Chromosome,GENE,Transcription start site (TSS),Variant,rsID,Strand,REF,ALT,PHYSICAL,distance_from_TSS,enformer_start,enformer_end,variant_pos_in_window
22,ENSG00000228274.1,38681860,chr22-38686169-A-G,rs10135,-1,A,G,38686169,4309,38485252,38878468,200917
22,ENSG00000230107.1,42438023,chr22-42439721-C-T,rs1016109,1,C,T,42439721,1698,42241415,42634631,198306
22,ENSG00000133519.8,23402157,chr22-23359943-T-C,rs10427608,-1,T,C,23359943,42214,23205549,23598765,154394
22,ENSG00000225335.1,18078884,chr22-17885381-C-T,rs1076113,-1,C,T,17885381,193503,17882276,18275492,3105
22,ENSG00000235111.1,49615716,chr22-49648735-T-C,rs1107514,-1,T,C,49648735,33019,49419108,49812324,229627
22,ENSG00000225528.1,39960397,chr22-39785583-T-C,rs113135601,1,T,C,39785583,174814,39763789,40157005,21794
22,ENSG00000226085.2,39875289,chr22-40004160-G-A,rs117035363,1,G,A,40004160,128871,39678681,40071897,325479
22,ENSG00000237214.2,41064052,chr22-40950641-T-C,rs117912353,1,T,C,40950641,113411,40867444,41260660,83197
22,ENSG00000229107.2,20670984,chr22-20671444-T-G,rs12168863,-1,T,G,20671444,460,20474376,20867592,197068
22,ENSG00000260708.1,46762564,chr22-46762282-G-A,rs12389,-1,G,A,46762282,282,46565956,46959172,196326
22,ENSG00000249310.2,38998209,chr22-38962032-A-C,rs12628403,-1,A,C,38962032,36177,38801601,39194817,160431
22,ENSG00000205559.3,50586873,chr22-50586195-T-C,rs131749,1,T,C,50586195,678,50390265,50783481,195930
22,ENSG00000232710.1,42139927,chr22-42072906-C-T,rs133380,-1,C,T,42072906,67021,41943319,42336535,129587
22,ENSG00000244627.1,38384096,chr22-38393931-G-A,rs138366,-1,G,A,38393931,9835,38187488,38580704,206443
22,ENSG00000260613.1,49838901,chr22-49726702-A-G,rs139784,-1,A,G,49726702,112199,49642293,50035509,84409
22,ENSG00000235954.2,27919421,chr22-27919477-T-C,rs16985722,1,T,C,27919477,56,27722813,28116029,196664
22,ENSG00000235954.2,27919421,chr22-27919477-T-A,rs16985722,1,T,A,27919477,56,27722813,28116029,196664
22,ENSG00000185065.6,19447893,chr22-19470889-A-G,rs17811336,1,A,G,19470889,22996,19251285,19644501,219604
22,ENSG00000261251.1,43812456,chr22-43660823-A-G,rs2040400,1,A,G,43660823,151633,43615848,44009064,44975
22,ENSG00000237438.1,17044873,chr22-17076254-A-G,rs2041629,1,A,G,17076254,31381,16848265,17241481,227989
22,ENSG00000240122.1,16595485,chr22-16613859-A-C,rs2096537,-1,A,C,16613859,18374,16398877,16792093,214982
22,ENSG00000226328.1,45163781,chr22-45173964-C-T,rs2138156,-1,C,T,45173964,10183,44967173,45360389,206791
22,ENSG00000184319.11,50798655,chr22-50774447-A-C,rs2238837,1,A,C,50774447,24208,50602047,50995263,172400
22,ENSG00000224086.3,21938293,chr22-21960091-T-C,rs239917,1,T,C,21960091,21798,21741685,22134901,218406
22,ENSG00000213888.2,31346777,chr22-31269876-A-G,rs2413045,1,A,G,31269876,76901,31150169,31543385,119707
22,ENSG00000172250.10,42500671,chr22-42500468-T-C,rs2413692,1,T,C,42500468,203,42304063,42697279,196405
22,ENSG00000161149.7,21014287,chr22-21002535-G-A,rs28372939,-1,G,A,21002535,11752,20817679,21210895,184856
22,ENSG00000230513.1,21001886,chr22-21002535-G-A,rs28372939,1,G,A,21002535,649,20805278,21198494,197257
22,ENSG00000227484.1,50314631,chr22-50289633-T-C,rs28379706,1,T,C,50289633,24998,50118023,50511239,171610
22,ENSG00000182257.5,46054144,chr22-46058328-G-A,rs3744749,-1,G,A,46058328,4184,45857536,46250752,200792
22,ENSG00000197182.8,46053869,chr22-46058328-G-A,rs3744749,1,G,A,46058328,4459,45857261,46250477,201067
22,ENSG00000241990.1,46053705,chr22-46058328-G-A,rs3744749,1,G,A,46058328,4623,45857097,46250313,201231
22,ENSG00000215493.3,20450122,chr22-20565159-G-A,rs3791192,1,G,A,20565159,115037,20253514,20646730,311645
22,ENSG00000233739.1,38073940,chr22-38060591-A-G,rs3952,-1,A,G,38060591,13349,37877332,38270548,183259
22,ENSG00000249263.2,16659628,chr22-16750713-C-T,rs4390844,-1,C,T,16750713,91085,16463020,16856236,287693
22,ENSG00000235513.1,41228500,chr22-41153917-A-C,rs4820431,-1,A,C,41153917,74583,41031892,41425108,122025
22,ENSG00000261188.1,26512503,chr22-26505264-G-C,rs4822730,1,G,C,26505264,7239,26315895,26709111,189369
22,ENSG00000225720.2,39091586,chr22-39250417-A-G,rs56229619,1,A,G,39250417,158831,38894978,39288194,355439
22,ENSG00000226450.2,42155001,chr22-42196233-C-G,rs5751239,-1,C,G,42196233,41232,41958393,42351609,237840
22,ENSG00000226450.2,42155001,chr22-42196233-C-T,rs5751239,-1,C,T,42196233,41232,41958393,42351609,237840
22,ENSG00000225282.1,23926900,chr22-23924860-C-T,rs5751777,1,C,T,23924860,2040,23730292,24123508,194568
22,ENSG00000215771.2,41190188,chr22-41065861-T-G,rs5758209,-1,T,G,41065861,124327,40993580,41386796,72281
22,ENSG00000205702.5,42144577,chr22-42288812-C-T,rs5758698,-1,C,T,42288812,144235,41947969,42341185,340843
22,ENSG00000211665.2,22747383,chr22-22661802-G-A,rs57625735,1,G,A,22661802,85581,22550775,22943991,111027
22,ENSG00000223730.1,44901592,chr22-44787665-T-C,rs5766013,1,T,C,44787665,113927,44704984,45098200,82681
22,ENSG00000254413.4,50579752,chr22-50631857-T-C,rs5770957,-1,T,C,50631857,52105,50383144,50776360,248713
22,ENSG00000223350.2,22343187,chr22-22457883-T-C,rs57849312,1,T,C,22457883,114696,22146579,22539795,311304
22,ENSG00000185837.3,17159351,chr22-17312122-G-A,rs5994253,1,G,A,17312122,152771,16962743,17355959,349379
22,ENSG00000226287.3,20702007,chr22-20844177-C-T,rs5996889,1,C,T,20844177,142170,20505399,20898615,338778
22,ENSG00000225544.1,21885673,chr22-21872748-A-C,rs5999891,-1,A,C,21872748,12925,21689065,22082281,183683
22,ENSG00000100058.7,25455712,chr22-25460264-C-T,rs6004658,1,C,T,25460264,4552,25259104,25652320,201160
22,ENSG00000226954.1,49724506,chr22-49761034-T-C,rs6009870,-1,T,C,49761034,36528,49527898,49921114,233136
22,ENSG00000243762.1,20111875,chr22-20193613-G-T,rs696885,-1,G,T,20193613,81738,19915267,20308483,278346
22,ENSG00000253239.1,22026076,chr22-22062249-T-C,rs7288332,1,T,C,22062249,36173,21829468,22222684,232781
22,ENSG00000235776.1,19792294,chr22-19848625-C-A,rs7288631,1,C,A,19848625,56331,19595686,19988902,252939
22,ENSG00000235776.1,19792294,chr22-19848625-C-T,rs7288631,1,C,T,19848625,56331,19595686,19988902,252939
22,ENSG00000230736.2,32376664,chr22-32362984-G-A,rs7289201,1,G,A,32362984,13680,32180056,32573272,182928
22,ENSG00000239435.1,16582707,chr22-16720766-T-A,rs73159852,-1,T,A,16720766,138059,16386099,16779315,334667
22,ENSG00000211644.2,22322472,chr22-22372843-G-T,rs738884,1,G,T,22372843,50371,22125864,22519080,246979
22,ENSG00000212939.2,49548681,chr22-49612430-C-T,rs763127,1,C,T,49612430,63749,49352073,49745289,260357
22,ENSG00000237015.1,29260889,chr22-29224187-G-A,rs78011494,1,G,A,29224187,36702,29064281,29457497,159906
22,ENSG00000230319.1,43038585,chr22-43134694-G-C,rs872841,1,G,C,43134694,96109,42841977,43235193,292717
22,ENSG00000093100.12,17811497,chr22-17982339-G-A,rs9605480,-1,G,A,17982339,170842,17614889,18008105,367450
22,ENSG00000128254.9,31945346,chr22-32064007-A-G,rs9609420,-1,A,G,32064007,118661,31748738,32141954,315269
22,ENSG00000234009.1,42777296,chr22-42757801-A-G,rs9611875,-1,A,G,42757801,19495,42580688,42973904,177113
22,ENSG00000188511.8,49657504,chr22-49657199-G-A,rs9616333,-1,G,A,49657199,305,49460896,49854112,196303
22,ENSG00000230071.1,40588003,chr22-40535227-T-C,rs9623181,-1,T,C,40535227,52776,40391395,40784611,143832
22,ENSG00000099984.6,23980123,chr22-23969285-G-A,rs9624364,1,G,A,23969285,10838,23783515,24176731,185770
22,ENSG00000172250.10,42500671,chr22-42585672-T-C,rs1043606,1,T,C,42585672,85001,42304063,42697279,281609
22,ENSG00000232926.1,19887289,chr22-19846503-A-G,rs1052978,1,A,G,19846503,40786,19690681,20083897,155822
22,ENSG00000185837.3,17159351,chr22-17201404-C-A,rs1076106,1,C,A,17201404,42053,16962743,17355959,238661
22,ENSG00000185065.6,19447893,chr22-19533775-A-G,rs112135032,1,A,G,19533775,85882,19251285,19644501,282490
22,ENSG00000188511.8,49657504,chr22-49660742-C-A,rs11705166,-1,C,A,49660742,3238,49460896,49854112,199846
22,ENSG00000184068.2,41834665,chr22-41801266-T-C,rs12166503,-1,T,C,41801266,33399,41638057,42031273,163209
22,ENSG00000214076.3,32269381,chr22-32440645-A-C,rs12167810,1,A,C,32440645,171264,32072773,32465989,367872
22,ENSG00000235513.1,41228500,chr22-41181960-G-A,rs12628695,-1,G,A,41181960,46540,41031892,41425108,150068
22,ENSG00000100068.7,25405274,chr22-25409257-T-C,rs13057190,-1,T,C,25409257,3983,25208666,25601882,200591
22,ENSG00000205559.3,50586873,chr22-50585879-T-C,rs131750,1,T,C,50585879,994,50390265,50783481,195614
22,ENSG00000233080.2,35194942,chr22-35130800-T-G,rs134215,-1,T,G,35130800,64142,34998334,35391550,132466
22,ENSG00000226450.2,42155001,chr22-42278233-A-G,rs134887,-1,A,G,42278233,123232,41958393,42351609,319840
22,ENSG00000225528.1,39960397,chr22-39937125-G-A,rs137985,1,G,A,39937125,23272,39763789,40157005,173336
22,ENSG00000202058.1,42565330,chr22-42519837-C-T,rs141049505,-1,C,T,42519837,45493,42368722,42761938,151115
22,ENSG00000234630.1,22293733,chr22-22379789-T-G,rs1477442,1,T,G,22379789,86056,22097125,22490341,282664
22,ENSG00000228050.1,22224566,chr22-22073744-C-T,rs16982463,-1,C,T,22073744,150822,22027958,22421174,45786
22,ENSG00000213279.2,49575426,chr22-49425841-G-A,rs17000949,-1,G,A,49425841,149585,49378818,49772034,47023
22,ENSG00000225282.1,23926900,chr22-24008384-C-A,rs17004811,1,C,A,24008384,81484,23730292,24123508,278092
22,ENSG00000225282.1,23926900,chr22-24008384-C-G,rs17004811,1,C,G,24008384,81484,23730292,24123508,278092
22,ENSG00000249263.2,16659628,chr22-16647551-G-A,rs17347266,-1,G,A,16647551,12077,16463020,16856236,184531
22,ENSG00000232710.1,42139927,chr22-42216290-C-A,rs17386314,-1,C,A,42216290,76363,41943319,42336535,272971
22,ENSG00000232710.1,42139927,chr22-42216290-C-T,rs17386314,-1,C,T,42216290,76363,41943319,42336535,272971
22,ENSG00000244425.1,23879790,chr22-23857332-C-T,rs17637865,-1,C,T,23857332,22458,23683182,24076398,174150
22,ENSG00000100058.7,25455712,chr22-25446967-T-C,rs17680597,1,T,C,25446967,8745,25259104,25652320,187863
22,ENSG00000225225.1,18103649,chr22-18070840-G-A,rs17742403,-1,G,A,18070840,32809,17907041,18300257,163799
22,ENSG00000223461.1,19121529,chr22-19128143-G-A,rs17811029,1,G,A,19128143,6614,18924921,19318137,203222
22,ENSG00000230513.1,21001886,chr22-20999039-G-A,rs178297,1,G,A,20999039,2847,20805278,21198494,193761
22,ENSG00000161149.7,21014287,chr22-20999039-G-A,rs178297,-1,G,A,20999039,15248,20817679,21210895,181360
22,ENSG00000232545.1,24101689,chr22-23970509-G-C,rs183093330,1,G,C,23970509,131180,23905081,24298297,65428
22,ENSG00000233739.1,38073940,chr22-38077699-G-A,rs2012859,-1,G,A,38077699,3759,37877332,38270548,200367
22,ENSG00000188078.5,36537604,chr22-36575910-A-C,rs2050140,-1,A,C,36575910,38306,36340996,36734212,234914
22,ENSG00000227117.2,30080230,chr22-29965892-G-A,rs2051764,-1,G,A,29965892,114338,29883622,30276838,82270
22,ENSG00000235989.2,30922449,chr22-31096496-C-T,rs2074736,1,C,T,31096496,174047,30725841,31119057,370655
22,ENSG00000205702.5,42144577,chr22-42146869-A-G,rs2142694,-1,A,G,42146869,2292,41947969,42341185,198900
22,ENSG00000249310.2,38998209,chr22-38996385-C-G,rs2179233,-1,C,G,38996385,1824,38801601,39194817,194784
22,ENSG00000253234.1,22856762,chr22-22939433-T-C,rs2188131,1,T,C,22939433,82671,22660154,23053370,279279
22,ENSG00000237668.1,36421644,chr22-36587381-G-A,rs2235682,-1,G,A,36587381,165737,36225036,36618252,362345
22,ENSG00000211637.2,22030934,chr22-22200764-C-T,rs2330021,1,C,T,22200764,169830,21834326,22227542,366438
22,ENSG00000224086.3,21938293,chr22-21994691-C-T,rs238775,1,C,T,21994691,56398,21741685,22134901,253006
22,ENSG00000214093.3,31559483,chr22-31508184-A-G,rs2413054,1,A,G,31508184,51299,31362875,31756091,145309
22,ENSG00000234353.2,23640425,chr22-23682628-C-T,rs3747110,-1,C,T,23682628,42203,23443817,23837033,238811
22,ENSG00000211651.2,22380766,chr22-22479416-G-A,rs403517,1,G,A,22479416,98650,22184158,22577374,295258
22,ENSG00000093100.12,17811497,chr22-18000622-A-G,rs4819654,-1,A,G,18000622,189125,17614889,18008105,385733
22,ENSG00000237438.1,17044873,chr22-17081023-A-C,rs4819956,1,A,C,17081023,36150,16848265,17241481,232758
22,ENSG00000237472.1,22988263,chr22-23122623-G-A,rs4820537,1,G,A,23122623,134360,22791655,23184871,330968
22,ENSG00000235237.1,37166757,chr22-37213254-A-G,rs4821603,1,A,G,37213254,46497,36970149,37363365,243105
22,ENSG00000226954.1,49724506,chr22-49726877-G-A,rs4824090,-1,G,A,49726877,2371,49527898,49921114,198979
22,ENSG00000133519.8,23402157,chr22-23308660-A-G,rs5751628,-1,A,G,23308660,93497,23205549,23598765,103111
22,ENSG00000249590.3,30409262,chr22-30433585-A-G,rs5753135,1,A,G,30433585,24323,30212654,30605870,220931
22,ENSG00000182841.8,42582001,chr22-42543702-A-G,rs5758798,-1,A,G,42543702,38299,42385393,42778609,158309
22,ENSG00000230319.1,43038585,chr22-43058449-A-G,rs5759124,1,A,G,43058449,19864,42841977,43235193,216472
22,ENSG00000214526.3,23322927,chr22-23506857-A-C,rs5759855,-1,A,C,23506857,183930,23126319,23519535,380538
22,ENSG00000161132.6,20299760,chr22-20410731-T-C,rs5761913,1,T,C,20410731,110971,20103152,20496368,307579
22,ENSG00000226471.1,28800683,chr22-28775310-G-A,rs5762784,1,G,A,28775310,25373,28604075,28997291,171235
22,ENSG00000238120.1,45620858,chr22-45610777-T-A,rs5765532,-1,T,A,45610777,10081,45424250,45817466,186527
22,ENSG00000211667.2,22771824,chr22-22695596-G-A,rs59747512,1,G,A,22695596,76228,22575216,22968432,120380
22,ENSG00000182257.5,46054144,chr22-46051834-T-C,rs59929908,-1,T,C,46051834,2310,45857536,46250752,194298
22,ENSG00000241990.1,46053705,chr22-46051834-T-C,rs59929908,1,T,C,46051834,1871,45857097,46250313,194737
22,ENSG00000197182.8,46053869,chr22-46051834-T-C,rs59929908,1,T,C,46051834,2035,45857261,46250477,194573
22,ENSG00000240122.1,16595485,chr22-16648848-T-C,rs5993792,-1,T,C,16648848,53363,16398877,16792093,249971
22,ENSG00000230107.1,42438023,chr22-42572530-G-A,rs5996192,1,G,A,42572530,134507,42241415,42634631,331115
22,ENSG00000230107.1,42438023,chr22-42572530-G-T,rs5996192,1,G,T,42572530,134507,42241415,42634631,331115
22,ENSG00000230701.1,23262767,chr22-23421987-C-T,rs6003704,1,C,T,23421987,159220,23066159,23459375,355828
22,ENSG00000099984.6,23980123,chr22-23896878-C-T,rs6003942,1,C,T,23896878,83245,23783515,24176731,113363
22,ENSG00000215270.3,15855243,chr22-15920591-G-A,rs62224618,-1,G,A,15920591,65348,15658635,16051851,261956
22,ENSG00000235111.1,49615716,chr22-49606629-C-T,rs62232134,-1,C,T,49606629,9087,49419108,49812324,187521
22,ENSG00000228839.1,31292499,chr22-31186676-A-G,rs6518737,1,A,G,31186676,105823,31095891,31489107,90785
22,ENSG00000218537.1,23898930,chr22-23840313-G-A,rs6519476,-1,G,A,23840313,58617,23702322,24095538,137991
22,ENSG00000260708.1,46762564,chr22-46749381-G-A,rs710123,-1,G,A,46749381,13183,46565956,46959172,183425
22,ENSG00000197549.5,21995428,chr22-22062249-T-C,rs7288332,-1,T,C,22062249,66821,21798820,22192036,263429
22,ENSG00000235776.1,19792294,chr22-19811651-C-T,rs73148929,1,C,T,19811651,19357,19595686,19988902,215965
22,ENSG00000235485.1,34591278,chr22-34494712-G-A,rs78252251,-1,G,A,34494712,96566,34394670,34787886,100042
22,ENSG00000211638.2,22098700,chr22-22017336-A-G,rs9610872,1,A,G,22017336,81364,21902092,22295308,115244
22,ENSG00000224688.1,21142371,chr22-21059718-T-C,rs9625442,-1,T,C,21059718,82653,20945763,21338979,113955
22,ENSG00000244625.1,26672805,chr22-26776863-A-C,rs1004970,1,A,C,26776863,104058,26476197,26869413,300666
22,ENSG00000232926.1,19887289,chr22-19890991-G-A,rs1015471,1,G,A,19890991,3702,19690681,20083897,200310
22,ENSG00000182057.4,42269744,chr22-42439721-C-T,rs1016109,1,C,T,42439721,169977,42073136,42466352,366585
22,ENSG00000227370.1,42132543,chr22-41943521-G-A,rs10483213,1,G,A,41943521,189022,41935935,42329151,7586
22,ENSG00000205702.5,42144577,chr22-42129623-C-T,rs1081004,-1,C,T,42129623,14954,41947969,42341185,181654
22,ENSG00000254835.1,31205616,chr22-31233025-G-A,rs11089492,-1,G,A,31233025,27409,31009008,31402224,224017
22,ENSG00000211644.2,22322472,chr22-22194177-T-C,rs111460696,1,T,C,22194177,128295,22125864,22519080,68313
22,ENSG00000100068.7,25405274,chr22-25385472-T-C,rs111824621,-1,T,C,25385472,19802,25208666,25601882,176806
22,ENSG00000211642.2,22214794,chr22-22244663-G-A,rs11574460,1,G,A,22244663,29869,22018186,22411402,226477
22,ENSG00000182257.5,46054144,chr22-46037562-G-A,rs12159453,-1,G,A,46037562,16582,45857536,46250752,180026
22,ENSG00000214125.2,31156647,chr22-31044717-A-C,rs12168052,-1,A,C,31044717,111930,30960039,31353255,84678
22,ENSG00000188511.8,49657504,chr22-49658341-A-G,rs13055216,-1,A,G,49658341,837,49460896,49854112,197445
22,ENSG00000254413.4,50579752,chr22-50550897-A-G,rs131778,-1,A,G,50550897,28855,50383144,50776360,167753
22,ENSG00000230107.1,42438023,chr22-42605122-C-T,rs137107,1,C,T,42605122,167099,42241415,42634631,363707
22,ENSG00000227367.1,16476870,chr22-16399370-G-A,rs140380,-1,G,A,16399370,77500,16280262,16673478,119108
22,ENSG00000213683.3,50755434,chr22-50755201-A-G,rs142680588,-1,A,G,50755201,233,50558826,50952042,196375
22,ENSG00000224688.1,21142371,chr22-21023045-C-T,rs1548412,-1,C,T,21023045,119326,20945763,21338979,77282
22,ENSG00000225450.1,38739003,chr22-38592339-C-T,rs1569493,1,C,T,38592339,146664,38542395,38935611,49944
22,ENSG00000224003.1,25647261,chr22-25513288-T-C,rs16980329,1,T,C,25513288,133973,25450653,25843869,62635
22,ENSG00000231369.1,26887548,chr22-26967669-T-C,rs16986703,-1,T,C,26967669,80121,26690940,27084156,276729
22,ENSG00000253818.1,22404207,chr22-22572747-C-T,rs16989280,1,C,T,22572747,168540,22207599,22600815,365148
22,ENSG00000237015.1,29260889,chr22-29445653-G-A,rs174719,1,G,A,29445653,184764,29064281,29457497,381372
22,ENSG00000225971.1,30137681,chr22-30234154-C-A,rs17729168,-1,C,A,30234154,96473,29941073,30334289,293081
22,ENSG00000230513.1,21001886,chr22-20996591-T-C,rs178295,1,T,C,20996591,5295,20805278,21198494,191313
22,ENSG00000161149.7,21014287,chr22-20997892-T-C,rs178296,-1,T,C,20997892,16395,20817679,21210895,180213
22,ENSG00000133519.8,23402157,chr22-23552510-C-T,rs179306,-1,C,T,23552510,150353,23205549,23598765,346961
22,ENSG00000184068.2,41834665,chr22-41887546-T-G,rs2284085,-1,T,G,41887546,52881,41638057,42031273,249489
22,ENSG00000223704.1,26860553,chr22-26815022-A-C,rs2331331,1,A,C,26815022,45531,26663945,27057161,151077
22,ENSG00000230736.2,32376664,chr22-32554118-A-G,rs2710381,1,A,G,32554118,177454,32180056,32573272,374062
22,ENSG00000185837.3,17159351,chr22-17145775-T-C,rs3788268,1,T,C,17145775,13576,16962743,17355959,183032
22,ENSG00000223730.1,44901592,chr22-44791910-G-A,rs3788622,1,G,A,44791910,109682,44704984,45098200,86926
22,ENSG00000249590.3,30409262,chr22-30457895-T-C,rs3804078,1,T,C,30457895,48633,30212654,30605870,245241
22,ENSG00000225225.1,18103649,chr22-18072368-A-G,rs4819666,-1,A,G,18072368,31281,17907041,18300257,165327
22,ENSG00000253234.1,22856762,chr22-22941147-A-G,rs4822352,1,A,G,22941147,84385,22660154,23053370,280993
22,ENSG00000099984.6,23980123,chr22-23913109-C-T,rs4822455,1,C,T,23913109,67014,23783515,24176731,129594
22,ENSG00000260708.1,46762564,chr22-46750478-C-T,rs4823572,-1,C,T,46750478,12086,46565956,46959172,184522
22,ENSG00000234735.1,43092167,chr22-43251948-A-G,rs53724,1,A,G,43251948,159781,42895559,43288775,356389
22,ENSG00000235776.1,19792294,chr22-19607792-C-A,rs5748350,1,C,A,19607792,184502,19595686,19988902,12106
22,ENSG00000235776.1,19792294,chr22-19607792-C-G,rs5748350,1,C,G,19607792,184502,19595686,19988902,12106
22,ENSG00000237438.1,17044873,chr22-17073766-T-C,rs5748851,1,T,C,17073766,28893,16848265,17241481,225501
22,ENSG00000235237.1,37166757,chr22-37215767-T-C,rs5756562,1,T,C,37215767,49010,36970149,37363365,245618
22,ENSG00000213790.2,42108953,chr22-42184927-A-C,rs5758637,-1,A,C,42184927,75974,41912345,42305561,272582
22,ENSG00000230319.1,43038585,chr22-43102108-G-A,rs5996274,1,G,A,43102108,63523,42841977,43235193,260131
22,ENSG00000205853.5,32382106,chr22-32390230-G-A,rs5998471,-1,G,A,32390230,8124,32185498,32578714,204732
22,ENSG00000233388.1,35503586,chr22-35644117-C-A,rs5999908,-1,C,A,35644117,140531,35306978,35700194,337139
22,ENSG00000100058.7,25455712,chr22-25513237-C-T,rs641296,1,C,T,25513237,57525,25259104,25652320,254133
22,ENSG00000229107.2,20670984,chr22-20666976-A-G,rs674478,-1,A,G,20666976,4008,20474376,20867592,192600
22,ENSG00000237668.1,36421644,chr22-36566805-C-T,rs67656940,-1,C,T,36566805,145161,36225036,36618252,341769
22,ENSG00000223350.2,22343187,chr22-22409502-T-G,rs72495405,1,T,G,22409502,66315,22146579,22539795,262923
22,ENSG00000228599.1,40107066,chr22-40016547-G-C,rs7284488,-1,G,C,40016547,90519,39910458,40303674,106089
22,ENSG00000250318.1,30654814,chr22-30695646-A-C,rs7288635,-1,A,C,30695646,40832,30458206,30851422,237440
22,ENSG00000226328.1,45163781,chr22-45131934-C-T,rs7290824,-1,C,T,45131934,31847,44967173,45360389,164761
22,ENSG00000205559.3,50586873,chr22-50514560-G-A,rs75276302,1,G,A,50514560,72313,50390265,50783481,124295
22,ENSG00000233080.2,35194942,chr22-35045645-G-A,rs80097772,-1,G,A,35045645,149297,34998334,35391550,47311
22,ENSG00000225282.1,23926900,chr22-23931098-G-T,rs8136062,1,G,T,23931098,4198,23730292,24123508,200806
22,ENSG00000228315.5,23717356,chr22-23913901-C-T,rs9608215,-1,C,T,23913901,196545,23520748,23913964,393153
22,ENSG00000228315.5,23717356,chr22-23913901-C-G,rs9608215,-1,C,G,23913901,196545,23520748,23913964,393153
22,ENSG00000224124.2,24658765,chr22-24824479-C-T,rs9608342,-1,C,T,24824479,165714,24462157,24855373,362322
22,ENSG00000225774.1,30542536,chr22-30455623-G-A,rs9608930,1,G,A,30455623,86913,30345928,30739144,109695
22,ENSG00000224086.3,21938293,chr22-21950571-G-A,rs9610690,1,G,A,21950571,12278,21741685,22134901,208886
22,ENSG00000182841.8,42582001,chr22-42763942-C-T,rs9611885,-1,C,T,42763942,181941,42385393,42778609,378549
22,ENSG00000261251.1,43812456,chr22-43797746-A-C,rs9614187,1,A,C,43797746,14710,43615848,44009064,181898
22,ENSG00000238120.1,45620858,chr22-45665362-A-G,rs9614501,-1,A,G,45665362,44504,45424250,45817466,241112
22,ENSG00000213279.2,49575426,chr22-49655461-G-A,rs9616713,-1,G,A,49655461,80035,49378818,49772034,276643
21,ENSG00000225331.1,44160072,chr21-44290224-T-C,rs1003854,-1,T,C,44290224,130152,43963464,44356680,326760
21,ENSG00000256073.1,32393095,chr21-32393251-C-T,rs11702306,1,C,T,32393251,156,32196487,32589703,196764
21,ENSG00000235772.1,42561934,chr21-42537146-G-A,rs12482752,-1,G,A,42537146,24788,42365326,42758542,171820
21,ENSG00000239415.1,46254133,chr21-46185421-C-T,rs12482934,-1,C,T,46185421,68712,46057525,46450741,127896
21,ENSG00000227039.1,44921051,chr21-44929581-C-T,rs1721,1,C,T,44929581,8530,44724443,45117659,205138
21,ENSG00000236883.1,41739373,chr21-41767035-C-T,rs199825512,1,C,T,41767035,27662,41542765,41935981,224270
21,ENSG00000233818.1,36445731,chr21-36459569-C-T,rs219784,1,C,T,36459569,13838,36249123,36642339,210446
21,ENSG00000237232.2,42009494,chr21-42024305-G-C,rs220219,1,G,C,42024305,14811,41812886,42206102,211419
21,ENSG00000249624.3,33230131,chr21-33252612-A-G,rs2236757,1,A,G,33252612,22481,33033523,33426739,219089
21,ENSG00000223799.1,33266296,chr21-33252612-A-G,rs2236757,-1,A,G,33252612,13684,33069688,33462904,182924
21,ENSG00000228941.1,31063168,chr21-31255676-T-G,rs2253204,-1,T,G,31255676,192508,30866560,31259776,389116
21,ENSG00000223768.1,45288037,chr21-45263707-A-G,rs2255761,1,A,G,45263707,24330,45091429,45484645,172278
21,ENSG00000168122.4,13113790,chr21-13240882-G-T,rs2259138,-1,G,T,13240882,127092,12917182,13310398,323700
21,ENSG00000224598.1,34136071,chr21-34167611-C-T,rs2834390,-1,C,T,34167611,31540,33939463,34332679,228148
21,ENSG00000242553.1,37221419,chr21-37231180-A-C,rs2835678,1,A,C,37231180,9761,37024811,37418027,206369
21,ENSG00000184441.4,44331234,chr21-44344514-T-G,rs2838551,1,T,G,44344514,13280,44134626,44527842,209888
21,ENSG00000236519.1,44802577,chr21-44802571-G-A,rs2838690,1,G,A,44802571,6,44605969,44999185,196602
21,ENSG00000236056.1,29222321,chr21-29203776-G-A,rs4817276,1,G,A,29203776,18545,29025713,29418929,178063
21,ENSG00000228600.1,14757588,chr21-14720750-A-G,rs56058204,1,A,G,14720750,36838,14560980,14954196,159770
21,ENSG00000235374.1,45072239,chr21-45115223-G-C,rs62216599,-1,G,C,45115223,42984,44875631,45268847,239592
21,ENSG00000230479.1,36430360,chr21-36387659-C-T,rs62229404,1,C,T,36387659,42701,36233752,36626968,153907
21,ENSG00000237594.1,31559245,chr21-31554584-C-T,rs6517046,1,C,T,31554584,4661,31362637,31755853,191947
21,ENSG00000235701.1,39172106,chr21-39181919-T-C,rs6517522,-1,T,C,39181919,9813,38975498,39368714,206421
21,ENSG00000230212.2,36126640,chr21-36066591-A-G,rs73370485,-1,A,G,36066591,60049,35930032,36323248,136559
21,ENSG00000228314.1,13847713,chr21-14022450-G-C,rs74532836,-1,G,C,14022450,174737,13651105,14044321,371345
21,ENSG00000230965.1,13906488,chr21-14022450-G-C,rs74532836,-1,G,C,14022450,115962,13709880,14103096,312570
21,ENSG00000237989.1,43362349,chr21-43499656-G-C,rs79491056,-1,G,C,43499656,137307,43165741,43558957,333915
21,ENSG00000237989.1,43362349,chr21-43499656-G-A,rs79491056,-1,G,A,43499656,137307,43165741,43558957,333915
21,ENSG00000229047.1,14961309,chr21-14844024-G-A,rs79694962,1,G,A,14844024,117285,14764701,15157917,79323
21,ENSG00000231125.1,29060095,chr21-29052092-T-C,rs8134828,-1,T,C,29052092,8003,28863487,29256703,188605
21,ENSG00000238197.1,32728600,chr21-32764715-G-A,rs9967977,1,G,A,32764715,36115,32531992,32925208,232723
21,ENSG00000238197.1,32728600,chr21-32764715-G-T,rs9967977,1,G,T,32764715,36115,32531992,32925208,232723
21,ENSG00000215458.4,43812567,chr21-43863789-T-C,rs10084623,-1,T,C,43863789,51222,43615959,44009175,247830
21,ENSG00000242553.1,37221419,chr21-37271471-T-G,rs1009922,1,T,G,37271471,50052,37024811,37418027,246660
21,ENSG00000260583.1,25583326,chr21-25648738-C-T,rs10482967,-1,C,T,25648738,65412,25386718,25779934,262020
21,ENSG00000215005.2,28889272,chr21-29059824-T-G,rs1064019,-1,T,G,29059824,170552,28692664,29085880,367160
21,ENSG00000184385.2,42108534,chr21-42110289-C-T,rs113203,-1,C,T,42110289,1755,41911926,42305142,198363
21,ENSG00000237604.1,44175489,chr21-44346142-G-C,rs11909876,1,G,C,44346142,170653,43978881,44372097,367261
21,ENSG00000235772.1,42561934,chr21-42572367-A-C,rs12483004,-1,A,C,42572367,10433,42365326,42758542,207041
21,ENSG00000223822.2,23390258,chr21-23551012-A-G,rs1557378,1,A,G,23551012,160754,23193650,23586866,357362
21,ENSG00000228314.1,13847713,chr21-13834363-A-G,rs1967441,-1,A,G,13834363,13350,13651105,14044321,183258
21,ENSG00000224905.2,14027421,chr21-14122133-C-A,rs1970046,1,C,A,14122133,94712,13830813,14224029,291320
21,ENSG00000184441.4,44331234,chr21-44330463-C-A,rs2070573,1,C,A,44330463,771,44134626,44527842,195837
21,ENSG00000229047.1,14961309,chr21-15044490-G-A,rs2823021,1,G,A,15044490,83181,14764701,15157917,279789
21,ENSG00000222042.1,25361868,chr21-25495958-C-T,rs2829780,-1,C,T,25495958,134090,25165260,25558476,330698
21,ENSG00000222042.1,25361868,chr21-25495958-C-G,rs2829780,-1,C,G,25495958,134090,25165260,25558476,330698
21,ENSG00000215533.4,29193480,chr21-29191846-G-T,rs2832255,1,G,T,29191846,1634,28996872,29390088,194974
21,ENSG00000237594.1,31559245,chr21-31582452-G-T,rs2833456,1,G,T,31582452,23207,31362637,31755853,219815
21,ENSG00000234107.1,31840341,chr21-31799518-G-A,rs2833517,1,G,A,31799518,40823,31643733,32036949,155785
21,ENSG00000223799.1,33266296,chr21-33254349-C-A,rs2834166,-1,C,A,33254349,11947,33069688,33462904,184661
21,ENSG00000234380.1,34745756,chr21-34713804-C-T,rs2834600,1,C,T,34713804,31952,34549148,34942364,164656
21,ENSG00000230982.1,46654022,chr21-46465226-G-A,rs2839266,-1,G,A,46465226,188796,46457414,46850630,7812
21,ENSG00000228318.1,41445708,chr21-41423100-G-A,rs459498,-1,G,A,41423100,22608,41249100,41642316,174000
21,ENSG00000237232.2,42009494,chr21-41996225-C-T,rs469359,1,C,T,41996225,13269,41812886,42206102,183339
21,ENSG00000223901.1,46220344,chr21-46250719-C-G,rs4818829,1,C,G,46250719,30375,46023736,46416952,226983
21,ENSG00000228709.1,44485463,chr21-44343759-A-G,rs4818908,1,A,G,44343759,141704,44288855,44682071,54904
21,ENSG00000236830.1,36175815,chr21-36303505-C-T,rs57462585,-1,C,T,36303505,127690,35979207,36372423,324298
21,ENSG00000214889.3,36132450,chr21-36303505-C-T,rs57462585,1,C,T,36303505,171055,35935842,36329058,367663
21,ENSG00000224790.1,36966485,chr21-36957100-T-C,rs61027540,1,T,C,36957100,9385,36769877,37163093,187223
21,ENSG00000227456.2,34157724,chr21-34315983-G-A,rs76633561,1,G,A,34315983,158259,33961116,34354332,354867
21,ENSG00000233818.1,36445731,chr21-36446773-A-G,rs8134233,1,A,G,36446773,1042,36249123,36642339,197650
21,ENSG00000227039.1,44921051,chr21-44942568-G-A,rs9637166,1,G,A,44942568,21517,44724443,45117659,218125
21,ENSG00000249624.3,33230131,chr21-33262760-C-T,rs9984273,1,C,T,33262760,32629,33033523,33426739,229237
21,ENSG00000215326.3,27143949,chr21-27100170-A-G,rs10482982,-1,A,G,27100170,43779,26947341,27340557,152829
21,ENSG00000230061.1,44425272,chr21-44305863-C-T,rs118169148,-1,C,T,44305863,119409,44228664,44621880,77199
21,ENSG00000224905.2,14027421,chr21-14164227-T-C,rs12482146,1,T,C,14164227,136806,13830813,14224029,333414
21,ENSG00000203616.2,13937325,chr21-13902170-C-T,rs12627520,-1,C,T,13902170,35155,13740717,14133933,161453
21,ENSG00000215533.4,29193480,chr21-29306256-C-T,rs16983948,1,C,T,29306256,112776,28996872,29390088,309384
21,ENSG00000238197.1,32728600,chr21-32820099-C-A,rs16989825,1,C,A,32820099,91499,32531992,32925208,288107
21,ENSG00000238197.1,32728600,chr21-32820099-C-T,rs16989825,1,C,T,32820099,91499,32531992,32925208,288107
21,ENSG00000235772.1,42561934,chr21-42554459-G-A,rs1878069,-1,G,A,42554459,7475,42365326,42758542,189133
21,ENSG00000223799.1,33266296,chr21-33208728-C-T,rs2186355,-1,C,T,33208728,57568,33069688,33462904,139040
21,ENSG00000233818.1,36445731,chr21-36430331-T-C,rs218642,1,T,C,36430331,15400,36249123,36642339,181208
21,ENSG00000184385.2,42108534,chr21-42062474-T-G,rs220265,-1,T,G,42062474,46060,41911926,42305142,150548
21,ENSG00000234380.1,34745756,chr21-34745975-C-T,rs2246640,1,C,T,34745975,219,34549148,34942364,196827
21,ENSG00000229880.1,44678086,chr21-44859590-T-C,rs235324,-1,T,C,44859590,181504,44481478,44874694,378112
21,ENSG00000228941.1,31063168,chr21-30915116-G-T,rs2833157,-1,G,T,30915116,148052,30866560,31259776,48556
21,ENSG00000234509.1,31659500,chr21-31854027-A-G,rs2833542,-1,A,G,31854027,194527,31462892,31856108,391135
21,ENSG00000205930.4,32772150,chr21-32642458-C-T,rs2833930,1,C,T,32642458,129692,32575542,32968758,66916
21,ENSG00000249624.3,33230131,chr21-33216189-T-C,rs2834153,1,T,C,33216189,13942,33033523,33426739,182666
21,ENSG00000230982.1,46654022,chr21-46564650-G-A,rs2839329,-1,G,A,46564650,89372,46457414,46850630,107236
21,ENSG00000237232.2,42009494,chr21-41998796-T-G,rs2839434,1,T,G,41998796,10698,41812886,42206102,185910
21,ENSG00000237232.2,42009494,chr21-41998796-T-C,rs2839434,1,T,C,41998796,10698,41812886,42206102,185910
21,ENSG00000227039.1,44921051,chr21-44993811-C-A,rs36221776,1,C,A,44993811,72760,44724443,45117659,269368
21,ENSG00000223768.1,45288037,chr21-45234503-C-T,rs3753016,1,C,T,45234503,53534,45091429,45484645,143074
21,ENSG00000222042.1,25361868,chr21-25398908-T-C,rs4817016,-1,T,C,25398908,37040,25165260,25558476,233648
21,ENSG00000237594.1,31559245,chr21-31543648-A-G,rs4817403,1,A,G,31543648,15597,31362637,31755853,181011
21,ENSG00000236519.1,44802577,chr21-44950676-T-C,rs4818995,1,T,C,44950676,148099,44605969,44999185,344707
21,ENSG00000233393.1,36104881,chr21-35928219-A-G,rs62230760,1,A,G,35928219,176662,35908273,36301489,19946
21,ENSG00000223901.1,46220344,chr21-46051796-A-G,rs7275542,1,A,G,46051796,168548,46023736,46416952,28060
21,ENSG00000223741.1,36487411,chr21-36576513-G-A,rs7283441,-1,G,A,36576513,89102,36290803,36684019,285710
21,ENSG00000223822.2,23390258,chr21-23265784-A-G,rs8131740,1,A,G,23265784,124474,23193650,23586866,72134
21,ENSG00000230965.1,13906488,chr21-14086964-G-C,rs8134447,-1,G,C,14086964,180476,13709880,14103096,377084
21,ENSG00000230965.1,13906488,chr21-14086964-G-A,rs8134447,-1,G,A,14086964,180476,13709880,14103096,377084
21,ENSG00000213440.2,44047041,chr21-44016117-C-G,rs965733,-1,C,G,44016117,30924,43850433,44243649,165684
21,ENSG00000184441.4,44331234,chr21-44401646-T-C,rs9974831,1,T,C,44401646,70412,44134626,44527842,267020
21,ENSG00000256073.1,32393095,chr21-32421227-G-A,rs9976461,1,G,A,32421227,28132,32196487,32589703,224740
21,ENSG00000242553.1,37221419,chr21-37288086-C-T,rs9976694,1,C,T,37288086,66667,37024811,37418027,263275
20,ENSG00000223651.1,41999397,chr20-41890348-C-T,rs10485682,-1,C,T,41890348,109049,41802789,42196005,87559
20,ENSG00000256566.1,2508907,chr20-2627511-A-G,rs11087524,-1,A,G,2627511,118604,2312299,2705515,315212
20,ENSG00000256566.1,2508907,chr20-2627511-A-T,rs11087524,-1,A,T,2627511,118604,2312299,2705515,315212
20,ENSG00000224635.1,38416797,chr20-38397157-A-G,rs1119803,-1,A,G,38397157,19640,38220189,38613405,176968
20,ENSG00000224635.1,38416797,chr20-38397157-A-T,rs1119803,-1,A,T,38397157,19640,38220189,38613405,176968
20,ENSG00000227379.2,25368766,chr20-25201362-T-C,rs11698185,-1,T,C,25201362,167404,25172158,25565374,29204
20,ENSG00000232333.1,17516843,chr20-17614084-G-A,rs13734,1,G,A,17614084,97241,17320235,17713451,293849
20,ENSG00000230155.1,35491005,chr20-35503847-G-A,rs17092712,-1,G,A,35503847,12842,35294397,35687613,209450
20,ENSG00000224497.1,35544747,chr20-35554516-G-A,rs17092784,-1,G,A,35554516,9769,35348139,35741355,206377
20,ENSG00000196756.5,38435381,chr20-38420312-A-G,rs1739652,-1,A,G,38420312,15069,38238773,38631989,181539
20,ENSG00000149531.9,30377372,chr20-30295149-A-G,rs1811868,1,A,G,30295149,82223,30180764,30573980,114385
20,ENSG00000228340.1,60138466,chr20-60140164-C-T,rs2025050,1,C,T,60140164,1698,59941858,60335074,198306
20,ENSG00000204556.4,26018832,chr20-26004160-T-C,rs2386804,1,T,C,26004160,14672,25822224,26215440,181936
20,ENSG00000205181.2,5526606,chr20-5504492-G-A,rs2423107,-1,G,A,5504492,22114,5329998,5723214,174494
20,ENSG00000230563.2,5445838,chr20-5504492-G-A,rs2423107,1,G,A,5504492,58654,5249230,5642446,255262
20,ENSG00000232803.1,62666724,chr20-62688263-A-G,rs2427385,-1,A,G,62688263,21539,62470116,62863332,218147
20,ENSG00000236352.1,53940160,chr20-53905181-A-G,rs2904376,1,A,G,53905181,34979,53743552,54136768,161629
20,ENSG00000232852.1,64292998,chr20-64199449-G-T,rs3003137,-1,G,T,64199449,93549,64096390,64489606,103059
20,ENSG00000215467.2,43652523,chr20-43727113-C-T,rs3091249,1,C,T,43727113,74590,43455915,43849131,271198
20,ENSG00000226405.1,21488625,chr20-21302257-A-C,rs34459185,-1,A,C,21302257,186368,21292017,21685233,10240
20,ENSG00000174365.14,38446343,chr20-38311767-A-G,rs3746476,1,A,G,38311767,134576,38249735,38642951,62032
20,ENSG00000229299.1,63744689,chr20-63711343-T-C,rs3761121,1,T,C,63711343,33346,63548081,63941297,163262
20,ENSG00000225336.2,34834462,chr20-34817507-C-A,rs3787217,-1,C,A,34817507,16955,34637854,35031070,179653
20,ENSG00000226632.1,3362324,chr20-3234902-C-A,rs3803957,-1,C,A,3234902,127422,3165716,3558932,69186
20,ENSG00000231133.1,63102371,chr20-63042490-T-C,rs4809469,-1,T,C,63042490,59881,62905763,63298979,136727
20,ENSG00000229853.1,47631438,chr20-47451332-A-G,rs4810639,-1,A,G,47451332,180106,47434830,47828046,16502
20,ENSG00000176659.5,60055853,chr20-60073043-G-T,rs4812146,1,G,T,60073043,17190,59859245,60252461,213798
20,ENSG00000223891.1,44210907,chr20-44216102-A-G,rs4812796,1,A,G,44216102,5195,44014299,44407515,201803
20,ENSG00000236526.1,11918677,chr20-11941589-G-A,rs4814046,-1,G,A,11941589,22912,11722069,12115285,219520
20,ENSG00000232645.1,23358175,chr20-23162329-C-T,rs4815179,-1,C,T,23162329,195846,23161567,23554783,762
20,ENSG00000225377.1,348490,chr20-409340-C-T,rs4815586,-1,C,T,409340,60850,151882,545098,257458
20,ENSG00000225978.1,63102205,chr20-63010496-G-A,rs6011530,1,G,A,63010496,91709,62905597,63298813,104899
20,ENSG00000218018.2,57392748,chr20-57260972-G-A,rs6014967,-1,G,A,57260972,131776,57196140,57589356,64832
20,ENSG00000225849.1,46465270,chr20-46521596-A-G,rs6017891,-1,A,G,46521596,56326,46268662,46661878,252934
20,ENSG00000231302.1,50620763,chr20-50622747-T-A,rs6020641,1,T,A,50622747,1984,50424155,50817371,198592
20,ENSG00000226243.1,44466842,chr20-44642914-G-A,rs6031688,-1,G,A,44642914,176072,44270234,44663450,372680
20,ENSG00000224565.1,47412327,chr20-47413302-T-C,rs6063108,-1,T,C,47413302,975,47215719,47608935,197583
20,ENSG00000228663.1,50913731,chr20-50838374-G-A,rs6067566,1,G,A,50838374,75357,50717123,51110339,121251
20,ENSG00000233347.1,52111049,chr20-51981647-G-A,rs6068032,-1,G,A,51981647,129402,51914441,52307657,67206
20,ENSG00000234684.1,1325405,chr20-1360321-G-C,rs6078809,1,G,C,1360321,34916,1128797,1522013,231524
20,ENSG00000212232.1,17962946,chr20-18026062-A-G,rs6080941,-1,A,G,18026062,63116,17766338,18159554,259724
20,ENSG00000226644.1,2207217,chr20-2199519-T-C,rs6082366,1,T,C,2199519,7698,2010609,2403825,188910
20,ENSG00000225022.1,5292831,chr20-5289618-G-T,rs6085074,-1,G,T,5289618,3213,5096223,5489439,193395
20,ENSG00000197670.5,53552770,chr20-53560021-G-A,rs6097480,1,G,A,53560021,7251,53356162,53749378,203859
20,ENSG00000175170.8,25868150,chr20-25868402-A-T,rs6115355,-1,A,T,25868402,252,25671542,26064758,196860
20,ENSG00000235590.2,58850903,chr20-58890516-G-A,rs6123837,-1,G,A,58890516,39613,58654295,59047511,236221
20,ENSG00000254995.4,58651434,chr20-58458328-C-T,rs6128347,1,C,T,58458328,193106,58454826,58848042,3502
20,ENSG00000125514.5,63037028,chr20-63034623-G-A,rs7273917,-1,G,A,63034623,2405,62840420,63233636,194203
20,ENSG00000261582.1,35280043,chr20-35438063-C-T,rs73094730,-1,C,T,35438063,158020,35083435,35476651,354628
20,ENSG00000213959.2,38615476,chr20-38665053-A-G,rs732503,-1,A,G,38665053,49577,38418868,38812084,246185
20,ENSG00000230837.1,33752543,chr20-33893855-T-C,rs733803,-1,T,C,33893855,141312,33555935,33949151,337920
20,ENSG00000214541.3,56601701,chr20-56698448-C-T,rs74416504,1,C,T,56698448,96747,56405093,56798309,293355
20,ENSG00000167046.4,62643304,chr20-62822995-G-A,rs760086,-1,G,A,62822995,179691,62446696,62839912,376299
20,ENSG00000225988.1,9514998,chr20-9467688-A-G,rs8122156,-1,A,G,9467688,47310,9318390,9711606,149298
20,ENSG00000227063.4,21755270,chr20-21719977-C-T,rs8124323,1,C,T,21719977,35293,21558662,21951878,161315
20,ENSG00000184617.9,46484461,chr20-46522634-A-G,rs847104,1,A,G,46522634,38173,46287853,46681069,234781
20,ENSG00000215063.3,4060113,chr20-4216551-A-G,rs910949,-1,A,G,4216551,156438,3863505,4256721,353046
20,ENSG00000124224.11,58286399,chr20-58326965-A-G,rs113512307,-1,A,G,58326965,40566,58089791,58483007,237174
20,ENSG00000230010.1,18347539,chr20-18282575-G-T,rs118036933,-1,G,T,18282575,64964,18150931,18544147,131644
20,ENSG00000101278.6,839977,chr20-989417-G-A,rs12329573,-1,G,A,989417,149440,643369,1036585,346048
20,ENSG00000175730.7,32690815,chr20-32603213-C-T,rs12480732,-1,C,T,32603213,87602,32494207,32887423,109006
20,ENSG00000236992.1,19823943,chr20-19802024-G-A,rs12481484,-1,G,A,19802024,21919,19627335,20020551,174689
20,ENSG00000237595.1,50166223,chr20-50205423-G-A,rs12624521,-1,G,A,50205423,39200,49969615,50362831,235808
20,ENSG00000230563.2,5445838,chr20-5509560-C-T,rs13039216,1,C,T,5509560,63722,5249230,5642446,260330
20,ENSG00000205181.2,5526606,chr20-5509560-C-T,rs13039216,-1,C,T,5509560,17046,5329998,5723214,179562
20,ENSG00000229539.1,3889173,chr20-4060804-G-A,rs17217189,-1,G,A,4060804,171631,3692565,4085781,368239
20,ENSG00000230155.1,35491005,chr20-35564866-C-T,rs2277862,-1,C,T,35564866,73861,35294397,35687613,270469
20,ENSG00000227688.2,36620403,chr20-36732236-T-C,rs2425266,1,T,C,36732236,111833,36423795,36817011,308441
20,ENSG00000177410.8,49278642,chr20-49097395-T-C,rs2426130,1,T,C,49097395,181247,49082034,49475250,15361
20,ENSG00000132832.4,44696096,chr20-44662579-C-G,rs2903744,-1,C,G,44662579,33517,44499488,44892704,163091
20,ENSG00000232852.1,64292998,chr20-64224768-C-T,rs351880,-1,C,T,64224768,68230,64096390,64489606,128378
20,ENSG00000233838.4,62845664,chr20-62841034-A-G,rs3664,1,A,G,62841034,4630,62649056,63042272,191978
20,ENSG00000213820.3,46099518,chr20-45968215-G-A,rs3737063,1,G,A,45968215,131303,45902910,46296126,65305
20,ENSG00000223651.1,41999397,chr20-42075463-G-A,rs3827068,-1,G,A,42075463,76066,41802789,42196005,272674
20,ENSG00000230568.1,3491005,chr20-3681495-C-T,rs554743,-1,C,T,3681495,190490,3294397,3687613,387098
20,ENSG00000234684.1,1325405,chr20-1368044-G-A,rs55686498,1,G,A,1368044,42639,1128797,1522013,239247
20,ENSG00000229222.1,49956745,chr20-49974428-G-C,rs55700732,1,G,C,49974428,17683,49760137,50153353,214291
20,ENSG00000229222.1,49956745,chr20-49974428-G-A,rs55700732,1,G,A,49974428,17683,49760137,50153353,214291
20,ENSG00000174365.14,38446343,chr20-38310476-T-C,rs5741801,1,T,C,38310476,135867,38249735,38642951,60741
20,ENSG00000124097.7,57495366,chr20-57400022-A-G,rs6025526,-1,A,G,57400022,95344,57298758,57691974,101264
20,ENSG00000223891.1,44210907,chr20-44211379-A-G,rs6031456,1,A,G,44211379,472,44014299,44407515,197080
20,ENSG00000236526.1,11918677,chr20-12008201-G-T,rs6041030,-1,G,T,12008201,89524,11722069,12115285,286132
20,ENSG00000225170.2,22273454,chr20-22325688-C-T,rs6048023,-1,C,T,22325688,52234,22076846,22470062,248842
20,ENSG00000213742.2,25624157,chr20-25584603-C-T,rs6050690,1,C,T,25584603,39554,25427549,25820765,157054
20,ENSG00000254995.4,58651434,chr20-58619923-G-A,rs6070537,1,G,A,58619923,31511,58454826,58848042,165097
20,ENSG00000234933.1,34402696,chr20-34515030-A-G,rs6088514,-1,A,G,34515030,112334,34206088,34599304,308942
20,ENSG00000225978.1,63102205,chr20-63081166-A-T,rs6090229,1,A,T,63081166,21039,62905597,63298813,175569
20,ENSG00000225978.1,63102205,chr20-63081166-A-C,rs6090229,1,A,C,63081166,21039,62905597,63298813,175569
20,ENSG00000125804.8,25985210,chr20-25988629-A-G,rs6115458,1,A,G,25988629,3419,25788602,26181818,200027
20,ENSG00000231133.1,63102371,chr20-63014756-C-T,rs62197298,-1,C,T,63014756,87615,62905763,63298979,108993
20,ENSG00000125514.5,63037028,chr20-63080132-T-C,rs62206577,-1,T,C,63080132,43104,62840420,63233636,239712
20,ENSG00000227063.4,21755270,chr20-21695583-A-G,rs7270286,1,A,G,21695583,59687,21558662,21951878,136921
20,ENSG00000238151.1,30403384,chr20-30406636-T-C,rs73117328,-1,T,C,30406636,3252,30206776,30599992,199860
20,ENSG00000232043.1,50578041,chr20-50565107-T-G,rs73272525,-1,T,G,50565107,12934,50381433,50774649,183674
20,ENSG00000225127.1,21106358,chr20-21027333-G-A,rs7344291,-1,G,A,21027333,79025,20909750,21302966,117583
20,ENSG00000212232.1,17962946,chr20-17874580-G-T,rs74672829,-1,G,T,17874580,88366,17766338,18159554,108242
20,ENSG00000231302.1,50620763,chr20-50792885-G-A,rs74842420,1,G,A,50792885,172122,50424155,50817371,368730
20,ENSG00000228340.1,60138466,chr20-60171129-A-G,rs761258,1,A,G,60171129,32663,59941858,60335074,229271
20,ENSG00000260032.1,36051018,chr20-35995025-T-G,rs76775934,-1,T,G,35995025,55993,35854410,36247626,140615
20,ENSG00000224635.1,38416797,chr20-38444448-G-A,rs805528,-1,G,A,38444448,27651,38220189,38613405,224259
20,ENSG00000026036.16,63659300,chr20-63842832-T-C,rs8121155,1,T,C,63842832,183532,63462692,63855908,380140
20,ENSG00000228663.1,50913731,chr20-50845163-G-T,rs8123262,1,G,T,50845163,68568,50717123,51110339,128040
20,ENSG00000224497.1,35544747,chr20-35425455-G-A,rs8123889,-1,G,A,35425455,119292,35348139,35741355,77316
20,ENSG00000223864.1,38978422,chr20-39171620-A-G,rs910100,-1,A,G,39171620,193198,38781814,39175030,389806
20,ENSG00000132832.4,44696096,chr20-44736480-A-G,rs113284708,-1,A,G,44736480,40384,44499488,44892704,236992
20,ENSG00000232493.2,41547422,chr20-41611182-G-A,rs11696455,1,G,A,41611182,63760,41350814,41744030,260368
20,ENSG00000231878.1,49729842,chr20-49621804-C-T,rs11905762,-1,C,T,49621804,108038,49533234,49926450,88570
20,ENSG00000225377.1,348490,chr20-430598-T-C,rs11906780,-1,T,C,430598,82108,151882,545098,278716
20,ENSG00000229873.1,62805961,chr20-62873233-A-G,rs12479676,-1,A,G,62873233,67272,62609353,63002569,263880
20,ENSG00000233838.4,62845664,chr20-62768472-C-T,rs12626156,1,C,T,62768472,77192,62649056,63042272,119416
20,ENSG00000196756.5,38435381,chr20-38612123-A-G,rs1569707,-1,A,G,38612123,176742,38238773,38631989,373350
20,ENSG00000236992.1,19823943,chr20-19861152-G-A,rs17301007,-1,G,A,19861152,37209,19627335,20020551,233817
20,ENSG00000232241.1,17479431,chr20-17508555-T-C,rs17717798,-1,T,C,17508555,29124,17282823,17676039,225732
20,ENSG00000233347.1,52111049,chr20-51958783-G-A,rs17730522,-1,G,A,51958783,152266,51914441,52307657,44342
20,ENSG00000225988.1,9514998,chr20-9516069-C-G,rs2232264,-1,C,G,9516069,1071,9318390,9711606,197679
20,ENSG00000233578.1,5548840,chr20-5426716-C-A,rs2273470,1,C,A,5426716,122124,5352232,5745448,74484
20,ENSG00000227379.2,25368766,chr20-25320386-G-A,rs2274890,-1,G,A,25320386,48380,25172158,25565374,148228
20,ENSG00000184617.9,46484461,chr20-46636381-A-C,rs2425890,1,A,C,46636381,151920,46287853,46681069,348528
20,ENSG00000176659.5,60055853,chr20-60074739-G-A,rs242813,1,G,A,60074739,18886,59859245,60252461,215494
20,ENSG00000225849.1,46465270,chr20-46507805-C-T,rs2780231,-1,C,T,46507805,42535,46268662,46661878,239143
20,ENSG00000224497.1,35544747,chr20-35444024-T-C,rs2889882,-1,T,C,35444024,100723,35348139,35741355,95885
20,ENSG00000234684.1,1325405,chr20-1325459-C-T,rs34019978,1,C,T,1325459,54,1128797,1522013,196662
20,ENSG00000223891.1,44210907,chr20-44211350-T-C,rs3843762,1,T,C,44211350,443,44014299,44407515,197051
20,ENSG00000231119.2,47352561,chr20-47259550-T-A,rs41496345,1,T,A,47259550,93011,47155953,47549169,103597
20,ENSG00000213959.2,38615476,chr20-38643946-G-A,rs419162,-1,G,A,38643946,28470,38418868,38812084,225078
20,ENSG00000226332.1,62306325,chr20-62200128-T-C,rs4925356,-1,T,C,62200128,106197,62109717,62502933,90411
20,ENSG00000226948.1,4630219,chr20-4776839-G-T,rs6037961,-1,G,T,4776839,146620,4433611,4826827,343228
20,ENSG00000229539.1,3889173,chr20-4037932-A-G,rs6052257,-1,A,G,4037932,148759,3692565,4085781,345367
20,ENSG00000175730.7,32690815,chr20-32857341-G-A,rs6057659,-1,G,A,32857341,166526,32494207,32887423,363134
20,ENSG00000125514.5,63037028,chr20-63024942-A-G,rs6062772,-1,A,G,63024942,12086,62840420,63233636,184522
20,ENSG00000167046.4,62643304,chr20-62706559-T-C,rs6062915,-1,T,C,62706559,63255,62446696,62839912,259863
20,ENSG00000227477.1,44966402,chr20-44988199-C-T,rs6073588,-1,C,T,44988199,21797,44769794,45163010,218405
20,ENSG00000230563.2,5445838,chr20-5490415-T-C,rs6085178,1,T,C,5490415,44577,5249230,5642446,241185
20,ENSG00000244558.1,44745995,chr20-44790965-C-T,rs6103863,-1,C,T,44790965,44970,44549387,44942603,241578
20,ENSG00000260257.1,32856621,chr20-32752550-T-C,rs6141803,1,T,C,32752550,104071,32660013,33053229,92537
20,ENSG00000224635.1,38416797,chr20-38442094-C-T,rs62203381,-1,C,T,38442094,25297,38220189,38613405,221905
20,ENSG00000230750.1,10385779,chr20-10489153-C-T,rs637688,1,C,T,10489153,103374,10189171,10582387,299982
20,ENSG00000229853.1,47631438,chr20-47439355-G-C,rs6512444,-1,G,C,47439355,192083,47434830,47828046,4525
20,ENSG00000224452.1,32170790,chr20-32091091-A-C,rs74502037,-1,A,C,32091091,79699,31974182,32367398,116909
20,ENSG00000224452.1,32170790,chr20-32091091-A-T,rs74502037,-1,A,T,32091091,79699,31974182,32367398,116909
20,ENSG00000226608.2,4023917,chr20-3945996-C-A,rs76354766,1,C,A,3945996,77921,3827309,4220525,118687
20,ENSG00000226143.1,43550949,chr20-43548659-G-C,rs79899793,-1,G,C,43548659,2290,43354341,43747557,194318
20,ENSG00000225978.1,63102205,chr20-63273900-G-A,rs80124662,1,G,A,63273900,171695,62905597,63298813,368303
19,ENSG00000219665.3,11987679,chr19-12012019-G-A,rs10404882,1,G,A,12012019,24340,11791071,12184287,220948
19,ENSG00000254887.1,42132555,chr19-42081822-T-G,rs10414151,1,T,G,42081822,50733,41935947,42329163,145875
19,ENSG00000104970.6,54532798,chr19-54520318-A-G,rs10421435,1,A,G,54520318,12480,54336190,54729406,184128
19,ENSG00000166770.4,56478230,chr19-56403850-A-G,rs10424112,1,A,G,56403850,74380,56281622,56674838,122228
19,ENSG00000261824.1,27793703,chr19-27898221-T-C,rs10516700,-1,T,C,27898221,104518,27597095,27990311,301126
19,ENSG00000255441.1,51415906,chr19-51403752-T-C,rs11084080,1,T,C,51403752,12154,51219298,51612514,184454
19,ENSG00000254760.1,51414298,chr19-51400630-G-A,rs11666106,1,G,A,51400630,13668,51217690,51610906,182940
19,ENSG00000167747.8,50798910,chr19-50796085-C-T,rs11668998,-1,C,T,50796085,2825,50602302,50995518,193783
19,ENSG00000187534.4,39943680,chr19-39941114-C-T,rs11879271,-1,C,T,39941114,2566,39747072,40140288,194042
19,ENSG00000205786.2,35399531,chr19-35407997-A-G,rs16970294,1,A,G,35407997,8466,35202923,35596139,205074
19,ENSG00000176761.6,44467641,chr19-44475493-A-C,rs16979124,1,A,C,44475493,7852,44271033,44664249,204460
19,ENSG00000240296.1,54268005,chr19-54368469-T-C,rs1985840,1,T,C,54368469,100464,54071397,54464613,297072
19,ENSG00000254503.1,17418288,chr19-17406365-T-C,rs2278233,-1,T,C,17406365,11923,17221680,17614896,184685
19,ENSG00000167807.9,10316009,chr19-10362257-A-G,rs280519,-1,A,G,10362257,46248,10119401,10512617,242856
19,ENSG00000188223.7,35745678,chr19-35741519-C-T,rs2871921,1,C,T,35741519,4159,35549070,35942286,192449
19,ENSG00000198153.6,22685167,chr19-22656585-A-G,rs2885221,1,A,G,22656585,28582,22488559,22881775,168026
19,ENSG00000232871.4,48680081,chr19-48618991-T-C,rs3094287,1,T,C,48618991,61090,48483473,48876689,135518
19,ENSG00000180279.4,50817384,chr19-50825480-C-T,rs3212810,1,C,T,50825480,8096,50620776,51013992,204704
19,ENSG00000231205.6,20409959,chr19-20543062-G-A,rs33930,-1,G,A,20543062,133103,20213351,20606567,329711
19,ENSG00000123870.8,52592038,chr19-52678095-G-A,rs34377664,1,G,A,52678095,86057,52395430,52788646,282665
19,ENSG00000197813.3,49340303,chr19-49336666-G-C,rs354025,-1,G,C,49336666,3637,49143695,49536911,192971
19,ENSG00000204666.3,50050589,chr19-50003109-C-T,rs3786675,1,C,T,50003109,47480,49853981,50247197,149128
19,ENSG00000230510.1,46527072,chr19-46382977-G-A,rs45587933,-1,G,A,46382977,144095,46330464,46723680,52513
19,ENSG00000230510.1,46527072,chr19-46382977-G-T,rs45587933,-1,G,T,46382977,144095,46330464,46723680,52513
19,ENSG00000249435.1,53426499,chr19-53431351-A-G,rs4803113,-1,A,G,53431351,4852,53229891,53623107,201460
19,ENSG00000261342.1,2729327,chr19-2763225-G-C,rs4807325,-1,G,C,2763225,33898,2532719,2925935,230506
19,ENSG00000142539.7,50415799,chr19-50344768-G-A,rs59323905,1,G,A,50344768,71031,50219191,50612407,125577
19,ENSG00000242255.1,52564076,chr19-52580557-T-C,rs62117242,1,T,C,52580557,16481,52367468,52760684,213089
19,ENSG00000241015.2,53441863,chr19-53439900-G-A,rs6509765,1,G,A,53439900,1963,53245255,53638471,194645
19,ENSG00000224730.1,54638892,chr19-54617369-G-A,rs7246537,-1,G,A,54617369,21523,54442284,54835500,175085
19,ENSG00000250731.1,53479350,chr19-53440585-C-T,rs7246687,1,C,T,53440585,38765,53282742,53675958,157843
19,ENSG00000226510.1,35673304,chr19-35682635-C-T,rs7252243,-1,C,T,35682635,9331,35476696,35869912,205939
19,ENSG00000105501.6,51645545,chr19-51664653-G-A,rs7255319,-1,G,A,51664653,19108,51448937,51842153,215716
19,ENSG00000105501.6,51645545,chr19-51664653-G-C,rs7255319,-1,G,C,51664653,19108,51448937,51842153,215716
19,ENSG00000213303.3,11523436,chr19-11469791-C-T,rs7257898,1,C,T,11469791,53645,11326828,11720044,142963
19,ENSG00000243066.1,14588357,chr19-14632433-A-G,rs726788,1,A,G,14632433,44076,14391749,14784965,240684
19,ENSG00000236312.3,22368952,chr19-22327616-C-A,rs73025983,-1,C,A,22327616,41336,22172344,22565560,155272
19,ENSG00000236312.3,22368952,chr19-22327616-C-G,rs73025983,-1,C,G,22327616,41336,22172344,22565560,155272
19,ENSG00000238150.1,53775599,chr19-53734954-C-T,rs74704964,1,C,T,53734954,40645,53578991,53972207,155963
19,ENSG00000233527.2,36573070,chr19-36514396-A-G,rs76808668,1,A,G,36514396,58674,36376462,36769678,137934
19,ENSG00000142396.4,58305377,chr19-58304963-T-C,rs80320621,1,T,C,58304963,414,58108769,58501985,196194
19,ENSG00000226025.3,39681433,chr19-39679413-G-A,rs8103033,1,G,A,39679413,2020,39484825,39878041,194588
19,ENSG00000248830.1,34545395,chr19-34677724-G-C,rs8106282,-1,G,C,34677724,132329,34348787,34742003,328937
19,ENSG00000248830.1,34545395,chr19-34677724-G-A,rs8106282,-1,G,A,34677724,132329,34348787,34742003,328937
19,ENSG00000242779.1,52970875,chr19-52948038-T-C,rs9304742,-1,T,C,52948038,22837,52774267,53167483,173771
19,ENSG00000171570.5,40778271,chr19-40772115-G-A,rs10425480,1,G,A,40772115,6156,40581663,40974879,190452
19,ENSG00000180279.4,50817384,chr19-50820245-A-G,rs1054713,1,A,G,50820245,2861,50620776,51013992,199469
19,ENSG00000226025.3,39681433,chr19-39679463-A-C,rs11083532,1,A,C,39679463,1970,39484825,39878041,194638
19,ENSG00000226025.3,39681433,chr19-39679463-A-T,rs11083532,1,A,T,39679463,1970,39484825,39878041,194638
19,ENSG00000243455.1,18048637,chr19-18063921-C-T,rs11575935,1,C,T,18063921,15284,17852029,18245245,211892
19,ENSG00000250731.1,53479350,chr19-53439630-A-G,rs11672864,1,A,G,53439630,39720,53282742,53675958,156888
19,ENSG00000197813.3,49340303,chr19-49381743-C-T,rs11882571,-1,C,T,49381743,41440,49143695,49536911,238048
19,ENSG00000213253.5,13158788,chr19-13220929-T-C,rs12461897,-1,T,C,13220929,62141,12962180,13355396,258749
19,ENSG00000123870.8,52592038,chr19-52578482-C-T,rs12971607,1,C,T,52578482,13556,52395430,52788646,183052
19,ENSG00000166770.4,56478230,chr19-56494183-G-A,rs16987292,1,G,A,56494183,15953,56281622,56674838,212561
19,ENSG00000242615.1,12142893,chr19-12128978-T-C,rs17719999,-1,T,C,12128978,13915,11946285,12339501,182693
19,ENSG00000167747.8,50798910,chr19-50824837-G-A,rs2560934,-1,G,A,50824837,25927,50602302,50995518,222535
19,ENSG00000249435.1,53426499,chr19-53429112-C-T,rs2617765,-1,C,T,53429112,2613,53229891,53623107,199221
19,ENSG00000249435.1,53426499,chr19-53429112-C-G,rs2617765,-1,C,G,53429112,2613,53229891,53623107,199221
19,ENSG00000188223.7,35745678,chr19-35795632-C-T,rs2619200,1,C,T,35795632,49954,35549070,35942286,246562
19,ENSG00000257355.1,12052967,chr19-12184795-C-G,rs271197,-1,C,G,12184795,131828,11856359,12249575,328436
19,ENSG00000232220.1,53876049,chr19-53889327-G-A,rs307947,-1,G,A,53889327,13278,53679441,54072657,209886
19,ENSG00000233527.2,36573070,chr19-36598063-G-A,rs3096628,1,G,A,36598063,24993,36376462,36769678,221601
19,ENSG00000260160.1,52063703,chr19-52135509-T-C,rs34216052,-1,T,C,52135509,71806,51867095,52260311,268414
19,ENSG00000131401.7,50344761,chr19-50454155-G-A,rs35215508,-1,G,A,50454155,109394,50148153,50541369,306002
19,ENSG00000242255.1,52564076,chr19-52564040-T-C,rs4401146,1,T,C,52564040,36,52367468,52760684,196572
19,ENSG00000259605.1,45764785,chr19-45735668-G-T,rs4803852,1,G,T,45735668,29117,45568177,45961393,167491
19,ENSG00000257074.1,34296592,chr19-34105092-T-C,rs4805985,-1,T,C,34105092,191500,34099984,34493200,5108
19,ENSG00000237017.1,54125343,chr19-54115811-G-A,rs4806711,-1,G,A,54115811,9532,53928735,54321951,187076
19,ENSG00000204666.3,50050589,chr19-50059493-G-T,rs61749501,1,G,T,50059493,8904,49853981,50247197,205512
19,ENSG00000262497.1,35233003,chr19-35396121-C-T,rs71352989,-1,C,T,35396121,163118,35036395,35429611,359726
19,ENSG00000205786.2,35399531,chr19-35437732-A-G,rs7258037,1,A,G,35437732,38201,35202923,35596139,234809
19,ENSG00000261770.1,27760849,chr19-27578083-C-T,rs73030427,-1,C,T,27578083,182766,27564241,27957457,13842
19,ENSG00000223573.1,5567953,chr19-5432998-C-T,rs74790527,-1,C,T,5432998,134955,5371345,5764561,61653
19,ENSG00000219665.3,11987679,chr19-12075917-A-G,rs76842919,1,A,G,12075917,88238,11791071,12184287,284846
19,ENSG00000241015.2,53441863,chr19-53444565-G-A,rs8102929,1,G,A,53444565,2702,53245255,53638471,199310
19,ENSG00000198153.6,22685167,chr19-22641717-T-C,rs8112981,1,T,C,22641717,43450,22488559,22881775,153158
19,ENSG00000213777.4,53503392,chr19-53408257-G-A,rs8182488,1,G,A,53408257,95135,53306784,53700000,101473
19,ENSG00000231205.6,20409959,chr19-20377121-G-A,rs8182505,-1,G,A,20377121,32838,20213351,20606567,163770
19,ENSG00000226510.1,35673304,chr19-35674556-C-A,rs9973289,-1,C,A,35674556,1252,35476696,35869912,197860
19,ENSG00000248406.1,12383687,chr19-12301460-T-C,rs10221531,-1,T,C,12301460,82227,12187079,12580295,114381
19,ENSG00000259242.1,19606350,chr19-19546389-C-T,rs1036215,1,C,T,19546389,59961,19409742,19802958,136647
19,ENSG00000105501.6,51645545,chr19-51670158-T-C,rs10853839,-1,T,C,51670158,24613,51448937,51842153,221221
19,ENSG00000167807.9,10316009,chr19-10431645-C-G,rs111740485,-1,C,G,10431645,115636,10119401,10512617,312244
19,ENSG00000205786.2,35399531,chr19-35577259-G-A,rs114852218,1,G,A,35577259,177728,35202923,35596139,374336
19,ENSG00000167774.1,8321379,chr19-8502381-T-C,rs11667920,-1,T,C,8502381,181002,8124771,8517987,377610
19,ENSG00000240522.1,21150438,chr19-21230335-C-T,rs11671410,-1,C,T,21230335,79897,20953830,21347046,276505
19,ENSG00000249435.1,53426499,chr19-53417738-G-A,rs11671655,-1,G,A,53417738,8761,53229891,53623107,187847
19,ENSG00000226510.1,35673304,chr19-35690144-T-C,rs12151356,-1,T,C,35690144,16840,35476696,35869912,213448
19,ENSG00000240225.3,56373250,chr19-56217080-T-C,rs12459850,1,T,C,56217080,156170,56176642,56569858,40438
19,ENSG00000123870.8,52592038,chr19-52600622-T-C,rs12971484,1,T,C,52600622,8584,52395430,52788646,205192
19,ENSG00000213777.4,53503392,chr19-53309491-C-T,rs1428641,1,C,T,53309491,193901,53306784,53700000,2707
19,ENSG00000255875.1,52809824,chr19-52987256-T-C,rs1583962,1,T,C,52987256,177432,52613216,53006432,374040
19,ENSG00000180279.4,50817384,chr19-50972447-C-A,rs16988619,1,C,A,50972447,155063,50620776,51013992,351671
19,ENSG00000186152.6,54696604,chr19-54662046-A-G,rs1749311,1,A,G,54662046,34558,54499996,54893212,162050
19,ENSG00000219665.3,11987679,chr19-12165463-G-A,rs17638694,1,G,A,12165463,177784,11791071,12184287,374392
19,ENSG00000233527.2,36573070,chr19-36526894-A-G,rs17707014,1,A,G,36526894,46176,36376462,36769678,150432
19,ENSG00000226696.1,54449014,chr19-54351651-A-G,rs2287826,-1,A,G,54351651,97363,54252406,54645622,99245
19,ENSG00000235555.1,49275119,chr19-49426923-T-C,rs2335086,1,T,C,49426923,151804,49078511,49471727,348412
19,ENSG00000231205.6,20409959,chr19-20388684-T-G,rs2336456,-1,T,G,20388684,21275,20213351,20606567,175333
19,ENSG00000167747.8,50798910,chr19-50817324-G-A,rs2739454,-1,G,A,50817324,18414,50602302,50995518,215022
19,ENSG00000224864.3,20125044,chr19-19944655-A-G,rs34485662,1,A,G,19944655,180389,19928436,20321652,16219
19,ENSG00000197813.3,49340303,chr19-49279364-G-A,rs353999,-1,G,A,49279364,60939,49143695,49536911,135669
19,ENSG00000213253.5,13158788,chr19-13339561-A-C,rs62109119,-1,A,C,13339561,180773,12962180,13355396,377381
19,ENSG00000161643.7,49969600,chr19-49907016-T-C,rs62126289,1,T,C,49907016,62584,49772992,50166208,134024
19,ENSG00000226025.3,39681433,chr19-39691955-A-G,rs6508902,1,A,G,39691955,10522,39484825,39878041,207130
19,ENSG00000261770.1,27760849,chr19-27933961-C-G,rs7255713,-1,C,G,27933961,173112,27564241,27957457,369720
19,ENSG00000243494.1,54973817,chr19-54956239-T-C,rs73605964,1,T,C,54956239,17578,54777209,55170425,179030
19,ENSG00000241015.2,53441863,chr19-53433258-G-A,rs79030195,1,G,A,53433258,8605,53245255,53638471,188003
19,ENSG00000242779.1,52970875,chr19-52997291-C-A,rs80008812,-1,C,A,52997291,26416,52774267,53167483,223024
19,ENSG00000261342.1,2729327,chr19-2834810-T-C,rs8102063,-1,T,C,2834810,105483,2532719,2925935,302091
19,ENSG00000250731.1,53479350,chr19-53444565-G-A,rs8102929,1,G,A,53444565,34785,53282742,53675958,161823
19,ENSG00000176593.3,58002061,chr19-57899184-G-A,rs8103254,1,G,A,57899184,102877,57805453,58198669,93731
19,ENSG00000232871.4,48680081,chr19-48748498-G-A,rs838143,1,G,A,48748498,68417,48483473,48876689,265025
19,ENSG00000243066.1,14588357,chr19-14632112-G-T,rs9305046,1,G,T,14632112,43755,14391749,14784965,240363
18,ENSG00000177337.2,3594099,chr18-3595286-G-A,rs2240898,1,G,A,3595286,1187,3397491,3790707,197795
18,ENSG00000176912.2,658269,chr18-683607-C-T,rs2612091,-1,C,T,683607,25338,461661,854877,221946
18,ENSG00000215492.4,32413176,chr18-32268764-C-T,rs3891458,-1,C,T,32268764,144412,32216568,32609784,52196
18,ENSG00000260747.1,68278243,chr18-68297384-A-C,rs517992,-1,A,C,68297384,19141,68081635,68474851,215749
18,ENSG00000259985.1,31685655,chr18-31689270-C-T,rs71361340,1,C,T,31689270,3615,31489047,31882263,200223
18,ENSG00000215512.5,15330282,chr18-15215872-C-G,rs7227666,-1,C,G,15215872,114410,15133674,15526890,82198
18,ENSG00000175886.7,39335672,chr18-39305746-T-G,rs117685376,-1,T,G,39305746,29926,39139064,39532280,166682
18,ENSG00000214255.4,70430231,chr18-70500037-C-T,rs17241630,1,C,T,70500037,69806,70233623,70626839,266414
18,ENSG00000260552.1,36187459,chr18-36132745-G-A,rs17672308,-1,G,A,36132745,54714,35990851,36384067,141894
18,ENSG00000260747.1,68278243,chr18-68289458-T-G,rs17802226,-1,T,G,68289458,11215,68081635,68474851,207823
18,ENSG00000176912.2,658269,chr18-714118-C-T,rs2847603,-1,C,T,714118,55849,461661,854877,252457
18,ENSG00000177337.2,3594099,chr18-3600188-A-G,rs548849,1,A,G,3600188,6089,3397491,3790707,202697
18,ENSG00000257513.1,11639461,chr18-11724008-A-G,rs9303744,-1,A,G,11724008,84547,11442853,11836069,281155
18,ENSG00000235028.1,58019061,chr18-58181021-T-C,rs12458881,-1,T,C,58181021,161960,57822453,58215669,358568
18,ENSG00000260552.1,36187459,chr18-36111350-T-G,rs1540043,-1,T,G,36111350,76109,35990851,36384067,120499
18,ENSG00000242060.1,60149576,chr18-59973835-C-T,rs17066438,1,C,T,59973835,175741,59952968,60346184,20867
18,ENSG00000262001.1,3603928,chr18-3764945-A-C,rs59441360,1,A,C,3764945,161017,3407320,3800536,357625
18,ENSG00000176912.2,658269,chr18-651091-A-G,rs66483937,-1,A,G,651091,7178,461661,854877,189430
18,ENSG00000214917.3,32076272,chr18-32056270-A-C,rs7236796,-1,A,C,32056270,20002,31879664,32272880,176606
18,ENSG00000243256.1,61405205,chr18-61394746-T-G,rs7237834,-1,T,G,61394746,10459,61208597,61601813,186149
18,ENSG00000231544.1,57838476,chr18-57919591-G-A,rs7240052,1,G,A,57919591,81115,57641868,58035084,277723
18,ENSG00000261126.1,80046900,chr18-80143232-A-G,rs78532971,1,A,G,80143232,96332,79850292,80243508,292940
18,ENSG00000243779.1,13919923,chr18-13926265-A-G,rs9958978,-1,A,G,13926265,6342,13723315,14116531,202950
17,ENSG00000231784.4,752884,chr17-741746-A-C,rs1064245,1,A,C,741746,11138,556276,949492,185470
17,ENSG00000241525.2,414023,chr17-409857-G-A,rs11150882,-1,G,A,409857,4166,217415,610631,192442
17,ENSG00000259753.1,47253897,chr17-47119930-C-T,rs11570579,1,C,T,47119930,133967,47057289,47450505,62641
17,ENSG00000255987.1,35515186,chr17-35537613-A-G,rs11650473,-1,A,G,35537613,22427,35318578,35711794,219035
17,ENSG00000128438.4,16932505,chr17-16921595-C-T,rs11651352,-1,C,T,16921595,10910,16735897,17129113,185698
17,ENSG00000262165.1,4802335,chr17-4801383-G-A,rs11654690,-1,G,A,4801383,952,4605727,4998943,195656
17,ENSG00000262049.1,81703317,chr17-81681544-C-T,rs117352501,-1,C,T,81681544,21773,81506709,81899925,174835
17,ENSG00000257950.2,3696194,chr17-3672887-C-T,rs117868196,-1,C,T,3672887,23307,3499586,3892802,173301
17,ENSG00000263164.1,5241543,chr17-5242264-C-T,rs11867480,-1,C,T,5242264,721,5044935,5438151,197329
17,ENSG00000226359.1,17242010,chr17-17229634-G-A,rs11869283,1,G,A,17229634,12376,17045402,17438618,184232
17,ENSG00000262879.1,47100289,chr17-47105786-C-T,rs11871364,-1,C,T,47105786,5497,46903681,47296897,202105
17,ENSG00000175061.9,16439037,chr17-16439519-T-C,rs11871958,1,T,C,16439519,482,16242429,16635645,197090
17,ENSG00000239291.1,47159993,chr17-47336018-G-A,rs12051795,-1,G,A,47336018,176025,46963385,47356601,372633
17,ENSG00000263063.1,82716255,chr17-82713475-T-C,rs12943478,-1,T,C,82713475,2780,82519647,82912863,193828
17,ENSG00000226377.1,32876759,chr17-32964613-C-T,rs12944754,1,C,T,32964613,87854,32680151,33073367,284462
17,ENSG00000244604.1,8561230,chr17-8751557-T-A,rs13341834,1,T,A,8751557,190327,8364622,8757838,386935
17,ENSG00000262147.1,82588411,chr17-82586979-T-C,rs1387545,-1,T,C,82586979,1432,82391803,82785019,195176
17,ENSG00000253102.1,50396438,chr17-50556377-T-C,rs1460211,1,T,C,50556377,159939,50199830,50593046,356547
17,ENSG00000226521.2,20716483,chr17-20672384-T-C,rs16941336,1,T,C,20672384,44099,20519875,20913091,152509
17,ENSG00000256826.1,64491523,chr17-64553147-T-C,rs16947868,1,T,C,64553147,61624,64294915,64688131,258232
17,ENSG00000261959.1,50165316,chr17-49987777-G-A,rs16948563,-1,G,A,49987777,177539,49968708,50361924,19069
17,ENSG00000214174.4,64973517,chr17-64985215-A-T,rs17685439,-1,A,T,64985215,11698,64776909,65170125,208306
17,ENSG00000214174.4,64973517,chr17-64985215-A-C,rs17685439,-1,A,C,64985215,11698,64776909,65170125,208306
17,ENSG00000228157.1,19093192,chr17-18964756-A-G,rs17718627,1,A,G,18964756,128436,18896584,19289800,68172
17,ENSG00000262227.1,4987689,chr17-4818081-A-G,rs17854914,1,A,G,4818081,169608,4791081,5184297,27000
17,ENSG00000246731.2,74213321,chr17-74173820-C-T,rs1870995,-1,C,T,74173820,39501,74016713,74409929,157107
17,ENSG00000189343.6,19446852,chr17-19570207-A-G,rs1961669,-1,A,G,19570207,123355,19250244,19643460,319963
17,ENSG00000161939.11,7013733,chr17-6996757-G-A,rs2073438,1,G,A,6996757,16976,6817125,7210341,179632
17,ENSG00000262319.1,19143689,chr17-19014602-C-T,rs2074280,-1,C,T,19014602,129087,18947081,19340297,67521
17,ENSG00000243423.1,35076737,chr17-35003837-T-C,rs2074521,1,T,C,35003837,72900,34880129,35273345,123708
17,ENSG00000262967.1,50693448,chr17-50677641-G-A,rs2240802,1,G,A,50677641,15807,50496840,50890056,180801
17,ENSG00000262678.1,4986466,chr17-4937082-G-A,rs2243107,1,G,A,4937082,49384,4789858,5183074,147224
17,ENSG00000262678.1,4986466,chr17-4937082-G-C,rs2243107,1,G,C,4937082,49384,4789858,5183074,147224
17,ENSG00000228331.2,19496943,chr17-19570764-G-A,rs2253611,1,G,A,19570764,73821,19300335,19693551,270429
17,ENSG00000215067.4,7012334,chr17-7114635-G-A,rs2289646,-1,G,A,7114635,102301,6815726,7208942,298909
17,ENSG00000233175.1,45241734,chr17-45135596-G-T,rs2291447,-1,G,T,45135596,106138,45045126,45438342,90470
17,ENSG00000223878.1,15506866,chr17-15554994-C-T,rs236810,1,C,T,15554994,48128,15310258,15703474,244736
17,ENSG00000262089.1,6995189,chr17-7093498-A-G,rs2455548,-1,A,G,7093498,98309,6798581,7191797,294917
17,ENSG00000261879.1,5192007,chr17-5223379-A-G,rs2641256,1,A,G,5223379,31372,4995399,5388615,227980
17,ENSG00000197291.3,42761257,chr17-42742128-C-T,rs28733490,-1,C,T,42742128,19129,42564649,42957865,177479
17,ENSG00000239809.1,62381668,chr17-62278668-T-C,rs2873812,1,T,C,62278668,103000,62185060,62578276,93608
17,ENSG00000178977.3,8224043,chr17-8173337-C-T,rs3202848,-1,C,T,8173337,50706,8027435,8420651,145902
17,ENSG00000226137.3,81034573,chr17-81094956-G-A,rs34534119,-1,G,A,81094956,60383,80837965,81231181,256991
17,ENSG00000262663.1,82918282,chr17-82831592-G-A,rs35653278,1,G,A,82831592,86690,82721674,83114890,109918
17,ENSG00000227077.2,18572752,chr17-18650916-T-C,rs3752015,1,T,C,18650916,78164,18376144,18769360,274772
17,ENSG00000262292.1,19160789,chr17-19292118-G-A,rs3785784,1,G,A,19292118,131329,18964181,19357397,327937
17,ENSG00000197665.4,19158893,chr17-19287629-G-A,rs3785787,-1,G,A,19287629,128736,18962285,19355501,325344
17,ENSG00000214425.1,45550335,chr17-45641777-A-G,rs393152,-1,A,G,45641777,91442,45353727,45746943,288050
17,ENSG00000261915.1,7319174,chr17-7439363-C-T,rs4151122,-1,C,T,7439363,120189,7122566,7515782,316797
17,ENSG00000212719.4,21573394,chr17-21383493-G-A,rs4247138,-1,G,A,21383493,189901,21376786,21770002,6707
17,ENSG00000229980.4,50866754,chr17-50898871-A-C,rs4372735,1,A,C,50898871,32117,50670146,51063362,228725
17,ENSG00000163597.8,76557775,chr17-76559024-T-C,rs4647885,1,T,C,76559024,1249,76361167,76754383,197857
17,ENSG00000263321.1,82734143,chr17-82613184-A-G,rs4789704,-1,A,G,82613184,120959,82537535,82930751,75649
17,ENSG00000244184.1,4704230,chr17-4742769-A-G,rs4790224,1,A,G,4742769,38539,4507622,4900838,235147
17,ENSG00000261924.1,80971213,chr17-80993115-C-T,rs4969331,-1,C,T,80993115,21902,80774605,81167821,218510
17,ENSG00000236234.1,45452844,chr17-45467013-G-A,rs55663797,1,G,A,45467013,14169,45256236,45649452,210777
17,ENSG00000234327.2,5097223,chr17-5111073-T-A,rs55777955,1,T,A,5111073,13850,4900615,5293831,210458
17,ENSG00000259623.1,41851447,chr17-42037812-C-T,rs60110245,-1,C,T,42037812,186365,41654839,42048055,382973
17,ENSG00000262410.1,82745068,chr17-82822154-A-G,rs62073990,1,A,G,82822154,77086,82548460,82941676,273694
17,ENSG00000233327.4,18519674,chr17-18363725-G-T,rs643333,-1,G,T,18363725,155949,18323066,18716282,40659
17,ENSG00000188933.6,16796043,chr17-16797711-A-T,rs678522,1,A,T,16797711,1668,16599435,16992651,198276
17,ENSG00000236088.1,14069483,chr17-14033343-A-G,rs708586,-1,A,G,14033343,36140,13872875,14266091,160468
17,ENSG00000262580.1,80205071,chr17-80209612-T-C,rs709678,-1,T,C,80209612,4541,80008463,80401679,201149
17,ENSG00000262188.1,79919310,chr17-79933000-C-T,rs71387956,1,C,T,79933000,13690,79722702,80115918,210298
17,ENSG00000262585.1,79926725,chr17-79933000-C-T,rs71387956,-1,C,T,79933000,6275,79730117,80123333,202883
17,ENSG00000263004.1,57084998,chr17-57087275-G-T,rs721427,-1,G,T,57087275,2277,56888390,57281606,198885
17,ENSG00000239203.1,16427474,chr17-16412605-A-G,rs7217735,1,A,G,16412605,14869,16230866,16624082,181739
17,ENSG00000262456.1,2384847,chr17-2371043-C-T,rs725348,1,C,T,2371043,13804,2188239,2581455,182804
17,ENSG00000262050.1,2712012,chr17-2777428-G-A,rs72817351,1,G,A,2777428,65416,2515404,2908620,262024
17,ENSG00000237888.1,43476198,chr17-43657979-G-T,rs739770,1,G,T,43657979,181781,43279590,43672806,378389
17,ENSG00000214514.2,41634106,chr17-41630613-G-A,rs7405662,-1,G,A,41630613,3493,41437498,41830714,193115
17,ENSG00000263301.1,7443327,chr17-7300759-A-T,rs7502836,-1,A,T,7300759,142568,7246719,7639935,54040
17,ENSG00000240480.1,7754394,chr17-7819325-C-T,rs75106566,1,C,T,7819325,64931,7557786,7951002,261539
17,ENSG00000262135.1,55551649,chr17-55389703-G-A,rs75210391,-1,G,A,55389703,161946,55355041,55748257,34662
17,ENSG00000167920.4,40819101,chr17-40846965-A-G,rs757272,1,A,G,40846965,27864,40622493,41015709,224472
17,ENSG00000262979.1,80315651,chr17-80448547-C-T,rs78986329,1,C,T,80448547,132896,80119043,80512259,329504
17,ENSG00000262228.1,765319,chr17-601865-T-C,rs79657649,-1,T,C,601865,163454,568711,961927,33154
17,ENSG00000213939.4,4705217,chr17-4654565-C-T,rs79962533,-1,C,T,4654565,50652,4508609,4901825,145956
17,ENSG00000261335.1,76671942,chr17-76565240-T-C,rs8067372,1,T,C,76565240,106702,76475334,76868550,89906
17,ENSG00000233483.1,45251129,chr17-45200857-C-T,rs8069208,-1,C,T,45200857,50272,45054521,45447737,146336
17,ENSG00000263171.1,7354944,chr17-7342355-G-A,rs8069505,-1,G,A,7342355,12589,7158336,7551552,184019
17,ENSG00000262526.1,7244635,chr17-7312491-T-C,rs8075575,-1,T,C,7312491,67856,7048027,7441243,264464
17,ENSG00000141028.4,14024514,chr17-13999570-T-C,rs8079249,1,T,C,13999570,24944,13827906,14221122,171664
17,ENSG00000243686.1,16044621,chr17-15897100-C-G,rs859234,1,C,G,15897100,147521,15848013,16241229,49087
17,ENSG00000227018.1,15783288,chr17-15897249-A-G,rs859235,1,A,G,15897249,113961,15586680,15979896,310569
17,ENSG00000214708.3,32143135,chr17-32256998-T-C,rs894723,-1,T,C,32256998,113863,31946527,32339743,310471
17,ENSG00000261192.1,57045521,chr17-57221998-A-G,rs9890106,1,A,G,57221998,176477,56848913,57242129,373085
17,ENSG00000227036.1,72592804,chr17-72608322-G-C,rs9891641,-1,G,C,72608322,15518,72396196,72789412,212126
17,ENSG00000205212.3,20896020,chr17-20756319-G-A,rs9899697,-1,G,A,20756319,139701,20699412,21092628,56907
17,ENSG00000214176.4,64829208,chr17-64792901-T-C,rs9901569,-1,T,C,64792901,36307,64632600,65025816,160301
17,ENSG00000262333.1,2306761,chr17-2309336-A-C,rs9910614,1,A,C,2309336,2575,2110153,2503369,199183
17,ENSG00000255987.1,35515186,chr17-35500057-C-T,rs10512471,-1,C,T,35500057,15129,35318578,35711794,181479
17,ENSG00000197291.3,42761257,chr17-42760742-A-G,rs1078523,-1,A,G,42760742,515,42564649,42957865,196093
17,ENSG00000197291.3,42761257,chr17-42760742-A-C,rs1078523,-1,A,C,42760742,515,42564649,42957865,196093
17,ENSG00000229848.1,81514047,chr17-81458645-A-G,rs111269853,1,A,G,81458645,55402,81317439,81710655,141206
17,ENSG00000230865.1,17456427,chr17-17399336-G-C,rs112667951,1,G,C,17399336,57091,17259819,17653035,139517
17,ENSG00000214174.4,64973517,chr17-65049958-T-C,rs11656396,-1,T,C,65049958,76441,64776909,65170125,273049
17,ENSG00000236088.1,14069483,chr17-14074145-G-A,rs11870213,-1,G,A,14074145,4662,13872875,14266091,201270
17,ENSG00000175061.9,16439037,chr17-16495241-C-A,rs11871620,1,C,A,16495241,56204,16242429,16635645,252812
17,ENSG00000263164.1,5241543,chr17-5216725-A-G,rs12051735,-1,A,G,5216725,24818,5044935,5438151,171790
17,ENSG00000228118.2,71620978,chr17-71678436-T-C,rs12449963,1,T,C,71678436,57458,71424370,71817586,254066
17,ENSG00000178977.3,8224043,chr17-8340467-A-G,rs12936935,-1,A,G,8340467,116424,8027435,8420651,313032
17,ENSG00000262580.1,80205071,chr17-80193856-G-A,rs12938321,-1,G,A,80193856,11215,80008463,80401679,185393
17,ENSG00000262147.1,82588411,chr17-82604344-C-T,rs12939611,-1,C,T,82604344,15933,82391803,82785019,212541
17,ENSG00000141028.4,14024514,chr17-14003993-G-A,rs12946964,1,G,A,14003993,20521,13827906,14221122,176087
17,ENSG00000262456.1,2384847,chr17-2392111-C-T,rs1545717,1,C,T,2392111,7264,2188239,2581455,203872
17,ENSG00000108958.4,1858446,chr17-1720381-A-G,rs1574525,-1,A,G,1720381,138065,1661838,2055054,58543
17,ENSG00000239291.1,47159993,chr17-46966142-T-C,rs16941382,-1,T,C,46966142,193851,46963385,47356601,2757
17,ENSG00000263050.1,2044968,chr17-2014529-A-G,rs16951823,-1,A,G,2014529,30439,1848360,2241576,166169
17,ENSG00000204650.6,45633049,chr17-45816121-G-A,rs171440,1,G,A,45816121,183072,45436441,45829657,379680
17,ENSG00000235183.3,49795343,chr17-49737217-C-T,rs17713394,1,C,T,49737217,58126,49598735,49991951,138482
17,ENSG00000239809.1,62381668,chr17-62396959-T-C,rs1809081,1,T,C,62396959,15291,62185060,62578276,211899
17,ENSG00000262678.1,4986466,chr17-4979657-G-A,rs1859434,1,G,A,4979657,6809,4789858,5183074,189799
17,ENSG00000197665.4,19158893,chr17-19014602-C-T,rs2074280,-1,C,T,19014602,144291,18962285,19355501,52317
17,ENSG00000231784.4,752884,chr17-753640-G-A,rs2251689,1,G,A,753640,756,556276,949492,197364
17,ENSG00000260105.1,42867279,chr17-42710629-G-T,rs2355374,1,G,T,42710629,156650,42670671,43063887,39958
17,ENSG00000226359.1,17242010,chr17-17348161-T-G,rs242244,1,T,G,17348161,106151,17045402,17438618,302759
17,ENSG00000226478.2,16746761,chr17-16603247-A-G,rs2970062,-1,A,G,16603247,143514,16550153,16943369,53094
17,ENSG00000167920.4,40819101,chr17-40876143-C-T,rs3169914,1,C,T,40876143,57042,40622493,41015709,253650
17,ENSG00000263063.1,82716255,chr17-82773222-G-A,rs36087138,-1,G,A,82773222,56967,82519647,82912863,253575
17,ENSG00000261924.1,80971213,chr17-80964698-C-T,rs3751934,-1,C,T,80964698,6515,80774605,81167821,190093
17,ENSG00000261924.1,80971213,chr17-80964698-C-A,rs3751934,-1,C,A,80964698,6515,80774605,81167821,190093
17,ENSG00000262319.1,19143689,chr17-19287629-G-A,rs3785787,-1,G,A,19287629,143940,18947081,19340297,340548
17,ENSG00000204584.1,49845910,chr17-49893999-G-C,rs399344,1,G,C,49893999,48089,49649302,50042518,244697
17,ENSG00000204584.1,49845910,chr17-49893999-G-T,rs399344,1,G,T,49893999,48089,49649302,50042518,244697
17,ENSG00000228979.2,63471604,chr17-63480462-G-A,rs4303,1,G,A,63480462,8858,63274996,63668212,205466
17,ENSG00000228979.2,63471604,chr17-63480462-G-T,rs4303,1,G,T,63480462,8858,63274996,63668212,205466
17,ENSG00000262526.1,7244635,chr17-7341158-A-G,rs4465647,-1,A,G,7341158,96523,7048027,7441243,293131
17,ENSG00000263171.1,7354944,chr17-7341158-A-G,rs4465647,-1,A,G,7341158,13786,7158336,7551552,182822
17,ENSG00000230897.1,14705534,chr17-14561983-G-A,rs4614771,-1,G,A,14561983,143551,14508926,14902142,53057
17,ENSG00000263219.1,4222091,chr17-4064770-A-C,rs4790555,1,A,C,4064770,157321,4025483,4418699,39287
17,ENSG00000128438.4,16932505,chr17-16942153-T-C,rs4792801,-1,T,C,16942153,9648,16735897,17129113,206256
17,ENSG00000187504.6,51503233,chr17-51321843-G-A,rs4794227,-1,G,A,51321843,181390,51306625,51699841,15218
17,ENSG00000244097.1,657547,chr17-603798-G-A,rs4968093,-1,G,A,603798,53749,460939,854155,142859
17,ENSG00000230969.2,16988329,chr17-16989020-C-T,rs57096150,1,C,T,16989020,691,16791721,17184937,197299
17,ENSG00000154874.9,18625447,chr17-18710696-C-T,rs59559052,-1,C,T,18710696,85249,18428839,18822055,281857
17,ENSG00000236618.2,1516877,chr17-1504582-C-T,rs7208369,1,C,T,1504582,12295,1320269,1713485,184313
17,ENSG00000263301.1,7443327,chr17-7492230-A-G,rs7217258,-1,A,G,7492230,48903,7246719,7639935,245511
17,ENSG00000214514.2,41634106,chr17-41676424-G-A,rs7219249,-1,G,A,41676424,42318,41437498,41830714,238926
17,ENSG00000244184.1,4704230,chr17-4838423-A-G,rs7225684,1,A,G,4838423,134193,4507622,4900838,330801
17,ENSG00000263321.1,82734143,chr17-82779675-T-C,rs72854352,-1,T,C,82779675,45532,82537535,82930751,242140
17,ENSG00000223979.2,17677688,chr17-17634544-G-A,rs75593451,-1,G,A,17634544,43144,17481080,17874296,153464
17,ENSG00000215769.3,64781626,chr17-64591124-G-A,rs75656954,-1,G,A,64591124,190502,64585018,64978234,6106
17,ENSG00000229944.2,49424922,chr17-49469402-G-A,rs76774894,-1,G,A,49469402,44480,49228314,49621530,241088
17,ENSG00000261879.1,5192007,chr17-5281172-T-G,rs77318561,1,T,G,5281172,89165,4995399,5388615,285773
17,ENSG00000253102.1,50396438,chr17-50535072-A-G,rs79723678,1,A,G,50535072,138634,50199830,50593046,335242
17,ENSG00000262967.1,50693448,chr17-50743979-G-A,rs79777439,1,G,A,50743979,50531,50496840,50890056,247139
17,ENSG00000261872.1,47169826,chr17-47061663-C-T,rs8064557,1,C,T,47061663,108163,46973218,47366434,88445
17,ENSG00000263004.1,57084998,chr17-57110686-A-C,rs8068737,-1,A,C,57110686,25688,56888390,57281606,222296
17,ENSG00000263089.1,57096425,chr17-57039914-A-T,rs8076541,-1,A,T,57039914,56511,56899817,57293033,140097
17,ENSG00000227018.1,15783288,chr17-15922707-A-C,rs859267,1,A,C,15922707,139419,15586680,15979896,336027
17,ENSG00000262953.1,2587866,chr17-2525214-C-T,rs9891572,-1,C,T,2525214,62652,2391258,2784474,133956
17,ENSG00000232724.1,75074306,chr17-75095226-C-T,rs9904626,1,C,T,75095226,20920,74877698,75270914,217528
17,ENSG00000214176.4,64829208,chr17-64758468-T-C,rs9908143,-1,T,C,64758468,70740,64632600,65025816,125868
17,ENSG00000262879.1,47100289,chr17-47075548-C-A,rs9908463,-1,C,A,47075548,24741,46903681,47296897,171867
17,ENSG00000262333.1,2306761,chr17-2350843-T-C,rs9915206,1,T,C,2350843,44082,2110153,2503369,240690
17,ENSG00000260647.1,18268080,chr17-18153901-C-T,rs9916193,1,C,T,18153901,114179,18071472,18464688,82429
17,ENSG00000260647.1,18268080,chr17-18153901-C-G,rs9916193,1,C,G,18153901,114179,18071472,18464688,82429
17,ENSG00000263004.1,57084998,chr17-57125954-C-T,rs1007462,-1,C,T,57125954,40956,56888390,57281606,237564
17,ENSG00000236618.2,1516877,chr17-1378570-A-G,rs10521111,1,A,G,1378570,138307,1320269,1713485,58301
17,ENSG00000236618.2,1516877,chr17-1378570-A-C,rs10521111,1,A,C,1378570,138307,1320269,1713485,58301
17,ENSG00000141028.4,14024514,chr17-14074847-A-G,rs10521253,1,A,G,14074847,50333,13827906,14221122,246941
17,ENSG00000205212.3,20896020,chr17-21038822-A-G,rs113799755,-1,A,G,21038822,142802,20699412,21092628,339410
17,ENSG00000262967.1,50693448,chr17-50676615-G-T,rs11568595,1,G,T,50676615,16833,50496840,50890056,179775
17,ENSG00000262967.1,50693448,chr17-50676615-G-A,rs11568595,1,G,A,50676615,16833,50496840,50890056,179775
17,ENSG00000262879.1,47100289,chr17-47181970-C-T,rs11570460,-1,C,T,47181970,81681,46903681,47296897,278289
17,ENSG00000220161.2,18411159,chr17-18229963-A-G,rs115967277,1,A,G,18229963,181196,18214551,18607767,15412
17,ENSG00000234203.1,4972851,chr17-4841388-A-G,rs11656534,1,A,G,4841388,131463,4776243,5169459,65145
17,ENSG00000204584.1,49845910,chr17-49883443-G-A,rs11657553,1,G,A,49883443,37533,49649302,50042518,234141
17,ENSG00000262333.1,2306761,chr17-2240911-G-A,rs118075173,1,G,A,2240911,65850,2110153,2503369,130758
17,ENSG00000188755.4,62274115,chr17-62178221-A-G,rs12943404,-1,A,G,62178221,95894,62077507,62470723,100714
17,ENSG00000226521.2,20716483,chr17-20717060-C-T,rs12945283,1,C,T,20717060,577,20519875,20913091,197185
17,ENSG00000246731.2,74213321,chr17-74274690-G-A,rs12946901,-1,G,A,74274690,61369,74016713,74409929,257977
17,ENSG00000223878.1,15506866,chr17-15432262-C-T,rs12947999,1,C,T,15432262,74604,15310258,15703474,122004
17,ENSG00000248714.2,49361189,chr17-49197998-G-A,rs12948798,1,G,A,49197998,163191,49164581,49557797,33417
17,ENSG00000230148.4,48544351,chr17-48607567-A-G,rs15689,1,A,G,48607567,63216,48347743,48740959,259824
17,ENSG00000189423.5,20424589,chr17-20389082-A-G,rs16941857,1,A,G,20389082,35507,20227981,20621197,161101
17,ENSG00000244649.1,48646929,chr17-48643388-A-G,rs16942810,1,A,G,48643388,3541,48450321,48843537,193067
17,ENSG00000231458.1,16683438,chr17-16568376-G-A,rs16959834,1,G,A,16568376,115062,16486830,16880046,81546
17,ENSG00000262304.1,3636249,chr17-3601939-C-T,rs17707155,-1,C,T,3601939,34310,3439641,3832857,162298
17,ENSG00000215067.4,7012334,chr17-6844435-A-G,rs17732046,-1,A,G,6844435,167899,6815726,7208942,28709
17,ENSG00000262292.1,19160789,chr17-19014602-C-T,rs2074280,1,C,T,19014602,146187,18964181,19357397,50421
17,ENSG00000233175.1,45241734,chr17-45120226-G-A,rs2129732,-1,G,A,45120226,121508,45045126,45438342,75100
17,ENSG00000263063.1,82716255,chr17-82723196-T-C,rs2246563,-1,T,C,82723196,6941,82519647,82912863,203549
17,ENSG00000263050.1,2044968,chr17-1880518-T-C,rs2277694,-1,T,C,1880518,164450,1848360,2241576,32158
17,ENSG00000262456.1,2384847,chr17-2369877-G-A,rs2429913,1,G,A,2369877,14970,2188239,2581455,181638
17,ENSG00000226377.1,32876759,chr17-32946860-T-C,rs2521984,1,T,C,32946860,70101,32680151,33073367,266709
17,ENSG00000263164.1,5241543,chr17-5235218-A-C,rs2585284,-1,A,C,5235218,6325,5044935,5438151,190283
17,ENSG00000240270.1,80976454,chr17-80836887-T-G,rs2589143,1,T,G,80836887,139567,80779846,81173062,57041
17,ENSG00000231784.4,752884,chr17-764137-G-A,rs2740345,1,G,A,764137,11253,556276,949492,207861
17,ENSG00000236088.1,14069483,chr17-14144300-G-A,rs28634134,-1,G,A,14144300,74817,13872875,14266091,271425
17,ENSG00000262663.1,82918282,chr17-82928652-C-T,rs3785512,1,C,T,82928652,10370,82721674,83114890,206978
17,ENSG00000239552.2,48557262,chr17-48704615-G-A,rs3809774,1,G,A,48704615,147353,48360654,48753870,343961
17,ENSG00000234912.3,77086716,chr17-76916278-G-A,rs4789374,1,G,A,76916278,170438,76890108,77283324,26170
17,ENSG00000262165.1,4802335,chr17-4759064-C-T,rs4790700,-1,C,T,4759064,43271,4605727,4998943,153337
17,ENSG00000242067.1,48691694,chr17-48714439-A-C,rs4793601,-1,A,C,48714439,22745,48495086,48888302,219353
17,ENSG00000236319.2,55561577,chr17-55410675-C-T,rs4794583,-1,C,T,55410675,150902,55364969,55758185,45706
17,ENSG00000214708.3,32143135,chr17-32242917-G-A,rs4795682,-1,G,A,32242917,99782,31946527,32339743,296390
17,ENSG00000262188.1,79919310,chr17-79930670-C-T,rs4889802,1,C,T,79930670,11360,79722702,80115918,207968
17,ENSG00000198496.5,43125551,chr17-43093454-C-T,rs4986850,1,C,T,43093454,32097,42928943,43322159,164511
17,ENSG00000175061.9,16439037,chr17-16467459-A-G,rs597985,1,A,G,16467459,28422,16242429,16635645,225030
17,ENSG00000262519.1,4572206,chr17-4519248-C-T,rs60158517,1,C,T,4519248,52958,4375598,4768814,143650
17,ENSG00000234327.2,5097223,chr17-5247358-G-A,rs6502851,1,G,A,5247358,150135,4900615,5293831,346743
17,ENSG00000261996.1,6655009,chr17-6635664-C-A,rs7209944,-1,C,A,6635664,19345,6458401,6851617,177263
17,ENSG00000226981.1,20814620,chr17-20833942-G-A,rs7212948,1,G,A,20833942,19322,20618012,21011228,215930
17,ENSG00000263171.1,7354944,chr17-7539195-T-C,rs7217605,-1,T,C,7539195,184251,7158336,7551552,380859
17,ENSG00000214425.1,45550335,chr17-45475784-T-C,rs7218394,-1,T,C,45475784,74551,45353727,45746943,122057
17,ENSG00000226359.1,17242010,chr17-17353060-G-A,rs72826244,1,G,A,17353060,111050,17045402,17438618,307658
17,ENSG00000260563.1,82293716,chr17-82301780-T-C,rs73368110,1,T,C,82301780,8064,82097108,82490324,204672
17,ENSG00000240494.1,28655557,chr17-28705349-C-T,rs74866084,1,C,T,28705349,49792,28458949,28852165,246400
17,ENSG00000234899.2,72120805,chr17-72177274-G-C,rs75237020,-1,G,C,72177274,56469,71924197,72317413,253077
17,ENSG00000240125.1,40439917,chr17-40527393-T-C,rs75253899,-1,T,C,40527393,87476,40243309,40636525,284084
17,ENSG00000262943.1,6893782,chr17-6829341-G-A,rs76018634,1,G,A,6829341,64441,6697174,7090390,132167
17,ENSG00000235672.1,18908279,chr17-18993817-T-G,rs77721749,1,T,G,18993817,85538,18711671,19104887,282146
17,ENSG00000241525.2,414023,chr17-415725-C-T,rs8064453,-1,C,T,415725,1702,217415,610631,198310
17,ENSG00000237854.1,68101908,chr17-68165589-A-G,rs8069646,1,A,G,68165589,63681,67905300,68298516,260289
17,ENSG00000163597.8,76557775,chr17-76579532-G-A,rs8070864,1,G,A,76579532,21757,76361167,76754383,218365
17,ENSG00000262526.1,7244635,chr17-7407503-T-C,rs8075459,-1,T,C,7407503,162868,7048027,7441243,359476
17,ENSG00000262580.1,80205071,chr17-80207628-C-T,rs8078181,-1,C,T,80207628,2557,80008463,80401679,199165
17,ENSG00000226049.3,34039872,chr17-34005811-A-G,rs8081899,-1,A,G,34005811,34061,33843264,34236480,162547
17,ENSG00000244184.1,4704230,chr17-4691670-C-T,rs906453,1,C,T,4691670,12560,4507622,4900838,184048
17,ENSG00000240480.1,7754394,chr17-7889008-C-T,rs931543,1,C,T,7889008,134614,7557786,7951002,331222
17,ENSG00000240480.1,7754394,chr17-7889008-C-A,rs931543,1,C,A,7889008,134614,7557786,7951002,331222
17,ENSG00000262777.1,1424473,chr17-1497598-G-A,rs939562,1,G,A,1497598,73125,1227865,1621081,269733
17,ENSG00000253102.1,50396438,chr17-50485928-G-A,rs9775,1,G,A,50485928,89490,50199830,50593046,286098
17,ENSG00000250186.3,49404081,chr17-49253110-G-T,rs9901674,1,G,T,49253110,150971,49207473,49600689,45637
17,ENSG00000227077.2,18572752,chr17-18734838-A-G,rs9916065,1,A,G,18734838,162086,18376144,18769360,358694
16,ENSG00000261288.1,2554975,chr16-2595964-G-A,rs1005273,1,G,A,2595964,40989,2358367,2751583,237597
16,ENSG00000260176.1,2645214,chr16-2595964-G-A,rs1005273,-1,G,A,2595964,49250,2448606,2841822,147358
16,ENSG00000261613.1,2556060,chr16-2595964-G-A,rs1005273,-1,G,A,2595964,39904,2359452,2752668,236512
16,ENSG00000260034.1,25149032,chr16-25138405-A-G,rs11074678,-1,A,G,25138405,10627,24952424,25345640,185981
16,ENSG00000260379.1,8508069,chr16-8509499-C-T,rs11077313,1,C,T,8509499,1430,8311461,8704677,198038
16,ENSG00000260755.1,66509437,chr16-66552286-C-G,rs1108281,1,C,G,66552286,42849,66312829,66706045,239457
16,ENSG00000261602.1,69709874,chr16-69726438-A-G,rs114238154,1,A,G,69726438,16564,69513266,69906482,213172
16,ENSG00000260668.1,64261239,chr16-64366849-A-C,rs11639835,-1,A,C,64366849,105610,64064631,64457847,302218
16,ENSG00000262703.1,11349321,chr16-11268872-G-A,rs11640138,-1,G,A,11268872,80449,11152713,11545929,116159
16,ENSG00000245694.4,54928843,chr16-54926407-C-T,rs11643696,-1,C,T,54926407,2436,54732235,55125451,194172
16,ENSG00000262700.1,25093387,chr16-25116324-A-G,rs11645986,1,A,G,25116324,22937,24896779,25289995,219545
16,ENSG00000260367.1,28978824,chr16-29144159-G-A,rs11646140,-1,G,A,29144159,165335,28782216,29175432,361943
16,ENSG00000261226.1,88939651,chr16-89080115-T-C,rs11647013,-1,T,C,89080115,140464,88743043,89136259,337072
16,ENSG00000260448.1,25111539,chr16-25105409-G-A,rs11649167,-1,G,A,25105409,6130,24914931,25308147,190478
16,ENSG00000228071.4,17932720,chr16-18051908-G-A,rs11649237,1,G,A,18051908,119188,17736112,18129328,315796
16,ENSG00000248124.3,21820384,chr16-21777587-G-A,rs116552188,-1,G,A,21777587,42797,21623776,22016992,153811
16,ENSG00000261079.1,74367462,chr16-74217183-G-A,rs117041818,1,G,A,74217183,150279,74170854,74564070,46329
16,ENSG00000261659.2,689494,chr16-770938-G-A,rs117105357,1,G,A,770938,81444,492886,886102,278052
16,ENSG00000260259.1,89686569,chr16-89668663-C-T,rs117418297,-1,C,T,89668663,17906,89489961,89883177,178702
16,ENSG00000260259.1,89686569,chr16-89668663-C-G,rs117418297,-1,C,G,89668663,17906,89489961,89883177,178702
16,ENSG00000205018.2,88939789,chr16-88950086-A-C,rs12102677,1,A,C,88950086,10297,88743181,89136397,206905
16,ENSG00000261732.1,1632259,chr16-1644150-G-A,rs12444617,1,G,A,1644150,11891,1435651,1828867,208499
16,ENSG00000260886.1,71565789,chr16-71681228-G-A,rs12447672,1,G,A,71681228,115439,71369181,71762397,312047
16,ENSG00000261519.1,66549280,chr16-66598482-T-C,rs12448207,1,T,C,66598482,49202,66352672,66745888,245810
16,ENSG00000260934.1,19501689,chr16-19500944-C-T,rs12708624,1,C,T,19500944,745,19305081,19698297,195863
16,ENSG00000261691.1,553847,chr16-486686-C-T,rs12921002,-1,C,T,486686,67161,357239,750455,129447
16,ENSG00000260853.1,28966436,chr16-28835925-T-C,rs12928404,-1,T,C,28835925,130511,28769828,29163044,66097
16,ENSG00000260267.1,31459736,chr16-31440005-C-T,rs13333031,-1,C,T,31440005,19731,31263128,31656344,176877
16,ENSG00000260281.1,47144323,chr16-47171849-T-C,rs1420563,1,T,C,47171849,27526,46947715,47340931,224134
16,ENSG00000263335.1,15726674,chr16-15727006-C-T,rs16967494,1,C,T,15727006,332,15530066,15923282,196940
16,ENSG00000172460.10,2842710,chr16-2868291-A-G,rs17660212,-1,A,G,2868291,25581,2646102,3039318,222189
16,ENSG00000261741.1,31564783,chr16-31710964-G-C,rs17839518,-1,G,C,31710964,146181,31368175,31761391,342789
16,ENSG00000261741.1,31564783,chr16-31710964-G-A,rs17839518,-1,G,A,31710964,146181,31368175,31761391,342789
16,ENSG00000235560.3,30534752,chr16-30528714-A-G,rs17839547,1,A,G,30528714,6038,30338144,30731360,190570
16,ENSG00000261840.1,30699058,chr16-30528714-A-G,rs17839547,-1,A,G,30528714,170344,30502450,30895666,26264
16,ENSG00000260335.1,29449191,chr16-29642431-G-A,rs17842265,1,G,A,29642431,193240,29252583,29645799,389848
16,ENSG00000263232.1,72006543,chr16-72005706-G-T,rs1820248,-1,G,T,72005706,837,71809935,72203151,195771
16,ENSG00000227624.2,20239247,chr16-20072371-C-G,rs1886712,-1,C,G,20072371,166876,20042639,20435855,29732
16,ENSG00000261471.1,84594393,chr16-84597662-T-C,rs2018540,1,T,C,84597662,3269,84397785,84791001,199877
16,ENSG00000261017.1,48059995,chr16-48096923-C-T,rs2019240,-1,C,T,48096923,36928,47863387,48256603,233536
16,ENSG00000260306.1,21795759,chr16-21719128-C-T,rs215901,-1,C,T,21719128,76631,21599151,21992367,119977
16,ENSG00000261889.1,3157483,chr16-3115682-C-T,rs2280951,-1,C,T,3115682,41801,2960875,3354091,154807
16,ENSG00000246898.1,66408516,chr16-66408503-C-T,rs2289149,1,C,T,66408503,13,66211908,66605124,196595
16,ENSG00000261759.1,19121629,chr16-19212648-G-A,rs229021,-1,G,A,19212648,91019,18925021,19318237,287627
16,ENSG00000261532.1,2211997,chr16-2210566-C-T,rs26857,1,C,T,2210566,1431,2015389,2408605,195177
16,ENSG00000261474.1,31453493,chr16-31457117-A-C,rs28533031,-1,A,C,31457117,3624,31256885,31650101,200232
16,ENSG00000227827.3,16356224,chr16-16259309-T-C,rs2856553,1,T,C,16259309,96915,16159616,16552832,99693
16,ENSG00000259780.1,2236913,chr16-2226088-G-A,rs3096278,-1,G,A,2226088,10825,2040305,2433521,185783
16,ENSG00000246777.1,66751752,chr16-66604342-G-A,rs35320143,1,G,A,66604342,147410,66555144,66948360,49198
16,ENSG00000215003.4,15932294,chr16-16047709-C-G,rs35590,-1,C,G,16047709,115415,15735686,16128902,312023
16,ENSG00000251417.1,28802743,chr16-28933379-G-A,rs35979293,1,G,A,28933379,130636,28606135,28999351,327244
16,ENSG00000251417.1,28802743,chr16-28933379-G-T,rs35979293,1,G,T,28933379,130636,28606135,28999351,327244
16,ENSG00000246465.1,28292064,chr16-28289127-T-C,rs36019610,-1,T,C,28289127,2937,28095456,28488672,193671
16,ENSG00000258354.1,14911345,chr16-14889311-C-G,rs3743531,-1,C,G,14889311,22034,14714737,15107953,174574
16,ENSG00000260304.1,31183285,chr16-31261808-T-C,rs3764327,-1,T,C,31261808,78523,30986677,31379893,275131
16,ENSG00000262528.1,656194,chr16-790597-C-T,rs3765265,-1,C,T,790597,134403,459586,852802,331011
16,ENSG00000262151.1,10888752,chr16-10930011-A-C,rs4072864,-1,A,C,10930011,41259,10692144,11085360,237867
16,ENSG00000260874.1,2459966,chr16-2404509-A-G,rs4129919,-1,A,G,2404509,55457,2263358,2656574,141151
16,ENSG00000262370.1,3087112,chr16-2973007-G-A,rs4149804,-1,G,A,2973007,114105,2890504,3283720,82503
16,ENSG00000260431.1,5207088,chr16-5354049-T-C,rs4238858,1,T,C,5354049,146961,5010480,5403696,343569
16,ENSG00000260630.1,88663298,chr16-88667860-A-G,rs4420519,1,A,G,88667860,4562,88466690,88859906,201170
16,ENSG00000262636.1,11381118,chr16-11495905-A-C,rs4520857,-1,A,C,11495905,114787,11184510,11577726,311395
16,ENSG00000259006.1,89922662,chr16-89936359-A-G,rs4558416,-1,A,G,89936359,13697,89726054,90119270,210305
16,ENSG00000131797.8,31703168,chr16-31695936-C-T,rs4632148,1,C,T,31695936,7232,31506560,31899776,189376
16,ENSG00000180747.11,21501886,chr16-21601241-G-A,rs474843,-1,G,A,21601241,99355,21305278,21698494,295963
16,ENSG00000263072.1,3143734,chr16-3133408-G-A,rs4785929,-1,G,A,3133408,10326,2947126,3340342,186282
16,ENSG00000261063.1,77249957,chr16-77210940-T-C,rs4887896,-1,T,C,77210940,39017,77053349,77446565,157591
16,ENSG00000260482.1,23670011,chr16-23476710-A-G,rs4968006,1,A,G,23476710,193301,23473403,23866619,3307
16,ENSG00000259881.1,88883272,chr16-88912442-C-T,rs555191,1,C,T,88912442,29170,88686664,89079880,225778
16,ENSG00000260908.1,29107445,chr16-29028339-G-T,rs55732292,-1,G,T,29028339,79106,28910837,29304053,117502
16,ENSG00000263280.1,2868251,chr16-2866701-T-C,rs56014472,-1,T,C,2866701,1550,2671643,3064859,195058
16,ENSG00000260177.1,87806476,chr16-87847868-G-A,rs56225907,-1,G,A,87847868,41392,87609868,88003084,238000
16,ENSG00000250616.2,30096430,chr16-30018771-G-A,rs56329348,1,G,A,30018771,77659,29899822,30293038,118949
16,ENSG00000263235.1,3651703,chr16-3722905-T-C,rs59541166,-1,T,C,3722905,71202,3455095,3848311,267810
16,ENSG00000214331.4,74360859,chr16-74277555-G-A,rs59681627,-1,G,A,74277555,83304,74164251,74557467,113304
16,ENSG00000233232.2,28472336,chr16-28498188-G-A,rs61738759,-1,G,A,28498188,25852,28275728,28668944,222460
16,ENSG00000260121.1,88718615,chr16-88780144-C-T,rs62048221,1,C,T,88780144,61529,88522007,88915223,258137
16,ENSG00000260290.1,69757937,chr16-69768769-C-T,rs6499253,-1,C,T,69768769,10832,69561329,69954545,207440
16,ENSG00000260682.1,81961926,chr16-81836959-C-T,rs6564924,1,C,T,81836959,124967,81765318,82158534,71641
16,ENSG00000261286.1,84467361,chr16-84464318-C-G,rs707225,-1,C,G,84464318,3043,84270753,84663969,193565
16,ENSG00000261140.1,2571936,chr16-2598650-G-T,rs71386677,-1,G,T,2598650,26714,2375328,2768544,223322
16,ENSG00000261707.1,77743000,chr16-77718311-C-A,rs7184635,-1,C,A,77718311,24689,77546392,77939608,171919
16,ENSG00000257381.1,16300159,chr16-16200608-T-C,rs7184653,1,T,C,16200608,99551,16103551,16496767,97057
16,ENSG00000226180.2,87696147,chr16-87716353-C-T,rs7189011,-1,C,T,87716353,20206,87499539,87892755,216814
16,ENSG00000262468.1,4253789,chr16-4248364-G-A,rs7190602,-1,G,A,4248364,5425,4057181,4450397,191183
16,ENSG00000261777.1,70346806,chr16-70291415-G-A,rs7198871,-1,G,A,70291415,55391,70150198,70543414,141217
16,ENSG00000262714.1,53386944,chr16-53328874-C-T,rs7203056,1,C,T,53328874,58070,53190336,53583552,138538
16,ENSG00000261790.1,1990477,chr16-2005819-G-A,rs72766639,-1,G,A,2005819,15342,1793869,2187085,211950
16,ENSG00000261158.1,12759282,chr16-12832453-T-C,rs72780926,1,T,C,12832453,73171,12562674,12955890,269779
16,ENSG00000259982.1,28701540,chr16-28821061-C-T,rs72793809,-1,C,T,28821061,119521,28504932,28898148,316129
16,ENSG00000240634.1,28814673,chr16-28978312-T-C,rs72795903,-1,T,C,28978312,163639,28618065,29011281,360247
16,ENSG00000214725.3,29864308,chr16-29863920-A-G,rs747973,1,A,G,29863920,388,29667700,30060916,196220
16,ENSG00000262587.1,25031881,chr16-25032248-A-G,rs7498149,1,A,G,25032248,367,24835273,25228489,196975
16,ENSG00000262155.1,25067079,chr16-25032248-A-G,rs7498149,1,A,G,25032248,34831,24870471,25263687,161777
16,ENSG00000261359.2,31201885,chr16-31082768-T-C,rs750953,1,T,C,31082768,119117,31005277,31398493,77491
16,ENSG00000238045.4,29820366,chr16-29887802-G-T,rs75331747,-1,G,T,29887802,67436,29623758,30016974,264044
16,ENSG00000260914.1,69299682,chr16-69351738-A-G,rs76116020,1,A,G,69351738,52056,69103074,69496290,248664
16,ENSG00000261971.1,3059363,chr16-3065324-G-C,rs76580947,-1,G,C,3065324,5961,2862755,3255971,202569
16,ENSG00000241932.1,12881170,chr16-12916351-C-T,rs76629959,1,C,T,12916351,35181,12684562,13077778,231789
16,ENSG00000262118.1,3369246,chr16-3484028-G-A,rs77534894,-1,G,A,3484028,114782,3172638,3565854,311390
16,ENSG00000258130.3,30205090,chr16-30179570-G-A,rs79623117,-1,G,A,30179570,25520,30008482,30401698,171088
16,ENSG00000260643.1,81096296,chr16-81089256-C-T,rs8043855,-1,C,T,81089256,7040,80899688,81292904,189568
16,ENSG00000196796.4,29038655,chr16-28963337-A-G,rs8044999,1,A,G,28963337,75318,28842047,29235263,121290
16,ENSG00000259945.1,67542963,chr16-67735190-A-G,rs8046195,-1,A,G,67735190,192227,67346355,67739571,388835
16,ENSG00000260083.1,30875222,chr16-30697737-T-C,rs8046436,1,T,C,30697737,177485,30678614,31071830,19123
16,ENSG00000261448.1,17134504,chr16-17059229-C-T,rs8049145,1,C,T,17059229,75275,16937896,17331112,121333
16,ENSG00000261546.1,89115279,chr16-89116518-A-G,rs8052780,-1,A,G,89116518,1239,88918671,89311887,197847
16,ENSG00000260051.1,1451760,chr16-1382257-A-G,rs8054315,1,A,G,1382257,69503,1255152,1648368,127105
16,ENSG00000255198.2,1964895,chr16-1971104-T-C,rs8055439,1,T,C,1971104,6209,1768287,2161503,202817
16,ENSG00000261416.1,30184563,chr16-30002136-G-A,rs8058765,-1,G,A,30002136,182427,29987955,30381171,14181
16,ENSG00000222019.2,90047597,chr16-90013126-A-G,rs8059973,-1,A,G,90013126,34471,89850989,90244205,162137
16,ENSG00000263276.1,68224713,chr16-68310460-A-C,rs8063446,1,A,C,68310460,85747,68028105,68421321,282355
16,ENSG00000231439.3,22910,chr16-47354-A-G,rs8466,1,A,G,47354,24444,-173698,219518,221052
16,ENSG00000262454.1,14302288,chr16-14301301-T-C,rs878340,1,T,C,14301301,987,14105680,14498896,195621
16,ENSG00000206168.1,231134,chr16-265840-G-A,rs8816,1,G,A,265840,34706,34526,427742,231314
16,ENSG00000232748.2,31056460,chr16-31111250-C-T,rs889555,1,C,T,31111250,54790,30859852,31253068,251398
16,ENSG00000261253.1,89321133,chr16-89320400-A-G,rs889574,1,A,G,89320400,733,89124525,89517741,195875
16,ENSG00000220793.4,9156881,chr16-9130419-A-C,rs956340,-1,A,C,9130419,26462,8960273,9353489,170146
16,ENSG00000260979.1,8962706,chr16-8987133-C-T,rs964006,1,C,T,8987133,24427,8766098,9159314,221035
16,ENSG00000259940.1,27214993,chr16-27221697-G-A,rs9788909,-1,G,A,27221697,6704,27018385,27411601,203312
16,ENSG00000262470.1,14200357,chr16-14362850-T-C,rs9923334,1,T,C,14362850,162493,14003749,14396965,359101
16,ENSG00000260326.1,52934813,chr16-52992233-A-G,rs9926762,1,A,G,52992233,57420,52738205,53131421,254028
16,ENSG00000263326.1,25072727,chr16-25073758-G-A,rs9928693,-1,G,A,25073758,1031,24876119,25269335,197639
16,ENSG00000223959.4,89972631,chr16-90082388-T-G,rs9929001,1,T,G,90082388,109757,89776023,90169239,306365
16,ENSG00000259877.1,89217653,chr16-89217262-C-T,rs9933428,-1,C,T,89217262,391,89021045,89414261,196217
16,ENSG00000261783.1,75381260,chr16-75486019-G-A,rs100912,-1,G,A,75486019,104759,75184652,75577868,301367
16,ENSG00000260083.1,30875222,chr16-30903305-T-C,rs1046276,1,T,C,30903305,28083,30678614,31071830,224691
16,ENSG00000214725.3,29864308,chr16-29822393-G-A,rs1057452,1,G,A,29822393,41915,29667700,30060916,154693
16,ENSG00000262155.1,25067079,chr16-25016734-A-G,rs11074666,1,A,G,25016734,50345,24870471,25263687,146263
16,ENSG00000260279.1,89296128,chr16-89276630-G-A,rs112043543,1,G,A,89276630,19498,89099520,89492736,177110
16,ENSG00000263343.1,31165648,chr16-31321569-C-T,rs1143681,1,C,T,31321569,155921,30969040,31362256,352529
16,ENSG00000125122.10,67226998,chr16-67210172-C-T,rs115503334,-1,C,T,67210172,16826,67030390,67423606,179782
16,ENSG00000259940.1,27214993,chr16-27233765-G-T,rs11641348,-1,G,T,27233765,18772,27018385,27411601,215380
16,ENSG00000228071.4,17932720,chr16-18019627-G-C,rs11645208,1,G,C,18019627,86907,17736112,18129328,283515
16,ENSG00000103472.5,29074976,chr16-29011236-A-G,rs11648430,1,A,G,29011236,63740,28878368,29271584,132868
16,ENSG00000260570.1,28837200,chr16-29011236-A-G,rs11648430,-1,A,G,29011236,174036,28640592,29033808,370644
16,ENSG00000259945.1,67542963,chr16-67409456-C-T,rs117028005,-1,C,T,67409456,133507,67346355,67739571,63101
16,ENSG00000214331.4,74360859,chr16-74217183-G-A,rs117041818,-1,G,A,74217183,143676,74164251,74557467,52932
16,ENSG00000261741.1,31564783,chr16-31686932-C-T,rs117111311,-1,C,T,31686932,122149,31368175,31761391,318757
16,ENSG00000260782.1,46789898,chr16-46730980-A-G,rs117479788,1,A,G,46730980,58918,46593290,46986506,137690
16,ENSG00000262468.1,4253789,chr16-4248428-G-A,rs117721843,-1,G,A,4248428,5361,4057181,4450397,191247
16,ENSG00000261804.1,53373479,chr16-53429699-G-A,rs117857845,1,G,A,53429699,56220,53176871,53570087,252828
16,ENSG00000259918.1,47598996,chr16-47640507-A-G,rs1200969,-1,A,G,47640507,41511,47402388,47795604,238119
16,ENSG00000261243.1,84495599,chr16-84417485-G-A,rs12149164,1,G,A,84417485,78114,84298991,84692207,118494
16,ENSG00000223959.4,89972631,chr16-89935952-G-A,rs12207,1,G,A,89935952,36679,89776023,90169239,159929
16,ENSG00000215003.4,15932294,chr16-16053917-C-T,rs12444264,-1,C,T,16053917,121623,15735686,16128902,318231
16,ENSG00000260934.1,19501689,chr16-19528536-A-G,rs12447418,1,A,G,19528536,26847,19305081,19698297,223455
16,ENSG00000131797.8,31703168,chr16-31849078-C-T,rs12447780,1,C,T,31849078,145910,31506560,31899776,342518
16,ENSG00000261067.1,28974804,chr16-28898301-G-A,rs12596913,1,G,A,28898301,76503,28778196,29171412,120105
16,ENSG00000259877.1,89217653,chr16-89155387-G-A,rs12597637,-1,G,A,89155387,62266,89021045,89414261,134342
16,ENSG00000260229.1,81476519,chr16-81438195-A-G,rs12920983,-1,A,G,81438195,38324,81279911,81673127,158284
16,ENSG00000241932.1,12881170,chr16-12707569-T-C,rs1346491,1,T,C,12707569,173601,12684562,13077778,23007
16,ENSG00000262470.1,14200357,chr16-14009965-C-T,rs1651191,1,C,T,14009965,190392,14003749,14396965,6216
16,ENSG00000261336.1,47566884,chr16-47669696-G-A,rs16945483,-1,G,A,47669696,102812,47370276,47763492,299420
16,ENSG00000244485.1,76235623,chr16-76065991-T-G,rs174000,-1,T,G,76065991,169632,76039015,76432231,26976
16,ENSG00000243101.1,78825281,chr16-78936217-T-C,rs17505656,1,T,C,78936217,110936,78628673,79021889,307544
16,ENSG00000262703.1,11349321,chr16-11319732-A-C,rs17605444,-1,A,C,11319732,29589,11152713,11545929,167019
16,ENSG00000261063.1,77249957,chr16-77301508-C-T,rs17619850,-1,C,T,77301508,51551,77053349,77446565,248159
16,ENSG00000260999.1,68948261,chr16-68859878-C-T,rs17690624,-1,C,T,68859878,88383,68751653,69144869,108225
16,ENSG00000261158.1,12759282,chr16-12655814-G-T,rs2059819,1,G,T,12655814,103468,12562674,12955890,93140
16,ENSG00000263126.1,67882461,chr16-67868167-G-A,rs2271293,1,G,A,67868167,14294,67685853,68079069,182314
16,ENSG00000263335.1,15726674,chr16-15756347-A-G,rs2272554,1,A,G,15756347,29673,15530066,15923282,226281
16,ENSG00000263072.1,3143734,chr16-3101335-C-T,rs2717694,-1,C,T,3101335,42399,2947126,3340342,154209
16,ENSG00000261207.1,1752262,chr16-1850146-G-T,rs2815299,-1,G,T,1850146,97884,1555654,1948870,294492
16,ENSG00000260349.1,9107174,chr16-9165833-A-G,rs2941346,-1,A,G,9165833,58659,8910566,9303782,255267
16,ENSG00000172460.10,2842710,chr16-2701172-C-T,rs3112728,-1,C,T,2701172,141538,2646102,3039318,55070
16,ENSG00000261123.1,2097026,chr16-1935996-C-A,rs3178732,-1,C,A,1935996,161030,1900418,2293634,35578
16,ENSG00000261641.1,1445343,chr16-1436461-C-T,rs35583599,1,C,T,1436461,8882,1248735,1641951,187726
16,ENSG00000260630.1,88663298,chr16-88649934-G-A,rs35601559,1,G,A,88649934,13364,88466690,88859906,183244
16,ENSG00000260316.1,905224,chr16-766977-G-A,rs35935235,-1,G,A,766977,138247,708616,1101832,58361
16,ENSG00000259804.1,67562309,chr16-67632192-T-G,rs36008260,-1,T,G,67632192,69883,67365701,67758917,266491
16,ENSG00000236829.4,386763,chr16-386257-G-A,rs367146,1,G,A,386257,506,190155,583371,196102
16,ENSG00000260923.1,90187183,chr16-90029076-C-T,rs3785184,1,C,T,90029076,158107,89990575,90383791,38501
16,ENSG00000226180.2,87696147,chr16-87694131-C-A,rs3812970,-1,C,A,87694131,2016,87499539,87892755,194592
16,ENSG00000261089.1,28413703,chr16-28499134-T-C,rs40835,1,T,C,28499134,85431,28217095,28610311,282039
16,ENSG00000231439.3,22910,chr16-36671-T-C,rs41340949,1,T,C,36671,13761,-173698,219518,210369
16,ENSG00000261971.1,3059363,chr16-3074919-A-G,rs4349147,-1,A,G,3074919,15556,2862755,3255971,212164
16,ENSG00000175604.2,12090302,chr16-12198281-G-A,rs4780416,-1,G,A,12198281,107979,11893694,12286910,304587
16,ENSG00000262636.1,11381118,chr16-11402723-T-C,rs4781083,-1,T,C,11402723,21605,11184510,11577726,218213
16,ENSG00000205018.2,88939789,chr16-88952758-A-G,rs4782498,1,A,G,88952758,12969,88743181,89136397,209577
16,ENSG00000261613.1,2556060,chr16-2460602-C-T,rs4786284,-1,C,T,2460602,95458,2359452,2752668,101150
16,ENSG00000205918.5,2642432,chr16-2827631-T-C,rs4786326,-1,T,C,2827631,185199,2445824,2839040,381807
16,ENSG00000260010.1,31603531,chr16-31439496-G-A,rs4889658,-1,G,A,31439496,164035,31406923,31800139,32573
16,ENSG00000261405.2,33570935,chr16-33744400-G-A,rs56163327,-1,G,A,33744400,173465,33374327,33767543,370073
16,ENSG00000260778.1,2268155,chr16-2430079-G-A,rs62040704,1,G,A,2430079,161924,2071547,2464763,358532
16,ENSG00000261288.1,2554975,chr16-2430079-G-A,rs62040704,1,G,A,2430079,124896,2358367,2751583,71712
16,ENSG00000262151.1,10888752,chr16-10929968-T-C,rs6416648,-1,T,C,10929968,41216,10692144,11085360,237824
16,ENSG00000263179.1,11242653,chr16-11234280-A-G,rs6498176,1,A,G,11234280,8373,11046045,11439261,188235
16,ENSG00000235560.3,30534752,chr16-30535167-G-A,rs6565191,1,G,A,30535167,415,30338144,30731360,197023
16,ENSG00000261140.1,2571936,chr16-2393942-G-C,rs6600201,-1,G,C,2393942,177994,2375328,2768544,18614
16,ENSG00000259856.1,46626992,chr16-46504606-A-G,rs7192689,-1,A,G,46504606,122386,46430384,46823600,74222
16,ENSG00000261173.1,46973789,chr16-46898215-C-T,rs7192932,1,C,T,46898215,75574,46777181,47170397,121034
16,ENSG00000260755.1,66509437,chr16-66566576-G-A,rs7193473,1,G,A,66566576,57139,66312829,66706045,253747
16,ENSG00000261118.1,89504460,chr16-89374209-C-T,rs7195691,-1,C,T,89374209,130251,89307852,89701068,66357
16,ENSG00000260908.1,29107445,chr16-29243432-C-T,rs7201024,-1,C,T,29243432,135987,28910837,29304053,332595
16,ENSG00000261395.2,68686399,chr16-68636778-A-G,rs7201548,1,A,G,68636778,49621,68489791,68883007,146987
16,ENSG00000261416.1,30184563,chr16-30145642-C-T,rs7204270,-1,C,T,30145642,38921,29987955,30381171,157687
16,ENSG00000261461.1,35170241,chr16-35170816-C-T,rs72810758,-1,C,T,35170816,575,34973633,35366849,197183
16,ENSG00000261644.1,50742815,chr16-50753572-A-G,rs7342715,-1,A,G,50753572,10757,50546207,50939423,207365
16,ENSG00000226942.2,38321,chr16-51277-G-T,rs74003635,-1,G,T,51277,12956,-158287,234929,209564
16,ENSG00000259842.1,33950420,chr16-33796240-C-T,rs74017492,-1,C,T,33796240,154180,33753812,34147028,42428
16,ENSG00000260249.2,50664903,chr16-50669105-C-T,rs74017766,1,C,T,50669105,4202,50468295,50861511,200810
16,ENSG00000260259.1,89686569,chr16-89579438-C-T,rs7404704,-1,C,T,89579438,107131,89489961,89883177,89477
16,ENSG00000261253.1,89321133,chr16-89407985-G-A,rs747486,1,G,A,89407985,86852,89124525,89517741,283460
16,ENSG00000261253.1,89321133,chr16-89407985-G-T,rs747486,1,G,T,89407985,86852,89124525,89517741,283460
16,ENSG00000260682.1,81961926,chr16-81879436-T-C,rs74943801,1,T,C,81879436,82490,81765318,82158534,114118
16,ENSG00000250685.3,84197053,chr16-84238932-A-G,rs75063301,-1,A,G,84238932,41879,84000445,84393661,238487
16,ENSG00000260803.1,35195,chr16-130530-G-A,rs75187722,-1,G,A,130530,95335,-161413,231803,291943
16,ENSG00000259982.1,28701540,chr16-28878650-C-T,rs75273069,-1,C,T,28878650,177110,28504932,28898148,373718
16,ENSG00000239763.2,74313390,chr16-74128763-G-C,rs75723453,-1,G,C,74128763,184627,74116782,74509998,11981
16,ENSG00000255198.2,1964895,chr16-1961125-A-G,rs758335,1,A,G,1961125,3770,1768287,2161503,192838
16,ENSG00000260107.1,1997654,chr16-1961125-A-G,rs758335,1,A,G,1961125,36529,1801046,2194262,160079
16,ENSG00000260482.1,23670011,chr16-23669844-G-A,rs7588,1,G,A,23669844,167,23473403,23866619,196441
16,ENSG00000260874.1,2459966,chr16-2501014-C-T,rs76267944,-1,C,T,2501014,41048,2263358,2656574,237656
16,ENSG00000260438.1,57713782,chr16-57580536-G-A,rs76725932,1,G,A,57580536,133246,57517174,57910390,63362
16,ENSG00000262766.1,31118078,chr16-30989947-T-C,rs77218983,1,T,C,30989947,128131,30921470,31314686,68477
16,ENSG00000259881.1,88883272,chr16-88755530-G-A,rs78014167,1,G,A,88755530,127742,88686664,89079880,68866
16,ENSG00000260186.1,58421339,chr16-58317792-G-A,rs78263708,1,G,A,58317792,103547,58224731,58617947,93061
16,ENSG00000261239.2,46568915,chr16-46594792-G-A,rs80068430,-1,G,A,46594792,25877,46372307,46765523,222485
16,ENSG00000260853.1,28966436,chr16-28976948-C-T,rs8045689,-1,C,T,28976948,10512,28769828,29163044,207120
16,ENSG00000261448.1,17134504,chr16-17037893-A-G,rs8046186,1,A,G,17037893,96611,16937896,17331112,99997
16,ENSG00000259768.3,72665133,chr16-72713203-C-T,rs8047850,1,C,T,72713203,48070,72468525,72861741,244678
16,ENSG00000260121.1,88718615,chr16-88684799-T-C,rs8048125,1,T,C,88684799,33816,88522007,88915223,162792
16,ENSG00000261707.1,77743000,chr16-77713547-A-G,rs8051061,-1,A,G,77713547,29453,77546392,77939608,167155
16,ENSG00000263280.1,2868251,chr16-2900832-T-C,rs8057363,-1,T,C,2900832,32581,2671643,3064859,229189
16,ENSG00000263280.1,2868251,chr16-2900832-T-A,rs8057363,-1,T,A,2900832,32581,2671643,3064859,229189
16,ENSG00000260751.1,23568673,chr16-23702074-C-T,rs8058610,1,C,T,23702074,133401,23372065,23765281,330009
16,ENSG00000262732.1,13935635,chr16-14045344-A-G,rs8060508,-1,A,G,14045344,109709,13739027,14132243,306317
16,ENSG00000261114.1,56941028,chr16-56896339-T-C,rs8063291,1,T,C,56896339,44689,56744420,57137636,151919
16,ENSG00000260979.1,8962706,chr16-8994527-A-G,rs8063445,1,A,G,8994527,31821,8766098,9159314,228429
16,ENSG00000261512.2,46624451,chr16-46803936-T-C,rs808428,-1,T,C,46803936,179485,46427843,46821059,376093
16,ENSG00000262700.1,25093387,chr16-25170711-T-C,rs9630611,1,T,C,25170711,77324,24896779,25289995,273932
16,ENSG00000261717.1,75464706,chr16-75620850-A-T,rs9921233,-1,A,T,75620850,156144,75268098,75661314,352752
16,ENSG00000261474.1,31453493,chr16-31533048-G-A,rs9923480,-1,G,A,31533048,79555,31256885,31650101,276163
16,ENSG00000261840.1,30699058,chr16-30595168-G-A,rs9924077,-1,G,A,30595168,103890,30502450,30895666,92718
16,ENSG00000261812.1,90094023,chr16-89988656-A-T,rs9930046,1,A,T,89988656,105367,89897415,90290631,91241
16,ENSG00000261552.1,28990778,chr16-28992050-C-T,rs9930735,-1,C,T,28992050,1272,28794170,29187386,197880
16,ENSG00000260565.1,2682369,chr16-2527012-G-A,rs9935778,-1,G,A,2527012,155357,2485761,2878977,41251
16,ENSG00000260425.1,1361405,chr16-1283386-C-T,rs9940055,-1,C,T,1283386,78019,1164797,1558013,118589
16,ENSG00000246898.1,66408516,chr16-66364942-G-A,rs9940166,1,G,A,66364942,43574,66211908,66605124,153034
16,ENSG00000260886.1,71565789,chr16-71452202-C-T,rs9940485,1,C,T,71452202,113587,71369181,71762397,83021
16,ENSG00000259810.1,31788202,chr16-31792064-A-G,rs1034614,1,A,G,31792064,3862,31591594,31984810,200470
16,ENSG00000221819.2,90029901,chr16-90033163-G-A,rs10431948,-1,G,A,90033163,3262,89833293,90226509,199870
16,ENSG00000261590.1,60357214,chr16-60545456-G-A,rs10500418,1,G,A,60545456,188242,60160606,60553822,384850
16,ENSG00000261889.1,3157483,chr16-3142672-T-C,rs1053997,-1,T,C,3142672,14811,2960875,3354091,181797
16,ENSG00000259843.2,50066224,chr16-50258073-A-T,rs11076529,-1,A,T,50258073,191849,49869616,50262832,388457
16,ENSG00000259843.2,50066224,chr16-50258073-A-C,rs11076529,-1,A,C,50258073,191849,49869616,50262832,388457
16,ENSG00000261063.1,77249957,chr16-77202367-C-A,rs1129680,-1,C,A,77202367,47590,77053349,77446565,149018
16,ENSG00000262136.1,69727013,chr16-69726438-A-G,rs114238154,1,A,G,69726438,575,69530405,69923621,196033
16,ENSG00000247033.1,75110712,chr16-75305397-C-T,rs11641943,-1,C,T,75305397,194685,74914104,75307320,391293
16,ENSG00000214725.3,29864308,chr16-29981787-C-G,rs11642046,1,C,G,29981787,117479,29667700,30060916,314087
16,ENSG00000214725.3,29864308,chr16-29981787-C-A,rs11642046,1,C,A,29981787,117479,29667700,30060916,314087
16,ENSG00000262587.1,25031881,chr16-24918154-T-C,rs11647538,1,T,C,24918154,113727,24835273,25228489,82881
16,ENSG00000259877.1,89217653,chr16-89249216-C-G,rs117350523,-1,C,G,89249216,31563,89021045,89414261,228171
16,ENSG00000251417.1,28802743,chr16-28811498-T-C,rs117475154,1,T,C,28811498,8755,28606135,28999351,205363
16,ENSG00000261461.1,35170241,chr16-35299048-C-G,rs117663045,-1,C,G,35299048,128807,34973633,35366849,325415
16,ENSG00000261461.1,35170241,chr16-35299048-C-T,rs117663045,-1,C,T,35299048,128807,34973633,35366849,325415
16,ENSG00000262514.1,68199795,chr16-68360802-C-T,rs117949548,1,C,T,68360802,161007,68003187,68396403,357615
16,ENSG00000260518.1,33698504,chr16-33687931-G-A,rs117949630,-1,G,A,33687931,10573,33501896,33895112,186035
16,ENSG00000260714.1,25015978,chr16-25125031-A-C,rs11860180,1,A,C,25125031,109053,24819370,25212586,305661
16,ENSG00000260034.1,25149032,chr16-25190418-C-T,rs11863284,-1,C,T,25190418,41386,24952424,25345640,237994
16,ENSG00000244043.1,59088837,chr16-59038606-G-A,rs11866470,1,G,A,59038606,50231,58892229,59285445,146377
16,ENSG00000172460.10,2842710,chr16-2896054-G-A,rs12447354,-1,G,A,2896054,53344,2646102,3039318,249952
16,ENSG00000247228.2,70173483,chr16-70158110-C-T,rs12448586,-1,C,T,70158110,15373,69976875,70370091,181235
16,ENSG00000261359.2,31201885,chr16-31190876-G-T,rs13331793,1,G,T,31190876,11009,31005277,31398493,185599
16,ENSG00000261731.2,31711984,chr16-31756893-A-G,rs13332983,-1,A,G,31756893,44909,31515376,31908592,241517
16,ENSG00000236829.4,386763,chr16-468828-G-A,rs13336211,1,G,A,468828,82065,190155,583371,278673
16,ENSG00000205913.2,2752593,chr16-2798609-G-A,rs142522686,-1,G,A,2798609,46016,2555985,2949201,242624
16,ENSG00000259804.1,67562309,chr16-67454974-A-G,rs1471142,-1,A,G,67454974,107335,67365701,67758917,89273
16,ENSG00000261327.1,88186803,chr16-88175154-T-C,rs148385295,-1,T,C,88175154,11649,87990195,88383411,184959
16,ENSG00000261546.1,89115279,chr16-88934085-G-A,rs1646233,-1,G,A,88934085,181194,88918671,89311887,15414
16,ENSG00000260979.1,8962706,chr16-8934684-G-C,rs1677490,1,G,C,8934684,28022,8766098,9159314,168586
16,ENSG00000227827.3,16356224,chr16-16539504-G-T,rs16955286,1,G,T,16539504,183280,16159616,16552832,379888
16,ENSG00000261707.1,77743000,chr16-77738102-A-G,rs17716830,-1,A,G,77738102,4898,77546392,77939608,191710
16,ENSG00000238098.4,2361144,chr16-2332353-C-T,rs17758402,1,C,T,2332353,28791,2164536,2557752,167817
16,ENSG00000262766.1,31118078,chr16-31089001-G-A,rs17882368,1,G,A,31089001,29077,30921470,31314686,167531
16,ENSG00000261395.2,68686399,chr16-68823538-T-C,rs1801552,1,T,C,68823538,137139,68489791,68883007,333747
16,ENSG00000261471.1,84594393,chr16-84597896-T-G,rs1807098,1,T,G,84597896,3503,84397785,84791001,200111
16,ENSG00000240634.1,28814673,chr16-28620264-T-G,rs1968752,-1,T,G,28620264,194409,28618065,29011281,2199
16,ENSG00000261588.1,30587920,chr16-30506775-C-T,rs2230434,-1,C,T,30506775,81145,30391312,30784528,115463
16,ENSG00000258186.1,21520365,chr16-21613612-G-T,rs226007,-1,G,T,21613612,93247,21323757,21716973,289855
16,ENSG00000259955.1,25238318,chr16-25224704-G-T,rs2287799,1,G,T,25224704,13614,25041710,25434926,182994
16,ENSG00000261519.1,66549280,chr16-66531589-A-G,rs2288399,1,A,G,66531589,17691,66352672,66745888,178917
16,ENSG00000206168.1,231134,chr16-65043-C-T,rs2288490,1,C,T,65043,166091,34526,427742,30517
16,ENSG00000261217.1,33991551,chr16-33804576-G-A,rs2335199,-1,G,A,33804576,186975,33794943,34188159,9633
16,ENSG00000246898.1,66408516,chr16-66422451-A-G,rs2344997,1,A,G,66422451,13935,66211908,66605124,210543
16,ENSG00000262636.1,11381118,chr16-11291154-C-T,rs243315,-1,C,T,11291154,89964,11184510,11577726,106644
16,ENSG00000262454.1,14302288,chr16-14274283-T-G,rs246166,1,T,G,14274283,28005,14105680,14498896,168603
16,ENSG00000231439.3,22910,chr16-64537-A-G,rs2562147,1,A,G,64537,41627,-173698,219518,238235
16,ENSG00000260643.1,81096296,chr16-81006022-A-G,rs2602421,-1,A,G,81006022,90274,80899688,81292904,106334
16,ENSG00000261089.1,28413703,chr16-28325561-T-C,rs2726034,1,T,C,28325561,88142,28217095,28610311,108466
16,ENSG00000205037.2,88100959,chr16-87947002-A-G,rs28479149,-1,A,G,87947002,153957,87904351,88297567,42651
16,ENSG00000205918.5,2642432,chr16-2698698-T-C,rs3112726,-1,T,C,2698698,56266,2445824,2839040,252874
16,ENSG00000260465.1,66720897,chr16-66604342-G-A,rs35320143,1,G,A,66604342,116555,66524289,66917505,80053
16,ENSG00000260425.1,1361405,chr16-1436461-C-T,rs35583599,-1,C,T,1436461,75056,1164797,1558013,271664
16,ENSG00000259856.1,46626992,chr16-46671590-T-C,rs36310,-1,T,C,46671590,44598,46430384,46823600,241206
16,ENSG00000183458.8,14911551,chr16-14889311-C-G,rs3743531,1,C,G,14889311,22240,14714943,15108159,174368
16,ENSG00000261218.1,81739158,chr16-81701272-T-G,rs3751858,1,T,G,81701272,37886,81542550,81935766,158722
16,ENSG00000260052.1,48637143,chr16-48575484-C-T,rs3859121,1,C,T,48575484,61659,48440535,48833751,134949
16,ENSG00000260809.1,35090501,chr16-35123031-C-T,rs409110,1,C,T,35123031,32530,34893893,35287109,229138
16,ENSG00000260229.1,81476519,chr16-81605304-G-A,rs4506892,-1,G,A,81605304,128785,81279911,81673127,325393
16,ENSG00000259940.1,27214993,chr16-27304962-T-C,rs4523933,-1,T,C,27304962,89969,27018385,27411601,286577
16,ENSG00000205018.2,88939789,chr16-88963710-T-C,rs4782494,1,T,C,88963710,23921,88743181,89136397,220529
16,ENSG00000260186.1,58421339,chr16-58433949-G-C,rs4784938,1,G,C,58433949,12610,58224731,58617947,209218
16,ENSG00000260186.1,58421339,chr16-58433949-G-A,rs4784938,1,G,A,58433949,12610,58224731,58617947,209218
16,ENSG00000261288.1,2554975,chr16-2460602-C-T,rs4786284,1,C,T,2460602,94373,2358367,2751583,102235
16,ENSG00000260498.1,87779374,chr16-87693792-G-A,rs4843676,-1,G,A,87693792,85582,87582766,87975982,111026
16,ENSG00000260213.1,81035735,chr16-81148012-C-T,rs4889247,-1,C,T,81148012,112277,80839127,81232343,308885
16,ENSG00000260051.1,1451760,chr16-1438014-A-C,rs4984840,1,A,C,1438014,13746,1255152,1648368,182862
16,ENSG00000260051.1,1451760,chr16-1438014-A-G,rs4984840,1,A,G,1438014,13746,1255152,1648368,182862
16,ENSG00000260121.1,88718615,chr16-88912442-C-T,rs555191,1,C,T,88912442,193827,88522007,88915223,390435
16,ENSG00000261659.2,689494,chr16-865323-G-C,rs62012415,1,G,C,865323,175829,492886,886102,372437
16,ENSG00000261541.1,32458758,chr16-32606434-G-C,rs62046077,-1,G,C,32606434,147676,32262150,32655366,344284
16,ENSG00000261647.1,10111382,chr16-10238214-T-G,rs6497811,1,T,G,10238214,126832,9914774,10307990,323440
16,ENSG00000260630.1,88663298,chr16-88661325-C-T,rs6500487,1,C,T,88661325,1973,88466690,88859906,194635
16,ENSG00000260177.1,87806476,chr16-87722441-T-G,rs6540074,-1,T,G,87722441,84035,87609868,88003084,112573
16,ENSG00000214331.4,74360859,chr16-74432521-T-C,rs6564097,-1,T,C,74432521,71662,74164251,74557467,268270
16,ENSG00000175604.2,12090302,chr16-12210761-T-C,rs709423,-1,T,C,12210761,120459,11893694,12286910,317067
16,ENSG00000261613.1,2556060,chr16-2598650-G-T,rs71386677,-1,G,T,2598650,42590,2359452,2752668,239198
16,ENSG00000261243.1,84495599,chr16-84511002-A-G,rs7191339,1,A,G,84511002,15403,84298991,84692207,212011
16,ENSG00000260884.1,74313337,chr16-74213008-T-C,rs7191483,1,T,C,74213008,100329,74116729,74509945,96279
16,ENSG00000263080.1,11345211,chr16-11368621-C-T,rs7205925,-1,C,T,11368621,23410,11148603,11541819,220018
16,ENSG00000261741.1,31564783,chr16-31657777-C-G,rs7206828,-1,C,G,31657777,92994,31368175,31761391,289602
16,ENSG00000262528.1,656194,chr16-605809-G-A,rs72767876,-1,G,A,605809,50385,459586,852802,146223
16,ENSG00000250616.2,30096430,chr16-29922569-C-T,rs72798151,1,C,T,29922569,173861,29899822,30293038,22747
16,ENSG00000226180.2,87696147,chr16-87736339-G-A,rs72812212,-1,G,A,87736339,40192,87499539,87892755,236800
16,ENSG00000261286.1,84467361,chr16-84454567-G-A,rs747718,-1,G,A,84454567,12794,84270753,84663969,183814
16,ENSG00000261067.1,28974804,chr16-28999450-A-C,rs7498329,1,A,C,28999450,24646,28778196,29171412,221254
16,ENSG00000125122.10,67226998,chr16-67199340-G-A,rs75193761,-1,G,A,67199340,27658,67030390,67423606,168950
16,ENSG00000261158.1,12759282,chr16-12599885-A-C,rs75399527,1,A,C,12599885,159397,12562674,12955890,37211
16,ENSG00000261158.1,12759282,chr16-12599885-A-T,rs75399527,1,A,T,12599885,159397,12562674,12955890,37211
16,ENSG00000261620.1,35803280,chr16-35811812-G-A,rs76190307,-1,G,A,35811812,8532,35606672,35999888,205140
16,ENSG00000260999.1,68948261,chr16-69036573-C-T,rs78213475,-1,C,T,69036573,88312,68751653,69144869,284920
16,ENSG00000259881.1,88883272,chr16-88692888-G-C,rs79327070,1,G,C,88692888,190384,88686664,89079880,6224
16,ENSG00000259881.1,88883272,chr16-88692888-G-A,rs79327070,1,G,A,88692888,190384,88686664,89079880,6224
16,ENSG00000260277.1,22090164,chr16-22217286-G-T,rs79424032,-1,G,T,22217286,127122,21893556,22286772,323730
16,ENSG00000261123.1,2097026,chr16-2143421-A-G,rs80175943,-1,A,G,2143421,46395,1900418,2293634,243003
16,ENSG00000260751.1,23568673,chr16-23651475-A-G,rs8043812,1,A,G,23651475,82802,23372065,23765281,279410
16,ENSG00000260494.1,30538231,chr16-30697737-T-C,rs8046436,-1,T,C,30697737,159506,30341623,30734839,356114
16,ENSG00000228201.1,649200,chr16-810258-A-G,rs8047170,-1,A,G,810258,161058,452592,845808,357666
16,ENSG00000262488.1,10841544,chr16-10928810-T-C,rs8048903,-1,T,C,10928810,87266,10644936,11038152,283874
16,ENSG00000103472.5,29074976,chr16-29017584-T-C,rs8052343,1,T,C,29017584,57392,28878368,29271584,139216
16,ENSG00000259933.1,2091539,chr16-2051590-T-C,rs8059880,1,T,C,2051590,39949,1894931,2288147,156659
16,ENSG00000260326.1,52934813,chr16-52823180-G-A,rs8060591,1,G,A,52823180,111633,52738205,53131421,84975
16,ENSG00000261270.1,56940278,chr16-56896339-T-C,rs8063291,1,T,C,56896339,43939,56743670,57136886,152669
16,ENSG00000261777.1,70346806,chr16-70408505-C-T,rs936994,-1,C,T,70408505,61699,70150198,70543414,258307
16,ENSG00000262700.1,25093387,chr16-25093773-A-C,rs9921120,1,A,C,25093773,386,24896779,25289995,196994
16,ENSG00000260267.1,31459736,chr16-31533048-G-A,rs9923480,-1,G,A,31533048,73312,31263128,31656344,269920
16,ENSG00000260060.1,31196131,chr16-31002858-C-T,rs9926533,1,C,T,31002858,193273,30999523,31392739,3335
16,ENSG00000261783.1,75381260,chr16-75208831-T-C,rs9928736,-1,T,C,75208831,172429,75184652,75577868,24179
15,ENSG00000259709.1,52124561,chr15-52159687-G-A,rs10220890,1,G,A,52159687,35126,51927953,52321169,231734
15,ENSG00000261315.1,36617089,chr15-36476020-C-T,rs10518881,1,C,T,36476020,141069,36420481,36813697,55539
15,ENSG00000259661.1,90921186,chr15-90931006-T-C,rs1052532,-1,T,C,90931006,9820,90724578,91117794,206428
15,ENSG00000259658.1,101745983,chr15-101737277-G-C,rs1052887,-1,G,C,101737277,8706,101549375,101942591,187902
15,ENSG00000177699.4,78978889,chr15-78944473-G-A,rs11072817,1,G,A,78944473,34416,78782281,79175497,162192
15,ENSG00000261147.1,90249556,chr15-90249274-C-G,rs11073920,1,C,G,90249274,282,90052948,90446164,196326
15,ENSG00000224078.3,25193313,chr15-25081026-T-C,rs1124767,1,T,C,25081026,112287,24996705,25389921,84321
15,ENSG00000259448.1,31216021,chr15-31111392-T-C,rs11636447,1,T,C,31111392,104629,31019413,31412629,91979
15,ENSG00000242295.1,96448154,chr15-96459423-A-G,rs11637980,1,A,G,96459423,11269,96251546,96644762,207877
15,ENSG00000259394.1,62953173,chr15-63145653-C-A,rs116985417,1,C,A,63145653,192480,62756565,63149781,389088
15,ENSG00000259299.1,29235137,chr15-29250460-C-T,rs117590493,-1,C,T,29250460,15323,29038529,29431745,211931
15,ENSG00000259686.1,33012119,chr15-32968984-G-A,rs117804335,1,G,A,32968984,43135,32815511,33208727,153473
15,ENSG00000259516.1,35237326,chr15-35192505-C-T,rs12050867,1,C,T,35192505,44821,35040718,35433934,151787
15,ENSG00000259540.1,100558677,chr15-100569613-G-A,rs12460,1,G,A,100569613,10936,100362069,100755285,207544
15,ENSG00000260928.1,43131008,chr15-43148458-G-A,rs12594277,1,G,A,43148458,17450,42934400,43327616,214058
15,ENSG00000205871.4,43116493,chr15-43148458-G-A,rs12594277,-1,G,A,43148458,31965,42919885,43313101,228573
15,ENSG00000245534.2,60479178,chr15-60502450-C-T,rs12594972,1,C,T,60502450,23272,60282570,60675786,219880
15,ENSG00000259232.1,65475614,chr15-65463635-C-T,rs12595213,-1,C,T,65463635,11979,65279006,65672222,184629
15,ENSG00000259883.1,41921417,chr15-41879264-C-T,rs12708402,1,C,T,41879264,42153,41724809,42118025,154455
15,ENSG00000212664.4,71341712,chr15-71264036-C-T,rs12708502,-1,C,T,71264036,77676,71145104,71538320,118932
15,ENSG00000259677.1,89876540,chr15-89777808-A-G,rs12900413,1,A,G,89777808,98732,89679932,90073148,97876
15,ENSG00000259172.1,101295419,chr15-101392873-G-C,rs12903394,1,G,C,101392873,97454,101098811,101492027,294062
15,ENSG00000259172.1,101295419,chr15-101392873-G-T,rs12903394,1,G,T,101392873,97454,101098811,101492027,294062
15,ENSG00000247728.2,30625773,chr15-30730116-A-G,rs12905321,-1,A,G,30730116,104343,30429165,30822381,300951
15,ENSG00000261822.1,42569994,chr15-42576088-A-G,rs12910030,-1,A,G,42576088,6094,42373386,42766602,202702
15,ENSG00000259655.1,99791127,chr15-99871875-A-G,rs12915935,1,A,G,99871875,80748,99594519,99987735,277356
15,ENSG00000215302.4,30470779,chr15-30660661-G-T,rs13380257,1,G,T,30660661,189882,30274171,30667387,386490
15,ENSG00000245479.2,90660207,chr15-90662391-T-C,rs16944717,1,T,C,90662391,2184,90463599,90856815,198792
15,ENSG00000214432.5,91022621,chr15-90875868-C-T,rs16944971,1,C,T,90875868,146753,90826013,91219229,49855
15,ENSG00000259627.1,63071911,chr15-63055888-A-G,rs16953475,-1,A,G,63055888,16023,62875303,63268519,180585
15,ENSG00000261687.1,43185141,chr15-43103649-G-A,rs16957431,-1,G,A,43103649,81492,42988533,43381749,115116
15,ENSG00000176700.15,84631963,chr15-84697473-T-C,rs16974502,1,T,C,84697473,65510,84435355,84828571,262118
15,ENSG00000245975.2,58770974,chr15-58770945-C-G,rs17269439,-1,C,G,58770945,29,58574366,58967582,196579
15,ENSG00000245975.2,58770974,chr15-58770945-C-A,rs17269439,-1,C,A,58770945,29,58574366,58967582,196579
15,ENSG00000259732.1,59121034,chr15-59152453-T-G,rs17269496,1,T,G,59152453,31419,58924426,59317642,228027
15,ENSG00000259712.1,52100523,chr15-52099709-T-A,rs17650082,-1,T,A,52099709,814,51903915,52297131,195794
15,ENSG00000259712.1,52100523,chr15-52099709-T-G,rs17650082,-1,T,G,52099709,814,51903915,52297131,195794
15,ENSG00000260648.1,40232082,chr15-40380923-T-C,rs17671250,1,T,C,40380923,148841,40035474,40428690,345449
15,ENSG00000259726.1,84186752,chr15-84080162-G-A,rs17841161,1,G,A,84080162,106590,83990144,84383360,90018
15,ENSG00000259726.1,84186752,chr15-84080162-G-C,rs17841161,1,G,C,84080162,106590,83990144,84383360,90018
15,ENSG00000260534.1,72589691,chr15-72630335-C-T,rs2016661,1,C,T,72630335,40644,72393083,72786299,237252
15,ENSG00000260139.1,77894684,chr15-78039680-T-C,rs2044099,1,T,C,78039680,144996,77698076,78091292,341604
15,ENSG00000259362.2,77525540,chr15-77466953-G-A,rs2055901,1,G,A,77466953,58587,77328932,77722148,138021
15,ENSG00000259250.1,58587507,chr15-58660608-T-C,rs2114573,1,T,C,58660608,73101,58390899,58784115,269709
15,ENSG00000260382.1,30883231,chr15-30841943-T-C,rs2140733,-1,T,C,30841943,41288,30686623,31079839,155320
15,ENSG00000260037.1,71818396,chr15-71903377-G-A,rs2291276,1,G,A,71903377,84981,71621788,72015004,281589
15,ENSG00000259520.1,45279251,chr15-45269670-C-A,rs2413769,-1,C,A,45269670,9581,45082643,45475859,187027
15,ENSG00000259715.1,50360194,chr15-50374243-T-C,rs2414049,-1,T,C,50374243,14049,50163586,50556802,210657
15,ENSG00000260689.1,57247893,chr15-57351872-T-C,rs2440946,-1,T,C,57351872,103979,57051285,57444501,300587
15,ENSG00000260689.1,57247893,chr15-57351872-T-G,rs2440946,-1,T,G,57351872,103979,57051285,57444501,300587
15,ENSG00000259704.1,90839641,chr15-90839685-G-A,rs2532101,1,G,A,90839685,44,90643033,91036249,196652
15,ENSG00000246877.1,75738623,chr15-75790874-G-A,rs2593289,-1,G,A,75790874,52251,75542015,75935231,248859
15,ENSG00000259684.1,50557601,chr15-50557202-T-C,rs2630,1,T,C,50557202,399,50360993,50754209,196209
15,ENSG00000260571.1,42313687,chr15-42359484-A-C,rs28364363,1,A,C,42359484,45797,42117079,42510295,242405
15,ENSG00000258771.1,21081447,chr15-21024744-C-T,rs28409350,-1,C,T,21024744,56703,20884839,21278055,139905
15,ENSG00000260206.1,75636139,chr15-75615295-G-A,rs28412110,1,G,A,75615295,20844,75439531,75832747,175764
15,ENSG00000259845.1,30815271,chr15-30959578-T-C,rs2949574,1,T,C,30959578,144307,30618663,31011879,340915
15,ENSG00000260892.1,75676227,chr15-75495841-T-C,rs34161372,1,T,C,75495841,180386,75479619,75872835,16222
15,ENSG00000240366.1,75186968,chr15-75228604-G-A,rs34739817,-1,G,A,75228604,41636,74990360,75383576,238244
15,ENSG00000259656.1,49101791,chr15-48992804-G-T,rs34895054,1,G,T,48992804,108987,48905183,49298399,87621
15,ENSG00000259656.1,49101791,chr15-48992804-G-C,rs34895054,1,G,C,48992804,108987,48905183,49298399,87621
15,ENSG00000259335.1,44449344,chr15-44608477-C-T,rs36014111,-1,C,T,44608477,159133,44252736,44645952,355741
15,ENSG00000259771.1,59271162,chr15-59208378-T-C,rs3816814,-1,T,C,59208378,62784,59074554,59467770,133824
15,ENSG00000260266.1,74361552,chr15-74168534-C-A,rs3848159,1,C,A,74168534,193018,74164944,74558160,3590
15,ENSG00000261684.1,42532081,chr15-42558182-A-G,rs3986280,-1,A,G,42558182,26101,42335473,42728689,222709
15,ENSG00000259583.1,100919391,chr15-100914124-T-C,rs4246329,-1,T,C,100914124,5267,100722783,101115999,191341
15,ENSG00000237550.3,82372888,chr15-82268478-C-T,rs4296215,-1,C,T,82268478,104410,82176280,82569496,92198
15,ENSG00000259670.1,48783190,chr15-48873235-T-C,rs4435197,1,T,C,48873235,90045,48586582,48979798,286653
15,ENSG00000262728.1,32615092,chr15-32639703-T-A,rs4544214,-1,T,A,32639703,24611,32418484,32811700,221219
15,ENSG00000259772.1,31230886,chr15-31236884-C-A,rs4779847,-1,C,A,31236884,5998,31034278,31427494,202606
15,ENSG00000259772.1,31230886,chr15-31236884-C-T,rs4779847,-1,C,T,31236884,5998,31034278,31427494,202606
15,ENSG00000259514.1,76342063,chr15-76336099-A-G,rs4886490,-1,A,G,76336099,5964,76145455,76538671,190644
15,ENSG00000259414.1,23293667,chr15-23102074-G-A,rs4932679,-1,G,A,23102074,191593,23097059,23490275,5015
15,ENSG00000259363.1,99806991,chr15-99853851-G-C,rs4965547,1,G,C,99853851,46860,99610383,100003599,243468
15,ENSG00000259327.1,52116574,chr15-52180454-T-G,rs55860410,1,T,G,52180454,63880,51919966,52313182,260488
15,ENSG00000259577.1,52180028,chr15-52180454-T-G,rs55860410,1,T,G,52180454,426,51983420,52376636,197034
15,ENSG00000259326.1,38502853,chr15-38505383-C-T,rs59254910,1,C,T,38505383,2530,38306245,38699461,199138
15,ENSG00000260799.1,42802405,chr15-42684508-C-T,rs62019359,-1,C,T,42684508,117897,42605797,42999013,78711
15,ENSG00000259340.1,96551381,chr15-96584674-A-G,rs62024494,1,A,G,96584674,33293,96354773,96747989,229901
15,ENSG00000246863.2,39921070,chr15-40039001-C-T,rs62621371,1,C,T,40039001,117931,39724462,40117678,314539
15,ENSG00000259287.1,33864825,chr15-33999459-A-G,rs646950,-1,A,G,33999459,134634,33668217,34061433,331242
15,ENSG00000259705.1,48645951,chr15-48646849-T-C,rs6493333,1,T,C,48646849,898,48449343,48842559,197506
15,ENSG00000259536.1,40488041,chr15-40553398-A-G,rs6582,1,A,G,40553398,65357,40291433,40684649,261965
15,ENSG00000175779.1,38628060,chr15-38696614-C-G,rs7165988,1,C,G,38696614,68554,38431452,38824668,265162
15,ENSG00000175779.1,38628060,chr15-38696614-C-T,rs7165988,1,C,T,38696614,68554,38431452,38824668,265162
15,ENSG00000180953.7,79923702,chr15-79919071-C-A,rs7167420,-1,C,A,79919071,4631,79727094,80120310,191977
15,ENSG00000189419.5,100350725,chr15-100457880-T-C,rs7171529,-1,T,C,100457880,107155,100154117,100547333,303763
15,ENSG00000260579.1,83114566,chr15-83279512-T-C,rs7171743,-1,T,C,83279512,164946,82917958,83311174,361554
15,ENSG00000261187.1,72466262,chr15-72475437-T-C,rs7174825,-1,T,C,72475437,9175,72269654,72662870,205783
15,ENSG00000259493.1,79560304,chr15-79381469-G-A,rs7177291,-1,G,A,79381469,178835,79363696,79756912,17773
15,ENSG00000245750.3,69462993,chr15-69423149-C-T,rs7180624,1,C,T,69423149,39844,69266385,69659601,156764
15,ENSG00000259205.1,100558954,chr15-100562307-C-A,rs7183379,-1,C,A,100562307,3353,100362346,100755562,199961
15,ENSG00000259479.2,44861850,chr15-44810421-G-C,rs72720062,-1,G,C,44810421,51429,44665242,45058458,145179
15,ENSG00000259187.1,44826540,chr15-44810421-G-C,rs72720062,1,G,C,44810421,16119,44629932,45023148,180489
15,ENSG00000261229.1,79844304,chr15-79726151-G-T,rs72732749,-1,G,T,79726151,118153,79647696,80040912,78455
15,ENSG00000259409.1,40088832,chr15-40234232-G-A,rs73391315,1,G,A,40234232,145400,39892224,40285440,342008
15,ENSG00000259660.2,101751553,chr15-101766049-G-A,rs74035815,1,G,A,101766049,14496,101554945,101948161,211104
15,ENSG00000258725.1,90966340,chr15-90972943-C-T,rs7496570,1,C,T,90972943,6603,90769732,91162948,203211
15,ENSG00000258780.1,20153776,chr15-19984159-A-G,rs7498096,1,A,G,19984159,169617,19957168,20350384,26991
15,ENSG00000259375.1,85580178,chr15-85509439-G-T,rs756426,-1,G,T,85509439,70739,85383570,85776786,125869
15,ENSG00000259375.1,85580178,chr15-85509439-G-C,rs756426,-1,G,C,85509439,70739,85383570,85776786,125869
15,ENSG00000259696.1,31454139,chr15-31343984-C-T,rs76500275,-1,C,T,31343984,110155,31257531,31650747,86453
15,ENSG00000259288.1,40218500,chr15-40242758-C-T,rs76650903,1,C,T,40242758,24258,40021892,40415108,220866
15,ENSG00000247982.2,57300365,chr15-57299965-T-A,rs76975836,1,T,A,57299965,400,57103757,57496973,196208
15,ENSG00000259337.2,19973218,chr15-19988969-C-T,rs77117206,-1,C,T,19988969,15751,19776610,20169826,212359
15,ENSG00000261054.1,99131806,chr15-99118115-C-A,rs77358683,-1,C,A,99118115,13691,98935198,99328414,182917
15,ENSG00000187951.5,30658717,chr15-30834732-A-G,rs798084,1,A,G,30834732,176015,30462109,30855325,372623
15,ENSG00000261616.1,99139317,chr15-99253969-A-G,rs8028374,1,A,G,99253969,114652,98942709,99335925,311260
15,ENSG00000260361.1,92781492,chr15-92962419-T-A,rs8032603,-1,T,A,92962419,180927,92584884,92978100,377535
15,ENSG00000260361.1,92781492,chr15-92962419-T-G,rs8032603,-1,T,G,92962419,180927,92584884,92978100,377535
15,ENSG00000259274.1,60529973,chr15-60551386-G-A,rs8033552,1,G,A,60551386,21413,60333365,60726581,218021
15,ENSG00000248508.2,40039264,chr15-40038428-C-T,rs8041057,1,C,T,40038428,836,39842656,40235872,195772
15,ENSG00000258787.1,93431217,chr15-93287388-A-G,rs936679,-1,A,G,93287388,143829,93234609,93627825,52779
15,ENSG00000258895.1,94033658,chr15-94185494-A-G,rs10162947,1,A,G,94185494,151836,93837050,94230266,348444
15,ENSG00000259712.1,52100523,chr15-52159687-G-A,rs10220890,-1,G,A,52159687,59164,51903915,52297131,255772
15,ENSG00000261460.1,72278867,chr15-72355693-T-G,rs10220917,1,T,G,72355693,76826,72082259,72475475,273434
15,ENSG00000260139.1,77894684,chr15-77866551-C-T,rs10468064,1,C,T,77866551,28133,77698076,78091292,168475
15,ENSG00000248508.2,40039264,chr15-40090240-T-C,rs10518679,1,T,C,40090240,50976,39842656,40235872,247584
15,ENSG00000259792.1,77993405,chr15-77985989-A-G,rs10851899,1,A,G,77985989,7416,77796797,78190013,189192
15,ENSG00000259479.2,44861850,chr15-44916471-G-A,rs111769507,-1,G,A,44916471,54621,44665242,45058458,251229
15,ENSG00000259201.1,51901123,chr15-51854488-A-G,rs111967363,-1,A,G,51854488,46635,51704515,52097731,149973
15,ENSG00000259658.1,101745983,chr15-101711790-G-A,rs11247320,-1,G,A,101711790,34193,101549375,101942591,162415
15,ENSG00000189419.5,100350725,chr15-100546155-C-T,rs113028030,-1,C,T,100546155,195430,100154117,100547333,392038
15,ENSG00000259409.1,40088832,chr15-40118639-A-G,rs11630670,1,A,G,40118639,29807,39892224,40285440,226415
15,ENSG00000259520.1,45279251,chr15-45259066-G-A,rs11632920,-1,G,A,45259066,20185,45082643,45475859,176423
15,ENSG00000259461.1,81118340,chr15-81308169-A-T,rs11632978,-1,A,T,81308169,189829,80921732,81314948,386437
15,ENSG00000229212.3,85209871,chr15-85279653-A-G,rs11638110,-1,A,G,85279653,69782,85013263,85406479,266390
15,ENSG00000260382.1,30883231,chr15-30997246-C-A,rs11638295,-1,C,A,30997246,114015,30686623,31079839,310623
15,ENSG00000231409.3,34943080,chr15-34897743-C-T,rs117298567,1,C,T,34897743,45337,34746472,35139688,151271
15,ENSG00000259657.1,59676757,chr15-59632949-T-G,rs117309407,1,T,G,59632949,43808,59480149,59873365,152800
15,ENSG00000261822.1,42569994,chr15-42613142-G-T,rs1197547,-1,G,T,42613142,43148,42373386,42766602,239756
15,ENSG00000174171.3,41892777,chr15-41895294-T-C,rs1197701,1,T,C,41895294,2517,41696169,42089385,199125
15,ENSG00000259308.1,83044368,chr15-82934811-G-A,rs12443081,1,G,A,82934811,109557,82847760,83240976,87051
15,ENSG00000244879.2,50355467,chr15-50329637-C-A,rs12594956,1,C,A,50329637,25830,50158859,50552075,170778
15,ENSG00000259378.1,50944663,chr15-50780118-C-A,rs12595754,1,C,A,50780118,164545,50748055,51141271,32063
15,ENSG00000214432.5,91022621,chr15-91000846-A-G,rs12899811,1,A,G,91000846,21775,90826013,91219229,174833
15,ENSG00000259442.1,82744223,chr15-82741261-T-C,rs12900374,1,T,C,82741261,2962,82547615,82940831,193646
15,ENSG00000259172.1,101295419,chr15-101388580-G-C,rs12900482,1,G,C,101388580,93161,101098811,101492027,289769
15,ENSG00000260689.1,57247893,chr15-57404877-C-T,rs12909385,-1,C,T,57404877,156984,57051285,57444501,353592
15,ENSG00000259363.1,99806991,chr15-99819351-A-G,rs12910753,1,A,G,99819351,12360,99610383,100003599,208968
15,ENSG00000259404.1,84080168,chr15-83929047-C-T,rs1480821,1,C,T,83929047,151121,83883560,84276776,45487
15,ENSG00000246740.2,41972763,chr15-41980513-G-T,rs1630894,1,G,T,41980513,7750,41776155,42169371,204358
15,ENSG00000259704.1,90839641,chr15-90840536-G-C,rs16944923,1,G,C,90840536,895,90643033,91036249,197503
15,ENSG00000259627.1,63071911,chr15-62900533-T-C,rs16946061,-1,T,C,62900533,171378,62875303,63268519,25230
15,ENSG00000260337.1,92596388,chr15-92463423-T-C,rs16946962,-1,T,C,92463423,132965,92399780,92792996,63643
15,ENSG00000243404.1,66446777,chr15-66301610-C-T,rs16949793,-1,C,T,66301610,145167,66250169,66643385,51441
15,ENSG00000261315.1,36617089,chr15-36428599-T-A,rs16963037,1,T,A,36428599,188490,36420481,36813697,8118
15,ENSG00000261375.1,32491586,chr15-32668937-T-C,rs16963345,-1,T,C,32668937,177351,32294978,32688194,373959
15,ENSG00000242327.1,52095295,chr15-52209474-T-C,rs16964770,1,T,C,52209474,114179,51898687,52291903,310787
15,ENSG00000259622.1,82010607,chr15-82062326-C-T,rs16973339,-1,C,T,82062326,51719,81813999,82207215,248327
15,ENSG00000259622.1,82010607,chr15-82062326-C-G,rs16973339,-1,C,G,82062326,51719,81813999,82207215,248327
15,ENSG00000230373.4,84516785,chr15-84618041-C-T,rs16974951,-1,C,T,84618041,101256,84320177,84713393,297864
15,ENSG00000259286.1,68833830,chr15-68667919-C-T,rs17278757,1,C,T,68667919,165911,68637222,69030438,30697
15,ENSG00000261229.1,79844304,chr15-79731845-A-G,rs17280731,-1,A,G,79731845,112459,79647696,80040912,84149
15,ENSG00000260579.1,83114566,chr15-83053307-A-G,rs17507300,-1,A,G,83053307,61259,82917958,83311174,135349
15,ENSG00000259238.1,59688517,chr15-59873923-A-G,rs1816619,1,A,G,59873923,185406,59491909,59885125,382014
15,ENSG00000245750.3,69462993,chr15-69486984-A-G,rs1857744,1,A,G,69486984,23991,69266385,69659601,220599
15,ENSG00000245534.2,60479178,chr15-60502560-C-T,rs1869488,1,C,T,60502560,23382,60282570,60675786,219990
15,ENSG00000259715.1,50360194,chr15-50275579-C-T,rs2114447,-1,C,T,50275579,84615,50163586,50556802,111993
15,ENSG00000255571.2,89378121,chr15-89510836-T-C,rs2119009,1,T,C,89510836,132715,89181513,89574729,329323
15,ENSG00000180953.7,79923702,chr15-79902138-T-C,rs2163005,-1,T,C,79902138,21564,79727094,80120310,175044
15,ENSG00000244251.1,40481315,chr15-40303273-A-C,rs2305646,-1,A,C,40303273,178042,40284707,40677923,18566
15,ENSG00000259187.1,44826540,chr15-44803892-A-G,rs2443979,1,A,G,44803892,22648,44629932,45023148,173960
15,ENSG00000259668.1,51455268,chr15-51390578-G-A,rs2470180,1,G,A,51390578,64690,51258660,51651876,131918
15,ENSG00000214424.4,96756987,chr15-96890850-G-A,rs28502476,1,G,A,96890850,133863,96560379,96953595,330471
15,ENSG00000259340.1,96551381,chr15-96585261-G-T,rs28651426,1,G,T,96585261,33880,96354773,96747989,230488
15,ENSG00000228998.2,90275129,chr15-90360078-A-C,rs28678568,1,A,C,90360078,84949,90078521,90471737,281557
15,ENSG00000177699.4,78978889,chr15-78997095-C-T,rs2870087,1,C,T,78997095,18206,78782281,79175497,214814
15,ENSG00000259248.1,63600795,chr15-63422272-A-G,rs290524,-1,A,G,63422272,178523,63404187,63797403,18085
15,ENSG00000261187.1,72466262,chr15-72275616-G-T,rs2912231,-1,G,T,72275616,190646,72269654,72662870,5962
15,ENSG00000261187.1,72466262,chr15-72275616-G-A,rs2912231,-1,G,A,72275616,190646,72269654,72662870,5962
15,ENSG00000259288.1,40218500,chr15-40113248-G-A,rs2934776,1,G,A,40113248,105252,40021892,40415108,91356
15,ENSG00000260174.1,30044455,chr15-30015359-T-C,rs34826242,1,T,C,30015359,29096,29847847,30241063,167512
15,ENSG00000259343.1,81331911,chr15-81334384-G-A,rs3935740,1,G,A,81334384,2473,81135303,81528519,199081
15,ENSG00000259845.1,30815271,chr15-30743366-T-C,rs3964705,1,T,C,30743366,71905,30618663,31011879,124703
15,ENSG00000259755.1,101086066,chr15-100902797-G-T,rs4246323,-1,G,T,100902797,183269,100889458,101282674,13339
15,ENSG00000259755.1,101086066,chr15-100902797-G-A,rs4246323,-1,G,A,100902797,183269,100889458,101282674,13339
15,ENSG00000259661.1,90921186,chr15-90822992-G-A,rs441399,-1,G,A,90822992,98194,90724578,91117794,98414
15,ENSG00000259583.1,100919391,chr15-100904414-C-T,rs4646680,-1,C,T,100904414,14977,100722783,101115999,181631
15,ENSG00000259577.1,52180028,chr15-52180486-G-T,rs4776010,1,G,T,52180486,458,51983420,52376636,197066
15,ENSG00000260898.1,72782835,chr15-72757881-C-T,rs4777534,1,C,T,72757881,24954,72586227,72979443,171654
15,ENSG00000260266.1,74361552,chr15-74267137-C-G,rs4887125,1,C,G,74267137,94415,74164944,74558160,102193
15,ENSG00000175779.1,38628060,chr15-38662903-G-C,rs4924280,1,G,C,38662903,34843,38431452,38824668,231451
15,ENSG00000259774.1,84422618,chr15-84549675-T-C,rs56232970,1,T,C,84549675,127057,84226010,84619226,323665
15,ENSG00000182625.3,58686411,chr15-58753575-A-G,rs593742,1,A,G,58753575,67164,58489803,58883019,263772
15,ENSG00000258965.1,25928575,chr15-25908174-T-C,rs61993826,-1,T,C,25908174,20401,25731967,26125183,176207
15,ENSG00000261779.1,75212167,chr15-75073352-C-T,rs62029253,-1,C,T,75073352,138815,75015559,75408775,57793
15,ENSG00000243403.1,64592979,chr15-64500697-G-A,rs640005,1,G,A,64500697,92282,64396371,64789587,104326
15,ENSG00000261002.1,42208413,chr15-42102170-A-C,rs645953,1,A,C,42102170,106243,42011805,42405021,90365
15,ENSG00000259327.1,52116574,chr15-52179350-G-T,rs67725996,1,G,T,52179350,62776,51919966,52313182,259384
15,ENSG00000179362.9,45555482,chr15-45658717-C-G,rs677413,1,C,G,45658717,103235,45358874,45752090,299843
15,ENSG00000179362.9,45555482,chr15-45658717-C-T,rs677413,1,C,T,45658717,103235,45358874,45752090,299843
15,ENSG00000259686.1,33012119,chr15-32898112-T-C,rs71462827,1,T,C,32898112,114007,32815511,33208727,82601
15,ENSG00000259315.1,82727425,chr15-82729551-C-T,rs7163840,-1,C,T,82729551,2126,82530817,82924033,198734
15,ENSG00000261616.1,99139317,chr15-99126124-A-G,rs7164548,1,A,G,99126124,13193,98942709,99335925,183415
15,ENSG00000258384.1,90955225,chr15-90811291-G-A,rs7167216,-1,G,A,90811291,143934,90758617,91151833,52674
15,ENSG00000259684.1,50557601,chr15-50420840-A-G,rs7170543,1,A,G,50420840,136761,50360993,50754209,59847
15,ENSG00000259337.2,19973218,chr15-19971047-C-T,rs7170864,-1,C,T,19971047,2171,19776610,20169826,194437
15,ENSG00000260657.1,68277994,chr15-68304789-T-C,rs7174755,-1,T,C,68304789,26795,68081386,68474602,223403
15,ENSG00000260657.1,68277994,chr15-68304789-T-G,rs7174755,-1,T,G,68304789,26795,68081386,68474602,223403
15,ENSG00000259647.1,30045848,chr15-29876778-C-T,rs7178240,-1,C,T,29876778,169070,29849240,30242456,27538
15,ENSG00000259408.1,33856809,chr15-33837156-C-T,rs7182398,-1,C,T,33837156,19653,33660201,34053417,176955
15,ENSG00000259709.1,52124561,chr15-52095248-G-A,rs72732991,1,G,A,52095248,29313,51927953,52321169,167295
15,ENSG00000259426.1,69415029,chr15-69433019-C-T,rs72758418,-1,C,T,69433019,17990,69218421,69611637,214598
15,ENSG00000261054.1,99131806,chr15-99281840-G-A,rs72758808,-1,G,A,99281840,150034,98935198,99328414,346642
15,ENSG00000260776.1,77926825,chr15-77878371-G-A,rs76208732,-1,G,A,77878371,48454,77730217,78123433,148154
15,ENSG00000259581.1,76261690,chr15-76080686-G-A,rs76505651,-1,G,A,76080686,181004,76065082,76458298,15604
15,ENSG00000259236.1,101781989,chr15-101819000-G-A,rs79724132,-1,G,A,101819000,37011,101585381,101978597,233619
15,ENSG00000259655.1,99791127,chr15-99789846-T-C,rs8027079,1,T,C,99789846,1281,99594519,99987735,195327
15,ENSG00000166763.7,43718184,chr15-43627365-T-C,rs8030536,-1,T,C,43627365,90819,43521576,43914792,105789
15,ENSG00000261069.1,25087661,chr15-25042581-A-G,rs8036980,1,A,G,25042581,45080,24891053,25284269,151528
15,ENSG00000259414.1,23293667,chr15-23117883-A-G,rs8040193,-1,A,G,23117883,175784,23097059,23490275,20824
15,ENSG00000214702.5,74098414,chr15-73932852-G-A,rs8041685,-1,G,A,73932852,165562,73901806,74295022,31046
15,ENSG00000259232.1,65475614,chr15-65555584-G-A,rs919999,-1,G,A,65555584,79970,65279006,65672222,276578
15,ENSG00000261043.1,75762405,chr15-75731380-T-C,rs10467951,-1,T,C,75731380,31025,75565797,75959013,165583
15,ENSG00000259668.1,51455268,chr15-51623615-C-T,rs10519313,1,C,T,51623615,168347,51258660,51651876,364955
15,ENSG00000259660.2,101751553,chr15-101737277-G-C,rs1052887,1,G,C,101737277,14276,101554945,101948161,182332
15,ENSG00000261002.1,42208413,chr15-42133673-G-A,rs11070361,1,G,A,42133673,74740,42011805,42405021,121868
15,ENSG00000259187.1,44826540,chr15-44916471-G-A,rs111769507,1,G,A,44916471,89931,44629932,45023148,286539
15,ENSG00000259352.1,45074048,chr15-44916471-G-A,rs111769507,-1,G,A,44916471,157577,44877440,45270656,39031
15,ENSG00000250988.3,82750572,chr15-82750492-T-C,rs1124911,1,T,C,82750492,80,82553964,82947180,196528
15,ENSG00000259274.1,60529973,chr15-60392977-G-A,rs11631777,1,G,A,60392977,136996,60333365,60726581,59612
15,ENSG00000259375.1,85580178,chr15-85536603-A-C,rs11632326,-1,A,C,85536603,43575,85383570,85776786,153033
15,ENSG00000260657.1,68277994,chr15-68463822-G-C,rs11633794,-1,G,C,68463822,185828,68081386,68474602,382436
15,ENSG00000259248.1,63600795,chr15-63487553-T-C,rs11634587,-1,T,C,63487553,113242,63404187,63797403,83366
15,ENSG00000260898.1,72782835,chr15-72889160-G-A,rs117358968,1,G,A,72889160,106325,72586227,72979443,302933
15,ENSG00000261069.1,25087661,chr15-25263518-A-C,rs11857055,1,A,C,25263518,175857,24891053,25284269,372465
15,ENSG00000238244.2,90349197,chr15-90309155-C-A,rs11857445,-1,C,A,90309155,40042,90152589,90545805,156566
15,ENSG00000249839.1,43684339,chr15-43602295-C-T,rs12050645,-1,C,T,43602295,82044,43487731,43880947,114564
15,ENSG00000228992.2,27895704,chr15-28047032-T-C,rs12442147,1,T,C,28047032,151328,27699096,28092312,347936
15,ENSG00000259358.1,31768201,chr15-31578250-T-C,rs12899987,-1,T,C,31578250,189951,31571593,31964809,6657
15,ENSG00000260382.1,30883231,chr15-30730116-A-G,rs12905321,-1,A,G,30730116,153115,30686623,31079839,43493
15,ENSG00000227973.1,43876244,chr15-44055302-T-C,rs12907002,-1,T,C,44055302,179058,43679636,44072852,375666
15,ENSG00000259287.1,33864825,chr15-33729762-T-G,rs12910679,-1,T,G,33729762,135063,33668217,34061433,61545
15,ENSG00000245750.3,69462993,chr15-69572884-C-T,rs1426075,1,C,T,69572884,109891,69266385,69659601,306499
15,ENSG00000259488.1,48331856,chr15-48449799-G-A,rs1426715,-1,G,A,48449799,117943,48135248,48528464,314551
15,ENSG00000261679.1,43268388,chr15-43279265-G-A,rs148818002,-1,G,A,43279265,10877,43071780,43464996,207485
15,ENSG00000259343.1,81331911,chr15-81184647-C-T,rs1509557,1,C,T,81184647,147264,81135303,81528519,49344
15,ENSG00000241362.2,89688243,chr15-89690774-A-G,rs1561725,-1,A,G,89690774,2531,89491635,89884851,199139
15,ENSG00000241362.2,89688243,chr15-89690774-A-C,rs1561725,-1,A,C,89690774,2531,89491635,89884851,199139
15,ENSG00000259686.1,33012119,chr15-33044504-T-A,rs1584956,1,T,A,33044504,32385,32815511,33208727,228993
15,ENSG00000259647.1,30045848,chr15-29993410-A-T,rs16954895,-1,A,T,29993410,52438,29849240,30242456,144170
15,ENSG00000260534.1,72589691,chr15-72534710-A-C,rs16957064,1,A,C,72534710,54981,72393083,72786299,141627
15,ENSG00000223509.3,32536926,chr15-32671555-A-G,rs16964074,-1,A,G,32671555,134629,32340318,32733534,331237
15,ENSG00000259622.1,82010607,chr15-81952462-C-T,rs16973250,-1,C,T,81952462,58145,81813999,82207215,138463
15,ENSG00000218052.3,85270892,chr15-85383609-A-G,rs16977252,-1,A,G,85383609,112717,85074284,85467500,309325
15,ENSG00000259250.1,58587507,chr15-58623239-A-C,rs17236146,1,A,C,58623239,35732,58390899,58784115,232340
15,ENSG00000166104.10,62253235,chr15-62247695-A-G,rs17271570,-1,A,G,62247695,5540,62056627,62449843,191068
15,ENSG00000259732.1,59121034,chr15-59238108-A-G,rs17302233,1,A,G,59238108,117074,58924426,59317642,313682
15,ENSG00000259299.1,29235137,chr15-29383480-T-C,rs17569233,-1,T,C,29383480,148343,29038529,29431745,344951
15,ENSG00000261147.1,90249556,chr15-90347604-G-C,rs1971898,1,G,C,90347604,98048,90052948,90446164,294656
15,ENSG00000259362.2,77525540,chr15-77531189-A-G,rs2055902,1,A,G,77531189,5649,77328932,77722148,202257
15,ENSG00000259684.1,50557601,chr15-50542929-T-C,rs2135452,1,T,C,50542929,14672,50360993,50754209,181936
15,ENSG00000248508.2,40039264,chr15-40030259-C-T,rs2307101,1,C,T,40030259,9005,39842656,40235872,187603
15,ENSG00000259479.2,44861850,chr15-44803892-A-G,rs2443979,-1,A,G,44803892,57958,44665242,45058458,138650
15,ENSG00000259704.1,90839641,chr15-90834020-C-G,rs2532103,1,C,G,90834020,5621,90643033,91036249,190987
15,ENSG00000180953.7,79923702,chr15-79942132-C-T,rs2562747,-1,C,T,79942132,18430,79727094,80120310,215038
15,ENSG00000259883.1,41921417,chr15-42021767-T-C,rs2598465,1,T,C,42021767,100350,41724809,42118025,296958
15,ENSG00000175779.1,38628060,chr15-38713726-C-T,rs2624276,1,C,T,38713726,85666,38431452,38824668,282274
15,ENSG00000175779.1,38628060,chr15-38713726-C-G,rs2624276,1,C,G,38713726,85666,38431452,38824668,282274
15,ENSG00000260490.1,42571927,chr15-42406086-G-A,rs28364509,1,G,A,42406086,165841,42375319,42768535,30767
15,ENSG00000259698.1,21019388,chr15-21024744-C-T,rs28409350,1,C,T,21024744,5356,20822780,21215996,201964
15,ENSG00000260337.1,92596388,chr15-92683598-T-C,rs285732,-1,T,C,92683598,87210,92399780,92792996,283818
15,ENSG00000180229.8,20505462,chr15-20421874-T-C,rs28621737,-1,T,C,20421874,83588,20308854,20702070,113020
15,ENSG00000182397.9,99801179,chr15-99767557-A-G,rs2958959,-1,A,G,99767557,33622,99604571,99997787,162986
15,ENSG00000255571.2,89378121,chr15-89335347-A-G,rs3176149,1,A,G,89335347,42774,89181513,89574729,153834
15,ENSG00000245975.2,58770974,chr15-58954509-G-T,rs34817930,-1,G,T,58954509,183535,58574366,58967582,380143
15,ENSG00000259642.1,79922771,chr15-79739771-G-A,rs372447,1,G,A,79739771,183000,79726163,80119379,13608
15,ENSG00000214432.5,91022621,chr15-91007723-C-G,rs3743447,1,C,G,91007723,14898,90826013,91219229,181710
15,ENSG00000259461.1,81118340,chr15-81279962-A-G,rs4076201,-1,A,G,81279962,161622,80921732,81314948,358230
15,ENSG00000260648.1,40232082,chr15-40304360-C-G,rs4244575,1,C,G,40304360,72278,40035474,40428690,268886
15,ENSG00000259790.1,75322509,chr15-75497103-C-T,rs4299117,-1,C,T,75497103,174594,75125901,75519117,371202
15,ENSG00000259201.1,51901123,chr15-52031306-C-T,rs4491448,-1,C,T,52031306,130183,51704515,52097731,326791
15,ENSG00000259322.1,78293286,chr15-78395583-C-T,rs4516196,1,C,T,78395583,102297,78096678,78489894,298905
15,ENSG00000260139.1,77894684,chr15-77810128-T-C,rs4624134,1,T,C,77810128,84556,77698076,78091292,112052
15,ENSG00000259337.2,19973218,chr15-20007545-G-A,rs4932072,-1,G,A,20007545,34327,19776610,20169826,230935
15,ENSG00000228998.2,90275129,chr15-90309095-G-C,rs4932320,1,G,C,90309095,33966,90078521,90471737,230574
15,ENSG00000259540.1,100558677,chr15-100547738-G-A,rs4965671,1,G,A,100547738,10939,100362069,100755285,185669
15,ENSG00000259755.1,101086066,chr15-101175315-T-G,rs4965803,-1,T,G,101175315,89249,100889458,101282674,285857
15,ENSG00000259751.1,34850395,chr15-34728190-A-G,rs518930,-1,A,G,34728190,122205,34653787,35047003,74403
15,ENSG00000259706.1,99257632,chr15-99396253-C-T,rs56380125,1,C,T,99396253,138621,99061024,99454240,335229
15,ENSG00000234664.1,29730713,chr15-29602873-T-C,rs6416521,1,T,C,29602873,127840,29534105,29927321,68768
15,ENSG00000244879.2,50355467,chr15-50399448-C-T,rs6493440,1,C,T,50399448,43981,50158859,50552075,240589
15,ENSG00000261635.1,36613474,chr15-36423817-T-C,rs6495834,1,T,C,36423817,189657,36416866,36810082,6951
15,ENSG00000259709.1,52124561,chr15-52097240-G-C,rs66742869,1,G,C,52097240,27321,51927953,52321169,169287
15,ENSG00000259232.1,65475614,chr15-65425954-G-A,rs67077161,-1,G,A,65425954,49660,65279006,65672222,146948
15,ENSG00000231169.2,52505191,chr15-52695991-A-G,rs7161887,1,A,G,52695991,190800,52308583,52701799,387408
15,ENSG00000230183.3,56007176,chr15-55938613-A-G,rs7163864,-1,A,G,55938613,68563,55810568,56203784,128045
15,ENSG00000259715.1,50360194,chr15-50370833-A-G,rs7164848,-1,A,G,50370833,10639,50163586,50556802,207247
15,ENSG00000259583.1,100919391,chr15-100948377-T-C,rs7170683,-1,T,C,100948377,28986,100722783,101115999,225594
15,ENSG00000260773.1,66331703,chr15-66310781-G-C,rs7176821,-1,G,C,66310781,20922,66135095,66528311,175686
15,ENSG00000259493.1,79560304,chr15-79674974-G-A,rs7183649,-1,G,A,79674974,114670,79363696,79756912,311278
15,ENSG00000260269.1,75601205,chr15-75464072-T-C,rs72732842,-1,T,C,75464072,137133,75404597,75797813,59475
15,ENSG00000259363.1,99806991,chr15-99844167-G-A,rs72764441,1,G,A,99844167,37176,99610383,100003599,233784
15,ENSG00000259658.1,101745983,chr15-101830769-T-C,rs73489048,-1,T,C,101830769,84786,101549375,101942591,281394
15,ENSG00000259469.1,48729844,chr15-48704508-C-T,rs78430496,-1,C,T,48704508,25336,48533236,48926452,171272
15,ENSG00000259307.1,40300670,chr15-40355876-T-G,rs78611791,1,T,G,40355876,55206,40104062,40497278,251814
15,ENSG00000261375.1,32491586,chr15-32656705-C-T,rs80167305,-1,C,T,32656705,165119,32294978,32688194,361727
15,ENSG00000259179.1,31420128,chr15-31549860-T-C,rs8024005,1,T,C,31549860,129732,31223520,31616736,326340
15,ENSG00000237550.3,82372888,chr15-82247833-A-G,rs8028284,-1,A,G,82247833,125055,82176280,82569496,71553
15,ENSG00000259378.1,50944663,chr15-50803116-C-T,rs8030680,1,C,T,50803116,141547,50748055,51141271,55061
15,ENSG00000259378.1,50944663,chr15-50803116-C-G,rs8030680,1,C,G,50803116,141547,50748055,51141271,55061
15,ENSG00000261687.1,43185141,chr15-43280129-T-G,rs8033666,-1,T,G,43280129,94988,42988533,43381749,291596
15,ENSG00000259205.1,100558954,chr15-100594092-C-G,rs8033689,-1,C,G,100594092,35138,100362346,100755562,231746
15,ENSG00000259627.1,63071911,chr15-63105008-G-A,rs8034945,-1,G,A,63105008,33097,62875303,63268519,229705
15,ENSG00000259678.1,51414097,chr15-51376047-G-A,rs8035834,1,G,A,51376047,38050,51217489,51610705,158558
15,ENSG00000259315.1,82727425,chr15-82732372-G-A,rs8036227,-1,G,A,82732372,4947,82530817,82924033,201555
15,ENSG00000259712.1,52100523,chr15-52175349-C-G,rs8038456,-1,C,G,52175349,74826,51903915,52297131,271434
15,ENSG00000259712.1,52100523,chr15-52175349-C-A,rs8038456,-1,C,A,52175349,74826,51903915,52297131,271434
15,ENSG00000259562.1,78291221,chr15-78291189-C-T,rs876364,-1,C,T,78291189,32,78094613,78487829,196576
15,ENSG00000257647.1,25032047,chr15-24881973-A-G,rs951651,-1,A,G,24881973,150074,24835439,25228655,46534
15,ENSG00000258965.1,25928575,chr15-25797471-T-C,rs9652531,-1,T,C,25797471,131104,25731967,26125183,65504
15,ENSG00000258397.1,20074334,chr15-19939966-G-A,rs9672493,-1,G,A,19939966,134368,19877726,20270942,62240
15,ENSG00000242327.1,52095295,chr15-52074068-G-A,rs9806395,1,G,A,52074068,21227,51898687,52291903,175381
15,ENSG00000259520.1,45279251,chr15-45448014-T-C,rs9806724,-1,T,C,45448014,168763,45082643,45475859,365371
14,ENSG00000258595.1,93138066,chr14-93191091-T-C,rs10135149,1,T,C,93191091,53025,92941458,93334674,249633
14,ENSG00000258430.1,104769349,chr14-104670515-A-G,rs10139247,1,A,G,104670515,98834,104572741,104965957,97774
14,ENSG00000258988.1,67199062,chr14-67076707-A-G,rs10144870,1,A,G,67076707,122355,67002454,67395670,74253
14,ENSG00000258768.1,20264308,chr14-20217764-T-C,rs10145736,-1,T,C,20217764,46544,20067700,20460916,150064
14,ENSG00000260285.1,103529072,chr14-103468884-G-C,rs10151139,-1,G,C,103468884,60188,103332464,103725680,136420
14,ENSG00000211829.2,22462932,chr14-22460708-T-G,rs10162417,1,T,G,22460708,2224,22266324,22659540,194384
14,ENSG00000258301.2,76786724,chr14-76715959-C-T,rs10483877,-1,C,T,76715959,70765,76590116,76983332,125843
14,ENSG00000258504.1,100291118,chr14-100302826-C-T,rs1059264,1,C,T,100302826,11708,100094510,100487726,208316
14,ENSG00000223648.2,106658258,chr14-106490002-T-C,rs112556248,-1,T,C,106490002,168256,106461650,106854866,28352
14,ENSG00000206596.1,34546714,chr14-34710175-G-A,rs115973958,1,G,A,34710175,163461,34350106,34743322,360069
14,ENSG00000206588.1,34556389,chr14-34710175-G-A,rs115973958,-1,G,A,34710175,153786,34359781,34752997,350394
14,ENSG00000259132.1,22982258,chr14-22989947-G-A,rs11624528,-1,G,A,22989947,7689,22785650,23178866,204297
14,ENSG00000258525.1,30889808,chr14-30855989-A-T,rs11626952,-1,A,T,30855989,33819,30693200,31086416,162789
14,ENSG00000259143.1,95185854,chr14-95282674-T-C,rs11628095,-1,T,C,95282674,96820,94989246,95382462,293428
14,ENSG00000259648.1,67615484,chr14-67572172-C-T,rs116547943,1,C,T,67572172,43312,67418876,67812092,153296
14,ENSG00000211945.2,106185394,chr14-106276418-C-T,rs117796724,-1,C,T,106276418,91024,105988786,106382002,287632
14,ENSG00000259515.1,102933574,chr14-102907823-C-A,rs117897999,1,C,A,102907823,25751,102736966,103130182,170857
14,ENSG00000258731.1,53153354,chr14-53040804-T-C,rs11844798,1,T,C,53040804,112550,52956746,53349962,84058
14,ENSG00000211962.2,106511856,chr14-106647657-T-C,rs11848687,-1,T,C,106647657,135801,106315248,106708464,332409
14,ENSG00000259775.1,103332367,chr14-103320219-G-A,rs11850831,-1,G,A,103320219,12148,103135759,103528975,184460
14,ENSG00000260792.1,104665558,chr14-104636500-G-A,rs11851335,-1,G,A,104636500,29058,104468950,104862166,167550
14,ENSG00000258758.1,57040885,chr14-57054171-T-G,rs1189821,1,T,G,57054171,13286,56844277,57237493,209894
14,ENSG00000240837.1,70610086,chr14-70661745-G-A,rs1205239,1,G,A,70661745,51659,70413478,70806694,248267
14,ENSG00000240837.1,70610086,chr14-70661745-G-C,rs1205239,1,G,C,70661745,51659,70413478,70806694,248267
14,ENSG00000258738.1,34874343,chr14-34862622-A-G,rs1208461,1,A,G,34862622,11721,34677735,35070951,184887
14,ENSG00000211892.2,105626066,chr14-105537986-T-G,rs12100587,-1,T,G,105537986,88080,105429458,105822674,108528
14,ENSG00000253755.1,105669843,chr14-105537986-T-G,rs12100587,-1,T,G,105537986,131857,105473235,105866451,64751
14,ENSG00000259086.1,32272301,chr14-32144853-A-C,rs12100688,-1,A,C,32144853,127448,32075693,32468909,69160
14,ENSG00000257285.1,22929613,chr14-22902571-T-C,rs1242631,1,T,C,22902571,27042,22733005,23126221,169566
14,ENSG00000259146.1,71321814,chr14-71170203-C-T,rs12433285,-1,C,T,71170203,151611,71125206,71518422,44997
14,ENSG00000234648.1,98973314,chr14-99027873-A-G,rs1257673,1,A,G,99027873,54559,98776706,99169922,251167
14,ENSG00000258377.1,49623480,chr14-49774943-C-A,rs12590913,-1,C,A,49774943,151463,49426872,49820088,348071
14,ENSG00000213315.4,90766531,chr14-90871455-G-A,rs1286267,1,G,A,90871455,104924,90569923,90963139,301532
14,ENSG00000259153.1,70809697,chr14-70837762-G-A,rs12884068,1,G,A,70837762,28065,70613089,71006305,224673
14,ENSG00000242071.2,69886140,chr14-70042720-A-G,rs12887763,-1,A,G,70042720,156580,69689532,70082748,353188
14,ENSG00000261208.1,52286797,chr14-52340173-A-C,rs12889653,1,A,C,52340173,53376,52090189,52483405,249984
14,ENSG00000243225.1,76968683,chr14-76959734-G-T,rs12889775,1,G,T,76959734,8949,76772075,77165291,187659
14,ENSG00000258602.1,76959638,chr14-76959734-G-T,rs12889775,1,G,T,76959734,96,76763030,77156246,196704
14,ENSG00000237356.1,53217955,chr14-53286116-A-G,rs1424827,1,A,G,53286116,68161,53021347,53414563,264769
14,ENSG00000258807.1,87872291,chr14-87759750-A-G,rs1450713,-1,A,G,87759750,112541,87675683,88068899,84067
14,ENSG00000257275.2,95711747,chr14-95544563-T-G,rs17092670,1,T,G,95544563,167184,95515139,95908355,29424
14,ENSG00000257831.1,31248628,chr14-31082357-A-G,rs17097708,1,A,G,31082357,166271,31052020,31445236,30337
14,ENSG00000258759.1,67799004,chr14-67973494-A-G,rs17104823,1,A,G,67973494,174490,67602396,67995612,371098
14,ENSG00000258526.1,39432607,chr14-39480974-T-A,rs17109296,1,T,A,39480974,48367,39235999,39629215,244975
14,ENSG00000242163.1,81333361,chr14-81297134-G-A,rs17111687,-1,G,A,81297134,36227,81136753,81529969,160381
14,ENSG00000259019.1,44077884,chr14-44138077-A-G,rs17114728,-1,A,G,44138077,60193,43881276,44274492,256801
14,ENSG00000258760.1,65302680,chr14-65407412-T-G,rs17246035,-1,T,G,65407412,104732,65106072,65499288,301340
14,ENSG00000258427.1,60397757,chr14-60262865-C-G,rs17256073,1,C,G,60262865,134892,60201149,60594365,61716
14,ENSG00000258572.1,95516136,chr14-95517638-G-A,rs179145,1,G,A,95517638,1502,95319528,95712744,198110
14,ENSG00000258843.1,50821880,chr14-50879841-G-A,rs1953877,1,G,A,50879841,57961,50625272,51018488,254569
14,ENSG00000258867.1,88024550,chr14-88021345-C-A,rs2119704,1,C,A,88021345,3205,87827942,88221158,193403
14,ENSG00000258610.1,76778952,chr14-76857439-G-A,rs2272590,1,G,A,76857439,78487,76582344,76975560,275095
14,ENSG00000259116.1,64540368,chr14-64698372-T-C,rs229603,-1,T,C,64698372,158004,64343760,64736976,354612
14,ENSG00000259084.1,95663256,chr14-95670438-C-A,rs2296310,1,C,A,95670438,7182,95466648,95859864,203790
14,ENSG00000187621.10,95651178,chr14-95670438-C-A,rs2296310,1,C,A,95670438,19260,95454570,95847786,215868
14,ENSG00000257621.2,58298129,chr14-58386422-C-T,rs2348075,-1,C,T,58386422,88293,58101521,58494737,284901
14,ENSG00000260711.1,91759798,chr14-91856072-T-C,rs2402076,-1,T,C,91856072,96274,91563190,91956406,292882
14,ENSG00000258811.1,104842663,chr14-104816822-C-T,rs2498778,1,C,T,104816822,25841,104646055,105039271,170767
14,ENSG00000258701.1,104821201,chr14-104816822-C-T,rs2498778,1,C,T,104816822,4379,104624593,105017809,192229
14,ENSG00000244270.1,49577794,chr14-49619845-C-T,rs3007030,-1,C,T,49619845,42051,49381186,49774402,238659
14,ENSG00000240023.1,35389069,chr14-35405648-T-C,rs3138053,-1,T,C,35405648,16579,35192461,35585677,213187
14,ENSG00000258940.1,39267061,chr14-39364480-C-A,rs34894621,-1,C,A,39364480,97419,39070453,39463669,294027
14,ENSG00000258445.1,60779978,chr14-60774640-T-G,rs4151179,1,T,G,60774640,5338,60583370,60976586,191270
14,ENSG00000259081.1,76781518,chr14-76743056-G-A,rs4903482,-1,G,A,76743056,38462,76584910,76978126,158146
14,ENSG00000246548.2,77041064,chr14-77053807-G-A,rs59111874,1,G,A,77053807,12743,76844456,77237672,209351
14,ENSG00000257171.1,18412264,chr14-18488398-G-A,rs61970557,-1,G,A,18488398,76134,18215656,18608872,272742
14,ENSG00000243730.2,36578005,chr14-36651924-A-G,rs6571757,-1,A,G,36651924,73919,36381397,36774613,270527
14,ENSG00000258623.1,68685565,chr14-68683145-A-G,rs6573851,-1,A,G,68683145,2420,68488957,68882173,194188
14,ENSG00000211943.2,106154163,chr14-106042040-T-C,rs7140202,-1,T,C,106042040,112123,105957555,106350771,84485
14,ENSG00000258666.1,100333790,chr14-100488345-C-T,rs7144995,1,C,T,100488345,154555,100137182,100530398,351163
14,ENSG00000177776.8,74378418,chr14-74521984-G-A,rs7145480,-1,G,A,74521984,143566,74181810,74575026,340174
14,ENSG00000258563.1,60179382,chr14-60212390-C-T,rs7156228,1,C,T,60212390,33008,59982774,60375990,229616
14,ENSG00000211965.2,106557477,chr14-106671943-C-T,rs7159651,-1,C,T,106671943,114466,106360869,106754085,311074
14,ENSG00000197358.7,28264554,chr14-28327712-C-T,rs7160556,1,C,T,28327712,63158,28067946,28461162,259766
14,ENSG00000211974.2,106724093,chr14-106530669-C-T,rs72684962,-1,C,T,106530669,193424,106527485,106920701,3184
14,ENSG00000224373.2,106627825,chr14-106715489-T-G,rs72690551,-1,T,G,106715489,87664,106431217,106824433,284272
14,ENSG00000211976.2,106803233,chr14-106827955-C-T,rs72692465,-1,C,T,106827955,24722,106606625,106999841,221330
14,ENSG00000211976.2,106803233,chr14-106827955-C-A,rs72692465,-1,C,A,106827955,24722,106606625,106999841,221330
14,ENSG00000258645.1,63601509,chr14-63540929-A-C,rs72716317,1,A,C,63540929,60580,63404901,63798117,136028
14,ENSG00000247287.2,61322838,chr14-61277744-G-A,rs74541115,-1,G,A,61277744,45094,61126230,61519446,151514
14,ENSG00000259136.1,57044960,chr14-56996685-C-T,rs76098246,-1,C,T,56996685,48275,56848352,57241568,148333
14,ENSG00000258875.1,91242935,chr14-91090351-G-A,rs77314340,1,G,A,91090351,152584,91046327,91439543,44024
14,ENSG00000259004.1,101120840,chr14-101115276-C-T,rs77379184,1,C,T,101115276,5564,100924232,101317448,191044
14,ENSG00000211966.2,106579236,chr14-106698331-C-T,rs79326420,-1,C,T,106698331,119095,106382628,106775844,315703
14,ENSG00000258900.1,58521223,chr14-58534554-C-T,rs8005231,1,C,T,58534554,13331,58324615,58717831,209939
14,ENSG00000259151.1,89291594,chr14-89287612-A-C,rs8013441,-1,A,C,89287612,3982,89094986,89488202,192626
14,ENSG00000258757.1,52640839,chr14-52640964-G-A,rs8013756,1,G,A,52640964,125,52444231,52837447,196733
14,ENSG00000259083.1,39175880,chr14-39095669-A-G,rs8014813,-1,A,G,39095669,80211,38979272,39372488,116397
14,ENSG00000225766.3,24036501,chr14-23934508-G-A,rs8015308,1,G,A,23934508,101993,23839893,24233109,94615
14,ENSG00000258841.1,81661428,chr14-81704599-C-T,rs8016575,1,C,T,81704599,43171,81464820,81858036,239779
14,ENSG00000215256.3,24052509,chr14-23937785-C-T,rs8017928,-1,C,T,23937785,114724,23855901,24249117,81884
14,ENSG00000213176.4,103041469,chr14-103198042-C-T,rs8020964,1,C,T,103198042,156573,102844861,103238077,353181
14,ENSG00000258646.1,75008481,chr14-74937114-G-A,rs887746,-1,G,A,74937114,71367,74811873,75205089,125241
14,ENSG00000239323.1,31463371,chr14-31281491-A-G,rs956810,-1,A,G,31281491,181880,31266763,31659979,14728
14,ENSG00000258985.1,53036755,chr14-52923902-C-T,rs957190,1,C,T,52923902,112853,52840147,53233363,83755
14,ENSG00000258515.1,20451305,chr14-20449506-T-C,rs999692,1,T,C,20449506,1799,20254697,20647913,194809
14,ENSG00000215256.3,24052509,chr14-24063202-G-A,rs1003761,-1,G,A,24063202,10693,23855901,24249117,207301
14,ENSG00000215256.3,24052509,chr14-24063202-G-C,rs1003761,-1,G,C,24063202,10693,23855901,24249117,207301
14,ENSG00000225766.3,24036501,chr14-24063202-G-A,rs1003761,1,G,A,24063202,26701,23839893,24233109,223309
14,ENSG00000225766.3,24036501,chr14-24063202-G-C,rs1003761,1,G,C,24063202,26701,23839893,24233109,223309
14,ENSG00000211950.2,106277043,chr14-106293502-A-G,rs10129879,-1,A,G,106293502,16459,106080435,106473651,213067
14,ENSG00000211974.2,106724093,chr14-106596292-A-G,rs10133734,-1,A,G,106596292,127801,106527485,106920701,68807
14,ENSG00000258629.1,65881070,chr14-66054275-A-G,rs10141580,-1,A,G,66054275,173205,65684462,66077678,369813
14,ENSG00000211966.2,106579236,chr14-106717172-G-A,rs10141910,-1,G,A,106717172,137936,106382628,106775844,334544
14,ENSG00000240837.1,70610086,chr14-70647156-G-A,rs10147181,1,G,A,70647156,37070,70413478,70806694,233678
14,ENSG00000211962.2,106511856,chr14-106693609-G-A,rs10147756,-1,G,A,106693609,181753,106315248,106708464,378361
14,ENSG00000260711.1,91759798,chr14-91824400-A-G,rs10498632,-1,A,G,91824400,64602,91563190,91956406,261210
14,ENSG00000258504.1,100291118,chr14-100300327-G-A,rs10873515,1,G,A,100300327,9209,100094510,100487726,205817
14,ENSG00000258857.1,50397013,chr14-50395275-T-C,rs11157743,1,T,C,50395275,1738,50200405,50593621,194870
14,ENSG00000259115.1,70641204,chr14-70590841-T-C,rs11158869,-1,T,C,70590841,50363,70444596,70837812,146245
14,ENSG00000258807.1,87872291,chr14-87986601-G-A,rs11552556,-1,G,A,87986601,114310,87675683,88068899,310918
14,ENSG00000258457.1,22982698,chr14-23080739-C-T,rs11555803,1,C,T,23080739,98041,22786090,23179306,294649
14,ENSG00000187621.10,95651178,chr14-95664581-G-A,rs116068986,1,G,A,95664581,13403,95454570,95847786,210011
14,ENSG00000211967.2,106593347,chr14-106638118-C-A,rs11621753,-1,C,A,106638118,44771,106396739,106789955,241379
14,ENSG00000258733.1,85934609,chr14-85817407-G-A,rs11622744,1,G,A,85817407,117202,85738001,86131217,79406
14,ENSG00000258733.1,85934609,chr14-85817407-G-T,rs11622744,1,G,T,85817407,117202,85738001,86131217,79406
14,ENSG00000259146.1,71321814,chr14-71447986-G-A,rs11625612,-1,G,A,71447986,126172,71125206,71518422,322780
14,ENSG00000260285.1,103529072,chr14-103459924-G-A,rs117105921,-1,G,A,103459924,69148,103332464,103725680,127460
14,ENSG00000260285.1,103529072,chr14-103459924-G-T,rs117105921,-1,G,T,103459924,69148,103332464,103725680,127460
14,ENSG00000259137.1,44120761,chr14-44132528-C-A,rs118062417,-1,C,A,44132528,11767,43924153,44317369,208375
14,ENSG00000224373.2,106627825,chr14-106647657-T-C,rs11848687,-1,T,C,106647657,19832,106431217,106824433,216440
14,ENSG00000250365.2,31420758,chr14-31458725-C-T,rs11850273,1,C,T,31458725,37967,31224150,31617366,234575
14,ENSG00000256500.3,103562962,chr14-103672302-C-T,rs12432994,1,C,T,103672302,109340,103366354,103759570,305948
14,ENSG00000258471.1,21014822,chr14-21012675-A-G,rs1243440,-1,A,G,21012675,2147,20818214,21211430,194461
14,ENSG00000259019.1,44077884,chr14-44135595-A-C,rs12435371,-1,A,C,44135595,57711,43881276,44274492,254319
14,ENSG00000232573.1,98973301,chr14-99015305-C-A,rs1257644,-1,C,A,99015305,42004,98776693,99169909,238612
14,ENSG00000259318.1,55395233,chr14-55486659-G-A,rs12587011,-1,G,A,55486659,91426,55198625,55591841,288034
14,ENSG00000258731.1,53153354,chr14-53058709-C-T,rs12882412,1,C,T,53058709,94645,52956746,53349962,101963
14,ENSG00000259143.1,95185854,chr14-95345207-C-T,rs12884539,-1,C,T,95345207,159353,94989246,95382462,355961
14,ENSG00000258301.2,76786724,chr14-76597981-C-T,rs1642820,-1,C,T,76597981,188743,76590116,76983332,7865
14,ENSG00000259084.1,95663256,chr14-95674812-C-T,rs17093221,1,C,T,95674812,11556,95466648,95859864,208164
14,ENSG00000257275.2,95711747,chr14-95815860-C-T,rs17093479,1,C,T,95815860,104113,95515139,95908355,300721
14,ENSG00000259116.1,64540368,chr14-64716008-A-G,rs17102000,-1,A,G,64716008,175640,64343760,64736976,372248
14,ENSG00000244053.1,47201104,chr14-47170072-A-G,rs17118127,-1,A,G,47170072,31032,47004496,47397712,165576
14,ENSG00000258458.1,22766457,chr14-22839195-G-A,rs17123091,-1,G,A,22839195,72738,22569849,22963065,269346
14,ENSG00000259151.1,89291594,chr14-89305004-T-A,rs17125653,-1,T,A,89305004,13410,89094986,89488202,210018
14,ENSG00000258908.1,20477089,chr14-20465456-A-G,rs1713460,-1,A,G,20465456,11633,20280481,20673697,184975
14,ENSG00000258900.1,58521223,chr14-58647729-C-T,rs17833004,1,C,T,58647729,126506,58324615,58717831,323114
14,ENSG00000258572.1,95516136,chr14-95518448-T-C,rs179144,1,T,C,95518448,2312,95319528,95712744,198920
14,ENSG00000258525.1,30889808,chr14-30755252-G-A,rs179562,-1,G,A,30755252,134556,30693200,31086416,62052
14,ENSG00000259065.1,73787360,chr14-73829948-T-C,rs1860139,1,T,C,73829948,42588,73590752,73983968,239196
14,ENSG00000258867.1,88024550,chr14-88088265-T-C,rs1887291,1,T,C,88088265,63715,87827942,88221158,260323
14,ENSG00000223648.2,106658258,chr14-106703312-T-C,rs2097578,-1,T,C,106703312,45054,106461650,106854866,241662
14,ENSG00000211972.2,106675544,chr14-106852518-G-A,rs2105992,-1,G,A,106852518,176974,106478936,106872152,373582
14,ENSG00000211829.2,22462932,chr14-22473159-A-C,rs2293732,1,A,C,22473159,10227,22266324,22659540,206835
14,ENSG00000258995.1,63123007,chr14-63211261-A-G,rs2356152,1,A,G,63211261,88254,62926399,63319615,284862
14,ENSG00000258856.1,57629926,chr14-57581964-T-C,rs238389,1,T,C,57581964,47962,57433318,57826534,148646
14,ENSG00000258856.1,57629926,chr14-57581964-T-G,rs238389,1,T,G,57581964,47962,57433318,57826534,148646
14,ENSG00000258701.1,104821201,chr14-104871466-C-T,rs28427389,1,C,T,104871466,50265,104624593,105017809,246873
14,ENSG00000211896.2,105743071,chr14-105731666-C-T,rs28670024,-1,C,T,105731666,11405,105546463,105939679,185203
14,ENSG00000258738.1,34874343,chr14-34868159-T-G,rs3783315,1,T,G,34868159,6184,34677735,35070951,190424
14,ENSG00000258695.2,73522878,chr14-73492108-T-C,rs3813563,1,T,C,73492108,30770,73326270,73719486,165838
14,ENSG00000259371.1,24120956,chr14-24290803-G-A,rs4568,1,G,A,24290803,169847,23924348,24317564,366455
14,ENSG00000211970.2,106639657,chr14-106563047-C-T,rs4636801,-1,C,T,106563047,76610,106443049,106836265,119998
14,ENSG00000259007.1,51969800,chr14-51867871-T-C,rs4901170,-1,T,C,51867871,101929,51773192,52166408,94679
14,ENSG00000258526.1,39432607,chr14-39389737-A-G,rs4902569,1,A,G,39389737,42870,39235999,39629215,153738
14,ENSG00000258602.1,76959638,chr14-76963725-G-C,rs4903522,1,G,C,76963725,4087,76763030,77156246,200695
14,ENSG00000259004.1,101120840,chr14-101291358-C-T,rs4906092,1,C,T,101291358,170518,100924232,101317448,367126
14,ENSG00000260792.1,104665558,chr14-104680242-A-C,rs4983522,-1,A,C,104680242,14684,104468950,104862166,211292
14,ENSG00000213140.2,105673314,chr14-105541979-C-T,rs61983271,-1,C,T,105541979,131335,105476706,105869922,65273
14,ENSG00000242163.1,81333361,chr14-81459714-C-T,rs61986618,-1,C,T,81459714,126353,81136753,81529969,322961
14,ENSG00000257307.1,35881001,chr14-36018459-T-C,rs61988208,1,T,C,36018459,137458,35684393,36077609,334066
14,ENSG00000253209.1,106666532,chr14-106681225-A-C,rs61997606,-1,A,C,106681225,14693,106469924,106863140,211301
14,ENSG00000243225.1,76968683,chr14-76957933-C-T,rs6574343,1,C,T,76957933,10750,76772075,77165291,185858
14,ENSG00000258704.1,34982526,chr14-34933173-G-A,rs712311,-1,G,A,34933173,49353,34785918,35179134,147255
14,ENSG00000258559.1,74294425,chr14-74220026-T-C,rs7140189,-1,T,C,74220026,74399,74097817,74491033,122209
14,ENSG00000224650.2,106811131,chr14-106825769-A-G,rs7140253,-1,A,G,106825769,14638,106614523,107007739,211246
14,ENSG00000258512.1,101730437,chr14-101810391-G-T,rs7143539,1,G,T,101810391,79954,101533829,101927045,276562
14,ENSG00000240954.1,21750269,chr14-21653705-G-A,rs7144733,1,G,A,21653705,96564,21553661,21946877,100044
14,ENSG00000259319.1,75427741,chr14-75482925-G-A,rs7153685,-1,G,A,75482925,55184,75231133,75624349,251792
14,ENSG00000258282.1,28673727,chr14-28745374-T-C,rs7157973,-1,T,C,28745374,71647,28477119,28870335,268255
14,ENSG00000250366.2,95876430,chr14-95803450-C-A,rs7158270,1,C,A,95803450,72980,95679822,96073038,123628
14,ENSG00000251533.2,103189028,chr14-103177491-G-A,rs7161651,-1,G,A,103177491,11537,102992420,103385636,185071
14,ENSG00000213867.4,30821419,chr14-30706367-G-A,rs72666434,1,G,A,30706367,115052,30624811,31018027,81556
14,ENSG00000253132.1,106643585,chr14-106793159-G-A,rs72692452,-1,G,A,106793159,149574,106446977,106840193,346182
14,ENSG00000258920.1,89417354,chr14-89318058-C-T,rs72701658,1,C,T,89318058,99296,89220746,89613962,97312
14,ENSG00000211973.2,106715181,chr14-106645315-T-G,rs74091763,-1,T,G,106645315,69866,106518573,106911789,126742
14,ENSG00000253692.2,105722527,chr14-105612107-C-T,rs75500838,-1,C,T,105612107,110420,105525919,105919135,86188
14,ENSG00000211976.2,106803233,chr14-106679700-C-T,rs756584,-1,C,T,106679700,123533,106606625,106999841,73075
14,ENSG00000258759.1,67799004,chr14-67939436-T-G,rs76351850,1,T,G,67939436,140432,67602396,67995612,337040
14,ENSG00000188831.3,36371412,chr14-36471089-A-C,rs76424069,1,A,C,36471089,99677,36174804,36568020,296285
14,ENSG00000259775.1,103332367,chr14-103348753-G-T,rs8009817,-1,G,T,103348753,16386,103135759,103528975,212994
14,ENSG00000243824.1,34740833,chr14-34777266-A-G,rs8015303,-1,A,G,34777266,36433,34544225,34937441,233041
14,ENSG00000203546.3,31457407,chr14-31543387-G-A,rs8016747,-1,G,A,31543387,85980,31260799,31654015,282588
14,ENSG00000259081.1,76781518,chr14-76651207-A-G,rs850748,-1,A,G,76651207,130311,76584910,76978126,66297
14,ENSG00000260806.1,96502321,chr14-96605213-A-G,rs9323946,-1,A,G,96605213,102892,96305713,96698929,299500
14,ENSG00000258515.1,20451305,chr14-20448799-T-C,rs938883,1,T,C,20448799,2506,20254697,20647913,194102
14,ENSG00000259135.1,34556774,chr14-34647083-G-A,rs9671535,1,G,A,34647083,90309,34360166,34753382,286917
14,ENSG00000258645.1,63601509,chr14-63555490-T-C,rs972984,1,T,C,63555490,46019,63404901,63798117,150589
14,ENSG00000213598.3,58794654,chr14-58945071-A-G,rs983449,1,A,G,58945071,150417,58598046,58991262,347025
14,ENSG00000254718.2,60248765,chr14-60289266-C-T,rs10130695,-1,C,T,60289266,40501,60052157,60445373,237109
14,ENSG00000258605.1,81412970,chr14-81506958-A-T,rs10137272,1,A,T,81506958,93988,81216362,81609578,290596
14,ENSG00000211892.2,105626066,chr14-105818281-C-T,rs10140065,-1,C,T,105818281,192215,105429458,105822674,388823
14,ENSG00000258985.1,53036755,chr14-53010176-T-C,rs10144660,1,T,C,53010176,26579,52840147,53233363,170029
14,ENSG00000259105.1,35468272,chr14-35291878-A-G,rs10144857,1,A,G,35291878,176394,35271664,35664880,20214
14,ENSG00000197358.7,28264554,chr14-28360210-G-A,rs10148497,1,G,A,28360210,95656,28067946,28461162,292264
14,ENSG00000259153.1,70809697,chr14-70843558-A-G,rs1024510,1,A,G,70843558,33861,70613089,71006305,230469
14,ENSG00000259007.1,51969800,chr14-51841596-G-A,rs10498437,-1,G,A,51841596,128204,51773192,52166408,68404
14,ENSG00000258788.1,96223108,chr14-96093122-C-A,rs1062710,1,C,A,96093122,129986,96026500,96419716,66622
14,ENSG00000247092.2,95534642,chr14-95690850-G-A,rs1064017,-1,G,A,95690850,156208,95338034,95731250,352816
14,ENSG00000259079.1,71330738,chr14-71191536-G-T,rs1079823,-1,G,T,71191536,139202,71134130,71527346,57406
14,ENSG00000258701.1,104821201,chr14-104846598-C-T,rs11624762,1,C,T,104846598,25397,104624593,105017809,222005
14,ENSG00000259775.1,103332367,chr14-103290384-A-G,rs11625351,-1,A,G,103290384,41983,103135759,103528975,154625
14,ENSG00000259137.1,44120761,chr14-44150610-T-C,rs11625574,-1,T,C,44150610,29849,43924153,44317369,226457
14,ENSG00000260669.2,24215974,chr14-24108267-G-T,rs11629199,-1,G,T,24108267,107707,24019366,24412582,88901
14,ENSG00000258695.2,73522878,chr14-73367853-G-A,rs117168412,1,G,A,73367853,155025,73326270,73719486,41583
14,ENSG00000240837.1,70610086,chr14-70663076-A-G,rs1205235,1,A,G,70663076,52990,70413478,70806694,249598
14,ENSG00000214770.2,64338639,chr14-64201257-T-C,rs12435376,-1,T,C,64201257,137382,64142031,64535247,59226
14,ENSG00000259045.1,32484800,chr14-32572615-G-A,rs12435734,-1,G,A,32572615,87815,32288192,32681408,284423
14,ENSG00000256385.1,21612381,chr14-21764193-T-C,rs12435882,-1,T,C,21764193,151812,21415773,21808989,348420
14,ENSG00000256350.1,21699151,chr14-21764193-T-C,rs12435882,-1,T,C,21764193,65042,21502543,21895759,261650
14,ENSG00000258759.1,67799004,chr14-67753534-C-T,rs12880908,1,C,T,67753534,45470,67602396,67995612,151138
14,ENSG00000186615.6,55580115,chr14-55613147-G-A,rs12891489,-1,G,A,55613147,33032,55383507,55776723,229640
14,ENSG00000258623.1,68685565,chr14-68637955-A-G,rs12893578,-1,A,G,68637955,47610,68488957,68882173,148998
14,ENSG00000259318.1,55395233,chr14-55541128-T-C,rs12894700,-1,T,C,55541128,145895,55198625,55591841,342503
14,ENSG00000258629.1,65881070,chr14-65977626-C-T,rs1663332,-1,C,T,65977626,96556,65684462,66077678,293164
14,ENSG00000243023.2,58141279,chr14-57979610-A-C,rs17094069,1,A,C,57979610,161669,57944671,58337887,34939
14,ENSG00000213598.3,58794654,chr14-58671193-G-A,rs17094885,1,G,A,58671193,123461,58598046,58991262,73147
14,ENSG00000258655.1,32076793,chr14-32009074-C-T,rs17098429,-1,C,T,32009074,67719,31880185,32273401,128889
14,ENSG00000258515.1,20451305,chr14-20447313-G-A,rs17111837,1,G,A,20447313,3992,20254697,20647913,192616
14,ENSG00000224373.2,106627825,chr14-106822773-T-C,rs17112075,-1,T,C,106822773,194948,106431217,106824433,391556
14,ENSG00000259084.1,95663256,chr14-95673747-G-A,rs1748932,1,G,A,95673747,10491,95466648,95859864,207099
14,ENSG00000257096.1,21521083,chr14-21422524-C-G,rs17792664,1,C,G,21422524,98559,21324475,21717691,98049
14,ENSG00000259019.1,44077884,chr14-44112426-C-T,rs1950548,-1,C,T,44112426,34542,43881276,44274492,231150
14,ENSG00000256243.2,35235651,chr14-35411536-A-C,rs1951269,-1,A,C,35411536,175885,35039043,35432259,372493
14,ENSG00000258956.1,61832369,chr14-61667367-A-G,rs2265402,-1,A,G,61667367,165002,61635761,62028977,31606
14,ENSG00000259116.1,64540368,chr14-64710167-G-A,rs229658,-1,G,A,64710167,169799,64343760,64736976,366407
14,ENSG00000258790.1,35122549,chr14-35161182-A-G,rs2415265,1,A,G,35161182,38633,34925941,35319157,235241
14,ENSG00000211967.2,106593347,chr14-106681046-G-A,rs2516864,-1,G,A,106681046,87699,106396739,106789955,284307
14,ENSG00000258581.1,100366628,chr14-100216112-C-T,rs2757538,1,C,T,100216112,150516,100170020,100563236,46092
14,ENSG00000260792.1,104665558,chr14-104652736-T-C,rs28676628,-1,T,C,104652736,12822,104468950,104862166,183786
14,ENSG00000240392.1,35262462,chr14-35408515-T-C,rs3138045,1,T,C,35408515,146053,35065854,35459070,342661
14,ENSG00000259143.1,95185854,chr14-95346140-G-A,rs4641666,-1,G,A,95346140,160286,94989246,95382462,356894
14,ENSG00000259133.1,56730506,chr14-56651350-T-C,rs4901709,-1,T,C,56651350,79156,56533898,56927114,117452
14,ENSG00000258422.1,70187123,chr14-70224994-A-T,rs4902794,1,A,T,70224994,37871,69990515,70383731,234479
14,ENSG00000258301.2,76786724,chr14-76703143-T-C,rs4903469,-1,T,C,76703143,83581,76590116,76983332,113027
14,ENSG00000250366.2,95876430,chr14-95923031-T-A,rs4905406,1,T,A,95923031,46601,95679822,96073038,243209
14,ENSG00000258702.1,96592766,chr14-96603467-T-C,rs4905508,1,T,C,96603467,10701,96396158,96789374,207309
14,ENSG00000251533.2,103189028,chr14-103362991-A-C,rs4906318,-1,A,C,103362991,173963,102992420,103385636,370571
14,ENSG00000258441.1,21206900,chr14-21102455-A-C,rs4982408,-1,A,C,21102455,104445,21010292,21403508,92163
14,ENSG00000258757.1,52640839,chr14-52691782-T-C,rs5017629,1,T,C,52691782,50943,52444231,52837447,247551
14,ENSG00000211976.2,106803233,chr14-106635737-A-G,rs55742508,-1,A,G,106635737,167496,106606625,106999841,29112
14,ENSG00000260806.1,96502321,chr14-96463250-T-C,rs59137893,-1,T,C,96463250,39071,96305713,96698929,157537
14,ENSG00000211962.2,106511856,chr14-106474734-G-A,rs61999684,-1,G,A,106474734,37122,106315248,106708464,159486
14,ENSG00000244053.1,47201104,chr14-47093812-G-T,rs6572404,-1,G,T,47093812,107292,47004496,47397712,89316
14,ENSG00000244270.1,49577794,chr14-49647114-A-G,rs6572596,-1,A,G,49647114,69320,49381186,49774402,265928
14,ENSG00000258920.1,89417354,chr14-89386550-G-A,rs6575059,1,G,A,89386550,30804,89220746,89613962,165804
14,ENSG00000259230.1,102545254,chr14-102348705-C-T,rs7011,1,C,T,102348705,196549,102348646,102741862,59
14,ENSG00000211974.2,106724093,chr14-106559411-C-A,rs7142635,-1,C,A,106559411,164682,106527485,106920701,31926
14,ENSG00000260711.1,91759798,chr14-91871533-T-C,rs7143288,-1,T,C,91871533,111735,91563190,91956406,308343
14,ENSG00000253209.1,106666532,chr14-106838890-C-G,rs7144404,-1,C,G,106838890,172358,106469924,106863140,368966
14,ENSG00000253209.1,106666532,chr14-106838890-C-T,rs7144404,-1,C,T,106838890,172358,106469924,106863140,368966
14,ENSG00000258512.1,101730437,chr14-101862761-T-C,rs7145618,1,T,C,101862761,132324,101533829,101927045,328932
14,ENSG00000242951.1,75596206,chr14-75540034-A-G,rs7147148,-1,A,G,75540034,56172,75399598,75792814,140436
14,ENSG00000258727.1,23561097,chr14-23714995-G-T,rs7147842,1,G,T,23714995,153898,23364489,23757705,350506
14,ENSG00000259081.1,76781518,chr14-76741298-C-G,rs7148983,-1,C,G,76741298,40220,76584910,76978126,156388
14,ENSG00000258841.1,81661428,chr14-81471543-C-T,rs7152448,1,C,T,81471543,189885,81464820,81858036,6723
14,ENSG00000258572.1,95516136,chr14-95510418-T-G,rs7155612,1,T,G,95510418,5718,95319528,95712744,190890
14,ENSG00000213176.4,103041469,chr14-103094249-T-C,rs7160202,1,T,C,103094249,52780,102844861,103238077,249388
14,ENSG00000223648.2,106658258,chr14-106825455-C-A,rs7161472,-1,C,A,106825455,167197,106461650,106854866,363805
14,ENSG00000223648.2,106658258,chr14-106825455-C-T,rs7161472,-1,C,T,106825455,167197,106461650,106854866,363805
14,ENSG00000258908.1,20477089,chr14-20487118-C-T,rs72672774,-1,C,T,20487118,10029,20280481,20673697,206637
14,ENSG00000224650.2,106811131,chr14-106715489-T-G,rs72690551,-1,T,G,106715489,95642,106614523,107007739,100966
14,ENSG00000211970.2,106639657,chr14-106715489-T-G,rs72690551,-1,T,G,106715489,75832,106443049,106836265,272440
14,ENSG00000260285.1,103529072,chr14-103554117-T-C,rs752624,-1,T,C,103554117,25045,103332464,103725680,221653
14,ENSG00000211891.4,105601728,chr14-105612107-C-T,rs75500838,-1,C,T,105612107,10379,105405120,105798336,206987
14,ENSG00000211973.2,106715181,chr14-106679700-C-T,rs756584,-1,C,T,106679700,35481,106518573,106911789,161127
14,ENSG00000240210.2,68339528,chr14-68482310-C-A,rs76904544,-1,C,A,68482310,142782,68142920,68536136,339390
14,ENSG00000258791.2,55796731,chr14-55977823-G-A,rs77179131,-1,G,A,55977823,181092,55600123,55993339,377700
14,ENSG00000258526.1,39432607,chr14-39568482-G-T,rs77398632,1,G,T,39568482,135875,39235999,39629215,332483
14,ENSG00000258645.1,63601509,chr14-63422807-T-C,rs77780840,1,T,C,63422807,178702,63404901,63798117,17906
14,ENSG00000259146.1,71321814,chr14-71258181-A-G,rs78323721,-1,A,G,71258181,63633,71125206,71518422,132975
14,ENSG00000257171.1,18412264,chr14-18490163-C-T,rs78432465,-1,C,T,18490163,77899,18215656,18608872,274507
14,ENSG00000258987.1,93939497,chr14-94079701-G-C,rs79048773,1,G,C,94079701,140204,93742889,94136105,336812
14,ENSG00000243225.1,76968683,chr14-77097333-G-A,rs79607813,1,G,A,77097333,128650,76772075,77165291,325258
14,ENSG00000258704.1,34982526,chr14-34891017-T-C,rs799685,-1,T,C,34891017,91509,34785918,35179134,105099
14,ENSG00000258940.1,39267061,chr14-39095669-A-G,rs8014813,-1,A,G,39095669,171392,39070453,39463669,25216
14,ENSG00000258602.1,76959638,chr14-77014493-G-T,rs80217144,1,G,T,77014493,54855,76763030,77156246,251463
14,ENSG00000259032.1,82693055,chr14-82888594-G-A,rs8023225,-1,G,A,82888594,195539,82496447,82889663,392147
14,ENSG00000258738.1,34874343,chr14-34890442-T-C,rs811340,1,T,C,34890442,16099,34677735,35070951,212707
14,ENSG00000259136.1,57044960,chr14-56903064-G-A,rs850279,-1,G,A,56903064,141896,56848352,57241568,54712
14,ENSG00000258504.1,100291118,chr14-100315540-A-T,rs9324018,1,A,T,100315540,24422,100094510,100487726,221030
14,ENSG00000258504.1,100291118,chr14-100315540-A-C,rs9324018,1,A,C,100315540,24422,100094510,100487726,221030
13,ENSG00000215515.2,32384660,chr13-32402221-G-A,rs10492397,1,G,A,32402221,17561,32188052,32581268,214169
13,ENSG00000235366.1,45701187,chr13-45877041-G-A,rs113025005,-1,G,A,45877041,175854,45504579,45897795,372462
13,ENSG00000227354.1,79406301,chr13-79314341-T-C,rs1155848,1,T,C,79314341,91960,79209693,79602909,104648
13,ENSG00000232894.1,19570288,chr13-19399665-G-A,rs115985822,-1,G,A,19399665,170623,19373680,19766896,25985
13,ENSG00000206192.7,18871967,chr13-18936342-T-C,rs117190915,-1,T,C,18936342,64375,18675359,19068575,260983
13,ENSG00000247400.2,95676920,chr13-95643377-T-A,rs1197891,-1,T,A,95643377,33543,95480312,95873528,163065
13,ENSG00000224429.1,21348721,chr13-21325070-T-C,rs12584088,-1,T,C,21325070,23651,21152113,21545329,172957
13,ENSG00000236044.1,51966742,chr13-51812144-C-A,rs12864768,1,C,A,51812144,154598,51770134,52163350,42010
13,ENSG00000238121.1,30376971,chr13-30389940-A-C,rs12869586,-1,A,C,30389940,12969,30180363,30573579,209577
13,ENSG00000232378.1,36927219,chr13-36868028-A-G,rs12877189,-1,A,G,36868028,59191,36730611,37123827,137417
13,ENSG00000235500.2,18895230,chr13-19060654-G-A,rs17064065,-1,G,A,19060654,165424,18698622,19091838,362032
13,ENSG00000215417.4,91347820,chr13-91375999-A-G,rs17556717,1,A,G,91375999,28179,91151212,91544428,224787
13,ENSG00000214222.2,41385183,chr13-41308060-C-T,rs2151237,-1,C,T,41308060,77123,41188575,41581791,119485
13,ENSG00000261553.1,75549773,chr13-75569436-T-C,rs2296146,1,T,C,75569436,19663,75353165,75746381,216271
13,ENSG00000234685.1,22915651,chr13-22734301-A-G,rs314880,1,A,G,22734301,181350,22719043,23112259,15258
13,ENSG00000232662.2,113276616,chr13-113123195-A-G,rs3211719,1,A,G,113123195,153421,113080008,113473224,43187
13,ENSG00000205240.3,41432201,chr13-41509635-G-T,rs348226,-1,G,T,41509635,77434,41235593,41628809,274042
13,ENSG00000215480.3,41442770,chr13-41509635-G-T,rs348226,1,G,T,41509635,66865,41246162,41639378,263473
13,ENSG00000238086.3,48320475,chr13-48317700-G-A,rs3825417,-1,G,A,48317700,2775,48123867,48517083,193833
13,ENSG00000225039.1,30422251,chr13-30431005-T-C,rs4769036,-1,T,C,30431005,8754,30225643,30618859,205362
13,ENSG00000232489.1,30542897,chr13-30640089-G-T,rs4769043,-1,G,T,30640089,97192,30346289,30739505,293800
13,ENSG00000260704.1,27953526,chr13-28047294-C-T,rs4771206,1,C,T,28047294,93768,27756918,28150134,290376
13,ENSG00000228444.1,75631271,chr13-75498607-A-G,rs4885301,1,A,G,75498607,132664,75434663,75827879,63944
13,ENSG00000232872.2,51910621,chr13-51835101-T-C,rs621221,-1,T,C,51835101,75520,51714013,52107229,121088
13,ENSG00000260388.1,47932622,chr13-48003049-A-G,rs6561429,-1,A,G,48003049,70427,47736014,48129230,267035
13,ENSG00000233672.1,50910594,chr13-50975421-G-A,rs6561604,-1,G,A,50975421,64827,50713986,51107202,261435
13,ENSG00000227105.1,110936759,chr13-110956379-G-A,rs67298778,1,G,A,110956379,19620,110740151,111133367,216228
13,ENSG00000237636.2,19344825,chr13-19304185-C-T,rs7329022,-1,C,T,19304185,40640,19148217,19541433,155968
13,ENSG00000236834.1,19345049,chr13-19287763-A-G,rs7332299,1,A,G,19287763,57286,19148441,19541657,139322
13,ENSG00000233695.1,113815630,chr13-113824799-C-T,rs7399637,1,C,T,113824799,9169,113619022,114012238,205777
13,ENSG00000237876.1,45688469,chr13-45702881-A-G,rs755428,-1,A,G,45702881,14412,45491861,45885077,211020
13,ENSG00000168852.7,40864352,chr13-40770068-G-A,rs76080821,-1,G,A,40770068,94284,40667744,41060960,102324
13,ENSG00000235280.1,112968824,chr13-112976094-G-A,rs78105344,-1,G,A,112976094,7270,112772216,113165432,203878
13,ENSG00000260509.1,25301438,chr13-25286135-A-C,rs7982860,-1,A,C,25286135,15303,25104830,25498046,181305
13,ENSG00000236778.1,51452364,chr13-51618259-G-A,rs7983294,1,G,A,51618259,165895,51255756,51648972,362503
13,ENSG00000176124.6,50082171,chr13-49928765-T-C,rs7995557,1,T,C,49928765,153406,49885563,50278779,43202
13,ENSG00000233610.1,48590587,chr13-48591739-G-A,rs8002098,-1,G,A,48591739,1152,48393979,48787195,197760
13,ENSG00000225131.1,48771128,chr13-48676905-C-T,rs9285169,1,C,T,48676905,94223,48574520,48967736,102385
13,ENSG00000233532.1,106376573,chr13-106360943-A-G,rs9520040,1,A,G,106360943,15630,106179965,106573181,180978
13,ENSG00000230490.1,33676820,chr13-33676841-T-C,rs9538300,-1,T,C,33676841,21,33480212,33873428,196629
13,ENSG00000236972.1,73100985,chr13-73098144-G-T,rs9543231,-1,G,T,73098144,2841,72904377,73297593,193767
13,ENSG00000225674.1,24123814,chr13-24221434-A-C,rs9580898,-1,A,C,24221434,97620,23927206,24320422,294228
13,ENSG00000235879.1,90170866,chr13-90119341-T-C,rs9583789,1,T,C,90119341,51525,89974258,90367474,145083
13,ENSG00000261105.1,75635994,chr13-75654645-G-A,rs9593109,-1,G,A,75654645,18651,75439386,75832602,215259
13,ENSG00000229696.1,41925598,chr13-41832992-G-C,rs114734228,1,G,C,41832992,92606,41728990,42122206,104002
13,ENSG00000213232.2,63811608,chr13-63793556-C-A,rs115400964,-1,C,A,63793556,18052,63615000,64008216,178556
13,ENSG00000235903.1,46052497,chr13-46044933-C-T,rs116151828,1,C,T,46044933,7564,45855889,46249105,189044
13,ENSG00000230022.1,21530690,chr13-21587666-T-C,rs1200032,1,T,C,21587666,56976,21334082,21727298,253584
13,ENSG00000204718.3,18726706,chr13-18717590-G-T,rs12585423,1,G,T,18717590,9116,18530098,18923314,187492
13,ENSG00000260992.1,99087819,chr13-99044157-T-C,rs12859048,1,T,C,99044157,43662,98891211,99284427,152946
13,ENSG00000235366.1,45701187,chr13-45885024-C-A,rs17067382,-1,C,A,45885024,183837,45504579,45897795,380445
13,ENSG00000232117.1,30159621,chr13-30252110-T-C,rs17803384,-1,T,C,30252110,92489,29963013,30356229,289097
13,ENSG00000234145.1,47763460,chr13-47802440-T-C,rs1886439,1,T,C,47802440,38980,47566852,47960068,235588
13,ENSG00000179611.2,43968424,chr13-43800845-A-G,rs1888303,1,A,G,43800845,167579,43771816,44165032,29029
13,ENSG00000224429.1,21348721,chr13-21330339-A-G,rs2027154,-1,A,G,21330339,18382,21152113,21545329,178226
13,ENSG00000233662.1,98641239,chr13-98704357-C-T,rs2274828,-1,C,T,98704357,63118,98444631,98837847,259726
13,ENSG00000251106.1,46270077,chr13-46343334-G-A,rs2478046,1,G,A,46343334,73257,46073469,46466685,269865
13,ENSG00000176124.6,50082171,chr13-50115946-C-T,rs2760911,1,C,T,50115946,33775,49885563,50278779,230383
13,ENSG00000231473.2,48303489,chr13-48147044-G-A,rs2768789,-1,G,A,48147044,156445,48106881,48500097,40163
13,ENSG00000225674.1,24123814,chr13-24251913-C-T,rs2793491,-1,C,T,24251913,128099,23927206,24320422,324707
13,ENSG00000235280.1,112968824,chr13-112963563-C-T,rs2993346,-1,C,T,112963563,5261,112772216,113165432,191347
13,ENSG00000237636.2,19344825,chr13-19374280-G-A,rs3002071,-1,G,A,19374280,29455,19148217,19541433,226063
13,ENSG00000229473.2,40993331,chr13-41083204-C-T,rs3794330,-1,C,T,41083204,89873,40796723,41189939,286481
13,ENSG00000238286.1,20607268,chr13-20787374-T-C,rs4146442,1,T,C,20787374,180106,20410660,20803876,376714
13,ENSG00000237952.1,22803296,chr13-22740783-T-G,rs4770296,1,T,G,22740783,62513,22606688,22999904,134095
13,ENSG00000215515.2,32384660,chr13-32349553-C-T,rs4942448,1,C,T,32349553,35107,32188052,32581268,161501
13,ENSG00000260910.1,113928991,chr13-113880317-C-T,rs6602901,-1,C,T,113880317,48674,113732383,114125599,147934
13,ENSG00000227590.1,106663437,chr13-106472022-G-T,rs73586125,1,G,T,106472022,191415,106466829,106860045,5193
13,ENSG00000227590.1,106663437,chr13-106472022-G-C,rs73586125,1,G,C,106472022,191415,106466829,106860045,5193
13,ENSG00000233695.1,113815630,chr13-113825489-T-C,rs7399539,1,T,C,113825489,9859,113619022,114012238,206467
13,ENSG00000180172.5,21094714,chr13-21115861-G-A,rs74686907,-1,G,A,21115861,21147,20898106,21291322,217755
13,ENSG00000235472.1,28598833,chr13-28639796-T-C,rs7990417,1,T,C,28639796,40963,28402225,28795441,237571
13,ENSG00000253771.1,24967454,chr13-24878980-G-C,rs79933264,-1,G,C,24878980,88474,24770846,25164062,108134
13,ENSG00000213411.2,30543461,chr13-30358630-C-T,rs7997259,-1,C,T,30358630,184831,30346853,30740069,11777
13,ENSG00000213411.2,30543461,chr13-30358630-C-G,rs7997259,-1,C,G,30358630,184831,30346853,30740069,11777
13,ENSG00000225039.1,30422251,chr13-30305895-T-C,rs9506288,-1,T,C,30305895,116356,30225643,30618859,80252
13,ENSG00000262619.1,22915775,chr13-22731026-G-A,rs9510308,-1,G,A,22731026,184749,22719167,23112383,11859
13,ENSG00000214823.3,39169951,chr13-39219842-C-T,rs9532358,-1,C,T,39219842,49891,38973343,39366559,246499
13,ENSG00000214269.3,64959396,chr13-65096198-T-C,rs9540355,-1,T,C,65096198,136802,64762788,65156004,333410
13,ENSG00000226537.1,67910986,chr13-67828303-A-G,rs9541230,1,A,G,67828303,82683,67714378,68107594,113925
13,ENSG00000203441.2,99501052,chr13-99416013-C-T,rs9557217,-1,C,T,99416013,85039,99304444,99697660,111569
13,ENSG00000205822.5,24408157,chr13-24213810-A-T,rs9578694,1,A,T,24213810,194347,24211549,24604765,2261
13,ENSG00000229800.1,32477274,chr13-32483208-G-T,rs9595617,1,G,T,32483208,5934,32280666,32673882,202542
13,ENSG00000214823.3,39169951,chr13-39293094-G-A,rs111279856,-1,G,A,39293094,123143,38973343,39366559,319751
13,ENSG00000236565.2,65788764,chr13-65837816-G-A,rs118078735,-1,G,A,65837816,49052,65592156,65985372,245660
13,ENSG00000224429.1,21348721,chr13-21334539-A-G,rs12864273,-1,A,G,21334539,14182,21152113,21545329,182426
13,ENSG00000231473.2,48303489,chr13-48172327-T-C,rs12875956,-1,T,C,48172327,131162,48106881,48500097,65446
13,ENSG00000228036.1,37994720,chr13-38123375-A-G,rs17057228,-1,A,G,38123375,128655,37798112,38191328,325263
13,ENSG00000229696.1,41925598,chr13-41996719-A-G,rs17062690,1,A,G,41996719,71121,41728990,42122206,267729
13,ENSG00000232489.1,30542897,chr13-30603637-G-A,rs17074775,-1,G,A,30603637,60740,30346289,30739505,257348
13,ENSG00000235472.1,28598833,chr13-28750396-C-T,rs1974335,1,C,T,28750396,151563,28402225,28795441,348171
13,ENSG00000179611.2,43968424,chr13-43897141-G-T,rs2121038,1,G,T,43897141,71283,43771816,44165032,125325
13,ENSG00000233532.1,106376573,chr13-106473457-T-C,rs2391298,1,T,C,106473457,96884,106179965,106573181,293492
13,ENSG00000213232.2,63811608,chr13-63881032-C-T,rs275903,-1,C,T,63881032,69424,63615000,64008216,266032
13,ENSG00000226361.4,18680494,chr13-18874469-C-A,rs2801739,1,C,A,18874469,193975,18483886,18877102,390583
13,ENSG00000227969.1,67832827,chr13-67865295-C-T,rs288786,-1,C,T,67865295,32468,67636219,68029435,229076
13,ENSG00000261105.1,75635994,chr13-75637352-T-G,rs34050766,-1,T,G,75637352,1358,75439386,75832602,197966
13,ENSG00000227879.2,19227432,chr13-19352368-T-C,rs34788580,-1,T,C,19352368,124936,19030824,19424040,321544
13,ENSG00000229473.2,40993331,chr13-40806227-C-T,rs3783164,-1,C,T,40806227,187104,40796723,41189939,9504
13,ENSG00000233524.1,20748057,chr13-20716717-G-A,rs41445248,-1,G,A,20716717,31340,20551449,20944665,165268
13,ENSG00000238169.1,25168969,chr13-25189527-T-C,rs45455893,1,T,C,25189527,20558,24972361,25365577,217166
13,ENSG00000260388.1,47932622,chr13-47885766-C-T,rs4941615,-1,C,T,47885766,46856,47736014,48129230,149752
13,ENSG00000170919.9,45341483,chr13-45443071-G-A,rs55829994,1,G,A,45443071,101588,45144875,45538091,298196
13,ENSG00000237876.1,45688469,chr13-45707017-G-C,rs6561247,-1,G,C,45707017,18548,45491861,45885077,215156
13,ENSG00000176268.5,40863902,chr13-40776843-G-A,rs7323436,-1,G,A,40776843,87059,40667294,41060510,109549
13,ENSG00000232894.1,19570288,chr13-19586204-G-A,rs74602138,-1,G,A,19586204,15916,19373680,19766896,212524
13,ENSG00000168852.7,40864352,chr13-40776200-C-T,rs7489635,-1,C,T,40776200,88152,40667744,41060960,108456
13,ENSG00000232662.2,113276616,chr13-113143487-A-G,rs753057,1,A,G,113143487,133129,113080008,113473224,63479
13,ENSG00000231856.1,51804297,chr13-51618259-G-A,rs7983294,1,G,A,51618259,186038,51607689,52000905,10570
13,ENSG00000205861.7,23891459,chr13-23799791-C-T,rs7996675,1,C,T,23799791,91668,23694851,24088067,104940
13,ENSG00000177197.7,48328564,chr13-48498429-G-A,rs9332053,-1,G,A,48498429,169865,48131956,48525172,366473
13,ENSG00000237672.1,20072136,chr13-19964438-G-A,rs9508983,-1,G,A,19964438,107698,19875528,20268744,88910
13,ENSG00000237672.1,20072136,chr13-19964438-G-T,rs9508983,-1,G,T,19964438,107698,19875528,20268744,88910
13,ENSG00000233672.1,50910594,chr13-50908576-C-T,rs9535525,-1,C,T,50908576,2018,50713986,51107202,194590
13,ENSG00000232380.1,68985058,chr13-69168131-G-T,rs9541804,1,G,T,69168131,183073,68788450,69181666,379681
13,ENSG00000225039.1,30422251,chr13-30367938-C-G,rs9551895,-1,C,G,30367938,54313,30225643,30618859,142295
13,ENSG00000225039.1,30422251,chr13-30367938-C-T,rs9551895,-1,C,T,30367938,54313,30225643,30618859,142295
13,ENSG00000235438.2,21260032,chr13-21357318-T-C,rs9552414,1,T,C,21357318,97286,21063424,21456640,293894
13,ENSG00000237636.2,19344825,chr13-19398566-C-G,rs9554214,-1,C,G,19398566,53741,19148217,19541433,250349
13,ENSG00000230490.1,33676820,chr13-33655932-A-G,rs9569997,-1,A,G,33655932,20888,33480212,33873428,175720
13,ENSG00000233695.1,113815630,chr13-113812448-A-G,rs9577876,1,A,G,113812448,3182,113619022,114012238,193426
13,ENSG00000226525.3,21629015,chr13-21645331-C-T,rs9578394,-1,C,T,21645331,16316,21432407,21825623,212924
13,ENSG00000215417.4,91347820,chr13-91322486-C-T,rs9589196,1,C,T,91322486,25334,91151212,91544428,171274
13,ENSG00000238213.1,60274776,chr13-60117933-T-C,rs9598088,1,T,C,60117933,156843,60078168,60471384,39765
12,ENSG00000259884.1,52059332,chr12-52183701-C-T,rs10444538,-1,C,T,52183701,124369,51862724,52255940,320977
12,ENSG00000247934.3,28190366,chr12-28115904-T-C,rs10459087,-1,T,C,28115904,74462,27993758,28386974,122146
12,ENSG00000257199.1,76984669,chr12-77055734-T-C,rs10506725,-1,T,C,77055734,71065,76788061,77181277,267673
12,ENSG00000258303.1,93836167,chr12-93857566-T-G,rs10745667,1,T,G,93857566,21399,93639559,94032775,218007
12,ENSG00000258303.1,93836167,chr12-93857566-T-A,rs10745667,1,T,A,93857566,21399,93639559,94032775,218007
12,ENSG00000248593.2,6884898,chr12-6796251-T-C,rs1075835,1,T,C,6796251,88647,6688290,7081506,107961
12,ENSG00000256849.1,19941521,chr12-20077705-A-G,rs10770612,1,A,G,20077705,136184,19744913,20138129,332792
12,ENSG00000212125.2,10965352,chr12-10799577-T-C,rs10772362,-1,T,C,10799577,165775,10768744,11161960,30833
12,ENSG00000256262.1,109053986,chr12-109015862-C-T,rs10774620,-1,C,T,109015862,38124,108857378,109250594,158484
12,ENSG00000257642.1,105327017,chr12-105267126-A-G,rs10778374,-1,A,G,105267126,59891,105130409,105523625,136717
12,ENSG00000257663.1,52082084,chr12-52068035-G-A,rs10783487,-1,G,A,52068035,14049,51885476,52278692,182559
12,ENSG00000255921.1,24949163,chr12-24976081-T-C,rs10842443,1,T,C,24976081,26918,24752555,25145771,223526
12,ENSG00000255966.1,6533498,chr12-6471199-T-C,rs10849465,-1,T,C,6471199,62299,6336890,6730106,134309
12,ENSG00000256364.1,120699501,chr12-120644425-C-T,rs10849774,-1,C,T,120644425,55076,120502893,120896109,141532
12,ENSG00000257222.1,102063355,chr12-102015768-G-T,rs10860831,1,G,T,102015768,47587,101866747,102259963,149021
12,ENSG00000245205.3,19457648,chr12-19455504-C-G,rs11044572,-1,C,G,19455504,2144,19261040,19654256,194464
12,ENSG00000256894.1,26126617,chr12-26272088-T-C,rs11048444,-1,T,C,26272088,145471,25930009,26323225,342079
12,ENSG00000257511.1,32727387,chr12-32560985-T-C,rs11052069,-1,T,C,32560985,166402,32530779,32923995,30206
12,ENSG00000241286.2,110842387,chr12-110885614-G-A,rs11065744,-1,G,A,110885614,43227,110645779,111038995,239835
12,ENSG00000257359.1,113932569,chr12-113874201-G-A,rs11066797,1,G,A,113874201,58368,113735961,114129177,138240
12,ENSG00000257847.1,94590821,chr12-94495948-G-A,rs11107557,1,G,A,94495948,94873,94394213,94787429,101735
12,ENSG00000258308.1,101962414,chr12-101844351-T-C,rs11111055,-1,T,C,101844351,118063,101765806,102159022,78545
12,ENSG00000257557.1,79934901,chr12-79918640-T-C,rs11114270,1,T,C,79918640,16261,79738293,80131509,180347
12,ENSG00000257964.1,49577505,chr12-49519246-A-G,rs11169055,-1,A,G,49519246,58259,49380897,49774113,138349
12,ENSG00000257542.2,52107278,chr12-52175128-T-C,rs11170032,1,T,C,52175128,67850,51910670,52303886,264458
12,ENSG00000213470.4,53633151,chr12-53647408-T-C,rs11170631,-1,T,C,53647408,14257,53436543,53829759,210865
12,ENSG00000256293.1,64338797,chr12-64346798-A-G,rs11175348,-1,A,G,64346798,8001,64142189,64535405,204609
12,ENSG00000257497.1,75489820,chr12-75486226-A-G,rs11180548,-1,A,G,75486226,3594,75293212,75686428,193014
12,ENSG00000257941.1,76057538,chr12-75964368-G-A,rs11180769,1,G,A,75964368,93170,75860930,76254146,103438
12,ENSG00000185684.8,132104021,chr12-132293618-C-T,rs112224861,1,C,T,132293618,189597,131907413,132300629,386205
12,ENSG00000255760.1,31959316,chr12-32113317-A-G,rs1144720,-1,A,G,32113317,154001,31762708,32155924,350609
12,ENSG00000244390.2,59020169,chr12-58849532-G-A,rs1148530,1,G,A,58849532,170637,58823561,59216777,25971
12,ENSG00000247373.2,123585115,chr12-123504325-C-T,rs11522341,-1,C,T,123504325,80790,123388507,123781723,115818
12,ENSG00000250132.1,990041,chr12-918208-A-G,rs11571457,-1,A,G,918208,71833,793433,1186649,124775
12,ENSG00000257242.1,92142671,chr12-91954326-T-C,rs116757761,-1,T,C,91954326,188345,91946063,92339279,8263
12,ENSG00000257539.1,111381867,chr12-111473690-T-A,rs117666960,1,T,A,111473690,91823,111185259,111578475,288431
12,ENSG00000255566.1,64443330,chr12-64511608-G-A,rs11832332,-1,G,A,64511608,68278,64246722,64639938,264886
12,ENSG00000233381.2,31652058,chr12-31668082-T-C,rs11833865,-1,T,C,31668082,16024,31455450,31848666,212632
12,ENSG00000256185.1,26336950,chr12-26440832-G-A,rs11837826,-1,G,A,26440832,103882,26140342,26533558,300490
12,ENSG00000260329.1,106955504,chr12-106951830-C-T,rs12099965,-1,C,T,106951830,3674,106758896,107152112,192934
12,ENSG00000234608.1,111842902,chr12-112039251-T-C,rs12231744,-1,T,C,112039251,196349,111646294,112039510,392957
12,ENSG00000257653.1,48766194,chr12-48779369-T-C,rs12306165,1,T,C,48779369,13175,48569586,48962802,209783
12,ENSG00000205537.2,47882649,chr12-47858356-G-A,rs12308082,1,G,A,47858356,24293,47686041,48079257,172315
12,ENSG00000257872.1,76137425,chr12-76236369-G-A,rs12308795,1,G,A,76236369,98944,75940817,76334033,295552
12,ENSG00000242137.1,120594548,chr12-120437972-T-C,rs12322142,-1,T,C,120437972,156576,120397940,120791156,40032
12,ENSG00000256576.1,132189728,chr12-132200219-T-G,rs12370221,-1,T,G,132200219,10491,131993120,132386336,207099
12,ENSG00000226469.1,111927018,chr12-111887042-T-C,rs12423041,1,T,C,111887042,39976,111730410,112123626,156632
12,ENSG00000255968.1,26318953,chr12-26237386-T-C,rs12424263,1,T,C,26237386,81567,26122345,26515561,115041
12,ENSG00000229186.2,111899263,chr12-111893513-G-A,rs12580246,1,G,A,111893513,5750,111702655,112095871,190858
12,ENSG00000257851.1,51713606,chr12-51630953-C-A,rs12581731,-1,C,A,51630953,82653,51516998,51910214,113955
12,ENSG00000257322.1,93215679,chr12-93394563-A-T,rs12811952,-1,A,T,93394563,178884,93019071,93412287,375492
12,ENSG00000257453.1,76030494,chr12-76182795-T-C,rs12833448,1,T,C,76182795,152301,75833886,76227102,348909
12,ENSG00000257611.1,106170004,chr12-106204692-T-C,rs1465546,1,T,C,106204692,34688,105973396,106366612,231296
12,ENSG00000257261.1,46383652,chr12-46266725-C-T,rs1492888,1,C,T,46266725,116927,46187044,46580260,79681
12,ENSG00000258304.1,76115711,chr12-76288504-A-G,rs1546761,1,A,G,76288504,172793,75919103,76312319,369401
12,ENSG00000261799.1,277123,chr12-305733-C-T,rs16929318,-1,C,T,305733,28610,80515,473731,225218
12,ENSG00000243015.1,93509487,chr12-93579094-A-G,rs17021323,1,A,G,93579094,69607,93312879,93706095,266215
12,ENSG00000212443.1,98599635,chr12-98769318-T-G,rs17028671,1,T,G,98769318,169683,98403027,98796243,366291
12,ENSG00000256128.1,126772411,chr12-126771869-C-T,rs1706506,-1,C,T,126771869,542,126575803,126969019,196066
12,ENSG00000255850.1,63822156,chr12-64008888-A-G,rs17099997,-1,A,G,64008888,186732,63625548,64018764,383340
12,ENSG00000144785.4,56315943,chr12-56273820-T-C,rs17118439,-1,T,C,56273820,42123,56119335,56512551,154485
12,ENSG00000144785.4,56315943,chr12-56273820-T-G,rs17118439,-1,T,G,56273820,42123,56119335,56512551,154485
12,ENSG00000247774.2,47216487,chr12-47280173-A-G,rs17121783,-1,A,G,47280173,63686,47019879,47413095,260294
12,ENSG00000231560.1,9953336,chr12-10013250-T-C,rs17205511,-1,T,C,10013250,59914,9756728,10149944,256522
12,ENSG00000248008.2,120495932,chr12-120474407-G-A,rs17431717,-1,G,A,120474407,21525,120299324,120692540,175083
12,ENSG00000256250.1,130810606,chr12-130821769-C-G,rs17564,1,C,G,130821769,11163,130613998,131007214,207771
12,ENSG00000256988.1,4830747,chr12-4820621-C-T,rs17702448,-1,C,T,4820621,10126,4634139,5027355,186482
12,ENSG00000219410.2,6663260,chr12-6576022-G-A,rs17790300,1,G,A,6576022,87238,6466652,6859868,109370
12,ENSG00000256039.1,10553364,chr12-10510617-C-T,rs17809278,1,C,T,10510617,42747,10356756,10749972,153861
12,ENSG00000256249.1,122687125,chr12-122716221-T-G,rs1798192,1,T,G,122716221,29096,122490517,122883733,225704
12,ENSG00000256249.1,122687125,chr12-122716221-T-C,rs1798192,1,T,C,122716221,29096,122490517,122883733,225704
12,ENSG00000177406.4,642674,chr12-607972-G-A,rs2075032,1,G,A,607972,34702,446066,839282,161906
12,ENSG00000238105.3,100173159,chr12-100049344-A-G,rs2131006,-1,A,G,100049344,123815,99976551,100369767,72793
12,ENSG00000236946.2,68035767,chr12-68017126-T-C,rs2159064,1,T,C,68017126,18641,67839159,68232375,177967
12,ENSG00000260470.1,54147225,chr12-54182016-C-A,rs2233921,-1,C,A,54182016,34791,53950617,54343833,231399
12,ENSG00000248265.1,54058254,chr12-54182016-C-A,rs2233921,1,C,A,54182016,123762,53861646,54254862,320370
12,ENSG00000257176.1,29317848,chr12-29381276-C-A,rs2278093,-1,C,A,29381276,63428,29121240,29514456,260036
12,ENSG00000257150.1,95672305,chr12-95567201-G-A,rs2367360,1,G,A,95567201,105104,95475697,95868913,91504
12,ENSG00000257342.1,57721510,chr12-57723572-T-C,rs238516,-1,T,C,57723572,2062,57524902,57918118,198670
12,ENSG00000260943.1,40142876,chr12-40165260-T-C,rs2708481,-1,T,C,40165260,22384,39946268,40339484,218992
12,ENSG00000239335.4,66130751,chr12-66103089-T-G,rs2870782,1,T,G,66103089,27662,65934143,66327359,168946
12,ENSG00000213942.3,6410013,chr12-6536399-T-C,rs2886093,-1,T,C,6536399,126386,6213405,6606621,322994
12,ENSG00000250742.1,54126191,chr12-54187830-T-C,rs3087404,1,T,C,54187830,61639,53929583,54322799,258247
12,ENSG00000255933.1,131758047,chr12-131628929-C-T,rs34265926,-1,C,T,131628929,129118,131561439,131954655,67490
12,ENSG00000216306.3,94834147,chr12-94844483-G-A,rs34697807,1,G,A,94844483,10336,94637539,95030755,206944
12,ENSG00000196668.3,116533435,chr12-116400950-C-T,rs34787957,1,C,T,116400950,132485,116336827,116730043,64123
12,ENSG00000258168.1,70468085,chr12-70534965-G-A,rs3752702,1,G,A,70534965,66880,70271477,70664693,263488
12,ENSG00000258365.1,94282844,chr12-94294912-A-C,rs3803070,-1,A,C,94294912,12068,94086236,94479452,208676
12,ENSG00000258092.1,2803938,chr12-2827110-A-G,rs3814249,-1,A,G,2827110,23172,2607330,3000546,219780
12,ENSG00000257802.1,71850428,chr12-72032569-G-C,rs41317114,-1,G,C,72032569,182141,71653820,72047036,378749
12,ENSG00000256667.1,10598209,chr12-10559023-C-T,rs4237928,-1,C,T,10559023,39186,10401601,10794817,157422
12,ENSG00000257907.1,43659827,chr12-43780963-C-T,rs4251580,1,C,T,43780963,121136,43463219,43856435,317744
12,ENSG00000241556.1,95467861,chr12-95372141-G-A,rs4762404,-1,G,A,95372141,95720,95271253,95664469,100888
12,ENSG00000261324.1,14767931,chr12-14663846-G-A,rs4764112,-1,G,A,14663846,104085,14571323,14964539,92523
12,ENSG00000255993.1,18692762,chr12-18631318-G-A,rs4764409,1,G,A,18631318,61444,18496154,18889370,135164
12,ENSG00000258302.1,89561129,chr12-89715544-T-C,rs4842499,1,T,C,89715544,154415,89364521,89757737,351023
12,ENSG00000258302.1,89561129,chr12-89715544-T-G,rs4842499,1,T,G,89715544,154415,89364521,89757737,351023
12,ENSG00000256512.1,27800708,chr12-27666629-G-A,rs4931235,-1,G,A,27666629,134079,27604100,27997316,62529
12,ENSG00000213442.4,104265309,chr12-104450407-T-C,rs4964290,1,T,C,104450407,185098,104068701,104461917,381706
12,ENSG00000139239.6,62965325,chr12-62816213-G-A,rs536881,1,G,A,62816213,149112,62768717,63161933,47496
12,ENSG00000245311.2,27446625,chr12-27494449-C-T,rs56656482,-1,C,T,27494449,47824,27250017,27643233,244432
12,ENSG00000205056.6,92466451,chr12-92465694-T-C,rs59692795,1,T,C,92465694,757,92269843,92663059,195851
12,ENSG00000205057.3,92428148,chr12-92432684-C-A,rs61935213,-1,C,A,92432684,4536,92231540,92624756,201144
12,ENSG00000247903.1,26971586,chr12-26962462-C-T,rs6487582,1,C,T,26962462,9124,26774978,27168194,187484
12,ENSG00000258357.1,94521869,chr12-94609582-C-A,rs6538520,-1,C,A,94609582,87713,94325261,94718477,284321
12,ENSG00000260030.1,53754358,chr12-53754445-G-A,rs67551371,1,G,A,53754445,87,53557750,53950966,196695
12,ENSG00000183935.2,13001499,chr12-12945330-T-C,rs7138555,1,T,C,12945330,56169,12804891,13198107,140439
12,ENSG00000256393.1,93083675,chr12-93274943-T-C,rs7296404,-1,T,C,93274943,191268,92887067,93280283,387876
12,ENSG00000258435.1,121391962,chr12-121409332-A-G,rs7296507,1,A,G,121409332,17370,121195354,121588570,213978
12,ENSG00000250654.2,54080288,chr12-53932012-G-T,rs7301643,-1,G,T,53932012,148276,53883680,54276896,48332
12,ENSG00000225422.2,66235234,chr12-66089018-G-A,rs73123449,-1,G,A,66089018,146216,66038626,66431842,50392
12,ENSG00000258244.1,114588194,chr12-114649811-G-T,rs73400697,1,G,T,114649811,61617,114391586,114784802,258225
12,ENSG00000258244.1,114588194,chr12-114649811-G-A,rs73400697,1,G,A,114649811,61617,114391586,114784802,258225
12,ENSG00000256799.1,4636140,chr12-4445382-G-C,rs7358740,-1,G,C,4445382,190758,4439532,4832748,5850
12,ENSG00000256799.1,4636140,chr12-4445382-G-T,rs7358740,-1,G,T,4445382,190758,4439532,4832748,5850
12,ENSG00000242444.2,4110215,chr12-4118082-G-A,rs741245,-1,G,A,4118082,7867,3913607,4306823,204475
12,ENSG00000256274.1,11078242,chr12-11160349-A-C,rs7486717,-1,A,C,11160349,82107,10881634,11274850,278715
12,ENSG00000241680.1,110460988,chr12-110403574-G-A,rs75347070,1,G,A,110403574,57414,110264380,110657596,139194
12,ENSG00000258204.1,98794485,chr12-98873788-T-C,rs759764,1,T,C,98873788,79303,98597877,98991093,275911
12,ENSG00000213235.3,16990670,chr12-16893920-A-G,rs76768530,1,A,G,16893920,96750,16794062,17187278,99858
12,ENSG00000257815.1,70243366,chr12-70198588-G-A,rs76787156,-1,G,A,70198588,44778,70046758,70439974,151830
12,ENSG00000256377.1,27710803,chr12-27699051-C-T,rs76851022,-1,C,T,27699051,11752,27514195,27907411,184856
12,ENSG00000258111.1,104514029,chr12-104553121-T-C,rs77849421,1,T,C,104553121,39092,104317421,104710637,235700
12,ENSG00000247157.2,11556966,chr12-11745611-C-T,rs78245407,1,C,T,11745611,188645,11360358,11753574,385253
12,ENSG00000256663.1,20551590,chr12-20367361-G-T,rs79487310,1,G,T,20367361,184229,20354982,20748198,12379
12,ENSG00000255733.1,67989529,chr12-68012672-C-T,rs7952790,1,C,T,68012672,23143,67792921,68186137,219751
12,ENSG00000257645.1,38533050,chr12-38464929-T-C,rs7962364,-1,T,C,38464929,68121,38336442,38729658,128487
12,ENSG00000213970.3,4324811,chr12-4393244-T-G,rs7967051,-1,T,G,4393244,68433,4128203,4521419,265041
12,ENSG00000258245.1,75689096,chr12-75677113-C-T,rs7967547,-1,C,T,75677113,11983,75492488,75885704,184625
12,ENSG00000258033.1,101066734,chr12-101162948-A-G,rs7969185,1,A,G,101162948,96214,100870126,101263342,292822
12,ENSG00000256742.1,121580792,chr12-121483887-C-T,rs7977709,1,C,T,121483887,96905,121384184,121777400,99703
12,ENSG00000258072.1,107903948,chr12-107848526-A-C,rs7979137,-1,A,C,107848526,55422,107707340,108100556,141186
12,ENSG00000258072.1,107903948,chr12-107848526-A-G,rs7979137,-1,A,G,107848526,55422,107707340,108100556,141186
12,ENSG00000257302.1,70671918,chr12-70796456-T-C,rs79855232,1,T,C,70796456,124538,70475310,70868526,321146
12,ENSG00000257718.1,38906451,chr12-38906939-T-C,rs908511,1,T,C,38906939,488,38709843,39103059,197096
12,ENSG00000257790.1,53153272,chr12-53220726-A-G,rs941139,1,A,G,53220726,67454,52956664,53349880,264062
12,ENSG00000257337.1,53047071,chr12-53103618-A-G,rs9658625,-1,A,G,53103618,56547,52850463,53243679,253155
12,ENSG00000257718.1,38906451,chr12-38900274-C-G,rs10444553,1,C,G,38900274,6177,38709843,39103059,190431
12,ENSG00000248593.2,6884898,chr12-6839528-A-G,rs1047776,1,A,G,6839528,45370,6688290,7081506,151238
12,ENSG00000240399.1,48055253,chr12-48081070-A-G,rs10492081,-1,A,G,48081070,25817,47858645,48251861,222425
12,ENSG00000258449.1,25100980,chr12-25075218-G-A,rs10743536,-1,G,A,25075218,25762,24904372,25297588,170846
12,ENSG00000214198.3,103915867,chr12-103893299-G-A,rs10778301,-1,G,A,103893299,22568,103719259,104112475,174040
12,ENSG00000257576.1,56511002,chr12-56570946-C-A,rs10783793,1,C,A,56570946,59944,56314394,56707610,256552
12,ENSG00000256849.1,19941521,chr12-19972015-A-G,rs10841417,1,A,G,19972015,30494,19744913,20138129,227102
12,ENSG00000245648.1,10363769,chr12-10340383-G-A,rs10845109,1,G,A,10340383,23386,10167161,10560377,173222
12,ENSG00000183935.2,13001499,chr12-12958930-A-G,rs10845684,1,A,G,12958930,42569,12804891,13198107,154039
12,ENSG00000256988.1,4830747,chr12-4683326-T-C,rs10849118,-1,T,C,4683326,147421,4634139,5027355,49187
12,ENSG00000257327.1,103841451,chr12-103859161-C-T,rs10861124,1,C,T,103859161,17710,103644843,104038059,214318
12,ENSG00000257564.1,78794114,chr12-78935385-A-G,rs10861175,-1,A,G,78935385,141271,78597506,78990722,337879
12,ENSG00000258017.1,49130909,chr12-49215383-G-A,rs10875935,1,G,A,49215383,84474,48934301,49327517,281082
12,ENSG00000257302.1,70671918,chr12-70718231-C-T,rs10879188,1,C,T,70718231,46313,70475310,70868526,242921
12,ENSG00000257878.1,95996460,chr12-95975662-G-T,rs1108405,1,G,T,95975662,20798,95799852,96193068,175810
12,ENSG00000257878.1,95996460,chr12-95975662-G-A,rs1108405,1,G,A,95975662,20798,95799852,96193068,175810
12,ENSG00000257433.1,47706085,chr12-47757011-C-T,rs11168227,1,C,T,47757011,50926,47509477,47902693,247534
12,ENSG00000257173.1,38078999,chr12-38257573-G-A,rs11183018,-1,G,A,38257573,178574,37882391,38275607,375182
12,ENSG00000223914.1,40156113,chr12-40287115-T-C,rs11564150,1,T,C,40287115,131002,39959505,40352721,327610
12,ENSG00000256021.1,21448314,chr12-21294002-T-C,rs11568574,-1,T,C,21294002,154312,21251706,21644922,42296
12,ENSG00000221949.2,62603690,chr12-62601502-G-T,rs1157629,-1,G,T,62601502,2188,62407082,62800298,194420
12,ENSG00000257453.1,76030494,chr12-76171719-G-A,rs11611315,1,G,A,76171719,141225,75833886,76227102,337833
12,ENSG00000216306.3,94834147,chr12-94855105-C-G,rs117041355,1,C,G,94855105,20958,94637539,95030755,217566
12,ENSG00000256664.1,68841946,chr12-68944858-G-C,rs117743406,1,G,C,68944858,102912,68645338,69038554,299520
12,ENSG00000256664.1,68841946,chr12-68944858-G-A,rs117743406,1,G,A,68944858,102912,68645338,69038554,299520
12,ENSG00000257668.1,57984761,chr12-57789853-A-G,rs117839344,-1,A,G,57789853,194908,57788153,58181369,1700
12,ENSG00000250790.2,132911470,chr12-132925152-T-C,rs11833667,1,T,C,132925152,13682,132714862,133108078,210290
12,ENSG00000245904.2,92146202,chr12-91992437-G-A,rs11834727,1,G,A,91992437,153765,91949594,92342810,42843
12,ENSG00000245311.2,27446625,chr12-27455826-G-A,rs11836460,-1,G,A,27455826,9201,27250017,27643233,205809
12,ENSG00000256250.1,130810606,chr12-130708062-A-G,rs1209607,1,A,G,130708062,102544,130613998,131007214,94064
12,ENSG00000213270.4,83151331,chr12-83047755-A-C,rs12312826,1,A,C,83047755,103576,82954723,83347939,93032
12,ENSG00000238105.3,100173159,chr12-100088518-C-A,rs12368073,-1,C,A,100088518,84641,99976551,100369767,111967
12,ENSG00000255993.1,18692762,chr12-18804320-C-T,rs12371073,1,C,T,18804320,111558,18496154,18889370,308166
12,ENSG00000257194.1,90107739,chr12-90040749-G-A,rs12423674,1,G,A,90040749,66990,89911131,90304347,129618
12,ENSG00000257194.1,90107739,chr12-90040749-G-C,rs12423674,1,G,C,90040749,66990,89911131,90304347,129618
12,ENSG00000258204.1,98794485,chr12-98837716-G-A,rs12423961,1,G,A,98837716,43231,98597877,98991093,239839
12,ENSG00000212443.1,98599635,chr12-98663074-T-C,rs12581724,1,T,C,98663074,63439,98403027,98796243,260047
12,ENSG00000242314.1,31948334,chr12-31954032-C-T,rs1259866,1,C,T,31954032,5698,31751726,32144942,202306
12,ENSG00000256283.1,15255823,chr12-15242859-C-T,rs1479409,-1,C,T,15242859,12964,15059215,15452431,183644
12,ENSG00000198134.2,12111163,chr12-12052548-G-A,rs1641714,1,G,A,12052548,58615,11914555,12307771,137993
12,ENSG00000257405.1,42637111,chr12-42533529-G-A,rs1669943,-1,G,A,42533529,103582,42440503,42833719,93026
12,ENSG00000258099.1,111599498,chr12-111571464-T-C,rs16941580,1,T,C,111571464,28034,111402890,111796106,168574
12,ENSG00000189238.4,126723416,chr12-126771869-C-T,rs1706506,1,C,T,126771869,48453,126526808,126920024,245061
12,ENSG00000258352.1,47135901,chr12-47109180-A-G,rs17097599,-1,A,G,47109180,26721,46939293,47332509,169887
12,ENSG00000213470.4,53633151,chr12-53709118-A-G,rs17101993,-1,A,G,53709118,75967,53436543,53829759,272575
12,ENSG00000260030.1,53754358,chr12-53761952-C-G,rs17102640,1,C,G,53761952,7594,53557750,53950966,204202
12,ENSG00000257480.1,89752913,chr12-89876000-C-T,rs17192317,1,C,T,89876000,123087,89556305,89949521,319695
12,ENSG00000258311.1,55716036,chr12-55736019-C-T,rs1725357,1,C,T,55736019,19983,55519428,55912644,216591
12,ENSG00000257261.1,46383652,chr12-46385098-G-T,rs1948425,1,G,T,46385098,1446,46187044,46580260,198054
12,ENSG00000258308.1,101962414,chr12-101788403-G-A,rs2108694,-1,G,A,101788403,174011,101765806,102159022,22597
12,ENSG00000247853.2,6578622,chr12-6748960-G-A,rs2302371,1,G,A,6748960,170338,6382014,6775230,366946
12,ENSG00000240087.2,68553882,chr12-68537280-T-C,rs2439757,-1,T,C,68537280,16602,68357274,68750490,180006
12,ENSG00000257557.1,79934901,chr12-79847048-C-T,rs2456018,1,C,T,79847048,87853,79738293,80131509,108755
12,ENSG00000256742.1,121580792,chr12-121559511-C-T,rs28698384,1,C,T,121559511,21281,121384184,121777400,175327
12,ENSG00000256356.1,4097451,chr12-4287540-C-T,rs3217847,1,C,T,4287540,190089,3900843,4294059,386697
12,ENSG00000258177.1,96223973,chr12-96161293-C-T,rs34600,-1,C,T,96161293,62680,96027365,96420581,133928
12,ENSG00000257839.1,76032658,chr12-76095798-C-G,rs34803467,1,C,G,76095798,63140,75836050,76229266,259748
12,ENSG00000258317.1,56129619,chr12-56220056-A-C,rs35382885,-1,A,C,56220056,90437,55933011,56326227,287045
12,ENSG00000257176.1,29317848,chr12-29349008-A-G,rs3764952,-1,A,G,29349008,31160,29121240,29514456,227768
12,ENSG00000260943.1,40142876,chr12-40127691-A-C,rs4533099,-1,A,C,40127691,15185,39946268,40339484,181423
12,ENSG00000258244.1,114588194,chr12-114734845-A-G,rs4614503,1,A,G,114734845,146651,114391586,114784802,343259
12,ENSG00000256234.1,26335856,chr12-26487624-C-T,rs4964002,-1,C,T,26487624,151768,26139248,26532464,348376
12,ENSG00000247903.1,26971586,chr12-27112084-T-C,rs4964041,1,T,C,27112084,140498,26774978,27168194,337106
12,ENSG00000257642.1,105327017,chr12-105282031-T-C,rs4964353,-1,T,C,105282031,44986,105130409,105523625,151622
12,ENSG00000258136.1,107736589,chr12-107641783-G-A,rs4964600,1,G,A,107641783,94806,107539981,107933197,101802
12,ENSG00000123009.3,120282303,chr12-120123451-G-C,rs55641680,1,G,C,120123451,158852,120085695,120478911,37756
12,ENSG00000257195.1,92883773,chr12-92954524-G-A,rs56404232,1,G,A,92954524,70751,92687165,93080381,267359
12,ENSG00000213352.3,62755227,chr12-62807485-T-C,rs564501,1,T,C,62807485,52258,62558619,62951835,248866
12,ENSG00000213352.3,62755227,chr12-62807485-T-G,rs564501,1,T,G,62807485,52258,62558619,62951835,248866
12,ENSG00000234925.2,68642993,chr12-68772675-G-A,rs58381281,-1,G,A,68772675,129682,68446385,68839601,326290
12,ENSG00000256576.1,132189728,chr12-132179556-G-A,rs59348626,-1,G,A,132179556,10172,131993120,132386336,186436
12,ENSG00000205537.2,47882649,chr12-47872761-C-G,rs61919100,1,C,G,47872761,9888,47686041,48079257,186720
12,ENSG00000257322.1,93215679,chr12-93121746-C-T,rs6538387,-1,C,T,93121746,93933,93019071,93412287,102675
12,ENSG00000248265.1,54058254,chr12-54167780-T-C,rs6580976,1,T,C,54167780,109526,53861646,54254862,306134
12,ENSG00000260470.1,54147225,chr12-54167780-T-C,rs6580976,-1,T,C,54167780,20555,53950617,54343833,217163
12,ENSG00000212125.2,10965352,chr12-10836466-C-T,rs666841,-1,C,T,10836466,128886,10768744,11161960,67722
12,ENSG00000256249.1,122687125,chr12-122728193-A-G,rs7131791,1,A,G,122728193,41068,122490517,122883733,237676
12,ENSG00000226982.4,89500093,chr12-89308292-C-T,rs7294734,1,C,T,89308292,191801,89303485,89696701,4807
12,ENSG00000256682.1,10895882,chr12-10929812-A-G,rs73042395,-1,A,G,10929812,33930,10699274,11092490,230538
12,ENSG00000256039.1,10553364,chr12-10552783-T-C,rs7305642,1,T,C,10552783,581,10356756,10749972,196027
12,ENSG00000258435.1,121391962,chr12-121432263-C-T,rs7316497,1,C,T,121432263,40301,121195354,121588570,236909
12,ENSG00000258334.1,49324576,chr12-49215103-C-A,rs74091020,-1,C,A,49215103,109473,49127968,49521184,87135
12,ENSG00000243663.1,1758011,chr12-1569270-G-A,rs74750890,-1,G,A,1569270,188741,1561403,1954619,7867
12,ENSG00000255882.1,9867027,chr12-9867697-T-C,rs75257612,1,T,C,9867697,670,9670419,10063635,197278
12,ENSG00000256667.1,10598209,chr12-10508918-C-T,rs75462134,-1,C,T,10508918,89291,10401601,10794817,107317
12,ENSG00000236946.2,68035767,chr12-67965406-C-T,rs75733598,1,C,T,67965406,70361,67839159,68232375,126247
12,ENSG00000242444.2,4110215,chr12-4056145-G-C,rs763417,-1,G,C,4056145,54070,3913607,4306823,142538
12,ENSG00000256211.1,16989126,chr12-16893920-A-G,rs76768530,1,A,G,16893920,95206,16792518,17185734,101402
12,ENSG00000258072.1,107903948,chr12-107789160-G-A,rs76914484,-1,G,A,107789160,114788,107707340,108100556,81820
12,ENSG00000257354.1,62602752,chr12-62767128-G-A,rs774161,1,G,A,62767128,164376,62406144,62799360,360984
12,ENSG00000255566.1,64443330,chr12-64350587-G-C,rs77897211,-1,G,C,64350587,92743,64246722,64639938,103865
12,ENSG00000257127.1,92421531,chr12-92306591-G-A,rs79090092,1,G,A,92306591,114940,92224923,92618139,81668
12,ENSG00000256708.1,68143318,chr12-68012672-C-T,rs7952790,1,C,T,68012672,130646,67946710,68339926,65962
12,ENSG00000232888.3,132825701,chr12-132760292-A-G,rs7959269,1,A,G,132760292,65409,132629093,133022309,131199
12,ENSG00000256894.1,26126617,chr12-26236309-T-C,rs7959761,-1,T,C,26236309,109692,25930009,26323225,306300
12,ENSG00000256072.1,66257434,chr12-66090549-G-T,rs7966543,-1,G,T,66090549,166885,66060826,66454042,29723
12,ENSG00000257698.1,57936345,chr12-57926317-G-A,rs7968265,-1,G,A,57926317,10028,57739737,58132953,186580
12,ENSG00000258303.1,93836167,chr12-93839977-C-T,rs7968920,1,C,T,93839977,3810,93639559,94032775,200418
12,ENSG00000257681.1,103766906,chr12-103787853-C-T,rs7970553,-1,C,T,103787853,20947,103570298,103963514,217555
12,ENSG00000256393.1,93083675,chr12-93278948-T-G,rs7978088,-1,T,G,93278948,195273,92887067,93280283,391881
12,ENSG00000256420.1,66569194,chr12-66682621-C-T,rs79822461,-1,C,T,66682621,113427,66372586,66765802,310035
12,ENSG00000257342.1,57721510,chr12-57814814-C-T,rs79970417,-1,C,T,57814814,93304,57524902,57918118,289912
12,ENSG00000257921.1,57773053,chr12-57762727-C-T,rs8176351,1,C,T,57762727,10326,57576445,57969661,186282
12,ENSG00000255921.1,24949163,chr12-25037857-G-A,rs859202,1,G,A,25037857,88694,24752555,25145771,285302
12,ENSG00000239617.1,48903813,chr12-48957540-T-G,rs863855,-1,T,G,48957540,53727,48707205,49100421,250335
12,ENSG00000177406.4,642674,chr12-569044-A-G,rs887512,1,A,G,569044,73630,446066,839282,122978
12,ENSG00000256377.1,27710803,chr12-27699497-T-C,rs929952,-1,T,C,27699497,11306,27514195,27907411,185302
12,ENSG00000257740.1,56308868,chr12-56320060-G-A,rs9645801,1,G,A,56320060,11192,56112260,56505476,207800
12,ENSG00000257497.1,75489820,chr12-75467307-G-A,rs10732759,-1,G,A,75467307,22513,75293212,75686428,174095
12,ENSG00000257176.1,29317848,chr12-29332516-G-A,rs10743656,-1,G,A,29332516,14668,29121240,29514456,211276
12,ENSG00000257222.1,102063355,chr12-102232941-T-G,rs10745937,1,T,G,102232941,169586,101866747,102259963,366194
12,ENSG00000257225.1,42459366,chr12-42603742-G-A,rs10785354,1,G,A,42603742,144376,42262758,42655974,340984
12,ENSG00000256667.1,10598209,chr12-10567965-A-G,rs10845165,-1,A,G,10567965,30244,10401601,10794817,166364
12,ENSG00000204603.2,131165011,chr12-131220576-T-C,rs10848315,1,T,C,131220576,55565,130968403,131361619,252173
12,ENSG00000256021.1,21448314,chr12-21355244-T-C,rs11045995,-1,T,C,21355244,93070,21251706,21644922,103538
12,ENSG00000248593.2,6884898,chr12-6757661-T-G,rs11064369,1,T,G,6757661,127237,6688290,7081506,69371
12,ENSG00000238168.3,111581379,chr12-111585879-G-A,rs11065963,1,G,A,111585879,4500,111384771,111777987,201108
12,ENSG00000258179.1,87820918,chr12-88000139-T-C,rs11104711,-1,T,C,88000139,179221,87624310,88017526,375829
12,ENSG00000186076.4,93641586,chr12-93684768-G-A,rs11107149,-1,G,A,93684768,43182,93444978,93838194,239790
12,ENSG00000257718.1,38906451,chr12-39045771-C-A,rs11170498,1,C,A,39045771,139320,38709843,39103059,335928
12,ENSG00000258168.1,70468085,chr12-70646548-T-C,rs11178344,1,T,C,70646548,178463,70271477,70664693,375071
12,ENSG00000258360.1,38207192,chr12-38261430-C-A,rs11183045,-1,C,A,38261430,54238,38010584,38403800,250846
12,ENSG00000256576.1,132189728,chr12-132159685-T-C,rs11246959,-1,T,C,132159685,30043,131993120,132386336,166565
12,ENSG00000257489.1,100199762,chr12-100168698-C-T,rs114732197,-1,C,T,100168698,31064,100003154,100396370,165544
12,ENSG00000256948.1,111850,chr12-239562-C-A,rs11613232,-1,C,A,239562,127712,-84758,308458,324320
12,ENSG00000256185.1,26336950,chr12-26357047-G-A,rs117217310,-1,G,A,26357047,20097,26140342,26533558,216705
12,ENSG00000258308.1,101962414,chr12-101945083-A-G,rs117651251,-1,A,G,101945083,17331,101765806,102159022,179277
12,ENSG00000257645.1,38533050,chr12-38553829-C-T,rs118063258,-1,C,T,38553829,20779,38336442,38729658,217387
12,ENSG00000257405.1,42637111,chr12-42812117-T-C,rs11833302,-1,T,C,42812117,175006,42440503,42833719,371614
12,ENSG00000257642.1,105327017,chr12-105212394-G-A,rs1196761,-1,G,A,105212394,114623,105130409,105523625,81985
12,ENSG00000256250.1,130810606,chr12-130952842-C-T,rs12099711,1,C,T,130952842,142236,130613998,131007214,338844
12,ENSG00000257354.1,62602752,chr12-62440596-G-A,rs12228446,1,G,A,62440596,162156,62406144,62799360,34452
12,ENSG00000257433.1,47706085,chr12-47680836-G-A,rs1237173,1,G,A,47680836,25249,47509477,47902693,171359
12,ENSG00000257815.1,70243366,chr12-70050428-T-A,rs1239913,-1,T,A,70050428,192938,70046758,70439974,3670
12,ENSG00000255850.1,63822156,chr12-63816966-G-A,rs12578452,-1,G,A,63816966,5190,63625548,64018764,191418
12,ENSG00000256987.1,31953889,chr12-31923889-A-G,rs1259771,1,A,G,31923889,30000,31757281,32150497,166608
12,ENSG00000223722.2,31754720,chr12-31944695-T-A,rs1259882,1,T,A,31944695,189975,31558112,31951328,386583
12,ENSG00000255760.1,31959316,chr12-32135930-C-T,rs1260868,-1,C,T,32135930,176614,31762708,32155924,373222
12,ENSG00000245904.2,92146202,chr12-92145814-T-C,rs12694,1,T,C,92145814,388,91949594,92342810,196220
12,ENSG00000258303.1,93836167,chr12-93832795-T-C,rs12825691,1,T,C,93832795,3372,93639559,94032775,193236
12,ENSG00000237176.3,59812102,chr12-59761690-A-G,rs12826693,1,A,G,59761690,50412,59615494,60008710,146196
12,ENSG00000257907.1,43659827,chr12-43809127-A-G,rs13377809,1,A,G,43809127,149300,43463219,43856435,345908
12,ENSG00000258056.1,55729094,chr12-55804652-T-C,rs13378024,1,T,C,55804652,75558,55532486,55925702,272166
12,ENSG00000177406.4,642674,chr12-642142-T-G,rs1471132,1,T,G,642142,532,446066,839282,196076
12,ENSG00000256450.1,16513445,chr12-16545705-T-C,rs16912016,1,T,C,16545705,32260,16316837,16710053,228868
12,ENSG00000242444.2,4110215,chr12-4109201-A-G,rs16931128,-1,A,G,4109201,1014,3913607,4306823,195594
12,ENSG00000256377.1,27710803,chr12-27651779-A-G,rs16932269,-1,A,G,27651779,59024,27514195,27907411,137584
12,ENSG00000230291.3,80103333,chr12-80254189-A-G,rs17006557,-1,A,G,80254189,150856,79906725,80299941,347464
12,ENSG00000257954.1,49389516,chr12-49241295-C-A,rs17123627,1,C,A,49241295,148221,49192908,49586124,48387
12,ENSG00000257210.1,93124543,chr12-92949247-C-T,rs17790417,-1,C,T,92949247,175296,92927935,93321151,21312
12,ENSG00000257261.1,46383652,chr12-46367541-C-T,rs1873793,1,C,T,46367541,16111,46187044,46580260,180497
12,ENSG00000258352.1,47135901,chr12-47121358-G-A,rs1917657,-1,G,A,47121358,14543,46939293,47332509,182065
12,ENSG00000255733.1,67989529,chr12-68067917-G-A,rs2041862,1,G,A,68067917,78388,67792921,68186137,274996
12,ENSG00000250790.2,132911470,chr12-132856158-C-T,rs2062162,1,C,T,132856158,55312,132714862,133108078,141296
12,ENSG00000258177.1,96223973,chr12-96213111-G-A,rs2075362,-1,G,A,96213111,10862,96027365,96420581,185746
12,ENSG00000258357.1,94521869,chr12-94580897-G-A,rs2128892,-1,G,A,94580897,59028,94325261,94718477,255636
12,ENSG00000257803.1,100578744,chr12-100403593-C-A,rs2182621,1,C,A,100403593,175151,100382136,100775352,21457
12,ENSG00000256262.1,109053986,chr12-109197271-T-C,rs2268392,-1,T,C,109197271,143285,108857378,109250594,339893
12,ENSG00000183935.2,13001499,chr12-12941920-C-G,rs2277397,1,C,G,12941920,59579,12804891,13198107,137029
12,ENSG00000213270.4,83151331,chr12-83133769-C-T,rs2292826,1,C,T,83133769,17562,82954723,83347939,179046
12,ENSG00000245614.2,31073786,chr12-31238715-A-C,rs2374041,-1,A,C,31238715,164929,30877178,31270394,361537
12,ENSG00000234040.2,68627187,chr12-68537280-T-C,rs2439757,-1,T,C,68537280,89907,68430579,68823795,106701
12,ENSG00000257878.1,95996460,chr12-96012945-G-T,rs2540495,1,G,T,96012945,16485,95799852,96193068,213093
12,ENSG00000257715.1,96025323,chr12-96129584-T-C,rs2540503,1,T,C,96129584,104261,95828715,96221931,300869
12,ENSG00000256039.1,10553364,chr12-10589758-C-T,rs2607899,1,C,T,10589758,36394,10356756,10749972,233002
12,ENSG00000257779.1,63002469,chr12-63155813-G-C,rs2738250,1,G,C,63155813,153344,62805861,63199077,349952
12,ENSG00000235872.2,67670919,chr12-67629252-G-A,rs34604787,-1,G,A,67629252,41667,67474311,67867527,154941
12,ENSG00000257663.1,52082084,chr12-51905475-G-T,rs3759178,-1,G,T,51905475,176609,51885476,52278692,19999
12,ENSG00000245648.1,10363769,chr12-10559249-T-C,rs4076336,1,T,C,10559249,195480,10167161,10560377,392088
12,ENSG00000258057.1,49828542,chr12-49899426-T-C,rs408045,1,T,C,49899426,70884,49631934,50025150,267492
12,ENSG00000258344.1,54276631,chr12-54342686-A-G,rs4326844,1,A,G,54342686,66055,54080023,54473239,262663
12,ENSG00000213942.3,6410013,chr12-6436445-G-A,rs4469949,-1,G,A,6436445,26432,6213405,6606621,223040
12,ENSG00000250654.2,54080288,chr12-54085283-C-G,rs4759330,-1,C,G,54085283,4995,53883680,54276896,201603
12,ENSG00000256988.1,4830747,chr12-4829151-G-A,rs4766293,-1,G,A,4829151,1596,4634139,5027355,195012
12,ENSG00000256249.1,122687125,chr12-122672004-T-C,rs598322,1,T,C,122672004,15121,122490517,122883733,181487
12,ENSG00000258072.1,107903948,chr12-108083778-C-T,rs61938034,-1,C,T,108083778,179830,107707340,108100556,376438
12,ENSG00000257616.1,52730425,chr12-52650483-C-T,rs638043,1,C,T,52650483,79942,52533817,52927033,116666
12,ENSG00000248008.2,120495932,chr12-120463463-C-T,rs7027,-1,C,T,120463463,32469,120299324,120692540,164139
12,ENSG00000225422.2,66235234,chr12-66082869-C-T,rs7135002,-1,C,T,66082869,152365,66038626,66431842,44243
12,ENSG00000234608.1,111842902,chr12-112010681-T-C,rs7135514,-1,T,C,112010681,167779,111646294,112039510,364387
12,ENSG00000245311.2,27446625,chr12-27391412-C-T,rs7304939,-1,C,T,27391412,55213,27250017,27643233,141395
12,ENSG00000205791.2,12357067,chr12-12397605-G-A,rs7309982,-1,G,A,12397605,40538,12160459,12553675,237146
12,ENSG00000257539.1,111381867,chr12-111236317-T-C,rs73197980,1,T,C,111236317,145550,111185259,111578475,51058
12,ENSG00000257242.1,92142671,chr12-91989774-G-A,rs73218572,-1,G,A,91989774,152897,91946063,92339279,43711
12,ENSG00000241352.1,12850982,chr12-12934127-T-C,rs741433,1,T,C,12934127,83145,12654374,13047590,279753
12,ENSG00000247363.2,68686859,chr12-68684112-T-C,rs751046,-1,T,C,68684112,2747,68490251,68883467,193861
12,ENSG00000258365.1,94282844,chr12-94254770-G-T,rs77277983,-1,G,T,94254770,28074,94086236,94479452,168534
12,ENSG00000248265.1,54058254,chr12-54152901-G-A,rs78995220,1,G,A,54152901,94647,53861646,54254862,291255
12,ENSG00000257964.1,49577505,chr12-49741973-C-T,rs79376950,-1,C,T,49741973,164468,49380897,49774113,361076
12,ENSG00000257964.1,49577505,chr12-49741973-C-A,rs79376950,-1,C,A,49741973,164468,49380897,49774113,361076
12,ENSG00000239374.1,116755874,chr12-116620954-T-C,rs79455749,-1,T,C,116620954,134920,116559266,116952482,61688
12,ENSG00000258283.1,48995150,chr12-49080449-G-T,rs7959831,1,G,T,49080449,85299,48798542,49191758,281907
12,ENSG00000237766.2,67266966,chr12-67141831-G-T,rs7966396,-1,G,T,67141831,125135,67070358,67463574,71473
12,ENSG00000257802.1,71850428,chr12-71695260-A-G,rs7967428,-1,A,G,71695260,155168,71653820,72047036,41440
12,ENSG00000260030.1,53754358,chr12-53854945-G-A,rs7968187,1,G,A,53854945,100587,53557750,53950966,297195
12,ENSG00000236349.1,94548241,chr12-94495988-G-T,rs7972607,1,G,T,94495988,52253,94351633,94744849,144355
12,ENSG00000238105.3,100173159,chr12-100007668-C-T,rs7975540,-1,C,T,100007668,165491,99976551,100369767,31117
12,ENSG00000250742.1,54126191,chr12-54190546-C-T,rs79811812,1,C,T,54190546,64355,53929583,54322799,260963
12,ENSG00000260470.1,54147225,chr12-54190546-C-T,rs79811812,-1,C,T,54190546,43321,53950617,54343833,239929
12,ENSG00000242990.1,57674665,chr12-57764775-C-T,rs8176345,1,C,T,57764775,90110,57478057,57871273,286718
12,ENSG00000255921.1,24949163,chr12-25011432-A-G,rs904090,1,A,G,25011432,62269,24752555,25145771,258877
12,ENSG00000257480.1,89752913,chr12-89607038-T-C,rs957525,1,T,C,89607038,145875,89556305,89949521,50733
12,ENSG00000240759.1,42679124,chr12-42679110-C-T,rs9669733,-1,C,T,42679110,14,42482516,42875732,196594
11,ENSG00000229368.1,3854612,chr11-3912334-T-C,rs10430939,1,T,C,3912334,57722,3658004,4051220,254330
11,ENSG00000196167.5,111305045,chr11-111350557-C-T,rs10502139,-1,C,T,111350557,45512,111108437,111501653,242120
11,ENSG00000255404.1,65797219,chr11-65791795-A-G,rs10791824,-1,A,G,65791795,5424,65600611,65993827,191184
11,ENSG00000254595.1,6489377,chr11-6558309-A-G,rs10839583,-1,A,G,6558309,68932,6292769,6685985,265540
11,ENSG00000255467.1,108121684,chr11-107954513-G-A,rs10890784,-1,G,A,107954513,167171,107925076,108318292,29437
11,ENSG00000247095.2,568449,chr11-570072-T-C,rs10902173,-1,T,C,570072,1623,371841,765057,198231
11,ENSG00000255375.1,32132657,chr11-32224800-C-G,rs11031647,1,C,G,32224800,92143,31936049,32329265,288751
11,ENSG00000225101.3,4474813,chr11-4393849-T-C,rs11032080,1,T,C,4393849,80964,4278205,4671421,115644
11,ENSG00000255521.1,35138032,chr11-35223096-C-A,rs11033031,-1,C,A,35223096,85064,34941424,35334640,281672
11,ENSG00000255498.1,45906461,chr11-45852713-A-G,rs11038689,-1,A,G,45852713,53748,45709853,46103069,142860
11,ENSG00000254860.1,8965048,chr11-8987127-A-G,rs11042148,1,A,G,8987127,22079,8768440,9161656,218687
11,ENSG00000246273.2,9758268,chr11-9640056-G-A,rs11042454,1,G,A,9640056,118212,9561660,9954876,78396
11,ENSG00000246308.1,10809204,chr11-10856137-A-G,rs11042983,1,A,G,10856137,46933,10612596,11005812,243541
11,ENSG00000255045.1,124746337,chr11-124878300-G-A,rs111277969,-1,G,A,124878300,131963,124549729,124942945,328571
11,ENSG00000250397.2,859795,chr11-1006874-G-T,rs111317734,-1,G,T,1006874,147079,663187,1056403,343687
11,ENSG00000256779.1,95037482,chr11-95068375-G-T,rs111408022,1,G,T,95068375,30893,94840874,95234090,227501
11,ENSG00000225215.1,107404589,chr11-107425373-C-A,rs11212225,-1,C,A,107425373,20784,107207981,107601197,217392
11,ENSG00000158483.11,71787537,chr11-71787856-G-A,rs11234944,1,G,A,71787856,319,71590929,71984145,196927
11,ENSG00000246174.2,78139774,chr11-78062880-C-T,rs11237374,1,C,T,78062880,76894,77943166,78336382,119714
11,ENSG00000255010.1,83106961,chr11-83217776-C-G,rs11530859,-1,C,G,83217776,110815,82910353,83303569,307423
11,ENSG00000255299.1,58505758,chr11-58463199-G-A,rs11601742,-1,G,A,58463199,42559,58309150,58702366,154049
11,ENSG00000255299.1,58505758,chr11-58463199-G-T,rs11601742,-1,G,T,58463199,42559,58309150,58702366,154049
11,ENSG00000251226.1,134762557,chr11-134678064-A-G,rs11603224,1,A,G,134678064,84493,134565949,134959165,112115
11,ENSG00000254449.1,123599452,chr11-123644469-T-G,rs11604797,-1,T,G,123644469,45017,123402844,123796060,241625
11,ENSG00000254449.1,123599452,chr11-123644469-T-C,rs11604797,-1,T,C,123644469,45017,123402844,123796060,241625
11,ENSG00000256940.1,64245838,chr11-64240504-C-T,rs11607007,1,C,T,64240504,5334,64049230,64442446,191274
11,ENSG00000255234.1,83286128,chr11-83204756-A-G,rs118059285,1,A,G,83204756,81372,83089520,83482736,115236
11,ENSG00000255084.1,78533176,chr11-78461069-G-A,rs11822363,1,G,A,78461069,72107,78336568,78729784,124501
11,ENSG00000254416.1,110355130,chr11-110330999-T-A,rs11823096,1,T,A,110330999,24131,110158522,110551738,172477
11,ENSG00000254884.1,9311689,chr11-9184732-G-A,rs12099067,-1,G,A,9184732,126957,9115081,9508297,69651
11,ENSG00000255284.1,777574,chr11-772490-G-A,rs12224894,1,G,A,772490,5084,580966,974182,191524
11,ENSG00000236129.1,131187022,chr11-131103970-A-G,rs12270113,1,A,G,131103970,83052,130990414,131383630,113556
11,ENSG00000255240.1,59058659,chr11-58930332-A-G,rs12270298,-1,A,G,58930332,128327,58862051,59255267,68281
11,ENSG00000255070.1,91115961,chr11-91224412-G-A,rs12272833,1,G,A,91224412,108451,90919353,91312569,305059
11,ENSG00000227097.4,82689559,chr11-82828269-C-T,rs12288782,1,C,T,82828269,138710,82492951,82886167,335318
11,ENSG00000238184.1,2377992,chr11-2201683-G-A,rs12292212,-1,G,A,2201683,176309,2181384,2574600,20299
11,ENSG00000224829.3,77313606,chr11-77212307-A-G,rs12418037,1,A,G,77212307,101299,77116998,77510214,95309
11,ENSG00000245148.2,72700474,chr11-72683661-G-A,rs12576058,1,G,A,72683661,16813,72503866,72897082,179795
11,ENSG00000251194.2,35212550,chr11-35208126-T-C,rs1467558,1,T,C,35208126,4424,35015942,35409158,192184
11,ENSG00000247271.2,10858219,chr11-10882223-T-C,rs1554520,1,T,C,10882223,24004,10661611,11054827,220612
11,ENSG00000255042.1,50295334,chr11-50471785-T-G,rs1602115,-1,T,G,50471785,176451,50098726,50491942,373059
11,ENSG00000246067.2,83072066,chr11-83077397-C-T,rs17144544,1,C,T,83077397,5331,82875458,83268674,201939
11,ENSG00000255301.1,57477534,chr11-57660956-G-A,rs17152015,-1,G,A,57660956,183422,57280926,57674142,380030
11,ENSG00000254939.1,98566827,chr11-98638582-T-G,rs17340054,-1,T,G,98638582,71755,98370219,98763435,268363
11,ENSG00000254427.1,45355465,chr11-45447972-C-T,rs17788407,1,C,T,45447972,92507,45158857,45552073,289115
11,ENSG00000254905.1,126294254,chr11-126295862-T-C,rs1786704,-1,T,C,126295862,1608,126097646,126490862,198216
11,ENSG00000254455.1,65145972,chr11-65213512-G-C,rs17882241,-1,G,C,65213512,67540,64949364,65342580,264148
11,ENSG00000254455.1,65145972,chr11-65213512-G-A,rs17882241,-1,G,A,65213512,67540,64949364,65342580,264148
11,ENSG00000254602.1,57638376,chr11-57664585-T-C,rs1798173,1,T,C,57664585,26209,57441768,57834984,222817
11,ENSG00000254589.1,58243097,chr11-58288552-C-T,rs1938644,-1,C,T,58288552,45455,58046489,58439705,242063
11,ENSG00000174370.5,128906044,chr11-128915228-A-G,rs1940455,-1,A,G,128915228,9184,128709436,129102652,205792
11,ENSG00000255455.1,130870247,chr11-130894953-A-G,rs1944148,-1,A,G,130894953,24706,130673639,131066855,221314
11,ENSG00000256469.1,94925521,chr11-94753291-C-T,rs2015016,-1,C,T,94753291,172230,94728913,95122129,24378
11,ENSG00000245522.2,9759533,chr11-9651216-T-C,rs2082807,-1,T,C,9651216,108317,9562925,9956141,88291
11,ENSG00000241170.2,74919587,chr11-74948888-G-A,rs2119028,1,G,A,74948888,29301,74722979,75116195,225909
11,ENSG00000260196.1,17380649,chr11-17277267-A-G,rs214084,1,A,G,17277267,103382,17184041,17577257,93226
11,ENSG00000256035.1,102807916,chr11-102733876-C-T,rs2155053,-1,C,T,102733876,74040,102611308,103004524,122568
11,ENSG00000255026.1,287305,chr11-295876-C-T,rs2242566,1,C,T,295876,8571,90697,483913,205179
11,ENSG00000254966.1,18706537,chr11-18707103-T-C,rs2289965,1,T,C,18707103,566,18509929,18903145,197174
11,ENSG00000244926.2,43920926,chr11-43920636-T-C,rs2292891,-1,T,C,43920636,290,43724318,44117534,196318
11,ENSG00000249489.1,88409223,chr11-88604945-T-C,rs2306153,-1,T,C,88604945,195722,88212615,88605831,392330
11,ENSG00000254911.1,93721513,chr11-93562168-C-T,rs2399685,1,C,T,93562168,159345,93524905,93918121,37263
11,ENSG00000254401.1,11020883,chr11-11172670-A-G,rs2403464,1,A,G,11172670,151787,10824275,11217491,348395
11,ENSG00000255126.1,62393372,chr11-62359022-A-G,rs2463836,-1,A,G,62359022,34350,62196764,62589980,162258
11,ENSG00000254721.1,70207390,chr11-70110559-C-T,rs2509184,-1,C,T,70110559,96831,70010782,70403998,99777
11,ENSG00000254873.1,118401309,chr11-118409221-T-C,rs3194726,-1,T,C,118409221,7912,118204701,118597917,204520
11,ENSG00000257086.1,64249494,chr11-64117275-C-T,rs35247680,-1,C,T,64117275,132219,64052886,64446102,64389
11,ENSG00000256897.1,47221751,chr11-47167041-T-C,rs3740690,-1,T,C,47167041,54710,47025143,47418359,141898
11,ENSG00000254979.1,57410113,chr11-57399496-C-T,rs3741085,-1,C,T,57399496,10617,57213505,57606721,185991
11,ENSG00000255443.1,35214985,chr11-35310095-G-A,rs3903687,-1,G,A,35310095,95110,35018377,35411593,291718
11,ENSG00000254614.1,65180884,chr11-65180806-A-C,rs3953797,-1,A,C,65180806,78,64984276,65377492,196530
11,ENSG00000255135.2,76444673,chr11-76376800-C-T,rs4320976,-1,C,T,76376800,67873,76248065,76641281,128735
11,ENSG00000226645.1,116773389,chr11-116781585-C-T,rs4417316,1,C,T,116781585,8196,116576781,116969997,204804
11,ENSG00000254748.1,87024583,chr11-86939240-T-C,rs4631906,1,T,C,86939240,85343,86827975,87221191,111265
11,ENSG00000236935.1,64340154,chr11-64340005-T-C,rs479777,-1,T,C,64340005,149,64143546,64536762,196459
11,ENSG00000254429.1,75260127,chr11-75447404-G-A,rs482458,1,G,A,75447404,187277,75063519,75456735,383885
11,ENSG00000245552.2,95151693,chr11-95341943-C-T,rs485702,1,C,T,95341943,190250,94955085,95348301,386858
11,ENSG00000255121.1,118998004,chr11-118975772-A-G,rs4938603,-1,A,G,118975772,22232,118801396,119194612,174376
11,ENSG00000245385.2,119337309,chr11-119434901-C-T,rs4938653,-1,C,T,119434901,97592,119140701,119533917,294200
11,ENSG00000130600.9,2001470,chr11-1867384-C-T,rs4980379,-1,C,T,1867384,134086,1804862,2198078,62522
11,ENSG00000245532.2,65422798,chr11-65423737-C-G,rs512715,1,C,G,65423737,939,65226190,65619406,197547
11,ENSG00000254452.1,66277487,chr11-66160302-T-G,rs526200,-1,T,G,66160302,117185,66080879,66474095,79423
11,ENSG00000214391.3,90282560,chr11-90357957-A-G,rs528542,1,A,G,90357957,75397,90085952,90479168,272005
11,ENSG00000255959.1,60842965,chr11-60860110-C-T,rs533116,-1,C,T,60860110,17145,60646357,61039573,213753
11,ENSG00000257052.1,60906789,chr11-60944605-G-A,rs552426,1,G,A,60944605,37816,60710181,61103397,234424
11,ENSG00000234964.2,59781722,chr11-59878206-A-C,rs55794407,-1,A,C,59878206,96484,59585114,59978330,293092
11,ENSG00000245498.2,124800450,chr11-124805318-A-G,rs558814,1,A,G,124805318,4868,124603842,124997058,201476
11,ENSG00000255153.1,1309769,chr11-1299442-C-T,rs5743922,1,C,T,1299442,10327,1113161,1506377,186281
11,ENSG00000250508.1,68870664,chr11-68862814-T-A,rs584108,1,T,A,68862814,7850,68674056,69067272,188758
11,ENSG00000254837.1,74493366,chr11-74489694-G-A,rs601904,1,G,A,74489694,3672,74296758,74689974,192936
11,ENSG00000255929.1,94740269,chr11-94602964-T-C,rs608972,-1,T,C,94602964,137305,94543661,94936877,59303
11,ENSG00000256007.1,72685075,chr11-72603021-C-T,rs61660502,1,C,T,72603021,82054,72488467,72881683,114554
11,ENSG00000256007.1,72685075,chr11-72603021-C-A,rs61660502,1,C,A,72603021,82054,72488467,72881683,114554
11,ENSG00000246250.2,43880726,chr11-43913615-T-C,rs61884011,-1,T,C,43913615,32889,43684118,44077334,229497
11,ENSG00000255428.1,111418186,chr11-111362586-T-G,rs61896828,-1,T,G,111362586,55600,111221578,111614794,141008
11,ENSG00000261098.1,107316271,chr11-107326880-G-C,rs630693,-1,G,C,107326880,10609,107119663,107512879,207217
11,ENSG00000254941.1,124808269,chr11-124808045-C-T,rs646521,-1,C,T,124808045,224,124611661,125004877,196384
11,ENSG00000254463.1,43466392,chr11-43509497-T-G,rs6485429,1,T,G,43509497,43105,43269784,43663000,239713
11,ENSG00000255337.1,102452919,chr11-102480978-C-T,rs651319,1,C,T,102480978,28059,102256311,102649527,224667
11,ENSG00000254815.1,557595,chr11-656523-C-T,rs6598007,1,C,T,656523,98928,360987,754203,295536
11,ENSG00000173727.7,65455269,chr11-65383978-A-G,rs681309,1,A,G,65383978,71291,65258661,65651877,125317
11,ENSG00000255237.1,463899,chr11-500248-G-A,rs7113204,-1,G,A,500248,36349,267291,660507,232957
11,ENSG00000255517.1,66480231,chr11-66471676-C-T,rs7123875,-1,C,T,66471676,8555,66283623,66676839,188053
11,ENSG00000254528.1,117833910,chr11-118021855-T-C,rs7127135,1,T,C,118021855,187945,117637302,118030518,384553
11,ENSG00000246100.2,115760306,chr11-115888063-G-T,rs72993659,-1,G,T,115888063,127757,115563698,115956914,324365
11,ENSG00000250073.2,124759129,chr11-124839956-G-A,rs73014347,1,G,A,124839956,80827,124562521,124955737,277435
11,ENSG00000255328.1,327310,chr11-324880-G-C,rs7395116,1,G,C,324880,2430,130702,523918,194178
11,ENSG00000255328.1,327310,chr11-324880-G-A,rs7395116,1,G,A,324880,2430,130702,523918,194178
11,ENSG00000254680.1,12263173,chr11-12148717-G-A,rs74377045,-1,G,A,12148717,114456,12066565,12459781,82152
11,ENSG00000251661.2,318653,chr11-307025-G-A,rs75117940,1,G,A,307025,11628,122045,515261,184980
11,ENSG00000254910.1,311141,chr11-307025-G-A,rs75117940,-1,G,A,307025,4116,114533,507749,192492
11,ENSG00000246790.2,121453013,chr11-121516695-G-T,rs77434062,-1,G,T,121516695,63682,121256405,121649621,260290
11,ENSG00000229534.1,5572192,chr11-5620796-A-T,rs7936093,-1,A,T,5620796,48604,5375584,5768800,245212
11,ENSG00000255213.1,62330946,chr11-62249293-C-T,rs7936908,1,C,T,62249293,81653,62134338,62527554,114955
11,ENSG00000224295.2,5524955,chr11-5620771-T-C,rs7939159,-1,T,C,5620771,95816,5328347,5721563,292424
11,ENSG00000255320.1,66257595,chr11-66209054-T-C,rs7942894,-1,T,C,66209054,48541,66060987,66454203,148067
11,ENSG00000255449.1,77870091,chr11-77699003-C-T,rs79819324,-1,C,T,77699003,171088,77673483,78066699,25520
11,ENSG00000254851.1,117135528,chr11-117196983-C-T,rs8521,1,C,T,117196983,61455,116938920,117332136,258063
11,ENSG00000181109.3,5726502,chr11-5738230-T-C,rs9665780,1,T,C,5738230,11728,5529894,5923110,208336
11,ENSG00000184224.3,67606706,chr11-67435355-G-A,rs10274,-1,G,A,67435355,171351,67410098,67803314,25257
11,ENSG00000173727.7,65455269,chr11-65436090-C-T,rs1144924,1,C,T,65436090,19179,65258661,65651877,177429
11,ENSG00000256940.1,64245838,chr11-64224109-G-A,rs11549690,1,G,A,64224109,21729,64049230,64442446,174879
11,ENSG00000255455.1,130870247,chr11-130896330-T-C,rs11602545,-1,T,C,130896330,26083,130673639,131066855,222691
11,ENSG00000254780.1,47905607,chr11-47826943-G-T,rs116983862,-1,G,T,47826943,78664,47708999,48102215,117944
11,ENSG00000251364.2,7513472,chr11-7653007-C-G,rs117115375,-1,C,G,7653007,139535,7316864,7710080,336143
11,ENSG00000254614.1,65180884,chr11-65179387-T-C,rs1195968,-1,T,C,65179387,1497,64984276,65377492,195111
11,ENSG00000254719.1,10272259,chr11-10213383-C-T,rs12278680,-1,C,T,10213383,58876,10075651,10468867,137732
11,ENSG00000181109.3,5726502,chr11-5710352-C-T,rs12417798,1,C,T,5710352,16150,5529894,5923110,180458
11,ENSG00000183562.2,2989863,chr11-2921363-G-A,rs1661052,1,G,A,2921363,68500,2793255,3186471,128108
11,ENSG00000257052.1,60906789,chr11-60854640-G-T,rs6591629,1,G,T,60854640,52149,60710181,61103397,144459
11,ENSG00000257038.1,73309361,chr11-73205309-G-T,rs11235679,-1,G,T,73205309,104052,73112753,73505969,92556
11,ENSG00000254406.1,119822129,chr11-119820360-G-A,rs1447149,-1,G,A,119820360,1769,119625521,120018737,194839
11,ENSG00000206597.1,62665422,chr11-62536350-C-T,rs17664979,1,C,T,62536350,129072,62468814,62862030,67536
11,ENSG00000256341.1,64119210,chr11-64258672-G-A,rs2244625,-1,G,A,64258672,139462,63922602,64315818,336070
11,ENSG00000256341.1,64119210,chr11-64258672-G-C,rs2244625,-1,G,C,64258672,139462,63922602,64315818,336070
11,ENSG00000254614.1,65180884,chr11-65210173-C-T,rs625750,-1,C,T,65210173,29289,64984276,65377492,225897
11,ENSG00000255435.2,118530695,chr11-118371763-A-G,rs7116691,-1,A,G,118371763,158932,118334087,118727303,37676
11,ENSG00000251661.2,318653,chr11-336138-A-G,rs7481076,1,A,G,336138,17485,122045,515261,214093
10,ENSG00000229124.1,17230018,chr10-17243290-T-C,rs1037008,-1,T,C,17243290,13272,17033410,17426626,209880
10,ENSG00000240996.1,89697928,chr10-89857367-A-G,rs10509582,-1,A,G,89857367,159439,89501320,89894536,356047
10,ENSG00000224934.1,99431138,chr10-99499226-T-A,rs10748777,1,T,A,99499226,68088,99234530,99627746,264696
10,ENSG00000216740.2,64825572,chr10-64661329-C-T,rs10761856,1,C,T,64661329,164243,64628964,65022180,32365
10,ENSG00000220585.3,91053051,chr10-91162041-C-G,rs10785991,1,C,G,91162041,108990,90856443,91249659,305598
10,ENSG00000259994.1,30306066,chr10-30354943-G-A,rs10826790,-1,G,A,30354943,48877,30109458,30502674,245485
10,ENSG00000240291.1,18545651,chr10-18549925-A-G,rs10828896,-1,A,G,18549925,4274,18349043,18742259,200882
10,ENSG00000213770.3,27350290,chr10-27486359-T-C,rs10829261,-1,T,C,27486359,136069,27153682,27546898,332677
10,ENSG00000244332.1,94577439,chr10-94740174-A-G,rs10882494,1,A,G,94740174,162735,94380831,94774047,359343
10,ENSG00000231233.1,104353625,chr10-104522837-C-T,rs10884015,-1,C,T,104522837,169212,104157017,104550233,365820
10,ENSG00000231233.1,104353625,chr10-104522837-C-A,rs10884015,-1,C,A,104522837,169212,104157017,104550233,365820
10,ENSG00000232470.1,110869743,chr10-110828597-G-A,rs10885054,1,G,A,110828597,41146,110673135,111066351,155462
10,ENSG00000227474.1,13592323,chr10-13515960-A-C,rs10906399,-1,A,C,13515960,76363,13395715,13788931,120245
10,ENSG00000213513.3,77781876,chr10-77825189-A-G,rs11002305,-1,A,G,77825189,43313,77585268,77978484,239921
10,ENSG00000226659.1,80536026,chr10-80535642-G-A,rs11185932,-1,G,A,80535642,384,80339418,80732634,196224
10,ENSG00000260475.1,99620857,chr10-99469618-G-T,rs11190101,1,G,T,99469618,151239,99424249,99817465,45369
10,ENSG00000233690.1,99697949,chr10-99597878-G-A,rs11190169,-1,G,A,99597878,100071,99501341,99894557,96537
10,ENSG00000233533.1,36944738,chr10-36872606-A-G,rs111998417,-1,A,G,36872606,72132,36748130,37141346,124476
10,ENSG00000230091.1,80078895,chr10-80122198-G-A,rs11201799,-1,G,A,80122198,43303,79882287,80275503,239911
10,ENSG00000224023.5,125719460,chr10-125748205-T-C,rs11244632,-1,T,C,125748205,28745,125522852,125916068,225353
10,ENSG00000228021.1,125683243,chr10-125748205-T-C,rs11244632,1,T,C,125748205,64962,125486635,125879851,261570
10,ENSG00000230131.1,123358279,chr10-123482767-C-T,rs11248546,1,C,T,123482767,124488,123161671,123554887,321096
10,ENSG00000228547.4,15000055,chr10-15081387-G-C,rs11259468,-1,G,C,15081387,81332,14803447,15196663,277940
10,ENSG00000235100.2,89701416,chr10-89680299-G-A,rs11599335,-1,G,A,89680299,21117,89504808,89898024,175491
10,ENSG00000176236.4,15097319,chr10-15097371-G-A,rs117151080,-1,G,A,15097371,52,14900711,15293927,196660
10,ENSG00000204682.5,21497071,chr10-21346866-T-G,rs117470310,-1,T,G,21346866,150205,21300463,21693679,46403
10,ENSG00000204682.5,21497071,chr10-21346866-T-C,rs117470310,-1,T,C,21346866,150205,21300463,21693679,46403
10,ENSG00000228755.1,42281819,chr10-42238566-A-C,rs118068376,-1,A,C,42238566,43253,42085211,42478427,153355
10,ENSG00000254536.1,133380026,chr10-133535779-A-G,rs11818144,1,A,G,133535779,155753,133183418,133576634,352361
10,ENSG00000229001.1,69022778,chr10-69170604-A-G,rs12256853,1,A,G,69170604,147826,68826170,69219386,344434
10,ENSG00000234017.1,112548872,chr10-112611182-T-A,rs12260096,-1,T,A,112611182,62310,112352264,112745480,258918
10,ENSG00000235677.1,96560185,chr10-96698294-G-A,rs12266911,1,G,A,96698294,138109,96363577,96756793,334717
10,ENSG00000180221.6,58213036,chr10-58312730-G-A,rs12267431,-1,G,A,58312730,99694,58016428,58409644,296302
10,ENSG00000230306.1,133344906,chr10-133190047-C-T,rs12359206,-1,C,T,133190047,154859,133148298,133541514,41749
10,ENSG00000229919.2,10174230,chr10-10177030-C-T,rs12360103,1,C,T,10177030,2800,9977622,10370838,199408
10,ENSG00000230224.1,100248271,chr10-100297811-T-C,rs12781019,1,T,C,100297811,49540,100051663,100444879,246148
10,ENSG00000227972.1,52411135,chr10-52322775-C-T,rs1590105,1,C,T,52322775,88360,52214527,52607743,108248
10,ENSG00000227972.1,52411135,chr10-52322775-C-A,rs1590105,1,C,A,52322775,88360,52214527,52607743,108248
10,ENSG00000236154.1,69572906,chr10-69694167-G-A,rs16926612,1,G,A,69694167,121261,69376298,69769514,317869
10,ENSG00000213700.3,73006595,chr10-72877840-A-G,rs16930150,-1,A,G,72877840,128755,72809987,73203203,67853
10,ENSG00000230555.1,43420738,chr10-43388447-T-A,rs17153601,1,T,A,43388447,32291,43224130,43617346,164317
10,ENSG00000151303.10,86992406,chr10-87050166-A-G,rs17343324,1,A,G,87050166,57760,86795798,87189014,254368
10,ENSG00000228701.1,91798309,chr10-91797862-C-T,rs2066276,-1,C,T,91797862,447,91601701,91994917,196161
10,ENSG00000226646.1,35697300,chr10-35592898-G-A,rs2216520,1,G,A,35592898,104402,35500692,35893908,92206
10,ENSG00000260917.1,112823490,chr10-112819235-G-A,rs2479124,1,G,A,112819235,4255,112626882,113020098,192353
10,ENSG00000215146.3,42353011,chr10-42366631-T-C,rs2489684,-1,T,C,42366631,13620,42156403,42549619,210228
10,ENSG00000180066.5,132445189,chr10-132304496-C-T,rs2492651,1,C,T,132304496,140693,132248581,132641797,55915
10,ENSG00000228748.1,77782866,chr10-77971601-A-G,rs2559661,1,A,G,77971601,188735,77586258,77979474,385343
10,ENSG00000235316.1,73731824,chr10-73866615-T-C,rs2664283,1,T,C,73866615,134791,73535216,73928432,331399
10,ENSG00000234743.1,80247683,chr10-80161797-T-C,rs2784774,-1,T,C,80161797,85886,80051075,80444291,110722
10,ENSG00000230425.1,42725857,chr10-42890717-G-A,rs2795517,1,G,A,42890717,164860,42529249,42922465,361468
10,ENSG00000226200.1,50624943,chr10-50525751-A-G,rs3011777,1,A,G,50525751,99192,50428335,50821551,97416
10,ENSG00000227096.1,116440044,chr10-116597401-G-T,rs34708330,-1,G,T,116597401,157357,116243436,116636652,353965
10,ENSG00000229605.4,28899484,chr10-28721489-C-T,rs34718559,-1,C,T,28721489,177995,28702876,29096092,18613
10,ENSG00000212743.1,6350316,chr10-6178690-C-T,rs34836742,1,C,T,6178690,171626,6153708,6546924,24982
10,ENSG00000215151.4,38601418,chr10-38741984-G-T,rs35322563,1,G,T,38741984,140566,38404810,38798026,337174
10,ENSG00000242338.1,73728580,chr10-73773690-A-G,rs3740289,-1,A,G,73773690,45110,73531972,73925188,241718
10,ENSG00000234961.1,17234833,chr10-17408083-A-G,rs41299056,-1,A,G,17408083,173250,17038225,17431441,369858
10,ENSG00000099251.10,38356455,chr10-38265765-T-C,rs4641407,1,T,C,38265765,90690,38159847,38553063,105918
10,ENSG00000250959.2,73731176,chr10-73647891-A-C,rs4746139,1,A,C,73647891,83285,73534568,73927784,113323
10,ENSG00000242288.3,73730466,chr10-73717540-A-G,rs4746143,-1,A,G,73717540,12926,73533858,73927074,183682
10,ENSG00000234369.1,63222155,chr10-63087649-G-A,rs4746893,1,G,A,63087649,134506,63025547,63418763,62102
10,ENSG00000225484.2,79806086,chr10-79837228-C-A,rs4933929,-1,C,A,79837228,31142,79609478,80002694,227750
10,ENSG00000231345.2,50658529,chr10-50598525-G-A,rs4935734,1,G,A,50598525,60004,50461921,50855137,136604
10,ENSG00000237470.2,15021863,chr10-14832693-G-A,rs6602768,-1,G,A,14832693,189170,14825255,15218471,7438
10,ENSG00000213449.2,91667782,chr10-91539927-A-G,rs7079061,-1,A,G,91539927,127855,91471174,91864390,68753
10,ENSG00000232807.1,5945900,chr10-5906675-C-T,rs7082434,-1,C,T,5906675,39225,5749292,6142508,157383
10,ENSG00000262412.1,27243130,chr10-27191120-T-C,rs7086553,1,T,C,27191120,52010,27046522,27439738,144598
10,ENSG00000236797.1,75382844,chr10-75455418-A-G,rs7096727,-1,A,G,75455418,72574,75186236,75579452,269182
10,ENSG00000254635.1,28532743,chr10-28501070-A-G,rs7098928,-1,A,G,28501070,31673,28336135,28729351,164935
10,ENSG00000232936.1,89645272,chr10-89693059-C-A,rs7098988,1,C,A,89693059,47787,89448664,89841880,244395
10,ENSG00000226864.1,121948188,chr10-122091147-T-C,rs7101179,1,T,C,122091147,142959,121751580,122144796,339567
10,ENSG00000225053.1,8161260,chr10-8187668-G-A,rs72784701,1,G,A,8187668,26408,7964652,8357868,223016
10,ENSG00000237590.1,44261813,chr10-44356510-G-A,rs736724,-1,G,A,44356510,94697,44065205,44458421,291305
10,ENSG00000165511.4,45000888,chr10-45052918-A-G,rs7478211,-1,A,G,45052918,52030,44804280,45197496,248638
10,ENSG00000230534.1,35126657,chr10-35259297-T-C,rs76458677,-1,T,C,35259297,132640,34930049,35323265,329248
10,ENSG00000215244.1,6271169,chr10-6321985-A-G,rs7919350,1,A,G,6321985,50816,6074561,6467777,247424
10,ENSG00000228169.3,114690634,chr10-114814931-T-G,rs808272,-1,T,G,114814931,124297,114494026,114887242,320905
10,ENSG00000228754.1,48746128,chr10-48589427-G-T,rs870353,-1,G,T,48589427,156701,48549520,48942736,39907
10,ENSG00000230322.1,11171376,chr10-11172255-A-G,rs9424123,-1,A,G,11172255,879,10974768,11367984,197487
10,ENSG00000228753.1,21028999,chr10-20992322-A-C,rs946861,1,A,C,20992322,36677,20832391,21225607,159931
10,ENSG00000203497.2,110872253,chr10-110843268-A-G,rs9633680,-1,A,G,110843268,28985,110675645,111068861,167623
10,ENSG00000233837.1,42566677,chr10-42382133-T-C,rs9988706,1,T,C,42382133,184544,42370069,42763285,12064
10,ENSG00000232734.1,69433371,chr10-69378377-C-T,rs10128330,-1,C,T,69378377,54994,69236763,69629979,141614
10,ENSG00000228547.4,15000055,chr10-15103949-T-C,rs10242,-1,T,C,15103949,103894,14803447,15196663,300502
10,ENSG00000229124.1,17230018,chr10-17249626-A-G,rs1028854,-1,A,G,17249626,19608,17033410,17426626,216216
10,ENSG00000225137.1,50264978,chr10-50412221-A-G,rs10508929,1,A,G,50412221,147243,50068370,50461586,343851
10,ENSG00000235100.2,89701416,chr10-89806827-A-G,rs10785903,-1,A,G,89806827,105411,89504808,89898024,302019
10,ENSG00000236552.1,96750288,chr10-96606828-A-G,rs10786304,1,A,G,96606828,143460,96553680,96946896,53148
10,ENSG00000237417.1,93209627,chr10-93108697-T-C,rs10882146,-1,T,C,93108697,100930,93013019,93406235,95678
10,ENSG00000226864.1,121948188,chr10-121950102-A-C,rs10887029,1,A,C,121950102,1914,121751580,122144796,198522
10,ENSG00000242338.1,73728580,chr10-73835746-A-G,rs11000790,-1,A,G,73835746,107166,73531972,73925188,303774
10,ENSG00000224597.3,29409618,chr10-29420919-T-C,rs11007566,1,T,C,29420919,11301,29213010,29606226,207909
10,ENSG00000240291.1,18545651,chr10-18490395-G-C,rs11014484,-1,G,C,18490395,55256,18349043,18742259,141352
10,ENSG00000232709.1,92418667,chr10-92457281-G-A,rs11187009,1,G,A,92457281,38614,92222059,92615275,235222
10,ENSG00000230224.1,100248271,chr10-100292006-T-C,rs11190456,1,T,C,100292006,43735,100051663,100444879,240343
10,ENSG00000227165.1,120851209,chr10-120772235-C-T,rs11199541,-1,C,T,120772235,78974,120654601,121047817,117634
10,ENSG00000214297.3,125667950,chr10-125502466-A-G,rs11244521,-1,A,G,125502466,165484,125471342,125864558,31124
10,ENSG00000232591.1,7472040,chr10-7484062-G-A,rs1157042,-1,G,A,7484062,12022,7275432,7668648,208630
10,ENSG00000226493.1,68499532,chr10-68316137-C-T,rs117731828,1,C,T,68316137,183395,68302924,68696140,13213
10,ENSG00000180066.5,132445189,chr10-132385605-C-T,rs11814053,1,C,T,132385605,59584,132248581,132641797,137024
10,ENSG00000228828.1,37820982,chr10-37742055-G-A,rs11815066,-1,G,A,37742055,78927,37624374,38017590,117681
10,ENSG00000226200.1,50624943,chr10-50471969-C-A,rs1203380,1,C,A,50471969,152974,50428335,50821551,43634
10,ENSG00000232936.1,89645272,chr10-89660239-C-T,rs12218194,1,C,T,89660239,14967,89448664,89841880,211575
10,ENSG00000232807.1,5945900,chr10-6035857-G-A,rs12722525,-1,G,A,6035857,89957,5749292,6142508,286565
10,ENSG00000230534.1,35126657,chr10-34997948-C-A,rs12772536,-1,C,A,34997948,128709,34930049,35323265,67899
10,ENSG00000213513.3,77781876,chr10-77944636-C-T,rs1366047,-1,C,T,77944636,162760,77585268,77978484,359368
10,ENSG00000227173.1,65169869,chr10-65354810-T-C,rs1504467,-1,T,C,65354810,184941,64973261,65366477,381549
10,ENSG00000225976.4,29697935,chr10-29860724-A-G,rs16930687,1,A,G,29860724,162789,29501327,29894543,359397
10,ENSG00000220842.5,120355183,chr10-120503254-G-A,rs17100273,-1,G,A,120503254,148071,120158575,120551791,344679
10,ENSG00000230565.1,43645942,chr10-43618762-A-C,rs17447650,1,A,C,43618762,27180,43449334,43842550,169428
10,ENSG00000244332.1,94577439,chr10-94670214-C-T,rs2104543,1,C,T,94670214,92775,94380831,94774047,289383
10,ENSG00000260917.1,112823490,chr10-112640536-G-A,rs2120929,1,G,A,112640536,182954,112626882,113020098,13654
10,ENSG00000235316.1,73731824,chr10-73799109-G-A,rs2271271,1,G,A,73799109,67285,73535216,73928432,263893
10,ENSG00000231970.1,97401115,chr10-97366492-G-A,rs2275581,1,G,A,97366492,34623,97204507,97597723,161985
10,ENSG00000213770.3,27350290,chr10-27501178-C-T,rs2505300,-1,C,T,27501178,150888,27153682,27546898,347496
10,ENSG00000222047.4,73922777,chr10-73889290-G-A,rs2675675,-1,G,A,73889290,33487,73726169,74119385,163121
10,ENSG00000259994.1,30306066,chr10-30346819-C-T,rs2771247,-1,C,T,30346819,40753,30109458,30502674,237361
10,ENSG00000214881.4,68544833,chr10-68537778-T-C,rs2795883,-1,T,C,68537778,7055,68348225,68741441,189553
10,ENSG00000234026.1,95231144,chr10-95238701-C-T,rs2901832,-1,C,T,95238701,7557,95034536,95427752,204165
10,ENSG00000233261.1,26591310,chr10-26452245-C-T,rs2992262,1,C,T,26452245,139065,26394702,26787918,57543
10,ENSG00000165511.4,45000888,chr10-44978995-A-C,rs3818713,-1,A,C,44978995,21893,44804280,45197496,174715
10,ENSG00000262412.1,27243130,chr10-27285852-A-G,rs4617487,1,A,G,27285852,42722,27046522,27439738,239330
10,ENSG00000229919.2,10174230,chr10-10322566-T-G,rs4747852,1,T,G,10322566,148336,9977622,10370838,344944
10,ENSG00000237399.1,3141632,chr10-3143045-A-G,rs4881109,1,A,G,3143045,1413,2945024,3338240,198021
10,ENSG00000225192.1,37796109,chr10-37625418-A-C,rs4934881,-1,A,C,37625418,170691,37599501,37992717,25917
10,ENSG00000227032.1,96621707,chr10-96770925-A-G,rs577981,-1,A,G,96770925,149218,96425099,96818315,345826
10,ENSG00000234118.1,110937233,chr10-110871453-G-A,rs6585018,-1,G,A,110871453,65780,110740625,111133841,130828
10,ENSG00000227540.1,73252791,chr10-73375688-C-T,rs6896,1,C,T,73375688,122897,73056183,73449399,319505
10,ENSG00000230322.1,11171376,chr10-11200817-G-A,rs7085721,-1,G,A,11200817,29441,10974768,11367984,226049
10,ENSG00000223482.1,87342403,chr10-87201095-A-G,rs7093841,-1,A,G,87201095,141308,87145795,87539011,55300
10,ENSG00000229870.1,49815096,chr10-49760749-T-C,rs717721,1,T,C,49760749,54347,49618488,50011704,142261
10,ENSG00000229870.1,49815096,chr10-49760749-T-G,rs717721,1,T,G,49760749,54347,49618488,50011704,142261
10,ENSG00000231060.1,80778088,chr10-80923464-T-C,rs729724,-1,T,C,80923464,145376,80581480,80974696,341984
10,ENSG00000234569.1,119621068,chr10-119443393-G-A,rs75555098,1,G,A,119443393,177675,119424460,119817676,18933
10,ENSG00000213412.3,46415853,chr10-46237566-C-T,rs77893994,1,C,T,46237566,178287,46219245,46612461,18321
10,ENSG00000180230.6,119997709,chr10-120099403-C-T,rs78639536,-1,C,T,120099403,101694,119801101,120194317,298302
10,ENSG00000226659.1,80536026,chr10-80540091-A-T,rs7900957,-1,A,T,80540091,4065,80339418,80732634,200673
10,ENSG00000230131.1,123358279,chr10-123474352-G-T,rs7922033,1,G,T,123474352,116073,123161671,123554887,312681
10,ENSG00000214807.2,124867510,chr10-124725883-G-A,rs869303,1,G,A,124725883,141627,124670902,125064118,54981
10,ENSG00000234961.1,17234833,chr10-17237563-G-T,rs1049341,-1,G,T,17237563,2730,17038225,17431441,199338
10,ENSG00000235100.2,89701416,chr10-89862401-A-G,rs10785908,-1,A,G,89862401,160985,89504808,89898024,357593
10,ENSG00000228462.1,45073541,chr10-45155924-C-T,rs10793590,-1,C,T,45155924,82383,44876933,45270149,278991
10,ENSG00000227896.1,86521945,chr10-86581254-C-A,rs10887625,1,C,A,86581254,59309,86325337,86718553,255917
10,ENSG00000236993.2,55668350,chr10-55840284-G-T,rs11005062,-1,G,T,55840284,171934,55471742,55864958,368542
10,ENSG00000240996.1,89697928,chr10-89592539-G-A,rs11185775,-1,G,A,89592539,105389,89501320,89894536,91219
10,ENSG00000225519.1,90994620,chr10-91022370-T-C,rs11186417,1,T,C,91022370,27750,90798012,91191228,224358
10,ENSG00000229278.1,99659284,chr10-99591947-A-G,rs11190164,-1,A,G,99591947,67337,99462676,99855892,129271
10,ENSG00000228195.2,116749905,chr10-116636627-T-A,rs11197775,1,T,A,116636627,113278,116553297,116946513,83330
10,ENSG00000228195.2,116749905,chr10-116636627-T-C,rs11197775,1,T,C,116636627,113278,116553297,116946513,83330
10,ENSG00000227165.1,120851209,chr10-120925036-T-C,rs11199656,-1,T,C,120925036,73827,120654601,121047817,270435
10,ENSG00000214362.2,95594598,chr10-95608056-G-C,rs112194607,1,G,C,95608056,13458,95397990,95791206,210066
10,ENSG00000214362.2,95594598,chr10-95608056-G-A,rs112194607,1,G,A,95608056,13458,95397990,95791206,210066
10,ENSG00000205740.1,988341,chr10-1071059-T-C,rs11250249,-1,T,C,1071059,82718,791733,1184949,279326
10,ENSG00000235763.1,13104793,chr10-13089135-G-A,rs11258183,-1,G,A,13089135,15658,12908185,13301401,180950
10,ENSG00000203414.2,13158136,chr10-13225905-C-T,rs11258274,-1,C,T,13225905,67769,12961528,13354744,264377
10,ENSG00000213412.3,46415853,chr10-46236406-C-A,rs11591944,1,C,A,46236406,179447,46219245,46612461,17161
10,ENSG00000235816.2,63427297,chr10-63579157-G-A,rs117359294,1,G,A,63579157,151860,63230689,63623905,348468
10,ENSG00000234043.3,91153349,chr10-91150022-G-A,rs12242279,-1,G,A,91150022,3327,90956741,91349957,193281
10,ENSG00000151303.10,86992406,chr10-86966227-A-G,rs1240390,1,A,G,86966227,26179,86795798,87189014,170429
10,ENSG00000230131.1,123358279,chr10-123460425-C-T,rs12572414,1,C,T,123460425,102146,123161671,123554887,298754
10,ENSG00000234026.1,95231144,chr10-95272855-T-C,rs12769370,-1,T,C,95272855,41711,95034536,95427752,238319
10,ENSG00000204682.5,21497071,chr10-21394895-T-C,rs16921796,-1,T,C,21394895,102176,21300463,21693679,94432
10,ENSG00000213613.2,87945502,chr10-87826220-C-T,rs17702687,1,C,T,87826220,119282,87748894,88142110,77326
10,ENSG00000230091.1,80078895,chr10-80001733-C-T,rs1932571,-1,C,T,80001733,77162,79882287,80275503,119446
10,ENSG00000233690.1,99697949,chr10-99731933-G-T,rs2231679,-1,G,T,99731933,33984,99501341,99894557,230592
10,ENSG00000233690.1,99697949,chr10-99731933-G-A,rs2231679,-1,G,A,99731933,33984,99501341,99894557,230592
10,ENSG00000238280.1,62805887,chr10-62820301-T-C,rs224277,-1,T,C,62820301,14414,62609279,63002495,211022
10,ENSG00000234699.1,103452846,chr10-103441820-C-T,rs2281860,1,C,T,103441820,11026,103256238,103649454,185582
10,ENSG00000230555.1,43420738,chr10-43360263-C-T,rs2493664,1,C,T,43360263,60475,43224130,43617346,136133
10,ENSG00000228302.1,12247845,chr10-12118252-T-C,rs2658195,-1,T,C,12118252,129593,12051237,12444453,67015
10,ENSG00000254635.1,28532743,chr10-28601231-C-T,rs2772431,-1,C,T,28601231,68488,28336135,28729351,265096
10,ENSG00000229605.4,28899484,chr10-28925802-T-C,rs2887379,-1,T,C,28925802,26318,28702876,29096092,222926
10,ENSG00000230306.1,133344906,chr10-133232519-T-A,rs3008359,-1,T,A,133232519,112387,133148298,133541514,84221
10,ENSG00000230306.1,133344906,chr10-133232519-T-G,rs3008359,-1,T,G,133232519,112387,133148298,133541514,84221
10,ENSG00000214434.2,30380174,chr10-30442964-C-A,rs303436,1,C,A,30442964,62790,30183566,30576782,259398
10,ENSG00000231187.2,46598150,chr10-46550427-T-A,rs3127679,-1,T,A,46550427,47723,46401542,46794758,148885
10,ENSG00000231187.2,46598150,chr10-46550427-T-C,rs3127679,-1,T,C,46550427,47723,46401542,46794758,148885
10,ENSG00000165511.4,45000888,chr10-45003561-A-G,rs3740093,-1,A,G,45003561,2673,44804280,45197496,199281
10,ENSG00000229124.1,17230018,chr10-17200036-A-G,rs4748362,-1,A,G,17200036,29982,17033410,17426626,166626
10,ENSG00000229124.1,17230018,chr10-17200036-A-C,rs4748362,-1,A,C,17200036,29982,17033410,17426626,166626
10,ENSG00000224597.3,29409618,chr10-29422591-C-T,rs4749421,1,C,T,29422591,12973,29213010,29606226,209581
10,ENSG00000236308.1,100190036,chr10-100328244-G-A,rs495734,1,G,A,100328244,138208,99993428,100386644,334816
10,ENSG00000230165.1,114246074,chr10-114302751-T-C,rs507098,1,T,C,114302751,56677,114049466,114442682,253285
10,ENSG00000203497.2,110872253,chr10-110813098-A-G,rs61862917,-1,A,G,110813098,59155,110675645,111068861,137453
10,ENSG00000203497.2,110872253,chr10-110813098-A-T,rs61862917,-1,A,T,110813098,59155,110675645,111068861,137453
10,ENSG00000255624.1,122879851,chr10-122915558-G-T,rs61872302,1,G,T,122915558,35707,122683243,123076459,232315
10,ENSG00000236493.1,92669743,chr10-92782827-C-T,rs6583840,-1,C,T,92782827,113084,92473135,92866351,309692
10,ENSG00000227586.4,123171875,chr10-123139854-C-T,rs67693083,-1,C,T,123139854,32021,122975267,123368483,164587
10,ENSG00000225192.1,37796109,chr10-37651512-C-A,rs7072977,-1,C,A,37651512,144597,37599501,37992717,52011
10,ENSG00000232591.1,7472040,chr10-7422888-T-G,rs72775588,-1,T,G,7422888,49152,7275432,7668648,147456
10,ENSG00000215146.3,42353011,chr10-42475056-A-G,rs72787863,-1,A,G,42475056,122045,42156403,42549619,318653
10,ENSG00000235489.2,64170850,chr10-63976691-G-T,rs72832107,-1,G,T,63976691,194159,63974242,64367458,2449
10,ENSG00000229001.1,69022778,chr10-68921954-C-T,rs73268355,1,C,T,68921954,100824,68826170,69219386,95784
10,ENSG00000262412.1,27243130,chr10-27119955-T-C,rs75027886,1,T,C,27119955,123175,27046522,27439738,73433
10,ENSG00000226318.1,67961464,chr10-68140082-G-A,rs77368905,-1,G,A,68140082,178618,67764856,68158072,375226
10,ENSG00000180221.6,58213036,chr10-58100790-T-C,rs77576448,-1,T,C,58100790,112246,58016428,58409644,84362
10,ENSG00000183055.5,58715554,chr10-58731065-A-G,rs78740117,1,A,G,58731065,15511,58518946,58912162,212119
10,ENSG00000230469.1,69778962,chr10-69614392-G-A,rs78809390,1,G,A,69614392,164570,69582354,69975570,32038
10,ENSG00000230534.1,35126657,chr10-35049771-G-A,rs7900480,-1,G,A,35049771,76886,34930049,35323265,119722
10,ENSG00000224934.1,99431138,chr10-99575246-A-G,rs7906204,1,A,G,99575246,144108,99234530,99627746,340716
10,ENSG00000233292.1,89139044,chr10-89302352-C-T,rs7922613,1,C,T,89302352,163308,88942436,89335652,359916
10,ENSG00000228169.3,114690634,chr10-114728318-T-C,rs79831602,-1,T,C,114728318,37684,114494026,114887242,234292
10,ENSG00000237470.2,15021863,chr10-14913317-G-T,rs79929834,-1,G,T,14913317,108546,14825255,15218471,88062
10,ENSG00000230224.1,100248271,chr10-100296543-G-T,rs80017045,1,G,T,100296543,48272,100051663,100444879,244880
10,ENSG00000233122.1,130106046,chr10-130089055-G-A,rs942675,1,G,A,130089055,16991,129909438,130302654,179617
10,ENSG00000226659.1,80536026,chr10-80505057-A-G,rs9633739,-1,A,G,80505057,30969,80339418,80732634,165639
10,ENSG00000240291.1,18545651,chr10-18699878-A-G,rs984292,-1,A,G,18699878,154227,18349043,18742259,350835
9,ENSG00000235138.1,134054290,chr9-134044158-C-T,rs10114627,1,C,T,134044158,10132,133857682,134250898,186476
9,ENSG00000233555.2,63581834,chr9-63574687-T-C,rs10120296,-1,T,C,63574687,7147,63385226,63778442,189461
9,ENSG00000228053.1,110025358,chr9-109955225-A-C,rs10120878,-1,A,C,109955225,70133,109828750,110221966,126475
9,ENSG00000232104.1,3526535,chr9-3682354-T-A,rs10733481,1,T,A,3682354,155819,3329927,3723143,352427
9,ENSG00000237999.1,100731240,chr9-100621917-G-C,rs10760734,1,G,C,100621917,109323,100534632,100927848,87285
9,ENSG00000227388.2,35772311,chr9-35867904-G-A,rs10814288,1,G,A,35867904,95593,35575703,35968919,292201
9,ENSG00000234160.1,37509150,chr9-37491283-A-C,rs10814556,1,A,C,37491283,17867,37312542,37705758,178741
9,ENSG00000224001.1,98234709,chr9-98373461-A-T,rs10818833,1,A,T,98373461,138752,98038101,98431317,335360
9,ENSG00000215283.3,36304924,chr9-36186267-T-C,rs10972784,-1,T,C,36186267,118657,36108316,36501532,77951
9,ENSG00000235865.2,121285530,chr9-121107558-C-T,rs10985157,-1,C,T,121107558,177972,121088922,121482138,18636
9,ENSG00000227269.1,99183373,chr9-99194212-C-T,rs10988746,1,C,T,99194212,10839,98986765,99379981,207447
9,ENSG00000203993.3,137618906,chr9-137595172-C-T,rs11137141,-1,C,T,137595172,23734,137422298,137815514,172874
9,ENSG00000204429.3,88180673,chr9-88031534-A-G,rs11142050,1,A,G,88031534,149139,87984065,88377281,47469
9,ENSG00000183148.4,40223397,chr9-40195539-T-C,rs117401093,1,T,C,40195539,27858,40026789,40420005,168750
9,ENSG00000228656.1,63762824,chr9-63840173-A-G,rs118106267,-1,A,G,63840173,77349,63566216,63959432,273957
9,ENSG00000235298.1,83972233,chr9-84082663-G-C,rs12236416,1,G,C,84082663,110430,83775625,84168841,307038
9,ENSG00000235298.1,83972233,chr9-84082663-G-A,rs12236416,1,G,A,84082663,110430,83775625,84168841,307038
9,ENSG00000226783.1,122685933,chr9-122517222-A-G,rs12238776,1,A,G,122517222,168711,122489325,122882541,27897
9,ENSG00000231381.1,6670008,chr9-6645251-C-T,rs12341698,-1,C,T,6645251,24757,6473400,6866616,171851
9,ENSG00000227666.1,94038030,chr9-93909364-T-C,rs12343357,1,T,C,93909364,128666,93841422,94234638,67942
9,ENSG00000250850.2,37002651,chr9-37002145-A-G,rs12554596,1,A,G,37002145,506,36806043,37199259,196102
9,ENSG00000204706.6,70175883,chr9-70326054-A-G,rs13297876,-1,A,G,70326054,150171,69979275,70372491,346779
9,ENSG00000229753.1,72741617,chr9-72769858-G-C,rs13298704,-1,G,C,72769858,28241,72545009,72938225,224849
9,ENSG00000236199.1,2046023,chr9-2066976-A-G,rs13300103,-1,A,G,2066976,20953,1849415,2242631,217561
9,ENSG00000228623.2,112998259,chr9-113098921-T-G,rs1411604,-1,T,G,113098921,100662,112801651,113194867,297270
9,ENSG00000235641.1,91159769,chr9-91090100-G-A,rs16907144,1,G,A,91090100,69669,90963161,91356377,126939
9,ENSG00000254473.1,83707594,chr9-83704499-T-C,rs17080575,1,T,C,83704499,3095,83510986,83904202,193513
9,ENSG00000219149.3,76549771,chr9-76586158-A-G,rs2149589,-1,A,G,76586158,36387,76353163,76746379,232995
9,ENSG00000223478.1,128724435,chr9-128633289-C-A,rs2228952,1,C,A,128633289,91146,128527827,128921043,105462
9,ENSG00000223478.1,128724435,chr9-128633289-C-T,rs2228952,1,C,T,128633289,91146,128527827,128921043,105462
9,ENSG00000225951.1,128473012,chr9-128382625-G-A,rs2240949,-1,G,A,128382625,90387,128276404,128669620,106221
9,ENSG00000232743.1,87816465,chr9-87727760-C-T,rs2274611,1,C,T,87727760,88705,87619857,88013073,107903
9,ENSG00000225693.1,33020165,chr9-33062130-G-A,rs2274764,-1,G,A,33062130,41965,32823557,33216773,238573
9,ENSG00000236816.2,42852675,chr9-42839370-T-C,rs2351569,1,T,C,42839370,13305,42656067,43049283,183303
9,ENSG00000260912.1,19453209,chr9-19448475-A-G,rs2383096,1,A,G,19448475,4734,19256601,19649817,191874
9,ENSG00000233820.1,96725890,chr9-96842892-T-G,rs2406184,1,T,G,96842892,117002,96529282,96922498,313610
9,ENSG00000233820.1,96725890,chr9-96842892-T-C,rs2406184,1,T,C,96842892,117002,96529282,96922498,313610
9,ENSG00000238251.1,96407284,chr9-96259379-A-G,rs2476923,1,A,G,96259379,147905,96210676,96603892,48703
9,ENSG00000229419.1,105520128,chr9-105392543-G-T,rs2771029,1,G,T,105392543,127585,105323520,105716736,69023
9,ENSG00000230074.1,34665607,chr9-34670794-G-A,rs2812346,1,G,A,34670794,5187,34468999,34862215,201795
9,ENSG00000215199.2,34922921,chr9-34799538-T-C,rs2890604,-1,T,C,34799538,123383,34726313,35119529,73225
9,ENSG00000225254.1,38454070,chr9-38535482-T-C,rs2993153,-1,T,C,38535482,81412,38257462,38650678,278020
9,ENSG00000237886.1,136546212,chr9-136546393-G-A,rs3013306,1,G,A,136546393,181,136349604,136742820,196789
9,ENSG00000214121.3,12973438,chr9-12833756-A-C,rs35509513,-1,A,C,12833756,139682,12776830,13170046,56926
9,ENSG00000260100.1,37079776,chr9-36936392-G-A,rs3824342,-1,G,A,36936392,143384,36883168,37276384,53224
9,ENSG00000261793.1,137171984,chr9-137161251-G-A,rs41290007,-1,G,A,137161251,10733,136975376,137368592,185875
9,ENSG00000176007.9,38527097,chr9-38680829-T-C,rs4242651,1,T,C,38680829,153732,38330489,38723705,350340
9,ENSG00000214110.3,14922334,chr9-14901628-C-G,rs4543641,-1,C,G,14901628,20706,14725726,15118942,175902
9,ENSG00000215237.5,14993312,chr9-15064518-T-A,rs4741449,1,T,A,15064518,71206,14796704,15189920,267814
9,ENSG00000225434.1,72305464,chr9-72312693-C-T,rs4745183,1,C,T,72312693,7229,72108856,72502072,203837
9,ENSG00000226752.1,120847294,chr9-120848010-C-T,rs4837796,1,C,T,120848010,716,120650686,121043902,197324
9,ENSG00000224020.1,124658412,chr9-124595399-C-T,rs4838196,1,C,T,124595399,63013,124461804,124855020,133595
9,ENSG00000260193.1,136109424,chr9-136110133-A-G,rs4842115,-1,A,G,136110133,709,135912816,136306032,197317
9,ENSG00000233554.1,33166948,chr9-33125281-G-A,rs4879666,1,G,A,33125281,41667,32970340,33363556,154941
9,ENSG00000183784.5,215741,chr9-211472-A-T,rs522747,-1,A,T,211472,4269,19133,412349,192339
9,ENSG00000236924.1,6645875,chr9-6646066-T-G,rs55645178,1,T,G,6646066,191,6449267,6842483,196799
9,ENSG00000204816.4,42625436,chr9-42736192-C-T,rs55755621,1,C,T,42736192,110756,42428828,42822044,307364
9,ENSG00000237357.1,42569353,chr9-42736192-C-T,rs55755621,-1,C,T,42736192,166839,42372745,42765961,363447
9,ENSG00000226801.1,33968518,chr9-33898825-C-T,rs62555930,-1,C,T,33898825,69693,33771910,34165126,126915
9,ENSG00000213558.3,107458306,chr9-107626124-A-C,rs6477586,-1,A,C,107626124,167818,107261698,107654914,364426
9,ENSG00000233016.1,136728184,chr9-136723384-C-T,rs6874,-1,C,T,136723384,4800,136531576,136924792,191808
9,ENSG00000255585.1,137788690,chr9-137873293-T-A,rs7025557,-1,T,A,137873293,84603,137592082,137985298,281211
9,ENSG00000255585.1,137788690,chr9-137873293-T-C,rs7025557,-1,T,C,137873293,84603,137592082,137985298,281211
9,ENSG00000204860.4,38620526,chr9-38661419-A-G,rs7031991,1,A,G,38661419,40893,38423918,38817134,237501
9,ENSG00000225032.1,127816066,chr9-127794947-G-A,rs7039798,1,G,A,127794947,21119,127619458,128012674,175489
9,ENSG00000232815.1,63818462,chr9-63702618-C-A,rs7041252,-1,C,A,63702618,115844,63621854,64015070,80764
9,ENSG00000230734.1,117181095,chr9-117172923-C-T,rs71507503,-1,C,T,117172923,8172,116984487,117377703,188436
9,ENSG00000234042.1,63703065,chr9-63659593-G-A,rs72709884,1,G,A,63659593,43472,63506457,63899673,153136
9,ENSG00000239684.1,63776143,chr9-63659593-G-A,rs72709884,-1,G,A,63659593,116550,63579535,63972751,80058
9,ENSG00000236184.1,32980403,chr9-32873076-G-A,rs72714885,-1,G,A,32873076,107327,32783795,33177011,89281
9,ENSG00000165121.10,85815966,chr9-85864099-T-G,rs74686393,1,T,G,85864099,48133,85619358,86012574,244741
9,ENSG00000180539.4,137027464,chr9-137031950-T-C,rs7469569,1,T,C,137031950,4486,136830856,137224072,201094
9,ENSG00000223568.1,14041861,chr9-14021277-G-C,rs77875888,-1,G,C,14021277,20584,13845253,14238469,176024
9,ENSG00000223568.1,14041861,chr9-14021277-G-A,rs77875888,-1,G,A,14021277,20584,13845253,14238469,176024
9,ENSG00000233178.1,68406454,chr9-68398884-T-C,rs7851710,-1,T,C,68398884,7570,68209846,68603062,189038
9,ENSG00000236254.1,5107937,chr9-5132309-A-C,rs7854968,1,A,C,5132309,24372,4911329,5304545,220980
9,ENSG00000254876.1,97238483,chr9-97238449-A-G,rs7856254,1,A,G,97238449,34,97041875,97435091,196574
9,ENSG00000227218.1,127934503,chr9-127941286-A-G,rs7859,1,A,G,127941286,6783,127737895,128131111,203391
9,ENSG00000255145.1,99906605,chr9-99758147-T-C,rs7859014,-1,T,C,99758147,148458,99709997,100103213,48150
9,ENSG00000237372.1,89639750,chr9-89725968-C-T,rs7864036,1,C,T,89725968,86218,89443142,89836358,282826
9,ENSG00000236404.2,2622373,chr9-2527980-A-G,rs7864942,-1,A,G,2527980,94393,2425765,2818981,102215
9,ENSG00000228544.1,136808848,chr9-136828956-G-T,rs7866538,-1,G,T,136828956,20108,136612240,137005456,216716
9,ENSG00000228544.1,136808848,chr9-136828956-G-A,rs7866538,-1,G,A,136828956,20108,136612240,137005456,216716
9,ENSG00000232630.1,125150653,chr9-125152931-T-A,rs7867749,1,T,A,125152931,2278,124954045,125347261,198886
9,ENSG00000232630.1,125150653,chr9-125152931-T-C,rs7867749,1,T,C,125152931,2278,124954045,125347261,198886
9,ENSG00000213612.2,97121659,chr9-97180153-C-T,rs78679782,1,C,T,97180153,58494,96925051,97318267,255102
9,ENSG00000213612.2,97121659,chr9-97180153-C-G,rs78679782,1,C,G,97180153,58494,96925051,97318267,255102
9,ENSG00000231799.1,89449558,chr9-89452888-A-G,rs7871577,1,A,G,89452888,3330,89252950,89646166,199938
9,ENSG00000177736.2,124968840,chr9-125063112-G-A,rs827660,-1,G,A,125063112,94272,124772232,125165448,290880
9,ENSG00000227518.1,27657,chr9-45440-C-A,rs9407029,1,C,A,45440,17783,-168951,224265,214391
9,ENSG00000204054.5,129476946,chr9-129479582-G-A,rs968477,1,G,A,129479582,2636,129280338,129673554,199244
9,ENSG00000231864.1,137063535,chr9-137087175-A-G,rs968733,1,A,G,137087175,23640,136866927,137260143,220248
9,ENSG00000214593.3,125264090,chr9-125445955-C-T,rs10115550,-1,C,T,125445955,181865,125067482,125460698,378473
9,ENSG00000228510.1,128444587,chr9-128541351-C-A,rs10513496,1,C,A,128541351,96764,128247979,128641195,293372
9,ENSG00000233554.1,33166948,chr9-33107710-T-C,rs10758187,1,T,C,33107710,59238,32970340,33363556,137370
9,ENSG00000234042.1,63703065,chr9-63647087-C-T,rs10796745,1,C,T,63647087,55978,63506457,63899673,140630
9,ENSG00000204860.4,38620526,chr9-38678074-G-C,rs10814736,1,G,C,38678074,57548,38423918,38817134,254156
9,ENSG00000231744.1,124599580,chr9-124708615-C-T,rs10818986,-1,C,T,124708615,109035,124402972,124796188,305643
9,ENSG00000227852.1,35592786,chr9-35599925-T-G,rs10972524,1,T,G,35599925,7139,35396178,35789394,203747
9,ENSG00000227933.1,35646270,chr9-35643366-C-T,rs10972542,1,C,T,35643366,2904,35449662,35842878,193704
9,ENSG00000256968.1,6748981,chr9-6919984-A-G,rs10975898,-1,A,G,6919984,171003,6552373,6945589,367611
9,ENSG00000175611.6,95875480,chr9-95840724-G-T,rs10985499,-1,G,T,95840724,34756,95678872,96072088,161852
9,ENSG00000226783.1,122685933,chr9-122698674-C-T,rs10985750,1,C,T,122698674,12741,122489325,122882541,209349
9,ENSG00000230262.1,94259461,chr9-94148676-G-A,rs10993070,-1,G,A,94148676,110785,94062853,94456069,85823
9,ENSG00000204003.3,136748453,chr9-136672437-G-A,rs11558192,-1,G,A,136672437,76016,136551845,136945061,120592
9,ENSG00000226020.3,63775241,chr9-63592674-G-T,rs115695984,-1,G,T,63592674,182567,63578633,63971849,14041
9,ENSG00000234771.2,128118693,chr9-128104485-G-A,rs116975394,-1,G,A,128104485,14208,127922085,128315301,182400
9,ENSG00000239684.1,63776143,chr9-63840173-A-G,rs118106267,-1,A,G,63840173,64030,63579535,63972751,260638
9,ENSG00000230894.1,116568449,chr9-116525276-A-G,rs12237388,1,A,G,116525276,43173,116371841,116765057,153435
9,ENSG00000228046.1,82428025,chr9-82616282-T-C,rs12685521,-1,T,C,82616282,188257,82231417,82624633,384865
9,ENSG00000246851.1,131194205,chr9-131036101-G-A,rs13283119,-1,G,A,131036101,158104,130997597,131390813,38504
9,ENSG00000226055.1,37878116,chr9-37729789-C-T,rs1359590,1,C,T,37729789,148327,37681508,38074724,48281
9,ENSG00000236924.1,6645875,chr9-6679844-C-G,rs1658940,1,C,G,6679844,33969,6449267,6842483,230577
9,ENSG00000256966.1,37592469,chr9-37521196-G-A,rs16934260,-1,G,A,37521196,71273,37395861,37789077,125335
9,ENSG00000225032.1,127816066,chr9-127642656-T-C,rs17382675,1,T,C,127642656,173410,127619458,128012674,23198
9,ENSG00000234982.1,14204248,chr9-14339757-T-C,rs1998441,1,T,C,14339757,135509,14007640,14400856,332117
9,ENSG00000227388.2,35772311,chr9-35708829-C-A,rs2756894,1,C,A,35708829,63482,35575703,35968919,133126
9,ENSG00000220105.2,4782078,chr9-4596135-G-T,rs301445,-1,G,T,4596135,185943,4585470,4978686,10665
9,ENSG00000220105.2,4782078,chr9-4596135-G-C,rs301445,-1,G,C,4596135,185943,4585470,4978686,10665
9,ENSG00000250850.2,37002651,chr9-36979398-C-T,rs3780169,1,C,T,36979398,23253,36806043,37199259,173355
9,ENSG00000259953.1,112039143,chr9-112015766-C-T,rs4401941,-1,C,T,112015766,23377,111842535,112235751,173231
9,ENSG00000176868.1,131500191,chr9-131560893-T-C,rs4740170,-1,T,C,131560893,60702,131303583,131696799,257310
9,ENSG00000230734.1,117181095,chr9-117129011-A-G,rs4838237,-1,A,G,117129011,52084,116984487,117377703,144524
9,ENSG00000232630.1,125150653,chr9-125029951-G-A,rs4838242,1,G,A,125029951,120702,124954045,125347261,75906
9,ENSG00000238110.1,87945023,chr9-87765109-T-C,rs4878118,-1,T,C,87765109,179914,87748415,88141631,16694
9,ENSG00000230074.1,34665607,chr9-34674765-G-A,rs4878585,1,G,A,34674765,9158,34468999,34862215,205766
9,ENSG00000236083.1,35859980,chr9-35700840-C-T,rs4879926,-1,C,T,35700840,159140,35663372,36056588,37468
9,ENSG00000233016.1,136728184,chr9-136725859-A-G,rs4880136,-1,A,G,136725859,2325,136531576,136924792,194283
9,ENSG00000183784.5,215741,chr9-269510-A-G,rs554243,-1,A,G,269510,53769,19133,412349,250377
9,ENSG00000232850.1,128128529,chr9-127986986-G-A,rs55934610,1,G,A,127986986,141543,127931921,128325137,55065
9,ENSG00000228843.1,35757940,chr9-35742984-G-A,rs58869857,-1,G,A,35742984,14956,35561332,35954548,181652
9,ENSG00000234424.1,85753306,chr9-85629673-T-C,rs591464,1,T,C,85629673,123633,85556698,85949914,72975
9,ENSG00000204814.4,61659733,chr9-61669536-C-T,rs62534929,1,C,T,61669536,9803,61463125,61856341,206411
9,ENSG00000225693.1,33020165,chr9-32890987-C-T,rs62542044,-1,C,T,32890987,129178,32823557,33216773,67430
9,ENSG00000260912.1,19453209,chr9-19431410-G-C,rs7021844,1,G,C,19431410,21799,19256601,19649817,174809
9,ENSG00000217716.3,88016300,chr9-88158956-A-G,rs7042919,1,A,G,88158956,142656,87819692,88212908,339264
9,ENSG00000233947.1,78178263,chr9-78169047-C-T,rs72741763,1,C,T,78169047,9216,77981655,78374871,187392
9,ENSG00000227638.1,88411463,chr9-88559810-G-A,rs72757733,-1,G,A,88559810,148347,88214855,88608071,344955
9,ENSG00000237372.1,89639750,chr9-89783585-G-A,rs74328824,1,G,A,89783585,143835,89443142,89836358,340443
9,ENSG00000228366.1,105710781,chr9-105573866-G-A,rs74995479,-1,G,A,105573866,136915,105514173,105907389,59693
9,ENSG00000261793.1,137171984,chr9-137155084-G-A,rs75845722,-1,G,A,137155084,16900,136975376,137368592,179708
9,ENSG00000235330.1,477856,chr9-653668-C-G,rs78402722,1,C,G,653668,175812,281248,674464,372420
9,ENSG00000203993.3,137618906,chr9-137804404-C-T,rs7852475,-1,C,T,137804404,185498,137422298,137815514,382106
9,ENSG00000257524.1,127899591,chr9-128062515-C-T,rs7854266,-1,C,T,128062515,162924,127702983,128096199,359532
9,ENSG00000224820.1,72108312,chr9-72001261-T-G,rs7855195,-1,T,G,72001261,107051,71911704,72304920,89557
9,ENSG00000225345.3,38568211,chr9-38444601-G-A,rs7865314,-1,G,A,38444601,123610,38371603,38764819,72998
9,ENSG00000232743.1,87816465,chr9-87708054-T-C,rs7868357,1,T,C,87708054,108411,87619857,88013073,88197
9,ENSG00000214121.3,12973438,chr9-12823083-A-G,rs7873809,-1,A,G,12823083,150355,12776830,13170046,46253
9,ENSG00000204055.4,129176326,chr9-129271375-T-C,rs913774,1,T,C,129271375,95049,128979718,129372934,291657
9,ENSG00000232063.1,94332459,chr9-94499290-G-A,rs9409787,1,G,A,94499290,166831,94135851,94529067,363439
9,ENSG00000227218.1,127934503,chr9-128012245-T-C,rs947625,1,T,C,128012245,77742,127737895,128131111,274350
9,ENSG00000260193.1,136109424,chr9-136106764-A-G,rs959016,-1,A,G,136106764,2660,135912816,136306032,193948
9,ENSG00000260193.1,136109424,chr9-136106764-A-C,rs959016,-1,A,C,136106764,2660,135912816,136306032,193948
9,ENSG00000224001.1,98234709,chr9-98333820-T-G,rs10117265,1,T,G,98333820,99111,98038101,98431317,295719
9,ENSG00000236801.1,70217195,chr9-70303251-T-C,rs10125617,1,T,C,70303251,86056,70020587,70413803,282664
9,ENSG00000215237.5,14993312,chr9-14850974-C-T,rs10125920,1,C,T,14850974,142338,14796704,15189920,54270
9,ENSG00000225511.1,92141438,chr9-92158213-G-A,rs10465156,1,G,A,92158213,16775,91944830,92338046,213383
9,ENSG00000214121.3,12973438,chr9-12847827-T-C,rs10491739,-1,T,C,12847827,125611,12776830,13170046,70997
9,ENSG00000228656.1,63762824,chr9-63647087-C-T,rs10796745,-1,C,T,63647087,115737,63566216,63959432,80871
9,ENSG00000261696.1,21396346,chr9-21408825-T-C,rs10811537,-1,T,C,21408825,12479,21199738,21592954,209087
9,ENSG00000227269.1,99183373,chr9-99275688-A-G,rs10819643,1,A,G,99275688,92315,98986765,99379981,288923
9,ENSG00000224546.1,96146007,chr9-96136006-C-T,rs10819907,1,C,T,96136006,10001,95949399,96342615,186607
9,ENSG00000230894.1,116568449,chr9-116571404-C-G,rs10983238,1,C,G,116571404,2955,116371841,116765057,199563
9,ENSG00000234789.1,129640476,chr9-129684814-C-A,rs10988469,1,C,A,129684814,44338,129443868,129837084,240946
9,ENSG00000235641.1,91159769,chr9-91207845-T-C,rs10991829,1,T,C,91207845,48076,90963161,91356377,244684
9,ENSG00000232063.1,94332459,chr9-94306657-A-C,rs10993161,1,A,C,94306657,25802,94135851,94529067,170806
9,ENSG00000255585.1,137788690,chr9-137914847-G-A,rs11137301,-1,G,A,137914847,126157,137592082,137985298,322765
9,ENSG00000159247.7,138175045,chr9-138130876-C-A,rs11137376,1,C,A,138130876,44169,137978437,138371653,152439
9,ENSG00000237886.1,136546212,chr9-136427093-G-A,rs11145988,1,G,A,136427093,119119,136349604,136742820,77489
9,ENSG00000225345.3,38568211,chr9-38572665-G-A,rs111732472,-1,G,A,38572665,4454,38371603,38764819,201062
9,ENSG00000176007.9,38527097,chr9-38406593-G-A,rs11361,1,G,A,38406593,120504,38330489,38723705,76104
9,ENSG00000204816.4,42625436,chr9-42729141-C-T,rs117413457,1,C,T,42729141,103705,42428828,42822044,300313
9,ENSG00000236816.2,42852675,chr9-42729141-C-T,rs117413457,1,C,T,42729141,123534,42656067,43049283,73074
9,ENSG00000213212.3,136815536,chr9-136873840-C-T,rs118075423,-1,C,T,136873840,58304,136618928,137012144,254912
9,ENSG00000226020.3,63775241,chr9-63840173-A-G,rs118106267,-1,A,G,63840173,64932,63578633,63971849,261540
9,ENSG00000204790.6,64004155,chr9-63840173-A-G,rs118106267,-1,A,G,63840173,163982,63807547,64200763,32626
9,ENSG00000256968.1,6748981,chr9-6923580-C-T,rs12156540,-1,C,T,6923580,174599,6552373,6945589,371207
9,ENSG00000232303.1,32567126,chr9-32695754-A-G,rs1329008,-1,A,G,32695754,128628,32370518,32763734,325236
9,ENSG00000260193.1,136109424,chr9-136152913-G-A,rs1622817,-1,G,A,136152913,43489,135912816,136306032,240097
9,ENSG00000257524.1,127899591,chr9-127837679-C-T,rs2005129,-1,C,T,127837679,61912,127702983,128096199,134696
9,ENSG00000231381.1,6670008,chr9-6620059-A-G,rs2118653,-1,A,G,6620059,49949,6473400,6866616,146659
9,ENSG00000232176.1,19201046,chr9-19376410-A-C,rs2277151,-1,A,C,19376410,175364,19004438,19397654,371972
9,ENSG00000232176.1,19201046,chr9-19376410-A-G,rs2277151,-1,A,G,19376410,175364,19004438,19397654,371972
9,ENSG00000230262.1,94259461,chr9-94237778-C-T,rs2717487,-1,C,T,94237778,21683,94062853,94456069,174925
9,ENSG00000236156.1,37434177,chr9-37426155-A-G,rs2768659,1,A,G,37426155,8022,37237569,37630785,188586
9,ENSG00000261215.1,34666029,chr9-34655439-T-C,rs2812357,-1,T,C,34655439,10590,34469421,34862637,186018
9,ENSG00000231864.1,137063535,chr9-137194178-G-A,rs28417902,1,G,A,137194178,130643,136866927,137260143,327251
9,ENSG00000236857.1,18718526,chr9-18609332-T-C,rs34157511,-1,T,C,18609332,109194,18521918,18915134,87414
9,ENSG00000238110.1,87945023,chr9-88089027-C-T,rs35178121,-1,C,T,88089027,144004,87748415,88141631,340612
9,ENSG00000204814.4,61659733,chr9-61663338-C-T,rs35478119,1,C,T,61663338,3605,61463125,61856341,200213
9,ENSG00000225434.1,72305464,chr9-72237388-G-A,rs4347048,1,G,A,72237388,68076,72108856,72502072,128532
9,ENSG00000238172.1,100117651,chr9-100040531-A-C,rs4743378,-1,A,C,100040531,77120,99921043,100314259,119488
9,ENSG00000213816.2,42973289,chr9-42877458-C-T,rs62538291,-1,C,T,42877458,95831,42776681,43169897,100777
9,ENSG00000231744.1,124599580,chr9-124696189-G-A,rs6478680,-1,G,A,124696189,96609,124402972,124796188,293217
9,ENSG00000237158.1,6568844,chr9-6611609-G-T,rs7035933,1,G,T,6611609,42765,6372236,6765452,239373
9,ENSG00000233554.1,33166948,chr9-33186158-T-C,rs7038463,1,T,C,33186158,19210,32970340,33363556,215818
9,ENSG00000186940.6,79391304,chr9-79509455-C-T,rs7040700,1,C,T,79509455,118151,79194696,79587912,314759
9,ENSG00000215548.2,63859641,chr9-63702618-C-A,rs7041252,-1,C,A,63702618,157023,63663033,64056249,39585
9,ENSG00000225411.1,63814159,chr9-63659593-G-A,rs72709884,-1,G,A,63659593,154566,63617551,64010767,42042
9,ENSG00000233178.1,68406454,chr9-68463206-A-G,rs74706355,-1,A,G,68463206,56752,68209846,68603062,253360
9,ENSG00000204055.4,129176326,chr9-129243022-C-T,rs749840,1,C,T,129243022,66696,128979718,129372934,263304
9,ENSG00000226327.2,88324454,chr9-88460248-G-A,rs75561980,1,G,A,88460248,135794,88127846,88521062,332402
9,ENSG00000237679.1,94288550,chr9-94304211-G-A,rs77505892,-1,G,A,94304211,15661,94091942,94485158,212269
9,ENSG00000232104.1,3526535,chr9-3584719-T-C,rs7870248,1,T,C,3584719,58184,3329927,3723143,254792
9,ENSG00000224820.1,72108312,chr9-72299078-C-G,rs7874628,-1,C,G,72299078,190766,71911704,72304920,387374
9,ENSG00000227218.1,127934503,chr9-127866860-T-G,rs913987,1,T,G,127866860,67643,127737895,128131111,128965
9,ENSG00000180539.4,137027464,chr9-137055556-G-A,rs9411242,1,G,A,137055556,28092,136830856,137224072,224700
9,ENSG00000229257.1,137057663,chr9-137195039-C-T,rs9411252,1,C,T,137195039,137376,136861055,137254271,333984
9,ENSG00000246851.1,131194205,chr9-131260861-G-A,rs9966,-1,G,A,131260861,66656,130997597,131390813,263264
8,ENSG00000167912.5,59119216,chr8-58960675-A-C,rs10092016,1,A,C,58960675,158541,58922608,59315824,38067
8,ENSG00000249859.2,127794541,chr8-127652696-T-C,rs10100504,1,T,C,127652696,141845,127597933,127991149,54763
8,ENSG00000246528.2,69834153,chr8-69854412-G-T,rs10103771,1,G,T,69854412,20259,69637545,70030761,216867
8,ENSG00000250428.1,124920428,chr8-124871033-G-A,rs10110021,1,G,A,124871033,49395,124723820,125117036,147213
8,ENSG00000226098.3,54523297,chr8-54587666-C-G,rs10113142,-1,C,G,54587666,64369,54326689,54719905,260977
8,ENSG00000254352.1,78724136,chr8-78663569-T-C,rs1021156,-1,T,C,78663569,60567,78527528,78920744,136041
8,ENSG00000261618.1,78835307,chr8-78663569-T-C,rs1021156,1,T,C,78663569,171738,78638699,79031915,24870
8,ENSG00000250979.1,72251565,chr8-72366328-A-G,rs10453111,-1,A,G,72366328,114763,72054957,72448173,311371
8,ENSG00000254266.1,78508485,chr8-78539135-G-A,rs10504676,-1,G,A,78539135,30650,78311877,78705093,227258
8,ENSG00000253214.1,81154265,chr8-81121292-T-C,rs10504731,1,T,C,81121292,32973,80957657,81350873,163635
8,ENSG00000183154.1,37737426,chr8-37853880-G-A,rs10808346,-1,G,A,37853880,116454,37540818,37934034,313062
8,ENSG00000254690.1,144315138,chr8-144441636-A-G,rs10902781,-1,A,G,144441636,126498,144118530,144511746,323106
8,ENSG00000177335.6,143039328,chr8-143043095-T-C,rs11136299,1,T,C,143043095,3767,142842720,143235936,200375
8,ENSG00000254244.1,4787332,chr8-4659395-C-G,rs11136760,1,C,G,4659395,127937,4590724,4983940,68671
8,ENSG00000254244.1,4787332,chr8-4659395-C-T,rs11136760,1,C,T,4659395,127937,4590724,4983940,68671
8,ENSG00000253716.1,143281705,chr8-143239885-G-C,rs117340186,-1,G,C,143239885,41820,143085097,143478313,154788
8,ENSG00000260368.1,100914388,chr8-100970958-C-T,rs117500306,-1,C,T,100970958,56570,100717780,101110996,253178
8,ENSG00000260368.1,100914388,chr8-100970958-C-G,rs117500306,-1,C,G,100970958,56570,100717780,101110996,253178
8,ENSG00000223508.4,213707,chr8-214984-A-G,rs11780869,-1,A,G,214984,1277,17099,410315,197885
8,ENSG00000253616.1,23074488,chr8-23074609-A-C,rs11784599,-1,A,C,23074609,121,22877880,23271096,196729
8,ENSG00000253616.1,23074488,chr8-23074609-A-T,rs11784599,-1,A,T,23074609,121,22877880,23271096,196729
8,ENSG00000245910.2,66925591,chr8-66967793-T-G,rs11985129,-1,T,G,66967793,42202,66728983,67122199,238810
8,ENSG00000254319.1,2728434,chr8-2738156-G-C,rs12056807,-1,G,C,2738156,9722,2531826,2925042,206330
8,ENSG00000253853.1,2726963,chr8-2738156-G-C,rs12056807,1,G,C,2738156,11193,2530355,2923571,207801
8,ENSG00000246130.1,23068229,chr8-23231650-C-A,rs12543863,1,C,A,23231650,163421,22871621,23264837,360029
8,ENSG00000246130.1,23068229,chr8-23231650-C-T,rs12543863,1,C,T,23231650,163421,22871621,23264837,360029
8,ENSG00000253896.2,72601,chr8-248839-C-T,rs12680113,1,C,T,248839,176238,-124007,269209,372846
8,ENSG00000253125.1,22690150,chr8-22755659-A-G,rs12682145,1,A,G,22755659,65509,22493542,22886758,262117
8,ENSG00000253174.1,41545044,chr8-41554412-C-A,rs13268546,-1,C,A,41554412,9368,41348436,41741652,205976
8,ENSG00000254340.1,9141427,chr8-9037721-G-C,rs13274157,1,G,C,9037721,103706,8944819,9338035,92902
8,ENSG00000250714.2,23230915,chr8-23225458-G-T,rs13278062,-1,G,T,23225458,5457,23034307,23427523,191151
8,ENSG00000250714.2,23230915,chr8-23225458-G-A,rs13278062,-1,G,A,23225458,5457,23034307,23427523,191151
8,ENSG00000246582.2,23225221,chr8-23225458-G-T,rs13278062,1,G,T,23225458,237,23028613,23421829,196845
8,ENSG00000246582.2,23225221,chr8-23225458-G-A,rs13278062,1,G,A,23225458,237,23028613,23421829,196845
8,ENSG00000253633.1,102528740,chr8-102536282-A-G,rs1347320,1,A,G,102536282,7542,102332132,102725348,204150
8,ENSG00000253859.2,81439436,chr8-81507277-A-G,rs1485999,1,A,G,81507277,67841,81242828,81636044,264449
8,ENSG00000253541.1,56477987,chr8-56616649-T-C,rs1606502,-1,T,C,56616649,138662,56281379,56674595,335270
8,ENSG00000253793.1,30984321,chr8-30867084-C-T,rs16877430,-1,C,T,30867084,117237,30787713,31180929,79371
8,ENSG00000253607.1,123002560,chr8-123126615-G-A,rs16898012,1,G,A,123126615,124055,122805952,123199168,320663
8,ENSG00000254088.1,86503591,chr8-86593578-T-A,rs16915984,1,T,A,86593578,89987,86306983,86700199,286595
8,ENSG00000253431.1,62864181,chr8-62840236-A-G,rs16929693,-1,A,G,62840236,23945,62667573,63060789,172663
8,ENSG00000246145.1,66428977,chr8-66270337-T-C,rs16932701,-1,T,C,66270337,158640,66232369,66625585,37968
8,ENSG00000228451.3,26381519,chr8-26310975-G-A,rs17055109,-1,G,A,26310975,70544,26184911,26578127,126064
8,ENSG00000246339.3,28702030,chr8-28712764-T-G,rs17059323,-1,T,G,28712764,10734,28505422,28898638,207342
8,ENSG00000244593.1,18383917,chr8-18216813-A-G,rs17126350,-1,A,G,18216813,167104,18187309,18580525,29504
8,ENSG00000255050.1,143573490,chr8-143580905-G-A,rs1809148,1,G,A,143580905,7415,143376882,143770098,204023
8,ENSG00000245970.2,98041726,chr8-97978993-A-G,rs1869609,1,A,G,97978993,62733,97845118,98238334,133875
8,ENSG00000250929.2,103121032,chr8-103085168-G-A,rs2047375,1,G,A,103085168,35864,102924424,103317640,160744
8,ENSG00000253738.1,91070192,chr8-91008808-C-T,rs2054805,-1,C,T,91008808,61384,90873584,91266800,135224
8,ENSG00000253666.1,100475670,chr8-100479811-C-T,rs2154636,1,C,T,100479811,4141,100279062,100672278,200749
8,ENSG00000254812.1,143632783,chr8-143613329-C-A,rs2242086,-1,C,A,143613329,19454,143436175,143829391,177154
8,ENSG00000253389.1,41660991,chr8-41701380-T-G,rs2304881,1,T,G,41701380,40389,41464383,41857599,236997
8,ENSG00000253923.2,102417979,chr8-102579009-G-A,rs2436916,1,G,A,102579009,161030,102221371,102614587,357638
8,ENSG00000261026.1,22684009,chr8-22872569-G-A,rs2457436,-1,G,A,22872569,188560,22487401,22880617,385168
8,ENSG00000248738.2,22877984,chr8-22880458-C-T,rs2466177,1,C,T,22880458,2474,22681376,23074592,199082
8,ENSG00000251013.1,100551713,chr8-100595169-C-G,rs2469661,-1,C,G,100595169,43456,100355105,100748321,240064
8,ENSG00000229211.3,31220984,chr8-31096348-T-C,rs2553260,-1,T,C,31096348,124636,31024376,31417592,71972
8,ENSG00000253741.1,142726992,chr8-142727533-C-T,rs2585138,-1,C,T,142727533,541,142530384,142923600,197149
8,ENSG00000253570.1,38601200,chr8-38596499-T-C,rs2604496,-1,T,C,38596499,4701,38404592,38797808,191907
8,ENSG00000253690.1,28339255,chr8-28311442-A-G,rs2722909,-1,A,G,28311442,27813,28142647,28535863,168795
8,ENSG00000250483.1,15807283,chr8-15848734-A-G,rs2736003,-1,A,G,15848734,41451,15610675,16003891,238059
8,ENSG00000244998.1,141392574,chr8-141497430-C-G,rs2748398,-1,C,G,141497430,104856,141195966,141589182,301464
8,ENSG00000225885.1,118291208,chr8-118292261-C-A,rs2875791,1,C,A,118292261,1053,118094600,118487816,197661
8,ENSG00000173295.2,8228605,chr8-8370514-C-T,rs2976972,1,C,T,8370514,141909,8031997,8425213,338517
8,ENSG00000249898.3,6708209,chr8-6661022-T-G,rs2980647,-1,T,G,6661022,47187,6511601,6904817,149421
8,ENSG00000254859.1,143549729,chr8-143529559-A-C,rs4242488,-1,A,C,143529559,20170,143353121,143746337,176438
8,ENSG00000247317.3,143018447,chr8-143012733-C-T,rs4270940,-1,C,T,143012733,5714,142821839,143215055,190894
8,ENSG00000251470.1,46697630,chr8-46682790-T-C,rs4344090,1,T,C,46682790,14840,46501022,46894238,181768
8,ENSG00000248498.3,46614523,chr8-46682790-T-C,rs4344090,-1,T,C,46682790,68267,46417915,46811131,264875
8,ENSG00000246366.2,70608577,chr8-70652432-T-C,rs441890,1,T,C,70652432,43855,70411969,70805185,240463
8,ENSG00000253167.1,125040684,chr8-125039544-A-C,rs4601330,1,A,C,125039544,1140,124844076,125237292,195468
8,ENSG00000255310.1,11109726,chr8-11111725-T-A,rs4618656,-1,T,A,11111725,1999,10913118,11306334,198607
8,ENSG00000261087.1,101169629,chr8-101294397-T-A,rs4734023,-1,T,A,101294397,124768,100973021,101366237,321376
8,ENSG00000237810.3,62144769,chr8-62203897-G-A,rs4737600,-1,G,A,62203897,59128,61948161,62341377,255736
8,ENSG00000261542.1,63215981,chr8-63191534-A-G,rs4739066,1,A,G,63191534,24447,63019373,63412589,172161
8,ENSG00000254129.1,29110573,chr8-29295520-C-T,rs491687,1,C,T,29295520,184947,28913965,29307181,381555
8,ENSG00000254307.1,94792963,chr8-94722486-C-T,rs6471480,-1,C,T,94722486,70477,94596355,94989571,126131
8,ENSG00000242607.1,12571130,chr8-12762917-T-G,rs6530972,-1,T,G,12762917,191787,12374522,12767738,388395
8,ENSG00000243537.1,133325997,chr8-133375112-A-C,rs6980814,1,A,C,133375112,49115,133129389,133522605,245723
8,ENSG00000251191.2,29735223,chr8-29745685-G-T,rs6983144,-1,G,T,29745685,10462,29538615,29931831,207070
8,ENSG00000247134.2,32927913,chr8-32897503-A-G,rs6986337,1,A,G,32897503,30410,32731305,33124521,166198
8,ENSG00000260398.1,78605952,chr8-78598290-A-G,rs6990845,1,A,G,78598290,7662,78409344,78802560,188946
8,ENSG00000248522.1,55455139,chr8-55425498-C-T,rs6995409,-1,C,T,55425498,29641,55258531,55651747,166967
8,ENSG00000196922.4,144999723,chr8-144953363-G-A,rs7000385,-1,G,A,144953363,46360,144803115,145196331,150248
8,ENSG00000254389.1,143368548,chr8-143365185-A-G,rs7003432,-1,A,G,143365185,3363,143171940,143565156,193245
8,ENSG00000253200.1,22616657,chr8-22662302-A-C,rs7005025,-1,A,C,22662302,45645,22420049,22813265,242253
8,ENSG00000253210.1,141130064,chr8-141127535-T-C,rs7009780,-1,T,C,141127535,2529,140933456,141326672,194079
8,ENSG00000255559.1,145002811,chr8-144911030-C-G,rs71522403,1,C,G,144911030,91781,144806203,145199419,104827
8,ENSG00000253605.1,141459075,chr8-141538426-G-A,rs72685498,1,G,A,141538426,79351,141262467,141655683,275959
8,ENSG00000224722.3,127087510,chr8-127163451-G-A,rs735542,-1,G,A,127163451,75941,126890902,127284118,272549
8,ENSG00000253161.1,37554183,chr8-37479021-C-T,rs743282,-1,C,T,37479021,75162,37357575,37750791,121446
8,ENSG00000253982.1,1764508,chr8-1768450-T-A,rs7461159,-1,T,A,1768450,3942,1567900,1961116,200550
8,ENSG00000243844.1,29632091,chr8-29436837-A-G,rs74798523,1,A,G,29436837,195254,29435483,29828699,1354
8,ENSG00000254578.1,144463817,chr8-144476070-A-C,rs750472,1,A,C,144476070,12253,144267209,144660425,208861
8,ENSG00000254285.2,61578220,chr8-61608431-C-T,rs76132602,1,C,T,61608431,30211,61381612,61774828,226819
8,ENSG00000253824.1,100464613,chr8-100354814-C-G,rs77744491,-1,C,G,100354814,109799,100268005,100661221,86809
8,ENSG00000253824.1,100464613,chr8-100354814-C-T,rs77744491,-1,C,T,100354814,109799,100268005,100661221,86809
8,ENSG00000253842.1,100432726,chr8-100265151-C-G,rs7824192,-1,C,G,100265151,167575,100236118,100629334,29033
8,ENSG00000260317.1,80541300,chr8-80483375-T-C,rs78289944,1,T,C,80483375,57925,80344692,80737908,138683
8,ENSG00000253550.1,6474288,chr8-6569623-G-T,rs78340857,-1,G,T,6569623,95335,6277680,6670896,291943
8,ENSG00000253550.1,6474288,chr8-6569623-G-C,rs78340857,-1,G,C,6569623,95335,6277680,6670896,291943
8,ENSG00000253550.1,6474288,chr8-6569623-G-A,rs78340857,-1,G,A,6569623,95335,6277680,6670896,291943
8,ENSG00000261220.1,133572158,chr8-133574394-A-G,rs7839535,1,A,G,133574394,2236,133375550,133768766,198844
8,ENSG00000255046.1,11802512,chr8-11795641-T-A,rs7845566,-1,T,A,11795641,6871,11605904,11999120,189737
8,ENSG00000255046.1,11802512,chr8-11795641-T-C,rs7845566,-1,T,C,11795641,6871,11605904,11999120,189737
8,ENSG00000255164.1,144992914,chr8-144920209-C-T,rs79181160,1,C,T,144920209,72705,144796306,145189522,123903
8,ENSG00000215288.4,27012371,chr8-27191767-C-G,rs80182079,-1,C,G,27191767,179396,26815763,27208979,376004
8,ENSG00000247081.2,103285907,chr8-103351442-G-T,rs827589,-1,G,T,103351442,65535,103089299,103482515,262143
8,ENSG00000241511.1,30117779,chr8-30020213-G-A,rs991124,-1,G,A,30020213,97566,29921171,30314387,99042
8,ENSG00000241511.1,30117779,chr8-30020213-G-T,rs991124,-1,G,T,30020213,97566,29921171,30314387,99042
8,ENSG00000253636.1,73052178,chr8-73134791-A-G,rs10097640,1,A,G,73134791,82613,72855570,73248786,279221
8,ENSG00000253161.1,37554183,chr8-37651148-C-T,rs10101300,-1,C,T,37651148,96965,37357575,37750791,293573
8,ENSG00000254266.1,78508485,chr8-78640408-A-G,rs10103897,-1,A,G,78640408,131923,78311877,78705093,328531
8,ENSG00000254812.1,143632783,chr8-143614871-A-G,rs1049832,-1,A,G,143614871,17912,143436175,143829391,178696
8,ENSG00000254389.1,143368548,chr8-143338760-C-T,rs10866910,-1,C,T,143338760,29788,143171940,143565156,166820
8,ENSG00000254088.1,86503591,chr8-86350477-A-G,rs10956802,1,A,G,86350477,153114,86306983,86700199,43494
8,ENSG00000254088.1,86503591,chr8-86350477-A-C,rs10956802,1,A,C,86350477,153114,86306983,86700199,43494
8,ENSG00000260398.1,78605952,chr8-78705078-G-A,rs10957898,1,G,A,78705078,99126,78409344,78802560,295734
8,ENSG00000253140.1,48518157,chr8-48445879-C-T,rs1123189,-1,C,T,48445879,72278,48321549,48714765,124330
8,ENSG00000196922.4,144999723,chr8-144929717-A-G,rs11248216,-1,A,G,144929717,70006,144803115,145196331,126602
8,ENSG00000253995.1,33540185,chr8-33677947-C-A,rs115503498,1,C,A,33677947,137762,33343577,33736793,334370
8,ENSG00000243181.2,34874159,chr8-34687373-T-C,rs117251116,1,T,C,34687373,186786,34677551,35070767,9822
8,ENSG00000253738.1,91070192,chr8-91063633-C-T,rs117344858,-1,C,T,91063633,6559,90873584,91266800,190049
8,ENSG00000213003.2,70273369,chr8-70109636-G-A,rs11786496,1,G,A,70109636,163733,70076761,70469977,32875
8,ENSG00000255107.1,69860540,chr8-69831932-G-A,rs118016633,-1,G,A,69831932,28608,69663932,70057148,168000
8,ENSG00000248738.2,22877984,chr8-22840696-G-A,rs11986200,1,G,A,22840696,37288,22681376,23074592,159320
8,ENSG00000248492.1,134598071,chr8-134642499-T-G,rs11995190,1,T,G,134642499,44428,134401463,134794679,241036
8,ENSG00000254231.1,86343429,chr8-86214786-G-T,rs12542402,-1,G,T,86214786,128643,86146821,86540037,67965
8,ENSG00000254231.1,86343429,chr8-86214786-G-A,rs12542402,-1,G,A,86214786,128643,86146821,86540037,67965
8,ENSG00000246366.2,70608577,chr8-70617031-A-G,rs13271014,1,A,G,70617031,8454,70411969,70805185,205062
8,ENSG00000249898.3,6708209,chr8-6675043-T-C,rs13279216,-1,T,C,6675043,33166,6511601,6904817,163442
8,ENSG00000253541.1,56477987,chr8-56651895-T-C,rs1425594,-1,T,C,56651895,173908,56281379,56674595,370516
8,ENSG00000253431.1,62864181,chr8-62828794-G-C,rs1552053,-1,G,C,62828794,35387,62667573,63060789,161221
8,ENSG00000245970.2,98041726,chr8-98143304-G-A,rs16896685,1,G,A,98143304,101578,97845118,98238334,298186
8,ENSG00000254065.1,47592609,chr8-47432026-G-A,rs16926260,-1,G,A,47432026,160583,47396001,47789217,36025
8,ENSG00000251633.3,73915010,chr8-73966852-C-G,rs16938747,-1,C,G,73966852,51842,73718402,74111618,248450
8,ENSG00000250483.1,15807283,chr8-15789199-G-A,rs17121980,-1,G,A,15789199,18084,15610675,16003891,178524
8,ENSG00000245281.2,18084386,chr8-17892648-C-T,rs17125814,1,C,T,17892648,191738,17887778,18280994,4870
8,ENSG00000254006.1,64817573,chr8-64679163-A-G,rs17293712,-1,A,G,64679163,138410,64620965,65014181,58198
8,ENSG00000173295.2,8228605,chr8-8406558-C-T,rs17669632,1,C,T,8406558,177953,8031997,8425213,374561
8,ENSG00000260588.1,41829934,chr8-41728053-C-T,rs1872877,-1,C,T,41728053,101881,41633326,42026542,94727
8,ENSG00000253945.1,95403802,chr8-95301179-C-G,rs1994793,1,C,G,95301179,102623,95207194,95600410,93985
8,ENSG00000253666.1,100475670,chr8-100492452-T-A,rs2022919,1,T,A,100492452,16782,100279062,100672278,213390
8,ENSG00000223508.4,213707,chr8-245254-C-A,rs2074718,-1,C,A,245254,31547,17099,410315,228155
8,ENSG00000223508.4,213707,chr8-245254-C-T,rs2074718,-1,C,T,245254,31547,17099,410315,228155
8,ENSG00000253330.1,47512141,chr8-47580283-T-C,rs2171854,-1,T,C,47580283,68142,47315533,47708749,264750
8,ENSG00000250714.2,23230915,chr8-23260130-T-C,rs2294125,-1,T,C,23260130,29215,23034307,23427523,225823
8,ENSG00000254285.2,61578220,chr8-61615586-C-T,rs2350622,1,C,T,61615586,37366,61381612,61774828,233974
8,ENSG00000253633.1,102528740,chr8-102564430-G-A,rs2436889,1,G,A,102564430,35690,102332132,102725348,232298
8,ENSG00000246089.2,6406572,chr8-6407358-T-G,rs2440452,-1,T,G,6407358,786,6209964,6603180,197394
8,ENSG00000225885.1,118291208,chr8-118148769-C-T,rs2468147,1,C,T,118148769,142439,118094600,118487816,54169
8,ENSG00000245080.3,95072920,chr8-95015078-G-A,rs2599723,-1,G,A,95015078,57842,94876312,95269528,138766
8,ENSG00000253167.1,125040684,chr8-124961673-T-G,rs2725881,1,T,G,124961673,79011,124844076,125237292,117597
8,ENSG00000253893.1,8226614,chr8-8248986-C-T,rs2948300,-1,C,T,8248986,22372,8030006,8423222,218980
8,ENSG00000250752.2,6899468,chr8-6858229-A-G,rs2980945,-1,A,G,6858229,41239,6702860,7096076,155369
8,ENSG00000253210.1,141130064,chr8-141182470-G-A,rs307739,-1,G,A,141182470,52406,140933456,141326672,249014
8,ENSG00000254294.1,123400582,chr8-123342728-G-C,rs34136040,1,G,C,123342728,57854,123203974,123597190,138754
8,ENSG00000245149.3,124474564,chr8-124430010-C-T,rs35630807,-1,C,T,124430010,44554,124277956,124671172,152054
8,ENSG00000228451.3,26381519,chr8-26381867-C-A,rs3758098,-1,C,A,26381867,348,26184911,26578127,196956
8,ENSG00000246582.2,23225221,chr8-23103040-C-A,rs41308122,1,C,A,23103040,122181,23028613,23421829,74427
8,ENSG00000251136.2,89757383,chr8-89766285-G-A,rs42490,-1,G,A,89766285,8902,89560775,89953991,205510
8,ENSG00000253616.1,23074488,chr8-23075498-G-A,rs4373519,-1,G,A,23075498,1010,22877880,23271096,197618
8,ENSG00000253616.1,23074488,chr8-23075498-G-C,rs4373519,-1,G,C,23075498,1010,22877880,23271096,197618
8,ENSG00000253214.1,81154265,chr8-81118320-T-C,rs4481546,1,T,C,81118320,35945,80957657,81350873,160663
8,ENSG00000177335.6,143039328,chr8-143102029-C-T,rs4607586,1,C,T,143102029,62701,142842720,143235936,259309
8,ENSG00000249859.2,127794541,chr8-127739317-C-T,rs4645963,1,C,T,127739317,55224,127597933,127991149,141384
8,ENSG00000246528.2,69834153,chr8-69849675-C-T,rs4738034,1,C,T,69849675,15522,69637545,70030761,212130
8,ENSG00000253981.1,8241411,chr8-8357833-T-C,rs4840939,-1,T,C,8357833,116422,8044803,8438019,313030
8,ENSG00000253389.1,41660991,chr8-41642195-A-G,rs537519,1,A,G,41642195,18796,41464383,41857599,177812
8,ENSG00000253200.1,22616657,chr8-22614675-A-G,rs55677256,-1,A,G,22614675,1982,22420049,22813265,194626
8,ENSG00000251191.2,29735223,chr8-29859859-C-G,rs57950553,-1,C,G,29859859,124636,29538615,29931831,321244
8,ENSG00000255182.1,144505444,chr8-144686890-G-A,rs62529935,-1,G,A,144686890,181446,144308836,144702052,378054
8,ENSG00000253605.1,141459075,chr8-141528639-C-T,rs6578201,1,C,T,141528639,69564,141262467,141655683,266172
8,ENSG00000253174.1,41545044,chr8-41659396-C-T,rs6981587,-1,C,T,41659396,114352,41348436,41741652,310960
8,ENSG00000253853.1,2726963,chr8-2733108-C-G,rs6982142,1,C,G,2733108,6145,2530355,2923571,202753
8,ENSG00000254129.1,29110573,chr8-29203064-G-A,rs6989058,1,G,A,29203064,92491,28913965,29307181,289099
8,ENSG00000231942.3,81807772,chr8-81733317-C-T,rs6998845,1,C,T,81733317,74455,81611164,82004380,122153
8,ENSG00000254741.1,143579636,chr8-143541958-A-G,rs6998917,1,A,G,143541958,37678,143383028,143776244,158930
8,ENSG00000254319.1,2728434,chr8-2754175-C-G,rs6998935,-1,C,G,2754175,25741,2531826,2925042,222349
8,ENSG00000255164.1,144992914,chr8-144953363-G-A,rs7000385,1,G,A,144953363,39551,144796306,145189522,157057
8,ENSG00000251396.2,60516795,chr8-60455509-T-C,rs7013829,-1,T,C,60455509,61286,60320187,60713403,135322
8,ENSG00000253550.1,6474288,chr8-6433344-A-G,rs73196775,-1,A,G,6433344,40944,6277680,6670896,155664
8,ENSG00000253930.1,23189279,chr8-23162697-G-A,rs73222565,1,G,A,23162697,26582,22992671,23385887,170026
8,ENSG00000233915.4,86661922,chr8-86808936-C-T,rs73280539,-1,C,T,86808936,147014,86465314,86858530,343622
8,ENSG00000253716.1,143281705,chr8-143223253-A-G,rs75548654,-1,A,G,143223253,58452,143085097,143478313,138156
8,ENSG00000236191.3,68525906,chr8-68668440-C-T,rs763845,-1,C,T,68668440,142534,68329298,68722514,339142
8,ENSG00000254162.1,80539135,chr8-80462733-A-C,rs76592669,-1,A,C,80462733,76402,80342527,80735743,120206
8,ENSG00000253667.1,53971231,chr8-53998443-G-A,rs76733857,1,G,A,53998443,27212,53774623,54167839,223820
8,ENSG00000253320.1,102864271,chr8-103023225-A-G,rs77481455,1,A,G,103023225,158954,102667663,103060879,355562
8,ENSG00000261451.1,10433672,chr8-10411865-T-C,rs7817793,1,T,C,10411865,21807,10237064,10630280,174801
8,ENSG00000188856.6,80558870,chr8-80748932-C-T,rs7844007,1,C,T,80748932,190062,80362262,80755478,386670
8,ENSG00000253669.2,102805517,chr8-102981228-G-A,rs78483911,1,G,A,102981228,175711,102608909,103002125,372319
8,ENSG00000255559.1,145002811,chr8-144837006-C-T,rs79007298,1,C,T,144837006,165805,144806203,145199419,30803
8,ENSG00000245164.2,126292788,chr8-126252930-T-C,rs79283829,-1,T,C,126252930,39858,126096180,126489396,156750
8,ENSG00000243537.1,133325997,chr8-133363047-G-A,rs79437414,1,G,A,133363047,37050,133129389,133522605,233658
8,ENSG00000259607.1,29067279,chr8-29167914-G-A,rs876058,1,G,A,29167914,100635,28870671,29263887,297243
8,ENSG00000250929.2,103121032,chr8-103047974-C-A,rs9283939,1,C,A,103047974,73058,102924424,103317640,123550
8,ENSG00000261220.1,133572158,chr8-133609443-A-G,rs9643306,1,A,G,133609443,37285,133375550,133768766,233893
8,ENSG00000253114.1,54696398,chr8-54518793-G-A,rs10089685,1,G,A,54518793,177605,54499790,54893006,19003
8,ENSG00000249898.3,6708209,chr8-6670089-C-G,rs10092065,-1,C,G,6670089,38120,6511601,6904817,158488
8,ENSG00000254859.1,143549729,chr8-143563290-A-G,rs10099003,-1,A,G,143563290,13561,143353121,143746337,210169
8,ENSG00000243181.2,34874159,chr8-35005684-T-G,rs10103839,1,T,G,35005684,131525,34677551,35070767,328133
8,ENSG00000251191.2,29735223,chr8-29678789-C-A,rs10105138,-1,C,A,29678789,56434,29538615,29931831,140174
8,ENSG00000261542.1,63215981,chr8-63235799-A-G,rs10108613,1,A,G,63235799,19818,63019373,63412589,216426
8,ENSG00000253629.1,101686547,chr8-101758750-C-G,rs10111993,1,C,G,101758750,72203,101489939,101883155,268811
8,ENSG00000255164.1,144992914,chr8-144973728-G-C,rs1045350,1,G,C,144973728,19186,144796306,145189522,177422
8,ENSG00000248492.1,134598071,chr8-134623238-C-A,rs1077224,1,C,A,134623238,25167,134401463,134794679,221775
8,ENSG00000249258.2,17131181,chr8-17041671-G-A,rs11203826,1,G,A,17041671,89510,16934573,17327789,107098
8,ENSG00000250752.2,6899468,chr8-7050482-C-T,rs112059898,-1,C,T,7050482,151014,6702860,7096076,347622
8,ENSG00000250752.2,6899468,chr8-7050482-C-A,rs112059898,-1,C,A,7050482,151014,6702860,7096076,347622
8,ENSG00000258677.1,73878854,chr8-73898173-G-A,rs113296456,-1,G,A,73898173,19319,73682246,74075462,215927
8,ENSG00000241431.1,56588407,chr8-56614628-G-A,rs113437773,1,G,A,56614628,26221,56391799,56785015,222829
8,ENSG00000253793.1,30984321,chr8-31147626-C-T,rs11574359,-1,C,T,31147626,163305,30787713,31180929,359913
8,ENSG00000254129.1,29110573,chr8-29231230-C-T,rs117559425,1,C,T,29231230,120657,28913965,29307181,317265
8,ENSG00000250428.1,124920428,chr8-124782538-T-G,rs117772542,1,T,G,124782538,137890,124723820,125117036,58718
8,ENSG00000250428.1,124920428,chr8-124782538-T-C,rs117772542,1,T,C,124782538,137890,124723820,125117036,58718
8,ENSG00000253389.1,41660991,chr8-41598060-C-T,rs11996670,1,C,T,41598060,62931,41464383,41857599,133677
8,ENSG00000224594.2,48384590,chr8-48370786-G-A,rs12334834,1,G,A,48370786,13804,48187982,48581198,182804
8,ENSG00000247081.2,103285907,chr8-103153554-C-T,rs12335035,-1,C,T,103153554,132353,103089299,103482515,64255
8,ENSG00000196922.4,144999723,chr8-144893834-C-T,rs12542335,-1,C,T,144893834,105889,144803115,145196331,90719
8,ENSG00000254006.1,64817573,chr8-64833339-T-C,rs12550805,-1,T,C,64833339,15766,64620965,65014181,212374
8,ENSG00000248738.2,22877984,chr8-22806014-A-G,rs12682049,1,A,G,22806014,71970,22681376,23074592,124638
8,ENSG00000253606.1,43271960,chr8-43203242-C-T,rs13253966,-1,C,T,43203242,68718,43075352,43468568,127890
8,ENSG00000253210.1,141130064,chr8-141188619-A-T,rs13268445,-1,A,T,141188619,58555,140933456,141326672,255163
8,ENSG00000253716.1,143281705,chr8-143201207-T-C,rs13270969,-1,T,C,143201207,80498,143085097,143478313,116110
8,ENSG00000260588.1,41829934,chr8-41995368-T-C,rs13271816,-1,T,C,41995368,165434,41633326,42026542,362042
8,ENSG00000253228.1,107983116,chr8-108132765-C-T,rs1450594,1,C,T,108132765,149649,107786508,108179724,346257
8,ENSG00000250031.1,58426685,chr8-58393415-G-T,rs1457049,-1,G,T,58393415,33270,58230077,58623293,163338
8,ENSG00000255437.1,14023422,chr8-14195767-C-T,rs1478014,-1,C,T,14195767,172345,13826814,14220030,368953
8,ENSG00000260398.1,78605952,chr8-78488803-A-G,rs1520333,1,A,G,78488803,117149,78409344,78802560,79459
8,ENSG00000253690.1,28339255,chr8-28305781-A-T,rs1531382,-1,A,T,28305781,33474,28142647,28535863,163134
8,ENSG00000253549.1,85464915,chr8-85306169-C-T,rs1553016,-1,C,T,85306169,158746,85268307,85661523,37862
8,ENSG00000253607.1,123002560,chr8-123187200-G-A,rs1670171,1,G,A,123187200,184640,122805952,123199168,381248
8,ENSG00000254388.1,123352181,chr8-123159239-A-G,rs1670190,1,A,G,123159239,192942,123155573,123548789,3666
8,ENSG00000248858.2,92877637,chr8-92965781-G-A,rs16915402,-1,G,A,92965781,88144,92681029,93074245,284752
8,ENSG00000253541.1,56477987,chr8-56496632-C-T,rs16920629,-1,C,T,56496632,18645,56281379,56674595,215253
8,ENSG00000254285.2,61578220,chr8-61609173-C-T,rs16927639,1,C,T,61609173,30953,61381612,61774828,227561
8,ENSG00000228451.3,26381519,chr8-26422349-C-T,rs17055205,-1,C,T,26422349,40830,26184911,26578127,237438
8,ENSG00000253893.1,8226614,chr8-8294694-T-A,rs17155246,-1,T,A,8294694,68080,8030006,8423222,264688
8,ENSG00000250962.1,88485110,chr8-88420771-A-G,rs17669974,1,A,G,88420771,64339,88288502,88681718,132269
8,ENSG00000246582.2,23225221,chr8-23260130-T-C,rs2294125,1,T,C,23260130,34909,23028613,23421829,231517
8,ENSG00000245970.2,98041726,chr8-98009781-C-A,rs2444896,1,C,A,98009781,31945,97845118,98238334,164663
8,ENSG00000254389.1,143368548,chr8-143331246-G-A,rs2450772,-1,G,A,143331246,37302,143171940,143565156,159306
8,ENSG00000254332.1,69129598,chr8-69131451-C-A,rs28623611,1,C,A,69131451,1853,68932990,69326206,198461
8,ENSG00000223508.4,213707,chr8-234319-T-C,rs2906326,-1,T,C,234319,20612,17099,410315,217220
8,ENSG00000253896.2,72601,chr8-244943-C-T,rs2906332,1,C,T,244943,172342,-124007,269209,368950
8,ENSG00000182366.3,383174,chr8-250422-G-C,rs2906336,-1,G,C,250422,132752,186566,579782,63856
8,ENSG00000253704.1,94553668,chr8-94609592-G-C,rs3133614,1,G,C,94609592,55924,94357060,94750276,252532
8,ENSG00000253704.1,94553668,chr8-94609592-G-T,rs3133614,1,G,T,94609592,55924,94357060,94750276,252532
8,ENSG00000177335.6,143039328,chr8-143126321-G-T,rs34242269,1,G,T,143126321,86993,142842720,143235936,283601
8,ENSG00000253167.1,125040684,chr8-124996779-A-G,rs3763545,1,A,G,124996779,43905,124844076,125237292,152703
8,ENSG00000255050.1,143573490,chr8-143582129-G-A,rs3793371,1,G,A,143582129,8639,143376882,143770098,205247
8,ENSG00000167912.5,59119216,chr8-59000178-T-C,rs380013,1,T,C,59000178,119038,58922608,59315824,77570
8,ENSG00000251136.2,89757383,chr8-89792100-C-T,rs383592,-1,C,T,89792100,34717,89560775,89953991,231325
8,ENSG00000244052.1,102924255,chr8-102828132-G-A,rs3836,-1,G,A,102828132,96123,102727647,103120863,100485
8,ENSG00000253981.1,8241411,chr8-8385290-C-A,rs4240617,-1,C,A,8385290,143879,8044803,8438019,340487
8,ENSG00000261026.1,22684009,chr8-22854564-G-A,rs4284046,-1,G,A,22854564,170555,22487401,22880617,367163
8,ENSG00000261451.1,10433672,chr8-10565764-C-T,rs4335093,1,C,T,10565764,132092,10237064,10630280,328700
8,ENSG00000253633.1,102528740,chr8-102541773-G-C,rs4734638,1,G,C,102541773,13033,102332132,102725348,209641
8,ENSG00000235165.2,122769274,chr8-122790447-A-G,rs4871305,1,A,G,122790447,21173,122572666,122965882,217781
8,ENSG00000254741.1,143579636,chr8-143462025-C-T,rs4874138,1,C,T,143462025,117611,143383028,143776244,78997
8,ENSG00000254812.1,143632783,chr8-143583592-G-A,rs4874157,-1,G,A,143583592,49191,143436175,143829391,147417
8,ENSG00000254578.1,144463817,chr8-144411764-G-T,rs4925820,1,G,T,144411764,52053,144267209,144660425,144555
8,ENSG00000254198.1,43126397,chr8-43103864-C-A,rs5024011,-1,C,A,43103864,22533,42929789,43323005,174075
8,ENSG00000253174.1,41545044,chr8-41641762-G-A,rs60202299,-1,G,A,41641762,96718,41348436,41741652,293326
8,ENSG00000251034.1,22553444,chr8-22703566-C-T,rs62494319,-1,C,T,22703566,150122,22356836,22750052,346730
8,ENSG00000260253.1,29353170,chr8-29216886-C-G,rs62502853,-1,C,G,29216886,136284,29156562,29549778,60324
8,ENSG00000253214.1,81154265,chr8-81066280-T-A,rs62517873,1,T,A,81066280,87985,80957657,81350873,108623
8,ENSG00000243498.2,123236852,chr8-123057389-G-T,rs6470135,1,G,T,123057389,179463,123040244,123433460,17145
8,ENSG00000240509.1,93957691,chr8-94137808-A-G,rs6471432,-1,A,G,94137808,180117,93761083,94154299,376725
8,ENSG00000254319.1,2728434,chr8-2725657-G-A,rs6558680,-1,G,A,2725657,2777,2531826,2925042,193831
8,ENSG00000253161.1,37554183,chr8-37496959-C-T,rs6991426,-1,C,T,37496959,57224,37357575,37750791,139384
8,ENSG00000240395.1,42342634,chr8-42206842-T-A,rs7003775,-1,T,A,42206842,135792,42146026,42539242,60816
8,ENSG00000232024.2,35525763,chr8-35427424-C-T,rs7008607,-1,C,T,35427424,98339,35329155,35722371,98269
8,ENSG00000254266.1,78508485,chr8-78372272-A-C,rs7016026,-1,A,C,78372272,136213,78311877,78705093,60395
8,ENSG00000212994.4,100895771,chr8-100879676-A-G,rs7016206,1,A,G,100879676,16095,100699163,101092379,180513
8,ENSG00000254185.1,109470131,chr8-109497855-C-T,rs72687045,1,C,T,109497855,27724,109273523,109666739,224332
8,ENSG00000245149.3,124474564,chr8-124422843-G-C,rs72710899,-1,G,C,124422843,51721,124277956,124671172,144887
8,ENSG00000245281.2,18084386,chr8-18076520-T-C,rs7462991,1,T,C,18076520,7866,17887778,18280994,188742
8,ENSG00000248578.1,56102267,chr8-56221766-G-A,rs76895802,-1,G,A,56221766,119499,55905659,56298875,316107
8,ENSG00000253741.1,142726992,chr8-142737982-C-T,rs77377310,-1,C,T,142737982,10990,142530384,142923600,207598
8,ENSG00000253570.1,38601200,chr8-38725759-C-T,rs77996533,-1,C,T,38725759,124559,38404592,38797808,321167
8,ENSG00000254064.1,22275162,chr8-22168131-G-A,rs7812993,-1,G,A,22168131,107031,22078554,22471770,89577
8,ENSG00000247317.3,143018447,chr8-143032183-G-A,rs7814982,-1,G,A,143032183,13736,142821839,143215055,210344
8,ENSG00000253649.1,10517983,chr8-10411865-T-C,rs7817793,-1,T,C,10411865,106118,10321375,10714591,90490
8,ENSG00000253899.1,27065278,chr8-27000176-G-A,rs7842266,-1,G,A,27000176,65102,26868670,27261886,131506
8,ENSG00000261693.1,142403652,chr8-142423108-C-T,rs9324591,1,C,T,142423108,19456,142207044,142600260,216064
8,ENSG00000253616.1,23074488,chr8-23116937-T-C,rs9644063,-1,T,C,23116937,42449,22877880,23271096,239057
8,ENSG00000253616.1,23074488,chr8-23116937-T-A,rs9644063,-1,T,A,23116937,42449,22877880,23271096,239057
7,ENSG00000235368.1,57424503,chr7-57505226-G-A,rs10081282,1,G,A,57505226,80723,57227895,57621111,277331
7,ENSG00000224057.1,55188977,chr7-55277589-G-A,rs10215194,-1,G,A,55277589,88612,54992369,55385585,285220
7,ENSG00000227053.1,101017665,chr7-101015436-T-C,rs10229453,-1,T,C,101015436,2229,100821057,101214273,194379
7,ENSG00000250561.1,6880626,chr7-6698035-G-A,rs10231608,-1,G,A,6698035,182591,6684018,7077234,14017
7,ENSG00000237286.1,2944035,chr7-2781966-T-C,rs10254662,1,T,C,2781966,162069,2747427,3140643,34539
7,ENSG00000224046.1,87152420,chr7-87226691-A-T,rs10273826,-1,A,T,87226691,74271,86955812,87349028,270879
7,ENSG00000188185.6,39733632,chr7-39610768-T-C,rs10486797,1,T,C,39610768,122864,39537024,39930240,73744
7,ENSG00000213261.3,131662624,chr7-131792785-A-G,rs10488337,-1,A,G,131792785,130161,131466016,131859232,326769
7,ENSG00000236081.1,1742272,chr7-1748644-G-C,rs10950352,-1,G,C,1748644,6372,1545664,1938880,202980
7,ENSG00000231812.1,97885868,chr7-97963042-G-A,rs111427138,1,G,A,97963042,77174,97689260,98082476,273782
7,ENSG00000237181.1,602792,chr7-592301-G-A,rs112653255,1,G,A,592301,10491,406184,799400,186117
7,ENSG00000235859.4,30371508,chr7-30338371-C-T,rs112995369,1,C,T,30338371,33137,30174900,30568116,163471
7,ENSG00000239969.1,102375808,chr7-102473643-T-C,rs1131359,1,T,C,102473643,97835,102179200,102572416,294443
7,ENSG00000239775.1,44064908,chr7-44075830-C-T,rs1139270,1,C,T,44075830,10922,43868300,44261516,207530
7,ENSG00000242258.1,150433654,chr7-150628290-T-C,rs114540180,1,T,C,150628290,194636,150237046,150630262,391244
7,ENSG00000223969.1,90597398,chr7-90583401-T-C,rs11563526,-1,T,C,90583401,13997,90400790,90794006,182611
7,ENSG00000241136.1,143782667,chr7-143735459-G-A,rs117060634,1,G,A,143735459,47208,143586059,143979275,149400
7,ENSG00000234927.1,121050927,chr7-121130056-A-G,rs117201097,1,A,G,121130056,79129,120854319,121247535,275737
7,ENSG00000228335.1,99443496,chr7-99334497-C-G,rs117316159,-1,C,G,99334497,108999,99246888,99640104,87609
7,ENSG00000228960.4,144299373,chr7-144126740-T-C,rs11763619,1,T,C,144126740,172633,144102765,144495981,23975
7,ENSG00000261305.1,150337483,chr7-150328826-G-T,rs11764936,1,G,T,150328826,8657,150140875,150534091,187951
7,ENSG00000261305.1,150337483,chr7-150328826-G-A,rs11764936,1,G,A,150328826,8657,150140875,150534091,187951
7,ENSG00000227986.1,64355078,chr7-64385366-G-A,rs11765812,1,G,A,64385366,30288,64158470,64551686,226896
7,ENSG00000078319.7,100335860,chr7-100475669-A-G,rs11766752,-1,A,G,100475669,139809,100139252,100532468,336417
7,ENSG00000237310.1,66493659,chr7-66517644-T-G,rs11773628,1,T,G,66517644,23985,66297051,66690267,220593
7,ENSG00000230882.1,76074963,chr7-75900750-C-T,rs118025992,-1,C,T,75900750,174213,75878355,76271571,22395
7,ENSG00000238228.1,97947998,chr7-97963894-T-C,rs11971168,-1,T,C,97963894,15896,97751390,98144606,212504
7,ENSG00000226869.2,104804088,chr7-104657355-T-C,rs11977439,-1,T,C,104657355,146733,104607480,105000696,49875
7,ENSG00000232729.1,74728862,chr7-74592868-G-A,rs11978193,-1,G,A,74592868,135994,74532254,74925470,60614
7,ENSG00000226278.1,55764797,chr7-55787487-G-A,rs11982736,1,G,A,55787487,22690,55568189,55961405,219298
7,ENSG00000227233.1,51382284,chr7-51324906-C-T,rs12536042,1,C,T,51324906,57378,51185676,51578892,139230
7,ENSG00000232400.1,16866308,chr7-16806127-T-C,rs12665886,-1,T,C,16806127,60181,16669700,17062916,136427
7,ENSG00000254959.1,30752137,chr7-30774528-C-T,rs12701027,1,C,T,30774528,22391,30555529,30948745,218999
7,ENSG00000231531.3,143313061,chr7-143465551-G-C,rs12703532,-1,G,C,143465551,152490,143116453,143509669,349098
7,ENSG00000231531.3,143313061,chr7-143465551-G-A,rs12703532,-1,G,A,143465551,152490,143116453,143509669,349098
7,ENSG00000214142.2,100140682,chr7-100084403-T-C,rs12705071,-1,T,C,100084403,56279,99944074,100337290,140329
7,ENSG00000231198.1,39833793,chr7-39711559-C-G,rs13228455,-1,C,G,39711559,122234,39637185,40030401,74374
7,ENSG00000197258.5,104667749,chr7-104504457-A-T,rs13234004,1,A,T,104504457,163292,104471141,104864357,33316
7,ENSG00000232053.1,136092923,chr7-135937098-T-C,rs13242292,1,T,C,135937098,155825,135896315,136289531,40783
7,ENSG00000186676.3,125033453,chr7-125144551-A-C,rs13246702,1,A,C,125144551,111098,124836845,125230061,307706
7,ENSG00000214754.3,47052793,chr7-46932135-C-T,rs13247397,1,C,T,46932135,120658,46856185,47249401,75950
7,ENSG00000231519.1,30075115,chr7-29962992-C-T,rs1465327,-1,C,T,29962992,112123,29878507,30271723,84485
7,ENSG00000229091.2,10451311,chr7-10438320-G-A,rs1524241,1,G,A,10438320,12991,10254703,10647919,183617
7,ENSG00000236976.1,64142401,chr7-64065867-A-G,rs1595620,-1,A,G,64065867,76534,63945793,64339009,120074
7,ENSG00000242261.1,128306649,chr7-128319168-G-A,rs17152002,1,G,A,128319168,12519,128110041,128503257,209127
7,ENSG00000244480.1,30524535,chr7-30594717-C-T,rs17159262,-1,C,T,30594717,70182,30327927,30721143,266790
7,ENSG00000235243.1,84848253,chr7-84893160-A-G,rs17159433,-1,A,G,84893160,44907,84651645,85044861,241515
7,ENSG00000243746.1,144648575,chr7-144637715-C-T,rs17287011,-1,C,T,144637715,10860,144451967,144845183,185748
7,ENSG00000170356.8,144251603,chr7-144173329-G-A,rs1731353,-1,G,A,144173329,78274,144054995,144448211,118334
7,ENSG00000232533.1,143381036,chr7-143342613-T-A,rs17381401,-1,T,A,143342613,38423,143184428,143577644,158185
7,ENSG00000232533.1,143381036,chr7-143342613-T-C,rs17381401,-1,T,C,143342613,38423,143184428,143577644,158185
7,ENSG00000237972.1,43918697,chr7-43952298-G-A,rs17654788,1,G,A,43952298,33601,43722089,44115305,230209
7,ENSG00000236105.1,127295620,chr7-127270520-T-C,rs17869257,1,T,C,127270520,25100,127099012,127492228,171508
7,ENSG00000239377.1,150383885,chr7-150394943-G-T,rs1880316,-1,G,T,150394943,11058,150187277,150580493,207666
7,ENSG00000224079.1,1074450,chr7-1057130-A-C,rs1881124,1,A,C,1057130,17320,877842,1271058,179288
7,ENSG00000204959.3,144286966,chr7-144141777-G-C,rs1919955,-1,G,C,144141777,145189,144090358,144483574,51419
7,ENSG00000226279.2,22881893,chr7-22725613-T-C,rs2069824,1,T,C,22725613,156280,22685285,23078501,40328
7,ENSG00000211701.2,38368169,chr7-38377955-A-C,rs2080284,-1,A,C,38377955,9786,38171561,38564777,206394
7,ENSG00000233306.2,38363518,chr7-38377955-A-C,rs2080284,-1,A,C,38377955,14437,38166910,38560126,211045
7,ENSG00000205236.5,102642869,chr7-102735216-A-G,rs2109995,-1,A,G,102735216,92347,102446261,102839477,288955
7,ENSG00000211698.2,38354517,chr7-38365370-A-T,rs2160195,-1,A,T,38365370,10853,38157909,38551125,207461
7,ENSG00000211699.2,38359162,chr7-38365370-A-T,rs2160195,-1,A,T,38365370,6208,38162554,38555770,202816
7,ENSG00000223500.1,135128444,chr7-134993772-C-T,rs2252826,1,C,T,134993772,134672,134931836,135325052,61936
7,ENSG00000228775.3,141738230,chr7-141764965-C-T,rs2270009,-1,C,T,141764965,26735,141541622,141934838,223343
7,ENSG00000242588.1,128531707,chr7-128400645-C-T,rs2278294,1,C,T,128400645,131062,128335099,128728315,65546
7,ENSG00000236015.1,39570198,chr7-39514211-C-T,rs2329401,-1,C,T,39514211,55987,39373590,39766806,140621
7,ENSG00000243302.2,128651185,chr7-128641202-G-A,rs2402923,1,G,A,128641202,9983,128454577,128847793,186625
7,ENSG00000233429.4,27096094,chr7-27104138-T-C,rs2522828,1,T,C,27104138,8044,26899486,27292702,204652
7,ENSG00000231419.2,159008421,chr7-158851177-T-C,rs2657323,1,T,C,158851177,157244,158811813,159205029,39364
7,ENSG00000237729.2,93670077,chr7-93682399-T-C,rs2677031,-1,T,C,93682399,12322,93473469,93866685,208930
7,ENSG00000196295.4,30562825,chr7-30602883-C-G,rs2709809,-1,C,G,30602883,40058,30366217,30759433,236666
7,ENSG00000196295.4,30562825,chr7-30602883-C-A,rs2709809,-1,C,A,30602883,40058,30366217,30759433,236666
7,ENSG00000260231.1,140177184,chr7-140349492-A-G,rs28670038,1,A,G,140349492,172308,139980576,140373792,368916
7,ENSG00000182722.5,64853354,chr7-64969122-G-A,rs28762167,-1,G,A,64969122,115768,64656746,65049962,312376
7,ENSG00000261455.1,152463786,chr7-152465124-A-C,rs3087586,1,A,C,152465124,1338,152267178,152660394,197946
7,ENSG00000243679.1,128653969,chr7-128721075-G-A,rs339077,1,G,A,128721075,67106,128457361,128850577,263714
7,ENSG00000214765.4,45765812,chr7-45728142-A-C,rs34262641,-1,A,C,45728142,37670,45569204,45962420,158938
7,ENSG00000234585.2,65064999,chr7-65231685-G-A,rs34919679,1,G,A,65231685,166686,64868391,65261607,363294
7,ENSG00000230487.3,1570073,chr7-1588347-C-T,rs34990622,1,C,T,1588347,18274,1373465,1766681,214882
7,ENSG00000230487.3,1570073,chr7-1588347-C-G,rs34990622,1,C,G,1588347,18274,1373465,1766681,214882
7,ENSG00000234985.2,121441261,chr7-121329358-G-C,rs35391640,-1,G,C,121329358,111903,121244653,121637869,84705
7,ENSG00000230359.3,129056019,chr7-129150650-T-C,rs35625644,1,T,C,129150650,94631,128859411,129252627,291239
7,ENSG00000242798.1,100127139,chr7-100119278-C-G,rs3807479,-1,C,G,100119278,7861,99930531,100323747,188747
7,ENSG00000227017.1,30179014,chr7-30173836-C-T,rs3823765,-1,C,T,30173836,5178,29982406,30375622,191430
7,ENSG00000186704.8,76978617,chr7-76806756-A-C,rs38629,1,A,C,76806756,171861,76782009,77175225,24747
7,ENSG00000231006.1,108510233,chr7-108559558-A-G,rs40936,1,A,G,108559558,49325,108313625,108706841,245933
7,ENSG00000237004.2,32728569,chr7-32765338-T-A,rs4283951,1,T,A,32765338,36769,32531961,32925177,233377
7,ENSG00000228668.1,38345499,chr7-38373387-T-C,rs4373430,-1,T,C,38373387,27888,38148891,38542107,224496
7,ENSG00000232581.1,6588974,chr7-6608107-T-C,rs4416743,-1,T,C,6608107,19133,6392366,6785582,215741
7,ENSG00000232581.1,6588974,chr7-6608107-T-A,rs4416743,-1,T,A,6608107,19133,6392366,6785582,215741
7,ENSG00000182648.7,156640599,chr7-156649341-T-C,rs4716437,-1,T,C,156649341,8742,156443991,156837207,205350
7,ENSG00000213875.3,13871856,chr7-13740859-T-C,rs4719379,1,T,C,13740859,130997,13675248,14068464,65611
7,ENSG00000229358.2,32761787,chr7-32663289-G-A,rs4723187,-1,G,A,32663289,98498,32565179,32958395,98110
7,ENSG00000228974.4,5560743,chr7-5471016-T-C,rs4724694,1,T,C,5471016,89727,5364135,5757351,106881
7,ENSG00000226342.1,63910453,chr7-63749086-G-A,rs56080486,-1,G,A,63749086,161367,63713845,64107061,35241
7,ENSG00000214106.3,154928485,chr7-154924722-C-T,rs57164738,1,C,T,154924722,3763,154731877,155125093,192845
7,ENSG00000232759.1,22563337,chr7-22567443-A-G,rs59026448,1,A,G,22567443,4106,22366729,22759945,200714
7,ENSG00000127957.12,75516235,chr7-75420076-C-T,rs60932781,-1,C,T,75420076,96159,75319627,75712843,100449
7,ENSG00000232956.2,44986961,chr7-45083124-G-A,rs61740895,-1,G,A,45083124,96163,44790353,45183569,292771
7,ENSG00000223855.1,522573,chr7-522201-T-C,rs62433354,1,T,C,522201,372,325965,719181,196236
7,ENSG00000211697.2,38350022,chr7-38372517-G-A,rs62445058,-1,G,A,38372517,22495,38153414,38546630,219103
7,ENSG00000230715.2,128652841,chr7-128668332-C-T,rs6467202,1,C,T,128668332,15491,128456233,128849449,212099
7,ENSG00000229161.2,42794906,chr7-42932812-A-G,rs647618,1,A,G,42932812,137906,42598298,42991514,334514
7,ENSG00000224273.1,76132187,chr7-75963607-T-C,rs6965343,-1,T,C,75963607,168580,75935579,76328795,28028
7,ENSG00000229877.1,143546735,chr7-143431406-G-A,rs6966814,-1,G,A,143431406,115329,143350127,143743343,81279
7,ENSG00000235944.3,5823207,chr7-5814372-C-T,rs6969131,1,C,T,5814372,8835,5626599,6019815,187773
7,ENSG00000133624.9,149624565,chr7-149487759-C-A,rs6971236,-1,C,A,149487759,136806,149427957,149821173,59802
7,ENSG00000249773.3,55887277,chr7-55909457-G-A,rs6971250,1,G,A,55909457,22180,55690669,56083885,218788
7,ENSG00000225792.1,26376237,chr7-26441611-C-T,rs73074126,-1,C,T,26441611,65374,26179629,26572845,261982
7,ENSG00000225792.1,26376237,chr7-26441611-C-A,rs73074126,-1,C,A,26441611,65374,26179629,26572845,261982
7,ENSG00000234450.1,156633355,chr7-156528249-G-C,rs73179073,1,G,C,156528249,105106,156436747,156829963,91502
7,ENSG00000257607.1,1059261,chr7-1172231-G-A,rs73265375,-1,G,A,1172231,112970,862653,1255869,309578
7,ENSG00000242474.1,149438,chr7-125510-G-T,rs73669600,-1,G,T,125510,23928,-47170,346046,172680
7,ENSG00000242474.1,149438,chr7-125510-G-C,rs73669600,-1,G,C,125510,23928,-47170,346046,172680
7,ENSG00000239919.1,129477875,chr7-129630797-A-G,rs74550698,1,A,G,129630797,152922,129281267,129674483,349530
7,ENSG00000179406.6,66491616,chr7-66335789-T-C,rs74777072,-1,T,C,66335789,155827,66295008,66688224,40781
7,ENSG00000179131.6,66914581,chr7-66780299-G-A,rs74838615,1,G,A,66780299,134282,66717973,67111189,62326
7,ENSG00000224903.1,156659582,chr7-156514971-C-T,rs77129616,-1,C,T,156514971,144611,156462974,156856190,51997
7,ENSG00000067601.6,67299424,chr7-67235151-A-G,rs77634321,-1,A,G,67235151,64273,67102816,67496032,132335
7,ENSG00000223459.4,143598039,chr7-143734790-A-G,rs7776595,1,A,G,143734790,136751,143401431,143794647,333359
7,ENSG00000213394.3,101204495,chr7-101192334-G-A,rs7777110,-1,G,A,101192334,12161,101007887,101401103,184447
7,ENSG00000225535.2,115030564,chr7-114985291-T-A,rs7786588,1,T,A,114985291,45273,114833956,115227172,151335
7,ENSG00000230658.1,23105703,chr7-23098855-C-T,rs7787110,-1,C,T,23098855,6848,22909095,23302311,189760
7,ENSG00000240889.1,140697077,chr7-140619432-T-C,rs7787161,-1,T,C,140619432,77645,140500469,140893685,118963
7,ENSG00000244701.1,141656810,chr7-141689840-A-G,rs7791469,-1,A,G,141689840,33030,141460202,141853418,229638
7,ENSG00000204934.6,149880610,chr7-149874377-A-G,rs7795944,-1,A,G,149874377,6233,149684002,150077218,190375
7,ENSG00000205578.4,73293497,chr7-73329980-A-C,rs7801936,1,A,C,73329980,36483,73096889,73490105,233091
7,ENSG00000234141.1,7950709,chr7-7946235-T-C,rs7806407,-1,T,C,7946235,4474,7754101,8147317,192134
7,ENSG00000233834.2,20217536,chr7-20239019-G-T,rs7806550,1,G,T,20239019,21483,20020928,20414144,218091
7,ENSG00000236018.2,157198511,chr7-157268948-C-A,rs7807,-1,C,A,157268948,70437,157001903,157395119,267045
7,ENSG00000235920.1,11821294,chr7-11821311-G-A,rs7807756,-1,G,A,11821311,17,11624686,12017902,196625
7,ENSG00000228649.1,22854159,chr7-22859490-T-C,rs7811699,1,T,C,22859490,5331,22657551,23050767,201939
7,ENSG00000233559.1,130853732,chr7-130811306-A-G,rs78773570,1,A,G,130811306,42426,130657124,131050340,154182
7,ENSG00000223705.5,75410368,chr7-75568472-T-C,rs794355,1,T,C,75568472,158104,75213760,75606976,354712
7,ENSG00000242562.1,106125371,chr7-106318111-A-G,rs79751113,1,A,G,106318111,192740,105928763,106321979,389348
7,ENSG00000236048.2,12471352,chr7-12461083-G-T,rs79786674,1,G,T,12461083,10269,12274744,12667960,186339
7,ENSG00000236048.2,12471352,chr7-12461083-G-A,rs79786674,1,G,A,12461083,10269,12274744,12667960,186339
7,ENSG00000182165.12,87345551,chr7-87348578-T-C,rs802036,-1,T,C,87348578,3027,87148943,87542159,199635
7,ENSG00000219039.2,75835663,chr7-75888589-T-C,rs872792,1,T,C,75888589,52926,75639055,76032271,249534
7,ENSG00000106610.10,67305987,chr7-67320150-C-A,rs9443,1,C,A,67320150,14163,67109379,67502595,210771
7,ENSG00000231087.2,76969250,chr7-77080835-T-C,rs9886341,-1,T,C,77080835,111585,76772642,77165858,308193
7,ENSG00000224079.1,1074450,chr7-1042336-C-A,rs10224368,1,C,A,1042336,32114,877842,1271058,164494
7,ENSG00000223969.1,90597398,chr7-90579060-G-A,rs10254430,-1,G,A,90579060,18338,90400790,90794006,178270
7,ENSG00000235955.1,45819016,chr7-45655873-T-G,rs10254640,-1,T,G,45655873,163143,45622408,46015624,33465
7,ENSG00000232736.1,35768640,chr7-35643118-T-C,rs10260422,-1,T,C,35643118,125522,35572032,35965248,71086
7,ENSG00000225314.1,37821210,chr7-37892653-T-G,rs10268173,1,T,G,37892653,71443,37624602,38017818,268051
7,ENSG00000223459.4,143598039,chr7-143733541-C-T,rs10270716,1,C,T,143733541,135502,143401431,143794647,332110
7,ENSG00000225535.2,115030564,chr7-114966524-C-T,rs10273599,1,C,T,114966524,64040,114833956,115227172,132568
7,ENSG00000242258.1,150433654,chr7-150447329-C-G,rs10276935,1,C,G,150447329,13675,150237046,150630262,210283
7,ENSG00000231167.3,105583256,chr7-105767569-T-C,rs10281039,-1,T,C,105767569,184313,105386648,105779864,380921
7,ENSG00000218586.3,54933699,chr7-54940809-C-T,rs10282396,1,C,T,54940809,7110,54737091,55130307,203718
7,ENSG00000242562.1,106125371,chr7-106150519-C-T,rs10953493,1,C,T,106150519,25148,105928763,106321979,221756
7,ENSG00000261455.1,152463786,chr7-152495036-A-G,rs1107394,1,A,G,152495036,31250,152267178,152660394,227858
7,ENSG00000183444.9,97967074,chr7-97986932-C-T,rs111371470,-1,C,T,97986932,19858,97770466,98163682,216466
7,ENSG00000233264.2,7980312,chr7-7870665-G-A,rs111623954,1,G,A,7870665,109647,7783704,8176920,86961
7,ENSG00000232533.1,143381036,chr7-143379943-C-T,rs1135411,-1,C,T,143379943,1093,143184428,143577644,195515
7,ENSG00000239622.1,25689959,chr7-25817789-C-A,rs1159802,-1,C,A,25817789,127830,25493351,25886567,324438
7,ENSG00000127957.12,75516235,chr7-75543861-G-A,rs1167796,-1,G,A,75543861,27626,75319627,75712843,224234
7,ENSG00000236305.1,100852635,chr7-100945319-C-T,rs117002451,-1,C,T,100945319,92684,100656027,101049243,289292
7,ENSG00000236305.1,100852635,chr7-100945319-C-G,rs117002451,-1,C,G,100945319,92684,100656027,101049243,289292
7,ENSG00000228668.1,38345499,chr7-38477731-A-C,rs11767573,-1,A,C,38477731,132232,38148891,38542107,328840
7,ENSG00000233306.2,38363518,chr7-38477731-A-C,rs11767573,-1,A,C,38477731,114213,38166910,38560126,310821
7,ENSG00000235368.1,57424503,chr7-57512420-T-C,rs117801264,1,T,C,57512420,87917,57227895,57621111,284525
7,ENSG00000232759.1,22563337,chr7-22392521-C-T,rs11978535,1,C,T,22392521,170816,22366729,22759945,25792
7,ENSG00000257607.1,1059261,chr7-923196-T-C,rs12381369,-1,T,C,923196,136065,862653,1255869,60543
7,ENSG00000106610.10,67305987,chr7-67325604-C-T,rs12537527,1,C,T,67325604,19617,67109379,67502595,216225
7,ENSG00000240211.1,100436204,chr7-100585068-C-T,rs12668337,1,C,T,100585068,148864,100239596,100632812,345472
7,ENSG00000240758.1,128455937,chr7-128569804-C-T,rs12670823,1,C,T,128569804,113867,128259329,128652545,310475
7,ENSG00000232400.1,16866308,chr7-16844687-A-G,rs12672876,-1,A,G,16844687,21621,16669700,17062916,174987
7,ENSG00000227017.1,30179014,chr7-30181214-G-A,rs12701008,-1,G,A,30181214,2200,29982406,30375622,198808
7,ENSG00000164556.7,38687037,chr7-38724568-T-C,rs13231320,-1,T,C,38724568,37531,38490429,38883645,234139
7,ENSG00000239919.1,129477875,chr7-129592879-G-A,rs13233824,1,G,A,129592879,115004,129281267,129674483,311612
7,ENSG00000204934.6,149880610,chr7-149870144-C-T,rs13243007,-1,C,T,149870144,10466,149684002,150077218,186142
7,ENSG00000234432.2,5428927,chr7-5233833-C-T,rs13244634,-1,C,T,5233833,195094,5232319,5625535,1514
7,ENSG00000224897.2,124929943,chr7-125062345-A-G,rs17147889,1,A,G,125062345,132402,124733335,125126551,329010
7,ENSG00000244479.2,144355520,chr7-144173412-C-A,rs17591937,-1,C,A,144173412,182108,144158912,144552128,14500
7,ENSG00000234513.1,22773993,chr7-22729691-G-A,rs2069842,-1,G,A,22729691,44302,22577385,22970601,152306
7,ENSG00000211698.2,38354517,chr7-38377955-A-C,rs2080284,-1,A,C,38377955,23438,38157909,38551125,220046
7,ENSG00000205236.5,102642869,chr7-102473640-C-T,rs2229796,-1,C,T,102473640,169229,102446261,102839477,27379
7,ENSG00000238228.1,97947998,chr7-97858034-A-T,rs2237289,-1,A,T,97858034,89964,97751390,98144606,106644
7,ENSG00000238228.1,97947998,chr7-97858034-A-G,rs2237289,-1,A,G,97858034,89964,97751390,98144606,106644
7,ENSG00000228649.1,22854159,chr7-22812893-C-T,rs2240727,1,C,T,22812893,41266,22657551,23050767,155342
7,ENSG00000228546.2,102337316,chr7-102252952-A-G,rs2529113,1,A,G,102252952,84364,102140708,102533924,112244
7,ENSG00000168255.12,102572653,chr7-102759410-C-T,rs2539336,-1,C,T,102759410,186757,102376045,102769261,383365
7,ENSG00000211699.2,38359162,chr7-38362895-A-G,rs2735118,-1,A,G,38362895,3733,38162554,38555770,200341
7,ENSG00000223855.1,522573,chr7-511485-A-G,rs28472363,1,A,G,511485,11088,325965,719181,185520
7,ENSG00000242261.1,128306649,chr7-128254797-G-A,rs28954114,1,G,A,128254797,51852,128110041,128503257,144756
7,ENSG00000229153.1,143407813,chr7-143501156-C-A,rs2949747,1,C,A,143501156,93343,143211205,143604421,289951
7,ENSG00000242588.1,128531707,chr7-128490492-C-T,rs34742251,1,C,T,128490492,41215,128335099,128728315,155393
7,ENSG00000239969.1,102375808,chr7-102401030-G-A,rs34804264,1,G,A,102401030,25222,102179200,102572416,221830
7,ENSG00000233476.2,22511999,chr7-22369326-C-T,rs34835504,-1,C,T,22369326,142673,22315391,22708607,53935
7,ENSG00000239521.2,100271983,chr7-100414711-G-A,rs34919929,-1,G,A,100414711,142728,100075375,100468591,339336
7,ENSG00000233559.1,130853732,chr7-130735979-A-G,rs35775580,1,A,G,130735979,117753,130657124,131050340,78855
7,ENSG00000226874.1,30544053,chr7-30505662-A-G,rs38417,1,A,G,30505662,38391,30347445,30740661,158217
7,ENSG00000196295.4,30562825,chr7-30556253-T-A,rs38474,-1,T,A,30556253,6572,30366217,30759433,190036
7,ENSG00000179131.6,66914581,chr7-67059761-T-C,rs4236210,1,T,C,67059761,145180,66717973,67111189,341788
7,ENSG00000229043.1,1160374,chr7-1104891-C-T,rs4236375,1,C,T,1104891,55483,963766,1356982,141125
7,ENSG00000240859.1,149597,chr7-194247-A-G,rs4275177,1,A,G,194247,44650,-47011,346205,241258
7,ENSG00000224163.3,128914063,chr7-128770687-T-G,rs4566976,-1,T,G,128770687,143376,128717455,129110671,53232
7,ENSG00000256646.3,42932214,chr7-43119026-A-G,rs4612244,-1,A,G,43119026,186812,42735606,43128822,383420
7,ENSG00000237773.1,17299288,chr7-17422597-C-T,rs4721602,-1,C,T,17422597,123309,17102680,17495896,319917
7,ENSG00000235090.1,75922755,chr7-75734799-T-C,rs4728351,1,T,C,75734799,187956,75726147,76119363,8652
7,ENSG00000227053.1,101017665,chr7-101058329-T-A,rs4729656,-1,T,A,101058329,40664,100821057,101214273,237272
7,ENSG00000225918.1,145040941,chr7-144927903-C-T,rs55695248,-1,C,T,144927903,113038,144844333,145237549,83570
7,ENSG00000228903.2,44041892,chr7-44206718-C-T,rs56298219,-1,C,T,44206718,164826,43845284,44238500,361434
7,ENSG00000214106.3,154928485,chr7-154930985-G-A,rs56377766,1,G,A,154930985,2500,154731877,155125093,199108
7,ENSG00000225969.1,73735407,chr7-73788263-G-T,rs60996614,1,G,T,73788263,52856,73538799,73932015,249464
7,ENSG00000239377.1,150383885,chr7-150572829-G-A,rs61741802,-1,G,A,150572829,188944,150187277,150580493,385552
7,ENSG00000226278.1,55764797,chr7-55733981-G-A,rs62456609,1,G,A,55733981,30816,55568189,55961405,165792
7,ENSG00000261305.1,150337483,chr7-150391022-C-T,rs6464061,1,C,T,150391022,53539,150140875,150534091,250147
7,ENSG00000228960.4,144299373,chr7-144144679-C-T,rs6464580,1,C,T,144144679,154694,144102765,144495981,41914
7,ENSG00000170356.8,144251603,chr7-144144679-C-T,rs6464580,-1,C,T,144144679,106924,144054995,144448211,89684
7,ENSG00000227499.1,55877912,chr7-56054365-A-C,rs6593297,1,A,C,56054365,176453,55681304,56074520,373061
7,ENSG00000227499.1,55877912,chr7-56054365-A-T,rs6593297,1,A,T,56054365,176453,55681304,56074520,373061
7,ENSG00000232445.1,101308270,chr7-101398477-C-A,rs6947185,1,C,A,101398477,90207,101111662,101504878,286815
7,ENSG00000214035.3,145009961,chr7-145185164-G-A,rs6961511,1,G,A,145185164,175203,144813353,145206569,371811
7,ENSG00000243679.1,128653969,chr7-128675835-A-T,rs6971819,1,A,T,128675835,21866,128457361,128850577,218474
7,ENSG00000226816.2,23205787,chr7-23176069-T-C,rs6972117,1,T,C,23176069,29718,23009179,23402395,166890
7,ENSG00000211697.2,38350022,chr7-38394665-C-T,rs720667,-1,C,T,38394665,44643,38153414,38546630,241251
7,ENSG00000211697.2,38350022,chr7-38394665-C-A,rs720667,-1,C,A,38394665,44643,38153414,38546630,241251
7,ENSG00000219039.2,75835663,chr7-75805044-A-G,rs73140282,1,A,G,75805044,30619,75639055,76032271,165989
7,ENSG00000232199.1,109999624,chr7-110025238-T-A,rs73197951,-1,T,A,110025238,25614,109803016,110196232,222222
7,ENSG00000232199.1,109999624,chr7-110025238-T-C,rs73197951,-1,T,C,110025238,25614,109803016,110196232,222222
7,ENSG00000224138.1,127350128,chr7-127533677-C-T,rs73234806,1,C,T,127533677,183549,127153520,127546736,380157
7,ENSG00000244218.1,128761338,chr7-128933391-G-T,rs73461567,1,G,T,128933391,172053,128564730,128957946,368661
7,ENSG00000244218.1,128761338,chr7-128933391-G-A,rs73461567,1,G,A,128933391,172053,128564730,128957946,368661
7,ENSG00000233834.2,20217536,chr7-20127277-T-A,rs73683382,1,T,A,20127277,90259,20020928,20414144,106349
7,ENSG00000232818.2,23490473,chr7-23345632-G-A,rs74452222,1,G,A,23345632,144841,23293865,23687081,51767
7,ENSG00000226102.2,35946294,chr7-35750074-C-A,rs74511011,1,C,A,35750074,196220,35749686,36142902,388
7,ENSG00000234722.2,153413981,chr7-153419891-G-A,rs75692465,-1,G,A,153419891,5910,153217373,153610589,202518
7,ENSG00000211701.2,38368169,chr7-38377213-C-T,rs76283292,-1,C,T,38377213,9044,38171561,38564777,205652
7,ENSG00000217825.2,155198455,chr7-155265743-C-T,rs77642229,-1,C,T,155265743,67288,155001847,155395063,263896
7,ENSG00000236453.1,94022833,chr7-93855969-G-A,rs7777209,1,G,A,93855969,166864,93826225,94219441,29744
7,ENSG00000182648.7,156640599,chr7-156671520-T-C,rs7790357,-1,T,C,156671520,30921,156443991,156837207,227529
7,ENSG00000229977.2,143533164,chr7-143503513-A-G,rs7792164,-1,A,G,143503513,29651,143336556,143729772,166957
7,ENSG00000179428.2,22727620,chr7-22758461-T-C,rs7808122,-1,T,C,22758461,30841,22531012,22924228,227449
7,ENSG00000244480.1,30524535,chr7-30655790-G-A,rs7812133,-1,G,A,30655790,131255,30327927,30721143,327863
7,ENSG00000186704.8,76978617,chr7-77121971-C-T,rs78155900,1,C,T,77121971,143354,76782009,77175225,339962
7,ENSG00000226824.2,66654513,chr7-66639940-C-T,rs79736939,1,C,T,66639940,14573,66457905,66851121,182035
7,ENSG00000213787.3,26922110,chr7-27034112-T-C,rs799234,1,T,C,27034112,112002,26725502,27118718,308610
7,ENSG00000260997.1,44960909,chr7-45123078-G-A,rs79994371,-1,G,A,45123078,162169,44764301,45157517,358777
7,ENSG00000214389.2,98386584,chr7-98534289-C-G,rs900481,-1,C,G,98534289,147705,98189976,98583192,344313
7,ENSG00000233429.4,27096094,chr7-27127918-T-C,rs929249,1,T,C,27127918,31824,26899486,27292702,228432
7,ENSG00000214293.4,77696265,chr7-77668098-C-T,rs9641271,-1,C,T,77668098,28167,77499657,77892873,168441
7,ENSG00000237181.1,602792,chr7-646497-G-T,rs9691438,1,G,T,646497,43705,406184,799400,240313
7,ENSG00000234985.2,121441261,chr7-121505623-A-G,rs10228676,-1,A,G,121505623,64362,121244653,121637869,260970
7,ENSG00000229358.2,32761787,chr7-32780825-A-G,rs10243492,-1,A,G,32780825,19038,32565179,32958395,215646
7,ENSG00000229677.1,139050006,chr7-139050988-G-A,rs10245175,-1,G,A,139050988,982,138853398,139246614,197590
7,ENSG00000242294.1,100338197,chr7-100246420-G-A,rs10250275,1,G,A,100246420,91777,100141589,100534805,104831
7,ENSG00000235859.4,30371508,chr7-30514081-A-G,rs10268380,1,A,G,30514081,142573,30174900,30568116,339181
7,ENSG00000229043.1,1160374,chr7-1008296-T-C,rs10276204,1,T,C,1008296,152078,963766,1356982,44530
7,ENSG00000196295.4,30562825,chr7-30621322-A-C,rs10951271,-1,A,C,30621322,58497,30366217,30759433,255105
7,ENSG00000232581.1,6588974,chr7-6527483-A-G,rs1105664,-1,A,G,6527483,61491,6392366,6785582,135117
7,ENSG00000225969.1,73735407,chr7-73882146-C-G,rs1114097,1,C,G,73882146,146739,73538799,73932015,343347
7,ENSG00000225969.1,73735407,chr7-73882146-C-A,rs1114097,1,C,A,73882146,146739,73538799,73932015,343347
7,ENSG00000236305.1,100852635,chr7-100948709-G-C,rs111461090,-1,G,C,100948709,96074,100656027,101049243,292682
7,ENSG00000168255.12,102572653,chr7-102446755-T-C,rs1129271,-1,T,C,102446755,125898,102376045,102769261,70710
7,ENSG00000241134.2,150749736,chr7-150628290-T-C,rs114540180,1,T,C,150628290,121446,150553128,150946344,75162
7,ENSG00000205236.5,102642869,chr7-102820511-C-T,rs116943888,-1,C,T,102820511,177642,102446261,102839477,374250
7,ENSG00000214293.4,77696265,chr7-77863304-A-G,rs117374332,-1,A,G,77863304,167039,77499657,77892873,363647
7,ENSG00000227986.1,64355078,chr7-64234704-C-T,rs11763256,1,C,T,64234704,120374,64158470,64551686,76234
7,ENSG00000235421.1,65554744,chr7-65487461-C-T,rs11763981,-1,C,T,65487461,67283,65358136,65751352,129325
7,ENSG00000234450.1,156633355,chr7-156591616-A-G,rs11764772,1,A,G,156591616,41739,156436747,156829963,154869
7,ENSG00000242588.1,128531707,chr7-128420671-T-G,rs11973781,1,T,G,128420671,111036,128335099,128728315,85572
7,ENSG00000225329.1,104926645,chr7-104811499-C-G,rs11981642,-1,C,G,104811499,115146,104730037,105123253,81462
7,ENSG00000228960.4,144299373,chr7-144158226-T-G,rs1209417,1,T,G,144158226,141147,144102765,144495981,55461
7,ENSG00000235029.1,157006307,chr7-157093285-A-G,rs12534197,1,A,G,157093285,86978,156809699,157202915,283586
7,ENSG00000228303.1,56650696,chr7-56740039-A-G,rs12538805,-1,A,G,56740039,89343,56454088,56847304,285951
7,ENSG00000224059.1,85027828,chr7-85071317-G-T,rs12673176,1,G,T,85071317,43489,84831220,85224436,240097
7,ENSG00000235090.1,75922755,chr7-75733069-A-G,rs13238507,1,A,G,75733069,189686,75726147,76119363,6922
7,ENSG00000224903.1,156659582,chr7-156473589-T-C,rs1527574,-1,T,C,156473589,185993,156462974,156856190,10615
7,ENSG00000228775.3,141738230,chr7-141862841-T-A,rs1655263,-1,T,A,141862841,124611,141541622,141934838,321219
7,ENSG00000214870.4,26398654,chr7-26534647-T-C,rs17153806,1,T,C,26534647,135993,26202046,26595262,332601
7,ENSG00000224046.1,87152420,chr7-87129922-T-C,rs17161323,-1,T,C,87129922,22498,86955812,87349028,174110
7,ENSG00000235920.1,11821294,chr7-11733156-T-C,rs17165101,-1,T,C,11733156,88138,11624686,12017902,108470
7,ENSG00000231721.2,131107928,chr7-131150836-A-G,rs17165465,-1,A,G,131150836,42908,130911320,131304536,239516
7,ENSG00000233369.2,73175415,chr7-73352951-C-T,rs17339094,1,C,T,73352951,177536,72978807,73372023,374144
7,ENSG00000214869.5,27023737,chr7-27096689-G-A,rs17449024,1,G,A,27096689,72952,26827129,27220345,269560
7,ENSG00000211698.2,38354517,chr7-38383269-T-C,rs17497544,-1,T,C,38383269,28752,38157909,38551125,225360
7,ENSG00000223969.1,90597398,chr7-90471292-A-G,rs177667,-1,A,G,90471292,126106,90400790,90794006,70502
7,ENSG00000227199.1,116954334,chr7-116791373-C-T,rs193686,-1,C,T,116791373,162961,116757726,117150942,33647
7,ENSG00000235828.4,15701752,chr7-15866670-C-T,rs1942645,-1,C,T,15866670,164918,15505144,15898360,361526
7,ENSG00000249978.1,38335514,chr7-38494809-G-A,rs2028210,-1,G,A,38494809,159295,38138906,38532122,355903
7,ENSG00000240132.1,151501878,chr7-151372608-A-G,rs2108725,1,A,G,151372608,129270,151305270,151698486,67338
7,ENSG00000067601.6,67299424,chr7-67393463-T-C,rs2110004,-1,T,C,67393463,94039,67102816,67496032,290647
7,ENSG00000211701.2,38368169,chr7-38365370-A-T,rs2160195,-1,A,T,38365370,2799,38171561,38564777,193809
7,ENSG00000232729.1,74728862,chr7-74706683-T-C,rs2301908,-1,T,C,74706683,22179,74532254,74925470,174429
7,ENSG00000133624.9,149624565,chr7-149663876-T-A,rs2373489,-1,T,A,149663876,39311,149427957,149821173,235919
7,ENSG00000237310.1,66493659,chr7-66645741-T-G,rs2533285,1,T,G,66645741,152082,66297051,66690267,348690
7,ENSG00000229180.2,66576923,chr7-66645741-T-G,rs2533285,-1,T,G,66645741,68818,66380315,66773531,265426
7,ENSG00000233297.4,102690469,chr7-102712182-T-G,rs28715957,-1,T,G,102712182,21713,102493861,102887077,218321
7,ENSG00000214106.3,154928485,chr7-154999468-A-G,rs306273,1,A,G,154999468,70983,154731877,155125093,267591
7,ENSG00000233834.2,20217536,chr7-20166070-T-G,rs3095000,1,T,G,20166070,51466,20020928,20414144,145142
7,ENSG00000237064.1,109960184,chr7-109818245-A-G,rs3107956,-1,A,G,109818245,141939,109763576,110156792,54669
7,ENSG00000227053.1,101017665,chr7-100992866-C-T,rs34196598,-1,C,T,100992866,24799,100821057,101214273,171809
7,ENSG00000233429.4,27096094,chr7-27171929-C-T,rs34957925,1,C,T,27171929,75835,26899486,27292702,272443
7,ENSG00000227968.1,108995029,chr7-108966627-G-A,rs41427546,-1,G,A,108966627,28402,108798421,109191637,168206
7,ENSG00000211697.2,38350022,chr7-38373387-T-C,rs4373430,-1,T,C,38373387,23365,38153414,38546630,219973
7,ENSG00000214035.3,145009961,chr7-145158276-A-G,rs4523168,1,A,G,145158276,148315,144813353,145206569,344923
7,ENSG00000230042.1,23129178,chr7-23295689-T-G,rs460031,1,T,G,23295689,166511,22932570,23325786,363119
7,ENSG00000230658.1,23105703,chr7-23295689-T-G,rs460031,-1,T,G,23295689,189986,22909095,23302311,386594
7,ENSG00000224971.1,55732144,chr7-55649184-G-T,rs4621761,1,G,T,55649184,82960,55535536,55928752,113648
7,ENSG00000232727.2,64433830,chr7-64356018-G-A,rs4718067,1,G,A,64356018,77812,64237222,64630438,118796
7,ENSG00000232759.1,22563337,chr7-22445549-G-A,rs4722141,1,G,A,22445549,117788,22366729,22759945,78820
7,ENSG00000232533.1,143381036,chr7-143404891-C-T,rs4726618,-1,C,T,143404891,23855,143184428,143577644,220463
7,ENSG00000223886.3,105530209,chr7-105446184-A-G,rs4730086,1,A,G,105446184,84025,105333601,105726817,112583
7,ENSG00000224280.1,16586757,chr7-16602124-A-C,rs523615,-1,A,C,16602124,15367,16390149,16783365,211975
7,ENSG00000228649.1,22854159,chr7-23030164-T-C,rs55921023,1,T,C,23030164,176005,22657551,23050767,372613
7,ENSG00000232956.2,44986961,chr7-45070059-G-C,rs55967204,-1,G,C,45070059,83098,44790353,45183569,279706
7,ENSG00000242073.2,75486108,chr7-75588074-G-A,rs56071227,-1,G,A,75588074,101966,75289500,75682716,298574
7,ENSG00000235314.1,44039523,chr7-44206718-C-T,rs56298219,1,C,T,44206718,167195,43842915,44236131,363803
7,ENSG00000230359.3,129056019,chr7-129146778-A-C,rs60107606,1,A,C,129146778,90759,128859411,129252627,287367
7,ENSG00000213650.3,56568858,chr7-56659271-A-C,rs62463298,-1,A,C,56659271,90413,56372250,56765466,287021
7,ENSG00000234585.2,65064999,chr7-65231622-C-T,rs62469333,1,C,T,65231622,166623,64868391,65261607,363231
7,ENSG00000232445.1,101308270,chr7-101277494-C-T,rs6968930,1,C,T,101277494,30776,101111662,101504878,165832
7,ENSG00000183444.9,97967074,chr7-97881674-C-T,rs6969821,-1,C,T,97881674,85400,97770466,98163682,111208
7,ENSG00000078319.7,100335860,chr7-100406771-C-T,rs6970350,-1,C,T,100406771,70911,100139252,100532468,267519
7,ENSG00000240211.1,100436204,chr7-100430564-C-T,rs6975729,1,C,T,100430564,5640,100239596,100632812,190968
7,ENSG00000227344.2,53187388,chr7-53032358-G-A,rs6977554,1,G,A,53032358,155030,52990780,53383996,41578
7,ENSG00000146677.6,44467897,chr7-44607262-T-C,rs73109403,1,T,C,44607262,139365,44271289,44664505,335973
7,ENSG00000106610.10,67305987,chr7-67356906-G-C,rs73150480,1,G,C,67356906,50919,67109379,67502595,247527
7,ENSG00000225739.1,36818959,chr7-36762554-C-T,rs741303,1,C,T,36762554,56405,36622351,37015567,140203
7,ENSG00000189212.8,35186041,chr7-35316675-A-G,rs75314410,-1,A,G,35316675,130634,34989433,35382649,327242
7,ENSG00000213394.3,101204495,chr7-101036851-G-A,rs75782138,-1,G,A,101036851,167644,101007887,101401103,28964
7,ENSG00000227436.1,23619333,chr7-23534127-C-T,rs75923419,1,C,T,23534127,85206,23422725,23815941,111402
7,ENSG00000228335.1,99443496,chr7-99247782-G-A,rs75958338,-1,G,A,99247782,195714,99246888,99640104,894
7,ENSG00000233306.2,38363518,chr7-38377213-C-T,rs76283292,-1,C,T,38377213,13695,38166910,38560126,210303
7,ENSG00000188185.6,39733632,chr7-39900256-C-T,rs76494285,1,C,T,39900256,166624,39537024,39930240,363232
7,ENSG00000226342.1,63910453,chr7-63834097-T-A,rs76540627,-1,T,A,63834097,76356,63713845,64107061,120252
7,ENSG00000228540.1,110725825,chr7-110742009-C-T,rs7781323,-1,C,T,110742009,16184,110529217,110922433,212792
7,ENSG00000170356.8,144251603,chr7-144178446-T-C,rs7791258,-1,T,C,144178446,73157,144054995,144448211,123451
7,ENSG00000224079.1,1074450,chr7-966937-T-C,rs7792825,1,T,C,966937,107513,877842,1271058,89095
7,ENSG00000235720.1,63893286,chr7-63854694-A-G,rs7793523,1,A,G,63854694,38592,63696678,64089894,158016
7,ENSG00000230189.2,66453634,chr7-66332201-T-C,rs77980817,-1,T,C,66332201,121433,66257026,66650242,75175
7,ENSG00000223459.4,143598039,chr7-143737311-G-C,rs7807308,1,G,C,143737311,139272,143401431,143794647,335880
7,ENSG00000260997.1,44960909,chr7-45110732-A-C,rs7810512,-1,A,C,45110732,149823,44764301,45157517,346431
7,ENSG00000254959.1,30752137,chr7-30850545-G-A,rs78722842,1,G,A,30850545,98408,30555529,30948745,295016
7,ENSG00000224172.1,64736743,chr7-64628227-T-C,rs78750842,-1,T,C,64628227,108516,64540135,64933351,88092
7,ENSG00000244701.1,141656810,chr7-141598179-C-G,rs79030772,-1,C,G,141598179,58631,141460202,141853418,137977
7,ENSG00000230715.2,128652841,chr7-128719406-C-T,rs79548510,1,C,T,128719406,66565,128456233,128849449,263173
7,ENSG00000243302.2,128651185,chr7-128719406-C-T,rs79548510,1,C,T,128719406,68221,128454577,128847793,264829
7,ENSG00000182648.7,156640599,chr7-156620502-T-C,rs849072,-1,T,C,156620502,20097,156443991,156837207,176511
7,ENSG00000228974.4,5560743,chr7-5568277-A-G,rs852503,1,A,G,5568277,7534,5364135,5757351,204142
7,ENSG00000225792.1,26376237,chr7-26474108-A-G,rs916969,-1,A,G,26474108,97871,26179629,26572845,294479
7,ENSG00000225792.1,26376237,chr7-26474108-A-C,rs916969,-1,A,C,26474108,97871,26179629,26572845,294479
7,ENSG00000229877.1,143546735,chr7-143486110-G-A,rs940697,-1,G,A,143486110,60625,143350127,143743343,135983
7,ENSG00000224138.1,127350128,chr7-127499154-T-C,rs954007,1,T,C,127499154,149026,127153520,127546736,345634
7,ENSG00000233264.2,7980312,chr7-7824142-C-G,rs960746,1,C,G,7824142,156170,7783704,8176920,40438
6,ENSG00000203875.4,85678748,chr6-85678170-G-T,rs1059307,-1,G,T,85678170,578,85482140,85875356,196030
6,ENSG00000218350.1,71165076,chr6-71159637-G-C,rs10945292,1,G,C,71159637,5439,70968468,71361684,191169
6,ENSG00000235008.1,166702839,chr6-166752298-C-T,rs10946186,-1,C,T,166752298,49459,166506231,166899447,246067
6,ENSG00000212802.3,12514110,chr6-12709407-T-G,rs10948184,1,T,G,12709407,195297,12317502,12710718,391905
6,ENSG00000227939.1,31280317,chr6-31345637-A-G,rs111343098,1,A,G,31345637,65320,31083709,31476925,261928
6,ENSG00000234147.1,140898381,chr6-140888061-A-G,rs11155139,-1,A,G,140888061,10320,140701773,141094989,186288
6,ENSG00000216819.1,3179764,chr6-3205200-T-C,rs11242827,-1,T,C,3205200,25436,2983156,3376372,222044
6,ENSG00000213880.3,29803991,chr6-29673737-C-G,rs114591600,-1,C,G,29673737,130254,29607383,30000599,66354
6,ENSG00000213880.3,29803991,chr6-29673737-C-T,rs114591600,-1,C,T,29673737,130254,29607383,30000599,66354
6,ENSG00000229931.1,16761724,chr6-16730996-G-A,rs1150637,1,G,A,16730996,30728,16565116,16958332,165880
6,ENSG00000225595.1,28863350,chr6-28997862-C-A,rs115486666,-1,C,A,28997862,134512,28666742,29059958,331120
6,ENSG00000213916.2,28861416,chr6-28997862-C-A,rs115486666,1,C,A,28997862,136446,28664808,29058024,333054
6,ENSG00000225580.2,112617880,chr6-112468530-G-A,rs117257765,-1,G,A,112468530,149350,112421272,112814488,47258
6,ENSG00000186743.2,116038756,chr6-116159456-C-T,rs11752488,1,C,T,116159456,120700,115842148,116235364,317308
6,ENSG00000226309.1,84430802,chr6-84540033-A-T,rs117533947,-1,A,T,84540033,109231,84234194,84627410,305839
6,ENSG00000219257.1,100051236,chr6-99871698-G-A,rs117801732,-1,G,A,99871698,179538,99854628,100247844,17070
6,ENSG00000226089.2,81534913,chr6-81624705-C-T,rs118143313,-1,C,T,81624705,89792,81338305,81731521,286400
6,ENSG00000218857.1,131185486,chr6-131204544-A-G,rs1190806,-1,A,G,131204544,19058,130988878,131382094,215666
6,ENSG00000218857.1,131185486,chr6-131204544-A-T,rs1190806,-1,A,T,131204544,19058,130988878,131382094,215666
6,ENSG00000224328.1,30703067,chr6-30754156-T-C,rs11964663,1,T,C,30754156,51089,30506459,30899675,247697
6,ENSG00000229921.2,167997077,chr6-167991179-C-A,rs12203032,-1,C,A,167991179,5898,167800469,168193685,190710
6,ENSG00000213130.3,128580884,chr6-128528613-T-C,rs12206907,-1,T,C,128528613,52271,128384276,128777492,144337
6,ENSG00000234484.1,132752675,chr6-132752034-C-T,rs12209262,1,C,T,132752034,641,132556067,132949283,195967
6,ENSG00000216863.4,6622744,chr6-6643424-A-G,rs12210481,-1,A,G,6643424,20680,6426136,6819352,217288
6,ENSG00000229852.2,73263222,chr6-73276934-T-C,rs12216162,1,T,C,73276934,13712,73066614,73459830,210320
6,ENSG00000176933.4,28218634,chr6-28208637-A-C,rs1233666,-1,A,C,28208637,9997,28022026,28415242,186611
6,ENSG00000224384.1,96785137,chr6-96800819-T-C,rs12525976,1,T,C,96800819,15682,96588529,96981745,212290
6,ENSG00000224384.1,96785137,chr6-96800819-T-A,rs12525976,1,T,A,96800819,15682,96588529,96981745,212290
6,ENSG00000219565.2,108787053,chr6-108632772-A-G,rs13207511,-1,A,G,108632772,154281,108590445,108983661,42327
6,ENSG00000213073.4,160093423,chr6-160081428-A-T,rs13207901,1,A,T,160081428,11995,159896815,160290031,184613
6,ENSG00000255389.1,111599875,chr6-111601517-A-G,rs13210247,1,A,G,111601517,1642,111403267,111796483,198250
6,ENSG00000260273.1,109382795,chr6-109365424-C-A,rs13437492,1,C,A,109365424,17371,109186187,109579403,179237
6,ENSG00000233916.1,29708547,chr6-29764617-A-G,rs1633043,-1,A,G,29764617,56070,29511939,29905155,252678
6,ENSG00000235174.1,73373263,chr6-73197316-C-T,rs16883494,-1,C,T,73197316,175947,73176655,73569871,20661
6,ENSG00000239626.1,73290403,chr6-73300891-A-G,rs16883564,1,A,G,73300891,10488,73093795,73487011,207096
6,ENSG00000225339.1,34248535,chr6-34287854-C-A,rs16883896,1,C,A,34287854,39319,34051927,34445143,235927
6,ENSG00000245261.1,43223860,chr6-43223680-T-C,rs16896363,-1,T,C,43223680,180,43027252,43420468,196428
6,ENSG00000249141.1,166956124,chr6-167032003-C-T,rs16899809,-1,C,T,167032003,75879,166759516,167152732,272487
6,ENSG00000218027.2,1515289,chr6-1386502-G-T,rs1711970,-1,G,T,1386502,128787,1318681,1711897,67821
6,ENSG00000204387.7,31834608,chr6-31845428-C-T,rs17201269,1,C,T,31845428,10820,31638000,32031216,207428
6,ENSG00000250535.1,32013270,chr6-31948236-T-C,rs17201431,1,T,C,31948236,65034,31816662,32209878,131574
6,ENSG00000219902.1,105302823,chr6-105125229-T-C,rs17524448,-1,T,C,105125229,177594,105106215,105499431,19014
6,ENSG00000204110.4,37507348,chr6-37519268-T-C,rs1757171,1,T,C,37519268,11920,37310740,37703956,208528
6,ENSG00000227920.2,37545145,chr6-37518534-A-G,rs1757178,1,A,G,37518534,26611,37348537,37741753,169997
6,ENSG00000238076.1,10460541,chr6-10390702-C-T,rs17572948,-1,C,T,10390702,69839,10263933,10657149,126769
6,ENSG00000205653.1,203313,chr6-209117-A-G,rs17744451,1,A,G,209117,5804,6705,399921,202412
6,ENSG00000230943.1,113650090,chr6-113745925-T-C,rs2030926,-1,T,C,113745925,95835,113453482,113846698,292443
6,ENSG00000204528.3,31177899,chr6-31272119-T-C,rs2074491,-1,T,C,31272119,94220,30981291,31374507,290828
6,ENSG00000215190.4,57961345,chr6-57964387-T-G,rs2146166,-1,T,G,57964387,3042,57764737,58157953,199650
6,ENSG00000230438.3,2881407,chr6-2876347-C-T,rs2252076,-1,C,T,2876347,5060,2684799,3078015,191548
6,ENSG00000217165.1,39110321,chr6-39117924-T-C,rs228813,1,T,C,39117924,7603,38913713,39306929,204211
6,ENSG00000250903.2,2245736,chr6-2230827-C-G,rs2295007,1,C,G,2230827,14909,2049128,2442344,181699
6,ENSG00000124593.10,41780946,chr6-41610923-G-A,rs2395782,1,G,A,41610923,170023,41584338,41977554,26585
6,ENSG00000230521.1,29888268,chr6-29720724-A-C,rs2517910,-1,A,C,29720724,167544,29691660,30084876,29064
6,ENSG00000229142.1,29828364,chr6-29720724-A-C,rs2517910,-1,A,C,29720724,107640,29631756,30024972,88968
6,ENSG00000230795.2,29926459,chr6-29971517-C-T,rs2523964,1,C,T,29971517,45058,29729851,30123067,241666
6,ENSG00000227766.1,29943067,chr6-29965662-C-T,rs2844806,-1,C,T,29965662,22595,29746459,30139675,219203
6,ENSG00000166984.7,167172145,chr6-167140697-A-C,rs3093001,1,A,C,167140697,31448,166975537,167368753,165160
6,ENSG00000233902.1,31463336,chr6-31572916-G-C,rs3093542,-1,G,C,31572916,109580,31266728,31659944,306188
6,ENSG00000233902.1,31463336,chr6-31572916-G-T,rs3093542,-1,G,T,31572916,109580,31266728,31659944,306188
6,ENSG00000219797.2,31520291,chr6-31579697-G-A,rs3093561,-1,G,A,31579697,59406,31323683,31716899,256014
6,ENSG00000206344.5,31197760,chr6-31193433-T-G,rs3095238,1,T,G,31193433,4327,31001152,31394368,192281
6,ENSG00000224557.3,33112516,chr6-33088041-A-G,rs3128964,1,A,G,33088041,24475,32915908,33309124,172133
6,ENSG00000228022.1,30743790,chr6-30790689-A-G,rs3131043,1,A,G,30790689,46899,30547182,30940398,243507
6,ENSG00000254870.1,31546582,chr6-31739953-T-C,rs3131382,-1,T,C,31739953,193371,31349974,31743190,389979
6,ENSG00000219755.1,99575712,chr6-99554211-G-A,rs330815,1,G,A,99554211,21501,99379104,99772320,175107
6,ENSG00000229559.2,37547280,chr6-37564181-A-G,rs34017770,-1,A,G,37564181,16901,37350672,37743888,213509
6,ENSG00000244041.1,2987967,chr6-2840548-C-T,rs34249702,1,C,T,2840548,147419,2791359,3184575,49189
6,ENSG00000235821.1,29751148,chr6-29747555-C-A,rs34260811,-1,C,A,29747555,3593,29554540,29947756,193015
6,ENSG00000225864.1,29723971,chr6-29721350-G-A,rs3757324,-1,G,A,29721350,2621,29527363,29920579,193987
6,ENSG00000225864.1,29723971,chr6-29721350-G-T,rs3757324,-1,G,T,29721350,2621,29527363,29920579,193987
6,ENSG00000168405.9,25138081,chr6-25099112-G-A,rs3792971,-1,G,A,25099112,38969,24941473,25334689,157639
6,ENSG00000227627.1,152983719,chr6-153002671-A-C,rs3818126,1,A,C,153002671,18952,152787111,153180327,215560
6,ENSG00000227627.1,152983719,chr6-153002671-A-G,rs3818126,1,A,G,153002671,18952,152787111,153180327,215560
6,ENSG00000216854.2,56871191,chr6-56683561-G-A,rs4073960,1,G,A,56683561,187630,56674583,57067799,8978
6,ENSG00000220666.2,56433213,chr6-56511293-C-T,rs41271864,-1,C,T,56511293,78080,56236605,56629821,274688
6,ENSG00000228170.1,3153062,chr6-3204587-G-A,rs4129373,-1,G,A,3204587,51525,2956454,3349670,248133
6,ENSG00000204789.3,27359854,chr6-27299229-C-T,rs4559087,-1,C,T,27299229,60625,27163246,27556462,135983
6,ENSG00000230913.1,41666906,chr6-41493657-T-C,rs4711676,1,T,C,41493657,173249,41470298,41863514,23359
6,ENSG00000226314.3,28161769,chr6-28071808-G-A,rs4713135,1,G,A,28071808,89961,27965161,28358377,106647
6,ENSG00000260000.1,100881450,chr6-100882312-C-T,rs4840159,1,C,T,100882312,862,100684842,101078058,197470
6,ENSG00000231889.2,111483512,chr6-111574525-G-A,rs4947124,1,G,A,111574525,91013,111286904,111680120,287621
6,ENSG00000168126.3,27937465,chr6-27892756-C-T,rs58106751,1,C,T,27892756,44709,27740857,28134073,151899
6,ENSG00000218565.2,139338018,chr6-139473819-G-A,rs62440877,1,G,A,139473819,135801,139141410,139534626,332409
6,ENSG00000226571.1,139271362,chr6-139270754-T-C,rs62441202,1,T,C,139270754,608,139074754,139467970,196000
6,ENSG00000214460.3,85427966,chr6-85368816-C-T,rs6454463,-1,C,T,85368816,59150,85231358,85624574,137458
6,ENSG00000218265.1,13521266,chr6-13473830-T-G,rs6458848,1,T,G,13473830,47436,13324658,13717874,149172
6,ENSG00000232876.1,135055033,chr6-135044680-C-T,rs6569990,1,C,T,135044680,10353,134858425,135251641,186255
6,ENSG00000261366.1,95577450,chr6-95399038-T-G,rs66733329,-1,T,G,95399038,178412,95380842,95774058,18196
6,ENSG00000261366.1,95577450,chr6-95399038-T-A,rs66733329,-1,T,A,95399038,178412,95380842,95774058,18196
6,ENSG00000213108.3,137544372,chr6-137712481-G-A,rs669274,-1,G,A,137712481,168109,137347764,137740980,364717
6,ENSG00000219758.5,113839279,chr6-113883308-A-G,rs688338,1,A,G,113883308,44029,113642671,114035887,240637
6,ENSG00000246982.2,36197203,chr6-36183400-T-C,rs6906612,-1,T,C,36183400,13803,36000595,36393811,182805
6,ENSG00000237786.1,13486294,chr6-13417514-G-A,rs6936420,1,G,A,13417514,68780,13289686,13682902,127828
6,ENSG00000219747.1,151099529,chr6-150977830-T-C,rs6940242,1,T,C,150977830,121699,150902921,151296137,74909
6,ENSG00000213131.3,127355756,chr6-127460675-T-C,rs723642,1,T,C,127460675,104919,127159148,127552364,301527
6,ENSG00000226445.1,169213254,chr6-169200949-C-T,rs73041845,1,C,T,169200949,12305,169016646,169409862,184303
6,ENSG00000183239.5,44089696,chr6-44225969-C-G,rs731780,-1,C,G,44225969,136273,43893088,44286304,332881
6,ENSG00000261839.1,28136849,chr6-28180332-C-T,rs73400532,1,C,T,28180332,43483,27940241,28333457,240091
6,ENSG00000229502.1,157875210,chr6-158069365-A-G,rs734882,-1,A,G,158069365,194155,157678602,158071818,390763
6,ENSG00000218073.1,16160926,chr6-16175979-C-G,rs74451139,1,C,G,16175979,15053,15964318,16357534,211661
6,ENSG00000231162.3,28446973,chr6-28314027-C-T,rs74967533,1,C,T,28314027,132946,28250365,28643581,63662
6,ENSG00000260645.1,80466958,chr6-80417442-G-A,rs75411105,1,G,A,80417442,49516,80270350,80663566,147092
6,ENSG00000229036.1,143490515,chr6-143435375-A-G,rs7740441,1,A,G,143435375,55140,143293907,143687123,141468
6,ENSG00000225690.1,41247369,chr6-41284483-G-A,rs7742256,1,G,A,41284483,37114,41050761,41443977,233722
6,ENSG00000219470.1,43539703,chr6-43523071-C-T,rs7755135,-1,C,T,43523071,16632,43343095,43736311,179976
6,ENSG00000217227.1,38587323,chr6-38686529-T-C,rs7761715,1,T,C,38686529,99206,38390715,38783931,295814
6,ENSG00000237988.2,29550407,chr6-29479947-A-G,rs7767061,1,A,G,29479947,70460,29353799,29747015,126148
6,ENSG00000234956.1,137792835,chr6-137983032-A-G,rs7768419,-1,A,G,137983032,190197,137596227,137989443,386805
6,ENSG00000234882.1,73291962,chr6-73209200-G-A,rs7771888,1,G,A,73209200,82762,73095354,73488570,113846
6,ENSG00000217241.1,116453565,chr6-116610192-A-G,rs784121,-1,A,G,116610192,156627,116256957,116650173,353235
6,ENSG00000261211.1,6686948,chr6-6684585-G-T,rs79506447,-1,G,T,6684585,2363,6490340,6883556,194245
6,ENSG00000261211.1,6686948,chr6-6684585-G-A,rs79506447,-1,G,A,6684585,2363,6490340,6883556,194245
6,ENSG00000213149.3,110858239,chr6-110842353-T-C,rs802688,1,T,C,110842353,15886,110661631,111054847,180722
6,ENSG00000228624.2,113969701,chr6-114030463-G-T,rs915203,1,G,T,114030463,60762,113773093,114166309,257370
6,ENSG00000215477.2,87122688,chr6-87318011-A-G,rs926947,-1,A,G,87318011,195323,86926080,87319296,391931
6,ENSG00000181577.10,44000585,chr6-44014395-C-A,rs926959,1,C,A,44014395,13810,43803977,44197193,210418
6,ENSG00000229391.3,32558186,chr6-32603062-A-G,rs9270856,-1,A,G,32603062,44876,32361578,32754794,241484
6,ENSG00000223534.1,32659880,chr6-32660921-C-T,rs9273529,1,C,T,32660921,1041,32463272,32856488,197649
6,ENSG00000204261.4,32844086,chr6-32963018-T-C,rs9276933,1,T,C,32963018,118932,32647478,33040694,315540
6,ENSG00000216915.2,27738494,chr6-27721723-G-A,rs9295740,-1,G,A,27721723,16771,27541886,27935102,179837
6,ENSG00000233231.1,166334568,chr6-166337928-C-T,rs9356478,1,C,T,166337928,3360,166137960,166531176,199968
6,ENSG00000225914.1,32255328,chr6-32341131-G-A,rs9469099,1,G,A,32341131,85803,32058720,32451936,282411
6,ENSG00000216813.1,47562622,chr6-47437719-T-C,rs9473111,1,T,C,47437719,124903,47366014,47759230,71705
6,ENSG00000220848.4,149594084,chr6-149441715-G-A,rs9498354,1,G,A,149441715,152369,149397476,149790692,44239
6,ENSG00000185689.10,4087534,chr6-4255474-A-G,rs9504008,1,A,G,4255474,167940,3890926,4284142,364548
6,ENSG00000217805.2,25181359,chr6-25070149-G-C,rs950877,1,G,C,25070149,111210,24984751,25377967,85398
6,ENSG00000233967.1,80442649,chr6-80250195-C-A,rs978814,1,C,A,80250195,192454,80246041,80639257,4154
6,ENSG00000213133.4,126258355,chr6-126106495-C-T,rs113058245,-1,C,T,126106495,151860,126061747,126454963,44748
6,ENSG00000213133.4,126258355,chr6-126106495-C-A,rs113058245,-1,C,A,126106495,151860,126061747,126454963,44748
6,ENSG00000235559.1,28784004,chr6-28733689-C-A,rs113396763,-1,C,A,28733689,50315,28587396,28980612,146293
6,ENSG00000235559.1,28784004,chr6-28733689-C-T,rs113396763,-1,C,T,28733689,50315,28587396,28980612,146293
6,ENSG00000235559.1,28784004,chr6-28733689-C-G,rs113396763,-1,C,G,28733689,50315,28587396,28980612,146293
6,ENSG00000235290.1,29956596,chr6-30024484-C-T,rs1150743,1,C,T,30024484,67888,29759988,30153204,264496
6,ENSG00000235652.1,145799409,chr6-145792625-C-G,rs117945383,1,C,G,145792625,6784,145602801,145996017,189824
6,ENSG00000225793.1,75285014,chr6-75430381-C-T,rs118062348,1,C,T,75430381,145367,75088406,75481622,341975
6,ENSG00000213204.3,87408012,chr6-87375228-C-G,rs118119352,1,C,G,87375228,32784,87211404,87604620,163824
6,ENSG00000205653.1,203313,chr6-206313-T-C,rs11961507,1,T,C,206313,3000,6705,399921,199608
6,ENSG00000219755.1,99575712,chr6-99394250-C-T,rs11964807,1,C,T,99394250,181462,99379104,99772320,15146
6,ENSG00000217139.2,121682925,chr6-121690223-C-T,rs11969322,1,C,T,121690223,7298,121486317,121879533,203906
6,ENSG00000226309.1,84430802,chr6-84272490-T-C,rs12174666,-1,T,C,84272490,158312,84234194,84627410,38296
6,ENSG00000161912.12,41101022,chr6-41091719-T-G,rs12189627,1,T,G,41091719,9303,40904414,41297630,187305
6,ENSG00000218261.1,53378503,chr6-53223007-A-G,rs12192403,1,A,G,53223007,155496,53181895,53575111,41112
6,ENSG00000217539.2,28010723,chr6-27820212-G-A,rs12196939,1,G,A,27820212,190511,27814115,28207331,6097
6,ENSG00000217385.1,4702463,chr6-4822997-C-T,rs12197283,1,C,T,4822997,120534,4505855,4899071,317142
6,ENSG00000216915.2,27738494,chr6-27586005-T-C,rs12197514,-1,T,C,27586005,152489,27541886,27935102,44119
6,ENSG00000239626.1,73290403,chr6-73198040-A-G,rs12215980,1,A,G,73198040,92363,73093795,73487011,104245
6,ENSG00000204387.7,31834608,chr6-31901358-G-A,rs12525922,1,G,A,31901358,66750,31638000,32031216,263358
6,ENSG00000215190.4,57961345,chr6-57970370-G-A,rs12663198,-1,G,A,57970370,9025,57764737,58157953,205633
6,ENSG00000227192.1,143042324,chr6-143037876-T-G,rs12664681,-1,T,G,143037876,4448,142845716,143238932,192160
6,ENSG00000220563.1,85660606,chr6-85630519-C-T,rs13202606,-1,C,T,85630519,30087,85463998,85857214,166521
6,ENSG00000235381.1,155256724,chr6-155067487-A-G,rs13211274,-1,A,G,155067487,189237,155060116,155453332,7371
6,ENSG00000213183.3,96649069,chr6-96669960-G-A,rs1475750,-1,G,A,96669960,20891,96452461,96845677,217499
6,ENSG00000234515.1,32879833,chr6-32773079-A-C,rs1480383,-1,A,C,32773079,106754,32683225,33076441,89854
6,ENSG00000228078.1,29934101,chr6-29841605-C-T,rs1611133,1,C,T,29841605,92496,29737493,30130709,104112
6,ENSG00000233916.1,29708547,chr6-29747985-G-A,rs1633086,-1,G,A,29747985,39438,29511939,29905155,236046
6,ENSG00000219891.2,28092427,chr6-27965931-A-T,rs16893533,1,A,T,27965931,126496,27895819,28289035,70112
6,ENSG00000219487.2,149112672,chr6-148965546-A-G,rs17080690,-1,A,G,148965546,147126,148916064,149309280,49482
6,ENSG00000230433.1,524171,chr6-476395-A-G,rs17133849,1,A,G,476395,47776,327563,720779,148832
6,ENSG00000225093.1,108005568,chr6-107819078-C-T,rs17589005,-1,C,T,107819078,186490,107808960,108202176,10118
6,ENSG00000226803.1,57172422,chr6-57302322-C-T,rs17683594,-1,C,T,57302322,129900,56975814,57369030,326508
6,ENSG00000231889.2,111483512,chr6-111585943-A-G,rs1883137,1,A,G,111585943,102431,111286904,111680120,299039
6,ENSG00000233967.1,80442649,chr6-80379819-A-G,rs1935036,1,A,G,80379819,62830,80246041,80639257,133778
6,ENSG00000124593.10,41780946,chr6-41635456-G-A,rs1973920,1,G,A,41635456,145490,41584338,41977554,51118
6,ENSG00000225791.1,52577314,chr6-52532249-T-G,rs2268731,1,T,G,52532249,45065,52380706,52773922,151543
6,ENSG00000228022.1,30743790,chr6-30756653-T-C,rs2394401,1,T,C,30756653,12863,30547182,30940398,209471
6,ENSG00000250264.1,32838822,chr6-32828908-A-G,rs241448,-1,A,G,32828908,9914,32642214,33035430,186694
6,ENSG00000235781.1,30516266,chr6-30503743-A-G,rs2429657,1,A,G,30503743,12523,30319658,30712874,184085
6,ENSG00000260645.1,80466958,chr6-80631458-T-C,rs2444830,1,T,C,80631458,164500,80270350,80663566,361108
6,ENSG00000220583.1,34263673,chr6-34068269-A-G,rs2499683,-1,A,G,34068269,195404,34067065,34460281,1204
6,ENSG00000231074.2,30327362,chr6-30264597-G-A,rs2516698,-1,G,A,30264597,62765,30130754,30523970,133843
6,ENSG00000229921.2,167997077,chr6-168004296-T-C,rs2516808,-1,T,C,168004296,7219,167800469,168193685,203827
6,ENSG00000244041.1,2987967,chr6-3005952-G-A,rs28383612,1,G,A,3005952,17985,2791359,3184575,214593
6,ENSG00000224796.1,33079451,chr6-33078305-C-T,rs2856819,1,C,T,33078305,1146,32882843,33276059,195462
6,ENSG00000216781.2,10366582,chr6-10429938-T-C,rs303061,-1,T,C,10429938,63356,10169974,10563190,259964
6,ENSG00000168405.9,25138081,chr6-25035692-G-A,rs303890,-1,G,A,25035692,102389,24941473,25334689,94219
6,ENSG00000166984.7,167172145,chr6-167136287-T-C,rs3093007,1,T,C,167136287,35858,166975537,167368753,160750
6,ENSG00000225864.1,29723971,chr6-29704752-T-C,rs3094727,-1,T,C,29704752,19219,29527363,29920579,177389
6,ENSG00000214922.3,29749049,chr6-29707450-T-A,rs3131862,-1,T,A,29707450,41599,29552441,29945657,155009
6,ENSG00000230521.1,29888268,chr6-29914753-T-G,rs3132689,-1,T,G,29914753,26485,29691660,30084876,223093
6,ENSG00000237685.1,10514546,chr6-10460081-C-T,rs34375686,-1,C,T,10460081,54465,10317938,10711154,142143
6,ENSG00000228624.2,113969701,chr6-113896087-A-G,rs352073,1,A,G,113896087,73614,113773093,114166309,122994
6,ENSG00000213073.4,160093423,chr6-160146896-G-T,rs3798167,1,G,T,160146896,53473,159896815,160290031,250081
6,ENSG00000216819.1,3179764,chr6-3150281-C-T,rs3799216,-1,C,T,3150281,29483,2983156,3376372,167125
6,ENSG00000228170.1,3153062,chr6-3150281-C-T,rs3799216,-1,C,T,3150281,2781,2956454,3349670,193827
6,ENSG00000216775.1,52665274,chr6-52673914-T-C,rs3823033,1,T,C,52673914,8640,52468666,52861882,205248
6,ENSG00000223534.1,32659880,chr6-32668032-T-C,rs3828790,1,T,C,32668032,8152,32463272,32856488,204760
6,ENSG00000255389.1,111599875,chr6-111526988-A-T,rs3851228,1,A,T,111526988,72887,111403267,111796483,123721
6,ENSG00000216817.1,104019748,chr6-103984290-G-A,rs4520040,-1,G,A,103984290,35458,103823140,104216356,161150
6,ENSG00000230711.2,168289350,chr6-168126178-T-C,rs4708660,-1,T,C,168126178,163172,168092742,168485958,33436
6,ENSG00000233330.1,149592663,chr6-149504128-C-T,rs4895792,-1,C,T,149504128,88535,149396055,149789271,108073
6,ENSG00000233330.1,149592663,chr6-149504128-C-A,rs4895792,-1,C,A,149504128,88535,149396055,149789271,108073
6,ENSG00000250535.1,32013270,chr6-31965741-T-C,rs492899,1,T,C,31965741,47529,31816662,32209878,149079
6,ENSG00000228834.1,108907873,chr6-108805722-A-C,rs517697,-1,A,C,108805722,102151,108711265,109104481,94457
6,ENSG00000213177.3,100136064,chr6-100145175-G-A,rs59984938,1,G,A,100145175,9111,99939456,100332672,205719
6,ENSG00000217165.1,39110321,chr6-39096167-G-A,rs60678751,1,G,A,39096167,14154,38913713,39306929,182454
6,ENSG00000231113.1,42943740,chr6-43046284-G-A,rs61732148,1,G,A,43046284,102544,42747132,43140348,299152
6,ENSG00000218565.2,139338018,chr6-139270754-T-C,rs62441202,1,T,C,139270754,67264,139141410,139534626,129344
6,ENSG00000218418.1,80070199,chr6-80246491-C-T,rs648831,-1,C,T,80246491,176292,79873591,80266807,372900
6,ENSG00000232876.1,135055033,chr6-134903615-C-A,rs6569976,1,C,A,134903615,151418,134858425,135251641,45190
6,ENSG00000216863.4,6622744,chr6-6589244-C-T,rs6597220,-1,C,T,6589244,33500,6426136,6819352,163108
6,ENSG00000260000.1,100881450,chr6-100854947-A-G,rs6908709,1,A,G,100854947,26503,100684842,101078058,170105
6,ENSG00000260000.1,100881450,chr6-100854947-A-T,rs6908709,1,A,T,100854947,26503,100684842,101078058,170105
6,ENSG00000204622.6,30006606,chr6-29966245-T-C,rs6914699,1,T,C,29966245,40361,29809998,30203214,156247
6,ENSG00000228506.1,99424913,chr6-99345399-T-C,rs6917584,1,T,C,99345399,79514,99228305,99621521,117094
6,ENSG00000219986.2,6795402,chr6-6769697-A-G,rs6918434,-1,A,G,6769697,25705,6598794,6992010,170903
6,ENSG00000228223.1,26521709,chr6-26527650-A-G,rs6934448,1,A,G,26527650,5941,26325101,26718317,202549
6,ENSG00000219703.1,117431591,chr6-117279035-C-T,rs706955,1,C,T,117279035,152556,117234983,117628199,44052
6,ENSG00000219703.1,117431591,chr6-117279035-C-G,rs706955,1,C,G,117279035,152556,117234983,117628199,44052
6,ENSG00000214460.3,85427966,chr6-85421438-A-G,rs727870,-1,A,G,85421438,6528,85231358,85624574,190080
6,ENSG00000233138.1,142748443,chr6-142686344-G-A,rs72984383,1,G,A,142686344,62099,142551835,142945051,134509
6,ENSG00000185689.10,4087534,chr6-4151255-C-T,rs73353387,1,C,T,4151255,63721,3890926,4284142,260329
6,ENSG00000233231.1,166334568,chr6-166302660-A-G,rs74650519,1,A,G,166302660,31908,166137960,166531176,164700
6,ENSG00000228415.2,30633632,chr6-30488109-G-A,rs762324,1,G,A,30488109,145523,30437024,30830240,51085
6,ENSG00000227627.1,152983719,chr6-152992697-G-A,rs766127,1,G,A,152992697,8978,152787111,153180327,205586
6,ENSG00000261366.1,95577450,chr6-95401709-C-T,rs7751232,-1,C,T,95401709,175741,95380842,95774058,20867
6,ENSG00000230943.1,113650090,chr6-113686616-C-T,rs7761143,-1,C,T,113686616,36526,113453482,113846698,233134
6,ENSG00000213131.3,127355756,chr6-127480138-A-C,rs7763458,1,A,C,127480138,124382,127159148,127552364,320990
6,ENSG00000232699.1,99174744,chr6-99211926-T-C,rs7767885,1,T,C,99211926,37182,98978136,99371352,233790
6,ENSG00000226445.1,169213254,chr6-169201218-C-A,rs7775470,1,C,A,169201218,12036,169016646,169409862,184572
6,ENSG00000217030.1,4979072,chr6-4913835-A-C,rs78768296,1,A,C,4913835,65237,4782464,5175680,131371
6,ENSG00000220884.2,128929988,chr6-128863543-G-A,rs78855065,-1,G,A,128863543,66445,128733380,129126596,130163
6,ENSG00000232757.1,30031713,chr6-29853516-A-C,rs9258631,1,A,C,29853516,178197,29835105,30228321,18411
6,ENSG00000225914.1,32255328,chr6-32237333-T-C,rs9267911,1,T,C,32237333,17995,32058720,32451936,178613
6,ENSG00000196301.3,32473500,chr6-32637674-A-G,rs9272449,-1,A,G,32637674,164174,32276892,32670108,360782
6,ENSG00000203711.6,158869867,chr6-158861342-T-C,rs9295088,1,T,C,158861342,8525,158673259,159066475,188083
6,ENSG00000219085.1,69706160,chr6-69513415-G-A,rs9364016,-1,G,A,69513415,192745,69509552,69902768,3863
6,ENSG00000229931.1,16761724,chr6-16669136-T-C,rs9367924,1,T,C,16669136,92588,16565116,16958332,104020
6,ENSG00000219565.2,108787053,chr6-108806173-G-A,rs9374046,-1,G,A,108806173,19120,108590445,108983661,215728
6,ENSG00000219806.1,139615204,chr6-139652777-A-G,rs9376442,-1,A,G,139652777,37573,139418596,139811812,234181
6,ENSG00000219257.1,100051236,chr6-99982041-G-A,rs9376634,-1,G,A,99982041,69195,99854628,100247844,127413
6,ENSG00000219257.1,100051236,chr6-99982041-G-C,rs9376634,-1,G,C,99982041,69195,99854628,100247844,127413
6,ENSG00000124549.9,26422119,chr6-26582186-G-A,rs9379892,1,G,A,26582186,160067,26225511,26618727,356675
6,ENSG00000230438.3,2881407,chr6-2869054-C-G,rs9392434,-1,C,G,2869054,12353,2684799,3078015,184255
6,ENSG00000216802.1,138650973,chr6-138509735-T-C,rs9402978,-1,T,C,138509735,141238,138454365,138847581,55370
6,ENSG00000226453.1,82169391,chr6-82333035-A-G,rs9449458,-1,A,G,82333035,163644,81972783,82365999,360252
6,ENSG00000218226.1,158621636,chr6-158592994-T-G,rs9457410,-1,T,G,158592994,28642,158425028,158818244,167966
6,ENSG00000238076.1,10460541,chr6-10271978-G-A,rs9465751,-1,G,A,10271978,188563,10263933,10657149,8045
6,ENSG00000236326.1,116244728,chr6-116409912-G-A,rs9488923,-1,G,A,116409912,165184,116048120,116441336,361792
6,ENSG00000234484.1,132752675,chr6-132752994-G-A,rs9493423,1,G,A,132752994,319,132556067,132949283,196927
6,ENSG00000213076.3,158922150,chr6-158961298-T-G,rs10455771,-1,T,G,158961298,39148,158725542,159118758,235756
6,ENSG00000234515.1,32879833,chr6-32784272-G-C,rs10484564,-1,G,C,32784272,95561,32683225,33076441,101047
6,ENSG00000227627.1,152983719,chr6-152950717-C-T,rs10484865,1,C,T,152950717,33002,152787111,153180327,163606
6,ENSG00000220563.1,85660606,chr6-85678170-G-T,rs1059307,-1,G,T,85678170,17564,85463998,85857214,214172
6,ENSG00000217139.2,121682925,chr6-121491720-T-C,rs10782213,1,T,C,121491720,191205,121486317,121879533,5403
6,ENSG00000218582.2,79954011,chr6-80094969-C-T,rs10943692,-1,C,T,80094969,140958,79757403,80150619,337566
6,ENSG00000229349.2,46204729,chr6-46060449-T-C,rs10948275,1,T,C,46060449,144280,46008121,46401337,52328
6,ENSG00000244041.1,2987967,chr6-2937113-G-A,rs11242810,1,G,A,2937113,50854,2791359,3184575,145754
6,ENSG00000231881.1,44058792,chr6-44204600-T-C,rs114874500,1,T,C,44204600,145808,43862184,44255400,342416
6,ENSG00000204110.4,37507348,chr6-37506245-A-C,rs1150792,1,A,C,37506245,1103,37310740,37703956,195505
6,ENSG00000204789.3,27359854,chr6-27332801-A-G,rs1156457,-1,A,G,27332801,27053,27163246,27556462,169555
6,ENSG00000228624.2,113969701,chr6-113821717-A-G,rs117075388,1,A,G,113821717,147984,113773093,114166309,48624
6,ENSG00000220069.1,86087134,chr6-86263880-A-C,rs11753535,-1,A,C,86263880,176746,85890526,86283742,373354
6,ENSG00000236591.1,149032573,chr6-149077964-G-T,rs117984853,-1,G,T,149077964,45391,148835965,149229181,241999
6,ENSG00000237786.1,13486294,chr6-13631616-T-C,rs11960990,1,T,C,13631616,145322,13289686,13682902,341930
6,ENSG00000229921.2,167997077,chr6-167983028-T-C,rs11964963,-1,T,C,167983028,14049,167800469,168193685,182559
6,ENSG00000234817.2,4136072,chr6-4157442-G-T,rs12195496,1,G,T,4157442,21370,3939464,4332680,217978
6,ENSG00000239626.1,73290403,chr6-73276934-T-C,rs12216162,1,T,C,73276934,13469,73093795,73487011,183139
6,ENSG00000213880.3,29803991,chr6-29654443-C-G,rs1233367,-1,C,G,29654443,149548,29607383,30000599,47060
6,ENSG00000216901.1,28176188,chr6-28205441-G-A,rs1233708,1,G,A,28205441,29253,27979580,28372796,225861
6,ENSG00000234484.1,132752675,chr6-132746594-T-C,rs12663711,1,T,C,132746594,6081,132556067,132949283,190527
6,ENSG00000218574.1,5610195,chr6-5456317-C-T,rs12664978,-1,C,T,5456317,153878,5413587,5806803,42730
6,ENSG00000206344.5,31197760,chr6-31148433-G-A,rs130071,1,G,A,31148433,49327,31001152,31394368,147281
6,ENSG00000226453.1,82169391,chr6-82059713-A-G,rs1361682,-1,A,G,82059713,109678,81972783,82365999,86930
6,ENSG00000232618.1,142946406,chr6-142949110-A-G,rs1413627,1,A,G,142949110,2704,142749798,143143014,199312
6,ENSG00000216904.2,113222166,chr6-113040493-G-C,rs1481306,1,G,C,113040493,181673,113025558,113418774,14935
6,ENSG00000228078.1,29934101,chr6-29750767-C-T,rs1610736,1,C,T,29750767,183334,29737493,30130709,13274
6,ENSG00000237154.1,27407697,chr6-27311853-C-A,rs16897557,1,C,A,27311853,95844,27211089,27604305,100764
6,ENSG00000225093.1,108005568,chr6-107818366-C-T,rs17068819,-1,C,T,107818366,187202,107808960,108202176,9406
6,ENSG00000233452.1,147204555,chr6-147165908-G-A,rs17076651,-1,G,A,147165908,38647,147007947,147401163,157961
6,ENSG00000255389.1,111599875,chr6-111593645-C-T,rs174385,1,C,T,111593645,6230,111403267,111796483,190378
6,ENSG00000218565.2,139338018,chr6-139508780-G-A,rs17513809,1,G,A,139508780,170762,139141410,139534626,367370
6,ENSG00000229931.1,16761724,chr6-16675521-A-G,rs17668407,1,A,G,16675521,86203,16565116,16958332,110405
6,ENSG00000261071.1,13615190,chr6-13517225-A-G,rs17680885,-1,A,G,13517225,97965,13418582,13811798,98643
6,ENSG00000228415.2,30633632,chr6-30492455-C-T,rs17875371,1,C,T,30492455,141177,30437024,30830240,55431
6,ENSG00000261211.1,6686948,chr6-6654616-A-G,rs1802323,-1,A,G,6654616,32332,6490340,6883556,164276
6,ENSG00000239650.2,57930291,chr6-58013740-C-A,rs1936268,-1,C,A,58013740,83449,57733683,58126899,280057
6,ENSG00000232876.1,135055033,chr6-135118125-A-G,rs2026937,1,A,G,135118125,63092,134858425,135251641,259700
6,ENSG00000243775.2,158842170,chr6-158762530-T-C,rs2171209,-1,T,C,158762530,79640,158645562,159038778,116968
6,ENSG00000231113.1,42943740,chr6-43045924-T-C,rs2273918,1,T,C,43045924,102184,42747132,43140348,298792
6,ENSG00000166984.7,167172145,chr6-167187860-T-C,rs2345970,1,T,C,167187860,15715,166975537,167368753,212323
6,ENSG00000230943.1,113650090,chr6-113547856-A-C,rs2348305,-1,A,C,113547856,102234,113453482,113846698,94374
6,ENSG00000176998.3,29792750,chr6-29848644-A-G,rs2394186,-1,A,G,29848644,55894,29596142,29989358,252502
6,ENSG00000181126.8,29792234,chr6-29975911-G-C,rs2394251,1,G,C,29975911,183677,29595626,29988842,380285
6,ENSG00000227262.2,29926973,chr6-29971000-A-T,rs2523969,-1,A,T,29971000,44027,29730365,30123581,240635
6,ENSG00000217241.1,116453565,chr6-116516393-A-G,rs2637677,-1,A,G,116516393,62828,116256957,116650173,259436
6,ENSG00000225092.2,7183083,chr6-7250727-G-A,rs2714338,1,G,A,7250727,67644,6986475,7379691,264252
6,ENSG00000214975.4,24976419,chr6-24877433-T-C,rs2747685,1,T,C,24877433,98986,24779811,25173027,97622
6,ENSG00000220483.4,65788417,chr6-65793925-A-C,rs2802038,1,A,C,65793925,5508,65591809,65985025,202116
6,ENSG00000246982.2,36197203,chr6-36144646-C-T,rs2815807,-1,C,T,36144646,52557,36000595,36393811,144051
6,ENSG00000223534.1,32659880,chr6-32604474-T-A,rs2858870,1,T,A,32604474,55406,32463272,32856488,141202
6,ENSG00000223534.1,32659880,chr6-32604474-T-C,rs2858870,1,T,C,32604474,55406,32463272,32856488,141202
6,ENSG00000239257.1,29727139,chr6-29693679-A-T,rs2894113,-1,A,T,29693679,33460,29530531,29923747,163148
6,ENSG00000228022.1,30743790,chr6-30759162-A-C,rs3095340,1,A,C,30759162,15372,30547182,30940398,211980
6,ENSG00000206341.6,29887752,chr6-29867174-T-C,rs3132722,1,T,C,29867174,20578,29691144,30084360,176030
6,ENSG00000230438.3,2881407,chr6-2886561-C-T,rs318473,-1,C,T,2886561,5154,2684799,3078015,201762
6,ENSG00000232757.1,30031713,chr6-30112592-G-A,rs34704616,1,G,A,30112592,80879,29835105,30228321,277487
6,ENSG00000226840.1,73327524,chr6-73183954-G-A,rs3757105,1,G,A,73183954,143570,73130916,73524132,53038
6,ENSG00000224557.3,33112516,chr6-33056829-C-G,rs376877,1,C,G,33056829,55687,32915908,33309124,140921
6,ENSG00000216863.4,6622744,chr6-6591050-T-C,rs3804464,-1,T,C,6591050,31694,6426136,6819352,164914
6,ENSG00000216775.1,52665274,chr6-52590748-C-T,rs3823034,1,C,T,52590748,74526,52468666,52861882,122082
6,ENSG00000235821.1,29751148,chr6-29839124-C-G,rs407238,-1,C,G,29839124,87976,29554540,29947756,284584
6,ENSG00000230056.1,29331061,chr6-29461988-A-G,rs41271553,-1,A,G,29461988,130927,29134453,29527669,327535
6,ENSG00000235008.1,166702839,chr6-166751831-C-T,rs41345853,-1,C,T,166751831,48992,166506231,166899447,245600
6,ENSG00000219470.1,43539703,chr6-43726861-T-C,rs4711748,-1,T,C,43726861,187158,43343095,43736311,383766
6,ENSG00000183239.5,44089696,chr6-44186588-C-T,rs4711777,-1,C,T,44186588,96892,43893088,44286304,293500
6,ENSG00000224796.1,33079451,chr6-33160210-C-A,rs4713614,1,C,A,33160210,80759,32882843,33276059,277367
6,ENSG00000220583.1,34263673,chr6-34165711-C-T,rs4713751,-1,C,T,34165711,97962,34067065,34460281,98646
6,ENSG00000220583.1,34263673,chr6-34165711-C-G,rs4713751,-1,C,G,34165711,97962,34067065,34460281,98646
6,ENSG00000219755.1,99575712,chr6-99425375-A-G,rs4840040,1,A,G,99425375,150337,99379104,99772320,46271
6,ENSG00000238076.1,10460541,chr6-10497171-C-T,rs501507,-1,C,T,10497171,36630,10263933,10657149,233238
6,ENSG00000228976.1,108618285,chr6-108757434-G-A,rs522731,-1,G,A,108757434,139149,108421677,108814893,335757
6,ENSG00000228976.1,108618285,chr6-108757434-G-C,rs522731,-1,G,C,108757434,139149,108421677,108814893,335757
6,ENSG00000203875.4,85678748,chr6-85675964-C-A,rs61396151,-1,C,A,85675964,2784,85482140,85875356,193824
6,ENSG00000204528.3,31177899,chr6-31079885-A-G,rs62398706,-1,A,G,31079885,98014,30981291,31374507,98594
6,ENSG00000261584.1,26686241,chr6-26566576-C-T,rs6456733,1,C,T,26566576,119665,26489633,26882849,76943
6,ENSG00000217824.1,148567654,chr6-148402931-A-T,rs6570848,-1,A,T,148402931,164723,148371046,148764262,31885
6,ENSG00000217165.1,39110321,chr6-39146031-G-T,rs6903109,1,G,T,39146031,35710,38913713,39306929,232318
6,ENSG00000220267.1,88276989,chr6-88143424-A-C,rs6911472,-1,A,C,88143424,133565,88080381,88473597,63043
6,ENSG00000228834.1,108907873,chr6-108744289-T-C,rs6918973,-1,T,C,108744289,163584,108711265,109104481,33024
6,ENSG00000219395.2,151413945,chr6-151526669-G-T,rs6922890,-1,G,T,151526669,112724,151217337,151610553,309332
6,ENSG00000176933.4,28218634,chr6-28311281-G-A,rs6932394,-1,G,A,28311281,92647,28022026,28415242,289255
6,ENSG00000220472.1,7339568,chr6-7324253-G-A,rs6938311,-1,G,A,7324253,15315,7142960,7536176,181293
6,ENSG00000231074.2,30327362,chr6-30345563-G-C,rs6986,-1,G,C,30345563,18201,30130754,30523970,214809
6,ENSG00000230433.1,524171,chr6-576902-T-C,rs708038,1,T,C,576902,52731,327563,720779,249339
6,ENSG00000234147.1,140898381,chr6-141057591-T-C,rs72983105,-1,T,C,141057591,159210,140701773,141094989,355818
6,ENSG00000249141.1,166956124,chr6-167112422-C-T,rs73023509,-1,C,T,167112422,156298,166759516,167152732,352906
6,ENSG00000233231.1,166334568,chr6-166356048-C-T,rs735297,1,C,T,166356048,21480,166137960,166531176,218088
6,ENSG00000216368.2,10118452,chr6-10192155-T-C,rs75072109,1,T,C,10192155,73703,9921844,10315060,270311
6,ENSG00000218226.1,158621636,chr6-158807984-G-A,rs75124571,-1,G,A,158807984,186348,158425028,158818244,382956
6,ENSG00000226309.1,84430802,chr6-84325170-A-G,rs76435401,-1,A,G,84325170,105632,84234194,84627410,90976
6,ENSG00000215477.2,87122688,chr6-87039925-C-T,rs7738920,-1,C,T,87039925,82763,86926080,87319296,113845
6,ENSG00000250264.1,32838822,chr6-32696555-T-C,rs7745040,-1,T,C,32696555,142267,32642214,33035430,54341
6,ENSG00000231120.2,149977922,chr6-149856312-T-A,rs7753340,1,T,A,149856312,121610,149781314,150174530,74998
6,ENSG00000229852.2,73263222,chr6-73306390-C-T,rs7753960,1,C,T,73306390,43168,73066614,73459830,239776
6,ENSG00000228506.1,99424913,chr6-99376529-A-T,rs7755791,1,A,T,99376529,48384,99228305,99621521,148224
6,ENSG00000217539.2,28010723,chr6-27957589-G-A,rs7767176,1,G,A,27957589,53134,27814115,28207331,143474
6,ENSG00000235381.1,155256724,chr6-155181982-G-A,rs7770051,-1,G,A,155181982,74742,155060116,155453332,121866
6,ENSG00000232389.1,70609334,chr6-70778603-G-A,rs7771348,-1,G,A,70778603,169269,70412726,70805942,365877
6,ENSG00000217414.2,18365423,chr6-18528168-C-T,rs78366315,-1,C,T,18528168,162745,18168815,18562031,359353
6,ENSG00000226571.1,139271362,chr6-139433650-C-G,rs79324176,1,C,G,139433650,162288,139074754,139467970,358896
6,ENSG00000219797.2,31520291,chr6-31686756-C-T,rs79515906,-1,C,T,31686756,166465,31323683,31716899,363073
6,ENSG00000229700.1,20042940,chr6-20135196-T-C,rs843318,-1,T,C,20135196,92256,19846332,20239548,288864
6,ENSG00000196301.3,32473500,chr6-32477883-T-C,rs9269149,-1,T,C,32477883,4383,32276892,32670108,200991
6,ENSG00000248993.1,32953122,chr6-32963018-T-C,rs9276933,-1,T,C,32963018,9896,32756514,33149730,206504
6,ENSG00000216915.2,27738494,chr6-27816650-A-G,rs9295750,-1,A,G,27816650,78156,27541886,27935102,274764
6,ENSG00000219163.1,53236297,chr6-53084119-T-C,rs9296698,-1,T,C,53084119,152178,53039689,53432905,44430
6,ENSG00000218890.1,66094909,chr6-66147689-T-C,rs9351548,-1,T,C,66147689,52780,65898301,66291517,249388
6,ENSG00000228223.1,26521709,chr6-26479663-G-T,rs9357008,1,G,T,26479663,42046,26325101,26718317,154562
6,ENSG00000218980.2,57004520,chr6-56961532-T-C,rs9382671,1,T,C,56961532,42988,56807912,57201128,153620
6,ENSG00000218980.2,57004520,chr6-56961532-T-A,rs9382671,1,T,A,56961532,42988,56807912,57201128,153620
6,ENSG00000216813.1,47562622,chr6-47586441-G-A,rs9395285,1,G,A,47586441,23819,47366014,47759230,220427
6,ENSG00000060303.5,50857662,chr6-50898107-C-T,rs943005,-1,C,T,50898107,40445,50661054,51054270,237053
6,ENSG00000218857.1,131185486,chr6-131221397-A-G,rs9483230,-1,A,G,131221397,35911,130988878,131382094,232519
5,ENSG00000231185.2,142404201,chr5-142334726-C-T,rs10037503,1,C,T,142334726,69475,142207593,142600809,127133
5,ENSG00000244945.1,179603741,chr5-179668757-G-A,rs10040357,-1,G,A,179668757,65016,179407133,179800349,261624
5,ENSG00000214485.5,150094302,chr5-150227185-T-C,rs10051644,1,T,C,150227185,132883,149897694,150290910,329491
5,ENSG00000249971.1,138349641,chr5-138283083-T-C,rs10054835,-1,T,C,138283083,66558,138153033,138546249,130050
5,ENSG00000224431.1,132199456,chr5-132350453-G-A,rs10058074,1,G,A,132350453,150997,132002848,132396064,347605
5,ENSG00000246214.1,16616158,chr5-16782540-T-C,rs10073730,1,T,C,16782540,166382,16419550,16812766,362990
5,ENSG00000250155.1,36725173,chr5-36702762-C-A,rs1025288,-1,C,A,36702762,22411,36528565,36921781,174197
5,ENSG00000213891.3,61391871,chr5-61535306-C-T,rs10447098,-1,C,T,61535306,143435,61195263,61588479,340043
5,ENSG00000253558.1,78044136,chr5-78023623-T-A,rs10514134,-1,T,A,78023623,20513,77847528,78240744,176095
5,ENSG00000249183.1,69069200,chr5-68913502-A-G,rs10940184,-1,A,G,68913502,155698,68872592,69265808,40910
5,ENSG00000247796.2,53109860,chr5-53113429-A-G,rs10940291,1,A,G,53113429,3569,52913252,53306468,200177
5,ENSG00000250492.1,39721513,chr5-39817662-G-A,rs10941473,-1,G,A,39817662,96149,39524905,39918121,292757
5,ENSG00000250602.1,126509021,chr5-126450912-G-A,rs114316363,-1,G,A,126450912,58109,126312413,126705629,138499
5,ENSG00000248677.1,6707711,chr5-6796657-A-G,rs114597858,-1,A,G,6796657,88946,6511103,6904319,285554
5,ENSG00000249921.1,108784098,chr5-108762295-A-C,rs115795788,1,A,C,108762295,21803,108587490,108980706,174805
5,ENSG00000244717.1,69469883,chr5-69362951-G-C,rs11739902,1,G,C,69362951,106932,69273275,69666491,89676
5,ENSG00000248873.1,42468868,chr5-42504329-T-C,rs11748366,-1,T,C,42504329,35461,42272260,42665476,232069
5,ENSG00000215068.3,43041579,chr5-42874805-C-T,rs12110284,1,C,T,42874805,166774,42844971,43238187,29834
5,ENSG00000239528.1,116562562,chr5-116475552-G-T,rs12516652,1,G,T,116475552,87010,116365954,116759170,109598
5,ENSG00000214108.4,31908361,chr5-31751632-C-A,rs12516878,1,C,A,31751632,156729,31711753,32104969,39879
5,ENSG00000250222.1,181191856,chr5-181243251-C-G,rs1279738,1,C,G,181243251,51395,180995248,181388464,248003
5,ENSG00000253512.1,165783134,chr5-165610512-G-A,rs13155598,-1,G,A,165610512,172622,165586526,165979742,23986
5,ENSG00000261360.1,14664604,chr5-14749019-C-T,rs13170282,-1,C,T,14749019,84415,14467996,14861212,281023
5,ENSG00000235172.3,170307722,chr5-170203006-C-T,rs13354784,1,C,T,170203006,104716,170111114,170504330,91892
5,ENSG00000251050.1,80019609,chr5-79993172-A-G,rs1438739,1,A,G,79993172,26437,79823001,80216217,170171
5,ENSG00000227762.3,99532628,chr5-99721923-C-T,rs1462411,1,C,T,99721923,189295,99336020,99729236,385903
5,ENSG00000250764.1,32121941,chr5-31940329-A-G,rs1505019,-1,A,G,31940329,181612,31925333,32318549,14996
5,ENSG00000185641.5,116052289,chr5-116160418-G-A,rs1508874,-1,G,A,116160418,108129,115855681,116248897,304737
5,ENSG00000243806.1,94826694,chr5-94840820-G-A,rs159601,-1,G,A,94840820,14126,94630086,95023302,210734
5,ENSG00000248781.1,56276630,chr5-56361048-T-C,rs1645483,-1,T,C,56361048,84418,56080022,56473238,281026
5,ENSG00000249092.1,42892817,chr5-42900811-T-C,rs16872900,-1,T,C,42900811,7994,42696209,43089425,204602
5,ENSG00000248684.1,75910565,chr5-76062004-A-G,rs16873165,1,A,G,76062004,151439,75713957,76107173,348047
5,ENSG00000250579.1,5140153,chr5-5045634-C-T,rs16874621,-1,C,T,5045634,94519,4943545,5336761,102089
5,ENSG00000250786.1,9546193,chr5-9391525-C-A,rs16882610,1,C,A,9391525,154668,9349585,9742801,41940
5,ENSG00000213956.4,50633124,chr5-50698836-A-G,rs16884480,1,A,G,50698836,65712,50436516,50829732,262320
5,ENSG00000251548.1,10665113,chr5-10624693-A-C,rs16885029,-1,A,C,10624693,40420,10468505,10861721,156188
5,ENSG00000250332.1,23305143,chr5-23289064-C-T,rs16892365,-1,C,T,23289064,16079,23108535,23501751,180529
5,ENSG00000253683.1,172656713,chr5-172695123-C-G,rs17075121,-1,C,G,172695123,38410,172460105,172853321,235018
5,ENSG00000253683.1,172656713,chr5-172695123-C-A,rs17075121,-1,C,A,172695123,38410,172460105,172853321,235018
5,ENSG00000249476.1,109326369,chr5-109324827-G-C,rs17161729,-1,G,C,109324827,1542,109129761,109522977,195066
5,ENSG00000244192.1,130989897,chr5-131162535-A-G,rs17165688,1,A,G,131162535,172638,130793289,131186505,369246
5,ENSG00000244921.2,134924049,chr5-134930722-C-T,rs17167694,-1,C,T,134930722,6673,134727441,135120657,203281
5,ENSG00000241956.5,164296978,chr5-164344035-G-A,rs17287615,1,G,A,164344035,47057,164100370,164493586,243665
5,ENSG00000250182.1,14653329,chr5-14693289-C-T,rs17363829,-1,C,T,14693289,39960,14456721,14849937,236568
5,ENSG00000215246.4,997308,chr5-870179-G-A,rs17568832,-1,G,A,870179,127129,800700,1193916,69479
5,ENSG00000238160.1,132426714,chr5-132485305-G-A,rs17622656,-1,G,A,132485305,58591,132230106,132623322,255199
5,ENSG00000238160.1,132426714,chr5-132485305-G-T,rs17622656,-1,G,T,132485305,58591,132230106,132623322,255199
5,ENSG00000228367.3,75921660,chr5-76108312-A-C,rs17673786,-1,A,C,76108312,186652,75725052,76118268,383260
5,ENSG00000245937.2,128083100,chr5-128021834-C-T,rs17764730,-1,C,T,128021834,61266,127886492,128279708,135342
5,ENSG00000253618.1,149357642,chr5-149414478-A-G,rs17796690,-1,A,G,149414478,56836,149161034,149554250,253444
5,ENSG00000215156.4,34190056,chr5-34221514-A-G,rs1854044,1,A,G,34221514,31458,33993448,34386664,228066
5,ENSG00000253861.1,168553727,chr5-168712264-G-A,rs1864951,-1,G,A,168712264,158537,168357119,168750335,355145
5,ENSG00000250329.1,128109486,chr5-128287291-C-T,rs2042327,1,C,T,128287291,177805,127912878,128306094,374413
5,ENSG00000250444.1,115512077,chr5-115386902-C-T,rs2166339,1,C,T,115386902,125175,115315469,115708685,71433
5,ENSG00000221990.2,443160,chr5-438449-T-C,rs2241598,-1,T,C,438449,4711,246552,639768,191897
5,ENSG00000205464.5,82295449,chr5-82275850-C-T,rs226202,1,C,T,82275850,19599,82098841,82492057,177009
5,ENSG00000185986.9,1593289,chr5-1489591-A-G,rs2277003,-1,A,G,1489591,103698,1396681,1789897,92910
5,ENSG00000225138.2,473236,chr5-469972-G-A,rs2278251,1,G,A,469972,3264,276628,669844,193344
5,ENSG00000250705.1,88602780,chr5-88599367-T-C,rs2431392,1,T,C,88599367,3413,88406172,88799388,193195
5,ENSG00000251018.2,163494034,chr5-163618898-C-T,rs249600,-1,C,T,163618898,124864,163297426,163690642,321472
5,ENSG00000248275.1,181261222,chr5-181271412-T-C,rs2545086,1,T,C,181271412,10190,181064614,181457830,206798
5,ENSG00000248794.1,81242599,chr5-81069496-G-A,rs26907,-1,G,A,81069496,173103,81045991,81439207,23505
5,ENSG00000233006.1,132369916,chr5-132315174-A-G,rs270606,-1,A,G,132315174,54742,132173308,132566524,141866
5,ENSG00000248769.1,69653248,chr5-69530961-G-A,rs28703202,1,G,A,69530961,122287,69456640,69849856,74321
5,ENSG00000250138.3,69631963,chr5-69530961-G-A,rs28703202,1,G,A,69530961,101002,69435355,69828571,95606
5,ENSG00000249494.1,119070902,chr5-119060533-C-T,rs299216,-1,C,T,119060533,10369,118874294,119267510,186239
5,ENSG00000183666.11,21459560,chr5-21424634-G-A,rs34123832,1,G,A,21424634,34926,21262952,21656168,161682
5,ENSG00000233974.3,21484011,chr5-21424634-G-A,rs34123832,-1,G,A,21424634,59377,21287403,21680619,137231
5,ENSG00000245060.2,180830948,chr5-180874648-G-A,rs34362037,1,G,A,180874648,43700,180634340,181027556,240308
5,ENSG00000248925.1,271516,chr5-200714-A-G,rs34629844,-1,A,G,200714,70802,74908,468124,125806
5,ENSG00000249026.1,115392370,chr5-115337612-C-T,rs34639164,-1,C,T,115337612,54758,115195762,115588978,141850
5,ENSG00000247828.2,88268883,chr5-88218187-G-T,rs371708,1,G,T,88218187,50696,88072275,88465491,145912
5,ENSG00000249572.1,33440619,chr5-33440200-C-A,rs3756663,-1,C,A,33440200,419,33244011,33637227,196189
5,ENSG00000247121.2,96935809,chr5-96991959-A-G,rs38040,-1,A,G,96991959,56150,96739201,97132417,252758
5,ENSG00000254132.1,94569470,chr5-94631801-A-G,rs385232,-1,A,G,94631801,62331,94372862,94766078,258939
5,ENSG00000250999.1,179658038,chr5-179667107-A-C,rs4331859,1,A,C,179667107,9069,179461430,179854646,205677
5,ENSG00000248693.1,18746173,chr5-18919952-G-C,rs4361518,-1,G,C,18919952,173779,18549565,18942781,370387
5,ENSG00000250526.1,14641018,chr5-14545898-A-G,rs4582273,-1,A,G,14545898,95120,14444410,14837626,101488
5,ENSG00000245556.2,78360414,chr5-78360947-T-C,rs4634329,-1,T,C,78360947,533,78163806,78557022,197141
5,ENSG00000213763.4,77784881,chr5-77638213-C-T,rs4704437,1,C,T,77638213,146668,77588273,77981489,49940
5,ENSG00000251675.1,80128361,chr5-80192370-C-T,rs4704627,1,C,T,80192370,64009,79931753,80324969,260617
5,ENSG00000170089.8,177875595,chr5-177833128-C-T,rs4958955,1,C,T,177833128,42467,177678987,178072203,154141
5,ENSG00000249119.1,134924123,chr5-135054891-A-C,rs4976242,1,A,C,135054891,130768,134727515,135120731,327376
5,ENSG00000260515.1,10197628,chr5-10318343-G-A,rs606490,-1,G,A,10318343,120715,10001020,10394236,317323
5,ENSG00000261434.1,195778,chr5-175027-C-T,rs61079366,1,C,T,175027,20751,-830,392386,175857
5,ENSG00000251235.2,76376675,chr5-76525905-G-T,rs62361970,1,G,T,76525905,149230,76180067,76573283,345838
5,ENSG00000249738.2,159553002,chr5-159391737-A-C,rs6556416,1,A,C,159391737,161265,159356394,159749610,35343
5,ENSG00000247679.2,177611240,chr5-177606518-C-G,rs6600950,1,C,G,177606518,4722,177414632,177807848,191886
5,ENSG00000242858.1,83746989,chr5-83867735-C-T,rs6897010,-1,C,T,83867735,120746,83550381,83943597,317354
5,ENSG00000241458.1,138473744,chr5-138583716-C-T,rs72805831,1,C,T,138583716,109972,138277136,138670352,306580
5,ENSG00000250461.1,61375112,chr5-61237688-A-G,rs7446842,1,A,G,61237688,137424,61178504,61571720,59184
5,ENSG00000240785.1,18049550,chr5-18192329-A-G,rs74912995,1,A,G,18192329,142779,17852942,18246158,339387
5,ENSG00000215032.2,60893577,chr5-60973278-G-A,rs75585870,-1,G,A,60973278,79701,60696969,61090185,276309
5,ENSG00000198868.3,134928326,chr5-134781363-G-A,rs75589259,-1,G,A,134781363,146963,134731718,135124934,49645
5,ENSG00000249825.1,80082404,chr5-80165604-T-C,rs75946551,-1,T,C,80165604,83200,79885796,80279012,279808
5,ENSG00000118990.5,161751768,chr5-161912125-T-C,rs76098157,-1,T,C,161912125,160357,161555160,161948376,356965
5,ENSG00000237714.1,132184876,chr5-132250265-A-G,rs7701414,1,A,G,132250265,65389,131988268,132381484,261997
5,ENSG00000253886.1,154493576,chr5-154437208-C-A,rs7708861,1,C,A,154437208,56368,154296968,154690184,140240
5,ENSG00000253744.1,66144795,chr5-66303212-C-T,rs7717523,-1,C,T,66303212,158417,65948187,66341403,355025
5,ENSG00000247049.2,181230685,chr5-181131279-C-T,rs7719816,-1,C,T,181131279,99406,181034077,181427293,97202
5,ENSG00000229738.1,132988110,chr5-133154239-T-C,rs7727572,-1,T,C,133154239,166129,132791502,133184718,362737
5,ENSG00000188002.6,1633984,chr5-1593981-A-G,rs7734561,-1,A,G,1593981,40003,1437376,1830592,156605
5,ENSG00000254211.1,173807791,chr5-173801323-C-G,rs791378,-1,C,G,173801323,6468,173611183,174004399,190140
5,ENSG00000247763.2,43233173,chr5-43207768-A-G,rs79477621,-1,A,G,43207768,25405,43036565,43429781,171203
5,ENSG00000248400.1,82968888,chr5-82856689-C-T,rs79590433,1,C,T,82856689,112199,82772280,83165496,84409
5,ENSG00000224032.2,112160526,chr5-112167145-G-A,rs79850882,1,G,A,112167145,6619,111963918,112357134,203227
5,ENSG00000247516.2,8457706,chr5-8459420-G-T,rs9313239,1,G,T,8459420,1714,8261098,8654314,198322
5,ENSG00000253520.1,179527513,chr5-179535917-G-A,rs9885443,-1,G,A,179535917,8404,179330905,179724121,205012
5,ENSG00000248734.1,96784777,chr5-96797092-G-A,rs998509,1,G,A,96797092,12315,96588169,96981385,208923
5,ENSG00000251303.1,60630514,chr5-60533638-C-T,rs10056275,1,C,T,60533638,96876,60433906,60827122,99732
5,ENSG00000250853.1,55530701,chr5-55402356-A-G,rs10062279,-1,A,G,55402356,128345,55334093,55727309,68263
5,ENSG00000188242.3,472876,chr5-422637-T-C,rs10072668,-1,T,C,422637,50239,276268,669484,146369
5,ENSG00000204758.3,172959377,chr5-172796042-G-T,rs1010482,-1,G,T,172796042,163335,172762769,173155985,33273
5,ENSG00000213433.5,151766239,chr5-151632696-C-T,rs1036196,-1,C,T,151632696,133543,151569631,151962847,63065
5,ENSG00000248794.1,81242599,chr5-81313949-C-T,rs1039326,-1,C,T,81313949,71350,81045991,81439207,267958
5,ENSG00000253653.1,157266625,chr5-157378779-G-A,rs10515749,-1,G,A,157378779,112154,157070017,157463233,308762
5,ENSG00000249042.1,80487939,chr5-80307889-T-G,rs10805934,-1,T,G,80307889,180050,80291331,80684547,16558
5,ENSG00000214244.4,60460739,chr5-60326565-G-A,rs10939842,-1,G,A,60326565,134174,60264131,60657347,62434
5,ENSG00000249855.1,43496454,chr5-43545098-T-C,rs111545564,-1,T,C,43545098,48644,43299846,43693062,245252
5,ENSG00000170089.8,177875595,chr5-177956781-A-G,rs11249784,1,A,G,177956781,81186,177678987,178072203,277794
5,ENSG00000260774.1,217279,chr5-215922-G-A,rs114938988,-1,G,A,215922,1357,20671,413887,195251
5,ENSG00000251667.1,176308063,chr5-176429867-G-A,rs115055783,1,G,A,176429867,121804,176111455,176504671,318412
5,ENSG00000248925.1,271516,chr5-181629-T-C,rs116033653,-1,T,C,181629,89887,74908,468124,106721
5,ENSG00000241956.5,164296978,chr5-164362712-C-T,rs116438820,1,C,T,164362712,65734,164100370,164493586,262342
5,ENSG00000247572.2,81301472,chr5-81284244-T-G,rs11745275,-1,T,G,81284244,17228,81104864,81498080,179380
5,ENSG00000253144.1,179083194,chr5-179192383-G-A,rs11748179,-1,G,A,179192383,109189,178886586,179279802,305797
5,ENSG00000251050.1,80019609,chr5-79998554-C-A,rs11956870,1,C,A,79998554,21055,79823001,80216217,175553
5,ENSG00000246214.1,16616158,chr5-16752877-T-G,rs11958235,1,T,G,16752877,136719,16419550,16812766,333327
5,ENSG00000221990.2,443160,chr5-428121-C-A,rs12188164,-1,C,A,428121,15039,246552,639768,181569
5,ENSG00000251118.1,115770586,chr5-115785542-G-C,rs12516736,1,G,C,115785542,14956,115573978,115967194,211564
5,ENSG00000249738.2,159553002,chr5-159521986-C-A,rs12659608,1,C,A,159521986,31016,159356394,159749610,165592
5,ENSG00000250526.1,14641018,chr5-14807628-G-A,rs13164197,-1,G,A,14807628,166610,14444410,14837626,363218
5,ENSG00000253955.1,173579643,chr5-173676859-G-A,rs13166404,1,G,A,173676859,97216,173383035,173776251,293824
5,ENSG00000241668.2,31053565,chr5-31123366-T-C,rs13170907,1,T,C,31123366,69801,30856957,31250173,266409
5,ENSG00000241907.1,150021921,chr5-149946500-C-T,rs13357787,-1,C,T,149946500,75421,149825313,150218529,121187
5,ENSG00000217416.3,62777263,chr5-62898775-C-T,rs13359556,-1,C,T,62898775,121512,62580655,62973871,318120
5,ENSG00000249485.1,14798400,chr5-14627724-A-G,rs153822,-1,A,G,14627724,170676,14601792,14995008,25932
5,ENSG00000224431.1,132199456,chr5-132191628-C-T,rs156033,1,C,T,132191628,7828,132002848,132396064,188780
5,ENSG00000226221.1,56505072,chr5-56470178-T-C,rs16885511,-1,T,C,56470178,34894,56308464,56701680,161714
5,ENSG00000245526.2,88684808,chr5-88682435-T-C,rs16903285,-1,T,C,88682435,2373,88488200,88881416,194235
5,ENSG00000251018.2,163494034,chr5-163595469-G-A,rs17062012,-1,G,A,163595469,101435,163297426,163690642,298043
5,ENSG00000251553.1,98679402,chr5-98749511-C-T,rs17166344,1,C,T,98749511,70109,98482794,98876010,266717
5,ENSG00000249494.1,119070902,chr5-119246023-A-G,rs17442317,-1,A,G,119246023,175121,118874294,119267510,371729
5,ENSG00000254298.1,151158462,chr5-151257572-A-G,rs17659728,-1,A,G,151257572,99110,150961854,151355070,295718
5,ENSG00000250579.1,5140153,chr5-5146919-T-C,rs1816235,-1,T,C,5146919,6766,4943545,5336761,203374
5,ENSG00000212643.1,112891610,chr5-112715364-T-C,rs1822163,1,T,C,112715364,176246,112695002,113088218,20362
5,ENSG00000248275.1,181261222,chr5-181239276-A-G,rs2287716,1,A,G,181239276,21946,181064614,181457830,174662
5,ENSG00000253522.1,160438594,chr5-160459613-A-G,rs2431099,1,A,G,160459613,21019,160241986,160635202,217627
5,ENSG00000185986.9,1593289,chr5-1443383-G-A,rs2455391,-1,G,A,1443383,149906,1396681,1789897,46702
5,ENSG00000237714.1,132184876,chr5-132111411-A-G,rs247008,1,A,G,132111411,73465,131988268,132381484,123143
5,ENSG00000253744.1,66144795,chr5-66328731-G-A,rs2561078,-1,G,A,66328731,183936,65948187,66341403,380544
5,ENSG00000248734.1,96784777,chr5-96778846-G-A,rs27039,1,G,A,96778846,5931,96588169,96981385,190677
5,ENSG00000250222.1,181191856,chr5-181187961-G-A,rs2770991,1,G,A,181187961,3895,180995248,181388464,192713
5,ENSG00000247679.2,177611240,chr5-177605049-C-G,rs28473516,1,C,G,177605049,6191,177414632,177807848,190417
5,ENSG00000253203.2,69679193,chr5-69530961-G-A,rs28703202,-1,G,A,69530961,148232,69482585,69875801,48376
5,ENSG00000213376.4,174513305,chr5-174427934-G-A,rs2964057,1,G,A,174427934,85371,174316697,174709913,111237
5,ENSG00000251405.2,157365501,chr5-157198268-T-C,rs31223,-1,T,C,157198268,167233,157168893,157562109,29375
5,ENSG00000247796.2,53109860,chr5-53071316-C-A,rs3212578,1,C,A,53071316,38544,52913252,53306468,158064
5,ENSG00000247796.2,53109860,chr5-53071316-C-T,rs3212578,1,C,T,53071316,38544,52913252,53306468,158064
5,ENSG00000245317.2,179859013,chr5-179893720-C-T,rs32437,1,C,T,179893720,34707,179662405,180055621,231315
5,ENSG00000250182.1,14653329,chr5-14572603-T-C,rs32635,-1,T,C,14572603,80726,14456721,14849937,115882
5,ENSG00000245937.2,128083100,chr5-128011321-A-G,rs34145453,-1,A,G,128011321,71779,127886492,128279708,124829
5,ENSG00000248909.1,78644845,chr5-78654714-T-A,rs341918,-1,T,A,78654714,9869,78448237,78841453,206477
5,ENSG00000245060.2,180830948,chr5-180797518-A-G,rs35418092,1,A,G,180797518,33430,180634340,181027556,163178
5,ENSG00000246334.2,177447699,chr5-177509818-C-T,rs3749728,-1,C,T,177509818,62119,177251091,177644307,258727
5,ENSG00000246334.2,177447699,chr5-177509818-C-G,rs3749728,-1,C,G,177509818,62119,177251091,177644307,258727
5,ENSG00000248400.1,82968888,chr5-83000863-A-C,rs37547,1,A,C,83000863,31975,82772280,83165496,228583
5,ENSG00000261434.1,195778,chr5-308981-A-C,rs3756712,1,A,C,308981,113203,-830,392386,309811
5,ENSG00000248966.1,110950780,chr5-111069977-A-G,rs3806932,-1,A,G,111069977,119197,110754172,111147388,315805
5,ENSG00000249825.1,80082404,chr5-80117251-G-A,rs452106,-1,G,A,80117251,34847,79885796,80279012,231455
5,ENSG00000245556.2,78360414,chr5-78360288-A-C,rs4530741,-1,A,C,78360288,126,78163806,78557022,196482
5,ENSG00000244945.1,179603741,chr5-179505034-C-T,rs4701179,-1,C,T,179505034,98707,179407133,179800349,97901
5,ENSG00000248449.1,141426286,chr5-141405328-C-T,rs4912606,1,C,T,141405328,20958,141229678,141622894,175650
5,ENSG00000248854.1,55840025,chr5-55750079-A-G,rs62361885,-1,A,G,55750079,89946,55643417,56036633,106662
5,ENSG00000253683.1,172656713,chr5-172478420-G-A,rs6556029,-1,G,A,172478420,178293,172460105,172853321,18315
5,ENSG00000248445.1,116449624,chr5-116292420-C-T,rs6866938,1,C,T,116292420,157204,116253016,116646232,39404
5,ENSG00000231185.2,142404201,chr5-142369114-A-G,rs6870768,1,A,G,142369114,35087,142207593,142600809,161521
5,ENSG00000240388.2,91354478,chr5-91203080-G-A,rs6878501,1,G,A,91203080,151398,91157870,91551086,45210
5,ENSG00000231228.3,180982273,chr5-181067803-A-G,rs6882877,1,A,G,181067803,85530,180785665,181178881,282138
5,ENSG00000205464.5,82295449,chr5-82226286-C-T,rs6895884,1,C,T,82226286,69163,82098841,82492057,127445
5,ENSG00000248626.1,159951498,chr5-159829479-A-G,rs719439,-1,A,G,159829479,122019,159754890,160148106,74589
5,ENSG00000226040.2,141896689,chr5-142013832-A-C,rs72640104,-1,A,C,142013832,117143,141700081,142093297,313751
5,ENSG00000235172.3,170307722,chr5-170501143-C-T,rs75708130,1,C,T,170501143,193421,170111114,170504330,390029
5,ENSG00000260515.1,10197628,chr5-10056440-T-C,rs75995538,-1,T,C,10056440,141188,10001020,10394236,55420
5,ENSG00000236882.3,95838245,chr5-95718417-C-A,rs76576394,1,C,A,95718417,119828,95641637,96034853,76780
5,ENSG00000214108.4,31908361,chr5-31811594-T-C,rs76633747,1,T,C,31811594,96767,31711753,32104969,99841
5,ENSG00000250274.1,170312806,chr5-170182711-G-A,rs77087878,-1,G,A,170182711,130095,170116198,170509414,66513
5,ENSG00000220157.4,80360040,chr5-80370212-G-A,rs7715187,-1,G,A,80370212,10172,80163432,80556648,206780
5,ENSG00000220157.4,80360040,chr5-80370212-G-T,rs7715187,-1,G,T,80370212,10172,80163432,80556648,206780
5,ENSG00000253520.1,179527513,chr5-179553008-C-G,rs7718673,-1,C,G,179553008,25495,179330905,179724121,222103
5,ENSG00000253520.1,179527513,chr5-179553008-C-T,rs7718673,-1,C,T,179553008,25495,179330905,179724121,222103
5,ENSG00000250441.1,108894628,chr5-108868462-A-G,rs7725263,-1,A,G,108868462,26166,108698020,109091236,170442
5,ENSG00000251062.1,32888145,chr5-32950259-A-G,rs7730041,-1,A,G,32950259,62114,32691537,33084753,258722
5,ENSG00000248873.1,42468868,chr5-42631573-C-T,rs7732333,-1,C,T,42631573,162705,42272260,42665476,359313
5,ENSG00000247121.2,96935809,chr5-96927886-T-G,rs7733301,-1,T,G,96927886,7923,96739201,97132417,188685
5,ENSG00000235253.1,132942932,chr5-132897875-T-C,rs77554816,1,T,C,132897875,45057,132746324,133139540,151551
5,ENSG00000250337.1,27217714,chr5-27377481-T-C,rs78164350,1,T,C,27377481,159767,27021106,27414322,356375
5,ENSG00000246859.2,111512226,chr5-111323014-C-G,rs79904063,1,C,G,111323014,189212,111315618,111708834,7396
5,ENSG00000225138.2,473236,chr5-476854-C-T,rs890978,1,C,T,476854,3618,276628,669844,200226
5,ENSG00000260686.1,122832356,chr5-122753195-A-G,rs922140,1,A,G,122753195,79161,122635748,123028964,117447
5,ENSG00000248684.1,75910565,chr5-76017896-A-G,rs9293663,1,A,G,76017896,107331,75713957,76107173,303939
5,ENSG00000253686.1,173746209,chr5-173722667-C-T,rs10039804,-1,C,T,173722667,23542,173549601,173942817,173066
5,ENSG00000221990.2,443160,chr5-423583-G-A,rs10064055,-1,G,A,423583,19577,246552,639768,177031
5,ENSG00000231185.2,142404201,chr5-142514992-A-C,rs10477182,1,A,C,142514992,110791,142207593,142600809,307399
5,ENSG00000241956.5,164296978,chr5-164316178-A-G,rs10515872,1,A,G,164316178,19200,164100370,164493586,215808
5,ENSG00000260871.1,90389363,chr5-90511578-T-C,rs10942597,-1,T,C,90511578,122215,90192755,90585971,318823
5,ENSG00000249494.1,119070902,chr5-119263304-C-T,rs116055231,-1,C,T,119263304,192402,118874294,119267510,389010
5,ENSG00000251279.1,61162070,chr5-61015093-C-T,rs116202687,1,C,T,61015093,146977,60965462,61358678,49631
5,ENSG00000254298.1,151158462,chr5-151349717-A-G,rs11737981,-1,A,G,151349717,191255,150961854,151355070,387863
5,ENSG00000235172.3,170307722,chr5-170383792-C-T,rs11739136,1,C,T,170383792,76070,170111114,170504330,272678
5,ENSG00000188002.6,1633984,chr5-1556230-T-C,rs11742758,-1,T,C,1556230,77754,1437376,1830592,118854
5,ENSG00000214857.4,81892490,chr5-81815863-A-G,rs11949897,1,A,G,81815863,76627,81695882,82089098,119981
5,ENSG00000214857.4,81892490,chr5-81815863-A-C,rs11949897,1,A,C,81815863,76627,81695882,82089098,119981
5,ENSG00000249684.1,177951413,chr5-177973247-C-A,rs11957941,1,C,A,177973247,21834,177754805,178148021,218442
5,ENSG00000249684.1,177951413,chr5-177973247-C-G,rs11957941,1,C,G,177973247,21834,177754805,178148021,218442
5,ENSG00000251107.1,76280956,chr5-76392435-A-G,rs11959381,1,A,G,76392435,111479,76084348,76477564,308087
5,ENSG00000250602.1,126509021,chr5-126362265-A-G,rs12188618,-1,A,G,126362265,146756,126312413,126705629,49852
5,ENSG00000251221.1,80622524,chr5-80619201-G-A,rs1232027,-1,G,A,80619201,3323,80425916,80819132,193285
5,ENSG00000253520.1,179527513,chr5-179683849-T-C,rs12518476,-1,T,C,179683849,156336,179330905,179724121,352944
5,ENSG00000212643.1,112891610,chr5-112708673-T-G,rs13169017,1,T,G,112708673,182937,112695002,113088218,13671
5,ENSG00000247877.2,100535234,chr5-100635457-T-C,rs13182963,-1,T,C,100635457,100223,100338626,100731842,296831
5,ENSG00000249825.1,80082404,chr5-80069262-A-G,rs1465853,-1,A,G,80069262,13142,79885796,80279012,183466
5,ENSG00000250564.1,134460615,chr5-134501370-T-G,rs1476097,-1,T,G,134501370,40755,134264007,134657223,237363
5,ENSG00000250155.1,36725173,chr5-36884064-A-G,rs151946,-1,A,G,36884064,158891,36528565,36921781,355499
5,ENSG00000254252.1,166029311,chr5-165890692-G-T,rs153261,-1,G,T,165890692,138619,165832703,166225919,57989
5,ENSG00000229119.3,166382305,chr5-166320200-A-G,rs1540718,1,A,G,166320200,62105,166185697,166578913,134503
5,ENSG00000248668.1,41869927,chr5-42008897-G-T,rs156700,1,G,T,42008897,138970,41673319,42066535,335578
5,ENSG00000246214.1,16616158,chr5-16681953-C-T,rs16868979,1,C,T,16681953,65795,16419550,16812766,262403
5,ENSG00000247516.2,8457706,chr5-8403341-C-A,rs16880515,1,C,A,8403341,54365,8261098,8654314,142243
5,ENSG00000248925.1,271516,chr5-190978-C-T,rs16900760,-1,C,T,190978,80538,74908,468124,116070
5,ENSG00000250346.1,147922179,chr5-147823470-G-A,rs17107298,1,G,A,147823470,98709,147725571,148118787,97899
5,ENSG00000250526.1,14641018,chr5-14780189-C-T,rs17317655,-1,C,T,14780189,139171,14444410,14837626,335779
5,ENSG00000215006.4,69333929,chr5-69219666-A-G,rs17331590,1,A,G,69219666,114263,69137321,69530537,82345
5,ENSG00000245526.2,88684808,chr5-88563765-G-A,rs17422122,-1,G,A,88563765,121043,88488200,88881416,75565
5,ENSG00000249959.1,107716841,chr5-107887896-A-G,rs17436077,-1,A,G,107887896,171055,107520233,107913449,367663
5,ENSG00000214784.4,111193042,chr5-111157916-A-G,rs17459022,-1,A,G,111157916,35126,110996434,111389650,161482
5,ENSG00000249119.1,134924123,chr5-134889198-A-G,rs17644351,1,A,G,134889198,34925,134727515,135120731,161683
5,ENSG00000254211.1,173807791,chr5-173793062-A-G,rs2042245,-1,A,G,173793062,14729,173611183,174004399,181879
5,ENSG00000245317.2,179859013,chr5-179950085-T-C,rs248328,1,T,C,179950085,91072,179662405,180055621,287680
5,ENSG00000253144.1,179083194,chr5-179187692-G-A,rs252070,-1,G,A,179187692,104498,178886586,179279802,301106
5,ENSG00000251467.1,72996920,chr5-72961353-G-T,rs2548331,1,G,T,72961353,35567,72800312,73193528,161041
5,ENSG00000249101.1,98025965,chr5-97997738-A-C,rs257239,1,A,C,97997738,28227,97829357,98222573,168381
5,ENSG00000253558.1,78044136,chr5-77956111-A-T,rs2637076,-1,A,T,77956111,88025,77847528,78240744,108583
5,ENSG00000248794.1,81242599,chr5-81068721-C-T,rs26905,-1,C,T,81068721,173878,81045991,81439207,22730
5,ENSG00000233937.2,181246523,chr5-181162644-C-T,rs2770973,1,C,T,181162644,83879,181049915,181443131,112729
5,ENSG00000250786.1,9546193,chr5-9658549-T-C,rs27841,1,T,C,9658549,112356,9349585,9742801,308964
5,ENSG00000215068.3,43041579,chr5-43037924-G-A,rs316398,1,G,A,43037924,3655,42844971,43238187,192953
5,ENSG00000247679.2,177611240,chr5-177513383-G-A,rs335438,1,G,A,177513383,97857,177414632,177807848,98751
5,ENSG00000250444.1,115512077,chr5-115573732-T-A,rs35215745,1,T,A,115573732,61655,115315469,115708685,258263
5,ENSG00000247828.2,88268883,chr5-88193453-G-A,rs357507,1,G,A,88193453,75430,88072275,88465491,121178
5,ENSG00000227908.3,55995167,chr5-55969461-A-G,rs3729959,1,A,G,55969461,25706,55798559,56191775,170902
5,ENSG00000253146.1,154560440,chr5-154416924-G-A,rs3734085,-1,G,A,154416924,143516,154363832,154757048,53092
5,ENSG00000249572.1,33440619,chr5-33458728-T-C,rs3765146,-1,T,C,33458728,18109,33244011,33637227,214717
5,ENSG00000251675.1,80128361,chr5-80119763-G-C,rs390292,1,G,C,80119763,8598,79931753,80324969,188010
5,ENSG00000243806.1,94826694,chr5-94933002-A-T,rs39624,-1,A,T,94933002,106308,94630086,95023302,302916
5,ENSG00000226432.3,24170370,chr5-24251970-G-A,rs4455522,1,G,A,24251970,81600,23973762,24366978,278208
5,ENSG00000260686.1,122832356,chr5-123022018-G-A,rs448442,1,G,A,123022018,189662,122635748,123028964,386270
5,ENSG00000223908.3,160024045,chr5-160206477-A-G,rs4568401,-1,A,G,160206477,182432,159827437,160220653,379040
5,ENSG00000248885.1,119128444,chr5-119305401-A-G,rs4895365,-1,A,G,119305401,176957,118931836,119325052,373565
5,ENSG00000214108.4,31908361,chr5-31759010-C-T,rs498791,1,C,T,31759010,149351,31711753,32104969,47257
5,ENSG00000250492.1,39721513,chr5-39869163-C-T,rs537289,-1,C,T,39869163,147650,39524905,39918121,344258
5,ENSG00000214278.4,404546,chr5-395354-T-G,rs61605057,-1,T,G,395354,9192,207938,601154,187416
5,ENSG00000170089.8,177875595,chr5-177841478-G-A,rs68047133,1,G,A,177841478,34117,177678987,178072203,162491
5,ENSG00000248493.1,145997218,chr5-145920472-T-C,rs6865660,1,T,C,145920472,76746,145800610,146193826,119862
5,ENSG00000225138.2,473236,chr5-495262-C-T,rs6868535,1,C,T,495262,22026,276628,669844,218634
5,ENSG00000241907.1,150021921,chr5-149871976-C-T,rs6886532,-1,C,T,149871976,149945,149825313,150218529,46663
5,ENSG00000247572.2,81301472,chr5-81214117-C-T,rs6893150,-1,C,T,81214117,87355,81104864,81498080,109253
5,ENSG00000213630.3,126663568,chr5-126498486-A-T,rs6896404,-1,A,T,126498486,165082,126466960,126860176,31526
5,ENSG00000250615.1,77073881,chr5-77078040-T-C,rs6897542,1,T,C,77078040,4159,76877273,77270489,200767
5,ENSG00000238160.1,132426714,chr5-132407773-T-C,rs6897597,-1,T,C,132407773,18941,132230106,132623322,177667
5,ENSG00000249637.1,140401460,chr5-140574338-C-T,rs702401,-1,C,T,140574338,172878,140204852,140598068,369486
5,ENSG00000177738.3,43067452,chr5-43161249-G-A,rs71627581,-1,G,A,43161249,93797,42870844,43264060,290405
5,ENSG00000204677.6,178008573,chr5-177961006-C-T,rs73339896,1,C,T,177961006,47567,177811965,178205181,149041
5,ENSG00000251273.1,25190690,chr5-25302572-C-A,rs73744856,-1,C,A,25302572,111882,24994082,25387298,308490
5,ENSG00000250909.1,176347941,chr5-176378685-G-A,rs74292755,1,G,A,176378685,30744,176151333,176544549,227352
5,ENSG00000253955.1,173579643,chr5-173584350-T-C,rs746215,1,T,C,173584350,4707,173383035,173776251,201315
5,ENSG00000251023.1,93863825,chr5-93754759-A-G,rs75352984,-1,A,G,93754759,109066,93667217,94060433,87542
5,ENSG00000248477.2,69618313,chr5-69473733-A-G,rs76915606,1,A,G,69473733,144580,69421705,69814921,52028
5,ENSG00000213661.3,121616247,chr5-121622994-T-C,rs7700795,1,T,C,121622994,6747,121419639,121812855,203355
5,ENSG00000248449.1,141426286,chr5-141342559-A-G,rs7701092,1,A,G,141342559,83727,141229678,141622894,112881
5,ENSG00000250900.2,181198200,chr5-181184340-A-G,rs7713229,1,A,G,181184340,13860,181001592,181394808,182748
5,ENSG00000249215.1,139494256,chr5-139416714-G-A,rs78502259,1,G,A,139416714,77542,139297648,139690864,119066
5,ENSG00000245556.2,78360414,chr5-78505536-A-G,rs876605,-1,A,G,78505536,145122,78163806,78557022,341730
5,ENSG00000249947.2,112885094,chr5-112718850-A-T,rs9326862,1,A,T,112718850,166244,112688486,113081702,30364
5,ENSG00000254132.1,94569470,chr5-94462775-T-C,rs952664,-1,T,C,94462775,106695,94372862,94766078,89913
4,ENSG00000236941.3,164948079,chr4-164928702-C-A,rs10005938,1,C,A,164928702,19377,164751471,165144687,177231
4,ENSG00000245958.2,119457968,chr4-119487776-T-G,rs10006525,1,T,G,119487776,29808,119261360,119654576,226416
4,ENSG00000250896.1,11371975,chr4-11434817-T-A,rs10012344,1,T,A,11434817,62842,11175367,11568583,259450
4,ENSG00000121089.4,164943290,chr4-164846476-G-C,rs10014767,1,G,C,164846476,96814,164746682,165139898,99794
4,ENSG00000250412.1,119334329,chr4-119470477-C-T,rs10032158,1,C,T,119470477,136148,119137721,119530937,332756
4,ENSG00000249685.1,39133913,chr4-39126127-G-A,rs1046655,1,G,A,39126127,7786,38937305,39330521,188822
4,ENSG00000245213.2,173169104,chr4-173192938-C-T,rs10520255,-1,C,T,173192938,23834,172972496,173365712,220442
4,ENSG00000251580.1,6673896,chr4-6670787-G-A,rs1054909,-1,G,A,6670787,3109,6477288,6870504,193499
4,ENSG00000250220.1,73259209,chr4-73138833-T-C,rs112050195,1,T,C,73138833,120376,73062601,73455817,76232
4,ENSG00000242882.1,173420137,chr4-173576276-G-A,rs115738174,-1,G,A,173576276,156139,173223529,173616745,352747
4,ENSG00000248401.1,83247179,chr4-83221735-G-A,rs11727365,1,G,A,83221735,25444,83050571,83443787,171164
4,ENSG00000249844.1,4175238,chr4-4361027-C-A,rs11728835,-1,C,A,4361027,185789,3978630,4371846,382397
4,ENSG00000248880.1,188389666,chr4-188326619-G-A,rs11930915,-1,G,A,188326619,63047,188193058,188586274,133561
4,ENSG00000248880.1,188389666,chr4-188326619-G-T,rs11930915,-1,G,T,188326619,63047,188193058,188586274,133561
4,ENSG00000248122.1,68304939,chr4-68267260-G-A,rs11933242,-1,G,A,68267260,37679,68108331,68501547,158929
4,ENSG00000180712.3,184353971,chr4-184353346-C-T,rs11946139,-1,C,T,184353346,625,184157363,184550579,195983
4,ENSG00000170846.11,6674075,chr4-6671825-G-A,rs11946525,1,G,A,6671825,2250,6477467,6870683,194358
4,ENSG00000248155.1,2608146,chr4-2434530-G-A,rs1203766,-1,G,A,2434530,173616,2411538,2804754,22992
4,ENSG00000241877.1,178286695,chr4-178414155-C-T,rs12498491,1,C,T,178414155,127460,178090087,178483303,324068
4,ENSG00000236296.2,143559487,chr4-143521099-A-G,rs12500603,1,A,G,143521099,38388,143362879,143756095,158220
4,ENSG00000227765.3,184299640,chr4-184313352-G-T,rs12506922,-1,G,T,184313352,13712,184103032,184496248,210320
4,ENSG00000250050.1,25719745,chr4-25876874-G-A,rs13104150,-1,G,A,25876874,157129,25523137,25916353,353737
4,ENSG00000248283.1,42562425,chr4-42563717-A-G,rs13135410,-1,A,G,42563717,1292,42365817,42759033,197900
4,ENSG00000245954.2,152090459,chr4-152101223-G-A,rs13140099,1,G,A,152101223,10764,151893851,152287067,207372
4,ENSG00000259959.1,47844339,chr4-47843903-A-G,rs1440221,-1,A,G,47843903,436,47647731,48040947,196172
4,ENSG00000183199.6,87891843,chr4-87891867-G-A,rs144232232,1,G,A,87891867,24,87695235,88088451,196632
4,ENSG00000183199.6,87891843,chr4-87891867-G-C,rs144232232,1,G,C,87891867,24,87695235,88088451,196632
4,ENSG00000249013.1,156006478,chr4-155862232-C-T,rs1514010,1,C,T,155862232,144246,155809870,156203086,52362
4,ENSG00000249673.1,2937266,chr4-2923849-G-A,rs16843596,1,G,A,2923849,13417,2740658,3133874,183191
4,ENSG00000249673.1,2937266,chr4-2923849-G-T,rs16843596,1,G,T,2923849,13417,2740658,3133874,183191
4,ENSG00000248254.1,47560259,chr4-47576954-G-A,rs16851681,-1,G,A,47576954,16695,47363651,47756867,213303
4,ENSG00000248180.1,87207092,chr4-87082963-C-A,rs17012394,1,C,A,87082963,124129,87010484,87403700,72479
4,ENSG00000246375.2,88284883,chr4-88282045-T-C,rs17013978,1,T,C,88282045,2838,88088275,88481491,193770
4,ENSG00000251254.1,147506091,chr4-147359722-T-G,rs17023122,1,T,G,147359722,146369,147309483,147702699,50239
4,ENSG00000247950.2,109433814,chr4-109526007-T-C,rs17040505,-1,T,C,109526007,92193,109237206,109630422,288801
4,ENSG00000260296.1,40166675,chr4-40098964-T-C,rs1704153,1,T,C,40098964,67711,39970067,40363283,128897
4,ENSG00000231707.3,39973444,chr4-40055669-C-T,rs1704157,1,C,T,40055669,82225,39776836,40170052,278833
4,ENSG00000250486.1,164956948,chr4-164865755-G-A,rs17045648,1,G,A,164865755,91193,164760340,165153556,105415
4,ENSG00000249096.1,184382416,chr4-184366416-A-G,rs17624018,-1,A,G,184366416,16000,184185808,184579024,180608
4,ENSG00000236764.3,96902801,chr4-96842407-T-G,rs2014646,1,T,G,96842407,60394,96706193,97099409,136214
4,ENSG00000223305.1,55540835,chr4-55407965-G-A,rs2048564,-1,G,A,55407965,132870,55344227,55737443,63738
4,ENSG00000243280.2,112171215,chr4-112356901-C-T,rs2074378,1,C,T,112356901,185686,111974607,112367823,382294
4,ENSG00000248394.1,128155389,chr4-128026720-G-A,rs2169270,1,G,A,128026720,128669,127958781,128351997,67939
4,ENSG00000246560.2,102827611,chr4-102864700-T-C,rs223339,1,T,C,102864700,37089,102631003,103024219,233697
4,ENSG00000251288.1,102751401,chr4-102686096-C-G,rs227283,1,C,G,102686096,65305,102554793,102948009,131303
4,ENSG00000249341.1,53659208,chr4-53693571-C-T,rs2590783,1,C,T,53693571,34363,53462600,53855816,230971
4,ENSG00000178458.4,139698554,chr4-139716717-C-A,rs2646062,-1,C,A,139716717,18163,139501946,139895162,214771
4,ENSG00000213448.3,137448087,chr4-137453783-T-C,rs28560376,1,T,C,137453783,5696,137251479,137644695,202304
4,ENSG00000198155.5,218650,chr4-207285-T-C,rs28716466,1,T,C,207285,11365,22042,415258,185243
4,ENSG00000251615.1,8358338,chr4-8356009-A-C,rs34893440,-1,A,C,8356009,2329,8161730,8554946,194279
4,ENSG00000251555.1,131975952,chr4-131917527-T-C,rs349871,-1,T,C,131917527,58425,131779344,132172560,138183
4,ENSG00000249334.1,10685003,chr4-10689294-C-G,rs35755918,1,C,G,10689294,4291,10488395,10881611,200899
4,ENSG00000187653.10,90839037,chr4-91016821-A-G,rs41338244,-1,A,G,91016821,177784,90642429,91035645,374392
4,ENSG00000250568.1,39973442,chr4-39818943-G-A,rs421631,-1,G,A,39818943,154499,39776834,40170050,42109
4,ENSG00000244004.1,9563171,chr4-9450197-T-C,rs4246697,1,T,C,9450197,112974,9366563,9759779,83634
4,ENSG00000249241.1,40316484,chr4-40353109-C-T,rs4264869,1,C,T,40353109,36625,40119876,40513092,233233
4,ENSG00000250326.1,143184861,chr4-143148408-G-T,rs4337690,-1,G,T,143148408,36453,142988253,143381469,160155
4,ENSG00000254531.1,101347752,chr4-101416549-T-C,rs4452435,1,T,C,101416549,68797,101151144,101544360,265405
4,ENSG00000240005.1,26860650,chr4-26858791-G-A,rs4505809,-1,G,A,26858791,1859,26664042,27057258,194749
4,ENSG00000229894.2,165279704,chr4-165375112-C-A,rs4691187,-1,C,A,165375112,95408,165083096,165476312,292016
4,ENSG00000240669.1,152614333,chr4-152597821-A-G,rs4696137,-1,A,G,152597821,16512,152417725,152810941,180096
4,ENSG00000248049.2,67701279,chr4-67614807-C-T,rs4860262,1,C,T,67614807,86472,67504671,67897887,110136
4,ENSG00000249212.1,42029209,chr4-42139371-C-T,rs4861164,1,C,T,42139371,110162,41832601,42225817,306770
4,ENSG00000213331.4,187970273,chr4-188109782-C-T,rs4862863,1,C,T,188109782,139509,187773665,188166881,336117
4,ENSG00000250980.1,152796831,chr4-152953514-G-A,rs61753649,-1,G,A,152953514,156683,152600223,152993439,353291
4,ENSG00000249006.1,2090617,chr4-2179881-C-T,rs617914,-1,C,T,2179881,89264,1894009,2287225,285872
4,ENSG00000250566.1,68517647,chr4-68500812-G-A,rs62299466,-1,G,A,68500812,16835,68321039,68714255,179773
4,ENSG00000247193.2,36244116,chr4-36127865-G-T,rs6531412,1,G,T,36127865,116251,36047508,36440724,80357
4,ENSG00000249863.1,37868292,chr4-37880546-T-G,rs6531592,1,T,G,37880546,12254,37671684,38064900,208862
4,ENSG00000241002.1,112738672,chr4-112696538-A-G,rs6533636,1,A,G,112696538,42134,112542064,112935280,154474
4,ENSG00000249741.1,143912053,chr4-143957754-G-A,rs6537214,-1,G,A,143957754,45701,143715445,144108661,242309
4,ENSG00000260526.1,112231596,chr4-112410634-G-T,rs6812485,-1,G,T,112410634,179038,112034988,112428204,375646
4,ENSG00000248785.1,109673843,chr4-109525298-A-G,rs6812906,1,A,G,109525298,148545,109477235,109870451,48063
4,ENSG00000249896.1,6227614,chr4-6210128-T-A,rs6816740,1,T,A,6210128,17486,6031006,6424222,179122
4,ENSG00000249592.1,781849,chr4-777799-A-G,rs6819857,-1,A,G,777799,4050,585241,978457,192558
4,ENSG00000245685.2,189940733,chr4-189942587-T-A,rs6820684,-1,T,A,189942587,1854,189744125,190137341,198462
4,ENSG00000249960.1,82571137,chr4-82656045-G-A,rs6823569,1,G,A,82656045,84908,82374529,82767745,281516
4,ENSG00000249509.1,112515431,chr4-112622996-T-C,rs6834538,1,T,C,112622996,107565,112318823,112712039,304173
4,ENSG00000251230.1,184855751,chr4-184852578-T-C,rs6835696,-1,T,C,184852578,3173,184659143,185052359,193435
4,ENSG00000250656.1,67717388,chr4-67649336-A-G,rs6840867,-1,A,G,67649336,68052,67520780,67913996,128556
4,ENSG00000227118.3,98740742,chr4-98577529-T-C,rs6844261,1,T,C,98577529,163213,98544134,98937350,33395
4,ENSG00000213434.2,183483490,chr4-183391966-T-C,rs72705526,1,T,C,183391966,91524,183286882,183680098,105084
4,ENSG00000250471.1,8174421,chr4-8272607-T-C,rs73081575,1,T,C,8272607,98186,7977813,8371029,294794
4,ENSG00000248780.1,40786110,chr4-40960938-G-A,rs73244030,1,G,A,40960938,174828,40589502,40982718,371436
4,ENSG00000250227.1,164915565,chr4-164977530-C-T,rs74651789,1,C,T,164977530,61965,164718957,165112173,258573
4,ENSG00000251095.1,89410960,chr4-89574494-A-G,rs74903671,1,A,G,89574494,163534,89214352,89607568,360142
4,ENSG00000232327.3,80388716,chr4-80263515-A-T,rs7659152,-1,A,T,80263515,125201,80192108,80585324,71407
4,ENSG00000213480.3,121370345,chr4-121275875-T-G,rs7661816,-1,T,G,121275875,94470,121173737,121566953,102138
4,ENSG00000248645.1,164939990,chr4-164931619-A-G,rs7663683,-1,A,G,164931619,8371,164743382,165136598,188237
4,ENSG00000248429.1,158170752,chr4-158048530-C-A,rs7664129,1,C,A,158048530,122222,157974144,158367360,74386
4,ENSG00000226950.2,52712501,chr4-52691511-C-A,rs7674000,1,C,A,52691511,20990,52515893,52909109,175618
4,ENSG00000180015.11,188738373,chr4-188619218-A-G,rs7675682,1,A,G,188619218,119155,188541765,188934981,77453
4,ENSG00000250131.1,177442519,chr4-177443649-T-C,rs7682705,1,T,C,177443649,1130,177245911,177639127,197738
4,ENSG00000251297.1,189984871,chr4-190000554-G-A,rs7686607,-1,G,A,190000554,15683,189788263,190181479,212291
4,ENSG00000249381.1,138425523,chr4-138347353-T-C,rs7687008,1,T,C,138347353,78170,138228915,138622131,118438
4,ENSG00000260303.1,146056762,chr4-146015695-A-T,rs7688003,-1,A,T,146015695,41067,145860154,146253370,155541
4,ENSG00000250902.1,145517118,chr4-145514998-A-C,rs7694086,-1,A,C,145514998,2120,145320510,145713726,194488
4,ENSG00000250892.1,205009,chr4-118051-T-C,rs77068144,-1,T,C,118051,86958,8401,401617,109650
4,ENSG00000248256.1,48860203,chr4-49027406-G-A,rs77730715,-1,G,A,49027406,167203,48663595,49056811,363811
4,ENSG00000166530.6,110252099,chr4-110370469-C-A,rs77862673,-1,C,A,110370469,118370,110055491,110448707,314978
4,ENSG00000250666.1,189881515,chr4-189947241-A-G,rs79403633,1,A,G,189947241,65726,189684907,190078123,262334
4,ENSG00000244459.2,1580527,chr4-1683484-T-C,rs798726,-1,T,C,1683484,102957,1383919,1777135,299565
4,ENSG00000251595.3,427882,chr4-498340-G-A,rs9994908,-1,G,A,498340,70458,231274,624490,267066
4,ENSG00000196656.6,113214393,chr4-113409459-G-A,rs10008952,-1,G,A,113409459,195066,113017785,113411001,391674
4,ENSG00000196656.6,113214393,chr4-113409459-G-T,rs10008952,-1,G,T,113409459,195066,113017785,113411001,391674
4,ENSG00000250910.1,155173716,chr4-155165316-G-A,rs10016444,1,G,A,155165316,8400,154977108,155370324,188208
4,ENSG00000178458.4,139698554,chr4-139621273-G-A,rs10027416,-1,G,A,139621273,77281,139501946,139895162,119327
4,ENSG00000231707.3,39973444,chr4-40108717-A-G,rs10033188,1,A,G,40108717,135273,39776836,40170052,331881
4,ENSG00000248019.2,88709789,chr4-88876487-G-A,rs10516823,1,G,A,88876487,166698,88513181,88906397,363306
4,ENSG00000249096.1,184382416,chr4-184382377-T-G,rs1105754,-1,T,G,184382377,39,184185808,184579024,196569
4,ENSG00000249096.1,184382416,chr4-184382377-T-A,rs1105754,-1,T,A,184382377,39,184185808,184579024,196569
4,ENSG00000249700.1,55395842,chr4-55391465-G-C,rs113058073,-1,G,C,55391465,4377,55199234,55592450,192231
4,ENSG00000196810.3,1249451,chr4-1388010-A-G,rs1137789,1,A,G,1388010,138559,1052843,1446059,335167
4,ENSG00000248890.1,144661357,chr4-144671207-T-C,rs114579528,-1,T,C,144671207,9850,144464749,144857965,206458
4,ENSG00000250075.1,67468251,chr4-67462403-T-C,rs116024466,-1,T,C,67462403,5848,67271643,67664859,190760
4,ENSG00000251432.2,128292933,chr4-128307507-T-C,rs11725346,1,T,C,128307507,14574,128096325,128489541,211182
4,ENSG00000253917.2,3955419,chr4-3789923-C-T,rs11733817,-1,C,T,3789923,165496,3758811,4152027,31112
4,ENSG00000244004.1,9563171,chr4-9509675-G-A,rs11737509,1,G,A,9509675,53496,9366563,9759779,143112
4,ENSG00000249381.1,138425523,chr4-138257740-T-C,rs11737641,1,T,C,138257740,167783,138228915,138622131,28825
4,ENSG00000250893.1,40426119,chr4-40522715-A-G,rs11930154,1,A,G,40522715,96596,40229511,40622727,293204
4,ENSG00000251580.1,6673896,chr4-6669654-C-T,rs11941814,-1,C,T,6669654,4242,6477288,6870504,192366
4,ENSG00000248283.1,42562425,chr4-42572356-G-A,rs12502828,-1,G,A,42572356,9931,42365817,42759033,206539
4,ENSG00000250327.1,186157896,chr4-186342557-A-T,rs12645838,1,A,T,186342557,184661,185961288,186354504,381269
4,ENSG00000186234.7,9692495,chr4-9746777-G-A,rs12648189,1,G,A,9746777,54282,9495887,9889103,250890
4,ENSG00000248590.2,56593004,chr4-56647746-C-T,rs12649154,1,C,T,56647746,54742,56396396,56789612,251350
4,ENSG00000248590.2,56593004,chr4-56647746-C-A,rs12649154,1,C,A,56647746,54742,56396396,56789612,251350
4,ENSG00000249920.1,73939558,chr4-74075048-G-A,rs12649753,-1,G,A,74075048,135490,73742950,74136166,332098
4,ENSG00000245958.2,119457968,chr4-119503425-T-G,rs13107334,1,T,G,119503425,45457,119261360,119654576,242065
4,ENSG00000251615.1,8358338,chr4-8501554-A-G,rs13111630,-1,A,G,8501554,143216,8161730,8554946,339824
4,ENSG00000180712.3,184353971,chr4-184363043-C-T,rs13119830,-1,C,T,184363043,9072,184157363,184550579,205680
4,ENSG00000205959.3,8482270,chr4-8389132-G-A,rs13136987,1,G,A,8389132,93138,8285662,8678878,103470
4,ENSG00000173966.7,53575713,chr4-53465539-A-G,rs13435672,1,A,G,53465539,110174,53379105,53772321,86434
4,ENSG00000234568.3,82275071,chr4-82183646-T-A,rs1353017,1,T,A,82183646,91425,82078463,82471679,105183
4,ENSG00000254531.1,101347752,chr4-101344239-T-C,rs1372244,1,T,C,101344239,3513,101151144,101544360,193095
4,ENSG00000250412.1,119334329,chr4-119309995-G-A,rs1397607,1,G,A,119309995,24334,119137721,119530937,172274
4,ENSG00000248049.2,67701279,chr4-67614500-T-C,rs1548119,1,T,C,67614500,86779,67504671,67897887,109829
4,ENSG00000248924.1,143555402,chr4-143634165-A-G,rs1553067,-1,A,G,143634165,78763,143358794,143752010,275371
4,ENSG00000247708.2,4542143,chr4-4568278-A-G,rs16835906,1,A,G,4568278,26135,4345535,4738751,222743
4,ENSG00000249072.1,78008688,chr4-77997421-A-T,rs17002860,-1,A,T,77997421,11267,77812080,78205296,185341
4,ENSG00000251600.1,143559457,chr4-143546652-C-T,rs17017869,1,C,T,143546652,12805,143362849,143756065,183803
4,ENSG00000249245.1,145626035,chr4-145483500-A-G,rs17020200,-1,A,G,145483500,142535,145429427,145822643,54073
4,ENSG00000225094.2,109554094,chr4-109611674-T-G,rs17040615,-1,T,G,109611674,57580,109357486,109750702,254188
4,ENSG00000260296.1,40166675,chr4-40055669-C-T,rs1704157,1,C,T,40055669,111006,39970067,40363283,85602
4,ENSG00000249311.2,136356336,chr4-136478891-T-G,rs17048694,-1,T,G,136478891,122555,136159728,136552944,319163
4,ENSG00000245322.2,100008071,chr4-100162025-C-T,rs17092,1,C,T,100162025,153954,99811463,100204679,350562
4,ENSG00000250568.1,39973442,chr4-39903362-A-G,rs17585757,-1,A,G,39903362,70080,39776834,40170050,126528
4,ENSG00000249592.1,781849,chr4-752774-T-C,rs17721913,-1,T,C,752774,29075,585241,978457,167533
4,ENSG00000249509.1,112515431,chr4-112431241-G-A,rs2074388,1,G,A,112431241,84190,112318823,112712039,112418
4,ENSG00000248971.1,102730171,chr4-102714026-T-C,rs223504,-1,T,C,102714026,16145,102533563,102926779,180463
4,ENSG00000251229.1,2506279,chr4-2510327-A-G,rs2282765,-1,A,G,2510327,4048,2309671,2702887,200656
4,ENSG00000170846.11,6674075,chr4-6668588-C-T,rs2285864,1,C,T,6668588,5487,6477467,6870683,191121
4,ENSG00000243894.1,4077491,chr4-4169516-T-C,rs2368853,-1,T,C,4169516,92025,3880883,4274099,288633
4,ENSG00000249685.1,39133913,chr4-39312209-T-C,rs2381375,1,T,C,39312209,178296,38937305,39330521,374904
4,ENSG00000234492.3,108620413,chr4-108715192-C-T,rs2575625,-1,C,T,108715192,94779,108423805,108817021,291387
4,ENSG00000250666.1,189881515,chr4-189808297-C-T,rs2739548,1,C,T,189808297,73218,189684907,190078123,123390
4,ENSG00000250131.1,177442519,chr4-177392391-C-T,rs28438487,1,C,T,177392391,50128,177245911,177639127,146480
4,ENSG00000251596.1,165406350,chr4-165269625-A-C,rs28853353,-1,A,C,165269625,136725,165209742,165602958,59883
4,ENSG00000248305.1,138482096,chr4-138341993-A-G,rs298468,-1,A,G,138341993,140103,138285488,138678704,56505
4,ENSG00000260519.1,42657496,chr4-42659954-C-A,rs34460227,1,C,A,42659954,2458,42460888,42854104,199066
4,ENSG00000248375.1,52720831,chr4-52588572-A-C,rs346005,-1,A,C,52588572,132259,52524223,52917439,64349
4,ENSG00000236562.3,66094142,chr4-66233695-G-A,rs35289226,1,G,A,66233695,139553,65897534,66290750,336161
4,ENSG00000250656.1,67717388,chr4-67604804-T-C,rs354883,-1,T,C,67604804,112584,67520780,67913996,84024
4,ENSG00000237170.3,4507078,chr4-4377748-G-A,rs36075145,1,G,A,4377748,129330,4310470,4703686,67278
4,ENSG00000245213.2,173169104,chr4-172998165-G-C,rs4235217,-1,G,C,172998165,170939,172972496,173365712,25669
4,ENSG00000248196.1,87166844,chr4-87239100-G-A,rs4331742,1,G,A,87239100,72256,86970236,87363452,268864
4,ENSG00000249341.1,53659208,chr4-53676034-T-G,rs4577639,1,T,G,53676034,16826,53462600,53855816,213434
4,ENSG00000180015.11,188738373,chr4-188622799-G-A,rs464466,1,G,A,188622799,115574,188541765,188934981,81034
4,ENSG00000243312.2,86870191,chr4-86849309-A-G,rs4693788,1,A,G,86849309,20882,86673583,87066799,175726
4,ENSG00000260641.1,98658894,chr4-98703582-G-T,rs55633696,1,G,T,98703582,44688,98462286,98855502,241296
4,ENSG00000243199.1,65573459,chr4-65688675-T-G,rs62299571,1,T,G,65688675,115216,65376851,65770067,311824
4,ENSG00000251555.1,131975952,chr4-131807788-C-T,rs62307074,-1,C,T,131807788,168164,131779344,132172560,28444
4,ENSG00000251555.1,131975952,chr4-131807788-C-G,rs62307074,-1,C,G,131807788,168164,131779344,132172560,28444
4,ENSG00000250902.1,145517118,chr4-145489393-G-A,rs6822700,-1,G,A,145489393,27725,145320510,145713726,168883
4,ENSG00000214980.4,84244003,chr4-84161085-C-T,rs6824813,1,C,T,84161085,82918,84047395,84440611,113690
4,ENSG00000248401.1,83247179,chr4-83192906-G-A,rs6826109,1,G,A,83192906,54273,83050571,83443787,142335
4,ENSG00000226950.2,52712501,chr4-52809167-T-C,rs6839900,1,T,C,52809167,96666,52515893,52909109,293274
4,ENSG00000249679.1,185471495,chr4-185480559-C-T,rs6846185,1,C,T,185480559,9064,185274887,185668103,205672
4,ENSG00000250144.1,135045464,chr4-135066709-C-T,rs6856823,1,C,T,135066709,21245,134848856,135242072,217853
4,ENSG00000239983.1,33968174,chr4-33921759-A-G,rs75546033,1,A,G,33921759,46415,33771566,34164782,150193
4,ENSG00000246375.2,88284883,chr4-88275669-A-G,rs7656367,1,A,G,88275669,9214,88088275,88481491,187394
4,ENSG00000260303.1,146056762,chr4-145972341-G-A,rs7657882,-1,G,A,145972341,84421,145860154,146253370,112187
4,ENSG00000248571.1,152666368,chr4-152666874-C-T,rs7670831,1,C,T,152666874,506,152469760,152862976,197114
4,ENSG00000249863.1,37868292,chr4-37783078-T-G,rs7679058,1,T,G,37783078,85214,37671684,38064900,111394
4,ENSG00000213370.3,173634371,chr4-173784891-T-C,rs7693514,-1,T,C,173784891,150520,173437763,173830979,347128
4,ENSG00000236941.3,164948079,chr4-164981898-G-A,rs7693977,1,G,A,164981898,33819,164751471,165144687,230427
4,ENSG00000250950.1,119456350,chr4-119554303-C-A,rs7694856,1,C,A,119554303,97953,119259742,119652958,294561
4,ENSG00000249896.1,6227614,chr4-6304448-C-T,rs78801088,1,C,T,6304448,76834,6031006,6424222,273442
4,ENSG00000251230.1,184855751,chr4-184827040-A-G,rs9686055,-1,A,G,184827040,28711,184659143,185052359,167897
4,ENSG00000250566.1,68517647,chr4-68476451-G-A,rs983745,-1,G,A,68476451,41196,68321039,68714255,155412
4,ENSG00000250566.1,68517647,chr4-68476451-G-C,rs983745,-1,G,C,68476451,41196,68321039,68714255,155412
4,ENSG00000242640.1,25678850,chr4-25718602-C-A,rs9992023,1,C,A,25718602,39752,25482242,25875458,236360
4,ENSG00000240005.1,26860650,chr4-26982131-C-T,rs9998009,-1,C,T,26982131,121481,26664042,27057258,318089
4,ENSG00000224097.3,39480485,chr4-39521375-A-G,rs10025178,1,A,G,39521375,40890,39283877,39677093,237498
4,ENSG00000248590.2,56593004,chr4-56639210-T-C,rs10030515,1,T,C,56639210,46206,56396396,56789612,242814
4,ENSG00000249592.1,781849,chr4-722459-T-C,rs10452329,-1,T,C,722459,59390,585241,978457,137218
4,ENSG00000246375.2,88284883,chr4-88228090-C-T,rs10516805,1,C,T,88228090,56793,88088275,88481491,139815
4,ENSG00000242670.1,54221126,chr4-54228348-C-A,rs1135534,1,C,A,54228348,7222,54024518,54417734,203830
4,ENSG00000241612.1,19813749,chr4-19623666-T-C,rs114389307,1,T,C,19623666,190083,19617141,20010357,6525
4,ENSG00000187653.10,90839037,chr4-90949829-A-G,rs115912636,-1,A,G,90949829,110792,90642429,91035645,307400
4,ENSG00000250471.1,8174421,chr4-8024449-C-T,rs11729381,1,C,T,8024449,149972,7977813,8371029,46636
4,ENSG00000251464.1,110400511,chr4-110505185-T-C,rs11731078,-1,T,C,110505185,104674,110203903,110597119,301282
4,ENSG00000242083.2,56356135,chr4-56328163-G-T,rs11733474,1,G,T,56328163,27972,56159527,56552743,168636
4,ENSG00000231707.3,39973444,chr4-40090525-T-A,rs11931647,1,T,A,40090525,117081,39776836,40170052,313689
4,ENSG00000249264.1,105484698,chr4-105467702-G-A,rs11933675,1,G,A,105467702,16996,105288090,105681306,179612
4,ENSG00000251022.1,82900960,chr4-82944332-C-T,rs11937821,-1,C,T,82944332,43372,82704352,83097568,239980
4,ENSG00000261668.1,127844040,chr4-127750022-C-T,rs11941394,-1,C,T,127750022,94018,127647432,128040648,102590
4,ENSG00000249334.1,10685003,chr4-10593163-C-T,rs12163882,1,C,T,10593163,91840,10488395,10881611,104768
4,ENSG00000251595.3,427882,chr4-236448-T-C,rs12503763,-1,T,C,236448,191434,231274,624490,5174
4,ENSG00000245213.2,173169104,chr4-173221723-A-G,rs12644699,-1,A,G,173221723,52619,172972496,173365712,249227
4,ENSG00000248019.2,88709789,chr4-88818977-G-A,rs13133548,1,G,A,88818977,109188,88513181,88906397,305796
4,ENSG00000205100.2,189472965,chr4-189301931-G-A,rs13133883,1,G,A,189301931,171034,189276357,189669573,25574
4,ENSG00000228981.3,143350117,chr4-143193260-A-G,rs13140326,-1,A,G,143193260,156857,143153509,143546725,39751
4,ENSG00000251429.1,158277758,chr4-158269138-C-T,rs1328925,1,C,T,158269138,8620,158081150,158474366,187988
4,ENSG00000249700.1,55395842,chr4-55313716-G-A,rs1399953,-1,G,A,55313716,82126,55199234,55592450,114482
4,ENSG00000213493.3,116598161,chr4-116583750-T-C,rs1425631,1,T,C,116583750,14411,116401553,116794769,182197
4,ENSG00000249717.1,74970362,chr4-75072613-C-T,rs1477587,-1,C,T,75072613,102251,74773754,75166970,298859
4,ENSG00000251442.1,78638780,chr4-78566052-T-G,rs17003351,1,T,G,78566052,72728,78442172,78835388,123880
4,ENSG00000248180.1,87207092,chr4-87061964-T-A,rs17012341,1,T,A,87061964,145128,87010484,87403700,51480
4,ENSG00000251288.1,102751401,chr4-102622692-A-G,rs17032985,1,A,G,102622692,128709,102554793,102948009,67899
4,ENSG00000250185.1,108789779,chr4-108959574-A-G,rs17039583,-1,A,G,108959574,169795,108593171,108986387,366403
4,ENSG00000250568.1,39973442,chr4-40055669-C-T,rs1704157,-1,C,T,40055669,82227,39776834,40170050,278835
4,ENSG00000250966.1,112564988,chr4-112585619-G-A,rs17044834,1,G,A,112585619,20631,112368380,112761596,217239
4,ENSG00000251095.1,89410960,chr4-89511026-C-T,rs17175612,1,C,T,89511026,100066,89214352,89607568,296674
4,ENSG00000250771.1,153678259,chr4-153668572-T-C,rs17370673,1,T,C,153668572,9687,153481651,153874867,186921
4,ENSG00000248780.1,40786110,chr4-40601038-C-T,rs17587482,1,C,T,40601038,185072,40589502,40982718,11536
4,ENSG00000251596.1,165406350,chr4-165550855-A-G,rs17587638,-1,A,G,165550855,144505,165209742,165602958,341113
4,ENSG00000248327.1,165551060,chr4-165452729-C-A,rs17687381,-1,C,A,165452729,98331,165354452,165747668,98277
4,ENSG00000236296.2,143559487,chr4-143559119-C-A,rs17690441,1,C,A,143559119,368,143362879,143756095,196240
4,ENSG00000251483.1,110945799,chr4-110773910-G-A,rs1906619,-1,G,A,110773910,171889,110749191,111142407,24719
4,ENSG00000250033.1,138089014,chr4-138098202-C-T,rs1982203,1,C,T,138098202,9188,137892406,138285622,205796
4,ENSG00000180015.11,188738373,chr4-188619529-G-A,rs2010907,1,G,A,188619529,118844,188541765,188934981,77764
4,ENSG00000249679.1,185471495,chr4-185425085-C-A,rs2028701,1,C,A,185425085,46410,185274887,185668103,150198
4,ENSG00000249381.1,138425523,chr4-138253286-G-A,rs2056003,1,G,A,138253286,172237,138228915,138622131,24371
4,ENSG00000250666.1,189881515,chr4-189821537-A-G,rs2293131,1,A,G,189821537,59978,189684907,190078123,136630
4,ENSG00000251571.1,103572089,chr4-103744581-C-A,rs233991,1,C,A,103744581,172492,103375481,103768697,369100
4,ENSG00000213448.3,137448087,chr4-137468912-G-A,rs2406756,1,G,A,137468912,20825,137251479,137644695,217433
4,ENSG00000249685.1,39133913,chr4-39051218-T-C,rs2566116,1,T,C,39051218,82695,38937305,39330521,113913
4,ENSG00000248283.1,42562425,chr4-42655406-T-C,rs2575441,-1,T,C,42655406,92981,42365817,42759033,289589
4,ENSG00000223305.1,55540835,chr4-55666449-A-G,rs2634465,-1,A,G,55666449,125614,55344227,55737443,322222
4,ENSG00000250566.1,68517647,chr4-68482946-A-G,rs2708695,-1,A,G,68482946,34701,68321039,68714255,161907
4,ENSG00000249072.1,78008688,chr4-78180702-G-A,rs2867000,-1,G,A,78180702,172014,77812080,78205296,368622
4,ENSG00000226950.2,52712501,chr4-52890833-G-A,rs2898681,1,G,A,52890833,178332,52515893,52909109,374940
4,ENSG00000248155.1,2608146,chr4-2482443-C-G,rs34514346,-1,C,G,2482443,125703,2411538,2804754,70905
4,ENSG00000249006.1,2090617,chr4-2057013-T-C,rs35300779,-1,T,C,2057013,33604,1894009,2287225,163004
4,ENSG00000249863.1,37868292,chr4-37847675-G-A,rs3775791,1,G,A,37847675,20617,37671684,38064900,175991
4,ENSG00000196810.3,1249451,chr4-1265862-A-G,rs3811733,1,A,G,1265862,16411,1052843,1446059,213019
4,ENSG00000250327.1,186157896,chr4-186257445-C-T,rs4253326,1,C,T,186257445,99549,185961288,186354504,296157
4,ENSG00000236941.3,164948079,chr4-164938799-T-C,rs4359860,1,T,C,164938799,9280,164751471,165144687,187328
4,ENSG00000248546.3,164197711,chr4-164300465-A-G,rs4404503,-1,A,G,164300465,102754,164001103,164394319,299362
4,ENSG00000250626.2,188818522,chr4-188624805-T-C,rs458862,-1,T,C,188624805,193717,188621914,189015130,2891
4,ENSG00000248254.1,47560259,chr4-47532713-G-A,rs4695243,-1,G,A,47532713,27546,47363651,47756867,169062
4,ENSG00000243417.1,152552364,chr4-152638316-T-C,rs4696332,-1,T,C,152638316,85952,152355756,152748972,282560
4,ENSG00000251087.2,9710812,chr4-9813816-C-T,rs56050634,-1,C,T,9813816,103004,9514204,9907420,299612
4,ENSG00000214988.4,82491635,chr4-82597226-T-G,rs56174237,-1,T,G,82597226,105591,82295027,82688243,302199
4,ENSG00000249341.1,53659208,chr4-53642358-T-A,rs62325512,1,T,A,53642358,16850,53462600,53855816,179758
4,ENSG00000251017.1,74086672,chr4-74012178-A-G,rs6446974,-1,A,G,74012178,74494,73890064,74283280,122114
4,ENSG00000234492.3,108620413,chr4-108686976-C-T,rs6811564,-1,C,T,108686976,66563,108423805,108817021,263171
4,ENSG00000250892.1,205009,chr4-206842-A-G,rs6826124,-1,A,G,206842,1833,8401,401617,198441
4,ENSG00000227118.3,98740742,chr4-98649934-C-T,rs6829297,1,C,T,98649934,90808,98544134,98937350,105800
4,ENSG00000240005.1,26860650,chr4-26870838-G-A,rs6833053,-1,G,A,26870838,10188,26664042,27057258,206796
4,ENSG00000250893.1,40426119,chr4-40580743-T-C,rs6853261,1,T,C,40580743,154624,40229511,40622727,351232
4,ENSG00000249896.1,6227614,chr4-6216372-T-G,rs6858345,1,T,G,6216372,11242,6031006,6424222,185366
4,ENSG00000248785.1,109673843,chr4-109566920-G-A,rs72674807,1,G,A,109566920,106923,109477235,109870451,89685
4,ENSG00000242882.1,173420137,chr4-173536816-G-C,rs72694291,-1,G,C,173536816,116679,173223529,173616745,313287
4,ENSG00000248625.1,169832653,chr4-169981123-C-T,rs72702344,1,C,T,169981123,148470,169636045,170029261,345078
4,ENSG00000196951.5,140373384,chr4-140183275-T-C,rs73857954,-1,T,C,140183275,190109,140176776,140569992,6499
4,ENSG00000251411.1,86914817,chr4-86969015-C-G,rs75259667,-1,C,G,86969015,54198,86718209,87111425,250806
4,ENSG00000248115.1,52945689,chr4-52869152-G-A,rs76418265,1,G,A,52869152,76537,52749081,53142297,120071
4,ENSG00000240669.1,152614333,chr4-152478539-T-C,rs76418725,-1,T,C,152478539,135794,152417725,152810941,60814
4,ENSG00000243280.2,112171215,chr4-111984067-G-A,rs7654718,1,G,A,111984067,187148,111974607,112367823,9460
4,ENSG00000248049.2,67701279,chr4-67773151-G-A,rs7662205,1,G,A,67773151,71872,67504671,67897887,268480
4,ENSG00000249348.1,39528019,chr4-39502649-C-T,rs7667751,1,C,T,39502649,25370,39331411,39724627,171238
4,ENSG00000251254.1,147506091,chr4-147396896-C-A,rs7671190,1,C,A,147396896,109195,147309483,147702699,87413
4,ENSG00000250325.1,82402456,chr4-82520714-G-T,rs7671872,-1,G,T,82520714,118258,82205848,82599064,314866
4,ENSG00000248697.1,112455924,chr4-112592782-T-C,rs7676983,1,T,C,112592782,136858,112259316,112652532,333466
4,ENSG00000248571.1,152666368,chr4-152560583-G-T,rs7679788,1,G,T,152560583,105785,152469760,152862976,90823
4,ENSG00000248113.1,82581384,chr4-82776007-C-A,rs7681220,-1,C,A,82776007,194623,82384776,82777992,391231
4,ENSG00000248113.1,82581384,chr4-82776007-C-T,rs7681220,-1,C,T,82776007,194623,82384776,82777992,391231
4,ENSG00000249844.1,4175238,chr4-4285597-C-T,rs7693612,-1,C,T,4285597,110359,3978630,4371846,306967
4,ENSG00000250486.1,164956948,chr4-164949083-C-G,rs7695257,1,C,G,164949083,7865,164760340,165153556,188743
4,ENSG00000249509.1,112515431,chr4-112494246-T-C,rs7699752,1,T,C,112494246,21185,112318823,112712039,175423
4,ENSG00000251230.1,184855751,chr4-184853799-G-A,rs77476975,-1,G,A,184853799,1952,184659143,185052359,194656
4,ENSG00000242358.1,16256555,chr4-16424312-A-G,rs77796768,-1,A,G,16424312,167757,16059947,16453163,364365
4,ENSG00000251615.1,8358338,chr4-8366706-G-A,rs7809,-1,G,A,8366706,8368,8161730,8554946,204976
4,ENSG00000250050.1,25719745,chr4-25911533-C-T,rs878552,-1,C,T,25911533,191788,25523137,25916353,388396
4,ENSG00000245954.2,152090459,chr4-152102831-C-T,rs890178,1,C,T,152102831,12372,151893851,152287067,208980
4,ENSG00000234036.3,76959169,chr4-76830809-C-T,rs9790694,-1,C,T,76830809,128360,76762561,77155777,68248
4,ENSG00000198155.5,218650,chr4-102685-T-C,rs9884834,1,T,C,102685,115965,22042,415258,80643
4,ENSG00000249464.1,123539451,chr4-123671981-A-G,rs9991619,1,A,G,123671981,132530,123342843,123736059,329138
4,ENSG00000251463.1,118194751,chr4-118011803-T-G,rs9997637,-1,T,G,118011803,182948,117998143,118391359,13660
3,ENSG00000229759.1,48256938,chr3-48270739-A-G,rs1045482,-1,A,G,48270739,13801,48060330,48453546,210409
3,ENSG00000240875.1,156817034,chr3-156751181-A-G,rs10513495,-1,A,G,156751181,65853,156620426,157013642,130755
3,ENSG00000256628.1,101676424,chr3-101627121-A-G,rs10936715,1,A,G,101627121,49303,101479816,101873032,147305
3,ENSG00000227440.1,172829176,chr3-172816638-C-T,rs10936738,-1,C,T,172816638,12538,172632568,173025784,184070
3,ENSG00000233544.1,24555834,chr3-24691402-C-A,rs11129160,1,C,A,24691402,135568,24359226,24752442,332176
3,ENSG00000223916.1,43485880,chr3-43616656-G-A,rs11130007,-1,G,A,43616656,130776,43289272,43682488,327384
3,ENSG00000223343.1,48989988,chr3-49082573-T-C,rs111494817,-1,T,C,49082573,92585,48793380,49186596,289193
3,ENSG00000189366.5,125990537,chr3-126107216-T-C,rs1127717,-1,T,C,126107216,116679,125793929,126187145,313287
3,ENSG00000232065.1,196632700,chr3-196563292-A-G,rs115402043,-1,A,G,196563292,69408,196436092,196829308,127200
3,ENSG00000244026.1,75435110,chr3-75462213-G-T,rs116564766,-1,G,T,75462213,27103,75238502,75631718,223711
3,ENSG00000224094.1,45160175,chr3-45268225-C-T,rs11706314,-1,C,T,45268225,108050,44963567,45356783,304658
3,ENSG00000235947.1,4751590,chr3-4765673-T-C,rs11713227,-1,T,C,4765673,14083,4554982,4948198,210691
3,ENSG00000236182.1,188990135,chr3-189143739-A-G,rs11715904,-1,A,G,189143739,153604,188793527,189186743,350212
3,ENSG00000239443.1,155309807,chr3-155410842-T-C,rs12493778,-1,T,C,155410842,101035,155113199,155506415,297643
3,ENSG00000228252.3,130212823,chr3-130135147-A-G,rs12496397,1,A,G,130135147,77676,130016215,130409431,118932
3,ENSG00000235897.1,196318350,chr3-196263951-G-A,rs12630070,1,G,A,196263951,54399,196121742,196514958,142209
3,ENSG00000241280.1,101960358,chr3-101951056-T-G,rs12630403,1,T,G,101951056,9302,101763750,102156966,187306
3,ENSG00000246082.2,131361930,chr3-131362037-C-T,rs12632774,1,C,T,131362037,107,131165322,131558538,196715
3,ENSG00000226642.1,12070195,chr3-11968241-C-T,rs13060219,1,C,T,11968241,101954,11873587,12266803,94654
3,ENSG00000176243.9,96776945,chr3-96860471-T-C,rs13070471,1,T,C,96860471,83526,96580337,96973553,280134
3,ENSG00000253540.1,130111472,chr3-130220778-C-T,rs13073206,-1,C,T,130220778,109306,129914864,130308080,305914
3,ENSG00000249786.1,15455940,chr3-15362062-G-A,rs13080491,-1,G,A,15362062,93878,15259332,15652548,102730
3,ENSG00000240137.1,150704962,chr3-150709886-T-G,rs13086215,1,T,G,150709886,4924,150508354,150901570,201532
3,ENSG00000230457.3,156810732,chr3-156627036-G-A,rs13090418,-1,G,A,156627036,183696,156614124,157007340,12912
3,ENSG00000243339.1,196399911,chr3-196239387-G-A,rs1580820,1,G,A,196239387,160524,196203303,196596519,36084
3,ENSG00000248839.1,98522570,chr3-98526788-C-T,rs1675521,1,C,T,98526788,4218,98325962,98719178,200826
3,ENSG00000242052.1,119636150,chr3-119559693-G-C,rs16829984,-1,G,C,119559693,76457,119439542,119832758,120151
3,ENSG00000182921.9,73183291,chr3-73247297-G-A,rs17010662,-1,G,A,73247297,64006,72986683,73379899,260614
3,ENSG00000224318.1,196721,chr3-244100-G-A,rs17012651,-1,G,A,244100,47379,113,393329,243987
3,ENSG00000224426.1,172604006,chr3-172528874-A-G,rs17601592,-1,A,G,172528874,75132,172407398,172800614,121476
3,ENSG00000229320.3,160567852,chr3-160394172-A-T,rs17826161,1,A,T,160394172,173680,160371244,160764460,22928
3,ENSG00000213157.3,180888075,chr3-180914186-T-G,rs1805583,-1,T,G,180914186,26111,180691467,181084683,222719
3,ENSG00000226845.1,40597494,chr3-40467766-A-G,rs185734649,-1,A,G,40467766,129728,40400886,40794102,66880
3,ENSG00000241135.1,157089918,chr3-157099873-C-T,rs2306531,1,C,T,157099873,9955,156893310,157286526,206563
3,ENSG00000231249.1,4493201,chr3-4491276-T-C,rs2307068,-1,T,C,4491276,1925,4296593,4689809,194683
3,ENSG00000223387.2,172595607,chr3-172594475-T-C,rs234049,-1,T,C,172594475,1132,172398999,172792215,195476
3,ENSG00000244380.1,48446632,chr3-48597999-G-A,rs2633958,-1,G,A,48597999,151367,48250024,48643240,347975
3,ENSG00000243795.1,113167819,chr3-113110595-G-A,rs2700201,-1,G,A,113110595,57224,112971211,113364427,139384
3,ENSG00000206573.4,9396654,chr3-9350175-G-A,rs2728936,-1,G,A,9350175,46479,9200046,9593262,150129
3,ENSG00000228242.1,14148402,chr3-14147200-C-A,rs2733533,1,C,A,14147200,1202,13951794,14345010,195406
3,ENSG00000249274.1,98782188,chr3-98962468-T-C,rs28637457,1,T,C,98962468,180280,98585580,98978796,376888
3,ENSG00000243176.1,157175269,chr3-157291124-C-T,rs2874616,1,C,T,157291124,115855,156978661,157371877,312463
3,ENSG00000231305.3,128871540,chr3-128889498-T-G,rs2929859,-1,T,G,128889498,17958,128674932,129068148,214566
3,ENSG00000261159.1,128860526,chr3-128889498-T-G,rs2929859,-1,T,G,128889498,28972,128663918,129057134,225580
3,ENSG00000241679.2,143123362,chr3-143188973-T-C,rs294466,1,T,C,143188973,65611,142926754,143319970,262219
3,ENSG00000229178.1,195657927,chr3-195588069-C-T,rs34605848,-1,C,T,195588069,69858,195461319,195854535,126750
3,ENSG00000231552.1,32621902,chr3-32426724-A-G,rs347156,-1,A,G,32426724,195178,32425294,32818510,1430
3,ENSG00000223899.1,33033863,chr3-33008095-A-T,rs35879433,1,A,T,33008095,25768,32837255,33230471,170840
3,ENSG00000231362.1,13053122,chr3-12995601-C-A,rs360835,-1,C,A,12995601,57521,12856514,13249730,139087
3,ENSG00000180385.4,9987904,chr3-9971589-A-G,rs3732968,1,A,G,9971589,16315,9791296,10184512,180293
3,ENSG00000239213.1,136862031,chr3-136928404-A-G,rs3772388,-1,A,G,136928404,66373,136665423,137058639,262981
3,ENSG00000239653.1,64004022,chr3-63988801-C-T,rs3774726,1,C,T,63988801,15221,63807414,64200630,181387
3,ENSG00000240057.1,113019468,chr3-113021298-C-T,rs3872610,1,C,T,113021298,1830,112822860,113216076,198438
3,ENSG00000241472.1,62369356,chr3-62226393-A-G,rs4072198,-1,A,G,62226393,142963,62172748,62565964,53645
3,ENSG00000243224.1,52239256,chr3-52240726-A-C,rs4082828,1,A,C,52240726,1470,52042648,52435864,198078
3,ENSG00000236062.1,12258460,chr3-12429164-G-A,rs4135361,-1,G,A,12429164,170704,12061852,12455068,367312
3,ENSG00000174912.6,156714928,chr3-156771933-C-T,rs41366145,-1,C,T,156771933,57005,156518320,156911536,253613
3,ENSG00000231443.2,195937243,chr3-195915283-G-A,rs4485751,1,G,A,195915283,21960,195740635,196133851,174648
3,ENSG00000229863.1,57134142,chr3-57152007-A-C,rs4535195,1,A,C,57152007,17865,56937534,57330750,214473
3,ENSG00000240048.1,154354799,chr3-154454441-T-C,rs4679735,-1,T,C,154454441,99642,154158191,154551407,296250
3,ENSG00000239445.1,98732757,chr3-98713715-C-T,rs4857414,-1,C,T,98713715,19042,98536149,98929365,177566
3,ENSG00000244515.1,157163932,chr3-157161331-T-G,rs5003893,-1,T,G,157161331,2601,156967324,157360540,194007
3,ENSG00000228168.1,39334979,chr3-39327476-G-A,rs59744905,1,G,A,39327476,7503,39138371,39531587,189105
3,ENSG00000240024.1,183451741,chr3-183407078-G-C,rs60347057,1,G,C,183407078,44663,183255133,183648349,151945
3,ENSG00000214301.4,133490824,chr3-133500935-G-T,rs6439416,1,G,T,133500935,10111,133294216,133687432,206719
3,ENSG00000225733.1,14948424,chr3-14939755-A-C,rs6442490,-1,A,C,14939755,8669,14751816,15145032,187939
3,ENSG00000224614.1,195908076,chr3-195870678-G-A,rs6583266,1,G,A,195870678,37398,195711468,196104684,159210
3,ENSG00000243276.1,118557668,chr3-118606867-C-G,rs6765182,-1,C,G,118606867,49199,118361060,118754276,245807
3,ENSG00000232535.1,98306752,chr3-98213209-C-T,rs6771271,1,C,T,98213209,93543,98110144,98503360,103065
3,ENSG00000243977.1,179650200,chr3-179588878-A-G,rs6784464,-1,A,G,179588878,61322,179453592,179846808,135286
3,ENSG00000224406.1,186493661,chr3-186646257-G-A,rs6785067,-1,G,A,186646257,152596,186297053,186690269,349204
3,ENSG00000213964.3,11234582,chr3-11364453-T-G,rs6785396,-1,T,G,11364453,129871,11037974,11431190,326479
3,ENSG00000241155.1,119322760,chr3-119313513-C-G,rs6786522,-1,C,G,119313513,9247,119126152,119519368,187361
3,ENSG00000223797.1,40453186,chr3-40451727-G-T,rs6801859,-1,G,T,40451727,1459,40256578,40649794,195149
3,ENSG00000261758.1,136752630,chr3-136770721-G-A,rs6802702,1,G,A,136770721,18091,136556022,136949238,214699
3,ENSG00000260743.1,179340322,chr3-179340714-A-G,rs6805876,1,A,G,179340714,392,179143714,179536930,197000
3,ENSG00000243410.1,64011964,chr3-64122597-C-T,rs704387,1,C,T,64122597,110633,63815356,64208572,307241
3,ENSG00000243629.1,157128595,chr3-157089639-G-A,rs73170828,-1,G,A,157089639,38956,156931987,157325203,157652
3,ENSG00000241544.1,157081738,chr3-157089639-G-A,rs73170828,1,G,A,157089639,7901,156885130,157278346,204509
3,ENSG00000226779.1,175271096,chr3-175276724-A-G,rs73184717,-1,A,G,175276724,5628,175074488,175467704,202236
3,ENSG00000249846.1,130112547,chr3-130123032-G-A,rs73210765,1,G,A,130123032,10485,129915939,130309155,207093
3,ENSG00000214135.4,197627848,chr3-197608945-C-T,rs73891640,-1,C,T,197608945,18903,197431240,197824456,177705
3,ENSG00000243422.1,75625153,chr3-75787707-A-G,rs7427663,-1,A,G,75787707,162554,75428545,75821761,359162
3,ENSG00000213178.3,169484080,chr3-169641564-A-G,rs74756127,-1,A,G,169641564,157484,169287472,169680688,354092
3,ENSG00000237433.1,32190747,chr3-32107224-G-T,rs748607,1,G,T,32107224,83523,31994139,32387355,113085
3,ENSG00000215837.6,195658096,chr3-195592384-G-A,rs75041105,1,G,A,195592384,65712,195461488,195854704,130896
3,ENSG00000226933.1,46023296,chr3-45844907-T-C,rs758389,1,T,C,45844907,178389,45826688,46219904,18219
3,ENSG00000224660.1,15254184,chr3-15353512-T-C,rs7614350,1,T,C,15353512,99328,15057576,15450792,295936
3,ENSG00000230266.1,195147764,chr3-195130448-G-A,rs7628775,1,G,A,195130448,17316,194951156,195344372,179292
3,ENSG00000236357.1,176068908,chr3-175877905-G-A,rs7630143,-1,G,A,175877905,191003,175872300,176265516,5605
3,ENSG00000175841.7,101521891,chr3-101414193-G-A,rs7630419,1,G,A,101414193,107698,101325283,101718499,88910
3,ENSG00000240063.1,182793394,chr3-182616865-G-A,rs7635859,-1,G,A,182616865,176529,182596786,182990002,20079
3,ENSG00000244161.1,58170636,chr3-58115042-C-T,rs7653042,-1,C,T,58115042,55594,57974028,58367244,141014
3,ENSG00000180438.10,14064203,chr3-13978795-A-G,rs76732393,1,A,G,13978795,85408,13867595,14260811,111200
3,ENSG00000243544.1,121654296,chr3-121632410-C-T,rs77852202,-1,C,T,121632410,21886,121457688,121850904,174722
3,ENSG00000235831.2,4980414,chr3-5000306-C-A,rs78704849,-1,C,A,5000306,19892,4783806,5177022,216500
3,ENSG00000187900.4,98238352,chr3-98392143-G-C,rs79116017,1,G,C,98392143,153791,98041744,98434960,350399
3,ENSG00000239351.1,149939799,chr3-150067426-A-G,rs79469600,-1,A,G,150067426,127627,149743191,150136407,324235
3,ENSG00000238278.3,75415070,chr3-75329768-T-C,rs79540395,1,T,C,75329768,85302,75218462,75611678,111306
3,ENSG00000243635.1,104502700,chr3-104645012-A-G,rs796589,1,A,G,104645012,142312,104306092,104699308,338920
3,ENSG00000250562.1,98525274,chr3-98555100-C-T,rs9289632,-1,C,T,98555100,29826,98328666,98721882,226434
3,ENSG00000243926.1,156674446,chr3-156672158-T-C,rs9289971,-1,T,C,156672158,2288,156477838,156871054,194320
3,ENSG00000224769.1,195614947,chr3-195595052-T-C,rs9330981,1,T,C,195595052,19895,195418339,195811555,176713
3,ENSG00000171084.11,125916624,chr3-125902007-G-A,rs9821905,1,G,A,125902007,14617,125720016,126113232,181991
3,ENSG00000239219.1,169966240,chr3-169966645-G-A,rs9836316,-1,G,A,169966645,405,169769632,170162848,197013
3,ENSG00000189229.10,6490512,chr3-6404581-G-C,rs9847933,1,G,C,6404581,85931,6293904,6687120,110677
3,ENSG00000233487.6,196987558,chr3-197124626-C-T,rs9850339,-1,C,T,197124626,137068,196790950,197184166,333676
3,ENSG00000241316.2,67654758,chr3-67590798-G-A,rs9856689,1,G,A,67590798,63960,67458150,67851366,132648
3,ENSG00000261488.1,112133423,chr3-112086273-G-T,rs9880242,1,G,T,112086273,47150,111936815,112330031,149458
3,ENSG00000241472.1,62369356,chr3-62220565-T-C,rs10510873,-1,T,C,62220565,148791,62172748,62565964,47817
3,ENSG00000221883.2,48918823,chr3-49114756-A-G,rs114570156,-1,A,G,49114756,195933,48722215,49115431,392541
3,ENSG00000227337.1,32785646,chr3-32593083-A-G,rs115055348,1,A,G,32593083,192563,32589038,32982254,4045
3,ENSG00000235947.1,4751590,chr3-4938806-C-T,rs115237767,-1,C,T,4938806,187216,4554982,4948198,383824
3,ENSG00000250939.1,12850659,chr3-12744330-G-A,rs115718559,1,G,A,12744330,106329,12654051,13047267,90279
3,ENSG00000240207.1,158732327,chr3-158584757-A-G,rs116650534,1,A,G,158584757,147570,158535719,158928935,49038
3,ENSG00000243150.1,158571066,chr3-158537898-T-C,rs11708784,-1,T,C,158537898,33168,158374458,158767674,163440
3,ENSG00000224318.1,196721,chr3-216440-A-G,rs11714407,-1,A,G,216440,19719,113,393329,216327
3,ENSG00000232829.3,130827659,chr3-130771244-C-T,rs11918709,1,C,T,130771244,56415,130631051,131024267,140193
3,ENSG00000229515.1,46143677,chr3-46122223-C-T,rs12330360,-1,C,T,46122223,21454,45947069,46340285,175154
3,ENSG00000244515.1,157163932,chr3-157266427-A-G,rs12634613,-1,A,G,157266427,102495,156967324,157360540,299103
3,ENSG00000171658.4,185960039,chr3-186125184-T-C,rs13068514,1,T,C,186125184,165145,185763431,186156647,361753
3,ENSG00000242539.1,179396961,chr3-179274163-C-T,rs13076233,1,C,T,179274163,122798,179200353,179593569,73810
3,ENSG00000240890.2,132386522,chr3-132291101-C-G,rs13077557,1,C,G,132291101,95421,132189914,132583130,101187
3,ENSG00000241135.1,157089918,chr3-157096233-C-A,rs13077741,1,C,A,157096233,6315,156893310,157286526,202923
3,ENSG00000175841.7,101521891,chr3-101523907-A-G,rs13088318,1,A,G,101523907,2016,101325283,101718499,198624
3,ENSG00000240875.1,156817034,chr3-156803332-T-C,rs1430412,-1,T,C,156803332,13702,156620426,157013642,182906
3,ENSG00000230757.1,39643638,chr3-39613636-A-G,rs1513217,1,A,G,39613636,30002,39447030,39840246,166606
3,ENSG00000240024.1,183451741,chr3-183489509-G-A,rs1553693,1,G,A,183489509,37768,183255133,183648349,234376
3,ENSG00000240567.1,161426427,chr3-161402695-C-T,rs16832279,1,C,T,161402695,23732,161229819,161623035,172876
3,ENSG00000250608.1,131381475,chr3-131359783-T-G,rs16836473,-1,T,G,131359783,21692,131184867,131578083,174916
3,ENSG00000213300.4,75214631,chr3-75315279-T-C,rs17028130,1,T,C,75315279,100648,75018023,75411239,297256
3,ENSG00000227110.2,8501672,chr3-8482603-C-T,rs17049184,-1,C,T,8482603,19069,8305064,8698280,177539
3,ENSG00000239557.1,52373652,chr3-52300577-T-C,rs17052053,1,T,C,52300577,73075,52177044,52570260,123533
3,ENSG00000213509.4,57941818,chr3-57970449-T-C,rs1718472,1,T,C,57970449,28631,57745210,58138426,225239
3,ENSG00000214280.3,139583593,chr3-139649764-C-T,rs17393045,-1,C,T,139649764,66171,139386985,139780201,262779
3,ENSG00000234661.1,385795,chr3-329404-G-A,rs17526472,-1,G,A,329404,56391,189187,582403,140217
3,ENSG00000240057.1,113019468,chr3-112838440-G-T,rs2037820,1,G,T,112838440,181028,112822860,113216076,15580
3,ENSG00000229589.1,38454820,chr3-38316326-C-T,rs2070492,-1,C,T,38316326,138494,38258212,38651428,58114
3,ENSG00000174912.6,156714928,chr3-156645453-A-G,rs2136690,-1,A,G,156645453,69475,156518320,156911536,127133
3,ENSG00000248243.1,130094304,chr3-129990127-G-A,rs2175849,-1,G,A,129990127,104177,129897696,130290912,92431
3,ENSG00000248839.1,98522570,chr3-98511645-T-C,rs2316131,1,T,C,98511645,10925,98325962,98719178,185683
3,ENSG00000236833.1,197665757,chr3-197510487-G-C,rs2567371,-1,G,C,197510487,155270,197469149,197862365,41338
3,ENSG00000198590.7,37385604,chr3-37540761-G-A,rs267539,1,G,A,37540761,155157,37188996,37582212,351765
3,ENSG00000206573.4,9396654,chr3-9347893-G-T,rs2728939,-1,G,T,9347893,48761,9200046,9593262,147847
3,ENSG00000249846.1,130112547,chr3-129989351-A-T,rs2896588,1,A,T,129989351,123196,129915939,130309155,73412
3,ENSG00000243276.1,118557668,chr3-118500126-T-C,rs2946820,-1,T,C,118500126,57542,118361060,118754276,139066
3,ENSG00000178631.7,139493809,chr3-139560431-A-G,rs295505,1,A,G,139560431,66622,139297201,139690417,263230
3,ENSG00000244171.3,143176327,chr3-143234689-A-G,rs35845859,1,A,G,143234689,58362,142979719,143372935,254970
3,ENSG00000243795.1,113167819,chr3-113021298-C-T,rs3872610,-1,C,T,113021298,146521,112971211,113364427,50087
3,ENSG00000234742.1,197850954,chr3-197890576-G-A,rs3889202,-1,G,A,197890576,39622,197654346,198047562,236230
3,ENSG00000236062.1,12258460,chr3-12361041-A-G,rs4135307,-1,A,G,12361041,102581,12061852,12455068,299189
3,ENSG00000231552.1,32621902,chr3-32579556-C-A,rs4384987,-1,C,A,32579556,42346,32425294,32818510,154262
3,ENSG00000231552.1,32621902,chr3-32579556-C-G,rs4384987,-1,C,G,32579556,42346,32425294,32818510,154262
3,ENSG00000231464.1,195996738,chr3-195915283-G-A,rs4485751,1,G,A,195915283,81455,195800130,196193346,115153
3,ENSG00000215837.6,195658096,chr3-195597739-G-A,rs4677617,1,G,A,195597739,60357,195461488,195854704,136251
3,ENSG00000230266.1,195147764,chr3-195153563-T-C,rs4677662,1,T,C,195153563,5799,194951156,195344372,202407
3,ENSG00000171084.11,125916624,chr3-125910985-A-C,rs4679199,1,A,C,125910985,5639,125720016,126113232,190969
3,ENSG00000251474.2,129397109,chr3-129590420-T-C,rs4688807,-1,T,C,129590420,193311,129200501,129593717,389919
3,ENSG00000249274.1,98782188,chr3-98713715-C-T,rs4857414,1,C,T,98713715,68473,98585580,98978796,128135
3,ENSG00000225578.1,196939877,chr3-196811777-C-T,rs4916555,1,C,T,196811777,128100,196743269,197136485,68508
3,ENSG00000213431.4,100912175,chr3-100766607-A-G,rs544500,-1,A,G,100766607,145568,100715567,101108783,51040
3,ENSG00000232953.1,19943310,chr3-19774465-T-A,rs57024137,-1,T,A,19774465,168845,19746702,20139918,27763
3,ENSG00000214135.4,197627848,chr3-197443250-G-T,rs58339845,-1,G,T,197443250,184598,197431240,197824456,12010
3,ENSG00000218754.4,96619304,chr3-96812115-T-C,rs61138285,1,T,C,96812115,192811,96422696,96815912,389419
3,ENSG00000229217.1,10058287,chr3-9884326-G-A,rs62247505,-1,G,A,9884326,173961,9861679,10254895,22647
3,ENSG00000229178.1,195657927,chr3-195788697-C-T,rs62282504,-1,C,T,195788697,130770,195461319,195854535,327378
3,ENSG00000243701.1,107240718,chr3-107182031-G-A,rs62322851,1,G,A,107182031,58687,107044110,107437326,137921
3,ENSG00000227440.1,172829176,chr3-172700394-T-G,rs645253,-1,T,G,172700394,128782,172632568,173025784,67826
3,ENSG00000224614.1,195908076,chr3-195850647-G-A,rs6583240,1,G,A,195850647,57429,195711468,196104684,139179
3,ENSG00000239653.1,64004022,chr3-64034771-C-T,rs6764606,1,C,T,64034771,30749,63807414,64200630,227357
3,ENSG00000230530.1,45689179,chr3-45779015-C-G,rs6771661,-1,C,G,45779015,89836,45492571,45885787,286444
3,ENSG00000230530.1,45689179,chr3-45779015-C-T,rs6771661,-1,C,T,45779015,89836,45492571,45885787,286444
3,ENSG00000250562.1,98525274,chr3-98560271-T-C,rs6774682,-1,T,C,98560271,34997,98328666,98721882,231605
3,ENSG00000224728.1,15878047,chr3-16020301-A-G,rs6777375,1,A,G,16020301,142254,15681439,16074655,338862
3,ENSG00000224728.1,15878047,chr3-16020301-A-C,rs6777375,1,A,C,16020301,142254,15681439,16074655,338862
3,ENSG00000189366.5,125990537,chr3-126079070-G-A,rs6796610,-1,G,A,126079070,88533,125793929,126187145,285141
3,ENSG00000223387.2,172595607,chr3-172656329-G-A,rs6796724,-1,G,A,172656329,60722,172398999,172792215,257330
3,ENSG00000224080.1,37143958,chr3-37269358-T-G,rs6800932,-1,T,G,37269358,125400,36947350,37340566,322008
3,ENSG00000235897.1,196318350,chr3-196237816-C-G,rs712012,1,C,G,196237816,80534,196121742,196514958,116074
3,ENSG00000235897.1,196318350,chr3-196237816-C-T,rs712012,1,C,T,196237816,80534,196121742,196514958,116074
3,ENSG00000206120.6,168249941,chr3-168323059-G-T,rs71304676,1,G,T,168323059,73118,168053333,168446549,269726
3,ENSG00000241810.1,153067278,chr3-153200740-C-T,rs72616700,1,C,T,153200740,133462,152870670,153263886,330070
3,ENSG00000224094.1,45160175,chr3-45249267-T-C,rs731610,-1,T,C,45249267,89092,44963567,45356783,285700
3,ENSG00000228252.3,130212823,chr3-130123032-G-A,rs73210765,1,G,A,130123032,89791,130016215,130409431,106817
3,ENSG00000243629.1,157128595,chr3-157103560-G-T,rs74563697,-1,G,T,157103560,25035,156931987,157325203,171573
3,ENSG00000243635.1,104502700,chr3-104557500-T-C,rs74670539,1,T,C,104557500,54800,104306092,104699308,251408
3,ENSG00000184100.5,160100850,chr3-159981731-G-T,rs747825,1,G,T,159981731,119119,159904242,160297458,77489
3,ENSG00000184100.5,160100850,chr3-159981731-G-A,rs747825,1,G,A,159981731,119119,159904242,160297458,77489
3,ENSG00000244026.1,75435110,chr3-75342299-G-A,rs74783618,-1,G,A,75342299,92811,75238502,75631718,103797
3,ENSG00000231305.3,128871540,chr3-128720336-C-T,rs75198802,-1,C,T,128720336,151204,128674932,129068148,45404
3,ENSG00000242759.1,107240663,chr3-107275222-C-T,rs75357977,-1,C,T,107275222,34559,107044055,107437271,231167
3,ENSG00000259970.1,49684983,chr3-49703017-C-T,rs76100153,-1,C,T,49703017,18034,49488375,49881591,214642
3,ENSG00000239699.1,80216261,chr3-80320585-C-T,rs7617987,1,C,T,80320585,104324,80019653,80412869,300932
3,ENSG00000248530.1,131526447,chr3-131521798-A-G,rs7618892,1,A,G,131521798,4649,131329839,131723055,191959
3,ENSG00000206549.7,46812574,chr3-46726984-C-T,rs7626129,-1,C,T,46726984,85590,46615966,47009182,111018
3,ENSG00000260572.1,160755142,chr3-160926617-G-T,rs7633319,-1,G,T,160926617,171475,160558534,160951750,368083
3,ENSG00000244124.1,141919021,chr3-142076731-C-T,rs7635444,-1,C,T,142076731,157710,141722413,142115629,354318
3,ENSG00000237433.1,32190747,chr3-32173407-T-C,rs7638856,1,T,C,32173407,17340,31994139,32387355,179268
3,ENSG00000241537.1,72772539,chr3-72928689-A-G,rs7643262,1,A,G,72928689,156150,72575931,72969147,352758
3,ENSG00000236297.1,193579413,chr3-193706317-C-T,rs7650095,-1,C,T,193706317,126904,193382805,193776021,323512
3,ENSG00000224660.1,15254184,chr3-15403305-A-G,rs7653883,1,A,G,15403305,149121,15057576,15450792,345729
3,ENSG00000241280.1,101960358,chr3-102100163-T-C,rs78082945,1,T,C,102100163,139805,101763750,102156966,336413
3,ENSG00000229704.1,185246441,chr3-185408583-A-G,rs78358809,-1,A,G,185408583,162142,185049833,185443049,358750
3,ENSG00000241293.1,87052738,chr3-87089281-G-A,rs79844519,-1,G,A,87089281,36543,86856130,87249346,233151
3,ENSG00000235805.1,44710886,chr3-44721367-A-G,rs80107322,-1,A,G,44721367,10481,44514278,44907494,207089
3,ENSG00000239445.1,98732757,chr3-98756235-G-T,rs893831,-1,G,T,98756235,23478,98536149,98929365,220086
3,ENSG00000243422.1,75625153,chr3-75816580-A-G,rs9310347,-1,A,G,75816580,191427,75428545,75821761,388035
3,ENSG00000249786.1,15455940,chr3-15629519-C-T,rs9310479,-1,C,T,15629519,173579,15259332,15652548,370187
3,ENSG00000224424.6,48847851,chr3-48658234-G-A,rs9812200,1,G,A,48658234,189617,48651243,49044459,6991
3,ENSG00000223797.1,40453186,chr3-40515105-G-A,rs9820580,-1,G,A,40515105,61919,40256578,40649794,258527
3,ENSG00000244226.1,65687301,chr3-65857340-T-C,rs9820754,1,T,C,65857340,170039,65490693,65883909,366647
3,ENSG00000260743.1,179340322,chr3-179337710-C-T,rs9824117,1,C,T,179337710,2612,179143714,179536930,193996
3,ENSG00000260743.1,179340322,chr3-179337710-C-A,rs9824117,1,C,A,179337710,2612,179143714,179536930,193996
3,ENSG00000243926.1,156674446,chr3-156577552-A-G,rs9826775,-1,A,G,156577552,96894,156477838,156871054,99714
3,ENSG00000230409.2,37275693,chr3-37158314-A-T,rs9828017,1,A,T,37158314,117379,37079085,37472301,79229
3,ENSG00000260261.1,195954485,chr3-195919905-G-A,rs9829723,-1,G,A,195919905,34580,195757877,196151093,162028
3,ENSG00000250983.1,133546272,chr3-133714626-G-A,rs9830001,-1,G,A,133714626,168354,133349664,133742880,364962
3,ENSG00000232535.1,98306752,chr3-98265098-A-G,rs9853906,1,A,G,98265098,41654,98110144,98503360,154954
3,ENSG00000173811.6,42732575,chr3-42838998-A-G,rs9861236,1,A,G,42838998,106423,42535967,42929183,303031
3,ENSG00000240429.1,179261273,chr3-179419314-T-C,rs9877546,-1,T,C,179419314,158041,179064665,179457881,354649
3,ENSG00000231770.1,194583991,chr3-194589630-G-A,rs999941,1,G,A,194589630,5639,194387383,194780599,202247
3,ENSG00000236297.1,193579413,chr3-193640945-A-G,rs100774,-1,A,G,193640945,61532,193382805,193776021,258140
3,ENSG00000223387.2,172595607,chr3-172654731-C-T,rs10513704,-1,C,T,172654731,59124,172398999,172792215,255732
3,ENSG00000261786.1,44117299,chr3-44180859-T-G,rs1105023,1,T,G,44180859,63560,43920691,44313907,260168
3,ENSG00000241532.1,75654773,chr3-75471929-T-C,rs111237405,-1,T,C,75471929,182844,75458165,75851381,13764
3,ENSG00000241095.1,82808021,chr3-82642668-T-C,rs11127782,-1,T,C,82642668,165353,82611413,83004629,31255
3,ENSG00000223899.1,33033863,chr3-33007660-C-T,rs1133253,1,C,T,33007660,26203,32837255,33230471,170405
3,ENSG00000205955.3,184115352,chr3-183975306-G-A,rs114229290,1,G,A,183975306,140046,183918744,184311960,56562
3,ENSG00000243176.1,157175269,chr3-157106337-G-A,rs114923591,1,G,A,157106337,68932,156978661,157371877,127676
3,ENSG00000224426.1,172604006,chr3-172635588-G-A,rs115858343,-1,G,A,172635588,31582,172407398,172800614,228190
3,ENSG00000250608.1,131381475,chr3-131389444-T-C,rs11706857,-1,T,C,131389444,7969,131184867,131578083,204577
3,ENSG00000214552.4,68145004,chr3-68207829-C-T,rs11711058,1,C,T,68207829,62825,67948396,68341612,259433
3,ENSG00000239797.1,145824739,chr3-145643569-A-G,rs11714523,-1,A,G,145643569,181170,145628131,146021347,15438
3,ENSG00000261159.1,128860526,chr3-128736890-T-C,rs11716540,-1,T,C,128736890,123636,128663918,129057134,72972
3,ENSG00000198590.7,37385604,chr3-37473850-C-T,rs12019224,1,C,T,37473850,88246,37188996,37582212,284854
3,ENSG00000242516.1,75672300,chr3-75766728-A-G,rs12496434,1,A,G,75766728,94428,75475692,75868908,291036
3,ENSG00000223791.1,23806905,chr3-23766059-C-T,rs12497066,-1,C,T,23766059,40846,23610297,24003513,155762
3,ENSG00000241679.2,143123362,chr3-143140341-G-C,rs12635534,1,G,C,143140341,16979,142926754,143319970,213587
3,ENSG00000242609.1,72086888,chr3-71986686-T-G,rs13058906,1,T,G,71986686,100202,71890280,72283496,96406
3,ENSG00000240695.1,136737229,chr3-136626977-A-G,rs13066401,-1,A,G,136626977,110252,136540621,136933837,86356
3,ENSG00000174912.6,156714928,chr3-156753166-A-G,rs13068223,-1,A,G,156753166,38238,156518320,156911536,234846
3,ENSG00000223358.1,185162901,chr3-185126919-G-A,rs13074297,1,G,A,185126919,35982,184966293,185359509,160626
3,ENSG00000234629.1,94938024,chr3-94990681-T-C,rs13080566,-1,T,C,94990681,52657,94741416,95134632,249265
3,ENSG00000241544.1,157081738,chr3-157106718-C-T,rs13314825,1,C,T,157106718,24980,156885130,157278346,221588
3,ENSG00000244515.1,157163932,chr3-157339601-G-A,rs13325944,-1,G,A,157339601,175669,156967324,157360540,372277
3,ENSG00000239978.1,125734295,chr3-125538008-G-T,rs1374908,1,G,T,125538008,196287,125537687,125930903,321
3,ENSG00000244722.1,110683154,chr3-110694089-T-C,rs1462318,-1,T,C,110694089,10935,110486546,110879762,207543
3,ENSG00000230732.1,196912646,chr3-196727148-C-T,rs1463628,1,C,T,196727148,185498,196716038,197109254,11110
3,ENSG00000228008.1,49903987,chr3-49722606-T-C,rs1466685,1,T,C,49722606,181381,49707379,50100595,15227
3,ENSG00000241490.1,114214391,chr3-114254744-A-G,rs1503671,1,A,G,114254744,40353,114017783,114410999,236961
3,ENSG00000224769.1,195614947,chr3-195545394-A-G,rs1532291,1,A,G,195545394,69553,195418339,195811555,127055
3,ENSG00000259976.1,114329714,chr3-114398480-G-A,rs16822593,-1,G,A,114398480,68766,114133106,114526322,265374
3,ENSG00000243635.1,104502700,chr3-104629865-G-T,rs16850153,1,G,T,104629865,127165,104306092,104699308,323773
3,ENSG00000243635.1,104502700,chr3-104629865-G-A,rs16850153,1,G,A,104629865,127165,104306092,104699308,323773
3,ENSG00000244171.3,143176327,chr3-143137717-A-T,rs16853038,1,A,T,143137717,38610,142979719,143372935,157998
3,ENSG00000224318.1,196721,chr3-270168-G-T,rs17017010,-1,G,T,270168,73447,113,393329,270055
3,ENSG00000244513.1,69014164,chr3-68874628-A-G,rs17048089,1,A,G,68874628,139536,68817556,69210772,57072
3,ENSG00000235339.1,41977008,chr3-41954812-G-A,rs17284472,1,G,A,41954812,22196,41780400,42173616,174412
3,ENSG00000240875.1,156817034,chr3-156929677-T-C,rs17442066,-1,T,C,156929677,112643,156620426,157013642,309251
3,ENSG00000227578.1,15141380,chr3-15240721-T-G,rs17480974,1,T,G,15240721,99341,14944772,15337988,295949
3,ENSG00000240207.1,158732327,chr3-158538778-G-C,rs17628958,1,G,C,158538778,193549,158535719,158928935,3059
3,ENSG00000241473.1,180820544,chr3-180914186-T-G,rs1805583,1,T,G,180914186,93642,180623936,181017152,290250
3,ENSG00000229863.1,57134142,chr3-57124220-A-G,rs1817691,1,A,G,57124220,9922,56937534,57330750,186686
3,ENSG00000189366.5,125990537,chr3-125964042-G-C,rs1827494,-1,G,C,125964042,26495,125793929,126187145,170113
3,ENSG00000241506.1,68635705,chr3-68484927-T-C,rs1877001,1,T,C,68484927,150778,68439097,68832313,45830
3,ENSG00000231249.1,4493201,chr3-4623881-A-G,rs2029665,-1,A,G,4623881,130680,4296593,4689809,327288
3,ENSG00000203644.2,129847957,chr3-129939655-C-T,rs2137574,-1,C,T,129939655,91698,129651349,130044565,288306
3,ENSG00000241316.2,67654758,chr3-67653678-G-A,rs2198015,1,G,A,67653678,1080,67458150,67851366,195528
3,ENSG00000214135.4,197627848,chr3-197511453-A-G,rs2567332,-1,A,G,197511453,116395,197431240,197824456,80213
3,ENSG00000240776.1,113850731,chr3-113901497-C-T,rs2632245,-1,C,T,113901497,50766,113654123,114047339,247374
3,ENSG00000229178.1,195657927,chr3-195800600-C-T,rs2688515,-1,C,T,195800600,142673,195461319,195854535,339281
3,ENSG00000228766.3,182610674,chr3-182659192-T-C,rs2700865,1,T,C,182659192,48518,182414066,182807282,245126
3,ENSG00000238278.3,75415070,chr3-75456899-G-A,rs2976084,1,G,A,75456899,41829,75218462,75611678,238437
3,ENSG00000186162.6,10023747,chr3-9935180-C-T,rs3901800,-1,C,T,9935180,88567,9827139,10220355,108041
3,ENSG00000173811.6,42732575,chr3-42735029-C-T,rs3907218,1,C,T,42735029,2454,42535967,42929183,199062
3,ENSG00000226779.1,175271096,chr3-175233966-T-C,rs4371530,-1,T,C,175233966,37130,175074488,175467704,159478
3,ENSG00000236152.1,6773343,chr3-6876897-C-T,rs455327,-1,C,T,6876897,103554,6576735,6969951,300162
3,ENSG00000233597.3,142044198,chr3-142202017-G-C,rs4630960,-1,G,C,142202017,157819,141847590,142240806,354427
3,ENSG00000244026.1,75435110,chr3-75347667-T-A,rs4677001,-1,T,A,75347667,87443,75238502,75631718,109165
3,ENSG00000228252.3,130212823,chr3-130229774-C-G,rs4688868,1,C,G,130229774,16951,130016215,130409431,213559
3,ENSG00000243547.1,96349554,chr3-96193245-T-C,rs4857185,1,T,C,96193245,156309,96152946,96546162,40299
3,ENSG00000250562.1,98525274,chr3-98553117-T-C,rs4857401,-1,T,C,98553117,27843,98328666,98721882,224451
3,ENSG00000260236.1,47381519,chr3-47438867-A-G,rs4858889,-1,A,G,47438867,57348,47184911,47578127,253956
3,ENSG00000240063.1,182793394,chr3-182616427-A-C,rs4859236,-1,A,C,182616427,176967,182596786,182990002,19641
3,ENSG00000248916.1,129325426,chr3-129260165-C-T,rs4927943,-1,C,T,129260165,65261,129128818,129522034,131347
3,ENSG00000240024.1,183451741,chr3-183489766-T-C,rs55681827,1,T,C,183489766,38025,183255133,183648349,234633
3,ENSG00000224660.1,15254184,chr3-15362621-T-C,rs58163887,1,T,C,15362621,108437,15057576,15450792,305045
3,ENSG00000242992.2,128765018,chr3-128814285-C-G,rs59753334,-1,C,G,128814285,49267,128568410,128961626,245875
3,ENSG00000226360.4,61743106,chr3-61803306-A-G,rs61135440,-1,A,G,61803306,60200,61546498,61939714,256808
3,ENSG00000243795.1,113167819,chr3-113175492-T-C,rs62264196,-1,T,C,113175492,7673,112971211,113364427,204281
3,ENSG00000171084.11,125916624,chr3-126068283-C-T,rs6438966,1,C,T,126068283,151659,125720016,126113232,348267
3,ENSG00000145075.7,180870933,chr3-180803836-A-G,rs6443721,-1,A,G,180803836,67097,180674325,181067541,129511
3,ENSG00000241472.1,62369356,chr3-62338428-C-A,rs6445263,-1,C,A,62338428,30928,62172748,62565964,165680
3,ENSG00000232439.1,38527325,chr3-38697226-G-A,rs6599240,-1,G,A,38697226,169901,38330717,38723933,366509
3,ENSG00000225770.1,196536532,chr3-196648269-T-G,rs6766451,1,T,G,196648269,111737,196339924,196733140,308345
3,ENSG00000243544.1,121654296,chr3-121846142-G-A,rs6767409,-1,G,A,121846142,191846,121457688,121850904,388454
3,ENSG00000132967.9,22381819,chr3-22534101-C-T,rs6769561,1,C,T,22534101,152282,22185211,22578427,348890
3,ENSG00000230454.1,50260303,chr3-50278688-T-C,rs6776145,1,T,C,50278688,18385,50063695,50456911,214993
3,ENSG00000224406.1,186493661,chr3-186478163-C-T,rs6776648,-1,C,T,186478163,15498,186297053,186690269,181110
3,ENSG00000243674.1,75348787,chr3-75317833-T-C,rs6777693,-1,T,C,75317833,30954,75152179,75545395,165654
3,ENSG00000243696.2,52835729,chr3-52725844-T-C,rs6788355,-1,T,C,52725844,109885,52639121,53032337,86723
3,ENSG00000224831.2,149983308,chr3-150047998-C-T,rs6789518,-1,C,T,150047998,64690,149786700,150179916,261298
3,ENSG00000213178.3,169484080,chr3-169533563-T-C,rs6806395,-1,T,C,169533563,49483,169287472,169680688,246091
3,ENSG00000250983.1,133546272,chr3-133382546-C-T,rs6807356,-1,C,T,133382546,163726,133349664,133742880,32882
3,ENSG00000240288.1,10285754,chr3-10201649-G-A,rs696320,1,G,A,10201649,84105,10089146,10482362,112503
3,ENSG00000213371.4,120805866,chr3-120709207-A-C,rs73181938,1,A,C,120709207,96659,120609258,121002474,99949
3,ENSG00000185485.10,195990258,chr3-195821265-C-T,rs73891133,-1,C,T,195821265,168993,195793650,196186866,27615
3,ENSG00000236833.1,197665757,chr3-197507802-G-A,rs7428150,-1,G,A,197507802,157955,197469149,197862365,38653
3,ENSG00000244380.1,48446632,chr3-48345866-G-A,rs749085,-1,G,A,48345866,100766,48250024,48643240,95842
3,ENSG00000227440.1,172829176,chr3-172785751-C-T,rs75489499,-1,C,T,172785751,43425,172632568,173025784,153183
3,ENSG00000251474.2,129397109,chr3-129243380-C-G,rs7610229,-1,C,G,129243380,153729,129200501,129593717,42879
3,ENSG00000235787.1,42469640,chr3-42541650-G-A,rs7622205,1,G,A,42541650,72010,42273032,42666248,268618
3,ENSG00000244161.1,58170636,chr3-58191659-T-C,rs7626509,-1,T,C,58191659,21023,57974028,58367244,217631
3,ENSG00000228168.1,39334979,chr3-39490370-A-G,rs76395532,1,A,G,39490370,155391,39138371,39531587,351999
3,ENSG00000231770.1,194583991,chr3-194581640-G-A,rs7652066,1,G,A,194581640,2351,194387383,194780599,194257
3,ENSG00000240622.1,124153063,chr3-124228930-G-A,rs77258559,-1,G,A,124228930,75867,123956455,124349671,272475
3,ENSG00000244193.1,169946754,chr3-169826510-T-G,rs77879098,-1,T,G,169826510,120244,169750146,170143362,76364
3,ENSG00000232535.1,98306752,chr3-98392143-G-C,rs79116017,1,G,C,98392143,85391,98110144,98503360,281999
3,ENSG00000230266.1,195147764,chr3-195144965-C-T,rs79259450,1,C,T,195144965,2799,194951156,195344372,193809
3,ENSG00000244153.1,98657802,chr3-98822578-G-T,rs828617,1,G,T,98822578,164776,98461194,98854410,361384
3,ENSG00000233308.1,191234605,chr3-191426810-T-C,rs9290987,-1,T,C,191426810,192205,191037997,191431213,388813
3,ENSG00000178631.7,139493809,chr3-139650925-T-A,rs9814679,1,T,A,139650925,157116,139297201,139690417,353724
3,ENSG00000225733.1,14948424,chr3-15081834-C-T,rs9845081,-1,C,T,15081834,133410,14751816,15145032,330018
3,ENSG00000242539.1,179396961,chr3-179278838-G-A,rs9856476,1,G,A,179278838,118123,179200353,179593569,78485
3,ENSG00000243759.1,143518229,chr3-143636295-A-C,rs9862274,-1,A,C,143636295,118066,143321621,143714837,314674
3,ENSG00000237433.1,32190747,chr3-32049648-T-A,rs9877445,1,T,A,32049648,141099,31994139,32387355,55509
3,ENSG00000239455.1,107107000,chr3-107268038-A-G,rs9879076,-1,A,G,107268038,161038,106910392,107303608,357646
2,ENSG00000235128.1,126679622,chr2-126697294-G-C,rs10174588,1,G,C,126697294,17672,126483014,126876230,214280
2,ENSG00000213963.2,177392674,chr2-177332141-C-T,rs10179735,-1,C,T,177332141,60533,177196066,177589282,136075
2,ENSG00000234559.1,129940217,chr2-129987975-A-G,rs10181949,-1,A,G,129987975,47758,129743609,130136825,244366
2,ENSG00000213594.4,38285410,chr2-38416161-C-T,rs10191584,1,C,T,38416161,130751,38088802,38482018,327359
2,ENSG00000225963.1,230121370,chr2-230046220-C-T,rs10199878,1,C,T,230046220,75150,229924762,230317978,121458
2,ENSG00000231969.1,149587673,chr2-149567238-G-C,rs10204262,1,G,C,149567238,20435,149391065,149784281,176173
2,ENSG00000223824.1,189917758,chr2-190107532-G-A,rs10206154,-1,G,A,190107532,189774,189721150,190114366,386382
2,ENSG00000179997.7,174501952,chr2-174695766-T-C,rs10210290,1,T,C,174695766,193814,174305344,174698560,390422
2,ENSG00000237951.1,26162056,chr2-26162980-G-A,rs1025542,1,G,A,26162980,924,25965448,26358664,197532
2,ENSG00000260101.1,64524110,chr2-64544141-C-T,rs1030130,-1,C,T,64544141,20031,64327502,64720718,216639
2,ENSG00000227692.1,186364598,chr2-186393110-T-C,rs10432501,1,T,C,186393110,28512,186167990,186561206,225120
2,ENSG00000259915.1,186356773,chr2-186393110-T-C,rs10432501,-1,T,C,186393110,36337,186160165,186553381,232945
2,ENSG00000236432.2,227325164,chr2-227371816-C-T,rs10439364,-1,C,T,227371816,46652,227128556,227521772,243260
2,ENSG00000246575.2,85315041,chr2-85328154-G-A,rs10460586,1,G,A,85328154,13113,85118433,85511649,209721
2,ENSG00000225964.1,6840430,chr2-6849889-C-T,rs10495545,-1,C,T,6849889,9459,6643822,7037038,206067
2,ENSG00000172974.9,65205108,chr2-65082162-G-A,rs10496123,1,G,A,65082162,122946,65008500,65401716,73662
2,ENSG00000225449.1,129968380,chr2-129910063-G-A,rs10803609,-1,G,A,129910063,58317,129771772,130164988,138291
2,ENSG00000228509.1,190841864,chr2-190723701-T-C,rs10931469,-1,T,C,190723701,118163,190645256,191038472,78445
2,ENSG00000234793.1,241755740,chr2-241771520-G-A,rs10933568,-1,G,A,241771520,15780,241559132,241952348,212388
2,ENSG00000213301.2,104771282,chr2-104749707-T-G,rs1110143,1,T,G,104749707,21575,104574674,104967890,175033
2,ENSG00000189223.7,113235536,chr2-113226726-T-C,rs11123172,1,T,C,113226726,8810,113038928,113432144,187798
2,ENSG00000236969.1,91775944,chr2-91874755-A-G,rs111864931,1,A,G,91874755,98811,91579336,91972552,295419
2,ENSG00000236969.1,91775944,chr2-91874755-A-C,rs111864931,1,A,C,91874755,98811,91579336,91972552,295419
2,ENSG00000230572.1,91714745,chr2-91874755-A-G,rs111864931,-1,A,G,91874755,160010,91518137,91911353,356618
2,ENSG00000230572.1,91714745,chr2-91874755-A-C,rs111864931,-1,A,C,91874755,160010,91518137,91911353,356618
2,ENSG00000235235.4,91817771,chr2-91874755-A-G,rs111864931,1,A,G,91874755,56984,91621163,92014379,253592
2,ENSG00000235235.4,91817771,chr2-91874755-A-C,rs111864931,1,A,C,91874755,56984,91621163,92014379,253592
2,ENSG00000162997.10,55282329,chr2-55094479-G-A,rs113858242,1,G,A,55094479,187850,55085721,55478937,8758
2,ENSG00000204581.2,111114185,chr2-110956544-T-A,rs115273210,-1,T,A,110956544,157641,110917577,111310793,38967
2,ENSG00000232970.1,216156811,chr2-216208470-G-C,rs115422954,-1,G,C,216208470,51659,215960203,216353419,248267
2,ENSG00000261096.1,231809846,chr2-231666012-C-T,rs115743472,1,C,T,231666012,143834,231613238,232006454,52774
2,ENSG00000224607.3,89968867,chr2-90108556-C-A,rs116171884,1,C,A,90108556,139689,89772259,90165475,336297
2,ENSG00000239571.1,89936859,chr2-90108556-C-A,rs116171884,1,C,A,90108556,171697,89740251,90133467,368305
2,ENSG00000233971.1,71984434,chr2-71963333-G-T,rs11678046,-1,G,T,71963333,21101,71787826,72181042,175507
2,ENSG00000235997.2,30346623,chr2-30336950-A-G,rs11680937,1,A,G,30336950,9673,30150015,30543231,186935
2,ENSG00000231747.1,112622167,chr2-112665171-C-G,rs11683520,-1,C,G,112665171,43004,112425559,112818775,239612
2,ENSG00000229867.1,119270714,chr2-119280688-C-T,rs11686984,-1,C,T,119280688,9974,119074106,119467322,206582
2,ENSG00000180152.3,112853328,chr2-112798211-C-T,rs11687733,1,C,T,112798211,55117,112656720,113049936,141491
2,ENSG00000235078.1,3519275,chr2-3652039-A-G,rs11688325,1,A,G,3652039,132764,3322667,3715883,329372
2,ENSG00000229503.1,62533059,chr2-62460245-A-G,rs11693346,-1,A,G,62460245,72814,62336451,62729667,123794
2,ENSG00000212978.4,61144950,chr2-61141397-T-G,rs1177274,-1,T,G,61141397,3553,60948342,61341558,193055
2,ENSG00000226080.1,11102142,chr2-10994010-T-C,rs11888040,1,T,C,10994010,108132,10905534,11298750,88476
2,ENSG00000223935.1,64453798,chr2-64486877-A-G,rs11894104,-1,A,G,64486877,33079,64257190,64650406,229687
2,ENSG00000172799.5,231434426,chr2-231307255-A-G,rs11894854,-1,A,G,231307255,127171,231237818,231631034,69437
2,ENSG00000234350.1,170813670,chr2-170719161-A-G,rs11895153,-1,A,G,170719161,94509,170617062,171010278,102099
2,ENSG00000236090.2,41819747,chr2-41847497-C-G,rs11902014,1,C,G,41847497,27750,41623139,42016355,224358
2,ENSG00000232625.1,218841599,chr2-218999172-C-T,rs11902763,1,C,T,218999172,157573,218644991,219038207,354181
2,ENSG00000178162.4,130431363,chr2-130377276-A-G,rs12151738,-1,A,G,130377276,54087,130234755,130627971,142521
2,ENSG00000236682.1,127388202,chr2-127328778-C-T,rs12613413,1,C,T,127328778,59424,127191594,127584810,137184
2,ENSG00000226491.1,42798712,chr2-42786632-C-T,rs12617051,-1,C,T,42786632,12080,42602104,42995320,184528
2,ENSG00000224184.1,12007128,chr2-11987139-T-C,rs12623991,1,T,C,11987139,19989,11810520,12203736,176619
2,ENSG00000227359.1,113704078,chr2-113735683-A-G,rs12624301,-1,A,G,113735683,31605,113507470,113900686,228213
2,ENSG00000253559.1,189762704,chr2-189664505-T-C,rs12693551,1,T,C,189664505,98199,189566096,189959312,98409
2,ENSG00000181798.2,231514396,chr2-231493441-T-C,rs12694893,-1,T,C,231493441,20955,231317788,231711004,175653
2,ENSG00000225402.1,37816915,chr2-37830485-C-T,rs12712554,1,C,T,37830485,13570,37620307,38013523,210178
2,ENSG00000242766.1,90082635,chr2-90201608-G-A,rs13003799,1,G,A,90201608,118973,89886027,90279243,315581
2,ENSG00000224041.2,90114838,chr2-90201608-G-A,rs13003799,1,G,A,90201608,86770,89918230,90311446,283378
2,ENSG00000239819.1,90220727,chr2-90201608-G-A,rs13003799,1,G,A,90201608,19119,90024119,90417335,177489
2,ENSG00000224331.2,164687596,chr2-164716684-C-T,rs13024606,-1,C,T,164716684,29088,164490988,164884204,225696
2,ENSG00000229781.1,142854095,chr2-142844934-T-C,rs13027801,1,T,C,142844934,9161,142657487,143050703,187447
2,ENSG00000236259.1,68125265,chr2-68207213-A-C,rs13029910,1,A,C,68207213,81948,67928657,68321873,278556
2,ENSG00000235064.1,33840678,chr2-33667696-C-T,rs13035680,-1,C,T,33667696,172982,33644070,34037286,23626
2,ENSG00000173209.16,61177539,chr2-61252282-C-T,rs13398770,1,C,T,61252282,74743,60980931,61374147,271351
2,ENSG00000234936.1,43229573,chr2-43229595-A-G,rs13407351,1,A,G,43229595,22,43032965,43426181,196630
2,ENSG00000213946.3,191882205,chr2-191920735-G-T,rs13408062,-1,G,T,191920735,38530,191685597,192078813,235138
2,ENSG00000203387.2,228353215,chr2-228445857-C-T,rs13410146,-1,C,T,228445857,92642,228156607,228549823,289250
2,ENSG00000213729.3,20156057,chr2-20121430-C-T,rs13415910,-1,C,T,20121430,34627,19959449,20352665,161981
2,ENSG00000241114.1,54080280,chr2-53968616-T-C,rs13432266,-1,T,C,53968616,111664,53883672,54276888,84944
2,ENSG00000228802.1,223967706,chr2-223957952-T-C,rs1347818,-1,T,C,223957952,9754,223771098,224164314,186854
2,ENSG00000205086.5,41956806,chr2-41877189-T-G,rs13639,-1,T,G,41877189,79617,41760198,42153414,116991
2,ENSG00000225889.2,64143239,chr2-64248838-G-A,rs1365482,1,G,A,64248838,105599,63946631,64339847,302207
2,ENSG00000172965.6,111495070,chr2-111566252-C-A,rs139586558,-1,C,A,111566252,71182,111298462,111691678,267790
2,ENSG00000204993.3,52570648,chr2-52380174-C-G,rs1424809,1,C,G,52380174,190474,52374040,52767256,6134
2,ENSG00000237641.1,231789887,chr2-231896307-A-G,rs16828492,-1,A,G,231896307,106420,231593279,231986495,303028
2,ENSG00000223466.1,195532945,chr2-195518785-T-C,rs16836823,1,T,C,195518785,14160,195336337,195729553,182448
2,ENSG00000235335.2,167941178,chr2-167896377-A-G,rs16854364,-1,A,G,167896377,44801,167744570,168137786,151807
2,ENSG00000235042.1,216412696,chr2-216592048-T-C,rs16856407,-1,T,C,216592048,179352,216216088,216609304,375960
2,ENSG00000236449.1,174547141,chr2-174569003-G-A,rs16862722,1,G,A,174569003,21862,174350533,174743749,218470
2,ENSG00000226539.1,223704621,chr2-223697943-C-A,rs16865100,1,C,A,223697943,6678,223508013,223901229,189930
2,ENSG00000235267.1,27455156,chr2-27389375-G-C,rs17006049,1,G,C,27389375,65781,27258548,27651764,130827
2,ENSG00000235267.1,27455156,chr2-27389375-G-A,rs17006049,1,G,A,27389375,65781,27258548,27651764,130827
2,ENSG00000237883.1,73981441,chr2-73992908-G-A,rs17009553,-1,G,A,73992908,11467,73784833,74178049,208075
2,ENSG00000237883.1,73981441,chr2-73992908-G-T,rs17009553,-1,G,T,73992908,11467,73784833,74178049,208075
2,ENSG00000227259.1,100591324,chr2-100764261-C-T,rs17024707,-1,C,T,100764261,172937,100394716,100787932,369545
2,ENSG00000236913.1,42469817,chr2-42641314-A-G,rs17029811,1,A,G,42641314,171497,42273209,42666425,368105
2,ENSG00000226508.1,105144142,chr2-104996243-G-A,rs17030487,1,G,A,104996243,147899,104947534,105340750,48709
2,ENSG00000238273.2,105363038,chr2-105366551-T-C,rs17030821,1,T,C,105366551,3513,105166430,105559646,200121
2,ENSG00000231259.2,87052992,chr2-87094919-G-A,rs17041053,-1,G,A,87094919,41927,86856384,87249600,238535
2,ENSG00000236124.1,112981434,chr2-113173287-A-G,rs17043031,-1,A,G,113173287,191853,112784826,113178042,388461
2,ENSG00000203327.2,55216126,chr2-55232237-T-G,rs17046778,-1,T,G,55232237,16111,55019518,55412734,212719
2,ENSG00000203327.2,55216126,chr2-55232237-T-C,rs17046778,-1,T,C,55232237,16111,55019518,55412734,212719
2,ENSG00000231312.2,39437433,chr2-39508321-C-G,rs17467001,1,C,G,39508321,70888,39240825,39634041,267496
2,ENSG00000224376.1,231388976,chr2-231394665-G-A,rs17513198,1,G,A,231394665,5689,231192368,231585584,202297
2,ENSG00000224839.1,208057745,chr2-208010631-C-T,rs17537823,-1,C,T,208010631,47114,207861137,208254353,149494
2,ENSG00000226833.1,28751600,chr2-28680495-A-C,rs17691678,-1,A,C,28680495,71105,28554992,28948208,125503
2,ENSG00000229056.1,196260024,chr2-196260096-A-G,rs17827837,1,A,G,196260096,72,196063416,196456632,196680
2,ENSG00000232713.1,60938604,chr2-60975034-C-G,rs1864268,-1,C,G,60975034,36430,60741996,61135212,233038
2,ENSG00000232931.1,95833963,chr2-95719987-A-G,rs1989620,-1,A,G,95719987,113976,95637355,96030571,82632
2,ENSG00000229127.1,210030733,chr2-210088343-G-A,rs2041654,1,G,A,210088343,57610,209834125,210227341,254218
2,ENSG00000260804.1,216217045,chr2-216179219-A-G,rs207941,1,A,G,216179219,37826,216020437,216413653,158782
2,ENSG00000257800.1,74120680,chr2-74131774-C-T,rs2122290,1,C,T,74131774,11094,73924072,74317288,207702
2,ENSG00000217702.1,74123965,chr2-74131774-C-T,rs2122290,1,C,T,74131774,7809,73927357,74320573,204417
2,ENSG00000204792.2,74918148,chr2-74956130-G-A,rs2129604,1,G,A,74956130,37982,74721540,75114756,234590
2,ENSG00000244563.1,127847084,chr2-127862798-T-C,rs2261682,-1,T,C,127862798,15714,127650476,128043692,212322
2,ENSG00000233870.1,71178587,chr2-71067924-A-C,rs2287329,1,A,C,71067924,110663,70981979,71375195,85945
2,ENSG00000235833.1,97524976,chr2-97657198-A-G,rs2290124,-1,A,G,97657198,132222,97328368,97721584,328830
2,ENSG00000232613.1,65030747,chr2-65056040-G-A,rs2302647,1,G,A,65056040,25293,64834139,65227355,221901
2,ENSG00000186235.6,238231585,chr2-238273263-A-G,rs2304674,-1,A,G,238273263,41678,238034977,238428193,238286
2,ENSG00000224891.1,37148530,chr2-37149171-G-C,rs2307466,1,G,C,37149171,641,36951922,37345138,197249
2,ENSG00000233654.1,190534855,chr2-190423345-G-T,rs2354877,1,G,T,190423345,111510,190338247,190731463,85098
2,ENSG00000261338.1,218255319,chr2-218286495-A-C,rs2382817,1,A,C,218286495,31176,218058711,218451927,227784
2,ENSG00000228590.1,60439828,chr2-60338433-T-C,rs243091,-1,T,C,60338433,101395,60243220,60636436,95213
2,ENSG00000227799.1,55224280,chr2-55244271-T-C,rs2589083,1,T,C,55244271,19991,55027672,55420888,216599
2,ENSG00000243264.1,89947512,chr2-90067648-A-T,rs2693240,1,A,T,90067648,120136,89750904,90144120,316744
2,ENSG00000243264.1,89947512,chr2-90067648-A-C,rs2693240,1,A,C,90067648,120136,89750904,90144120,316744
2,ENSG00000230406.1,221592441,chr2-221606293-T-G,rs2710525,1,T,G,221606293,13852,221395833,221789049,210460
2,ENSG00000257135.1,10448689,chr2-10440401-C-T,rs28362418,1,C,T,10440401,8288,10252081,10645297,188320
2,ENSG00000260942.1,240586699,chr2-240577199-A-G,rs2953177,-1,A,G,240577199,9500,240390091,240783307,187108
2,ENSG00000228925.1,46899275,chr2-46918907-G-A,rs3087857,1,G,A,46918907,19632,46702667,47095883,216240
2,ENSG00000231890.1,135985124,chr2-135899682-T-C,rs309152,1,T,C,135899682,85442,135788516,136181732,111166
2,ENSG00000233296.1,680081,chr2-677295-C-T,rs3210390,1,C,T,677295,2786,483473,876689,193822
2,ENSG00000227270.1,107903964,chr2-107995735-A-G,rs333214,1,A,G,107995735,91771,107707356,108100572,288379
2,ENSG00000236502.1,44941916,chr2-44758772-A-C,rs343945,-1,A,C,44758772,183144,44745308,45138524,13464
2,ENSG00000186825.3,131796178,chr2-131652488-C-T,rs35927124,-1,C,T,131652488,143690,131599570,131992786,52918
2,ENSG00000234174.1,113175337,chr2-113179986-A-G,rs3762494,-1,A,G,113179986,4649,112978729,113371945,201257
2,ENSG00000224137.1,207662376,chr2-207659476-A-G,rs3845812,1,A,G,207659476,2900,207465768,207858984,193708
2,ENSG00000237784.1,234329483,chr2-234503932-G-A,rs3935712,1,G,A,234503932,174449,234132875,234526091,371057
2,ENSG00000230002.1,73456764,chr2-73314705-G-A,rs41451449,1,G,A,73314705,142059,73260156,73653372,54549
2,ENSG00000231851.1,105102968,chr2-105171090-C-T,rs4241219,-1,C,T,105171090,68122,104906360,105299576,264730
2,ENSG00000260077.1,10040663,chr2-10053051-C-A,rs4444493,-1,C,A,10053051,12388,9844055,10237271,208996
2,ENSG00000234171.1,3558439,chr2-3561166-T-C,rs4583476,1,T,C,3561166,2727,3361831,3755047,199335
2,ENSG00000225234.1,3482409,chr2-3478086-G-T,rs4641971,-1,G,T,3478086,4323,3285801,3679017,192285
2,ENSG00000231908.1,208255214,chr2-208370648-G-A,rs4673402,1,G,A,208370648,115434,208058606,208451822,312042
2,ENSG00000231672.2,217756593,chr2-217794347-T-C,rs4674213,-1,T,C,217794347,37754,217559985,217953201,234362
2,ENSG00000236348.1,17385091,chr2-17325517-A-G,rs4832491,1,A,G,17325517,59574,17188483,17581699,137034
2,ENSG00000237753.1,112645720,chr2-112642218-T-C,rs4849090,-1,T,C,112642218,3502,112449112,112842328,193106
2,ENSG00000236397.2,113601261,chr2-113692451-G-A,rs4849261,-1,G,A,113692451,91190,113404653,113797869,287798
2,ENSG00000228857.2,113890937,chr2-113833617-A-G,rs4849290,-1,A,G,113833617,57320,113694329,114087545,139288
2,ENSG00000259848.1,94892756,chr2-94868063-C-T,rs4854233,-1,C,T,94868063,24693,94696148,95089364,171915
2,ENSG00000236431.1,95536495,chr2-95718829-C-G,rs4907275,-1,C,G,95718829,182334,95339887,95733103,378942
2,ENSG00000261186.1,242088457,chr2-242078572-G-A,rs4973686,-1,G,A,242078572,9885,241891849,242285065,186723
2,ENSG00000261186.1,242088457,chr2-242078572-G-T,rs4973686,-1,G,T,242078572,9885,241891849,242285065,186723
2,ENSG00000231414.1,70254010,chr2-70079228-A-C,rs56126702,-1,A,C,70079228,174782,70057402,70450618,21826
2,ENSG00000236790.1,8324630,chr2-8268050-A-G,rs56129208,-1,A,G,8268050,56580,8128022,8521238,140028
2,ENSG00000232531.2,91748986,chr2-91748437-G-A,rs58198317,-1,G,A,91748437,549,91552378,91945594,196059
2,ENSG00000223703.1,91736726,chr2-91748437-G-A,rs58198317,1,G,A,91748437,11711,91540118,91933334,208319
2,ENSG00000214329.2,91931714,chr2-91748437-G-A,rs58198317,-1,G,A,91748437,183277,91735106,92128322,13331
2,ENSG00000232992.2,138902747,chr2-138783495-C-T,rs60663874,-1,C,T,138783495,119252,138706139,139099355,77356
2,ENSG00000233806.2,241881366,chr2-241943048-A-G,rs6605261,1,A,G,241943048,61682,241684758,242077974,258290
2,ENSG00000235151.1,241844380,chr2-241796572-G-A,rs66492541,1,G,A,241796572,47808,241647772,242040988,148800
2,ENSG00000225787.1,85102694,chr2-85291151-C-T,rs6706073,-1,C,T,85291151,188457,84906086,85299302,385065
2,ENSG00000232485.2,216498761,chr2-216427610-C-T,rs6711638,-1,C,T,216427610,71151,216302153,216695369,125457
2,ENSG00000229267.1,214810209,chr2-214802180-T-C,rs6712055,1,T,C,214802180,8029,214613601,215006817,188579
2,ENSG00000237940.2,241970683,chr2-241987082-T-G,rs6712567,1,T,G,241987082,16399,241774075,242167291,213007
2,ENSG00000230408.3,200812170,chr2-200625113-C-T,rs6720189,-1,C,T,200625113,187057,200615562,201008778,9551
2,ENSG00000213222.3,131724279,chr2-131682500-G-C,rs6720375,-1,G,C,131682500,41779,131527671,131920887,154829
2,ENSG00000197927.7,131722417,chr2-131682500-G-C,rs6720375,1,G,C,131682500,39917,131525809,131919025,156691
2,ENSG00000233045.1,138278574,chr2-138253203-T-G,rs6734558,1,T,G,138253203,25371,138081966,138475182,171237
2,ENSG00000233266.1,54051334,chr2-54129214-T-C,rs6751105,1,T,C,54129214,77880,53854726,54247942,274488
2,ENSG00000238062.1,230996031,chr2-230822591-A-C,rs6760721,-1,A,C,230822591,173440,230799423,231192639,23168
2,ENSG00000238062.1,230996031,chr2-230822591-A-T,rs6760721,-1,A,T,230822591,173440,230799423,231192639,23168
2,ENSG00000225439.2,74148079,chr2-74217304-A-T,rs702462,1,A,T,74217304,69225,73951471,74344687,265833
2,ENSG00000230385.1,230908852,chr2-230946983-A-G,rs7340358,1,A,G,230946983,38131,230712244,231105460,234739
2,ENSG00000226806.1,135820191,chr2-135830461-C-A,rs73957037,1,C,A,135830461,10270,135623583,136016799,206878
2,ENSG00000226853.1,174487387,chr2-174503602-C-T,rs73975139,1,C,T,174503602,16215,174290779,174683995,212823
2,ENSG00000237638.1,65056168,chr2-64905574-T-C,rs7423214,-1,T,C,64905574,150594,64859560,65252776,46014
2,ENSG00000234572.1,64863626,chr2-64905574-T-C,rs7423214,-1,T,C,64905574,41948,64667018,65060234,238556
2,ENSG00000213055.3,232730198,chr2-232576992-A-C,rs74453786,-1,A,C,232576992,153206,232533590,232926806,43402
2,ENSG00000180178.5,130040560,chr2-129891576-G-T,rs75407243,-1,G,T,129891576,148984,129843952,130237168,47624
2,ENSG00000214330.4,91840601,chr2-91737435-T-A,rs7559391,1,T,A,91737435,103166,91643993,92037209,93442
2,ENSG00000227497.1,91877969,chr2-91737435-T-A,rs7559391,1,T,A,91737435,140534,91681361,92074577,56074
2,ENSG00000224272.2,241810637,chr2-241773455-G-T,rs7563672,-1,G,T,241773455,37182,241614029,242007245,159426
2,ENSG00000228551.1,109251422,chr2-109440847-G-A,rs7568486,1,G,A,109440847,189425,109054814,109448030,386033
2,ENSG00000242282.2,3536873,chr2-3618353-T-C,rs7571039,-1,T,C,3618353,81480,3340265,3733481,278088
2,ENSG00000234028.2,88627539,chr2-88595833-T-C,rs7571971,1,T,C,88595833,31706,88430931,88824147,164902
2,ENSG00000231546.1,236409077,chr2-236321004-C-G,rs75812139,-1,C,G,236321004,88073,236212469,236605685,108535
2,ENSG00000188765.6,3617757,chr2-3524018-A-G,rs75827652,-1,A,G,3524018,93739,3421149,3814365,102869
2,ENSG00000232238.1,148595158,chr2-148515007-T-C,rs7592968,1,T,C,148515007,80151,148398550,148791766,116457
2,ENSG00000232228.1,69595058,chr2-69419372-G-A,rs7605572,-1,G,A,69419372,175686,69398450,69791666,20922
2,ENSG00000213925.3,203773502,chr2-203590006-T-G,rs7606996,-1,T,G,203590006,183496,203576894,203970110,13112
2,ENSG00000237877.1,186486005,chr2-186577105-G-T,rs76405227,-1,G,T,186577105,91100,186289397,186682613,287708
2,ENSG00000238029.1,100425348,chr2-100292172-A-C,rs764828,1,A,C,100292172,133176,100228740,100621956,63432
2,ENSG00000226340.1,148872797,chr2-148772380-G-C,rs76918096,-1,G,C,148772380,100417,148676189,149069405,96191
2,ENSG00000228203.1,6918709,chr2-6920498-C-T,rs771274,-1,C,T,6920498,1789,6722101,7115317,198397
2,ENSG00000228507.1,171491422,chr2-171586155-T-G,rs78221949,1,T,G,171586155,94733,171294814,171688030,291341
2,ENSG00000227617.2,168786429,chr2-168736637-G-A,rs78837218,-1,G,A,168736637,49792,168589821,168983037,146816
2,ENSG00000224220.1,25421117,chr2-25468623-C-T,rs78853597,1,C,T,25468623,47506,25224509,25617725,244114
2,ENSG00000214657.2,15869939,chr2-15931401-G-C,rs79631687,1,G,C,15931401,61462,15673331,16066547,258070
2,ENSG00000229689.1,95525345,chr2-95665873-C-A,rs79726494,1,C,A,95665873,140528,95328737,95721953,337136
2,ENSG00000220804.4,242094894,chr2-241972899-C-T,rs79903379,1,C,T,241972899,121995,241898286,242291502,74613
2,ENSG00000227653.1,128519177,chr2-128527313-C-T,rs841082,-1,C,T,128527313,8136,128322569,128715785,204744
2,ENSG00000237522.1,60938049,chr2-60909363-A-C,rs842616,-1,A,C,60909363,28686,60741441,61134657,167922
2,ENSG00000225523.2,90021567,chr2-90077265-C-T,rs859750,1,C,T,90077265,55698,89824959,90218175,252306
2,ENSG00000230395.1,87120980,chr2-87314821-A-C,rs908770,-1,A,C,87314821,193841,86924372,87317588,390449
2,ENSG00000236255.1,117833937,chr2-117869524-T-C,rs9677816,1,T,C,117869524,35587,117637329,118030545,232195
2,ENSG00000235616.1,187825341,chr2-187659657-A-G,rs10166232,1,A,G,187659657,165684,187628733,188021949,30924
2,ENSG00000226928.1,111296046,chr2-111177400-C-T,rs10169613,-1,C,T,111177400,118646,111099438,111492654,77962
2,ENSG00000225062.1,218367885,chr2-218172874-T-C,rs10175470,-1,T,C,218172874,195011,218171277,218564493,1597
2,ENSG00000226491.1,42798712,chr2-42797402-G-A,rs10186492,-1,G,A,42797402,1310,42602104,42995320,195298
2,ENSG00000225234.1,3482409,chr2-3476188-T-C,rs10188054,-1,T,C,3476188,6221,3285801,3679017,190387
2,ENSG00000232531.2,91748986,chr2-91893614-G-A,rs10200611,-1,G,A,91893614,144628,91552378,91945594,341236
2,ENSG00000232531.2,91748986,chr2-91893614-G-T,rs10200611,-1,G,T,91893614,144628,91552378,91945594,341236
2,ENSG00000214329.2,91931714,chr2-91893614-G-A,rs10200611,-1,G,A,91893614,38100,91735106,92128322,158508
2,ENSG00000214329.2,91931714,chr2-91893614-G-T,rs10200611,-1,G,T,91893614,38100,91735106,92128322,158508
2,ENSG00000213055.3,232730198,chr2-232834705-G-A,rs10211596,-1,G,A,232834705,104507,232533590,232926806,301115
2,ENSG00000244063.1,113831119,chr2-113843665-T-C,rs1028246,-1,T,C,113843665,12546,113634511,114027727,209154
2,ENSG00000224891.1,37148530,chr2-37030243-T-C,rs10495869,1,T,C,37030243,118287,36951922,37345138,78321
2,ENSG00000225787.1,85102694,chr2-85148068-T-G,rs10520405,-1,T,G,85148068,45374,84906086,85299302,241982
2,ENSG00000260059.1,138602426,chr2-138671498-G-A,rs10803570,-1,G,A,138671498,69072,138405818,138799034,265680
2,ENSG00000224287.1,233868230,chr2-233850773-C-G,rs10929310,-1,C,G,233850773,17457,233671622,234064838,179151
2,ENSG00000257135.1,10448689,chr2-10370731-G-A,rs10929656,1,G,A,10370731,77958,10252081,10645297,118650
2,ENSG00000257135.1,10448689,chr2-10370731-G-C,rs10929656,1,G,C,10370731,77958,10252081,10645297,118650
2,ENSG00000234793.1,241755740,chr2-241751260-G-A,rs1106639,-1,G,A,241751260,4480,241559132,241952348,192128
2,ENSG00000189223.7,113235536,chr2-113236840-G-T,rs1110839,1,G,T,113236840,1304,113038928,113432144,197912
2,ENSG00000228925.1,46899275,chr2-46899207-C-T,rs11125102,1,C,T,46899207,68,46702667,47095883,196540
2,ENSG00000228925.1,46899275,chr2-46899207-C-A,rs11125102,1,C,A,46899207,68,46702667,47095883,196540
2,ENSG00000214330.4,91840601,chr2-91874755-A-G,rs111864931,1,A,G,91874755,34154,91643993,92037209,230762
2,ENSG00000214330.4,91840601,chr2-91874755-A-C,rs111864931,1,A,C,91874755,34154,91643993,92037209,230762
2,ENSG00000229127.1,210030733,chr2-209839258-A-G,rs112831177,1,A,G,209839258,191475,209834125,210227341,5133
2,ENSG00000235997.2,30346623,chr2-30351347-G-T,rs113207583,1,G,T,30351347,4724,30150015,30543231,201332
2,ENSG00000240350.1,111491556,chr2-111621136-T-C,rs113835349,1,T,C,111621136,129580,111294948,111688164,326188
2,ENSG00000260942.1,240586699,chr2-240602394-C-T,rs114966520,-1,C,T,240602394,15695,240390091,240783307,212303
2,ENSG00000228802.1,223967706,chr2-223959900-A-G,rs11546405,-1,A,G,223959900,7806,223771098,224164314,188802
2,ENSG00000224041.2,90114838,chr2-90176529-A-T,rs115899805,1,A,T,90176529,61691,89918230,90311446,258299
2,ENSG00000260804.1,216217045,chr2-216088971-C-T,rs116018538,1,C,T,216088971,128074,216020437,216413653,68534
2,ENSG00000225695.1,201063089,chr2-201183400-C-T,rs11674246,1,C,T,201183400,120311,200866481,201259697,316919
2,ENSG00000213126.2,179814251,chr2-179817141-C-T,rs11680455,1,C,T,179817141,2890,179617643,180010859,199498
2,ENSG00000233673.2,86871301,chr2-86855556-C-T,rs11688534,1,C,T,86855556,15745,86674693,87067909,180863
2,ENSG00000225889.2,64143239,chr2-64211945-C-G,rs11690638,1,C,G,64211945,68706,63946631,64339847,265314
2,ENSG00000242076.1,89268506,chr2-89203631-G-A,rs11690913,-1,G,A,89203631,64875,89071898,89465114,131733
2,ENSG00000232713.1,60938604,chr2-60848054-C-T,rs1177206,-1,C,T,60848054,90550,60741996,61135212,106058
2,ENSG00000227497.1,91877969,chr2-91920044-A-C,rs118061427,1,A,C,91920044,42075,91681361,92074577,238683
2,ENSG00000223977.1,83219105,chr2-83400097-C-T,rs11903895,-1,C,T,83400097,180992,83022497,83415713,377600
2,ENSG00000224184.1,12007128,chr2-12082153-C-G,rs12465663,1,C,G,12082153,75025,11810520,12203736,271633
2,ENSG00000229647.1,207166120,chr2-206980105-A-G,rs12477676,1,A,G,206980105,186015,206969512,207362728,10593
2,ENSG00000231890.1,135985124,chr2-135901925-T-C,rs12478902,1,T,C,135901925,83199,135788516,136181732,113409
2,ENSG00000234171.1,3558439,chr2-3557878-A-G,rs12711976,1,A,G,3557878,561,3361831,3755047,196047
2,ENSG00000246575.2,85315041,chr2-85304684-C-A,rs12714139,1,C,A,85304684,10357,85118433,85511649,186251
2,ENSG00000235688.1,951502,chr2-836197-T-C,rs12714424,-1,T,C,836197,115305,754894,1148110,81303
2,ENSG00000241244.1,90100236,chr2-90189822-A-C,rs12986609,1,A,C,90189822,89586,89903628,90296844,286194
2,ENSG00000242580.1,90209873,chr2-90201608-G-A,rs13003799,1,G,A,90201608,8265,90013265,90406481,188343
2,ENSG00000237638.1,65056168,chr2-64903791-C-T,rs13022034,-1,C,T,64903791,152377,64859560,65252776,44231
2,ENSG00000228857.2,113890937,chr2-113815946-C-T,rs13026880,-1,C,T,113815946,74991,113694329,114087545,121617
2,ENSG00000186825.3,131796178,chr2-131710381-T-C,rs13391470,-1,T,C,131710381,85797,131599570,131992786,110811
2,ENSG00000226125.1,230700340,chr2-230730929-C-T,rs13396097,-1,C,T,230730929,30589,230503732,230896948,227197
2,ENSG00000260742.1,181891663,chr2-181914457-A-G,rs13405727,-1,A,G,181914457,22794,181695055,182088271,219402
2,ENSG00000226666.1,221961737,chr2-222031137-T-C,rs13419328,1,T,C,222031137,69400,221765129,222158345,266008
2,ENSG00000234350.1,170813670,chr2-170784432-T-C,rs1362487,-1,T,C,170784432,29238,170617062,171010278,167370
2,ENSG00000237745.1,107914948,chr2-108058237-T-C,rs1486176,1,T,C,108058237,143289,107718340,108111556,339897
2,ENSG00000163016.5,73671030,chr2-73511677-A-G,rs1589576,1,A,G,73511677,159353,73474422,73867638,37255
2,ENSG00000228655.2,143572105,chr2-143746125-T-C,rs16822986,-1,T,C,143746125,174020,143375497,143768713,370628
2,ENSG00000213962.2,177998770,chr2-177843429-C-T,rs16865825,-1,C,T,177843429,155341,177802162,178195378,41267
2,ENSG00000228446.1,224500100,chr2-224462855-C-T,rs16865992,-1,C,T,224462855,37245,224303492,224696708,159363
2,ENSG00000217702.1,74123965,chr2-73992908-G-T,rs17009553,1,G,T,73992908,131057,73927357,74320573,65551
2,ENSG00000217702.1,74123965,chr2-73992908-G-A,rs17009553,1,G,A,73992908,131057,73927357,74320573,65551
2,ENSG00000235325.1,107921248,chr2-108077131-C-T,rs17035639,-1,C,T,108077131,155883,107724640,108117856,352491
2,ENSG00000225496.1,111941036,chr2-111865911-A-T,rs17041471,-1,A,T,111865911,75125,111744428,112137644,121483
2,ENSG00000226121.1,161507705,chr2-161406964-T-G,rs17183625,-1,T,G,161406964,100741,161311097,161704313,95867
2,ENSG00000229056.1,196260024,chr2-196258326-C-T,rs17231279,1,C,T,196258326,1698,196063416,196456632,194910
2,ENSG00000229267.1,214810209,chr2-214956856-T-C,rs17492577,1,T,C,214956856,146647,214613601,215006817,343255
2,ENSG00000236878.1,120211054,chr2-120332155-T-C,rs17625845,1,T,C,120332155,121101,120014446,120407662,317709
2,ENSG00000233870.1,71178587,chr2-71002603-A-G,rs1861074,1,A,G,71002603,175984,70981979,71375195,20624
2,ENSG00000128692.7,170751805,chr2-170771166-T-G,rs1861462,1,T,G,170771166,19361,170555197,170948413,215969
2,ENSG00000227368.1,112932625,chr2-113069255-A-G,rs1867833,1,A,G,113069255,136630,112736017,113129233,333238
2,ENSG00000251485.1,232343116,chr2-232507645-C-T,rs1881496,1,C,T,232507645,164529,232146508,232539724,361137
2,ENSG00000224152.1,159615292,chr2-159710999-T-C,rs1972708,1,T,C,159710999,95707,159418684,159811900,292315
2,ENSG00000185078.3,208031953,chr2-207843774-C-A,rs2022148,-1,C,A,207843774,188179,207835345,208228561,8429
2,ENSG00000179818.6,70102909,chr2-70127505-C-T,rs2028879,-1,C,T,70127505,24596,69906301,70299517,221204
2,ENSG00000231158.1,158065545,chr2-158135013-T-G,rs2074954,1,T,G,158135013,69468,157868937,158262153,266076
2,ENSG00000230562.3,157380414,chr2-157285241-T-C,rs2121347,-1,T,C,157285241,95173,157183806,157577022,101435
2,ENSG00000205086.5,41956806,chr2-41932038-G-T,rs2276697,-1,G,T,41932038,24768,41760198,42153414,171840
2,ENSG00000233849.1,70301451,chr2-70301469-T-C,rs2279158,1,T,C,70301469,18,70104843,70498059,196626
2,ENSG00000234572.1,64863626,chr2-64901564-T-C,rs2422354,-1,T,C,64901564,37938,64667018,65060234,234546
2,ENSG00000211632.2,90172802,chr2-90067648-A-C,rs2693240,1,A,C,90067648,105154,89976194,90369410,91454
2,ENSG00000211632.2,90172802,chr2-90067648-A-T,rs2693240,1,A,T,90067648,105154,89976194,90369410,91454
2,ENSG00000228325.2,90234812,chr2-90067648-A-C,rs2693240,1,A,C,90067648,167164,90038204,90431420,29444
2,ENSG00000228325.2,90234812,chr2-90067648-A-T,rs2693240,1,A,T,90067648,167164,90038204,90431420,29444
2,ENSG00000211623.2,89985922,chr2-90067648-A-C,rs2693240,1,A,C,90067648,81726,89789314,90182530,278334
2,ENSG00000211623.2,89985922,chr2-90067648-A-T,rs2693240,1,A,T,90067648,81726,89789314,90182530,278334
2,ENSG00000242766.1,90082635,chr2-89968860-G-A,rs2847917,1,G,A,89968860,113775,89886027,90279243,82833
2,ENSG00000239819.1,90220727,chr2-90190754-A-G,rs2847976,1,A,G,90190754,29973,90024119,90417335,166635
2,ENSG00000230799.1,201762737,chr2-201808220-A-G,rs2882322,1,A,G,201808220,45483,201566129,201959345,242091
2,ENSG00000231848.1,44996413,chr2-45054453-C-T,rs2922017,1,C,T,45054453,58040,44799805,45193021,254648
2,ENSG00000224839.1,208057745,chr2-208243593-C-T,rs34218846,-1,C,T,208243593,185848,207861137,208254353,382456
2,ENSG00000233806.2,241881366,chr2-241822779-T-C,rs34346880,1,T,C,241822779,58587,241684758,242077974,138021
2,ENSG00000230992.2,132352722,chr2-132161850-C-G,rs34528085,1,C,G,132161850,190872,132156114,132549330,5736
2,ENSG00000214465.3,26149204,chr2-25956020-C-T,rs34960191,1,C,T,25956020,193184,25952596,26345812,3424
2,ENSG00000228509.1,190841864,chr2-190701212-T-C,rs35295960,-1,T,C,190701212,140652,190645256,191038472,55956
2,ENSG00000237510.2,95792220,chr2-95700142-T-C,rs35711624,1,T,C,95700142,92078,95595612,95988828,104530
2,ENSG00000204581.2,111114185,chr2-111240679-A-C,rs35718992,-1,A,C,111240679,126494,110917577,111310793,323102
2,ENSG00000232760.1,131836532,chr2-131652488-C-T,rs35927124,-1,C,T,131652488,184044,131639924,132033140,12564
2,ENSG00000224165.1,24972072,chr2-25146354-T-C,rs3731634,1,T,C,25146354,174282,24775464,25168680,370890
2,ENSG00000232625.1,218841599,chr2-218656172-T-C,rs3731872,1,T,C,218656172,185427,218644991,219038207,11181
2,ENSG00000260101.1,64524110,chr2-64587631-A-G,rs3770725,-1,A,G,64587631,63521,64327502,64720718,260129
2,ENSG00000260025.1,36355471,chr2-36358181-G-A,rs3770968,-1,G,A,36358181,2710,36158863,36552079,199318
2,ENSG00000235013.1,230957593,chr2-230813650-C-T,rs3792065,1,C,T,230813650,143943,230760985,231154201,52665
2,ENSG00000235235.4,91817771,chr2-92003556-A-C,rs4116423,1,A,C,92003556,185785,91621163,92014379,382393
2,ENSG00000223816.3,92035000,chr2-92003556-A-C,rs4116423,-1,A,C,92003556,31444,91838392,92231608,165164
2,ENSG00000236397.2,113601261,chr2-113761733-A-G,rs41439449,-1,A,G,113761733,160472,113404653,113797869,357080
2,ENSG00000236432.2,227325164,chr2-227340213-C-T,rs4420693,-1,C,T,227340213,15049,227128556,227521772,211657
2,ENSG00000188765.6,3617757,chr2-3488858-T-C,rs4508632,-1,T,C,3488858,128899,3421149,3814365,67709
2,ENSG00000236682.1,127388202,chr2-127244996-G-A,rs4536600,1,G,A,127244996,143206,127191594,127584810,53402
2,ENSG00000224137.1,207662376,chr2-207643083-C-T,rs4675690,1,C,T,207643083,19293,207465768,207858984,177315
2,ENSG00000231292.4,113406396,chr2-113220359-C-T,rs4849176,1,C,T,113220359,186037,113209788,113603004,10571
2,ENSG00000240356.2,113612247,chr2-113692451-G-A,rs4849261,-1,G,A,113692451,80204,113415639,113808855,276812
2,ENSG00000238029.1,100425348,chr2-100272924-T-C,rs4851282,1,T,C,100272924,152424,100228740,100621956,44184
2,ENSG00000237883.1,73981441,chr2-73975451-T-C,rs4852324,-1,T,C,73975451,5990,73784833,74178049,190618
2,ENSG00000237655.1,177603089,chr2-177685896-A-G,rs61260452,1,A,G,177685896,82807,177406481,177799697,279415
2,ENSG00000228251.1,112590796,chr2-112550173-G-A,rs62158587,1,G,A,112550173,40623,112394188,112787404,155985
2,ENSG00000226553.1,187003377,chr2-187001000-C-T,rs62173501,-1,C,T,187001000,2377,186806769,187199985,194231
2,ENSG00000179997.7,174501952,chr2-174337970-G-A,rs62174228,1,G,A,174337970,163982,174305344,174698560,32626
2,ENSG00000230450.1,131178946,chr2-131028815-T-C,rs6430526,-1,T,C,131028815,150131,130982338,131375554,46477
2,ENSG00000223960.1,178413635,chr2-178240261-G-T,rs6433715,1,G,T,178240261,173374,178217027,178610243,23234
2,ENSG00000215043.2,194130266,chr2-194172579-C-G,rs6434675,-1,C,G,194172579,42313,193933658,194326874,238921
2,ENSG00000237940.2,241970683,chr2-241943048-A-G,rs6605261,1,A,G,241943048,27635,241774075,242167291,168973
2,ENSG00000237753.1,112645720,chr2-112673515-C-T,rs6705487,-1,C,T,112673515,27795,112449112,112842328,224403
2,ENSG00000214657.2,15869939,chr2-15997718-A-G,rs6709176,1,A,G,15997718,127779,15673331,16066547,324387
2,ENSG00000230385.1,230908852,chr2-230887148-G-A,rs6710419,1,G,A,230887148,21704,230712244,231105460,174904
2,ENSG00000226856.1,118186386,chr2-118224458-A-G,rs6715039,-1,A,G,118224458,38072,117989778,118382994,234680
2,ENSG00000223725.1,207529795,chr2-207564627-T-C,rs6740584,-1,T,C,207564627,34832,207333187,207726403,231440
2,ENSG00000229758.1,128199901,chr2-128295922-G-T,rs6744014,1,G,T,128295922,96021,128003293,128396509,292629
2,ENSG00000234936.1,43229573,chr2-43257417-A-G,rs6749927,1,A,G,43257417,27844,43032965,43426181,224452
2,ENSG00000232613.1,65030747,chr2-64923736-C-T,rs6751300,1,C,T,64923736,107011,64834139,65227355,89597
2,ENSG00000243650.1,230507101,chr2-230501847-C-T,rs6751402,1,C,T,230501847,5254,230310493,230703709,191354
2,ENSG00000172974.9,65205108,chr2-65079604-T-C,rs6756260,1,T,C,65079604,125504,65008500,65401716,71104
2,ENSG00000213148.3,173431812,chr2-173442997-C-T,rs72625245,-1,C,T,173442997,11185,173235204,173628420,207793
2,ENSG00000234645.2,138288793,chr2-138264388-C-G,rs72868718,-1,C,G,138264388,24405,138092185,138485401,172203
2,ENSG00000236431.1,95536495,chr2-95727132-A-G,rs72948081,-1,A,G,95727132,190637,95339887,95733103,387245
2,ENSG00000227403.1,161244720,chr2-161236129-G-A,rs7309,1,G,A,161236129,8591,161048112,161441328,188017
2,ENSG00000261338.1,218255319,chr2-218101592-C-T,rs7426289,1,C,T,218101592,153727,218058711,218451927,42881
2,ENSG00000236790.1,8324630,chr2-8212814-C-T,rs74457339,-1,C,T,8212814,111816,8128022,8521238,84792
2,ENSG00000260077.1,10040663,chr2-10128199-T-C,rs75249934,-1,T,C,10128199,87536,9844055,10237271,284144
2,ENSG00000234174.1,113175337,chr2-113215368-A-G,rs752590,-1,A,G,113215368,40031,112978729,113371945,236639
2,ENSG00000233654.1,190534855,chr2-190533277-C-T,rs7556716,1,C,T,190533277,1578,190338247,190731463,195030
2,ENSG00000231043.2,58462032,chr2-58517535-C-T,rs7557639,-1,C,T,58517535,55503,58265424,58658640,252111
2,ENSG00000233757.2,95207521,chr2-95265470-C-T,rs7563350,1,C,T,95265470,57949,95010913,95404129,254557
2,ENSG00000224646.2,74754819,chr2-74916540-G-A,rs7566005,-1,G,A,74916540,161721,74558211,74951427,358329
2,ENSG00000259793.1,233353416,chr2-233370649-G-C,rs7566221,-1,G,C,233370649,17233,233156808,233550024,213841
2,ENSG00000233266.1,54051334,chr2-53989842-C-A,rs7569954,1,C,A,53989842,61492,53854726,54247942,135116
2,ENSG00000231672.2,217756593,chr2-217784764-T-G,rs7577167,-1,T,G,217784764,28171,217559985,217953201,224779
2,ENSG00000224220.1,25421117,chr2-25390277-T-C,rs7577599,1,T,C,25390277,30840,25224509,25617725,165768
2,ENSG00000231908.1,208255214,chr2-208257535-T-C,rs7580715,1,T,C,208257535,2321,208058606,208451822,198929
2,ENSG00000197927.7,131722417,chr2-131739641-T-C,rs7585022,1,T,C,131739641,17224,131525809,131919025,213832
2,ENSG00000182814.6,84290777,chr2-84219069-C-T,rs7590843,1,C,T,84219069,71708,84094169,84487385,124900
2,ENSG00000203387.2,228353215,chr2-228540749-G-A,rs7590961,-1,G,A,228540749,187534,228156607,228549823,384142
2,ENSG00000226539.1,223704621,chr2-223612134-T-G,rs7595351,1,T,G,223612134,92487,223508013,223901229,104121
2,ENSG00000217950.3,131444587,chr2-131350804-A-G,rs7596865,-1,A,G,131350804,93783,131247979,131641195,102825
2,ENSG00000236969.1,91775944,chr2-91885541-C-T,rs7597312,1,C,T,91885541,109597,91579336,91972552,306205
2,ENSG00000223703.1,91736726,chr2-91885541-C-T,rs7597312,1,C,T,91885541,148815,91540118,91933334,345423
2,ENSG00000235522.1,105855240,chr2-105754451-G-C,rs7604409,-1,G,C,105754451,100789,105658632,106051848,95819
2,ENSG00000228590.1,60439828,chr2-60498316-G-C,rs7606173,-1,G,C,60498316,58488,60243220,60636436,255096
2,ENSG00000228043.1,138501698,chr2-138644520-G-A,rs76070861,-1,G,A,138644520,142822,138305090,138698306,339430
2,ENSG00000213222.3,131724279,chr2-131565153-A-C,rs7607806,-1,A,C,131565153,159126,131527671,131920887,37482
2,ENSG00000223935.1,64453798,chr2-64415419-T-C,rs7609154,-1,T,C,64415419,38379,64257190,64650406,158229
2,ENSG00000186235.6,238231585,chr2-238254093-C-T,rs77248397,-1,C,T,238254093,22508,238034977,238428193,219116
2,ENSG00000227799.1,55224280,chr2-55273393-A-G,rs77363231,1,A,G,55273393,49113,55027672,55420888,245721
2,ENSG00000230076.1,214847128,chr2-214870398-A-G,rs777313,1,A,G,214870398,23270,214650520,215043736,219878
2,ENSG00000222041.5,87455506,chr2-87480209-T-G,rs78050112,1,T,G,87480209,24703,87258898,87652114,221311
2,ENSG00000222041.5,87455506,chr2-87480209-T-A,rs78050112,1,T,A,87480209,24703,87258898,87652114,221311
2,ENSG00000204792.2,74918148,chr2-74969604-A-G,rs7881,1,A,G,74969604,51456,74721540,75114756,248064
2,ENSG00000233296.1,680081,chr2-715112-A-G,rs79040397,1,A,G,715112,35031,483473,876689,231639
2,ENSG00000237442.2,41156598,chr2-41030880-C-T,rs79634146,1,C,T,41030880,125718,40959990,41353206,70890
2,ENSG00000233747.1,24334512,chr2-24441196-G-A,rs80325320,1,G,A,24441196,106684,24137904,24531120,303292
2,ENSG00000257800.1,74120680,chr2-74128117-G-A,rs828842,1,G,A,74128117,7437,73924072,74317288,204045
2,ENSG00000228551.1,109251422,chr2-109325750-A-G,rs891415,1,A,G,109325750,74328,109054814,109448030,270936
2,ENSG00000222020.2,239401703,chr2-239340592-T-C,rs908265,1,T,C,239340592,61111,239205095,239598311,135497
2,ENSG00000238165.1,50829678,chr2-50691829-T-C,rs9309190,-1,T,C,50691829,137849,50633070,51026286,58759
2,ENSG00000231969.1,149587673,chr2-149677380-T-C,rs962097,1,T,C,149677380,89707,149391065,149784281,286315
2,ENSG00000229781.1,142854095,chr2-142834540-A-G,rs966624,1,A,G,142834540,19555,142657487,143050703,177053
2,ENSG00000228590.1,60439828,chr2-60346171-C-A,rs10168270,-1,C,A,60346171,93657,60243220,60636436,102951
2,ENSG00000228590.1,60439828,chr2-60346171-C-T,rs10168270,-1,C,T,60346171,93657,60243220,60636436,102951
2,ENSG00000235325.1,107921248,chr2-107980068-A-C,rs10181373,-1,A,C,107980068,58820,107724640,108117856,255428
2,ENSG00000235480.1,96532306,chr2-96721089-C-A,rs10189727,-1,C,A,96721089,188783,96335698,96728914,385391
2,ENSG00000228551.1,109251422,chr2-109268953-G-A,rs10195035,1,G,A,109268953,17531,109054814,109448030,214139
2,ENSG00000228551.1,109251422,chr2-109268953-G-C,rs10195035,1,G,C,109268953,17531,109054814,109448030,214139
2,ENSG00000230572.1,91714745,chr2-91893614-G-A,rs10200611,-1,G,A,91893614,178869,91518137,91911353,375477
2,ENSG00000230572.1,91714745,chr2-91893614-G-T,rs10200611,-1,G,T,91893614,178869,91518137,91911353,375477
2,ENSG00000223816.3,92035000,chr2-91893614-G-A,rs10200611,-1,G,A,91893614,141386,91838392,92231608,55222
2,ENSG00000223816.3,92035000,chr2-91893614-G-T,rs10200611,-1,G,T,91893614,141386,91838392,92231608,55222
2,ENSG00000236969.1,91775944,chr2-91893614-G-A,rs10200611,1,G,A,91893614,117670,91579336,91972552,314278
2,ENSG00000236969.1,91775944,chr2-91893614-G-T,rs10200611,1,G,T,91893614,117670,91579336,91972552,314278
2,ENSG00000235235.4,91817771,chr2-91893614-G-A,rs10200611,1,G,A,91893614,75843,91621163,92014379,272451
2,ENSG00000235235.4,91817771,chr2-91893614-G-T,rs10200611,1,G,T,91893614,75843,91621163,92014379,272451
2,ENSG00000229267.1,214810209,chr2-214933778-G-A,rs10208498,1,G,A,214933778,123569,214613601,215006817,320177
2,ENSG00000238062.1,230996031,chr2-230987679-G-A,rs1060780,-1,G,A,230987679,8352,230799423,231192639,188256
2,ENSG00000236397.2,113601261,chr2-113689607-A-G,rs11123205,-1,A,G,113689607,88346,113404653,113797869,284954
2,ENSG00000234488.1,63684305,chr2-63796060-A-G,rs111742389,1,A,G,63796060,111755,63487697,63880913,308363
2,ENSG00000180178.5,130040560,chr2-130159332-G-T,rs112307532,-1,G,T,130159332,118772,129843952,130237168,315380
2,ENSG00000211611.2,89160366,chr2-89186851-G-T,rs112901007,-1,G,T,89186851,26485,88963758,89356974,223093
2,ENSG00000181798.2,231514396,chr2-231461706-C-T,rs1131171,-1,C,T,231461706,52690,231317788,231711004,143918
2,ENSG00000018607.5,132309309,chr2-132424239-C-A,rs114746223,1,C,A,132424239,114930,132112701,132505917,311538
2,ENSG00000239855.1,88966767,chr2-88809128-C-T,rs115789219,-1,C,T,88809128,157639,88770159,89163375,38969
2,ENSG00000241244.1,90100236,chr2-90108556-C-A,rs116171884,1,C,A,90108556,8320,89903628,90296844,204928
2,ENSG00000246575.2,85315041,chr2-85441865-A-G,rs11682343,1,A,G,85441865,126824,85118433,85511649,323432
2,ENSG00000234936.1,43229573,chr2-43363760-G-A,rs11694173,1,G,A,43363760,134187,43032965,43426181,330795
2,ENSG00000214330.4,91840601,chr2-91920044-A-C,rs118061427,1,A,C,91920044,79443,91643993,92037209,276051
2,ENSG00000228203.1,6918709,chr2-6918805-A-G,rs118107744,-1,A,G,6918805,96,6722101,7115317,196704
2,ENSG00000230482.1,197263111,chr2-197206063-A-G,rs11885072,1,A,G,197206063,57048,197066503,197459719,139560
2,ENSG00000260077.1,10040663,chr2-10100048-G-A,rs11897268,-1,G,A,10100048,59385,9844055,10237271,255993
2,ENSG00000237039.1,231256097,chr2-231368990-A-G,rs12468313,1,A,G,231368990,112893,231059489,231452705,309501
2,ENSG00000224875.2,42170231,chr2-42034731-A-G,rs12473667,-1,A,G,42034731,135500,41973623,42366839,61108
2,ENSG00000231890.1,135985124,chr2-136028199-T-G,rs12619854,1,T,G,136028199,43075,135788516,136181732,239683
2,ENSG00000234431.2,201166965,chr2-201131056-A-G,rs12620435,1,A,G,201131056,35909,200970357,201363573,160699
2,ENSG00000237951.1,26162056,chr2-26327361-C-G,rs12621217,1,C,G,26327361,165305,25965448,26358664,361913
2,ENSG00000228509.1,190841864,chr2-190748467-A-T,rs1263118,-1,A,T,190748467,93397,190645256,191038472,103211
2,ENSG00000228509.1,190841864,chr2-190748467-A-G,rs1263118,-1,A,G,190748467,93397,190645256,191038472,103211
2,ENSG00000240286.1,209178804,chr2-209147975-A-C,rs12999691,1,A,C,209147975,30829,208982196,209375412,165779
2,ENSG00000231609.1,63047656,chr2-63026921-A-C,rs13004408,-1,A,C,63026921,20735,62851048,63244264,175873
2,ENSG00000228305.1,63622831,chr2-63579836-G-A,rs13008892,-1,G,A,63579836,42995,63426223,63819439,153613
2,ENSG00000186825.3,131796178,chr2-131626766-C-T,rs13011244,-1,C,T,131626766,169412,131599570,131992786,27196
2,ENSG00000213236.3,126558162,chr2-126439679-C-T,rs13031986,-1,C,T,126439679,118483,126361554,126754770,78125
2,ENSG00000228236.1,149068910,chr2-148908504-C-T,rs13032506,-1,C,T,148908504,160406,148872302,149265518,36202
2,ENSG00000231822.1,99102018,chr2-99179382-A-C,rs13404012,1,A,C,99179382,77364,98905410,99298626,273972
2,ENSG00000213553.3,38481851,chr2-38495907-G-A,rs13424546,1,G,A,38495907,14056,38285243,38678459,210664
2,ENSG00000241114.1,54080280,chr2-54048054-A-C,rs13426329,-1,A,C,54048054,32226,53883672,54276888,164382
2,ENSG00000237732.4,222318275,chr2-222257271-C-T,rs1367416,1,C,T,222257271,61004,222121667,222514883,135604
2,ENSG00000231327.1,70132923,chr2-70316254-T-C,rs1382457,-1,T,C,70316254,183331,69936315,70329531,379939
2,ENSG00000223960.1,178413635,chr2-178327865-C-A,rs1434084,1,C,A,178327865,85770,178217027,178610243,110838
2,ENSG00000260101.1,64524110,chr2-64696674-C-T,rs1477034,-1,C,T,64696674,172564,64327502,64720718,369172
2,ENSG00000228446.1,224500100,chr2-224638384-A-G,rs1565074,-1,A,G,224638384,138284,224303492,224696708,334892
2,ENSG00000162997.10,55282329,chr2-55436985-G-A,rs1598163,1,G,A,55436985,154656,55085721,55478937,351264
2,ENSG00000213126.2,179814251,chr2-179677016-G-A,rs16866917,1,G,A,179677016,137235,179617643,180010859,59373
2,ENSG00000228784.1,19868874,chr2-19678433-C-A,rs16986826,1,C,A,19678433,190441,19672266,20065482,6167
2,ENSG00000217702.1,74123965,chr2-74143485-T-C,rs17009668,1,T,C,74143485,19520,73927357,74320573,216128
2,ENSG00000236213.1,37562486,chr2-37636926-G-T,rs17021160,1,G,T,37636926,74440,37365878,37759094,271048
2,ENSG00000223725.1,207529795,chr2-207390794-A-G,rs17203016,-1,A,G,207390794,139001,207333187,207726403,57607
2,ENSG00000226276.1,215941719,chr2-216001408-C-T,rs17314497,-1,C,T,216001408,59689,215745111,216138327,256297
2,ENSG00000236790.1,8324630,chr2-8143879-T-A,rs17389729,-1,T,A,8143879,180751,8128022,8521238,15857
2,ENSG00000236330.1,110967834,chr2-110983094-C-T,rs17481486,1,C,T,110983094,15260,110771226,111164442,211868
2,ENSG00000227368.1,112932625,chr2-113082279-C-T,rs17611872,1,C,T,113082279,149654,112736017,113129233,346262
2,ENSG00000185078.3,208031953,chr2-207985508-C-A,rs17640594,-1,C,A,207985508,46445,207835345,208228561,150163
2,ENSG00000224041.2,90114838,chr2-90006438-C-A,rs17704088,1,C,A,90006438,108400,89918230,90311446,88208
2,ENSG00000238133.2,173271620,chr2-173173274-T-C,rs17710437,-1,T,C,173173274,98346,173075012,173468228,98262
2,ENSG00000228325.2,90234812,chr2-90050455-G-A,rs17842625,1,G,A,90050455,184357,90038204,90431420,12251
2,ENSG00000173209.16,61177539,chr2-61186588-A-T,rs1809028,1,A,T,61186588,9049,60980931,61374147,205657
2,ENSG00000173209.16,61177539,chr2-61186588-A-G,rs1809028,1,A,G,61186588,9049,60980931,61374147,205657
2,ENSG00000177855.8,183608119,chr2-183576327-G-A,rs1919270,-1,G,A,183576327,31792,183411511,183804727,164816
2,ENSG00000226539.1,223704621,chr2-223644473-A-G,rs1982183,1,A,G,223644473,60148,223508013,223901229,136460
2,ENSG00000235499.1,73985132,chr2-74126339-T-A,rs2049453,1,T,A,74126339,141207,73788524,74181740,337815
2,ENSG00000235852.1,190882059,chr2-191010027-T-C,rs2066798,-1,T,C,191010027,127968,190685451,191078667,324576
2,ENSG00000214821.3,170602228,chr2-170591132-T-C,rs2110733,-1,T,C,170591132,11096,170405620,170798836,185512
2,ENSG00000253559.1,189762704,chr2-189954152-G-A,rs2168058,1,G,A,189954152,191448,189566096,189959312,388056
2,ENSG00000235064.1,33840678,chr2-33690999-C-T,rs2197804,-1,C,T,33690999,149679,33644070,34037286,46929
2,ENSG00000205086.5,41956806,chr2-41901721-C-G,rs2374338,-1,C,G,41901721,55085,41760198,42153414,141523
2,ENSG00000250207.1,129993105,chr2-129901142-T-C,rs2407072,-1,T,C,129901142,91963,129796497,130189713,104645
2,ENSG00000211625.2,90038848,chr2-90067648-A-T,rs2693240,1,A,T,90067648,28800,89842240,90235456,225408
2,ENSG00000211625.2,90038848,chr2-90067648-A-C,rs2693240,1,A,C,90067648,28800,89842240,90235456,225408
2,ENSG00000228380.1,208269957,chr2-208147143-T-G,rs2854711,-1,T,G,208147143,122814,208073349,208466565,73794
2,ENSG00000233296.1,680081,chr2-686675-G-T,rs2867117,1,G,T,686675,6594,483473,876689,203202
2,ENSG00000235351.1,241725693,chr2-241720283-C-T,rs34016185,-1,C,T,241720283,5410,241529085,241922301,191198
2,ENSG00000235688.1,951502,chr2-794979-T-C,rs34416867,-1,T,C,794979,156523,754894,1148110,40085
2,ENSG00000178162.4,130431363,chr2-130373952-C-T,rs3739122,-1,C,T,130373952,57411,130234755,130627971,139197
2,ENSG00000227403.1,161244720,chr2-161420790-G-A,rs3769956,1,G,A,161420790,176070,161048112,161441328,372678
2,ENSG00000214329.2,91931714,chr2-92003556-A-C,rs4116423,-1,A,C,92003556,71842,91735106,92128322,268450
2,ENSG00000233673.2,86871301,chr2-86829682-A-G,rs4240205,1,A,G,86829682,41619,86674693,87067909,154989
2,ENSG00000226491.1,42798712,chr2-42851530-C-T,rs4277572,-1,C,T,42851530,52818,42602104,42995320,249426
2,ENSG00000257800.1,74120680,chr2-74169564-G-A,rs4527231,1,G,A,74169564,48884,73924072,74317288,245492
2,ENSG00000257800.1,74120680,chr2-74169564-G-T,rs4527231,1,G,T,74169564,48884,73924072,74317288,245492
2,ENSG00000186235.6,238231585,chr2-238237319-T-C,rs4663865,-1,T,C,238237319,5734,238034977,238428193,202342
2,ENSG00000234572.1,64863626,chr2-64908236-T-C,rs4671628,-1,T,C,64908236,44610,64667018,65060234,241218
2,ENSG00000237638.1,65056168,chr2-64933899-G-A,rs4671632,-1,G,A,64933899,122269,64859560,65252776,74339
2,ENSG00000233868.1,221944223,chr2-221780618-G-A,rs4674611,1,G,A,221780618,163605,221747615,222140831,33003
2,ENSG00000224137.1,207662376,chr2-207480416-T-C,rs4675679,1,T,C,207480416,181960,207465768,207858984,14648
2,ENSG00000234171.1,3558439,chr2-3582979-A-G,rs4850031,1,A,G,3582979,24540,3361831,3755047,221148
2,ENSG00000241962.3,99141485,chr2-99028009-C-T,rs4850895,1,C,T,99028009,113476,98944877,99338093,83132
2,ENSG00000224061.1,106253717,chr2-106073681-G-A,rs4851111,-1,G,A,106073681,180036,106057109,106450325,16572
2,ENSG00000163016.5,73671030,chr2-73700804-A-G,rs4852974,1,A,G,73700804,29774,73474422,73867638,226382
2,ENSG00000213148.3,173431812,chr2-173493136-A-G,rs4972581,-1,A,G,173493136,61324,173235204,173628420,257932
2,ENSG00000214211.2,167716065,chr2-167810591-T-C,rs55759826,-1,T,C,167810591,94526,167519457,167912673,291134
2,ENSG00000214211.2,167716065,chr2-167810591-T-A,rs55759826,-1,T,A,167810591,94526,167519457,167912673,291134
2,ENSG00000236824.1,47335315,chr2-47220182-G-A,rs62138371,1,G,A,47220182,115133,47138707,47531923,81475
2,ENSG00000237745.1,107914948,chr2-107939345-A-G,rs62148672,1,A,G,107939345,24397,107718340,108111556,221005
2,ENSG00000231739.2,187415552,chr2-187314268-C-T,rs62174473,1,C,T,187314268,101284,187218944,187612160,95324
2,ENSG00000213946.3,191882205,chr2-192010777-G-A,rs62181509,-1,G,A,192010777,128572,191685597,192078813,325180
2,ENSG00000235411.1,20241046,chr2-20177631-C-A,rs6419087,-1,C,A,20177631,63415,20044438,20437654,133193
2,ENSG00000235770.1,215843536,chr2-215812189-G-A,rs6435922,-1,G,A,215812189,31347,215646928,216040144,165261
2,ENSG00000225963.1,230121370,chr2-230130610-G-A,rs6436907,1,G,A,230130610,9240,229924762,230317978,205848
2,ENSG00000237298.1,178523221,chr2-178374452-A-G,rs6706483,1,A,G,178374452,148769,178326613,178719829,47839
2,ENSG00000229056.1,196260024,chr2-196250012-C-T,rs6707844,1,C,T,196250012,10012,196063416,196456632,186596
2,ENSG00000233426.2,58251440,chr2-58338366-T-C,rs6708046,1,T,C,58338366,86926,58054832,58448048,283534
2,ENSG00000235042.1,216412696,chr2-216427610-C-T,rs6711638,-1,C,T,216427610,14914,216216088,216609304,211522
2,ENSG00000231351.2,86930754,chr2-86750442-C-A,rs6711850,-1,C,A,86750442,180312,86734146,87127362,16296
2,ENSG00000233806.2,241881366,chr2-241987082-T-G,rs6712567,1,T,G,241987082,105716,241684758,242077974,302324
2,ENSG00000232973.3,38075700,chr2-37947821-A-G,rs6716296,1,A,G,37947821,127879,37879092,38272308,68729
2,ENSG00000250116.2,46580238,chr2-46503001-A-T,rs6719900,-1,A,T,46503001,77237,46383630,46776846,119371
2,ENSG00000259439.1,44939199,chr2-44999443-G-A,rs6724823,-1,G,A,44999443,60244,44742591,45135807,256852
2,ENSG00000228925.1,46899275,chr2-46899331-G-C,rs6727958,1,G,C,46899331,56,46702667,47095883,196664
2,ENSG00000235151.1,241844380,chr2-241768747-C-T,rs6746151,1,C,T,241768747,75633,241647772,242040988,120975
2,ENSG00000231848.1,44996413,chr2-45125493-A-G,rs6757058,1,A,G,45125493,129080,44799805,45193021,325688
2,ENSG00000232508.1,88365608,chr2-88435492-C-T,rs67975102,-1,C,T,88435492,69884,88169000,88562216,266492
2,ENSG00000232508.1,88365608,chr2-88435492-C-A,rs67975102,-1,C,A,88435492,69884,88169000,88562216,266492
2,ENSG00000237784.1,234329483,chr2-234342322-T-C,rs71423637,1,T,C,234342322,12839,234132875,234526091,209447
2,ENSG00000232713.1,60938604,chr2-60996155-T-C,rs717304,-1,T,C,60996155,57551,60741996,61135212,254159
2,ENSG00000224891.1,37148530,chr2-37191478-C-T,rs72792810,1,C,T,37191478,42948,36951922,37345138,239556
2,ENSG00000231546.1,236409077,chr2-236359974-G-A,rs72982610,-1,G,A,236359974,49103,236212469,236605685,147505
2,ENSG00000225889.2,64143239,chr2-64261922-A-T,rs73934421,1,A,T,64261922,118683,63946631,64339847,315291
2,ENSG00000234793.1,241755740,chr2-241804528-G-T,rs741776,-1,G,T,241804528,48788,241559132,241952348,245396
2,ENSG00000224272.2,241810637,chr2-241804528-G-T,rs741776,-1,G,T,241804528,6109,241614029,242007245,190499
2,ENSG00000236695.1,194187379,chr2-194302318-G-A,rs7419322,1,G,A,194302318,114939,193990771,194383987,311547
2,ENSG00000232613.1,65030747,chr2-64870478-C-T,rs75109710,1,C,T,64870478,160269,64834139,65227355,36339
2,ENSG00000243819.1,10690344,chr2-10847969-C-G,rs75379303,1,C,G,10847969,157625,10493736,10886952,354233
2,ENSG00000243819.1,10690344,chr2-10847969-C-T,rs75379303,1,C,T,10847969,157625,10493736,10886952,354233
2,ENSG00000243819.1,10690344,chr2-10847969-C-A,rs75379303,1,C,A,10847969,157625,10493736,10886952,354233
2,ENSG00000182814.6,84290777,chr2-84204865-T-G,rs7589274,1,T,G,84204865,85912,84094169,84487385,110696
2,ENSG00000251491.1,158862311,chr2-158944077-C-T,rs75912194,1,C,T,158944077,81766,158665703,159058919,278374
2,ENSG00000231536.1,110610916,chr2-110797585-G-A,rs7592058,1,G,A,110797585,186669,110414308,110807524,383277
2,ENSG00000227497.1,91877969,chr2-91885541-C-T,rs7597312,1,C,T,91885541,7572,91681361,92074577,204180
2,ENSG00000223466.1,195532945,chr2-195392675-C-A,rs7605057,1,C,A,195392675,140270,195336337,195729553,56338
2,ENSG00000229920.1,63644038,chr2-63821848-A-G,rs7606341,-1,A,G,63821848,177810,63447430,63840646,374418
2,ENSG00000231955.1,206115547,chr2-205957701-G-A,rs76252708,1,G,A,205957701,157846,205918939,206312155,38762
2,ENSG00000213938.3,199659551,chr2-199841705-C-T,rs769964,1,C,T,199841705,182154,199462943,199856159,378762
2,ENSG00000233747.1,24334512,chr2-24342108-G-A,rs77524462,1,G,A,24342108,7596,24137904,24531120,204204
2,ENSG00000260942.1,240586699,chr2-240497919-A-G,rs78557056,-1,A,G,240497919,88780,240390091,240783307,107828
2,ENSG00000260942.1,240586699,chr2-240497919-A-C,rs78557056,-1,A,C,240497919,88780,240390091,240783307,107828
2,ENSG00000233862.1,30140666,chr2-30023656-C-A,rs78840594,-1,C,A,30023656,117010,29944058,30337274,79598
2,ENSG00000224839.1,208057745,chr2-207969767-C-T,rs78972205,-1,C,T,207969767,87978,207861137,208254353,108630
2,ENSG00000239819.1,90220727,chr2-90077265-C-T,rs859750,1,C,T,90077265,143462,90024119,90417335,53146
2,ENSG00000236148.3,64347741,chr2-64410368-G-A,rs868986,-1,G,A,64410368,62627,64151133,64544349,259235
2,ENSG00000189223.7,113235536,chr2-113261552-G-T,rs877202,1,G,T,113261552,26016,113038928,113432144,222624
2,ENSG00000237641.1,231789887,chr2-231862453-G-C,rs878444,-1,G,C,231862453,72566,231593279,231986495,269174
2,ENSG00000227692.1,186364598,chr2-186438149-C-A,rs9288129,1,C,A,186438149,73551,186167990,186561206,270159
2,ENSG00000232485.2,216498761,chr2-216656925-C-T,rs9341191,-1,C,T,216656925,158164,216302153,216695369,354772
2,ENSG00000168129.7,82856826,chr2-82820299-T-C,rs9678502,1,T,C,82820299,36527,82660218,83053434,160081
2,ENSG00000225234.1,3482409,chr2-3493265-G-A,rs9678647,-1,G,A,3493265,10856,3285801,3679017,207464
2,ENSG00000227347.1,136200503,chr2-136150010-A-G,rs9941506,-1,A,G,136150010,50493,136003895,136397111,146115
2,ENSG00000226125.1,230700340,chr2-230708669-A-C,rs9973480,-1,A,C,230708669,8329,230503732,230896948,204937
1,ENSG00000231767.2,192716183,chr1-192777204-A-T,rs1011256,1,A,T,192777204,61021,192519575,192912791,257629
1,ENSG00000234975.4,228687415,chr1-228800328-C-T,rs10218459,1,C,T,228800328,112913,228490807,228884023,309521
1,ENSG00000239670.1,32986952,chr1-33077451-A-G,rs10429857,1,A,G,33077451,90499,32790344,33183560,287107
1,ENSG00000227217.1,157691762,chr1-157699878-G-A,rs10489678,1,G,A,157699878,8116,157495154,157888370,204724
1,ENSG00000227811.2,111739579,chr1-111584677-G-A,rs10494137,1,G,A,111584677,154902,111542971,111936187,41706
1,ENSG00000232022.1,46432129,chr1-46569971-T-C,rs1054743,1,T,C,46569971,137842,46235521,46628737,334450
1,ENSG00000241720.1,109725820,chr1-109739319-G-A,rs10735234,1,G,A,109739319,13499,109529212,109922428,210107
1,ENSG00000261135.1,16514645,chr1-16679211-G-A,rs10907262,1,G,A,16679211,164566,16318037,16711253,361174
1,ENSG00000229820.1,28453541,chr1-28614821-G-A,rs10915181,1,G,A,28614821,161280,28256933,28650149,357888
1,ENSG00000231105.1,21293290,chr1-21305170-G-A,rs10916959,1,G,A,21305170,11880,21096682,21489898,208488
1,ENSG00000135747.7,247078736,chr1-247098200-C-T,rs10924910,-1,C,T,247098200,19464,246882128,247275344,216072
1,ENSG00000244716.2,108992282,chr1-108808209-G-C,rs11102473,1,G,C,108808209,184073,108795674,109188890,12535
1,ENSG00000244716.2,108992282,chr1-108808209-G-A,rs11102473,1,G,A,108808209,184073,108795674,109188890,12535
1,ENSG00000237278.1,113126883,chr1-113136262-A-T,rs11102590,-1,A,T,113136262,9379,112930275,113323491,205987
1,ENSG00000232883.1,220317599,chr1-220300682-A-G,rs11118515,-1,A,G,220300682,16917,220120991,220514207,179691
1,ENSG00000232883.1,220317599,chr1-220300682-A-T,rs11118515,-1,A,T,220300682,16917,220120991,220514207,179691
1,ENSG00000116652.4,63547082,chr1-63391221-C-T,rs11208204,1,C,T,63391221,155861,63350474,63743690,40747
1,ENSG00000185031.5,64986087,chr1-64993523-G-A,rs11208566,-1,G,A,64993523,7436,64789479,65182695,204044
1,ENSG00000225506.2,47179271,chr1-47153042-G-A,rs11211471,-1,G,A,47153042,26229,46982663,47375879,170379
1,ENSG00000223804.1,120341839,chr1-120391914-A-G,rs112145593,-1,A,G,120391914,50075,120145231,120538447,246683
1,ENSG00000180867.9,147178113,chr1-147267177-A-G,rs11239962,1,A,G,147267177,89064,146981505,147374721,285672
1,ENSG00000226457.1,16369530,chr1-16385239-T-C,rs11260740,-1,T,C,16385239,15709,16172922,16566138,212317
1,ENSG00000230163.1,34850694,chr1-34850318-A-G,rs11263919,1,A,G,34850318,376,34654086,35047302,196232
1,ENSG00000233728.1,37800879,chr1-37734325-G-C,rs11264095,-1,G,C,37734325,66554,37604271,37997487,130054
1,ENSG00000232093.1,155046118,chr1-155047234-A-C,rs11264300,-1,A,C,155047234,1116,154849510,155242726,197724
1,ENSG00000230415.1,1275223,chr1-1134155-G-A,rs113355263,1,G,A,1134155,141068,1078615,1471831,55540
1,ENSG00000224870.3,1399515,chr1-1204482-T-C,rs11466691,1,T,C,1204482,195033,1202907,1596123,1575
1,ENSG00000230849.2,173142350,chr1-173127824-T-C,rs11484630,-1,T,C,173127824,14526,172945742,173338958,182082
1,ENSG00000234419.1,222468094,chr1-222437868-C-T,rs11485175,1,C,T,222437868,30226,222271486,222664702,166382
1,ENSG00000236360.1,52993702,chr1-53103558-T-A,rs114930372,-1,T,A,53103558,109856,52797094,53190310,306464
1,ENSG00000227775.1,1735817,chr1-1671797-G-A,rs11523819,1,G,A,1671797,64020,1539209,1932425,132588
1,ENSG00000241666.1,167630674,chr1-167455220-T-C,rs115647472,-1,T,C,167455220,175454,167434066,167827282,21154
1,ENSG00000223583.1,26455187,chr1-26477915-G-C,rs11576300,-1,G,C,26477915,22728,26258579,26651795,219336
1,ENSG00000260360.1,179954705,chr1-179786448-C-T,rs11583659,-1,C,T,179786448,168257,179758097,180151313,28351
1,ENSG00000238145.1,46891639,chr1-46998060-T-G,rs11589889,1,T,G,46998060,106421,46695031,47088247,303029
1,ENSG00000229376.1,722092,chr1-831716-A-G,rs115991721,1,A,G,831716,109624,525484,918700,306232
1,ENSG00000238081.1,89290337,chr1-89131000-A-G,rs11804922,-1,A,G,89131000,159337,89093729,89486945,37271
1,ENSG00000235501.1,94927478,chr1-94935643-A-T,rs11807661,1,A,T,94935643,8165,94730870,95124086,204773
1,ENSG00000235501.1,94927478,chr1-94935643-A-C,rs11807661,1,A,C,94935643,8165,94730870,95124086,204773
1,ENSG00000233184.1,101025846,chr1-100862216-A-G,rs11812031,1,A,G,100862216,163630,100829238,101222454,32978
1,ENSG00000228348.1,35122022,chr1-35225659-G-A,rs1188340,1,G,A,35225659,103637,34925414,35318630,300245
1,ENSG00000181201.2,228464594,chr1-228280757-G-A,rs1188697,-1,G,A,228280757,183837,228267986,228661202,12771
1,ENSG00000223653.1,85277672,chr1-85392440-C-T,rs12033483,1,C,T,85392440,114768,85081064,85474280,311376
1,ENSG00000223776.4,236524508,chr1-236521494-C-T,rs12041958,-1,C,T,236521494,3014,236327900,236721116,193594
1,ENSG00000228126.1,150515757,chr1-150363992-G-T,rs12046899,1,G,T,150363992,151765,150319149,150712365,44843
1,ENSG00000224699.1,110347116,chr1-110431867-A-G,rs12048154,1,A,G,110431867,84751,110150508,110543724,281359
1,ENSG00000218510.3,22024558,chr1-22024054-C-T,rs12061255,1,C,T,22024054,504,21827950,22221166,196104
1,ENSG00000259865.1,247188526,chr1-247190481-T-C,rs12071728,-1,T,C,247190481,1955,246991918,247385134,198563
1,ENSG00000227671.2,247209493,chr1-247190481-T-C,rs12071728,-1,T,C,247190481,19012,247012885,247406101,177596
1,ENSG00000238015.1,78666272,chr1-78566913-A-G,rs12080077,1,A,G,78566913,99359,78469664,78862880,97249
1,ENSG00000227777.1,168542737,chr1-168686483-A-G,rs12090370,1,A,G,168686483,143746,168346129,168739345,340354
1,ENSG00000229757.1,168579439,chr1-168686483-A-G,rs12090370,-1,A,G,168686483,107044,168382831,168776047,303652
1,ENSG00000236646.1,62038842,chr1-62051633-T-G,rs12117302,1,T,G,62051633,12791,61842234,62235450,209399
1,ENSG00000233839.1,113168994,chr1-113049966-C-T,rs12122331,1,C,T,113049966,119028,112972386,113365602,77580
1,ENSG00000255835.1,225924278,chr1-226058772-A-C,rs12126865,-1,A,C,226058772,134494,225727670,226120886,331102
1,ENSG00000260941.1,119599271,chr1-119588974-G-A,rs12139088,-1,G,A,119588974,10297,119402663,119795879,186311
1,ENSG00000228818.1,240145389,chr1-240177019-T-C,rs12145620,-1,T,C,240177019,31630,239948781,240341997,228238
1,ENSG00000215795.2,247185482,chr1-247229840-T-C,rs12145632,-1,T,C,247229840,44358,246988874,247382090,240966
1,ENSG00000225880.4,827539,chr1-818725-C-T,rs12184325,-1,C,T,818725,8814,630931,1024147,187794
1,ENSG00000228327.2,774280,chr1-818725-C-T,rs12184325,-1,C,T,818725,44445,577672,970888,241053
1,ENSG00000177757.1,817371,chr1-818725-C-T,rs12184325,1,C,T,818725,1354,620763,1013979,197962
1,ENSG00000243323.1,202168051,chr1-202174384-A-G,rs12401678,1,A,G,202174384,6333,201971443,202364659,202941
1,ENSG00000173810.8,101271363,chr1-101216494-T-C,rs12404070,-1,T,C,101216494,54869,101074755,101467971,141739
1,ENSG00000261654.1,110942353,chr1-110906029-G-A,rs12564752,-1,G,A,110906029,36324,110745745,111138961,160284
1,ENSG00000260948.1,111433068,chr1-111425694-G-A,rs1264888,-1,G,A,111425694,7374,111236460,111629676,189234
1,ENSG00000237033.1,70661265,chr1-70691978-A-G,rs12731606,-1,A,G,70691978,30713,70464657,70857873,227321
1,ENSG00000233196.1,186581191,chr1-186765480-G-T,rs12734919,-1,G,T,186765480,184289,186384583,186777799,380897
1,ENSG00000260063.1,26694131,chr1-26701730-A-G,rs12743862,-1,A,G,26701730,7599,26497523,26890739,204207
1,ENSG00000232995.2,163321792,chr1-163308255-T-C,rs12746009,-1,T,C,163308255,13537,163125184,163518400,183071
1,ENSG00000224818.1,201465146,chr1-201460297-T-C,rs12753908,-1,T,C,201460297,4849,201268538,201661754,191759
1,ENSG00000237520.1,234957231,chr1-234953983-C-T,rs12754888,1,C,T,234953983,3248,234760623,235153839,193360
1,ENSG00000237520.1,234957231,chr1-234953983-C-G,rs12754888,1,C,G,234953983,3248,234760623,235153839,193360
1,ENSG00000239494.1,169859756,chr1-169691640-A-G,rs12938,1,A,G,169691640,168116,169663148,170056364,28492
1,ENSG00000234614.1,151841877,chr1-151707120-G-A,rs1308153,1,G,A,151707120,134757,151645269,152038485,61851
1,ENSG00000231365.1,119140730,chr1-119041345-T-A,rs1325939,1,T,A,119041345,99385,118944122,119337338,97223
1,ENSG00000203739.3,173489407,chr1-173474134-G-A,rs13376447,-1,G,A,173474134,15273,173292799,173686015,181335
1,ENSG00000243781.1,237926831,chr1-237762517-G-A,rs1357150,1,G,A,237762517,164314,237730223,238123439,32294
1,ENSG00000237842.1,157060762,chr1-157095382-G-A,rs1467662,-1,G,A,157095382,34620,156864154,157257370,231228
1,ENSG00000260805.1,212559731,chr1-212539378-T-C,rs1512847,-1,T,C,212539378,20353,212363123,212756339,176255
1,ENSG00000227001.2,21427967,chr1-21440170-G-C,rs1566523,-1,G,C,21440170,12203,21231359,21624575,208811
1,ENSG00000233427.1,28877336,chr1-28877395-T-C,rs157198,-1,T,C,28877395,59,28680728,29073944,196667
1,ENSG00000231050.1,1891223,chr1-1886690-A-C,rs16824526,1,A,C,1886690,4533,1694615,2087831,192075
1,ENSG00000228549.1,16872281,chr1-16971088-T-C,rs16830783,1,T,C,16971088,98807,16675673,17068889,295415
1,ENSG00000261716.1,149850772,chr1-149995204-G-A,rs16832989,-1,G,A,149995204,144432,149654164,150047380,341040
1,ENSG00000244457.1,236483165,chr1-236510395-A-G,rs16833729,1,A,G,236510395,27230,236286557,236679773,223838
1,ENSG00000238003.1,201978642,chr1-202137669-A-G,rs16849710,1,A,G,202137669,159027,201782034,202175250,355635
1,ENSG00000235060.1,180434800,chr1-180257493-C-T,rs16855609,1,C,T,180257493,177307,180238192,180631408,19301
1,ENSG00000226292.1,166022215,chr1-166140474-T-C,rs16856607,1,T,C,166140474,118259,165825607,166218823,314867
1,ENSG00000181227.2,75744776,chr1-75750501-C-T,rs17097429,-1,C,T,75750501,5725,75548168,75941384,202333
1,ENSG00000213559.3,80452004,chr1-80315916-C-G,rs17104640,-1,C,G,80315916,136088,80255396,80648612,60520
1,ENSG00000197568.9,70354844,chr1-70355119-G-A,rs17131261,1,G,A,70355119,275,70158236,70551452,196883
1,ENSG00000229635.1,93384998,chr1-93195181-T-G,rs17131710,-1,T,G,93195181,189817,93188390,93581606,6791
1,ENSG00000225265.1,222589928,chr1-222546244-T-C,rs17163191,1,T,C,222546244,43684,222393320,222786536,152924
1,ENSG00000228217.1,117778506,chr1-117733913-G-A,rs17257575,-1,G,A,117733913,44593,117581898,117975114,152015
1,ENSG00000238198.1,113073113,chr1-113022022-C-T,rs1728232,-1,C,T,113022022,51091,112876505,113269721,145517
1,ENSG00000227741.1,160208869,chr1-160176786-A-G,rs17368598,-1,A,G,160176786,32083,160012261,160405477,164525
1,ENSG00000227533.1,42959078,chr1-42950462-T-C,rs17387775,1,T,C,42950462,8616,42762470,43155686,187992
1,ENSG00000228502.1,96446930,chr1-96389789-T-C,rs17425106,1,T,C,96389789,57141,96250322,96643538,139467
1,ENSG00000226167.1,113856635,chr1-113901277-G-A,rs17464525,1,G,A,113901277,44642,113660027,114053243,241250
1,ENSG00000226029.1,16460948,chr1-16460141-G-C,rs1746722,1,G,C,16460141,807,16264340,16657556,195801
1,ENSG00000258082.1,234980804,chr1-234987549-G-A,rs17600585,-1,G,A,234987549,6745,234784196,235177412,203353
1,ENSG00000233461.1,231528604,chr1-231520672-G-A,rs1765794,-1,G,A,231520672,7932,231331996,231725212,188676
1,ENSG00000226754.1,53238580,chr1-53071594-G-A,rs1769316,1,G,A,53071594,166986,53041972,53435188,29622
1,ENSG00000237301.1,15603626,chr1-15518431-C-T,rs1820205,-1,C,T,15518431,85195,15407018,15800234,111413
1,ENSG00000225154.1,47075979,chr1-47154454-A-G,rs1832992,-1,A,G,47154454,78475,46879371,47272587,275083
1,ENSG00000213028.3,229689904,chr1-229710052-T-C,rs1931324,-1,T,C,229710052,20148,229493296,229886512,216756
1,ENSG00000233203.2,54887563,chr1-54705766-A-G,rs1981583,1,A,G,54705766,181797,54690955,55084171,14811
1,ENSG00000223396.2,201520056,chr1-201507672-G-T,rs1998920,1,G,T,201507672,12384,201323448,201716664,184224
1,ENSG00000228477.1,39962680,chr1-39822379-G-A,rs1999574,1,G,A,39822379,140301,39766072,40159288,56307
1,ENSG00000230138.1,53368245,chr1-53364057-T-C,rs1999897,-1,T,C,53364057,4188,53171637,53564853,192420
1,ENSG00000229255.1,248485484,chr1-248681796-C-T,rs2000390,-1,C,T,248681796,196312,248288876,248682092,392920
1,ENSG00000235371.1,236110061,chr1-236012039-T-C,rs2031487,1,T,C,236012039,98022,235913453,236306669,98586
1,ENSG00000236675.1,155230975,chr1-155202588-A-G,rs2066981,1,A,G,155202588,28387,155034367,155427583,168221
1,ENSG00000228172.1,25819772,chr1-25804530-T-C,rs2072749,-1,T,C,25804530,15242,25623164,26016380,181366
1,ENSG00000238186.1,40517174,chr1-40450731-G-A,rs2076493,-1,G,A,40450731,66443,40320566,40713782,130165
1,ENSG00000238142.1,16889672,chr1-17010896-G-A,rs2076600,-1,G,A,17010896,121224,16693064,17086280,317832
1,ENSG00000261798.1,39788976,chr1-39777257-A-G,rs2138686,1,A,G,39777257,11719,39592368,39985584,184889
1,ENSG00000233706.1,226992140,chr1-227166834-C-T,rs2175789,1,C,T,227166834,174694,226795532,227188748,371302
1,ENSG00000237276.3,16228027,chr1-16210794-T-G,rs221063,-1,T,G,16210794,17233,16031419,16424635,179375
1,ENSG00000211454.8,19274194,chr1-19311815-A-G,rs2227295,-1,A,G,19311815,37621,19077586,19470802,234229
1,ENSG00000236872.1,45415020,chr1-45566639-A-G,rs2229540,1,A,G,45566639,151619,45218412,45611628,348227
1,ENSG00000242861.1,225846522,chr1-225838705-A-G,rs2234922,-1,A,G,225838705,7817,225649914,226043130,188791
1,ENSG00000251520.1,180964511,chr1-181049100-A-G,rs2236410,1,A,G,181049100,84589,180767903,181161119,281197
1,ENSG00000238063.1,38474882,chr1-38475432-A-G,rs2244181,1,A,G,38475432,550,38278274,38671490,197158
1,ENSG00000228288.2,202810850,chr1-202812036-G-A,rs2246083,1,G,A,202812036,1186,202614242,203007458,197794
1,ENSG00000215833.2,168451211,chr1-168399780-T-C,rs2268545,-1,T,C,168399780,51431,168254603,168647819,145177
1,ENSG00000228056.2,63843685,chr1-63652242-A-G,rs2269237,-1,A,G,63652242,191443,63647077,64040293,5165
1,ENSG00000233012.1,220625740,chr1-220761739-G-A,rs2275575,1,G,A,220761739,135999,220429132,220822348,332607
1,ENSG00000236423.1,3900403,chr1-3829920-T-C,rs2275829,1,T,C,3829920,70483,3703795,4097011,126125
1,ENSG00000198468.2,212858125,chr1-212857192-C-T,rs2279692,-1,C,T,212857192,933,212661517,213054733,195675
1,ENSG00000236266.1,7827342,chr1-7820652-G-A,rs228692,-1,G,A,7820652,6690,7630734,8023950,189918
1,ENSG00000185495.6,223995895,chr1-224010652-A-G,rs2404851,1,A,G,224010652,14757,223799287,224192503,211365
1,ENSG00000228397.1,22026048,chr1-22035352-G-A,rs2473277,-1,G,A,22035352,9304,21829440,22222656,205912
1,ENSG00000233621.1,37474386,chr1-37473572-T-C,rs2492301,-1,T,C,37473572,814,37277778,37670994,195794
1,ENSG00000227751.1,17406760,chr1-17396630-A-G,rs2526833,1,A,G,17396630,10130,17210152,17603368,186478
1,ENSG00000238005.1,234970062,chr1-234957196-T-C,rs2674001,-1,T,C,234957196,12866,234773454,235166670,183742
1,ENSG00000228175.2,89994321,chr1-89985650-A-G,rs2704004,-1,A,G,89985650,8671,89797713,90190929,187937
1,ENSG00000230325.1,236550280,chr1-236548510-A-G,rs2758997,-1,A,G,236548510,1770,236353672,236746888,194838
1,ENSG00000229022.1,241831935,chr1-241947377-G-A,rs28459756,1,G,A,241947377,115442,241635327,242028543,312050
1,ENSG00000230955.1,37860697,chr1-37901235-T-C,rs28739509,1,T,C,37901235,40538,37664089,38057305,237146
1,ENSG00000219133.2,204347258,chr1-204368506-T-C,rs2942138,-1,T,C,204368506,21248,204150650,204543866,217856
1,ENSG00000231551.2,148415258,chr1-148351648-A-C,rs2999614,1,A,C,148351648,63610,148218650,148611866,132998
1,ENSG00000258634.1,110058340,chr1-109897014-C-T,rs333961,1,C,T,109897014,161326,109861732,110254948,35282
1,ENSG00000228863.1,160676371,chr1-160712046-C-G,rs352685,1,C,G,160712046,35675,160479763,160872979,232283
1,ENSG00000234711.1,873292,chr1-946538-G-A,rs35471880,1,G,A,946538,73246,676684,1069900,269854
1,ENSG00000231029.1,167591392,chr1-167495229-A-G,rs35506338,1,A,G,167495229,96163,167394784,167788000,100445
1,ENSG00000236263.1,155213819,chr1-155070410-T-G,rs35902694,-1,T,G,155070410,143409,155017211,155410427,53199
1,ENSG00000217801.4,1063079,chr1-1004823-G-A,rs35940137,1,G,A,1004823,58256,866471,1259687,138352
1,ENSG00000215914.3,1699942,chr1-1689421-G-A,rs3737622,1,G,A,1689421,10521,1503334,1896550,186087
1,ENSG00000232450.1,113699631,chr1-113699500-T-C,rs3752954,-1,T,C,113699500,131,113503023,113896239,196477
1,ENSG00000220323.2,149843041,chr1-149943855-G-A,rs3754041,1,G,A,149943855,100814,149646433,150039649,297422
1,ENSG00000238249.1,8893409,chr1-8961939-T-C,rs3765965,1,T,C,8961939,68530,8696801,9090017,265138
1,ENSG00000260179.1,1251334,chr1-1082207-C-T,rs3766191,-1,C,T,1082207,169127,1054726,1447942,27481
1,ENSG00000237950.1,43940781,chr1-43832001-T-C,rs3791073,-1,T,C,43832001,108780,43744173,44137389,87828
1,ENSG00000235101.1,160670148,chr1-160673321-A-C,rs3795324,1,A,C,160673321,3173,160473540,160866756,199781
1,ENSG00000260088.1,200669507,chr1-200670555-G-T,rs3806358,1,G,T,200670555,1048,200472899,200866115,197656
1,ENSG00000215867.3,111649544,chr1-111536389-T-C,rs3849169,-1,T,C,111536389,113155,111452936,111846152,83453
1,ENSG00000260246.1,109693742,chr1-109640399-G-T,rs3850616,-1,G,T,109640399,53343,109497134,109890350,143265
1,ENSG00000261000.1,206503948,chr1-206502998-G-A,rs3860295,1,G,A,206502998,950,206307340,206700556,195658
1,ENSG00000229815.1,44958557,chr1-44812422-T-C,rs4073112,1,T,C,44812422,146135,44761949,45155165,50473
1,ENSG00000259357.1,150965249,chr1-151060221-G-T,rs41266624,1,G,T,151060221,94972,150768641,151161857,291580
1,ENSG00000236809.2,211417025,chr1-211358094-C-G,rs41303049,1,C,G,211358094,58931,211220417,211613633,137677
1,ENSG00000260855.1,246772301,chr1-246756170-C-T,rs4130317,1,C,T,246756170,16131,246575693,246968909,180477
1,ENSG00000203865.4,116418607,chr1-116449285-G-A,rs41439745,-1,G,A,116449285,30678,116221999,116615215,227286
1,ENSG00000231507.1,203273221,chr1-203291372-T-C,rs4543864,1,T,C,203291372,18151,203076613,203469829,214759
1,ENSG00000234222.1,145927236,chr1-145990515-A-C,rs4636400,1,A,C,145990515,63279,145730628,146123844,259887
1,ENSG00000213062.3,169486076,chr1-169367379-G-A,rs4656671,1,G,A,169367379,118697,169289468,169682684,77911
1,ENSG00000229953.1,156661424,chr1-156664847-A-G,rs4661210,-1,A,G,156664847,3423,156464816,156858032,200031
1,ENSG00000225938.1,101236624,chr1-101345005-T-C,rs4907936,-1,T,C,101345005,108381,101040016,101433232,304989
1,ENSG00000198711.4,54236440,chr1-54214239-T-C,rs4927071,1,T,C,54214239,22201,54039832,54433048,174407
1,ENSG00000231346.1,111608318,chr1-111612005-G-A,rs500714,-1,G,A,111612005,3687,111411710,111804926,200295
1,ENSG00000233708.1,42888767,chr1-42940483-C-G,rs5031048,-1,C,G,42940483,51716,42692159,43085375,248324
1,ENSG00000231999.2,89632979,chr1-89757841-C-A,rs519989,-1,C,A,89757841,124862,89436371,89829587,321470
1,ENSG00000226088.1,70360437,chr1-70512990-G-T,rs55734633,-1,G,T,70512990,152553,70163829,70557045,349161
1,ENSG00000228044.2,234656052,chr1-234497877-C-T,rs57078448,1,C,T,234497877,158175,234459444,234852660,38433
1,ENSG00000223416.3,58056480,chr1-58240737-T-C,rs577005,-1,T,C,58240737,184257,57859872,58253088,380865
1,ENSG00000236810.1,23778283,chr1-23729228-G-A,rs586173,-1,G,A,23729228,49055,23581675,23974891,147553
1,ENSG00000177173.5,116534092,chr1-116488683-C-T,rs58830348,-1,C,T,116488683,45409,116337484,116730700,151199
1,ENSG00000237861.1,197222222,chr1-197050728-A-C,rs6000,1,A,C,197050728,171494,197025614,197418830,25114
1,ENSG00000229431.1,43385113,chr1-43230037-G-A,rs607949,1,G,A,43230037,155076,43188505,43581721,41532
1,ENSG00000187952.7,21428303,chr1-21598419-A-G,rs61775974,1,A,G,21598419,170116,21231695,21624911,366724
1,ENSG00000243970.1,39558707,chr1-39476625-C-G,rs61779310,-1,C,G,39476625,82082,39362099,39755315,114526
1,ENSG00000230628.1,234696153,chr1-234682676-T-A,rs620462,-1,T,A,234682676,13477,234499545,234892761,183131
1,ENSG00000224520.1,157073257,chr1-157097158-T-C,rs6427351,1,T,C,157097158,23901,156876649,157269865,220509
1,ENSG00000214796.4,202859099,chr1-202891611-G-T,rs6427976,-1,G,T,202891611,32512,202662491,203055707,229120
1,ENSG00000224727.1,243268119,chr1-243284099-C-T,rs6429420,-1,C,T,243284099,15980,243071511,243464727,212588
1,ENSG00000230699.2,911435,chr1-915400-C-T,rs6657440,1,C,T,915400,3965,714827,1108043,200573
1,ENSG00000223745.1,93345831,chr1-93273671-A-G,rs6667701,-1,A,G,93273671,72160,93149223,93542439,124448
1,ENSG00000231671.1,101323837,chr1-101371523-G-T,rs6688602,1,G,T,101371523,47686,101127229,101520445,244294
1,ENSG00000228844.1,240637052,chr1-240639870-A-G,rs6691111,-1,A,G,240639870,2818,240440444,240833660,199426
1,ENSG00000225171.1,166868748,chr1-166858437-T-C,rs6691431,1,T,C,166858437,10311,166672140,167065356,186297
1,ENSG00000230787.1,79056055,chr1-79020326-T-C,rs6693037,-1,T,C,79020326,35729,78859447,79252663,160879
1,ENSG00000231663.1,234373664,chr1-234367623-G-C,rs6693224,-1,G,C,234367623,6041,234177056,234570272,190567
1,ENSG00000228452.1,42776790,chr1-42746440-C-T,rs6882,-1,C,T,42746440,30350,42580182,42973398,166258
1,ENSG00000228086.1,100485997,chr1-100564159-A-G,rs721385,-1,A,G,100564159,78162,100289389,100682605,274770
1,ENSG00000228589.2,28096422,chr1-28037730-T-G,rs72658313,-1,T,G,28037730,58692,27899814,28293030,137916
1,ENSG00000261349.1,25267136,chr1-25257119-C-G,rs72660908,-1,C,G,25257119,10017,25070528,25463744,186591
1,ENSG00000225568.1,87045875,chr1-87221727-T-C,rs72725826,1,T,C,87221727,175852,86849267,87242483,372460
1,ENSG00000224939.1,234629311,chr1-234520957-G-A,rs72767206,1,G,A,234520957,108354,234432703,234825919,88254
1,ENSG00000237292.1,181174484,chr1-181161258-T-G,rs73044273,1,T,G,181161258,13226,180977876,181371092,183382
1,ENSG00000217644.3,32979947,chr1-32977463-C-T,rs735402,1,C,T,32977463,2484,32783339,33176555,194124
1,ENSG00000234546.1,9182004,chr1-9200882-G-C,rs737261,1,G,C,9200882,18878,8985396,9378612,215486
1,ENSG00000235363.1,205351247,chr1-205347394-A-G,rs7512024,1,A,G,205347394,3853,205154639,205547855,192755
1,ENSG00000236792.1,192247505,chr1-192256849-T-C,rs7517414,1,T,C,192256849,9344,192050897,192444113,205952
1,ENSG00000179840.5,9654586,chr1-9651429-T-C,rs7518793,-1,T,C,9651429,3157,9457978,9851194,193451
1,ENSG00000213036.3,214483387,chr1-214292448-C-A,rs7519743,-1,C,A,214292448,190939,214286779,214679995,5669
1,ENSG00000215790.2,1739557,chr1-1683909-A-C,rs7520934,-1,A,C,1683909,55648,1542949,1936165,140960
1,ENSG00000213226.3,147319110,chr1-147222864-A-G,rs7525225,1,A,G,147222864,96246,147122502,147515718,100362
1,ENSG00000227278.1,40515057,chr1-40482997-C-T,rs7534068,-1,C,T,40482997,32060,40318449,40711665,164548
1,ENSG00000226723.1,192247487,chr1-192264406-A-G,rs7540236,-1,A,G,192264406,16919,192050879,192444095,213527
1,ENSG00000183298.4,101787219,chr1-101938894-T-C,rs75427469,-1,T,C,101938894,151675,101590611,101983827,348283
1,ENSG00000229991.1,224574434,chr1-224696671-G-T,rs7545558,1,G,T,224696671,122237,224377826,224771042,318845
1,ENSG00000229991.1,224574434,chr1-224696671-G-A,rs7545558,1,G,A,224696671,122237,224377826,224771042,318845
1,ENSG00000198857.3,119601340,chr1-119622343-C-T,rs7552885,1,C,T,119622343,21003,119404732,119797948,217611
1,ENSG00000233791.1,203305309,chr1-203325492-A-G,rs75733035,-1,A,G,203325492,20183,203108701,203501917,216791
1,ENSG00000224950.1,116499212,chr1-116539188-A-G,rs758518,-1,A,G,116539188,39976,116302604,116695820,236584
1,ENSG00000232347.1,247241823,chr1-247374638-A-G,rs76356095,-1,A,G,247374638,132815,247045215,247438431,329423
1,ENSG00000228192.2,42846414,chr1-43001414-T-C,rs76794017,-1,T,C,43001414,155000,42649806,43043022,351608
1,ENSG00000237568.1,89260582,chr1-89434663-C-T,rs77250947,1,C,T,89434663,174081,89063974,89457190,370689
1,ENSG00000229020.3,112923423,chr1-112999179-G-A,rs773433,1,G,A,112999179,75756,112726815,113120031,272364
1,ENSG00000182873.4,2183875,chr1-2254676-G-A,rs77797313,-1,G,A,2254676,70801,1987267,2380483,267409
1,ENSG00000206585.1,148038916,chr1-147846731-C-T,rs78318689,-1,C,T,147846731,192185,147842308,148235524,4423
1,ENSG00000225217.1,161606291,chr1-161763917-G-A,rs78349639,1,G,A,161763917,157626,161409683,161802899,354234
1,ENSG00000177788.5,229271145,chr1-229090576-G-A,rs78658121,-1,G,A,229090576,180569,229074537,229467753,16039
1,ENSG00000227205.3,119853316,chr1-119877637-C-A,rs79460646,1,C,A,119877637,24321,119656708,120049924,220929
1,ENSG00000233396.1,146052594,chr1-146023711-G-A,rs863850,1,G,A,146023711,28883,145855986,146249202,167725
1,ENSG00000236782.1,26171832,chr1-26170849-A-C,rs8768,-1,A,C,26170849,983,25975224,26368440,195625
1,ENSG00000228830.1,234607008,chr1-234604395-G-A,rs8823,1,G,A,234604395,2613,234410400,234803616,193995
1,ENSG00000224592.1,38047425,chr1-38202032-T-G,rs898978,1,T,G,38202032,154607,37850817,38244033,351215
1,ENSG00000236905.1,212824027,chr1-212685455-T-C,rs906363,1,T,C,212685455,138572,212627419,213020635,58036
1,ENSG00000225077.2,6234692,chr1-6236178-T-G,rs9970334,1,T,G,6236178,1486,6038084,6431300,198094
1,ENSG00000260948.1,111433068,chr1-111414689-G-C,rs10067,-1,G,C,111414689,18379,111236460,111629676,178229
1,ENSG00000224521.1,248548756,chr1-248524348-C-T,rs10158204,1,C,T,248524348,24408,248352148,248745364,172200
1,ENSG00000226419.1,112956824,chr1-113126295-A-C,rs10494151,1,A,C,113126295,169471,112760216,113153432,366079
1,ENSG00000231084.1,185171710,chr1-185353357-C-T,rs10752948,-1,C,T,185353357,181647,184975102,185368318,378255
1,ENSG00000223396.2,201520056,chr1-201495806-G-A,rs10753903,1,G,A,201495806,24250,201323448,201716664,172358
1,ENSG00000251520.1,180964511,chr1-181049663-A-C,rs10797666,1,A,C,181049663,85152,180767903,181161119,281760
1,ENSG00000215833.2,168451211,chr1-168325965-T-C,rs10800353,-1,T,C,168325965,125246,168254603,168647819,71362
1,ENSG00000226849.1,11068471,chr1-10908673-T-G,rs10864479,1,T,G,10908673,159798,10871863,11265079,36810
1,ENSG00000233621.1,37474386,chr1-37436730-G-A,rs10908350,-1,G,A,37436730,37656,37277778,37670994,158952
1,ENSG00000227295.2,158177755,chr1-158072363-C-T,rs10908615,-1,C,T,158072363,105392,157981147,158374363,91216
1,ENSG00000243155.1,180976482,chr1-180962656-T-C,rs10914142,-1,T,C,180962656,13826,180779874,181173090,182782
1,ENSG00000233485.1,15343876,chr1-15265433-T-C,rs10927753,-1,T,C,15265433,78443,15147268,15540484,118165
1,ENSG00000261000.1,206503948,chr1-206453261-A-G,rs11120575,1,A,G,206453261,50687,206307340,206700556,145921
1,ENSG00000227591.1,209724125,chr1-209736164-T-C,rs111488558,-1,T,C,209736164,12039,209527517,209920733,208647
1,ENSG00000181227.2,75744776,chr1-75750645-T-C,rs11161521,-1,T,C,75750645,5869,75548168,75941384,202477
1,ENSG00000227070.1,51518289,chr1-51339003-T-C,rs11205835,1,T,C,51339003,179286,51321681,51714897,17322
1,ENSG00000243970.1,39558707,chr1-39583512-G-A,rs11206378,-1,G,A,39583512,24805,39362099,39755315,221413
1,ENSG00000261798.1,39788976,chr1-39750562-A-G,rs11206754,1,A,G,39750562,38414,39592368,39985584,158194
1,ENSG00000185031.5,64986087,chr1-65068808-A-G,rs11208579,-1,A,G,65068808,82721,64789479,65182695,279329
1,ENSG00000244371.1,146957659,chr1-147089017-G-A,rs11239930,-1,G,A,147089017,131358,146761051,147154267,327966
1,ENSG00000215859.4,148009592,chr1-147868183-G-T,rs11240142,-1,G,T,147868183,141409,147812984,148206200,55199
1,ENSG00000225710.1,16552531,chr1-16421984-C-T,rs112564075,-1,C,T,16421984,130547,16355923,16749139,66061
1,ENSG00000228044.2,234656052,chr1-234704933-T-C,rs113352710,1,T,C,234704933,48881,234459444,234852660,245489
1,ENSG00000232450.1,113699631,chr1-113652315-G-A,rs1146181,-1,G,A,113652315,47316,113503023,113896239,149292
1,ENSG00000213690.2,242377432,chr1-242424544-T-C,rs114677102,-1,T,C,242424544,47112,242180824,242574040,243720
1,ENSG00000229965.1,226438564,chr1-226506921-A-G,rs1151816,1,A,G,226506921,68357,226241956,226635172,264965
1,ENSG00000224520.1,157073257,chr1-157173882-C-T,rs115704940,1,C,T,157173882,100625,156876649,157269865,297233
1,ENSG00000236888.1,57606206,chr1-57632215-G-A,rs11589769,-1,G,A,57632215,26009,57409598,57802814,222617
1,ENSG00000228794.2,827598,chr1-831716-A-G,rs115991721,1,A,G,831716,4118,630990,1024206,200726
1,ENSG00000215873.2,91328369,chr1-91460916-G-A,rs116235557,1,G,A,91460916,132547,91131761,91524977,329155
1,ENSG00000213028.3,229689904,chr1-229579145-G-A,rs116265206,-1,G,A,229579145,110759,229493296,229886512,85849
1,ENSG00000242757.1,227430526,chr1-227455445-C-T,rs118000395,1,C,T,227455445,24919,227233918,227627134,221527
1,ENSG00000237101.1,224219613,chr1-224159731-C-T,rs11804144,1,C,T,224159731,59882,224023005,224416221,136726
1,ENSG00000181101.7,175045648,chr1-175190449-A-G,rs11809762,-1,A,G,175190449,144801,174849040,175242256,341409
1,ENSG00000223575.1,119085954,chr1-118964609-T-C,rs12021544,-1,T,C,118964609,121345,118889346,119282562,75263
1,ENSG00000224616.1,100266179,chr1-100206504-T-C,rs12021720,-1,T,C,100206504,59675,100069571,100462787,136933
1,ENSG00000224407.1,230281893,chr1-230291712-A-T,rs12030266,-1,A,T,230291712,9819,230085285,230478501,206427
1,ENSG00000224407.1,230281893,chr1-230291712-A-C,rs12030266,-1,A,C,230291712,9819,230085285,230478501,206427
1,ENSG00000235363.1,205351247,chr1-205493786-T-C,rs12058761,1,T,C,205493786,142539,205154639,205547855,339147
1,ENSG00000229388.1,28643228,chr1-28608390-A-G,rs12077489,1,A,G,28608390,34838,28446620,28839836,161770
1,ENSG00000241014.1,34977395,chr1-34921714-T-C,rs12078977,-1,T,C,34921714,55681,34780787,35174003,140927
1,ENSG00000227373.1,174159334,chr1-174291870-C-T,rs12081444,-1,C,T,174291870,132536,173962726,174355942,329144
1,ENSG00000232093.1,155046118,chr1-155050384-G-C,rs12085572,-1,G,C,155050384,4266,154849510,155242726,200874
1,ENSG00000232093.1,155046118,chr1-155050384-G-A,rs12085572,-1,G,A,155050384,4266,154849510,155242726,200874
1,ENSG00000238249.1,8893409,chr1-8940161-A-G,rs12091891,1,A,G,8940161,46752,8696801,9090017,243360
1,ENSG00000228288.2,202810850,chr1-202829373-A-G,rs12092568,1,A,G,202829373,18523,202614242,203007458,215131
1,ENSG00000237276.3,16228027,chr1-16226277-A-G,rs12119764,-1,A,G,16226277,1750,16031419,16424635,194858
1,ENSG00000230337.1,11099430,chr1-11057594-C-T,rs12122160,1,C,T,11057594,41836,10902822,11296038,154772
1,ENSG00000236674.1,63361179,chr1-63333854-G-A,rs12123368,-1,G,A,63333854,27325,63164571,63557787,169283
1,ENSG00000236423.1,3900403,chr1-3877709-C-T,rs12132240,1,C,T,3877709,22694,3703795,4097011,173914
1,ENSG00000236782.1,26171832,chr1-26193801-G-T,rs12138368,-1,G,T,26193801,21969,25975224,26368440,218577
1,ENSG00000225506.2,47179271,chr1-47052288-G-C,rs12140581,-1,G,C,47052288,126983,46982663,47375879,69625
1,ENSG00000225506.2,47179271,chr1-47052288-G-A,rs12140581,-1,G,A,47052288,126983,46982663,47375879,69625
1,ENSG00000238198.1,113073113,chr1-113174848-A-G,rs1216870,-1,A,G,113174848,101735,112876505,113269721,298343
1,ENSG00000223583.1,26455187,chr1-26420316-G-A,rs12728900,-1,G,A,26420316,34871,26258579,26651795,161737
1,ENSG00000218283.2,220253570,chr1-220418676-G-A,rs12750820,1,G,A,220418676,165106,220056962,220450178,361714
1,ENSG00000261654.1,110942353,chr1-110914197-G-A,rs1282018,-1,G,A,110914197,28156,110745745,111138961,168452
1,ENSG00000259818.1,53220663,chr1-53376427-C-T,rs1316436,1,C,T,53376427,155764,53024055,53417271,352372
1,ENSG00000215381.3,23244765,chr1-23359753-C-T,rs13523,1,C,T,23359753,114988,23048157,23441373,311596
1,ENSG00000234383.1,68163090,chr1-68131446-C-T,rs1411115,-1,C,T,68131446,31644,67966482,68359698,164964
1,ENSG00000231344.1,27739091,chr1-27884892-A-G,rs1467465,1,A,G,27884892,145801,27542483,27935699,342409
1,ENSG00000223653.1,85277672,chr1-85224504-C-A,rs1498380,1,C,A,85224504,53168,85081064,85474280,143440
1,ENSG00000234478.1,226148003,chr1-226066335-T-C,rs1533114,1,T,C,226066335,81668,225951395,226344611,114940
1,ENSG00000228192.2,42846414,chr1-42880055-C-T,rs1601238,-1,C,T,42880055,33641,42649806,43043022,230249
1,ENSG00000225333.4,39718028,chr1-39713759-T-C,rs16826508,1,T,C,39713759,4269,39521420,39914636,192339
1,ENSG00000238287.1,40508661,chr1-40533803-A-T,rs16827358,-1,A,T,40533803,25142,40312053,40705269,221750
1,ENSG00000238287.1,40508661,chr1-40533803-A-G,rs16827358,-1,A,G,40533803,25142,40312053,40705269,221750
1,ENSG00000235082.1,160317403,chr1-160125835-A-G,rs16831388,1,A,G,160125835,191568,160120795,160514011,5040
1,ENSG00000227417.2,203806263,chr1-203619183-A-G,rs16851939,-1,A,G,203619183,187080,203609655,204002871,9528
1,ENSG00000237292.1,181174484,chr1-181288963-C-T,rs16857062,1,C,T,181288963,114479,180977876,181371092,311087
1,ENSG00000231684.2,182336001,chr1-182152463-G-A,rs1689804,1,G,A,182152463,183538,182139393,182532609,13070
1,ENSG00000250536.1,214608840,chr1-214514267-T-C,rs17023132,-1,T,C,214514267,94573,214412232,214805448,102035
1,ENSG00000223489.1,116742609,chr1-116572507-G-A,rs17036001,-1,G,A,116572507,170102,116546001,116939217,26506
1,ENSG00000213560.3,78091499,chr1-77905306-C-T,rs17101052,1,C,T,77905306,186193,77894891,78288107,10415
1,ENSG00000213735.2,52253621,chr1-52207635-A-C,rs17107100,1,A,C,52207635,45986,52057013,52450229,150622
1,ENSG00000228121.1,58999676,chr1-58927109-C-G,rs17118414,1,C,G,58927109,72567,58803068,59196284,124041
1,ENSG00000237188.1,147173362,chr1-147083644-T-C,rs17160592,1,T,C,147083644,89718,146976754,147369970,106890
1,ENSG00000232185.1,115564601,chr1-115371217-C-G,rs17163852,1,C,G,115371217,193384,115367993,115761209,3224
1,ENSG00000225712.1,209268223,chr1-209229213-T-G,rs17260224,-1,T,G,209229213,39010,209071615,209464831,157598
1,ENSG00000259865.1,247188526,chr1-247208861-G-T,rs17269923,-1,G,T,247208861,20335,246991918,247385134,216943
1,ENSG00000223804.1,120341839,chr1-120381544-G-A,rs17346661,-1,G,A,120381544,39705,120145231,120538447,236313
1,ENSG00000234329.1,45651826,chr1-45612519-T-A,rs17410308,-1,T,A,45612519,39307,45455218,45848434,157301
1,ENSG00000227001.2,21427967,chr1-21467568-C-T,rs17420195,-1,C,T,21467568,39601,21231359,21624575,236209
1,ENSG00000228086.1,100485997,chr1-100353172-T-G,rs17420882,-1,T,G,100353172,132825,100289389,100682605,63783
1,ENSG00000228084.1,99969957,chr1-99863339-A-G,rs17448792,-1,A,G,99863339,106618,99773349,100166565,89990
1,ENSG00000227311.1,40333557,chr1-40299877-C-T,rs17462950,-1,C,T,40299877,33680,40136949,40530165,162928
1,ENSG00000236065.2,32987075,chr1-33134514-A-G,rs17542433,1,A,G,33134514,147439,32790467,33183683,344047
1,ENSG00000233461.1,231528604,chr1-231515645-A-G,rs1769807,-1,A,G,231515645,12959,231331996,231725212,183649
1,ENSG00000175147.7,15152464,chr1-15151369-G-A,rs1883761,-1,G,A,15151369,1095,14955856,15349072,195513
1,ENSG00000224358.1,165768929,chr1-165726489-T-C,rs1913846,1,T,C,165726489,42440,165572321,165965537,154168
1,ENSG00000234264.1,68496676,chr1-68543220-G-T,rs1924533,1,G,T,68543220,46544,68300068,68693284,243152
1,ENSG00000230547.1,171271590,chr1-171290538-C-T,rs2038097,-1,C,T,171290538,18948,171074982,171468198,215556
1,ENSG00000225217.1,161606291,chr1-161530340-A-G,rs2099684,1,A,G,161530340,75951,161409683,161802899,120657
1,ENSG00000224986.1,48326123,chr1-48341908-C-T,rs2175862,-1,C,T,48341908,15785,48129515,48522731,212393
1,ENSG00000227217.1,157691762,chr1-157699203-C-T,rs2210913,1,C,T,157699203,7441,157495154,157888370,204049
1,ENSG00000241720.1,109725820,chr1-109736980-T-G,rs2234696,1,T,G,109736980,11160,109529212,109922428,207768
1,ENSG00000233427.1,28877336,chr1-28863085-C-T,rs2234918,-1,C,T,28863085,14251,28680728,29073944,182357
1,ENSG00000224950.1,116499212,chr1-116409905-C-T,rs2269975,-1,C,T,116409905,89307,116302604,116695820,107301
1,ENSG00000225886.1,27669490,chr1-27725146-A-G,rs2272796,1,A,G,27725146,55656,27472882,27866098,252264
1,ENSG00000235101.1,160670148,chr1-160647341-T-A,rs2295614,1,T,A,160647341,22807,160473540,160866756,173801
1,ENSG00000230415.1,1275223,chr1-1129599-C-T,rs2298217,1,C,T,1129599,145624,1078615,1471831,50984
1,ENSG00000231702.1,1008229,chr1-1129599-C-T,rs2298217,-1,C,T,1129599,121370,811621,1204837,317978
1,ENSG00000232453.1,58931897,chr1-58885774-G-A,rs2492321,-1,G,A,58885774,46123,58735289,59128505,150485
1,ENSG00000258634.1,110058340,chr1-110216833-G-A,rs2603594,1,G,A,110216833,158493,109861732,110254948,355101
1,ENSG00000261135.1,16514645,chr1-16413412-A-C,rs2670494,1,A,C,16413412,101233,16318037,16711253,95375
1,ENSG00000237520.1,234957231,chr1-234957196-T-C,rs2674001,1,T,C,234957196,35,234760623,235153839,196573
1,ENSG00000187952.7,21428303,chr1-21249071-C-T,rs2682369,1,C,T,21249071,179232,21231695,21624911,17376
1,ENSG00000232883.1,220317599,chr1-220159210-C-T,rs2789792,-1,C,T,220159210,158389,220120991,220514207,38219
1,ENSG00000203914.2,91642516,chr1-91679413-T-C,rs2810893,1,T,C,91679413,36897,91445908,91839124,233505
1,ENSG00000228452.1,42776790,chr1-42764888-C-T,rs2816594,-1,C,T,42764888,11902,42580182,42973398,184706
1,ENSG00000243960.1,111441364,chr1-111257850-T-C,rs2820082,-1,T,C,111257850,183514,111244756,111637972,13094
1,ENSG00000198857.3,119601340,chr1-119780338-G-A,rs2843016,1,G,A,119780338,178998,119404732,119797948,375606
1,ENSG00000224308.1,152949210,chr1-153003726-T-C,rs28989175,-1,T,C,153003726,54516,152752602,153145818,251124
1,ENSG00000237352.1,58933643,chr1-59019982-G-C,rs2985887,1,G,C,59019982,86339,58737035,59130251,282947
1,ENSG00000237033.1,70661265,chr1-70698032-G-A,rs3001038,-1,G,A,70698032,36767,70464657,70857873,233375
1,ENSG00000177757.1,817371,chr1-817341-A-G,rs3131972,1,A,G,817341,30,620763,1013979,196578
1,ENSG00000228217.1,117778506,chr1-117642158-T-G,rs319508,-1,T,G,117642158,136348,117581898,117975114,60260
1,ENSG00000232273.1,37544763,chr1-37430454-C-T,rs34442203,1,C,T,37430454,114309,37348155,37741371,82299
1,ENSG00000234441.1,103668268,chr1-103771190-G-A,rs34848656,-1,G,A,103771190,102922,103471660,103864876,299530
1,ENSG00000229985.2,27176751,chr1-27003177-C-T,rs35308549,1,C,T,27003177,173574,26980143,27373359,23034
1,ENSG00000225294.1,26986340,chr1-27076911-C-G,rs35327731,-1,C,G,27076911,90571,26789732,27182948,287179
1,ENSG00000198711.4,54236440,chr1-54275959-A-G,rs35364040,1,A,G,54275959,39519,54039832,54433048,236127
1,ENSG00000260179.1,1251334,chr1-1086035-A-G,rs3737728,-1,A,G,1086035,165299,1054726,1447942,31309
1,ENSG00000260179.1,1251334,chr1-1086035-A-T,rs3737728,-1,A,T,1086035,165299,1054726,1447942,31309
1,ENSG00000233712.1,157642751,chr1-157527473-T-C,rs3761961,-1,T,C,157527473,115278,157446143,157839359,81330
1,ENSG00000228054.1,109046828,chr1-109091891-A-G,rs3768500,1,A,G,109091891,45063,108850220,109243436,241671
1,ENSG00000203288.3,151790824,chr1-151790770-G-A,rs3811414,1,G,A,151790770,54,151594216,151987432,196554
1,ENSG00000223776.4,236524508,chr1-236524482-A-G,rs3820564,-1,A,G,236524482,26,236327900,236721116,196582
1,ENSG00000230955.1,37860697,chr1-37802725-T-C,rs3845498,1,T,C,37802725,57972,37664089,38057305,138636
1,ENSG00000215914.3,1699942,chr1-1680672-C-T,rs4074197,1,C,T,1680672,19270,1503334,1896550,177338
1,ENSG00000229162.1,24961345,chr1-24864312-A-G,rs4074406,1,A,G,24864312,97033,24764737,25157953,99575
1,ENSG00000231999.2,89632979,chr1-89763028-C-G,rs41305844,-1,C,G,89763028,130049,89436371,89829587,326657
1,ENSG00000230623.2,200333193,chr1-200180367-C-G,rs41415747,1,C,G,200180367,152826,200136585,200529801,43782
1,ENSG00000228863.1,160676371,chr1-160674942-A-T,rs41440146,1,A,T,160674942,1429,160479763,160872979,195179
1,ENSG00000230699.2,911435,chr1-900119-A-G,rs4422948,1,A,G,900119,11316,714827,1108043,185292
1,ENSG00000244703.3,207645234,chr1-207703232-C-A,rs4562622,1,C,A,207703232,57998,207448626,207841842,254606
1,ENSG00000233791.1,203305309,chr1-203289557-G-C,rs4615902,-1,G,C,203289557,15752,203108701,203501917,180856
1,ENSG00000251484.2,109104766,chr1-109240583-G-T,rs4623734,-1,G,T,109240583,135817,108908158,109301374,332425
1,ENSG00000237568.1,89260582,chr1-89335435-C-G,rs4658310,1,C,G,89335435,74853,89063974,89457190,271461
1,ENSG00000237568.1,89260582,chr1-89335435-C-A,rs4658310,1,C,A,89335435,74853,89063974,89457190,271461
1,ENSG00000179743.2,15848147,chr1-15836236-C-T,rs4661667,-1,C,T,15836236,11911,15651539,16044755,184697
1,ENSG00000226029.1,16460948,chr1-16409637-T-C,rs4661746,1,T,C,16409637,51311,16264340,16657556,145297
1,ENSG00000224818.1,201465146,chr1-201461308-A-G,rs481298,-1,A,G,201461308,3838,201268538,201661754,192770
1,ENSG00000225265.1,222589928,chr1-222547946-C-T,rs4846382,1,C,T,222547946,41982,222393320,222786536,154626
1,ENSG00000231671.1,101323837,chr1-101329473-C-T,rs4908127,1,C,T,101329473,5636,101127229,101520445,202244
1,ENSG00000235912.1,27649419,chr1-27701750-T-G,rs4908335,1,T,G,27701750,52331,27452811,27846027,248939
1,ENSG00000236266.1,7827342,chr1-7657582-C-A,rs4908666,-1,C,A,7657582,169760,7630734,8023950,26848
1,ENSG00000211454.8,19274194,chr1-19311596-G-C,rs4911983,-1,G,C,19311596,37402,19077586,19470802,234010
1,ENSG00000244256.1,63655743,chr1-63843422-G-A,rs4915931,1,G,A,63843422,187679,63459135,63852351,384287
1,ENSG00000233626.1,211936249,chr1-212062815-G-T,rs4951436,1,G,T,212062815,126566,211739641,212132857,323174
1,ENSG00000198468.2,212858125,chr1-212706302-C-T,rs4951458,-1,C,T,212706302,151823,212661517,213054733,44785
1,ENSG00000236675.1,155230975,chr1-155304078-G-A,rs4971072,1,G,A,155304078,73103,155034367,155427583,269711
1,ENSG00000197568.9,70354844,chr1-70398053-C-T,rs511459,1,C,T,70398053,43209,70158236,70551452,239817
1,ENSG00000224939.1,234629311,chr1-234629179-G-A,rs530596,1,G,A,234629179,132,234432703,234825919,196476
1,ENSG00000261716.1,149850772,chr1-149909621-A-C,rs55909843,-1,A,C,149909621,58849,149654164,150047380,255457
1,ENSG00000230679.1,8878835,chr1-8883291-C-G,rs56379806,1,C,G,8883291,4456,8682227,9075443,201064
1,ENSG00000236035.1,203657760,chr1-203520555-C-T,rs60226453,-1,C,T,203520555,137205,203461152,203854368,59403
1,ENSG00000236546.1,39897745,chr1-39717570-G-A,rs61779765,1,G,A,39717570,180175,39701137,40094353,16433
1,ENSG00000197989.8,28582986,chr1-28392819-A-G,rs61783808,-1,A,G,28392819,190167,28386378,28779594,6441
1,ENSG00000244682.3,161581340,chr1-161710728-T-A,rs61801161,1,T,A,161710728,129388,161384732,161777948,325996
1,ENSG00000260805.1,212559731,chr1-212636753-C-T,rs61830700,-1,C,T,212636753,77022,212363123,212756339,273630
1,ENSG00000260088.1,200669507,chr1-200671753-G-T,rs6427837,1,G,T,200671753,2246,200472899,200866115,198854
1,ENSG00000237922.1,236286960,chr1-236481317-T-G,rs653740,-1,T,G,236481317,194357,236090352,236483568,390965
1,ENSG00000153363.8,211382775,chr1-211320231-A-G,rs6540681,1,A,G,211320231,62544,211186167,211579383,134064
1,ENSG00000260246.1,109693742,chr1-109672556-A-G,rs655315,-1,A,G,109672556,21186,109497134,109890350,175422
1,ENSG00000259943.1,40257971,chr1-40214037-G-A,rs6600321,-1,G,A,40214037,43934,40061363,40454579,152674
1,ENSG00000238122.1,108273689,chr1-108118294-T-G,rs661202,-1,T,G,108118294,155395,108077081,108470297,41213
1,ENSG00000217801.4,1063079,chr1-1022260-C-T,rs6657048,1,C,T,1022260,40819,866471,1259687,155789
1,ENSG00000224699.1,110347116,chr1-110407098-C-T,rs6671673,1,C,T,110407098,59982,110150508,110543724,256590
1,ENSG00000213478.2,51158471,chr1-51173694-A-G,rs6675413,-1,A,G,51173694,15223,50961863,51355079,211831
1,ENSG00000260855.1,246772301,chr1-246790995-G-A,rs6680122,1,G,A,246790995,18694,246575693,246968909,215302
1,ENSG00000223861.1,151557446,chr1-151384857-T-C,rs6684085,1,T,C,151384857,172589,151360838,151754054,24019
1,ENSG00000227740.1,175921057,chr1-175905698-C-T,rs6687954,-1,C,T,175905698,15359,175724449,176117665,181249
1,ENSG00000227775.1,1735817,chr1-1892483-A-G,rs6688000,1,A,G,1892483,156666,1539209,1932425,353274
1,ENSG00000135747.7,247078736,chr1-247035979-C-T,rs6698643,-1,C,T,247035979,42757,246882128,247275344,153851
1,ENSG00000213033.3,220267917,chr1-220314846-G-A,rs6702901,-1,G,A,220314846,46929,220071309,220464525,243537
1,ENSG00000228665.1,109030067,chr1-109161739-A-G,rs679224,1,A,G,109161739,131672,108833459,109226675,328280
1,ENSG00000227533.1,42959078,chr1-42947982-A-G,rs710222,1,A,G,42947982,11096,42762470,43155686,185512
1,ENSG00000236137.1,117059490,chr1-117045526-A-G,rs72699145,-1,A,G,117045526,13964,116862882,117256098,182644
1,ENSG00000228060.1,39565052,chr1-39496921-G-A,rs74645539,1,G,A,39496921,68131,39368444,39761660,128477
1,ENSG00000237842.1,157060762,chr1-157110875-C-T,rs7516164,-1,C,T,157110875,50113,156864154,157257370,246721
1,ENSG00000238186.1,40517174,chr1-40423162-G-A,rs7526834,-1,G,A,40423162,94012,40320566,40713782,102596
1,ENSG00000228063.1,219173768,chr1-219144286-T-C,rs7527419,-1,T,C,219144286,29482,218977160,219370376,167126
1,ENSG00000227056.1,119220096,chr1-119163343-G-A,rs7543720,-1,G,A,119163343,56753,119023488,119416704,139855
1,ENSG00000215795.2,247185482,chr1-247197066-T-C,rs7551512,-1,T,C,247197066,11584,246988874,247382090,208192
1,ENSG00000235605.1,234357141,chr1-234517602-G-A,rs75627953,-1,G,A,234517602,160461,234160533,234553749,357069
1,ENSG00000232134.1,220144351,chr1-220325042-C-T,rs75902550,-1,C,T,220325042,180691,219947743,220340959,377299
1,ENSG00000236528.1,25859613,chr1-25811645-C-A,rs760598,1,C,A,25811645,47968,25663005,26056221,148640
1,ENSG00000249087.3,23368949,chr1-23180067-C-A,rs76065586,1,C,A,23180067,188882,23172341,23565557,7726
1,ENSG00000238142.1,16889672,chr1-16975177-T-C,rs761423,-1,T,C,16975177,85505,16693064,17086280,282113
1,ENSG00000227278.1,40515057,chr1-40651577-G-A,rs77060218,-1,G,A,40651577,136520,40318449,40711665,333128
1,ENSG00000213041.3,205202191,chr1-205105594-A-T,rs77224007,1,A,T,205105594,96597,205005583,205398799,100011
1,ENSG00000232751.1,173351689,chr1-173240356-A-C,rs844644,1,A,C,173240356,111333,173155081,173548297,85275
1,ENSG00000225077.2,6234692,chr1-6219310-G-C,rs846111,1,G,C,6219310,15382,6038084,6431300,181226
1,ENSG00000203865.4,116418607,chr1-116364217-G-A,rs850617,-1,G,A,116364217,54390,116221999,116615215,142218
1,ENSG00000225099.1,42903232,chr1-42947056-T-C,rs900836,1,T,C,42947056,43824,42706624,43099840,240432
1,ENSG00000228852.1,95278940,chr1-95206673-C-T,rs933107,-1,C,T,95206673,72267,95082332,95475548,124341
1,ENSG00000179840.5,9654586,chr1-9678728-C-G,rs9430635,-1,C,G,9678728,24142,9457978,9851194,220750
1,ENSG00000215790.2,1739557,chr1-1688328-C-T,rs9442411,-1,C,T,1688328,51229,1542949,1936165,145379
1,ENSG00000223416.3,58056480,chr1-58096078-C-T,rs946310,-1,C,T,58096078,39598,57859872,58253088,236206
1,ENSG00000234546.1,9182004,chr1-9218083-G-A,rs1009940,1,G,A,9218083,36079,8985396,9378612,232687
1,ENSG00000258634.1,110058340,chr1-110077495-C-T,rs10127539,1,C,T,110077495,19155,109861732,110254948,215763
1,ENSG00000227311.1,40333557,chr1-40456390-T-C,rs10489434,-1,T,C,40456390,122833,40136949,40530165,319441
1,ENSG00000230163.1,34850694,chr1-34765777-A-G,rs10489656,1,A,G,34765777,84917,34654086,35047302,111691
1,ENSG00000230623.2,200333193,chr1-200433967-T-C,rs10494814,1,T,C,200433967,100774,200136585,200529801,297382
1,ENSG00000227589.1,3668772,chr1-3864532-C-A,rs10797348,-1,C,A,3864532,195760,3472164,3865380,392368
1,ENSG00000225300.1,246605873,chr1-246661538-T-A,rs10802429,1,T,A,246661538,55665,246409265,246802481,252273
1,ENSG00000242861.1,225846522,chr1-225907348-C-T,rs10915896,-1,C,T,225907348,60826,225649914,226043130,257434
1,ENSG00000226396.1,19608114,chr1-19469357-T-C,rs10917454,1,T,C,19469357,138757,19411506,19804722,57851
1,ENSG00000213262.3,117641639,chr1-117708553-A-C,rs10923398,-1,A,C,117708553,66914,117445031,117838247,263522
1,ENSG00000215790.2,1739557,chr1-1760882-T-C,rs1107910,-1,T,C,1760882,21325,1542949,1936165,217933
1,ENSG00000232134.1,220144351,chr1-220300682-A-G,rs11118515,-1,A,G,220300682,156331,219947743,220340959,352939
1,ENSG00000232134.1,220144351,chr1-220300682-A-T,rs11118515,-1,A,T,220300682,156331,219947743,220340959,352939
1,ENSG00000153363.8,211382775,chr1-211471233-G-A,rs11119744,1,G,A,211471233,88458,211186167,211579383,285066
1,ENSG00000227006.1,230272100,chr1-230321601-G-A,rs11122494,-1,G,A,230321601,49501,230075492,230468708,246109
1,ENSG00000241318.2,91535593,chr1-91534178-T-C,rs11164900,-1,T,C,91534178,1415,91338985,91732201,195193
1,ENSG00000224616.1,100266179,chr1-100178539-C-T,rs11166410,-1,C,T,100178539,87640,100069571,100462787,108968
1,ENSG00000234807.3,58785128,chr1-58907742-G-A,rs11207328,1,G,A,58907742,122614,58588520,58981736,319222
1,ENSG00000228121.1,58999676,chr1-58920595-T-C,rs11207332,1,T,C,58920595,79081,58803068,59196284,117527
1,ENSG00000229133.1,68243055,chr1-68165819-C-T,rs11209225,-1,C,T,68165819,77236,68046447,68439663,119372
1,ENSG00000226945.1,206907619,chr1-207085324-C-T,rs112272621,1,C,T,207085324,177705,206711011,207104227,374313
1,ENSG00000230832.3,147083578,chr1-147035072-T-C,rs11240099,-1,T,C,147035072,48506,146886970,147280186,148102
1,ENSG00000224870.3,1399515,chr1-1229930-G-A,rs11260562,1,G,A,1229930,169585,1202907,1596123,27023
1,ENSG00000240731.1,1318689,chr1-1229930-G-A,rs11260562,-1,G,A,1229930,88759,1122081,1515297,107849
1,ENSG00000242396.1,54886812,chr1-54935654-T-C,rs114147529,1,T,C,54935654,48842,54690204,55083420,245450
1,ENSG00000256407.1,54196433,chr1-54268833-C-T,rs115721466,-1,C,T,54268833,72400,53999825,54393041,269008
1,ENSG00000233406.3,51251472,chr1-51174641-G-C,rs11580368,-1,G,C,51174641,76831,51054864,51448080,119777
1,ENSG00000223694.1,240170155,chr1-240363181-A-G,rs11585682,1,A,G,240363181,193026,239973547,240366763,389634
1,ENSG00000224261.1,160267225,chr1-160450246-C-T,rs11585691,-1,C,T,160450246,183021,160070617,160463833,379629
1,ENSG00000223396.2,201520056,chr1-201517800-T-G,rs11586401,1,T,G,201517800,2256,201323448,201716664,194352
1,ENSG00000183929.5,228650241,chr1-228786874-T-C,rs115885712,1,T,C,228786874,136633,228453633,228846849,333241
1,ENSG00000225154.1,47075979,chr1-46998060-T-G,rs11589889,-1,T,G,46998060,77919,46879371,47272587,118689
1,ENSG00000234211.1,161674824,chr1-161722364-T-C,rs11590932,-1,T,C,161722364,47540,161478216,161871432,244148
1,ENSG00000223804.1,120341839,chr1-120374606-A-G,rs117817481,-1,A,G,120374606,32767,120145231,120538447,229375
1,ENSG00000236085.1,103569553,chr1-103482095-C-T,rs11800914,1,C,T,103482095,87458,103372945,103766161,109150
1,ENSG00000228060.1,39565052,chr1-39527206-T-G,rs1180342,1,T,G,39527206,37846,39368444,39761660,158762
1,ENSG00000229191.1,201023961,chr1-201021631-T-C,rs11804082,1,T,C,201021631,2330,200827353,201220569,194278
1,ENSG00000214144.2,247229940,chr1-247322352-T-C,rs11804535,1,T,C,247322352,92412,247033332,247426548,289020
1,ENSG00000241720.1,109725820,chr1-109718120-T-C,rs11807,1,T,C,109718120,7700,109529212,109922428,188908
1,ENSG00000236804.1,119127291,chr1-118964609-T-C,rs12021544,-1,T,C,118964609,162682,118930683,119323899,33926
1,ENSG00000227751.1,17406760,chr1-17371859-C-T,rs1204875,1,C,T,17371859,34901,17210152,17603368,161707
1,ENSG00000233084.2,248936581,chr1-248800358-C-T,rs12059437,1,C,T,248800358,136223,248739973,249133189,60385
1,ENSG00000227205.3,119853316,chr1-119737931-C-T,rs12070041,1,C,T,119737931,115385,119656708,120049924,81223
1,ENSG00000225171.1,166868748,chr1-167053683-C-G,rs12076250,1,C,G,167053683,184935,166672140,167065356,381543
1,ENSG00000225171.1,166868748,chr1-167053683-C-T,rs12076250,1,C,T,167053683,184935,166672140,167065356,381543
1,ENSG00000231663.1,234373664,chr1-234361134-T-C,rs12087908,-1,T,C,234361134,12530,234177056,234570272,184078
1,ENSG00000231789.1,9687583,chr1-9672808-T-G,rs12092982,-1,T,G,9672808,14775,9490975,9884191,181833
1,ENSG00000215795.2,247185482,chr1-247241609-G-A,rs12118988,-1,G,A,247241609,56127,246988874,247382090,252735
1,ENSG00000236137.1,117059490,chr1-117039751-G-A,rs12121509,-1,G,A,117039751,19739,116862882,117256098,176869
1,ENSG00000213560.3,78091499,chr1-78248191-C-T,rs12122075,1,C,T,78248191,156692,77894891,78288107,353300
1,ENSG00000218510.3,22024558,chr1-22167331-C-T,rs12405138,1,C,T,22167331,142773,21827950,22221166,339381
1,ENSG00000229570.1,119496841,chr1-119471954-G-A,rs12407458,-1,G,A,119471954,24887,119300233,119693449,171721
1,ENSG00000230325.1,236550280,chr1-236608104-A-G,rs12408801,-1,A,G,236608104,57824,236353672,236746888,254432
1,ENSG00000187952.7,21428303,chr1-21532717-C-T,rs1256348,1,C,T,21532717,104414,21231695,21624911,301022
1,ENSG00000228126.1,150515757,chr1-150508095-G-A,rs12724450,1,G,A,150508095,7662,150319149,150712365,188946
1,ENSG00000227777.1,168542737,chr1-168720364-C-T,rs12733054,1,C,T,168720364,177627,168346129,168739345,374235
1,ENSG00000229757.1,168579439,chr1-168720364-C-T,rs12733054,-1,C,T,168720364,140925,168382831,168776047,337533
1,ENSG00000227217.1,157691762,chr1-157668178-A-G,rs12737968,1,A,G,157668178,23584,157495154,157888370,173024
1,ENSG00000238005.1,234970062,chr1-234953983-C-G,rs12754888,-1,C,G,234953983,16079,234773454,235166670,180529
1,ENSG00000238005.1,234970062,chr1-234953983-C-T,rs12754888,-1,C,T,234953983,16079,234773454,235166670,180529
1,ENSG00000224114.1,206696269,chr1-206537285-C-G,rs12756098,-1,C,G,206537285,158984,206499661,206892877,37624
1,ENSG00000236723.1,53213472,chr1-53316868-C-T,rs1288475,-1,C,T,53316868,103396,53016864,53410080,300004
1,ENSG00000182873.4,2183875,chr1-2015152-G-A,rs13303016,-1,G,A,2015152,168723,1987267,2380483,27885
1,ENSG00000223949.1,64171297,chr1-64365709-T-C,rs1390484,-1,T,C,64365709,194412,63974689,64367905,391020
1,ENSG00000228399.1,101256274,chr1-101237693-T-C,rs1411017,1,T,C,101237693,18581,101059666,101452882,178027
1,ENSG00000225338.1,212309518,chr1-212177977-T-C,rs1472224,-1,T,C,212177977,131541,212112910,212506126,65067
1,ENSG00000233057.1,194188967,chr1-194175173-T-C,rs1487530,1,T,C,194175173,13794,193992359,194385575,182814
1,ENSG00000224174.1,16520694,chr1-16468706-C-T,rs149562,1,C,T,16468706,51988,16324086,16717302,144620
1,ENSG00000225886.1,27669490,chr1-27745325-C-T,rs1569432,1,C,T,27745325,75835,27472882,27866098,272443
1,ENSG00000259865.1,247188526,chr1-247173424-A-G,rs1609840,-1,A,G,247173424,15102,246991918,247385134,181506
1,ENSG00000223945.1,150053864,chr1-150080753-A-G,rs16833647,1,A,G,150080753,26889,149857256,150250472,223497
1,ENSG00000231615.1,173363733,chr1-173358366-G-A,rs16845722,-1,G,A,173358366,5367,173167125,173560341,191241
1,ENSG00000229612.1,168898136,chr1-168709109-A-G,rs16861377,1,A,G,168709109,189027,168701528,169094744,7581
1,ENSG00000225113.1,109596225,chr1-109414229-A-C,rs17037726,1,A,C,109414229,181996,109399617,109792833,14612
1,ENSG00000236911.1,207606555,chr1-207631132-C-A,rs17048122,-1,C,A,207631132,24577,207409947,207803163,221185
1,ENSG00000234383.1,68163090,chr1-68098124-C-T,rs17130460,-1,C,T,68098124,64966,67966482,68359698,131642
1,ENSG00000234419.1,222468094,chr1-222446560-T-C,rs17163128,1,T,C,222446560,21534,222271486,222664702,175074
1,ENSG00000260941.1,119599271,chr1-119756437-C-T,rs17186247,-1,C,T,119756437,157166,119402663,119795879,353774
1,ENSG00000234937.1,155845367,chr1-156014078-T-C,rs17385169,1,T,C,156014078,168711,155648759,156041975,365319
1,ENSG00000234332.1,100394026,chr1-100267299-T-C,rs17454070,-1,T,C,100267299,126727,100197418,100590634,69881
1,ENSG00000225265.1,222589928,chr1-222588786-A-C,rs17464836,1,A,C,222588786,1142,222393320,222786536,195466
1,ENSG00000227408.1,103713723,chr1-103580909-A-G,rs17467099,1,A,G,103580909,132814,103517115,103910331,63794
1,ENSG00000229399.1,222641858,chr1-222788994-A-G,rs17534083,-1,A,G,222788994,147136,222445250,222838466,343744
1,ENSG00000180867.9,147178113,chr1-147085274-T-G,rs1867142,1,T,G,147085274,92839,146981505,147374721,103769
1,ENSG00000234080.2,50326131,chr1-50324208-C-T,rs1875645,1,C,T,50324208,1923,50129523,50522739,194685
1,ENSG00000224407.1,230281893,chr1-230102760-A-G,rs1998067,-1,A,G,230102760,179133,230085285,230478501,17475
1,ENSG00000211451.6,145919344,chr1-145849473-A-C,rs199809125,1,A,C,145849473,69871,145722736,146115952,126737
1,ENSG00000234422.1,96418594,chr1-96418731-G-A,rs2011693,1,G,A,96418731,137,96221986,96615202,196745
1,ENSG00000228863.1,160676371,chr1-160712073-G-T,rs2070931,1,G,T,160712073,35702,160479763,160872979,232310
1,ENSG00000231050.1,1891223,chr1-1755504-T-C,rs2072929,1,T,C,1755504,135719,1694615,2087831,60889
1,ENSG00000230138.1,53368245,chr1-53379768-T-C,rs2185077,-1,T,C,53379768,11523,53171637,53564853,208131
1,ENSG00000228844.1,240637052,chr1-240512815-G-T,rs2185284,-1,G,T,240512815,124237,240440444,240833660,72371
1,ENSG00000239494.1,169859756,chr1-169796199-G-A,rs2205845,1,G,A,169796199,63557,169663148,170056364,133051
1,ENSG00000225591.1,173741674,chr1-173906263-T-G,rs2227612,1,T,G,173906263,164589,173545066,173938282,361197
1,ENSG00000227591.1,209724125,chr1-209625860-A-G,rs2229465,-1,A,G,209625860,98265,209527517,209920733,98343
1,ENSG00000220785.3,32241592,chr1-32191963-T-C,rs2281385,-1,T,C,32191963,49629,32044984,32438200,146979
1,ENSG00000236360.1,52993702,chr1-53084871-A-G,rs2282339,-1,A,G,53084871,91169,52797094,53190310,287777
1,ENSG00000236360.1,52993702,chr1-53084871-A-T,rs2282339,-1,A,T,53084871,91169,52797094,53190310,287777
1,ENSG00000225077.2,6234692,chr1-6197796-G-A,rs2294713,1,G,A,6197796,36896,6038084,6431300,159712
1,ENSG00000235101.1,160670148,chr1-160646913-G-A,rs2295612,1,G,A,160646913,23235,160473540,160866756,173373
1,ENSG00000235101.1,160670148,chr1-160646913-G-T,rs2295612,1,G,T,160646913,23235,160473540,160866756,173373
1,ENSG00000177173.5,116534092,chr1-116561593-A-G,rs2300747,-1,A,G,116561593,27501,116337484,116730700,224109
1,ENSG00000261798.1,39788976,chr1-39801680-T-C,rs230301,1,T,C,39801680,12704,39592368,39985584,209312
1,ENSG00000223653.1,85277672,chr1-85306326-G-A,rs233100,1,G,A,85306326,28654,85081064,85474280,225262
1,ENSG00000228140.1,15409433,chr1-15401793-T-C,rs2473344,-1,T,C,15401793,7640,15212825,15606041,188968
1,ENSG00000228665.1,109030067,chr1-109186355-A-G,rs2477363,1,A,G,109186355,156288,108833459,109226675,352896
1,ENSG00000237424.1,47434641,chr1-47539104-C-T,rs2485439,-1,C,T,47539104,104463,47238033,47631249,301071
1,ENSG00000228187.1,77194825,chr1-77346890-A-C,rs2602933,1,A,C,77346890,152065,76998217,77391433,348673
1,ENSG00000238142.1,16889672,chr1-17060385-G-A,rs2746543,-1,G,A,17060385,170713,16693064,17086280,367321
1,ENSG00000177757.1,817371,chr1-969248-G-A,rs28562326,1,G,A,969248,151877,620763,1013979,348485
1,ENSG00000228794.2,827598,chr1-1024129-T-G,rs28591569,1,T,G,1024129,196531,630990,1024206,393139
1,ENSG00000229255.1,248485484,chr1-248482322-C-T,rs28625479,-1,C,T,248482322,3162,248288876,248682092,193446
1,ENSG00000224521.1,248548756,chr1-248482322-C-T,rs28625479,1,C,T,248482322,66434,248352148,248745364,130174
1,ENSG00000228196.1,178747754,chr1-178717674-C-T,rs2988268,-1,C,T,178717674,30080,178551146,178944362,166528
1,ENSG00000236546.1,39897745,chr1-39921012-A-G,rs3117091,1,A,G,39921012,23267,39701137,40094353,219875
1,ENSG00000234264.1,68496676,chr1-68405059-C-T,rs3118391,1,C,T,68405059,91617,68300068,68693284,104991
1,ENSG00000227533.1,42959078,chr1-42974530-C-A,rs3738516,1,C,A,42974530,15452,42762470,43155686,212060
1,ENSG00000261000.1,206503948,chr1-206496132-C-T,rs3748022,1,C,T,206496132,7816,206307340,206700556,188792
1,ENSG00000235308.1,88923370,chr1-88969731-A-G,rs3753679,1,A,G,88969731,46361,88726762,89119978,242969
1,ENSG00000260246.1,109693742,chr1-109710619-A-C,rs3754446,-1,A,C,109710619,16877,109497134,109890350,213485
1,ENSG00000237301.1,15603626,chr1-15482377-G-A,rs3766160,-1,G,A,15482377,121249,15407018,15800234,75359
1,ENSG00000238287.1,40508661,chr1-40508484-T-C,rs3795347,-1,T,C,40508484,177,40312053,40705269,196431
1,ENSG00000236782.1,26171832,chr1-26158522-T-G,rs3806382,-1,T,G,26158522,13310,25975224,26368440,183298
1,ENSG00000241014.1,34977395,chr1-35010638-T-C,rs41266437,-1,T,C,35010638,33243,34780787,35174003,229851
1,ENSG00000227278.1,40515057,chr1-40547175-A-G,rs41268081,-1,A,G,40547175,32118,40318449,40711665,228726
1,ENSG00000231752.1,121519345,chr1-121443141-A-T,rs4240824,1,A,T,121443141,76204,121322737,121715953,120404
1,ENSG00000223575.1,119085954,chr1-119137673-C-T,rs4387216,-1,C,T,119137673,51719,118889346,119282562,248327
1,ENSG00000228830.1,234607008,chr1-234481346-G-A,rs4442397,1,G,A,234481346,125662,234410400,234803616,70946
1,ENSG00000125462.11,156456613,chr1-156616399-G-A,rs4553183,-1,G,A,156616399,159786,156260005,156653221,356394
1,ENSG00000234329.1,45651826,chr1-45519485-T-C,rs4633317,-1,T,C,45519485,132341,45455218,45848434,64267
1,ENSG00000234518.1,89104767,chr1-89001575-T-C,rs4656075,-1,T,C,89001575,103192,88908159,89301375,93416
1,ENSG00000223452.2,155148544,chr1-155133751-A-T,rs4745,1,A,T,155133751,14793,154951936,155345152,181815
1,ENSG00000235527.2,113929495,chr1-114120248-G-C,rs479359,-1,G,C,114120248,190753,113732887,114126103,387361
1,ENSG00000235527.2,113929495,chr1-114120248-G-A,rs479359,-1,G,A,114120248,190753,113732887,114126103,387361
1,ENSG00000233432.1,121502344,chr1-121442201-T-C,rs4844607,1,T,C,121442201,60143,121305736,121698952,136465
1,ENSG00000236266.1,7827342,chr1-7647227-G-A,rs4908660,-1,G,A,7647227,180115,7630734,8023950,16493
1,ENSG00000238137.2,211442274,chr1-211356748-G-A,rs4951744,1,G,A,211356748,85526,211245666,211638882,111082
1,ENSG00000236872.1,45415020,chr1-45544980-A-G,rs518365,1,A,G,45544980,129960,45218412,45611628,326568
1,ENSG00000231871.1,201829559,chr1-201676532-G-T,rs531606,-1,G,T,201676532,153027,201632951,202026167,43581
1,ENSG00000233691.1,160935537,chr1-160745301-A-G,rs549103,1,A,G,160745301,190236,160738929,161132145,6372
1,ENSG00000260948.1,111433068,chr1-111414970-A-G,rs56294468,-1,A,G,111414970,18098,111236460,111629676,178510
1,ENSG00000228477.1,39962680,chr1-39977384-A-C,rs56337507,1,A,C,39977384,14704,39766072,40159288,211312
1,ENSG00000228217.1,117778506,chr1-117659656-G-C,rs58596036,-1,G,C,117659656,118850,117581898,117975114,77758
1,ENSG00000228217.1,117778506,chr1-117659656-G-A,rs58596036,-1,G,A,117659656,118850,117581898,117975114,77758
1,ENSG00000226029.1,16460948,chr1-16389879-T-C,rs612727,1,T,C,16389879,71069,16264340,16657556,125539
1,ENSG00000261135.1,16514645,chr1-16449087-C-T,rs61769455,1,C,T,16449087,65558,16318037,16711253,131050
1,ENSG00000223989.1,9848318,chr1-9811167-G-A,rs61785191,1,G,A,9811167,37151,9651710,10044926,159457
1,ENSG00000243781.1,237926831,chr1-238103576-A-G,rs649704,1,A,G,238103576,176745,237730223,238123439,373353
1,ENSG00000234694.1,43358676,chr1-43290841-A-G,rs6670250,-1,A,G,43290841,67835,43162068,43555284,128773
1,ENSG00000223776.4,236524508,chr1-236634008-T-C,rs6671787,-1,T,C,236634008,109500,236327900,236721116,306108
1,ENSG00000224950.1,116499212,chr1-116446734-A-T,rs6674256,-1,A,T,116446734,52478,116302604,116695820,144130
1,ENSG00000224358.1,165768929,chr1-165842492-C-T,rs6677965,1,C,T,165842492,73563,165572321,165965537,270171
1,ENSG00000260088.1,200669507,chr1-200537968-G-A,rs6682828,1,G,A,200537968,131539,200472899,200866115,65069
1,ENSG00000228929.1,52772648,chr1-52620368-T-C,rs6688451,-1,T,C,52620368,152280,52576040,52969256,44328
1,ENSG00000243155.1,180976482,chr1-181036508-G-A,rs6692913,-1,G,A,181036508,60026,180779874,181173090,256634
1,ENSG00000233020.1,70530526,chr1-70470497-T-C,rs6695895,1,T,C,70470497,60029,70333918,70727134,136579
1,ENSG00000229022.1,241831935,chr1-241918678-C-T,rs6700418,1,C,T,241918678,86743,241635327,242028543,283351
1,ENSG00000235449.1,202767418,chr1-202878591-A-G,rs6703138,-1,A,G,202878591,111173,202570810,202964026,307781
1,ENSG00000217801.4,1063079,chr1-1237527-C-T,rs715643,1,C,T,1237527,174448,866471,1259687,371056
1,ENSG00000228436.1,38859973,chr1-39015245-C-T,rs72660040,1,C,T,39015245,155272,38663365,39056581,351880
1,ENSG00000229431.1,43385113,chr1-43520774-C-T,rs72887223,1,C,T,43520774,135661,43188505,43581721,332269
1,ENSG00000215914.3,1699942,chr1-1753033-C-T,rs7407,1,C,T,1753033,53091,1503334,1896550,249699
1,ENSG00000230699.2,911435,chr1-1053522-C-A,rs74223856,1,C,A,1053522,142087,714827,1108043,338695
1,ENSG00000236439.2,202472117,chr1-202581943-A-G,rs747640,-1,A,G,202581943,109826,202275509,202668725,306434
1,ENSG00000231095.1,55222379,chr1-55230627-A-C,rs74955119,1,A,C,55230627,8248,55025771,55418987,204856
1,ENSG00000260855.1,246772301,chr1-246743904-G-T,rs7513496,1,G,T,246743904,28397,246575693,246968909,168211
1,ENSG00000135747.7,247078736,chr1-247145389-T-C,rs7521596,-1,T,C,247145389,66653,246882128,247275344,263261
1,ENSG00000203288.3,151790824,chr1-151803929-A-C,rs7534811,1,A,C,151803929,13105,151594216,151987432,209713
1,ENSG00000238186.1,40517174,chr1-40566387-G-A,rs7537003,-1,G,A,40566387,49213,40320566,40713782,245821
1,ENSG00000232208.1,8907744,chr1-9013742-C-T,rs7537425,-1,C,T,9013742,105998,8711136,9104352,302606
1,ENSG00000237491.2,778747,chr1-918870-A-G,rs7537756,1,A,G,918870,140123,582139,975355,336731
1,ENSG00000225217.1,161606291,chr1-161542941-G-A,rs7539036,1,G,A,161542941,63350,161409683,161802899,133258
1,ENSG00000237276.3,16228027,chr1-16231369-G-T,rs7541369,-1,G,T,16231369,3342,16031419,16424635,199950
1,ENSG00000238198.1,113073113,chr1-113002219-C-T,rs773440,-1,C,T,113002219,70894,112876505,113269721,125714
1,ENSG00000237352.1,58933643,chr1-59072535-C-G,rs77519408,1,C,G,59072535,138892,58737035,59130251,335500
1,ENSG00000231029.1,167591392,chr1-167492575-C-T,rs77622794,1,C,T,167492575,98817,167394784,167788000,97791
1,ENSG00000226167.1,113856635,chr1-114003357-A-G,rs77637424,1,A,G,114003357,146722,113660027,114053243,343330
1,ENSG00000215014.3,1574102,chr1-1575344-C-T,rs77661767,1,C,T,1575344,1242,1377494,1770710,197850
1,ENSG00000228407.1,52160600,chr1-52283346-C-T,rs78253772,-1,C,T,52283346,122746,51963992,52357208,319354
1,ENSG00000224609.1,59296491,chr1-59267916-G-A,rs78373455,-1,G,A,59267916,28575,59099883,59493099,168033
1,ENSG00000227671.2,247209493,chr1-247197236-A-G,rs78663796,-1,A,G,247197236,12257,247012885,247406101,184351
1,ENSG00000227056.1,119220096,chr1-119291050-C-G,rs79709077,-1,C,G,119291050,70954,119023488,119416704,267562
1,ENSG00000231365.1,119140730,chr1-119222569-G-T,rs80032050,1,G,T,119222569,81839,118944122,119337338,278447
1,ENSG00000232185.1,115564601,chr1-115621184-C-T,rs80143118,1,C,T,115621184,56583,115367993,115761209,253191
1,ENSG00000238015.1,78666272,chr1-78747309-C-T,rs80309829,1,C,T,78747309,81037,78469664,78862880,277645
1,ENSG00000203865.4,116418607,chr1-116389941-T-A,rs850609,-1,T,A,116389941,28666,116221999,116615215,167942
1,ENSG00000232864.1,227411319,chr1-227545861-A-G,rs903696,-1,A,G,227545861,134542,227214711,227607927,331150
1,ENSG00000227001.2,21427967,chr1-21489167-C-T,rs904927,-1,C,T,21489167,61200,21231359,21624575,257808
1,ENSG00000173810.8,101271363,chr1-101280865-G-A,rs9434168,-1,G,A,101280865,9502,101074755,101467971,206110
