Chromosome,GENE,Transcription start site (TSS),Variant,rsID,Strand,REF,ALT,PHYSICAL,distance_from_TSS,enformer_start,enformer_end,variant_pos_in_window
22,ENSG00000159496.9,23691013,chr22-23696660-T-C,rs1007298,1,T,C,23696660,5647,23494405,23887621,202255
22,ENSG00000234965.1,41915074,chr22-41843344-G-C,rs1009544,-1,G,C,41843344,71730,41718466,42111682,124878
22,ENSG00000099937.6,20774113,chr22-20707880-C-T,rs1058552,1,C,T,20707880,66233,20577505,20970721,130375
22,ENSG00000244486.2,20437825,chr22-20552080-G-A,rs1075339,-1,G,A,20552080,114255,20241217,20634433,310863
22,ENSG00000184164.10,49918634,chr22-49926381-G-T,rs10854860,1,G,T,49926381,7747,49722026,50115242,204355
22,ENSG00000184164.10,49918634,chr22-49926381-G-A,rs10854860,1,G,A,49926381,7747,49722026,50115242,204355
22,ENSG00000215012.4,19854874,chr22-19841917-G-A,rs11089314,-1,G,A,19841917,12957,19658266,20051482,183651
22,ENSG00000100209.5,28742039,chr22-28608582-G-A,rs111623460,1,G,A,28608582,133457,28545431,28938647,63151
22,ENSG00000100209.5,28742039,chr22-28608582-G-T,rs111623460,1,G,T,28608582,133457,28545431,28938647,63151
22,ENSG00000100220.7,32412247,chr22-32334843-A-G,rs112290541,-1,A,G,32334843,77404,32215639,32608855,119204
22,ENSG00000128242.8,30574665,chr22-30555239-C-T,rs112976399,-1,C,T,30555239,19426,30378057,30771273,177182
22,ENSG00000100239.10,50343327,chr22-50271969-C-T,rs115894888,1,C,T,50271969,71358,50146719,50539935,125250
22,ENSG00000175329.7,35066158,chr22-35143904-G-A,rs11703514,1,G,A,35143904,77746,34869550,35262766,274354
22,ENSG00000100324.8,39399780,chr22-39372075-G-T,rs11704158,1,G,T,39372075,27705,39203172,39596388,168903
22,ENSG00000128283.6,37560480,chr22-37416456-C-T,rs11705648,1,C,T,37416456,144024,37363872,37757088,52584
22,ENSG00000235568.2,42432403,chr22-42469005-C-A,rs11912326,-1,C,A,42469005,36602,42235795,42629011,233210
22,ENSG00000100207.14,42270653,chr22-42384459-G-C,rs11912524,-1,G,C,42384459,113806,42074045,42467261,310414
22,ENSG00000100351.11,39901084,chr22-40035805-A-G,rs11914044,1,A,G,40035805,134721,39704476,40097692,331329
22,ENSG00000073150.8,50170731,chr22-50099472-C-T,rs12169319,1,C,T,50099472,71259,49974123,50367339,125349
22,ENSG00000099954.13,17369460,chr22-17425883-A-T,rs12628073,1,A,T,17425883,56423,17172852,17566068,253031
22,ENSG00000128383.8,38957609,chr22-38962032-A-C,rs12628403,1,A,C,38962032,4423,38761001,39154217,201031
22,ENSG00000128394.12,39040864,chr22-38962032-A-C,rs12628403,1,A,C,38962032,78832,38844256,39237472,117776
22,ENSG00000179750.11,38982347,chr22-38962032-A-C,rs12628403,1,A,C,38962032,20315,38785739,39178955,176293
22,ENSG00000130487.4,50545899,chr22-50549764-A-G,rs131779,1,A,G,50549764,3865,50349291,50742507,200473
22,ENSG00000177989.8,50532498,chr22-50517109-A-G,rs131817,-1,A,G,50517109,15389,50335890,50729106,181219
22,ENSG00000183762.8,29073035,chr22-29129138-C-T,rs132274,1,C,T,29129138,56103,28876427,29269643,252711
22,ENSG00000183172.6,42079700,chr22-42067810-C-T,rs133369,1,C,T,42067810,11890,41883092,42276308,184718
22,ENSG00000188636.3,44498233,chr22-44455210-A-C,rs133754,-1,A,C,44455210,43023,44301625,44694841,153585
22,ENSG00000213923.5,38317433,chr22-38260679-A-G,rs135710,-1,A,G,38260679,56754,38120825,38514041,139854
22,ENSG00000100345.14,36387967,chr22-36276230-A-C,rs136187,-1,A,C,36276230,111737,36191359,36584575,84871
22,ENSG00000183569.12,42553956,chr22-42585161-G-A,rs137086,1,G,A,42585161,31205,42357348,42750564,227813
22,ENSG00000172404.4,40862113,chr22-40876139-T-C,rs138354,-1,T,C,40876139,14026,40665505,41058721,210634
22,ENSG00000100304.10,43187134,chr22-43188223-T-G,rs138957,-1,T,G,43188223,1089,42990526,43383742,197697
22,ENSG00000100298.11,39097244,chr22-39111882-A-G,rs139347,1,A,G,39111882,14638,38900636,39293852,211246
22,ENSG00000239713.3,39077275,chr22-39157767-A-G,rs139413,1,A,G,39157767,80492,38880667,39273883,277100
22,ENSG00000183597.11,20021110,chr22-19969500-C-T,rs165728,1,C,T,19969500,51610,19824502,20217718,144998
22,ENSG00000128203.6,26429260,chr22-26326084-G-A,rs16981735,1,G,A,26326084,103176,26232652,26625868,93432
22,ENSG00000185339.4,30607174,chr22-30644418-G-T,rs16988925,1,G,T,30644418,37244,30410566,30803782,233852
22,ENSG00000128298.11,38110684,chr22-38268439-T-C,rs16998865,-1,T,C,38268439,157755,37914076,38307292,354363
22,ENSG00000128298.11,38110684,chr22-38268439-T-G,rs16998865,-1,T,G,38268439,157755,37914076,38307292,354363
22,ENSG00000100221.6,38700943,chr22-38586026-C-A,rs16999109,-1,C,A,38586026,114917,38504335,38897551,81691
22,ENSG00000100226.11,38705944,chr22-38586026-C-A,rs16999109,1,C,A,38586026,119918,38509336,38902552,76690
22,ENSG00000100147.8,41800679,chr22-41756984-A-C,rs17377643,1,A,C,41756984,43695,41604071,41997287,152913
22,ENSG00000100292.12,35381096,chr22-35383230-T-C,rs17885925,1,T,C,35383230,2134,35184488,35577704,198742
22,ENSG00000100084.9,19431733,chr22-19298947-T-C,rs2023637,-1,T,C,19298947,132786,19235125,19628341,63822
22,ENSG00000100321.10,39349991,chr22-39351775-G-A,rs2069235,1,G,A,39351775,1784,39153383,39546599,198392
22,ENSG00000128218.7,23754425,chr22-23754487-A-C,rs2070454,-1,A,C,23754487,62,23557817,23951033,196670
22,ENSG00000100116.11,37807934,chr22-37808252-C-T,rs2071910,1,C,T,37808252,318,37611326,38004542,196926
22,ENSG00000185022.7,38201994,chr22-38121398-T-C,rs2076116,1,T,C,38121398,80596,38005386,38398602,116012
22,ENSG00000093000.13,45163925,chr22-45188017-A-G,rs226515,1,A,G,45188017,24092,44967317,45360533,220700
22,ENSG00000099956.12,23786966,chr22-23775729-A-G,rs2267029,1,A,G,23775729,11237,23590358,23983574,185371
22,ENSG00000128294.10,26590132,chr22-26578776-G-A,rs2267097,-1,G,A,26578776,11356,26393524,26786740,185252
22,ENSG00000159958.3,41926806,chr22-41905010-A-G,rs2269662,-1,A,G,41905010,21796,41730198,42123414,174812
22,ENSG00000077935.12,45413599,chr22-45413743-C-A,rs2272804,-1,C,A,45413743,144,45216991,45610207,196752
22,ENSG00000128408.7,45413693,chr22-45413743-C-A,rs2272804,1,C,A,45413743,50,45217085,45610301,196658
22,ENSG00000100427.11,50085426,chr22-50144197-A-G,rs2272837,-1,A,G,50144197,58771,49888818,50282034,255379
22,ENSG00000100225.13,32474811,chr22-32326976-C-A,rs2281032,1,C,A,32326976,147835,32278203,32671419,48773
22,ENSG00000128253.9,32205073,chr22-32386141-A-C,rs2281034,-1,A,C,32386141,181068,32008465,32401681,377676
22,ENSG00000079974.13,50783636,chr22-50739662-G-A,rs2285395,-1,G,A,50739662,43974,50587028,50980244,152634
22,ENSG00000100385.8,37149916,chr22-37158799-C-G,rs229484,-1,C,G,37158799,8883,36953308,37346524,205491
22,ENSG00000100038.14,21982787,chr22-21912468-G-A,rs240055,-1,G,A,21912468,70319,21786179,22179395,126289
22,ENSG00000100027.10,21735794,chr22-21912468-G-A,rs240055,-1,G,A,21912468,176674,21539186,21932402,373282
22,ENSG00000128340.10,37244269,chr22-37092941-A-G,rs2543515,-1,A,G,37092941,151328,37047661,37440877,45280
22,ENSG00000100167.15,41969443,chr22-42134634-G-A,rs28641480,1,G,A,42134634,165191,41772835,42166051,361799
22,ENSG00000243811.2,39021127,chr22-39024596-T-C,rs34074269,1,T,C,39024596,3469,38824519,39217735,200077
22,ENSG00000128309.11,37019742,chr22-37018427-T-G,rs35156365,1,T,G,37018427,1315,36823134,37216350,195293
22,ENSG00000128311.8,37019447,chr22-37018427-T-G,rs35156365,-1,T,G,37018427,1020,36822839,37216055,195588
22,ENSG00000100129.11,37849419,chr22-37762734-A-G,rs3788530,1,A,G,37762734,86685,37652811,38046027,109923
22,ENSG00000099917.12,20507610,chr22-20565159-G-A,rs3791192,1,G,A,20565159,57549,20311002,20704218,254157
22,ENSG00000100211.6,38656638,chr22-38668801-A-C,rs3827356,1,A,C,38668801,12163,38460030,38853246,208771
22,ENSG00000183773.10,20967255,chr22-21031696-C-T,rs402931,1,C,T,21031696,64441,20770647,21163863,261049
22,ENSG00000099957.11,21015165,chr22-21065510-C-T,rs410356,1,C,T,21065510,50345,20818557,21211773,246953
22,ENSG00000217442.3,50562919,chr22-50550768-C-T,rs41281529,-1,C,T,50550768,12151,50366311,50759527,184457
22,ENSG00000100360.10,36776119,chr22-36754958-G-C,rs41466945,-1,G,C,36754958,21161,36579511,36972727,175447
22,ENSG00000183741.7,38872216,chr22-38885631-A-G,rs4361209,-1,A,G,38885631,13415,38675608,39068824,210023
22,ENSG00000239900.4,40346500,chr22-40453700-C-A,rs4507196,1,C,A,40453700,107200,40149892,40543108,303808
22,ENSG00000243156.2,18024561,chr22-17973064-A-G,rs453557,-1,A,G,17973064,51497,17827953,18221169,145111
22,ENSG00000183785.9,18110809,chr22-18114735-T-C,rs464901,1,T,C,18114735,3926,17914201,18307417,200534
22,ENSG00000215193.5,18077990,chr22-18072368-A-G,rs4819666,1,A,G,18072368,5622,17881382,18274598,190986
22,ENSG00000185721.6,31399604,chr22-31440392-G-T,rs4820972,1,G,T,31440392,40788,31202996,31596212,237396
22,ENSG00000100365.10,36861006,chr22-36856876-C-T,rs4821542,1,C,T,36856876,4130,36664398,37057614,192478
22,ENSG00000133466.9,37188247,chr22-37213254-A-G,rs4821603,-1,A,G,37213254,25007,36991639,37384855,221615
22,ENSG00000167074.9,41381942,chr22-41380642-G-C,rs4822025,1,G,C,41380642,1300,41185334,41578550,195308
22,ENSG00000167074.9,41381942,chr22-41380642-G-A,rs4822025,1,G,A,41380642,1300,41185334,41578550,195308
22,ENSG00000188677.9,44024302,chr22-44161183-G-A,rs4823197,1,G,A,44161183,136881,43827694,44220910,333489
22,ENSG00000188130.8,50261683,chr22-50430496-A-C,rs4824127,-1,A,C,50430496,168813,50065075,50458291,365421
22,ENSG00000128165.7,50481543,chr22-50458349-G-A,rs4824149,1,G,A,50458349,23194,50284935,50678151,173414
22,ENSG00000170638.5,50185913,chr22-50217680-A-C,rs55955211,1,A,C,50217680,31767,49989305,50382521,228375
22,ENSG00000093010.7,19941772,chr22-19939623-A-C,rs5748489,1,A,C,19939623,2149,19745164,20138380,194459
22,ENSG00000128272.10,39520562,chr22-39541264-A-G,rs5750848,1,A,G,39541264,20702,39323954,39717170,217310
22,ENSG00000172346.9,41561010,chr22-41619761-C-T,rs5751129,1,C,T,41619761,58751,41364402,41757618,255359
22,ENSG00000100197.15,42130810,chr22-42037797-C-T,rs5751204,-1,C,T,42037797,93013,41934202,42327418,103595
22,ENSG00000186716.14,23180509,chr22-23181443-C-A,rs5751602,1,C,A,23181443,934,22983901,23377117,197542
22,ENSG00000099953.5,23772849,chr22-23842663-A-G,rs5751749,1,A,G,23842663,69814,23576241,23969457,266422
22,ENSG00000099940.6,20859007,chr22-20751767-G-A,rs5751852,1,G,A,20751767,107240,20662399,21055615,89368
22,ENSG00000100031.14,24603193,chr22-24596299-T-C,rs5751901,1,T,C,24596299,6894,24406585,24799801,189714
22,ENSG00000178026.8,24593073,chr22-24604262-A-T,rs5751904,-1,A,T,24604262,11189,24396465,24789681,207797
22,ENSG00000100319.11,29767007,chr22-29657974-A-G,rs5752949,-1,A,G,29657974,109033,29570399,29963615,87575
22,ENSG00000100314.3,29720003,chr22-29657974-A-G,rs5752949,1,A,G,29657974,62029,29523395,29916611,134579
22,ENSG00000100307.8,39152680,chr22-39262621-T-C,rs5757580,-1,T,C,39262621,109941,38956072,39349288,306549
22,ENSG00000100271.11,43089391,chr22-43058449-A-G,rs5759124,-1,A,G,43058449,30942,42892783,43285999,165666
22,ENSG00000100294.7,43143398,chr22-43077428-T-C,rs5759142,-1,T,C,43077428,65970,42946790,43340006,130638
22,ENSG00000099998.12,24245082,chr22-24240854-T-C,rs5760273,-1,T,C,24240854,4228,24048474,24441690,192380
22,ENSG00000183579.10,28883572,chr22-28890192-C-T,rs5762879,1,C,T,28890192,6620,28686964,29080180,203228
22,ENSG00000100347.10,43955442,chr22-43889189-G-A,rs5764386,1,G,A,43889189,66253,43758834,44152050,130355
22,ENSG00000182902.8,17563498,chr22-17619861-A-G,rs5992761,1,A,G,17619861,56363,17366890,17760106,252971
22,ENSG00000183864.4,41446801,chr22-41335492-C-T,rs5996020,-1,C,T,41335492,111309,41250193,41643409,85299
22,ENSG00000100417.7,41589840,chr22-41585953-A-G,rs5996039,-1,A,G,41585953,3887,41393232,41786448,192721
22,ENSG00000100243.15,42649392,chr22-42645831-A-C,rs6002851,-1,A,C,42645831,3561,42452784,42846000,193047
22,ENSG00000100364.13,45240894,chr22-45247026-T-C,rs6006956,-1,T,C,45247026,6132,45044286,45437502,202740
22,ENSG00000075234.12,46268008,chr22-46292311-C-A,rs6008552,1,C,A,46292311,24303,46071400,46464616,220911
22,ENSG00000073169.9,50201011,chr22-50205748-G-A,rs6010202,1,G,A,50205748,4737,50004403,50397619,201345
22,ENSG00000250479.3,23767972,chr22-23765421-G-A,rs61160578,-1,G,A,23765421,2551,23571364,23964580,194057
22,ENSG00000100299.12,50628152,chr22-50625049-T-C,rs6151429,-1,T,C,50625049,3103,50431544,50824760,193505
22,ENSG00000198792.7,38273010,chr22-38283399-T-G,rs62230172,-1,T,G,38283399,10389,38076402,38469618,206997
22,ENSG00000100401.14,41286187,chr22-41325340-C-A,rs62238179,-1,C,A,41325340,39153,41089579,41482795,235761
22,ENSG00000205593.5,50327012,chr22-50320444-C-T,rs62241237,-1,C,T,50320444,6568,50130404,50523620,190040
22,ENSG00000100290.2,43110750,chr22-43120016-C-T,rs6519362,1,C,T,43120016,9266,42914142,43307358,205874
22,ENSG00000187045.12,37109713,chr22-36927772-C-T,rs7286768,-1,C,T,36927772,181941,36913105,37306321,14667
22,ENSG00000169314.9,23762990,chr22-23764499-C-T,rs7291060,1,C,T,23764499,1509,23566382,23959598,198117
22,ENSG00000133460.13,23857875,chr22-23764499-C-T,rs7291060,1,C,T,23764499,93376,23661267,24054483,103232
22,ENSG00000100418.7,41621043,chr22-41642253-C-A,rs7291732,-1,C,A,41642253,21210,41424435,41817651,217818
22,ENSG00000100023.12,21666012,chr22-21635036-C-T,rs730882,1,C,T,21635036,30976,21469404,21862620,165632
22,ENSG00000100056.7,19144651,chr22-19144812-A-G,rs737923,-1,A,G,19144812,161,18948043,19341259,196769
22,ENSG00000128274.10,42720870,chr22-42716469-C-T,rs738526,-1,C,T,42716469,4401,42524262,42917478,192207
22,ENSG00000186998.11,29205896,chr22-29225139-C-G,rs743920,1,C,G,29225139,19243,29009288,29402504,215851
22,ENSG00000025708.8,50530012,chr22-50504994-G-A,rs762669,-1,G,A,50504994,25018,50333404,50726620,171590
22,ENSG00000188064.5,45977162,chr22-46100176-G-A,rs77251783,-1,G,A,46100176,123014,45780554,46173770,319622
22,ENSG00000100036.11,30635781,chr22-30612806-G-A,rs79711084,1,G,A,30612806,22975,30439173,30832389,173633
22,ENSG00000128159.7,50245023,chr22-50052506-T-C,rs79814761,-1,T,C,50052506,192517,50048415,50441631,4091
22,ENSG00000069998.8,17159277,chr22-17158947-A-G,rs79822985,-1,A,G,17158947,330,16962669,17355885,196278
22,ENSG00000025770.13,50508224,chr22-50587778-T-C,rs8137073,1,T,C,50587778,79554,50311616,50704832,276162
22,ENSG00000099994.10,24181487,chr22-24029959-C-T,rs8137455,1,C,T,24029959,151528,23984879,24378095,45080
22,ENSG00000100285.8,29480218,chr22-29446153-C-A,rs8141113,1,C,A,29446153,34065,29283610,29676826,162543
22,ENSG00000040608.9,20268318,chr22-20226155-A-C,rs854962,-1,A,C,20226155,42163,20071710,20464926,154445
22,ENSG00000183307.3,17121360,chr22-17108677-C-T,rs879575,-1,C,T,17108677,12683,16924752,17317968,183925
22,ENSG00000100368.8,36913628,chr22-36864559-A-G,rs909484,1,A,G,36864559,49069,36717020,37110236,147539
22,ENSG00000180957.12,27919256,chr22-27883606-C-T,rs926467,-1,C,T,27883606,35650,27722648,28115864,160958
22,ENSG00000138964.10,44180925,chr22-44181270-G-T,rs9306473,1,G,T,44181270,345,43984317,44377533,196953
22,ENSG00000099904.11,20131804,chr22-19955462-C-T,rs9332348,1,C,T,19955462,176342,19935196,20328412,20266
22,ENSG00000093072.10,17219435,chr22-17220344-A-G,rs9606655,-1,A,G,17220344,909,17022827,17416043,197517
22,ENSG00000100413.12,41544470,chr22-41371482-T-C,rs9611565,-1,T,C,41371482,172988,41347862,41741078,23620
22,ENSG00000100296.9,29553757,chr22-29727040-G-C,rs9614041,-1,G,C,29727040,173283,29357149,29750365,369891
22,ENSG00000100296.9,29553757,chr22-29727040-G-A,rs9614041,-1,G,A,29727040,173283,29357149,29750365,369891
22,ENSG00000176177.9,39893760,chr22-39782614-T-C,rs9623071,-1,T,C,39782614,111146,39697152,40090368,85462
22,ENSG00000133433.6,23961195,chr22-23969285-G-A,rs9624364,-1,G,A,23969285,8090,23764587,24157803,204698
22,ENSG00000100311.12,39244982,chr22-39274846-G-T,rs968451,-1,G,T,39274846,29864,39048374,39441590,226472
22,ENSG00000100104.7,26483877,chr22-26420216-C-T,rs9917612,1,C,T,26420216,63661,26287269,26680485,132947
22,ENSG00000183773.10,20967255,chr22-20980635-G-C,rs105034,1,G,C,20980635,13380,20770647,21163863,209988
22,ENSG00000100299.12,50628152,chr22-50542911-C-T,rs113637408,-1,C,T,50542911,85241,50431544,50824760,111367
22,ENSG00000188636.3,44498233,chr22-44430681-G-C,rs115020852,-1,G,C,44430681,67552,44301625,44694841,129056
22,ENSG00000188636.3,44498233,chr22-44430681-G-T,rs115020852,-1,G,T,44430681,67552,44301625,44694841,129056
22,ENSG00000100258.12,50507702,chr22-50512918-A-G,rs115920265,-1,A,G,50512918,5216,50311094,50704310,201824
22,ENSG00000100281.9,35257493,chr22-35447806-C-T,rs116859443,1,C,T,35447806,190313,35060885,35454101,386921
22,ENSG00000128408.7,45413693,chr22-45446523-G-T,rs11704569,1,G,T,45446523,32830,45217085,45610301,229438
22,ENSG00000184702.12,19714503,chr22-19639908-C-G,rs11705429,1,C,G,19639908,74595,19517895,19911111,122013
22,ENSG00000099957.11,21015165,chr22-21044065-C-T,rs117468585,1,C,T,21044065,28900,20818557,21211773,225508
22,ENSG00000099957.11,21015165,chr22-21044065-C-G,rs117468585,1,C,G,21044065,28900,20818557,21211773,225508
22,ENSG00000099956.12,23786966,chr22-23805408-T-C,rs11912715,1,T,C,23805408,18442,23590358,23983574,215050
22,ENSG00000167065.9,30667875,chr22-30667845-G-A,rs11912792,-1,G,A,30667845,30,30471267,30864483,196578
22,ENSG00000167065.9,30667875,chr22-30667845-G-C,rs11912792,-1,G,C,30667845,30,30471267,30864483,196578
22,ENSG00000015475.14,17774469,chr22-17860245-C-A,rs11917,-1,C,A,17860245,85776,17577861,17971077,282384
22,ENSG00000205560.8,50578427,chr22-50387186-G-A,rs12159089,-1,G,A,50387186,191241,50381819,50775035,5367
22,ENSG00000100347.10,43955442,chr22-44005991-C-T,rs12160094,1,C,T,44005991,50549,43758834,44152050,247157
22,ENSG00000184792.11,30694874,chr22-30889149-T-C,rs12166521,1,T,C,30889149,194275,30498266,30891482,390883
22,ENSG00000184792.11,30694874,chr22-30889149-T-G,rs12166521,1,T,G,30889149,194275,30498266,30891482,390883
22,ENSG00000100243.15,42649392,chr22-42665476-G-A,rs130328,-1,G,A,42665476,16084,42452784,42846000,212692
22,ENSG00000172404.4,40862113,chr22-40679539-A-G,rs133072,-1,A,G,40679539,182574,40665505,41058721,14034
22,ENSG00000100197.15,42130810,chr22-42285854-T-C,rs134897,-1,T,C,42285854,155044,41934202,42327418,351652
22,ENSG00000189306.6,42519796,chr22-42586566-C-G,rs137091,-1,C,G,42586566,66770,42323188,42716404,263378
22,ENSG00000182858.7,49918438,chr22-50028113-T-C,rs137890,-1,T,C,50028113,109675,49721830,50115046,306283
22,ENSG00000100304.10,43187134,chr22-43197126-C-G,rs138973,-1,C,G,43197126,9992,42990526,43383742,206600
22,ENSG00000138964.10,44180925,chr22-44170346-C-A,rs139099,1,C,A,44170346,10579,43984317,44377533,186029
22,ENSG00000239713.3,39077275,chr22-39111882-A-G,rs139347,1,A,G,39111882,34607,38880667,39273883,231215
22,ENSG00000243811.2,39021127,chr22-39151196-G-A,rs139404,1,G,A,39151196,130069,38824519,39217735,326677
22,ENSG00000100276.8,29315697,chr22-29296498-G-T,rs140065,-1,G,T,29296498,19199,29119089,29512305,177409
22,ENSG00000130487.4,50545899,chr22-50522253-C-T,rs140524,1,C,T,50522253,23646,50349291,50742507,172962
22,ENSG00000177989.8,50532498,chr22-50522253-C-T,rs140524,-1,C,T,50522253,10245,50335890,50729106,186363
22,ENSG00000183307.3,17121360,chr22-17179611-C-G,rs14332,-1,C,G,17179611,58251,16924752,17317968,254859
22,ENSG00000183307.3,17121360,chr22-17179611-C-A,rs14332,-1,C,A,17179611,58251,16924752,17317968,254859
22,ENSG00000185838.9,19854874,chr22-19827686-T-G,rs1468090,-1,T,G,19827686,27188,19658266,20051482,169420
22,ENSG00000100372.10,40819346,chr22-40844831-G-A,rs1573745,-1,G,A,40844831,25485,40622738,41015954,222093
22,ENSG00000100104.7,26483877,chr22-26388913-T-C,rs16982000,1,T,C,26388913,94964,26287269,26680485,101644
22,ENSG00000075275.12,46537620,chr22-46393383-C-T,rs16995177,-1,C,T,46393383,144237,46341012,46734228,52371
22,ENSG00000100284.13,35299894,chr22-35325857-A-T,rs16995584,1,A,T,35325857,25963,35103286,35496502,222571
22,ENSG00000100320.16,35840587,chr22-35651093-G-A,rs16995908,-1,G,A,35651093,189494,35643979,36037195,7114
22,ENSG00000239900.4,40346500,chr22-40363304-A-G,rs17001863,1,A,G,40363304,16804,40149892,40543108,213412
22,ENSG00000128250.5,29438583,chr22-29382463-G-C,rs174773,1,G,C,29382463,56120,29241975,29635191,140488
22,ENSG00000184436.7,21002118,chr22-20996591-T-C,rs178295,-1,T,C,20996591,5527,20805510,21198726,191081
22,ENSG00000099949.13,20982297,chr22-20997892-T-C,rs178296,1,T,C,20997892,15595,20785689,21178905,212203
22,ENSG00000100151.11,38057404,chr22-38077805-T-G,rs2012867,1,T,G,38077805,20401,37860796,38254012,217009
22,ENSG00000166897.9,37427479,chr22-37499947-A-G,rs2015823,-1,A,G,37499947,72468,37230871,37624087,269076
22,ENSG00000099889.9,20016823,chr22-19997984-G-A,rs2073745,-1,G,A,19997984,18839,19820215,20213431,177769
22,ENSG00000128383.8,38957609,chr22-38996385-C-G,rs2179233,1,C,G,38996385,38776,38761001,39154217,235384
22,ENSG00000179750.11,38982347,chr22-38996385-C-G,rs2179233,1,C,G,38996385,14038,38785739,39178955,210646
22,ENSG00000185339.4,30607174,chr22-30615570-T-C,rs2267163,1,T,C,30615570,8396,30410566,30803782,205004
22,ENSG00000213923.5,38317433,chr22-38169202-G-A,rs2267368,-1,G,A,38169202,148231,38120825,38514041,48377
22,ENSG00000128276.6,32357867,chr22-32397397-T-C,rs2294312,1,T,C,32397397,39530,32161259,32554475,236138
22,ENSG00000128340.10,37244269,chr22-37178224-C-T,rs229512,-1,C,T,37178224,66045,37047661,37440877,130563
22,ENSG00000133466.9,37188247,chr22-37195278-G-A,rs229541,-1,G,A,37195278,7031,36991639,37384855,203639
22,ENSG00000100288.15,50582849,chr22-50429584-A-G,rs2334099,-1,A,G,50429584,153265,50386241,50779457,43343
22,ENSG00000100034.8,21952848,chr22-21994691-C-T,rs238775,-1,C,T,21994691,41843,21756240,22149456,238451
22,ENSG00000100038.14,21982787,chr22-21985092-G-A,rs238780,-1,G,A,21985092,2305,21786179,22179395,198913
22,ENSG00000100038.14,21982787,chr22-21985092-G-T,rs238780,-1,G,T,21985092,2305,21786179,22179395,198913
22,ENSG00000183569.12,42553956,chr22-42500468-T-C,rs2413692,1,T,C,42500468,53488,42357348,42750564,143120
22,ENSG00000182944.13,29268268,chr22-29299939-T-G,rs2518683,1,T,G,29299939,31671,29071660,29464876,228279
22,ENSG00000217442.3,50562919,chr22-50500185-T-C,rs28375115,-1,T,C,50500185,62734,50366311,50759527,133874
22,ENSG00000235568.2,42432403,chr22-42421786-T-C,rs28405495,-1,T,C,42421786,10617,42235795,42629011,185991
22,ENSG00000025708.8,50530012,chr22-50597456-C-T,rs3213443,-1,C,T,50597456,67444,50333404,50726620,264052
22,ENSG00000130943.5,46263343,chr22-46364189-C-T,rs35364389,-1,C,T,46364189,100846,46066735,46459951,297454
22,ENSG00000185252.13,20394151,chr22-20565159-G-A,rs3791192,1,G,A,20565159,171008,20197543,20590759,367616
22,ENSG00000100360.10,36776119,chr22-36761196-C-A,rs3827351,-1,C,A,36761196,14923,36579511,36972727,181685
22,ENSG00000169184.5,27801756,chr22-27750289-G-A,rs41277851,-1,G,A,27750289,51467,27605148,27998364,145141
22,ENSG00000183172.6,42079700,chr22-42145327-G-A,rs4467371,1,G,A,42145327,65627,41883092,42276308,262235
22,ENSG00000215193.5,18077990,chr22-18100501-T-C,rs467504,1,T,C,18100501,22511,17881382,18274598,219119
22,ENSG00000099977.9,23974441,chr22-23900786-A-G,rs4820571,-1,A,G,23900786,73655,23777833,24171049,122953
22,ENSG00000100263.9,29267981,chr22-29273659-G-A,rs4820803,-1,G,A,29273659,5678,29071373,29464589,202286
22,ENSG00000100263.9,29267981,chr22-29273659-G-C,rs4820803,-1,G,C,29273659,5678,29071373,29464589,202286
22,ENSG00000100387.8,40951378,chr22-41047071-T-C,rs4821992,1,T,C,41047071,95693,40754770,41147986,292301
22,ENSG00000133433.6,23961195,chr22-23913109-C-T,rs4822455,-1,C,T,23913109,48086,23764587,24157803,148522
22,ENSG00000240972.1,23894383,chr22-24028666-G-C,rs4822469,1,G,C,24028666,134283,23697775,24090991,330891
22,ENSG00000100376.7,45309934,chr22-45457227-C-T,rs4823219,1,C,T,45457227,147293,45113326,45506542,343901
22,ENSG00000205593.5,50327012,chr22-50247079-A-G,rs4838866,-1,A,G,50247079,79933,50130404,50523620,116675
22,ENSG00000100354.14,40177925,chr22-40051298-C-G,rs55754970,1,C,G,40051298,126627,39981317,40374533,69981
22,ENSG00000100336.13,36201809,chr22-36238540-A-C,rs55880164,-1,A,C,36238540,36731,36005201,36398417,233339
22,ENSG00000100336.13,36201809,chr22-36238540-A-T,rs55880164,-1,A,T,36238540,36731,36005201,36398417,233339
22,ENSG00000073169.9,50201011,chr22-50044449-A-G,rs56263616,1,A,G,50044449,156562,50004403,50397619,40046
22,ENSG00000131100.8,17628749,chr22-17589857-C-G,rs5747244,-1,C,G,17589857,38892,17432141,17825357,157716
22,ENSG00000185608.4,19432545,chr22-19530636-C-G,rs5748261,1,C,G,19530636,98091,19235937,19629153,294699
22,ENSG00000100218.7,23141990,chr22-23146855-G-A,rs5751591,-1,G,A,23146855,4865,22945382,23338598,201473
22,ENSG00000100353.12,36529166,chr22-36495811-C-A,rs5756219,-1,C,A,36495811,33355,36332558,36725774,163253
22,ENSG00000100368.8,36913628,chr22-36881574-A-G,rs5756381,1,A,G,36881574,32054,36717020,37110236,164554
22,ENSG00000187051.4,39532748,chr22-39545149-A-G,rs5757715,-1,A,G,39545149,12401,39336140,39729356,209009
22,ENSG00000100412.10,41469117,chr22-41435263-A-C,rs5758350,1,A,C,41435263,33854,41272509,41665725,162754
22,ENSG00000186716.14,23180509,chr22-23138775-T-G,rs5759598,1,T,G,23138775,41734,22983901,23377117,154874
22,ENSG00000128218.7,23754425,chr22-23813427-G-A,rs5760045,-1,G,A,23813427,59002,23557817,23951033,255610
22,ENSG00000093000.13,45163925,chr22-45065901-G-A,rs5766388,1,G,A,45065901,98024,44967317,45360533,98584
22,ENSG00000075240.12,46620386,chr22-46581342-A-G,rs5768982,1,A,G,46581342,39044,46423778,46816994,157564
22,ENSG00000128165.7,50481543,chr22-50464322-C-T,rs5771041,1,C,T,50464322,17221,50284935,50678151,179387
22,ENSG00000170638.5,50185913,chr22-50189275-G-T,rs5771217,1,G,T,50189275,3362,49989305,50382521,199970
22,ENSG00000170638.5,50185913,chr22-50189275-G-A,rs5771217,1,G,A,50189275,3362,49989305,50382521,199970
22,ENSG00000100364.13,45240894,chr22-45223007-C-T,rs58112670,-1,C,T,45223007,17887,45044286,45437502,178721
22,ENSG00000100060.12,37486384,chr22-37398253-A-C,rs5995425,-1,A,C,37398253,88131,37289776,37682992,108477
22,ENSG00000100335.8,39502290,chr22-39393081-A-C,rs5995729,1,A,C,39393081,109209,39305682,39698898,87399
22,ENSG00000128253.9,32205073,chr22-32390230-G-A,rs5998471,-1,G,A,32390230,185157,32008465,32401681,381765
22,ENSG00000161180.5,21632760,chr22-21591562-G-A,rs5998619,1,G,A,21591562,41198,21436152,21829368,155410
22,ENSG00000198125.7,35617329,chr22-35733656-T-G,rs5999988,-1,T,G,35733656,116327,35420721,35813937,312935
22,ENSG00000075218.13,46296870,chr22-46282007-A-G,rs6008495,1,A,G,46282007,14863,46100262,46493478,181745
22,ENSG00000100206.4,38570183,chr22-38674917-C-T,rs6519132,-1,C,T,38674917,104734,38373575,38766791,301342
22,ENSG00000100294.7,43143398,chr22-43162966-G-A,rs6972,-1,G,A,43162966,19568,42946790,43340006,216176
22,ENSG00000100300.12,43151559,chr22-43163131-G-T,rs6973,1,G,T,43163131,11572,42954951,43348167,208180
22,ENSG00000182902.8,17563498,chr22-17727794-T-G,rs725769,1,T,G,17727794,164296,17366890,17760106,360904
22,ENSG00000185721.6,31399604,chr22-31423133-A-C,rs73160619,1,A,C,31423133,23529,31202996,31596212,220137
22,ENSG00000100348.5,36481640,chr22-36493069-C-A,rs73169658,-1,C,A,36493069,11429,36285032,36678248,208037
22,ENSG00000054611.9,46762650,chr22-46749059-G-T,rs73182605,1,G,T,46749059,13591,46566042,46959258,183017
22,ENSG00000100129.11,37849419,chr22-37780263-C-T,rs73411546,1,C,T,37780263,69156,37652811,38046027,127452
22,ENSG00000100319.11,29767007,chr22-29676770-T-C,rs737787,-1,T,C,29676770,90237,29570399,29963615,106371
22,ENSG00000100290.2,43110750,chr22-43114213-A-G,rs738276,1,A,G,43114213,3463,42914142,43307358,200071
22,ENSG00000128283.6,37560480,chr22-37506170-T-C,rs738304,1,T,C,37506170,54310,37363872,37757088,142298
22,ENSG00000188130.8,50261683,chr22-50132326-G-C,rs75570992,-1,G,C,50132326,129357,50065075,50458291,67251
22,ENSG00000100365.10,36861006,chr22-36867664-C-T,rs760519,1,C,T,36867664,6658,36664398,37057614,203266
22,ENSG00000196576.9,50307646,chr22-50445299-G-A,rs761744,-1,G,A,50445299,137653,50111038,50504254,334261
22,ENSG00000185022.7,38201994,chr22-38240789-G-A,rs76599369,1,G,A,38240789,38795,38005386,38398602,235403
22,ENSG00000077935.12,45413599,chr22-45481572-T-C,rs76935916,-1,T,C,45481572,67973,45216991,45610207,264581
22,ENSG00000184164.10,49918634,chr22-49919039-C-T,rs79431035,1,C,T,49919039,405,49722026,50115242,197013
22,ENSG00000075234.12,46268008,chr22-46323157-T-C,rs8135305,1,T,C,46323157,55149,46071400,46464616,251757
22,ENSG00000128346.6,37953601,chr22-38136281-T-C,rs8135937,-1,T,C,38136281,182680,37756993,38150209,379288
22,ENSG00000100298.11,39097244,chr22-39146287-G-A,rs877529,1,G,A,39146287,49043,38900636,39293852,245651
22,ENSG00000040608.9,20268318,chr22-20247294-C-T,rs887765,-1,C,T,20247294,21024,20071710,20464926,175584
22,ENSG00000040608.9,20268318,chr22-20247294-C-G,rs887765,-1,C,G,20247294,21024,20071710,20464926,175584
22,ENSG00000169314.9,23762990,chr22-23891275-C-T,rs915591,1,C,T,23891275,128285,23566382,23959598,324893
22,ENSG00000198832.6,31107568,chr22-31097139-G-A,rs917208,-1,G,A,31097139,10429,30910960,31304176,186179
22,ENSG00000069998.8,17159277,chr22-17178262-T-C,rs9306251,-1,T,C,17178262,18985,16962669,17355885,215593
22,ENSG00000186951.11,46150526,chr22-45968281-G-A,rs9330813,1,G,A,45968281,182245,45953918,46347134,14363
22,ENSG00000100036.11,30635781,chr22-30610873-A-G,rs9606756,1,A,G,30610873,24908,30439173,30832389,171700
22,ENSG00000100106.14,37697048,chr22-37690567-C-T,rs9610834,1,C,T,37690567,6481,37500440,37893656,190127
22,ENSG00000100226.11,38705944,chr22-38828118-G-A,rs9611033,1,G,A,38828118,122174,38509336,38902552,318782
22,ENSG00000100266.11,43015149,chr22-42904004-C-A,rs9611959,-1,C,A,42904004,111145,42818541,43211757,85463
22,ENSG00000099953.5,23772849,chr22-23832323-G-A,rs9612481,1,G,A,23832323,59474,23576241,23969457,256082
22,ENSG00000184117.7,29581113,chr22-29585255-G-C,rs9613971,-1,G,C,29585255,4142,29384505,29777721,200750
22,ENSG00000184117.7,29581113,chr22-29585255-G-A,rs9613971,-1,G,A,29585255,4142,29384505,29777721,200750
22,ENSG00000128185.5,20320060,chr22-20343221-C-T,rs9617876,-1,C,T,20343221,23161,20123452,20516668,219769
22,ENSG00000133475.12,21227637,chr22-21070630-A-G,rs9620785,-1,A,G,21070630,157007,21031029,21424245,39601
22,ENSG00000206203.3,19131308,chr22-19220335-C-T,rs999699,1,C,T,19220335,89027,18934700,19327916,285635
22,ENSG00000243156.2,18024561,chr22-17961968-C-T,rs1110661,-1,C,T,17961968,62593,17827953,18221169,134015
22,ENSG00000205560.8,50578427,chr22-50410214-G-T,rs112430043,-1,G,T,50410214,168213,50381819,50775035,28395
22,ENSG00000183762.8,29073035,chr22-29107146-A-G,rs114239625,1,A,G,29107146,34111,28876427,29269643,230719
22,ENSG00000184381.11,38181830,chr22-38122615-A-G,rs11570734,-1,A,G,38122615,59215,37985222,38378438,137393
22,ENSG00000170638.5,50185913,chr22-50213998-C-T,rs11703673,1,C,T,50213998,28085,49989305,50382521,224693
22,ENSG00000198089.9,31496536,chr22-31400577-C-T,rs11704156,1,C,T,31400577,95959,31299928,31693144,100649
22,ENSG00000100395.10,41205312,chr22-41361766-C-A,rs117079136,1,C,A,41361766,156454,41008704,41401920,353062
22,ENSG00000093000.13,45163925,chr22-45030339-A-G,rs117680337,1,A,G,45030339,133586,44967317,45360533,63022
22,ENSG00000100290.2,43110750,chr22-43028277-G-A,rs11912530,1,G,A,43028277,82473,42914142,43307358,114135
22,ENSG00000100129.11,37849419,chr22-37859192-A-G,rs11913731,1,A,G,37859192,9773,37652811,38046027,206381
22,ENSG00000128311.8,37019447,chr22-37077067-G-T,rs12159830,-1,G,T,37077067,57620,36822839,37216055,254228
22,ENSG00000205593.5,50327012,chr22-50422154-T-C,rs12163230,-1,T,C,50422154,95142,50130404,50523620,291750
22,ENSG00000100311.12,39244982,chr22-39350419-C-T,rs12166817,-1,C,T,39350419,105437,39048374,39441590,302045
22,ENSG00000100311.12,39244982,chr22-39350419-C-A,rs12166817,-1,C,A,39350419,105437,39048374,39441590,302045
22,ENSG00000100219.10,28800524,chr22-28806075-A-G,rs12168849,-1,A,G,28806075,5551,28603916,28997132,202159
22,ENSG00000166897.9,37427479,chr22-37317772-G-A,rs12710561,-1,G,A,37317772,109707,37230871,37624087,86901
22,ENSG00000100075.5,19178736,chr22-19286738-T-C,rs13056680,-1,T,C,19286738,108002,18982128,19375344,304610
22,ENSG00000188636.3,44498233,chr22-44496255-A-G,rs131163,-1,A,G,44496255,1978,44301625,44694841,194630
22,ENSG00000025708.8,50530012,chr22-50525111-G-C,rs131807,-1,G,C,50525111,4901,50333404,50726620,191707
22,ENSG00000177096.4,42074248,chr22-41988121-A-G,rs133295,1,A,G,41988121,86127,41877640,42270856,110481
22,ENSG00000198951.6,42070812,chr22-41988121-A-G,rs133295,-1,A,G,41988121,82691,41874204,42267420,113917
22,ENSG00000167065.9,30667875,chr22-30834406-G-T,rs136218,-1,G,T,30834406,166531,30471267,30864483,363139
22,ENSG00000100321.10,39349991,chr22-39281833-G-A,rs137581,1,G,A,39281833,68158,39153383,39546599,128450
22,ENSG00000172404.4,40862113,chr22-40866848-C-T,rs138351,-1,C,T,40866848,4735,40665505,41058721,201343
22,ENSG00000100380.7,40856639,chr22-40866848-C-T,rs138351,-1,C,T,40866848,10209,40660031,41053247,206817
22,ENSG00000100304.10,43187134,chr22-43189842-C-T,rs138963,-1,C,T,43189842,2708,42990526,43383742,199316
22,ENSG00000138964.10,44180925,chr22-44180205-A-G,rs139123,1,A,G,44180205,720,43984317,44377533,195888
22,ENSG00000243811.2,39021127,chr22-39111882-A-G,rs139347,1,A,G,39111882,90755,38824519,39217735,287363
22,ENSG00000244509.2,39014257,chr22-39131904-G-A,rs139383,1,G,A,39131904,117647,38817649,39210865,314255
22,ENSG00000100288.15,50582849,chr22-50539595-C-A,rs140521,-1,C,A,50539595,43254,50386241,50779457,153354
22,ENSG00000215012.4,19854874,chr22-19890839-T-C,rs1548357,-1,T,C,19890839,35965,19658266,20051482,232573
22,ENSG00000100285.8,29480218,chr22-29478261-A-G,rs165649,1,A,G,29478261,1957,29283610,29676826,194651
22,ENSG00000185686.13,22559265,chr22-22604355-G-A,rs16989599,-1,G,A,22604355,45090,22362657,22755873,241698
22,ENSG00000100351.11,39901084,chr22-39890266-G-A,rs17001508,1,G,A,39890266,10818,39704476,40097692,185790
22,ENSG00000183172.6,42079700,chr22-41886008-C-T,rs17002737,1,C,T,41886008,193692,41883092,42276308,2916
22,ENSG00000182944.13,29268268,chr22-29102568-A-G,rs17522248,1,A,G,29102568,165700,29071660,29464876,30908
22,ENSG00000186654.15,44702204,chr22-44791799-G-A,rs17532423,1,G,A,44791799,89595,44505596,44898812,286203
22,ENSG00000241973.6,20858811,chr22-20997892-T-C,rs178296,-1,T,C,20997892,139081,20662203,21055419,335689
22,ENSG00000128322.6,23580290,chr22-23462943-A-C,rs17842461,-1,A,C,23462943,117347,23383682,23776898,79261
22,ENSG00000128159.7,50245023,chr22-50064634-G-T,rs181700711,-1,G,T,50064634,180389,50048415,50441631,16219
22,ENSG00000100104.7,26483877,chr22-26358955-C-T,rs2000640,1,C,T,26358955,124922,26287269,26680485,71686
22,ENSG00000184117.7,29581113,chr22-29676696-T-G,rs2009354,-1,T,G,29676696,95583,29384505,29777721,292191
22,ENSG00000242259.3,19447711,chr22-19385133-C-T,rs2013516,-1,C,T,19385133,62578,19251103,19644319,134030
22,ENSG00000099956.12,23786966,chr22-23841688-A-G,rs2070464,1,A,G,23841688,54722,23590358,23983574,251330
22,ENSG00000133424.14,33920476,chr22-33900105-A-C,rs2157153,-1,A,C,33900105,20371,33723868,34117084,176237
22,ENSG00000189060.3,37805229,chr22-37855679-T-C,rs2157472,1,T,C,37855679,50450,37608621,38001837,247058
22,ENSG00000182902.8,17563498,chr22-17431799-T-C,rs2189077,1,T,C,17431799,131699,17366890,17760106,64909
22,ENSG00000187045.12,37109713,chr22-37143673-T-C,rs2235330,-1,T,C,37143673,33960,36913105,37306321,230568
22,ENSG00000100345.14,36387967,chr22-36580928-T-C,rs2267341,-1,T,C,36580928,192961,36191359,36584575,389569
22,ENSG00000100372.10,40819346,chr22-40861873-T-G,rs2269619,-1,T,G,40861873,42527,40622738,41015954,239135
22,ENSG00000069998.8,17159277,chr22-17118970-A-C,rs2277830,-1,A,C,17118970,40307,16962669,17355885,156301
22,ENSG00000100292.12,35381096,chr22-35393270-A-G,rs2285112,1,A,G,35393270,12174,35184488,35577704,208782
22,ENSG00000128218.7,23754425,chr22-23782284-C-T,rs28382569,-1,C,T,23782284,27859,23557817,23951033,224467
22,ENSG00000128218.7,23754425,chr22-23782284-C-A,rs28382569,-1,C,A,23782284,27859,23557817,23951033,224467
22,ENSG00000100207.14,42270653,chr22-42134634-G-A,rs28641480,-1,G,A,42134634,136019,42074045,42467261,60589
22,ENSG00000079974.13,50783636,chr22-50780578-G-A,rs28729663,-1,G,A,50780578,3058,50587028,50980244,193550
22,ENSG00000215193.5,18077990,chr22-18089062-T-C,rs361807,1,T,C,18089062,11072,17881382,18274598,207680
22,ENSG00000075275.12,46537620,chr22-46517077-G-A,rs3827411,-1,G,A,46517077,20543,46341012,46734228,176065
22,ENSG00000099958.10,23839006,chr22-23743839-C-T,rs41277301,-1,C,T,23743839,95167,23642398,24035614,101441
22,ENSG00000130943.5,46263343,chr22-46219479-G-A,rs4253755,-1,G,A,46219479,43864,46066735,46459951,152744
22,ENSG00000100368.8,36913628,chr22-36856876-C-T,rs4821542,1,C,T,36856876,56752,36717020,37110236,139856
22,ENSG00000128272.10,39520562,chr22-39695542-A-G,rs4821914,1,A,G,39695542,174980,39323954,39717170,371588
22,ENSG00000073169.9,50201011,chr22-50091421-T-C,rs56144269,1,T,C,50091421,109590,50004403,50397619,87018
22,ENSG00000239713.3,39077275,chr22-39250417-A-G,rs56229619,1,A,G,39250417,173142,38880667,39273883,369750
22,ENSG00000093009.5,19479920,chr22-19651860-A-G,rs5748376,1,A,G,19651860,171940,19283312,19676528,368548
22,ENSG00000198792.7,38273010,chr22-38224050-G-A,rs5750562,-1,G,A,38224050,48960,38076402,38469618,147648
22,ENSG00000128268.11,39457012,chr22-39541264-A-G,rs5750848,1,A,G,39541264,84252,39260404,39653620,280860
22,ENSG00000100197.15,42130810,chr22-42196233-C-G,rs5751239,-1,C,G,42196233,65423,41934202,42327418,262031
22,ENSG00000100197.15,42130810,chr22-42196233-C-T,rs5751239,-1,C,T,42196233,65423,41934202,42327418,262031
22,ENSG00000100122.5,26618027,chr22-26747282-G-A,rs5752402,-1,G,A,26747282,129255,26421419,26814635,325863
22,ENSG00000100365.10,36861006,chr22-36886051-T-C,rs5756384,1,T,C,36886051,25045,36664398,37057614,221653
22,ENSG00000133466.9,37188247,chr22-37195621-C-T,rs5756552,-1,C,T,37195621,7374,36991639,37384855,203982
22,ENSG00000100083.14,37608834,chr22-37803943-T-C,rs5756825,1,T,C,37803943,195109,37412226,37805442,391717
22,ENSG00000189306.6,42519796,chr22-42543702-A-G,rs5758798,-1,A,G,42543702,23906,42323188,42716404,220514
22,ENSG00000183569.12,42553956,chr22-42543702-A-G,rs5758798,1,A,G,42543702,10254,42357348,42750564,186354
22,ENSG00000100218.7,23141990,chr22-23152646-T-G,rs5759603,-1,T,G,23152646,10656,22945382,23338598,207264
22,ENSG00000099974.7,23966888,chr22-23891405-C-T,rs5760090,1,C,T,23891405,75483,23770280,24163496,121125
22,ENSG00000100263.9,29267981,chr22-29321727-G-A,rs5763138,-1,G,A,29321727,53746,29071373,29464589,250354
22,ENSG00000128408.7,45413693,chr22-45298042-G-A,rs5765250,1,G,A,45298042,115651,45217085,45610301,80957
22,ENSG00000100364.13,45240894,chr22-45235716-G-A,rs5766579,-1,G,A,45235716,5178,45044286,45437502,191430
22,ENSG00000188064.5,45977162,chr22-46138166-A-G,rs5768939,-1,A,G,46138166,161004,45780554,46173770,357612
22,ENSG00000130487.4,50545899,chr22-50545626-T-C,rs5770775,1,T,C,50545626,273,50349291,50742507,196335
22,ENSG00000133433.6,23961195,chr22-23896878-C-T,rs6003942,-1,C,T,23896878,64317,23764587,24157803,132291
22,ENSG00000099994.10,24181487,chr22-24067797-C-T,rs6004052,1,C,T,24067797,113690,23984879,24378095,82918
22,ENSG00000099957.11,21015165,chr22-21042318-C-T,rs6005347,1,C,T,21042318,27153,20818557,21211773,223761
22,ENSG00000099917.12,20507610,chr22-20631784-G-A,rs602269,1,G,A,20631784,124174,20311002,20704218,320782
22,ENSG00000177989.8,50532498,chr22-50626933-C-A,rs6151415,-1,C,A,50626933,94435,50335890,50729106,291043
22,ENSG00000100350.10,36507040,chr22-36478176-C-T,rs62229974,-1,C,T,36478176,28864,36310432,36703648,167744
22,ENSG00000100154.10,28679840,chr22-28493747-C-A,rs695567,-1,C,A,28493747,186093,28483232,28876448,10515
22,ENSG00000128266.6,23070519,chr22-23100835-C-G,rs71316787,1,C,G,23100835,30316,22873911,23267127,226924
22,ENSG00000099937.6,20774113,chr22-20867517-A-G,rs715579,1,A,G,20867517,93404,20577505,20970721,290012
22,ENSG00000075234.12,46268008,chr22-46409584-G-A,rs7288959,1,G,A,46409584,141576,46071400,46464616,338184
22,ENSG00000075234.12,46268008,chr22-46409584-G-C,rs7288959,1,G,C,46409584,141576,46071400,46464616,338184
22,ENSG00000183307.3,17121360,chr22-17116878-A-G,rs7289082,-1,A,G,17116878,4482,16924752,17317968,192126
22,ENSG00000185339.4,30607174,chr22-30608201-G-C,rs7289549,1,G,C,30608201,1027,30410566,30803782,197635
22,ENSG00000128276.6,32357867,chr22-32408464-T-C,rs7289656,1,T,C,32408464,50597,32161259,32554475,247205
22,ENSG00000185651.10,21567714,chr22-21724874-C-T,rs7292106,1,C,T,21724874,157160,21371106,21764322,353768
22,ENSG00000100336.13,36201809,chr22-36206137-G-T,rs7364143,-1,G,T,36206137,4328,36005201,36398417,200936
22,ENSG00000099954.13,17369460,chr22-17221986-G-T,rs737966,1,G,T,17221986,147474,17172852,17566068,49134
22,ENSG00000100147.8,41800679,chr22-41794305-A-G,rs738247,1,A,G,41794305,6374,41604071,41997287,190234
22,ENSG00000196576.9,50307646,chr22-50445532-G-A,rs756014,-1,G,A,50445532,137886,50111038,50504254,334494
22,ENSG00000100271.11,43089391,chr22-43080426-G-T,rs760771,-1,G,T,43080426,8965,42892783,43285999,187643
22,ENSG00000217442.3,50562919,chr22-50628562-C-T,rs762668,-1,C,T,50628562,65643,50366311,50759527,262251
22,ENSG00000100299.12,50628152,chr22-50628562-C-T,rs762668,-1,C,T,50628562,410,50431544,50824760,197018
22,ENSG00000100276.8,29315697,chr22-29479783-T-C,rs76393761,-1,T,C,29479783,164086,29119089,29512305,360694
22,ENSG00000183597.11,20021110,chr22-20177186-T-C,rs78908,1,T,C,20177186,156076,19824502,20217718,352684
22,ENSG00000099968.13,17638757,chr22-17475904-C-G,rs80053119,1,C,G,17475904,162853,17442149,17835365,33755
22,ENSG00000100060.12,37486384,chr22-37526407-T-C,rs8139526,-1,T,C,37526407,40023,37289776,37682992,236631
22,ENSG00000040608.9,20268318,chr22-20234321-C-A,rs855072,-1,C,A,20234321,33997,20071710,20464926,162611
22,ENSG00000100300.12,43151559,chr22-43134694-G-C,rs872841,1,G,C,43134694,16865,42954951,43348167,179743
22,ENSG00000100379.13,37051742,chr22-37068584-T-C,rs877908,1,T,C,37068584,16842,36855134,37248350,213450
22,ENSG00000185252.13,20394151,chr22-20393473-T-G,rs887021,1,T,G,20393473,678,20197543,20590759,195930
22,ENSG00000186976.10,43812305,chr22-43748046-C-T,rs929091,-1,C,T,43748046,64259,43615697,44008913,132349
22,ENSG00000100116.11,37807934,chr22-37877742-T-C,rs9466,1,T,C,37877742,69808,37611326,38004542,266416
22,ENSG00000070371.11,19291719,chr22-19199864-G-A,rs9605957,-1,G,A,19199864,91855,19095111,19488327,104753
22,ENSG00000099999.9,30387411,chr22-30214557-T-C,rs9608851,-1,T,C,30214557,172854,30190803,30584019,23754
22,ENSG00000100211.6,38656638,chr22-38719668-C-T,rs9611012,1,C,T,38719668,63030,38460030,38853246,259638
22,ENSG00000184436.7,21002118,chr22-20907161-G-A,rs9613260,-1,G,A,20907161,94957,20805510,21198726,101651
22,ENSG00000188677.9,44024302,chr22-44170554-G-A,rs9614359,1,G,A,44170554,146252,43827694,44220910,342860
22,ENSG00000186716.14,23180509,chr22-23065123-A-C,rs9624019,1,A,C,23065123,115386,22983901,23377117,81222
22,ENSG00000100258.12,50507702,chr22-50561109-A-G,rs9628178,-1,A,G,50561109,53407,50311094,50704310,250015
21,ENSG00000159261.6,36480122,chr21-36547598-C-G,rs10483034,-1,C,G,36547598,67476,36283514,36676730,264084
21,ENSG00000156253.2,29019349,chr21-29059824-T-G,rs1064019,-1,T,G,29059824,40475,28822741,29215957,237083
21,ENSG00000160200.12,43075835,chr21-43071315-C-T,rs11701048,-1,C,T,43071315,4520,42879227,43272443,192088
21,ENSG00000184221.8,33070141,chr21-32985229-C-G,rs11908914,1,C,G,32985229,84912,32873533,33266749,111696
21,ENSG00000157557.7,38805929,chr21-38783137-C-T,rs1209918,1,C,T,38783137,22792,38609321,39002537,173816
21,ENSG00000185272.9,14216157,chr21-14095383-T-C,rs12151976,1,T,C,14095383,120774,14019549,14412765,75834
21,ENSG00000157617.12,41954018,chr21-41781218-A-C,rs12627460,-1,A,C,41781218,172800,41757410,42150626,23808
21,ENSG00000157617.12,41954018,chr21-41781218-A-G,rs12627460,-1,A,G,41781218,172800,41757410,42150626,23808
21,ENSG00000182093.8,39380326,chr21-39370990-G-C,rs1554933,1,G,C,39370990,9336,39183718,39576934,187272
21,ENSG00000154719.9,25607481,chr21-25548682-A-G,rs1740081,-1,A,G,25548682,58799,25410873,25804089,137809
21,ENSG00000159131.11,33542117,chr21-33430303-C-T,rs17879705,-1,C,T,33430303,111814,33345509,33738725,84794
21,ENSG00000160188.5,42496224,chr21-42502887-T-C,rs2051329,-1,T,C,42502887,6663,42299616,42692832,203271
21,ENSG00000156261.7,29073648,chr21-29073627-G-A,rs2070610,-1,G,A,29073627,21,28877040,29270256,196587
21,ENSG00000160298.13,46323870,chr21-46461396-A-G,rs2078203,-1,A,G,46461396,137526,46127262,46520478,334134
21,ENSG00000243646.3,33266367,chr21-33266554-G-A,rs2239573,1,G,A,33266554,187,33069759,33462975,196795
21,ENSG00000188992.6,14210955,chr21-14118929-T-C,rs2246835,-1,T,C,14118929,92026,14014347,14407563,104582
21,ENSG00000156299.6,31344261,chr21-31509375-G-A,rs2284543,-1,G,A,31509375,165114,31147653,31540869,361722
21,ENSG00000159110.14,33229938,chr21-33259936-C-T,rs2300371,1,C,T,33259936,29998,33033330,33426546,226606
21,ENSG00000183255.7,44873690,chr21-44855132-A-C,rs235317,-1,A,C,44855132,18558,44677082,45070298,178050
21,ENSG00000155307.13,14546315,chr21-14525718-T-C,rs2822733,-1,T,C,14525718,20597,14349707,14742923,176011
21,ENSG00000159055.3,32279049,chr21-32183825-G-A,rs2833697,-1,G,A,32183825,95224,32082441,32475657,101384
21,ENSG00000142207.5,32393012,chr21-32321947-A-T,rs2833765,-1,A,T,32321947,71065,32196404,32589620,125543
21,ENSG00000159259.5,36385392,chr21-36258875-G-A,rs2835330,1,G,A,36258875,126517,36188784,36582000,70091
21,ENSG00000157551.12,38256991,chr21-38263627-C-T,rs2836257,1,C,T,38263627,6636,38060383,38453599,203244
21,ENSG00000160207.4,43659488,chr21-43656562-A-G,rs2838341,-1,A,G,43656562,2926,43462880,43856096,193682
21,ENSG00000160213.5,43776308,chr21-43794700-G-A,rs2838367,-1,G,A,43794700,18392,43579700,43972916,215000
21,ENSG00000160209.12,43719129,chr21-43794700-G-A,rs2838367,1,G,A,43794700,75571,43522521,43915737,272179
21,ENSG00000160285.9,46228774,chr21-46269820-G-A,rs2839185,-1,G,A,46269820,41046,46032166,46425382,237654
21,ENSG00000142156.9,45981770,chr21-45953498-C-T,rs364984,1,C,T,45953498,28272,45785162,46178378,168336
21,ENSG00000182670.9,37073271,chr21-37150966-C-A,rs3737540,1,C,A,37150966,77695,36876663,37269879,274303
21,ENSG00000160185.9,42403902,chr21-42406282-T-C,rs3746924,1,T,C,42406282,2380,42207294,42600510,198988
21,ENSG00000160310.11,46635674,chr21-46610705-G-T,rs4464358,1,G,T,46610705,24969,46439066,46832282,171639
21,ENSG00000157601.9,41426239,chr21-41423100-G-A,rs459498,1,G,A,41423100,3139,41229631,41622847,193469
21,ENSG00000197381.10,45074580,chr21-45115223-G-C,rs62216599,1,G,C,45115223,40643,44877972,45271188,237251
21,ENSG00000159267.9,36966669,chr21-36861972-G-A,rs6517385,-1,G,A,36861972,104697,36770061,37163277,91911
21,ENSG00000160183.8,42396052,chr21-42337178-C-T,rs6586309,-1,C,T,42337178,58874,42199444,42592660,137734
21,ENSG00000160190.8,42513852,chr21-42668573-C-T,rs71320537,1,C,T,42668573,154721,42317244,42710460,351329
21,ENSG00000160282.9,46155579,chr21-46127220-A-G,rs7282065,-1,A,G,46127220,28359,45958971,46352187,168249
21,ENSG00000159212.8,34668994,chr21-34691253-G-A,rs733014,1,G,A,34691253,22259,34472386,34865602,218867
21,ENSG00000159228.8,36070024,chr21-36066591-A-G,rs73370485,1,A,G,36066591,3433,35873416,36266632,193175
21,ENSG00000159216.12,35049302,chr21-35006274-A-G,rs734382,-1,A,G,35006274,43028,34852694,35245910,153580
21,ENSG00000184012.7,41508158,chr21-41395858-C-T,rs74688837,-1,C,T,41395858,112300,41311550,41704766,84308
21,ENSG00000160233.5,44455510,chr21-44345083-C-T,rs75292526,1,C,T,44345083,110427,44258902,44652118,86181
21,ENSG00000241945.2,44107399,chr21-43988289-A-C,rs76426094,1,A,C,43988289,119110,43910791,44304007,77498
21,ENSG00000142168.9,31659693,chr21-31850150-C-T,rs77305211,1,C,T,31850150,190457,31463085,31856301,387065
21,ENSG00000159197.2,34364006,chr21-34263554-A-G,rs78574613,1,A,G,34263554,100452,34167398,34560614,96156
21,ENSG00000142178.7,43427131,chr21-43499656-G-C,rs79491056,-1,G,C,43499656,72525,43230523,43623739,269133
21,ENSG00000142178.7,43427131,chr21-43499656-G-A,rs79491056,-1,G,A,43499656,72525,43230523,43623739,269133
21,ENSG00000183145.4,37006702,chr21-37070182-T-C,rs8127496,1,T,C,37070182,63480,36810094,37203310,260088
21,ENSG00000141959.11,44300053,chr21-44304505-G-A,rs8129937,1,G,A,44304505,4452,44103445,44496661,201060
21,ENSG00000160191.13,42653621,chr21-42644903-C-T,rs8134101,1,C,T,42644903,8718,42457013,42850229,187890
21,ENSG00000160191.13,42653621,chr21-42644903-C-G,rs8134101,1,C,G,42644903,8718,42457013,42850229,187890
21,ENSG00000159086.10,32771755,chr21-32936805-T-G,rs8134589,-1,T,G,32936805,165050,32575147,32968363,361658
21,ENSG00000182362.9,46286342,chr21-46299019-T-C,rs914249,1,T,C,46299019,12677,46089734,46482950,209285
21,ENSG00000160221.11,44133683,chr21-44029525-G-A,rs9306169,1,G,A,44029525,104158,43937075,44330291,92450
21,ENSG00000185437.9,39451970,chr21-39552934-A-C,rs953748,1,A,C,39552934,100964,39255362,39648578,297572
21,ENSG00000160193.7,42879539,chr21-42896893-T-G,rs9974287,-1,T,G,42896893,17354,42682931,43076147,213962
21,ENSG00000142185.11,44353621,chr21-44353556-C-T,rs9975520,1,C,T,44353556,65,44157013,44550229,196543
21,ENSG00000156239.7,28885367,chr21-28840396-T-C,rs9981922,-1,T,C,28840396,44971,28688759,29081975,151637
21,ENSG00000170262.8,32298855,chr21-32262196-C-T,rs112565244,1,C,T,32262196,36659,32102247,32495463,159949
21,ENSG00000234289.3,43565182,chr21-43372243-G-A,rs117001852,1,G,A,43372243,192939,43368574,43761790,3669
21,ENSG00000160216.12,43865223,chr21-43907869-G-A,rs11700575,1,G,A,43907869,42646,43668615,44061831,239254
21,ENSG00000185808.8,37073071,chr21-37158357-C-T,rs118100253,-1,C,T,37158357,85286,36876463,37269679,281894
21,ENSG00000160185.9,42403902,chr21-42431928-T-C,rs12482947,1,T,C,42431928,28026,42207294,42600510,224634
21,ENSG00000177398.12,42071317,chr21-41979806-T-G,rs12627125,1,T,G,41979806,91511,41874709,42267925,105097
21,ENSG00000160285.9,46228774,chr21-46313656-T-C,rs13047780,-1,T,C,46313656,84882,46032166,46425382,281490
21,ENSG00000182240.9,41168160,chr21-41227291-T-A,rs17000688,1,T,A,41227291,59131,40971552,41364768,255739
21,ENSG00000142173.10,46098112,chr21-46151261-C-G,rs17292975,1,C,G,46151261,53149,45901504,46294720,249757
21,ENSG00000142173.10,46098112,chr21-46151261-C-T,rs17292975,1,C,T,46151261,53149,45901504,46294720,249757
21,ENSG00000188992.6,14210955,chr21-14122133-C-A,rs1970046,-1,C,A,14122133,88822,14014347,14407563,107786
21,ENSG00000141956.8,41879344,chr21-41767035-C-T,rs199825512,-1,C,T,41767035,112309,41682736,42075952,84299
21,ENSG00000160213.5,43776308,chr21-43797575-G-A,rs2070537,-1,G,A,43797575,21267,43579700,43972916,217875
21,ENSG00000173276.9,42010360,chr21-42014253-C-T,rs220196,-1,C,T,42014253,3893,41813752,42206968,200501
21,ENSG00000155307.13,14546315,chr21-14719893-A-G,rs2246699,-1,A,G,14719893,173578,14349707,14742923,370186
21,ENSG00000160193.7,42879539,chr21-42873634-C-G,rs2248490,-1,C,G,42873634,5905,42682931,43076147,190703
21,ENSG00000160183.8,42396052,chr21-42381603-C-A,rs225430,-1,C,A,42381603,14449,42199444,42592660,182159
21,ENSG00000183421.6,41767052,chr21-41653781-G-A,rs2402161,-1,G,A,41653781,113271,41570444,41963660,83337
21,ENSG00000180530.5,15065000,chr21-14958573-T-C,rs2822987,-1,T,C,14958573,106427,14868392,15261608,90181
21,ENSG00000155313.11,15729982,chr21-15773154-A-G,rs2823484,1,A,G,15773154,43172,15533374,15926590,239780
21,ENSG00000156253.2,29019349,chr21-29210411-A-G,rs2832258,-1,A,G,29210411,191062,28822741,29215957,387670
21,ENSG00000159212.8,34668994,chr21-34692022-T-C,rs2834585,1,T,C,34692022,23028,34472386,34865602,219636
21,ENSG00000159228.8,36070024,chr21-36018190-G-A,rs2835230,1,G,A,36018190,51834,35873416,36266632,144774
21,ENSG00000160284.10,46184459,chr21-46171242-G-A,rs2839131,-1,G,A,46171242,13217,45987851,46381067,183391
21,ENSG00000157557.7,38805929,chr21-38805129-T-G,rs28420538,1,T,G,38805129,800,38609321,39002537,195808
21,ENSG00000243646.3,33266367,chr21-33276503-C-T,rs2849997,1,C,T,33276503,10136,33069759,33462975,206744
21,ENSG00000141959.11,44300053,chr21-44278679-T-G,rs2850161,1,T,G,44278679,21374,44103445,44496661,175234
21,ENSG00000159131.11,33542117,chr21-33491977-T-C,rs3761347,-1,T,C,33491977,50140,33345509,33738725,146468
21,ENSG00000160208.11,43659560,chr21-43778474-T-G,rs3761385,1,T,G,43778474,118914,43462952,43856168,315522
21,ENSG00000157601.9,41426239,chr21-41425679-G-A,rs462903,1,G,A,41425679,560,41229631,41622847,196048
21,ENSG00000160233.5,44455510,chr21-44338005-G-A,rs56212056,1,G,A,44338005,117505,44258902,44652118,79103
21,ENSG00000182093.8,39380326,chr21-39529504-G-A,rs570510,1,G,A,39529504,149178,39183718,39576934,345786
21,ENSG00000160188.5,42496224,chr21-42496947-T-C,rs61747218,-1,T,C,42496947,723,42299616,42692832,197331
21,ENSG00000173638.13,45542440,chr21-45591158-T-C,rs62214354,-1,T,C,45591158,48718,45345832,45739048,245326
21,ENSG00000184221.8,33070141,chr21-33111275-G-A,rs72613614,1,G,A,33111275,41134,32873533,33266749,237742
21,ENSG00000160191.13,42653621,chr21-42655668-T-C,rs73377801,1,T,C,42655668,2047,42457013,42850229,198655
21,ENSG00000160201.7,43107570,chr21-43149257-G-A,rs76189090,-1,G,A,43149257,41687,42910962,43304178,238295
21,ENSG00000160310.11,46635674,chr21-46661303-A-G,rs76674087,1,A,G,46661303,25629,46439066,46832282,222237
21,ENSG00000159231.5,36135079,chr21-36101015-G-A,rs79624889,1,G,A,36101015,34064,35938471,36331687,162544
21,ENSG00000159128.9,33403413,chr21-33448802-A-G,rs8134061,1,A,G,33448802,45389,33206805,33600021,241997
21,ENSG00000184900.10,44818062,chr21-44806651-T-G,rs8645,-1,T,G,44806651,11411,44621454,45014670,185197
21,ENSG00000156273.10,29298922,chr21-29458073-T-G,rs9981313,1,T,G,29458073,159151,29102314,29495530,355759
21,ENSG00000160183.8,42396052,chr21-42321320-G-C,rs10084557,-1,G,C,42321320,74732,42199444,42592660,121876
21,ENSG00000185808.8,37073071,chr21-36936611-G-A,rs1065758,-1,G,A,36936611,136460,36876463,37269679,60148
21,ENSG00000142207.5,32393012,chr21-32542835-C-A,rs11088225,-1,C,A,32542835,149823,32196404,32589620,346431
21,ENSG00000160209.12,43719129,chr21-43727683-C-T,rs11089094,1,C,T,43727683,8554,43522521,43915737,205162
21,ENSG00000182871.9,45405165,chr21-45584775-T-C,rs11700708,1,T,C,45584775,179610,45208557,45601773,376218
21,ENSG00000156273.10,29298922,chr21-29402473-G-A,rs11702825,1,G,A,29402473,103551,29102314,29495530,300159
21,ENSG00000185437.9,39451970,chr21-39488579-C-T,rs117545257,1,C,T,39488579,36609,39255362,39648578,233217
21,ENSG00000185437.9,39451970,chr21-39488579-C-G,rs117545257,1,C,G,39488579,36609,39255362,39648578,233217
21,ENSG00000159128.9,33403413,chr21-33594626-C-T,rs117998302,1,C,T,33594626,191213,33206805,33600021,387821
21,ENSG00000154723.8,25734904,chr21-25795788-C-G,rs11909849,-1,C,G,25795788,60884,25538296,25931512,257492
21,ENSG00000243646.3,33266367,chr21-33256870-A-G,rs11911133,1,A,G,33256870,9497,33069759,33462975,187111
21,ENSG00000160299.11,46324156,chr21-46328033-C-A,rs11911663,1,C,A,46328033,3877,46127548,46520764,200485
21,ENSG00000160191.13,42653621,chr21-42771392-A-C,rs13048220,1,A,C,42771392,117771,42457013,42850229,314379
21,ENSG00000188992.6,14210955,chr21-14087115-C-T,rs13048221,-1,C,T,14087115,123840,14014347,14407563,72768
21,ENSG00000154645.8,18244833,chr21-18055170-A-C,rs150056,1,A,C,18055170,189663,18048225,18441441,6945
21,ENSG00000155307.13,14546315,chr21-14569387-C-T,rs1556281,-1,C,T,14569387,23072,14349707,14742923,219680
21,ENSG00000198743.5,34073578,chr21-33970813-G-A,rs16991107,1,G,A,33970813,102765,33876970,34270186,93843
21,ENSG00000160216.12,43865223,chr21-43879965-G-A,rs17004613,1,G,A,43879965,14742,43668615,44061831,211350
21,ENSG00000183421.6,41767052,chr21-41894495-G-A,rs170135,-1,G,A,41894495,127443,41570444,41963660,324051
21,ENSG00000160188.5,42496224,chr21-42543337-G-T,rs17115062,-1,G,T,42543337,47113,42299616,42692832,243721
21,ENSG00000160188.5,42496224,chr21-42543337-G-A,rs17115062,-1,G,A,42543337,47113,42299616,42692832,243721
21,ENSG00000142156.9,45981770,chr21-46072023-G-T,rs17272021,1,G,T,46072023,90253,45785162,46178378,286861
21,ENSG00000160185.9,42403902,chr21-42381603-C-A,rs225430,1,C,A,42381603,22299,42207294,42600510,174309
21,ENSG00000157557.7,38805929,chr21-38804769-C-T,rs2283639,1,C,T,38804769,1160,38609321,39002537,195448
21,ENSG00000154640.10,17612901,chr21-17668103-T-C,rs2824431,-1,T,C,17668103,55202,17416293,17809509,251810
21,ENSG00000156239.7,28885367,chr21-28801017-A-T,rs2832097,-1,A,T,28801017,84350,28688759,29081975,112258
21,ENSG00000156299.6,31344261,chr21-31151914-C-T,rs2833306,-1,C,T,31151914,192347,31147653,31540869,4261
21,ENSG00000205929.5,32813703,chr21-33005286-A-G,rs2834063,-1,A,G,33005286,191583,32617095,33010311,388191
21,ENSG00000160213.5,43776308,chr21-43832957-T-C,rs2838416,-1,T,C,43832957,56649,43579700,43972916,253257
21,ENSG00000183570.9,45643725,chr21-45618451-C-T,rs2838968,1,C,T,45618451,25274,45447117,45840333,171334
21,ENSG00000185917.9,36060526,chr21-36216752-A-G,rs2850080,-1,A,G,36216752,156226,35863918,36257134,352834
21,ENSG00000183844.12,41316801,chr21-41280019-T-C,rs3746889,1,T,C,41280019,36782,41120193,41513409,159826
21,ENSG00000173638.13,45542440,chr21-45537304-A-G,rs3788202,-1,A,G,45537304,5136,45345832,45739048,191472
21,ENSG00000233056.1,42925630,chr21-42760626-G-A,rs3928097,-1,G,A,42760626,165004,42729022,43122238,31604
21,ENSG00000160233.5,44455510,chr21-44434857-C-T,rs45593631,1,C,T,44434857,20653,44258902,44652118,175955
21,ENSG00000222018.1,34401072,chr21-34534792-G-A,rs4817674,-1,G,A,34534792,133720,34204464,34597680,330328
21,ENSG00000182362.9,46286342,chr21-46250719-C-G,rs4818829,1,C,G,46250719,35623,46089734,46482950,160985
21,ENSG00000160256.8,44940029,chr21-45010877-A-G,rs4819012,1,A,G,45010877,70848,44743421,45136637,267456
21,ENSG00000160285.9,46228774,chr21-46159754-A-G,rs4819210,-1,A,G,46159754,69020,46032166,46425382,127588
21,ENSG00000182093.8,39380326,chr21-39573341-C-T,rs572926,1,C,T,39573341,193015,39183718,39576934,389623
21,ENSG00000160310.11,46635674,chr21-46653398-T-C,rs6518306,1,T,C,46653398,17724,46439066,46832282,214332
21,ENSG00000159212.8,34668994,chr21-34628463-C-T,rs66632134,1,C,T,34628463,40531,34472386,34865602,156077
21,ENSG00000142185.11,44353621,chr21-44508296-C-T,rs7275190,1,C,T,44508296,154675,44157013,44550229,351283
21,ENSG00000141956.8,41879344,chr21-41852190-T-C,rs7281207,-1,T,C,41852190,27154,41682736,42075952,169454
21,ENSG00000159055.3,32279049,chr21-32281681-A-G,rs7281700,-1,A,G,32281681,2632,32082441,32475657,199240
21,ENSG00000184012.7,41508158,chr21-41607213-G-A,rs73903452,-1,G,A,41607213,99055,41311550,41704766,295663
21,ENSG00000159261.6,36480122,chr21-36469867-T-C,rs74276156,-1,T,C,36469867,10255,36283514,36676730,186353
21,ENSG00000159267.9,36966669,chr21-37000429-G-A,rs8131913,-1,G,A,37000429,33760,36770061,37163277,230368
21,ENSG00000180530.5,15065000,chr21-15101699-C-T,rs9305547,-1,C,T,15101699,36699,14868392,15261608,233307
21,ENSG00000180530.5,15065000,chr21-15101699-C-A,rs9305547,-1,C,A,15101699,36699,14868392,15261608,233307
21,ENSG00000177398.12,42071317,chr21-41977002-G-A,rs9977968,1,G,A,41977002,94315,41874709,42267925,102293
21,ENSG00000160194.11,42893309,chr21-42736659-A-G,rs9979235,1,A,G,42736659,156650,42696701,43089917,39958
21,ENSG00000142166.8,33324970,chr21-33293855-A-G,rs999261,1,A,G,33293855,31115,33128362,33521578,165493
20,ENSG00000089199.5,5911510,chr20-5789907-A-G,rs1008493,1,A,G,5789907,121603,5714902,6108118,75005
20,ENSG00000168734.9,44582579,chr20-44709292-T-A,rs1022923,1,T,A,44709292,126713,44385971,44779187,323321
20,ENSG00000168734.9,44582579,chr20-44709292-T-C,rs1022923,1,T,C,44709292,126713,44385971,44779187,323321
20,ENSG00000125845.5,6767686,chr20-6880248-G-A,rs1028394,1,G,A,6880248,112562,6571078,6964294,309170
20,ENSG00000247315.2,297570,chr20-327549-A-T,rs1047507,1,A,T,327549,29979,100962,494178,226587
20,ENSG00000247315.2,297570,chr20-327549-A-G,rs1047507,1,A,G,327549,29979,100962,494178,226587
20,ENSG00000198547.3,32673941,chr20-32626095-G-A,rs10485499,-1,G,A,32626095,47846,32477333,32870549,148762
20,ENSG00000166619.7,37527876,chr20-37435163-T-C,rs11086214,-1,T,C,37435163,92713,37331268,37724484,103895
20,ENSG00000124226.6,49936397,chr20-49794892-A-T,rs11086294,1,A,T,49794892,141505,49739789,50133005,55103
20,ENSG00000177732.6,325552,chr20-275844-A-C,rs111450572,1,A,C,275844,49708,128944,522160,146900
20,ENSG00000101146.8,57351255,chr20-57356538-C-T,rs1138386,1,C,T,57356538,5283,57154647,57547863,201891
20,ENSG00000053438.7,37521250,chr20-37477926-A-G,rs116949243,1,A,G,37477926,43324,37324642,37717858,153284
20,ENSG00000197457.5,63653424,chr20-63757025-G-A,rs11697497,-1,G,A,63757025,103601,63456816,63850032,300209
20,ENSG00000171858.11,62387103,chr20-62392885-C-T,rs11698818,1,C,T,62392885,5782,62190495,62583711,202390
20,ENSG00000125818.10,1118602,chr20-1144204-T-G,rs11699981,1,T,G,1144204,25602,921994,1315210,222210
20,ENSG00000101307.11,1620009,chr20-1619759-C-A,rs117803469,-1,C,A,1619759,250,1423401,1816617,196358
20,ENSG00000124155.11,45416141,chr20-45339966-T-C,rs11905122,1,T,C,45339966,76175,45219533,45612749,120433
20,ENSG00000101216.6,63627101,chr20-63769761-C-T,rs12480190,-1,C,T,63769761,142660,63430493,63823709,339268
20,ENSG00000101470.5,45827312,chr20-45675532-T-C,rs12481168,-1,T,C,45675532,151780,45630704,46023920,44828
20,ENSG00000088832.10,1393054,chr20-1391053-A-G,rs1294690,-1,A,G,1391053,2001,1196446,1589662,194607
20,ENSG00000101191.11,62926505,chr20-62917850-A-G,rs13040088,-1,A,G,62917850,8655,62729897,63123113,187953
20,ENSG00000101138.6,56392645,chr20-56279986-G-A,rs1326018,1,G,A,56279986,112659,56196037,56589253,83949
20,ENSG00000089057.10,5001510,chr20-4997142-G-T,rs1401828,-1,G,T,4997142,4368,4804902,5198118,192240
20,ENSG00000089006.11,17968794,chr20-17968394-T-C,rs146288789,-1,T,C,17968394,400,17772186,18165402,196208
20,ENSG00000197496.4,46709649,chr20-46794930-C-T,rs1473678,1,C,T,46794930,85281,46513041,46906257,281889
20,ENSG00000089048.9,13784919,chr20-13721935-T-C,rs1541059,-1,T,C,13721935,62984,13588311,13981527,133624
20,ENSG00000132793.6,41340821,chr20-41340348-A-G,rs16985665,1,A,G,41340348,473,41144213,41537429,196135
20,ENSG00000101443.13,45469753,chr20-45465910-A-C,rs16990209,1,A,C,45465910,3843,45273145,45666361,192765
20,ENSG00000125977.6,34112243,chr20-34053837-T-C,rs17091489,-1,T,C,34053837,58406,33915635,34308851,138202
20,ENSG00000100985.6,46008908,chr20-46011586-A-G,rs17576,1,A,G,46011586,2678,45812300,46205516,199286
20,ENSG00000101363.8,37289655,chr20-37316771-G-T,rs1806940,1,G,T,37316771,27116,37093047,37486263,223724
20,ENSG00000124143.6,38601809,chr20-38606495-A-G,rs1883784,1,A,G,38606495,4686,38405201,38798417,201294
20,ENSG00000125871.9,17969018,chr20-17945226-A-G,rs1884709,1,A,G,17945226,23792,17772410,18165626,172816
20,ENSG00000124145.5,45348424,chr20-45346811-C-A,rs1981431,-1,C,A,45346811,1613,45151816,45545032,194995
20,ENSG00000101353.10,37158904,chr20-37210188-T-C,rs2050091,-1,T,C,37210188,51284,36962296,37355512,247892
20,ENSG00000124171.4,50731580,chr20-50746645-G-T,rs2064278,1,G,T,50746645,15065,50534972,50928188,211673
20,ENSG00000125967.11,33674428,chr20-33678033-A-G,rs2071054,-1,A,G,33678033,3605,33477820,33871036,200213
20,ENSG00000197586.7,25195712,chr20-25213313-G-A,rs2076561,1,G,A,25213313,17601,24999104,25392320,214209
20,ENSG00000132823.5,44210771,chr20-44209910-A-G,rs2143606,-1,A,G,44209910,861,44014163,44407379,195747
20,ENSG00000101019.16,35411973,chr20-35317523-C-T,rs2145082,-1,C,T,35317523,94450,35215365,35608581,102158
20,ENSG00000088882.6,2800627,chr20-2781082-C-T,rs215525,-1,C,T,2781082,19545,2604019,2997235,177063
20,ENSG00000101181.12,62183028,chr20-62201219-A-G,rs2184161,1,A,G,62201219,18191,61986420,62379636,214799
20,ENSG00000154930.9,25058139,chr20-25074809-A-G,rs2207632,-1,A,G,25074809,16670,24861531,25254747,213278
20,ENSG00000025772.7,44960397,chr20-44960400-G-A,rs2234197,-1,G,A,44960400,3,44763789,45157005,196611
20,ENSG00000101438.3,38724486,chr20-38761363-A-G,rs2244440,1,A,G,38761363,36877,38527878,38921094,233485
20,ENSG00000101442.8,38748460,chr20-38767477-A-G,rs2245231,1,A,G,38767477,19017,38551852,38945068,215625
20,ENSG00000242372.2,35284772,chr20-35280121-G-A,rs2250205,-1,G,A,35280121,4651,35088164,35481380,191957
20,ENSG00000100997.12,25390835,chr20-25275630-G-T,rs2260997,-1,G,T,25275630,115205,25194227,25587443,81403
20,ENSG00000088881.13,2693574,chr20-2839847-C-A,rs2274670,1,C,A,2839847,146273,2496966,2890182,342881
20,ENSG00000125534.4,63520765,chr20-63517559-C-G,rs2314639,1,C,G,63517559,3206,63324157,63717373,193402
20,ENSG00000125534.4,63520765,chr20-63517559-C-T,rs2314639,1,C,T,63517559,3206,63324157,63717373,193402
20,ENSG00000203880.6,64255748,chr20-64225081-C-A,rs2320358,1,C,A,64225081,30667,64059140,64452356,165941
20,ENSG00000158470.5,49713878,chr20-49630591-A-G,rs235029,-1,A,G,49630591,83287,49517270,49910486,113321
20,ENSG00000125966.7,35226690,chr20-35281932-C-T,rs2425044,1,C,T,35281932,55242,35030082,35423298,251850
20,ENSG00000101417.7,33720310,chr20-33789224-G-A,rs2626549,-1,G,A,33789224,68914,33523702,33916918,265522
20,ENSG00000158296.9,46651459,chr20-46476793-T-C,rs279716,-1,T,C,46476793,174666,46454851,46848067,21942
20,ENSG00000101057.11,43667114,chr20-43668004-A-C,rs285205,1,A,C,43668004,890,43470506,43863722,197498
20,ENSG00000064787.7,54070594,chr20-54070647-A-G,rs290391,-1,A,G,54070647,53,53873986,54267202,196661
20,ENSG00000125870.6,16730026,chr20-16742280-T-C,rs3171297,1,T,C,16742280,12254,16533418,16926634,208862
20,ENSG00000100994.7,25248085,chr20-25227636-C-T,rs3746337,1,C,T,25227636,20449,25051477,25444693,176159
20,ENSG00000196421.3,64036182,chr20-64047196-G-A,rs3810504,1,G,A,64047196,11014,63839574,64232790,207622
20,ENSG00000126001.11,35455598,chr20-35603048-C-T,rs41293082,1,C,T,35603048,147450,35258990,35652206,344058
20,ENSG00000101052.8,43590937,chr20-43636013-G-A,rs41296223,1,G,A,43636013,45076,43394329,43787545,241684
20,ENSG00000100979.10,45912155,chr20-45910853-G-C,rs441346,-1,G,C,45910853,1302,45715547,46108763,195306
20,ENSG00000101204.10,63361349,chr20-63352549-G-A,rs45461993,-1,G,A,63352549,8800,63164741,63557957,187808
20,ENSG00000101220.11,3767753,chr20-3753520-T-C,rs45495794,-1,T,C,3753520,14233,3571145,3964361,182375
20,ENSG00000132622.6,3732685,chr20-3753520-T-C,rs45495794,1,T,C,3753520,20835,3536077,3929293,217443
20,ENSG00000131069.13,34876612,chr20-34875039-A-G,rs45606744,1,A,G,34875039,1573,34680004,35073220,195035
20,ENSG00000196132.7,64164452,chr20-64064685-G-A,rs4809392,1,G,A,64064685,99767,63967844,64361060,96841
20,ENSG00000132792.14,37694030,chr20-37874901-C-T,rs4809875,1,C,T,37874901,180871,37497422,37890638,377479
20,ENSG00000244274.3,45408289,chr20-45397052-T-C,rs4812896,1,T,C,45397052,11237,45211681,45604897,185371
20,ENSG00000088876.7,2508915,chr20-2493435-T-C,rs4815270,-1,T,C,2493435,15480,2312307,2705523,181128
20,ENSG00000125869.4,9514590,chr20-9512833-C-T,rs4816144,1,C,T,9512833,1757,9317982,9711198,194851
20,ENSG00000125898.7,833715,chr20-813863-G-A,rs500066,1,G,A,813863,19852,637107,1030323,176756
20,ENSG00000158480.6,49915529,chr20-49974428-G-C,rs55700732,-1,G,C,49974428,58899,49718921,50112137,255507
20,ENSG00000158480.6,49915529,chr20-49974428-G-A,rs55700732,-1,G,A,49974428,58899,49718921,50112137,255507
20,ENSG00000132635.10,2840655,chr20-2737434-G-A,rs56254520,-1,G,A,2737434,103221,2644047,3037263,93387
20,ENSG00000182463.7,52972358,chr20-52782795-A-G,rs6013523,1,A,G,52782795,189563,52775750,53168966,7045
20,ENSG00000132819.12,57391396,chr20-57260972-G-A,rs6014967,1,G,A,57260972,130424,57194788,57588004,66184
20,ENSG00000124164.11,58389229,chr20-58409038-T-G,rs6026243,1,T,G,58409038,19809,58192621,58585837,216417
20,ENSG00000124164.11,58389229,chr20-58409038-T-A,rs6026243,1,T,A,58409038,19809,58192621,58585837,216417
20,ENSG00000124203.5,59163821,chr20-59172851-C-T,rs6026752,1,C,T,59172851,9030,58967213,59360429,205638
20,ENSG00000198900.5,41028822,chr20-40996350-G-T,rs6029508,1,G,T,40996350,32472,40832214,41225430,164136
20,ENSG00000175121.7,45115162,chr20-45284615-A-T,rs6032095,-1,A,T,45284615,169453,44918554,45311770,366061
20,ENSG00000149654.5,46308498,chr20-46311311-A-G,rs6032772,-1,A,G,46311311,2813,46111890,46505106,199421
20,ENSG00000125821.7,18588054,chr20-18592306-A-G,rs6035086,1,A,G,18592306,4252,18391446,18784662,200860
20,ENSG00000089063.10,5113076,chr20-5093191-G-A,rs6038069,-1,G,A,5093191,19885,4916468,5309684,176723
20,ENSG00000149346.10,10435305,chr20-10326437-A-G,rs6039851,1,A,G,10326437,108868,10238697,10631913,87740
20,ENSG00000125868.10,17570075,chr20-17688541-G-A,rs6044953,1,G,A,17688541,118466,17373467,17766683,315074
20,ENSG00000101236.11,4015558,chr20-3905270-T-C,rs6052162,-1,T,C,3905270,110288,3818950,4212166,86320
20,ENSG00000171984.9,5750401,chr20-5774984-C-G,rs6053673,1,C,G,5774984,24583,5553793,5947009,221191
20,ENSG00000125885.8,5950652,chr20-5989792-G-C,rs6053815,1,G,C,5989792,39140,5754044,6147260,235748
20,ENSG00000132623.10,10034987,chr20-10035559-C-G,rs6057110,1,C,G,10035559,572,9838379,10231595,197180
20,ENSG00000088305.12,32762385,chr20-32736328-C-T,rs6058847,1,C,T,32736328,26057,32565777,32958993,170551
20,ENSG00000101000.3,35172072,chr20-35006423-G-T,rs6060151,1,G,T,35006423,165649,34975464,35368680,30959
20,ENSG00000131044.11,31870634,chr20-31944240-A-G,rs6061045,1,A,G,31944240,73606,31674026,32067242,270214
20,ENSG00000101190.8,62861822,chr20-62862184-G-C,rs6062375,-1,G,C,62862184,362,62665214,63058430,196970
20,ENSG00000203896.5,63736664,chr20-63688889-G-A,rs6062492,1,G,A,63688889,47775,63540056,63933272,148833
20,ENSG00000130584.5,63831264,chr20-63817967-C-T,rs6062541,-1,C,T,63817967,13297,63634656,64027872,183311
20,ENSG00000171700.9,64079518,chr20-64120459-A-C,rs6062634,-1,A,C,64120459,40941,63882910,64276126,237549
20,ENSG00000149636.9,36773763,chr20-36693605-C-A,rs6065197,-1,C,A,36693605,80158,36577155,36970371,116450
20,ENSG00000101158.7,58981256,chr20-58988006-C-T,rs6070684,1,C,T,58988006,6750,58784648,59177864,203358
20,ENSG00000124116.14,45791883,chr20-45773476-A-C,rs6073905,-1,A,C,45773476,18407,45595275,45988491,178201
20,ENSG00000101230.4,13221274,chr20-13333299-G-C,rs6079001,1,G,C,13333299,112025,13024666,13417882,308633
20,ENSG00000232388.1,18567432,chr20-18739775-T-C,rs6081341,1,T,C,18739775,172343,18370824,18764040,368951
20,ENSG00000196476.7,290750,chr20-274210-G-C,rs6081660,-1,G,C,274210,16540,94142,487358,180068
20,ENSG00000088970.10,21126082,chr20-21265982-G-A,rs6082361,1,G,A,21265982,139900,20929474,21322690,336508
20,ENSG00000149600.6,32743467,chr20-32762102-T-C,rs6087990,-1,T,C,32762102,18635,32546859,32940075,215243
20,ENSG00000078814.11,34955868,chr20-34882711-T-C,rs6088638,1,T,C,34882711,73157,34759260,35152476,123451
20,ENSG00000125510.11,64080082,chr20-64082287-C-G,rs6090042,1,C,G,64082287,2205,63883474,64276690,198813
20,ENSG00000125510.11,64080082,chr20-64082287-C-T,rs6090042,1,C,T,64082287,2205,63883474,64276690,198813
20,ENSG00000149596.6,44187188,chr20-44198070-C-T,rs6103674,-1,C,T,44198070,10882,43990580,44383796,207490
20,ENSG00000101457.8,45791954,chr20-45747557-T-C,rs6104325,1,T,C,45747557,44397,45595346,45988562,152211
20,ENSG00000125827.4,8019761,chr20-8022945-A-T,rs6108092,-1,A,T,8022945,3184,7823153,8216369,199792
20,ENSG00000125875.8,462533,chr20-628723-G-A,rs6116853,-1,G,A,628723,166190,265925,659141,362798
20,ENSG00000101294.11,31514442,chr20-31332596-C-T,rs6119844,1,C,T,31332596,181846,31317834,31711050,14762
20,ENSG00000100983.5,34955806,chr20-34900968-C-T,rs6120757,-1,C,T,34900968,54838,34759198,35152414,141770
20,ENSG00000130589.11,63572455,chr20-63755534-C-A,rs6122161,-1,C,A,63755534,183079,63375847,63769063,379687
20,ENSG00000125901.5,3046052,chr20-3039907-A-G,rs6138988,1,A,G,3039907,6145,2849444,3242660,190463
20,ENSG00000171940.8,53593839,chr20-53570298-G-A,rs61744628,-1,G,A,53570298,23541,53397231,53790447,173067
20,ENSG00000132825.5,59940305,chr20-60102366-G-A,rs622705,-1,G,A,60102366,162061,59743697,60136913,358669
20,ENSG00000092758.10,62817050,chr20-62831150-G-C,rs66658258,1,G,C,62831150,14100,62620442,63013658,210708
20,ENSG00000088888.12,3846834,chr20-3862380-C-A,rs7262903,1,C,A,3862380,15546,3650226,4043442,212154
20,ENSG00000077984.4,24949269,chr20-25039866-C-T,rs7268879,1,C,T,25039866,90597,24752661,25145877,287205
20,ENSG00000101265.10,4823608,chr20-4749913-G-C,rs7269641,-1,G,C,4749913,73695,4627000,5020216,122913
20,ENSG00000088766.6,6006123,chr20-5809945-A-G,rs73073217,1,A,G,5809945,196178,5809515,6202731,430
20,ENSG00000149599.10,31870527,chr20-31916432-C-T,rs73102622,-1,C,T,31916432,45905,31673919,32067135,242513
20,ENSG00000020256.14,52191779,chr20-52076402-G-A,rs74835713,-1,G,A,52076402,115377,51995171,52388387,81231
20,ENSG00000101400.5,33443763,chr20-33297333-C-T,rs75456555,-1,C,T,33297333,146430,33247155,33640371,50178
20,ENSG00000132669.8,19758258,chr20-19665058-A-G,rs78829187,1,A,G,19665058,93200,19561650,19954866,103408
20,ENSG00000259399.1,36574553,chr20-36387975-C-T,rs80117149,1,C,T,36387975,186578,36377945,36771161,10030
20,ENSG00000132821.7,37903127,chr20-37947622-T-G,rs8122593,1,T,G,37947622,44495,37706519,38099735,241103
20,ENSG00000130702.9,62367312,chr20-62338071-A-G,rs8124907,-1,A,G,62338071,29241,62170704,62563920,167367
20,ENSG00000171703.12,64063198,chr20-64050264-G-A,rs8125759,1,G,A,64050264,12934,63866590,64259806,183674
20,ENSG00000196700.3,63969930,chr20-63966341-T-G,rs817329,-1,T,G,63966341,3589,63773322,64166538,193019
20,ENSG00000101161.6,63981132,chr20-63981045-G-C,rs817353,1,G,C,63981045,87,63784524,64177740,196521
20,ENSG00000125877.6,3209498,chr20-3213332-G-A,rs8362,1,G,A,3213332,3834,3012890,3406106,200442
20,ENSG00000124194.10,44247308,chr20-44117885-C-G,rs875669,1,C,G,44117885,129423,44050700,44443916,67185
20,ENSG00000124194.10,44247308,chr20-44117885-C-A,rs875669,1,C,A,44117885,129423,44050700,44443916,67185
20,ENSG00000101246.12,63707976,chr20-63742354-G-T,rs8957,-1,G,T,63742354,34378,63511368,63904584,230986
20,ENSG00000089050.9,18497225,chr20-18444182-T-C,rs932580,-1,T,C,18444182,53043,18300617,18693833,143565
20,ENSG00000088812.12,3471018,chr20-3344773-T-C,rs976041,1,T,C,3344773,126245,3274410,3667626,70363
20,ENSG00000101003.8,25407673,chr20-25296608-A-G,rs9927,1,A,G,25296608,111065,25211065,25604281,85543
20,ENSG00000101000.3,35172072,chr20-35132230-C-A,rs1033799,1,C,A,35132230,39842,34975464,35368680,156766
20,ENSG00000064601.11,45891335,chr20-46079999-A-G,rs10485438,1,A,G,46079999,188664,45694727,46087943,385272
20,ENSG00000259399.1,36574553,chr20-36548138-G-A,rs11553089,1,G,A,36548138,26415,36377945,36771161,170193
20,ENSG00000100997.12,25390835,chr20-25275962-A-G,rs11697384,-1,A,G,25275962,114873,25194227,25587443,81735
20,ENSG00000101132.5,54208087,chr20-54050346-T-C,rs11698014,1,T,C,54050346,157741,54011479,54404695,38867
20,ENSG00000124198.7,48921711,chr20-48743611-A-T,rs11698661,1,A,T,48743611,178100,48725103,49118319,18508
20,ENSG00000196421.3,64036182,chr20-64114857-C-T,rs117582734,1,C,T,64114857,78675,63839574,64232790,275283
20,ENSG00000158470.5,49713878,chr20-49621804-C-T,rs11905762,-1,C,T,49621804,92074,49517270,49910486,104534
20,ENSG00000089177.12,16573448,chr20-16559390-G-A,rs12106039,-1,G,A,16559390,14058,16376840,16770056,182550
20,ENSG00000124116.14,45791883,chr20-45798779-A-G,rs12480887,-1,A,G,45798779,6896,45595275,45988491,203504
20,ENSG00000124257.6,45891208,chr20-45995458-G-A,rs13038175,-1,G,A,45995458,104250,45694600,46087816,300858
20,ENSG00000124257.6,45891208,chr20-45995458-G-T,rs13038175,-1,G,T,45995458,104250,45694600,46087816,300858
20,ENSG00000132823.5,44210771,chr20-44203668-T-C,rs13044950,-1,T,C,44203668,7103,44014163,44407379,189505
20,ENSG00000132661.3,23350791,chr20-23377301-C-T,rs16985298,1,C,T,23377301,26510,23154183,23547399,223118
20,ENSG00000101443.13,45469753,chr20-45446292-T-C,rs16990154,1,T,C,45446292,23461,45273145,45666361,173147
20,ENSG00000124217.3,50958818,chr20-51121367-A-G,rs16995757,1,A,G,51121367,162549,50762210,51155426,359157
20,ENSG00000101236.11,4015558,chr20-3994755-A-G,rs17215529,-1,A,G,3994755,20803,3818950,4212166,175805
20,ENSG00000075043.12,63472655,chr20-63500615-A-G,rs1741614,-1,A,G,63500615,27960,63276047,63669263,224568
20,ENSG00000075043.12,63472655,chr20-63500615-A-C,rs1741614,-1,A,C,63500615,27960,63276047,63669263,224568
20,ENSG00000125534.4,63520765,chr20-63500615-A-G,rs1741614,1,A,G,63500615,20150,63324157,63717373,176458
20,ENSG00000125534.4,63520765,chr20-63500615-A-C,rs1741614,1,A,C,63500615,20150,63324157,63717373,176458
20,ENSG00000132664.7,18467390,chr20-18635720-T-G,rs17735473,1,T,G,18635720,168330,18270782,18663998,364938
20,ENSG00000101353.10,37158904,chr20-37159445-G-A,rs1780690,-1,G,A,37159445,541,36962296,37355512,197149
20,ENSG00000171984.9,5750401,chr20-5800238-C-T,rs1977869,1,C,T,5800238,49837,5553793,5947009,246445
20,ENSG00000244274.3,45408289,chr20-45429940-A-G,rs2092109,1,A,G,45429940,21651,45211681,45604897,218259
20,ENSG00000101266.10,543790,chr20-349198-T-C,rs2092473,-1,T,C,349198,194592,347182,740398,2016
20,ENSG00000124155.11,45416141,chr20-45375150-G-T,rs2231622,1,G,T,45375150,40991,45219533,45612749,155617
20,ENSG00000088854.11,3407669,chr20-3279722-G-C,rs2236094,-1,G,C,3279722,127947,3211061,3604277,68661
20,ENSG00000101197.8,63235905,chr20-63239870-C-T,rs2273492,1,C,T,63239870,3965,63039297,63432513,200573
20,ENSG00000101109.7,44966512,chr20-45059065-T-C,rs2299978,1,T,C,45059065,92553,44769904,45163120,289161
20,ENSG00000125885.8,5950652,chr20-5952889-A-G,rs236111,1,A,G,5952889,2237,5754044,6147260,198845
20,ENSG00000101439.4,23637955,chr20-23642243-G-A,rs2405367,-1,G,A,23642243,4288,23441347,23834563,200896
20,ENSG00000171858.11,62387103,chr20-62429751-G-A,rs2427336,1,G,A,62429751,42648,62190495,62583711,239256
20,ENSG00000196700.3,63969930,chr20-64009856-G-A,rs2427587,-1,G,A,64009856,39926,63773322,64166538,236534
20,ENSG00000125510.11,64080082,chr20-64263071-C-T,rs2427636,1,C,T,64263071,182989,63883474,64276690,379597
20,ENSG00000131061.9,33731996,chr20-33790926-G-A,rs2747565,1,G,A,33790926,58930,33535388,33928604,255538
20,ENSG00000124256.9,57620426,chr20-57566235-T-C,rs28359554,-1,T,C,57566235,54191,57423818,57817034,142417
20,ENSG00000149657.13,62122475,chr20-61999289-G-A,rs28382112,1,G,A,61999289,123186,61925867,62319083,73422
20,ENSG00000064787.7,54070594,chr20-53905181-A-G,rs2904376,-1,A,G,53905181,165413,53873986,54267202,31195
20,ENSG00000124191.11,43914852,chr20-43727113-C-T,rs3091249,1,C,T,43727113,187739,43718244,44111460,8869
20,ENSG00000101104.6,44910060,chr20-44915887-A-G,rs3092074,1,A,G,44915887,5827,44713452,45106668,202435
20,ENSG00000088832.10,1393054,chr20-1325459-C-T,rs34019978,-1,C,T,1325459,67595,1196446,1589662,129013
20,ENSG00000126001.11,35455598,chr20-35602948-A-G,rs3746410,1,A,G,35602948,147350,35258990,35652206,343958
20,ENSG00000125898.7,833715,chr20-763806-G-A,rs3746805,1,G,A,763806,69909,637107,1030323,126699
20,ENSG00000203896.5,63736664,chr20-63591304-C-A,rs3787111,1,C,A,63591304,145360,63540056,63933272,51248
20,ENSG00000101152.6,63895126,chr20-64047196-G-A,rs3810504,1,G,A,64047196,152070,63698518,64091734,348678
20,ENSG00000185019.12,3159865,chr20-3234173-T-G,rs3827075,-1,T,G,3234173,74308,2963257,3356473,270916
20,ENSG00000172315.5,46689444,chr20-46551651-C-T,rs3848682,-1,C,T,46551651,137793,46492836,46886052,58815
20,ENSG00000101473.11,45857392,chr20-45704234-G-A,rs386196,-1,G,A,45704234,153158,45660784,46054000,43450
20,ENSG00000149654.5,46308498,chr20-46314580-G-A,rs4072977,-1,G,A,46314580,6082,46111890,46505106,202690
20,ENSG00000089063.10,5113076,chr20-5133938-G-A,rs4239761,-1,G,A,5133938,20862,4916468,5309684,217470
20,ENSG00000197457.5,63653424,chr20-63829952-C-A,rs4809367,-1,C,A,63829952,176528,63456816,63850032,373136
20,ENSG00000197457.5,63653424,chr20-63829952-C-T,rs4809367,-1,C,T,63829952,176528,63456816,63850032,373136
20,ENSG00000166619.7,37527876,chr20-37458793-G-C,rs4810665,-1,G,C,37458793,69083,37331268,37724484,127525
20,ENSG00000088826.12,4148828,chr20-4112605-C-T,rs4813670,1,C,T,4112605,36223,3952220,4345436,160385
20,ENSG00000125818.10,1118602,chr20-1104061-T-C,rs4813929,1,T,C,1104061,14541,921994,1315210,182067
20,ENSG00000101384.6,10673999,chr20-10789229-T-C,rs4813944,-1,T,C,10789229,115230,10477391,10870607,311838
20,ENSG00000125775.10,1329139,chr20-1337617-T-G,rs4814138,-1,T,G,1337617,8478,1132531,1525747,205086
20,ENSG00000125775.10,1329139,chr20-1337617-T-A,rs4814138,-1,T,A,1337617,8478,1132531,1525747,205086
20,ENSG00000125848.8,14337612,chr20-14492355-C-G,rs4814308,-1,C,G,14492355,154743,14141004,14534220,351351
20,ENSG00000101265.10,4823608,chr20-4807525-A-G,rs4815745,-1,A,G,4807525,16083,4627000,5020216,180525
20,ENSG00000101181.12,62183028,chr20-62197527-G-A,rs4925354,1,G,A,62197527,14499,61986420,62379636,211107
20,ENSG00000101052.8,43590937,chr20-43756553-A-G,rs56109022,1,A,G,43756553,165616,43394329,43787545,362224
20,ENSG00000124215.12,59958423,chr20-59793018-G-A,rs56144357,1,G,A,59793018,165405,59761815,60155031,31203
20,ENSG00000101474.7,24992751,chr20-24855142-G-T,rs56232101,-1,G,T,24855142,137609,24796143,25189359,58999
20,ENSG00000101474.7,24992751,chr20-24855142-G-A,rs56232101,-1,G,A,24855142,137609,24796143,25189359,58999
20,ENSG00000101220.11,3767753,chr20-3731217-A-C,rs580502,-1,A,C,3731217,36536,3571145,3964361,160072
20,ENSG00000197114.6,63708039,chr20-63636052-C-T,rs6010605,1,C,T,63636052,71987,63511431,63904647,124621
20,ENSG00000101190.8,62861822,chr20-62865662-A-G,rs6011430,-1,A,G,62865662,3840,62665214,63058430,200448
20,ENSG00000101191.11,62926505,chr20-62882518-A-G,rs6011442,-1,A,G,62882518,43987,62729897,63123113,152621
20,ENSG00000125508.3,63547749,chr20-63542350-G-A,rs6011892,-1,G,A,63542350,5399,63351141,63744357,191209
20,ENSG00000132825.5,59940305,chr20-60124692-C-T,rs6015655,-1,C,T,60124692,184387,59743697,60136913,380995
20,ENSG00000101363.8,37289655,chr20-37349094-C-T,rs6017943,1,C,T,37349094,59439,37093047,37486263,256047
20,ENSG00000132792.14,37694030,chr20-37677050-G-A,rs6020130,1,G,A,37677050,16980,37497422,37890638,179628
20,ENSG00000124243.11,50795061,chr20-50750539-T-G,rs6020721,1,T,G,50750539,44522,50598453,50991669,152086
20,ENSG00000101447.8,38926417,chr20-38869044-A-G,rs6028172,1,A,G,38869044,57373,38729809,39123025,139235
20,ENSG00000247315.2,297570,chr20-183442-T-C,rs6032887,1,T,C,183442,114128,100962,494178,82480
20,ENSG00000172296.8,13008972,chr20-12866472-A-G,rs6033532,1,A,G,12866472,142500,12812364,13205580,54108
20,ENSG00000132640.10,11917893,chr20-12008201-G-T,rs6041030,1,G,T,12008201,90308,11721285,12114501,286916
20,ENSG00000100994.7,25248085,chr20-25197284-A-G,rs6050422,1,A,G,25197284,50801,25051477,25444693,145807
20,ENSG00000197586.7,25195712,chr20-25200438-T-C,rs6050427,1,T,C,25200438,4726,24999104,25392320,201334
20,ENSG00000198171.7,3204682,chr20-3208397-C-T,rs6051644,-1,C,T,3208397,3715,3008074,3401290,200323
20,ENSG00000171867.11,4686456,chr20-4838455-A-G,rs6052915,1,A,G,4838455,151999,4489848,4883064,348607
20,ENSG00000125845.5,6767686,chr20-6696076-A-G,rs6054474,1,A,G,6696076,71610,6571078,6964294,124998
20,ENSG00000198547.3,32673941,chr20-32653587-T-C,rs6057610,-1,T,C,32653587,20354,32477333,32870549,176254
20,ENSG00000101421.3,33811348,chr20-33878248-C-T,rs6057920,1,C,T,33878248,66900,33614740,34007956,263508
20,ENSG00000125966.7,35226690,chr20-35212274-C-A,rs6058205,1,C,A,35212274,14416,35030082,35423298,182192
20,ENSG00000101412.9,33686385,chr20-33869352-T-C,rs6059504,-1,T,C,33869352,182967,33489777,33882993,379575
20,ENSG00000131044.11,31870634,chr20-31923305-G-A,rs6061032,1,G,A,31923305,52671,31674026,32067242,249279
20,ENSG00000130706.7,62302997,chr20-62221468-C-T,rs6062153,1,C,T,62221468,81529,62106389,62499605,115079
20,ENSG00000101162.3,59019429,chr20-59046400-T-C,rs6070701,1,T,C,59046400,26971,58822821,59216037,223579
20,ENSG00000089091.10,18467185,chr20-18574225-C-A,rs6075367,-1,C,A,18574225,107040,18270577,18663793,303648
20,ENSG00000196476.7,290750,chr20-291796-G-A,rs6075791,-1,G,A,291796,1046,94142,487358,197654
20,ENSG00000101298.9,1266294,chr20-1175210-T-C,rs6078022,1,T,C,1175210,91084,1069686,1462902,105524
20,ENSG00000089048.9,13784919,chr20-13751166-A-G,rs6079161,-1,A,G,13751166,33753,13588311,13981527,162855
20,ENSG00000101337.10,32109714,chr20-32131988-A-G,rs6087820,1,A,G,32131988,22274,31913106,32306322,218882
20,ENSG00000131067.12,34872856,chr20-34955093-C-T,rs6088660,-1,C,T,34955093,82237,34676248,35069464,278845
20,ENSG00000100983.5,34955806,chr20-35118208-A-C,rs6088721,-1,A,C,35118208,162402,34759198,35152414,359010
20,ENSG00000101057.11,43667114,chr20-43586834-G-A,rs6093858,1,G,A,43586834,80280,43470506,43863722,116328
20,ENSG00000198185.6,46513559,chr20-46497315-G-A,rs6094356,-1,G,A,46497315,16244,46316951,46710167,180364
20,ENSG00000089006.11,17968794,chr20-17995393-T-C,rs6111780,-1,T,C,17995393,26599,17772186,18165402,223207
20,ENSG00000101361.9,2652632,chr20-2543474-A-G,rs6114849,1,A,G,2543474,109158,2456024,2849240,87450
20,ENSG00000149488.11,2536573,chr20-2661730-C-G,rs6115381,1,C,G,2661730,125157,2339965,2733181,321765
20,ENSG00000101255.6,380760,chr20-396582-C-T,rs6115830,1,C,T,396582,15822,184152,577368,212430
20,ENSG00000101391.14,33401519,chr20-33588030-A-G,rs6120314,-1,A,G,33588030,186511,33204911,33598127,383119
20,ENSG00000158480.6,49915529,chr20-49981882-G-A,rs6125849,-1,G,A,49981882,66353,49718921,50112137,262961
20,ENSG00000124226.6,49936397,chr20-50124635-A-G,rs6125909,1,A,G,50124635,188238,49739789,50133005,384846
20,ENSG00000101407.8,38033456,chr20-38207790-G-A,rs6127436,-1,G,A,38207790,174334,37836848,38230064,370942
20,ENSG00000124253.8,57561110,chr20-57503634-G-A,rs6128059,1,G,A,57503634,57476,57364502,57757718,139132
20,ENSG00000131069.13,34876612,chr20-34692141-T-G,rs6579185,1,T,G,34692141,184471,34680004,35073220,12137
20,ENSG00000125841.7,347111,chr20-410526-C-T,rs7059,1,C,T,410526,63415,150503,543719,260023
20,ENSG00000089195.10,5950533,chr20-6073108-C-T,rs71338522,-1,C,T,6073108,122575,5753925,6147141,319183
20,ENSG00000125968.7,31605289,chr20-31615679-T-C,rs7263476,1,T,C,31615679,10390,31408681,31801897,206998
20,ENSG00000198276.8,63956416,chr20-63922080-C-T,rs7264220,-1,C,T,63922080,34336,63759808,64153024,162272
20,ENSG00000125877.6,3209498,chr20-3213247-A-C,rs7270101,1,A,C,3213247,3749,3012890,3406106,200357
20,ENSG00000100979.10,45912155,chr20-45788954-C-A,rs73122754,-1,C,A,45788954,123201,45715547,46108763,73407
20,ENSG00000100979.10,45912155,chr20-45788954-C-T,rs73122754,-1,C,T,45788954,123201,45715547,46108763,73407
20,ENSG00000215440.7,58692800,chr20-58686290-T-G,rs73124350,1,T,G,58686290,6510,58496192,58889408,190098
20,ENSG00000130590.9,63979642,chr20-64044057-G-A,rs73153160,-1,G,A,64044057,64415,63783034,64176250,261023
20,ENSG00000101161.6,63981132,chr20-64044057-G-A,rs73153160,1,G,A,64044057,62925,63784524,64177740,259533
20,ENSG00000101417.7,33720310,chr20-33893855-T-C,rs733803,-1,T,C,33893855,173545,33523702,33916918,370153
20,ENSG00000198900.5,41028822,chr20-40945134-G-A,rs7361183,1,G,A,40945134,83688,40832214,41225430,112920
20,ENSG00000173418.7,20017362,chr20-19886762-C-A,rs73901320,1,C,A,19886762,130600,19820754,20213970,66008
20,ENSG00000168734.9,44582579,chr20-44408932-C-T,rs73909506,1,C,T,44408932,173647,44385971,44779187,22961
20,ENSG00000242372.2,35284772,chr20-35439830-G-A,rs739329,-1,G,A,35439830,155058,35088164,35481380,351666
20,ENSG00000149474.7,18137863,chr20-18018768-C-T,rs74504750,1,C,T,18018768,119095,17941255,18334471,77513
20,ENSG00000092758.10,62817050,chr20-62822995-G-A,rs760086,1,G,A,62822995,5945,62620442,63013658,202553
20,ENSG00000132623.10,10034987,chr20-9971915-G-A,rs76748950,1,G,A,9971915,63072,9838379,10231595,133536
20,ENSG00000197296.5,44311202,chr20-44222832-T-G,rs76935057,-1,T,G,44222832,88370,44114594,44507810,108238
20,ENSG00000101247.12,13785028,chr20-13775443-T-C,rs78633569,1,T,C,13775443,9585,13588420,13981636,187023
20,ENSG00000101445.4,38805697,chr20-38924283-C-T,rs79424561,1,C,T,38924283,118586,38609089,39002305,315194
20,ENSG00000101158.7,58981256,chr20-59049586-G-A,rs79954987,1,G,A,59049586,68330,58784648,59177864,264938
20,ENSG00000125967.11,33674428,chr20-33501435-A-C,rs8119925,-1,A,C,33501435,172993,33477820,33871036,23615
20,ENSG00000196839.8,44651699,chr20-44698618-C-T,rs8121830,-1,C,T,44698618,46919,44455091,44848307,243527
20,ENSG00000203883.5,64049639,chr20-63966341-T-G,rs817329,-1,T,G,63966341,83298,63853031,64246247,113310
20,ENSG00000125821.7,18588054,chr20-18781393-G-A,rs8182677,1,G,A,18781393,193339,18391446,18784662,389947
20,ENSG00000132622.6,3732685,chr20-3740054-C-T,rs862832,1,C,T,3740054,7369,3536077,3929293,203977
20,ENSG00000149679.6,62407285,chr20-62389008-A-G,rs8668,-1,A,G,62389008,18277,62210677,62603893,178331
20,ENSG00000101216.6,63627101,chr20-63639577-C-A,rs909334,-1,C,A,63639577,12476,63430493,63823709,209084
20,ENSG00000124164.11,58389229,chr20-58420884-A-G,rs9679935,1,A,G,58420884,31655,58192621,58585837,228263
20,ENSG00000149596.6,44187188,chr20-44196847-T-C,rs9875,-1,T,C,44196847,9659,43990580,44383796,206267
20,ENSG00000258366.2,63658312,chr20-63506295-A-G,rs10485825,1,A,G,63506295,152017,63461704,63854920,44591
20,ENSG00000089050.9,18497225,chr20-18493314-T-G,rs11087256,-1,T,G,18493314,3911,18300617,18693833,192697
20,ENSG00000170471.9,38472843,chr20-38349233-G-A,rs11536940,1,G,A,38349233,123610,38276235,38669451,72998
20,ENSG00000158470.5,49713878,chr20-49682540-G-A,rs116799941,-1,G,A,49682540,31338,49517270,49910486,165270
20,ENSG00000125531.5,63554159,chr20-63399750-G-A,rs116844172,1,G,A,63399750,154409,63357551,63750767,42199
20,ENSG00000125877.6,3209498,chr20-3204477-A-T,rs11697186,1,A,T,3204477,5021,3012890,3406106,191587
20,ENSG00000064787.7,54070594,chr20-54050346-T-C,rs11698014,-1,T,C,54050346,20248,53873986,54267202,176360
20,ENSG00000101230.4,13221274,chr20-13308146-C-T,rs11699846,1,C,T,13308146,86872,13024666,13417882,283480
20,ENSG00000101204.10,63361349,chr20-63331544-C-T,rs117413284,-1,C,T,63331544,29805,63164741,63557957,166803
20,ENSG00000101126.9,50931437,chr20-50785726-C-T,rs117655020,-1,C,T,50785726,145711,50734829,51128045,50897
20,ENSG00000089012.9,1657779,chr20-1619759-C-A,rs117803469,-1,C,A,1619759,38020,1461171,1854387,158588
20,ENSG00000101187.10,62642503,chr20-62561745-C-T,rs11906462,1,C,T,62561745,80758,62445895,62839111,115850
20,ENSG00000124177.10,41618377,chr20-41463529-T-C,rs12625845,-1,T,C,41463529,154848,41421769,41814985,41760
20,ENSG00000101158.7,58981256,chr20-58981914-T-C,rs13044688,1,T,C,58981914,658,58784648,59177864,197266
20,ENSG00000149679.6,62407285,chr20-62429086-A-G,rs13045292,-1,A,G,62429086,21801,62210677,62603893,218409
20,ENSG00000101160.9,59007254,chr20-59027736-T-C,rs151337,-1,T,C,59027736,20482,58810646,59203862,217090
20,ENSG00000132793.6,41340821,chr20-41449621-C-G,rs16985796,1,C,G,41449621,108800,41144213,41537429,305408
20,ENSG00000132793.6,41340821,chr20-41449621-C-T,rs16985796,1,C,T,41449621,108800,41144213,41537429,305408
20,ENSG00000101367.8,32819954,chr20-32972502-A-G,rs17123911,1,A,G,32972502,152548,32623346,33016562,349156
20,ENSG00000100997.12,25390835,chr20-25453715-A-G,rs2072975,-1,A,G,25453715,62880,25194227,25587443,259488
20,ENSG00000025772.7,44960397,chr20-44860130-T-C,rs2179067,-1,T,C,44860130,100267,44763789,45157005,96341
20,ENSG00000204070.5,45363156,chr20-45375150-G-T,rs2231622,1,G,T,45375150,11994,45166548,45559764,208602
20,ENSG00000125885.8,5950652,chr20-6084192-T-C,rs2232077,1,T,C,6084192,133540,5754044,6147260,330148
20,ENSG00000124226.6,49936397,chr20-49942850-G-A,rs2294600,1,G,A,49942850,6453,49739789,50133005,203061
20,ENSG00000088826.12,4148828,chr20-4175021-C-T,rs2295483,1,C,T,4175021,26193,3952220,4345436,222801
20,ENSG00000101162.3,59019429,chr20-58970710-G-A,rs235195,1,G,A,58970710,48719,58822821,59216037,147889
20,ENSG00000126005.10,35278122,chr20-35281932-C-T,rs2425044,-1,C,T,35281932,3810,35081514,35474730,200418
20,ENSG00000171700.9,64079518,chr20-64009856-G-A,rs2427587,-1,G,A,64009856,69662,63882910,64276126,126946
20,ENSG00000168734.9,44582579,chr20-44624274-T-C,rs244076,1,T,C,44624274,41695,44385971,44779187,238303
20,ENSG00000125868.10,17570075,chr20-17758528-C-T,rs2618599,1,C,T,17758528,188453,17373467,17766683,385061
20,ENSG00000244274.3,45408289,chr20-45424429-T-C,rs2741566,1,T,C,45424429,16140,45211681,45604897,212748
20,ENSG00000088305.12,32762385,chr20-32686035-G-A,rs28581854,1,G,A,32686035,76350,32565777,32958993,120258
20,ENSG00000240849.6,50153723,chr20-50289452-A-G,rs2904263,-1,A,G,50289452,135729,49957115,50350331,332337
20,ENSG00000101132.5,54208087,chr20-54062953-C-G,rs290436,1,C,G,54062953,145134,54011479,54404695,51474
20,ENSG00000101057.11,43667114,chr20-43728655-C-A,rs3127065,1,C,A,43728655,61541,43470506,43863722,258149
20,ENSG00000053438.7,37521250,chr20-37454009-A-G,rs35604425,1,A,G,37454009,67241,37324642,37717858,129367
20,ENSG00000101082.9,36646196,chr20-36794533-G-T,rs35707272,-1,G,T,36794533,148337,36449588,36842804,344945
20,ENSG00000101082.9,36646196,chr20-36794533-G-A,rs35707272,-1,G,A,36794533,148337,36449588,36842804,344945
20,ENSG00000124134.4,45101127,chr20-45238829-G-A,rs35985025,-1,G,A,45238829,137702,44904519,45297735,334310
20,ENSG00000198185.6,46513559,chr20-46512761-A-C,rs366860,-1,A,C,46512761,798,46316951,46710167,195810
20,ENSG00000197296.5,44311202,chr20-44280325-G-C,rs3810511,-1,G,C,44280325,30877,44114594,44507810,165731
20,ENSG00000197296.5,44311202,chr20-44280325-G-A,rs3810511,-1,G,A,44280325,30877,44114594,44507810,165731
20,ENSG00000149635.2,46550654,chr20-46551651-C-T,rs3848682,-1,C,T,46551651,997,46354046,46747262,197605
20,ENSG00000101290.9,5127008,chr20-5043267-C-T,rs405769,1,C,T,5043267,83741,4930400,5323616,112867
20,ENSG00000132823.5,44210771,chr20-44210980-A-G,rs4142441,-1,A,G,44210980,209,44014163,44407379,196817
20,ENSG00000101335.5,36541519,chr20-36418546-G-A,rs4322899,1,G,A,36418546,122973,36344911,36738127,73635
20,ENSG00000075043.12,63472655,chr20-63454625-T-C,rs4809565,-1,T,C,63454625,18030,63276047,63669263,178578
20,ENSG00000101407.8,38033456,chr20-37874901-C-T,rs4809875,-1,C,T,37874901,158555,37836848,38230064,38053
20,ENSG00000125835.12,2470789,chr20-2477514-T-C,rs4815266,-1,T,C,2477514,6725,2274181,2667397,203333
20,ENSG00000101391.14,33401519,chr20-33225328-C-T,rs4911305,-1,C,T,33225328,176191,33204911,33598127,20417
20,ENSG00000101363.8,37289655,chr20-37288563-A-C,rs56151005,1,A,C,37288563,1092,37093047,37486263,195516
20,ENSG00000166619.7,37527876,chr20-37411490-A-G,rs58728038,-1,A,G,37411490,116386,37331268,37724484,80222
20,ENSG00000182463.7,52972358,chr20-53103062-C-T,rs6013630,1,C,T,53103062,130704,52775750,53168966,327312
20,ENSG00000101413.7,38033746,chr20-38070518-A-G,rs6022796,1,A,G,38070518,36772,37837138,38230354,233380
20,ENSG00000124098.9,56358974,chr20-56243950-A-C,rs6024728,1,A,C,56243950,115024,56162366,56555582,81584
20,ENSG00000124098.9,56358974,chr20-56243950-A-T,rs6024728,1,A,T,56243950,115024,56162366,56555582,81584
20,ENSG00000149474.7,18137863,chr20-18138763-C-T,rs6034985,1,C,T,18138763,900,17941255,18334471,197508
20,ENSG00000132623.10,10034987,chr20-10030427-C-T,rs6039659,1,C,T,10030427,4560,9838379,10231595,192048
20,ENSG00000198053.7,1895407,chr20-1826415-C-A,rs6044876,1,C,A,1826415,68992,1698799,2092015,127616
20,ENSG00000125798.8,22584572,chr20-22449933-G-T,rs6048103,-1,G,T,22449933,134639,22387964,22781180,61969
20,ENSG00000198171.7,3204682,chr20-3192943-T-C,rs6051629,-1,T,C,3192943,11739,3008074,3401290,184869
20,ENSG00000125841.7,347111,chr20-426232-T-C,rs6051941,1,T,C,426232,79121,150503,543719,275729
20,ENSG00000101181.12,62183028,chr20-62190366-C-T,rs6062130,1,C,T,62190366,7338,61986420,62379636,203946
20,ENSG00000171940.8,53593839,chr20-53557198-G-A,rs6068579,-1,G,A,53557198,36641,53397231,53790447,159967
20,ENSG00000124253.8,57561110,chr20-57562128-C-T,rs6070157,1,C,T,57562128,1018,57364502,57757718,197626
20,ENSG00000125826.14,408299,chr20-304170-T-C,rs6082746,1,T,C,304170,104129,211691,604907,92479
20,ENSG00000101417.7,33720310,chr20-33871514-G-C,rs6088329,-1,G,C,33871514,151204,33523702,33916918,347812
20,ENSG00000126001.11,35455598,chr20-35583402-G-A,rs6088887,1,G,A,35583402,127804,35258990,35652206,324412
20,ENSG00000131044.11,31870634,chr20-31934129-A-G,rs6089122,1,A,G,31934129,63495,31674026,32067242,260103
20,ENSG00000149596.6,44187188,chr20-44114814-A-G,rs6093935,-1,A,G,44114814,72374,43990580,44383796,124234
20,ENSG00000132819.12,57391396,chr20-57482763-G-T,rs6099647,1,G,T,57482763,91367,57194788,57588004,287975
20,ENSG00000124104.13,45833799,chr20-45997113-C-T,rs6104413,1,C,T,45997113,163314,45637191,46030407,359922
20,ENSG00000125834.8,2101827,chr20-2251544-T-C,rs6113380,1,T,C,2251544,149717,1905219,2298435,346325
20,ENSG00000077984.4,24949269,chr20-24865596-T-C,rs6114899,1,T,C,24865596,83673,24752661,25145877,112935
20,ENSG00000170191.4,25624014,chr20-25585849-A-G,rs6115218,-1,A,G,25585849,38165,25427406,25820622,158443
20,ENSG00000125875.8,462533,chr20-352819-G-A,rs6115682,-1,G,A,352819,109714,265925,659141,86894
20,ENSG00000089063.10,5113076,chr20-5131352-A-C,rs6116658,-1,A,C,5131352,18276,4916468,5309684,214884
20,ENSG00000125818.10,1118602,chr20-932392-G-T,rs6118267,1,G,T,932392,186210,921994,1315210,10398
20,ENSG00000125991.12,35542078,chr20-35597239-G-T,rs6120993,1,G,T,35597239,55161,35345470,35738686,251769
20,ENSG00000101191.11,62926505,chr20-63115991-G-A,rs6122093,-1,G,A,63115991,189486,62729897,63123113,386094
20,ENSG00000101438.3,38724486,chr20-38786294-T-G,rs6129020,1,T,G,38786294,61808,38527878,38921094,258416
20,ENSG00000171984.9,5750401,chr20-5810420-C-T,rs6133267,1,C,T,5810420,60019,5553793,5947009,256627
20,ENSG00000125821.7,18588054,chr20-18678893-C-T,rs6136466,1,C,T,18678893,90839,18391446,18784662,287447
20,ENSG00000132661.3,23350791,chr20-23321731-C-T,rs6137892,1,C,T,23321731,29060,23154183,23547399,167548
20,ENSG00000125898.7,833715,chr20-763126-C-T,rs6140113,1,C,T,763126,70589,637107,1030323,126019
20,ENSG00000197183.7,32585333,chr20-32641590-G-A,rs6141768,-1,G,A,32641590,56257,32388725,32781941,252865
20,ENSG00000101361.9,2652632,chr20-2657933-T-C,rs6753,1,T,C,2657933,5301,2456024,2849240,201909
20,ENSG00000089057.10,5001510,chr20-4971940-C-T,rs7263163,-1,C,T,4971940,29570,4804902,5198118,167038
20,ENSG00000124228.9,49219416,chr20-49376465-C-T,rs7269408,1,C,T,49376465,157049,49022808,49416024,353657
20,ENSG00000124160.7,46089962,chr20-45979022-G-A,rs7270354,-1,G,A,45979022,110940,45893354,46286570,85668
20,ENSG00000101421.3,33811348,chr20-33778742-T-C,rs7271022,1,T,C,33778742,32606,33614740,34007956,164002
20,ENSG00000172296.8,13008972,chr20-12913325-C-T,rs73075991,1,C,T,12913325,95647,12812364,13205580,100961
20,ENSG00000101439.4,23637955,chr20-23643280-G-A,rs73102333,-1,G,A,23643280,5325,23441347,23834563,201933
20,ENSG00000101439.4,23637955,chr20-23643280-G-T,rs73102333,-1,G,T,23643280,5325,23441347,23834563,201933
20,ENSG00000198276.8,63956416,chr20-64044057-G-A,rs73153160,-1,G,A,64044057,87641,63759808,64153024,284249
20,ENSG00000175121.7,45115162,chr20-45112882-C-T,rs734685,-1,C,T,45112882,2280,44918554,45311770,194328
20,ENSG00000101052.8,43590937,chr20-43703206-C-T,rs7347231,1,C,T,43703206,112269,43394329,43787545,308877
20,ENSG00000101220.11,3767753,chr20-3679309-C-T,rs7354032,-1,C,T,3679309,88444,3571145,3964361,108164
20,ENSG00000088854.11,3407669,chr20-3392922-T-C,rs74338704,-1,T,C,3392922,14747,3211061,3604277,181861
20,ENSG00000101189.5,62796473,chr20-62795326-G-A,rs75817908,1,G,A,62795326,1147,62599865,62993081,195461
20,ENSG00000020256.14,52191779,chr20-52060146-C-A,rs761852,-1,C,A,52060146,131633,51995171,52388387,64975
20,ENSG00000124140.7,46029215,chr20-46087893-C-T,rs77202366,1,C,T,46087893,58678,45832607,46225823,255286
20,ENSG00000124217.3,50958818,chr20-50851631-T-G,rs77469152,1,T,G,50851631,107187,50762210,51155426,89421
20,ENSG00000118705.11,37179330,chr20-37369744-C-T,rs77909210,1,C,T,37369744,190414,36982722,37375938,387022
20,ENSG00000158296.9,46651459,chr20-46587492-A-G,rs78298864,-1,A,G,46587492,63967,46454851,46848067,132641
20,ENSG00000101197.8,63235905,chr20-63249722-C-T,rs78618692,1,C,T,63249722,13817,63039297,63432513,210425
20,ENSG00000197114.6,63708039,chr20-63869021-C-T,rs8116909,1,C,T,63869021,160982,63511431,63904647,357590
20,ENSG00000124203.5,59163821,chr20-59228941-C-T,rs8120150,1,C,T,59228941,65120,58967213,59360429,261728
20,ENSG00000124203.5,59163821,chr20-59228941-C-A,rs8120150,1,C,A,59228941,65120,58967213,59360429,261728
20,ENSG00000125871.9,17969018,chr20-17972928-C-T,rs8121408,1,C,T,17972928,3910,17772410,18165626,200518
20,ENSG00000196421.3,64036182,chr20-64020625-G-A,rs816925,1,G,A,64020625,15557,63839574,64232790,181051
20,ENSG00000101161.6,63981132,chr20-63966341-T-G,rs817329,1,T,G,63966341,14791,63784524,64177740,181817
20,ENSG00000130590.9,63979642,chr20-63966341-T-G,rs817329,-1,T,G,63966341,13301,63783034,64176250,183307
20,ENSG00000178726.5,23049672,chr20-23098359-C-T,rs844813,-1,C,T,23098359,48687,22853064,23246280,245295
20,ENSG00000185019.12,3159865,chr20-3144371-C-G,rs857253,-1,C,G,3144371,15494,2963257,3356473,181114
20,ENSG00000185019.12,3159865,chr20-3144371-C-A,rs857253,-1,C,A,3144371,15494,2963257,3356473,181114
20,ENSG00000092758.10,62817050,chr20-62814660-G-A,rs910151,1,G,A,62814660,2390,62620442,63013658,194218
20,ENSG00000132622.6,3732685,chr20-3747323-T-C,rs910652,1,T,C,3747323,14638,3536077,3929293,211246
20,ENSG00000101190.8,62861822,chr20-63027162-C-T,rs910944,-1,C,T,63027162,165340,62665214,63058430,361948
20,ENSG00000196839.8,44651699,chr20-44683756-T-C,rs912914,-1,T,C,44683756,32057,44455091,44848307,228665
20,ENSG00000101445.4,38805697,chr20-38732861-T-C,rs997848,1,T,C,38732861,72836,38609089,39002305,123772
19,ENSG00000099864.10,708935,chr19-730297-G-A,rs1009690,1,G,A,730297,21362,512327,905543,217970
19,ENSG00000104979.3,13774456,chr19-13774670-A-G,rs10104,1,A,G,13774670,214,13577848,13971064,196822
19,ENSG00000250067.3,19528911,chr19-19546389-C-T,rs1036215,1,C,T,19546389,17478,19332303,19725519,214086
19,ENSG00000198482.5,52527668,chr19-52344460-C-A,rs10402784,1,C,A,52344460,183208,52331060,52724276,13400
19,ENSG00000104973.8,49818289,chr19-49838854-G-A,rs10403127,1,G,A,49838854,20565,49621681,50014897,217173
19,ENSG00000008441.10,12995475,chr19-13160907-C-T,rs10403956,1,C,T,13160907,165432,12798867,13192083,362040
19,ENSG00000189190.6,52786807,chr19-52780882-C-T,rs10404486,-1,C,T,52780882,5925,52590199,52983415,190683
19,ENSG00000196967.4,37172695,chr19-36997153-T-G,rs10405238,-1,T,G,36997153,175542,36976087,37369303,21066
19,ENSG00000167637.11,43827321,chr19-43826620-A-G,rs10408461,1,A,G,43826620,701,43630713,44023929,195907
19,ENSG00000105426.8,5340812,chr19-5290052-T-C,rs10408836,-1,T,C,5290052,50760,5144204,5537420,145848
19,ENSG00000160007.11,46860997,chr19-47002869-C-A,rs10410262,1,C,A,47002869,141872,46664389,47057605,338480
19,ENSG00000105695.8,35292161,chr19-35309759-G-T,rs10411704,1,G,T,35309759,17598,35095553,35488769,214206
19,ENSG00000186272.7,57411161,chr19-57434452-A-G,rs10411904,1,A,G,57434452,23291,57214553,57607769,219899
19,ENSG00000167476.4,2256417,chr19-2254027-T-C,rs10411919,-1,T,C,2254027,2390,2059809,2453025,194218
19,ENSG00000105373.12,47745546,chr19-47779238-C-T,rs10412896,1,C,T,47779238,33692,47548938,47942154,230300
19,ENSG00000161609.4,49388249,chr19-49390280-A-G,rs10413687,1,A,G,49390280,2031,49191641,49584857,198639
19,ENSG00000130479.5,17719480,chr19-17630238-A-G,rs10413821,1,A,G,17630238,89242,17522872,17916088,107366
19,ENSG00000160352.9,21082203,chr19-20997981-T-C,rs10413841,1,T,C,20997981,84222,20885595,21278811,112386
19,ENSG00000072071.11,14206169,chr19-14258950-A-G,rs10414604,-1,A,G,14258950,52781,14009561,14402777,249389
19,ENSG00000004777.10,35775564,chr19-35771026-A-G,rs10420134,1,A,G,35771026,4538,35578956,35972172,192070
19,ENSG00000127903.10,56671757,chr19-56670599-C-T,rs10420727,-1,C,T,56670599,1158,56475149,56868365,195450
19,ENSG00000064607.11,19033517,chr19-19123617-A-G,rs10421019,-1,A,G,19123617,90100,18836909,19230125,286708
19,ENSG00000127220.3,17303425,chr19-17345414-A-G,rs10421557,-1,A,G,17345414,41989,17106817,17500033,238597
19,ENSG00000141905.11,3366583,chr19-3379048-A-G,rs10422402,1,A,G,3379048,12465,3169975,3563191,209073
19,ENSG00000196263.2,56507855,chr19-56403850-A-G,rs10424112,1,A,G,56403850,104005,56311247,56704463,92603
19,ENSG00000198046.5,56477345,chr19-56403850-A-G,rs10424112,-1,A,G,56403850,73495,56280737,56673953,123113
19,ENSG00000130751.4,47019837,chr19-46989218-G-A,rs10425259,1,G,A,46989218,30619,46823229,47216445,165989
19,ENSG00000197497.5,53193358,chr19-53194155-A-T,rs10426161,-1,A,T,53194155,797,52996750,53389966,197405
19,ENSG00000171236.6,4540036,chr19-4651257-G-A,rs10426502,-1,G,A,4651257,111221,4343428,4736644,307829
19,ENSG00000214456.3,4535224,chr19-4651257-G-A,rs10426502,-1,G,A,4651257,116033,4338616,4731832,312641
19,ENSG00000226763.2,43612088,chr19-43795146-C-T,rs10426528,1,C,T,43795146,183058,43415480,43808696,379666
19,ENSG00000099817.6,1095375,chr19-1084573-A-G,rs10426888,-1,A,G,1084573,10802,898767,1291983,185806
19,ENSG00000130812.5,10102678,chr19-10046990-A-G,rs10432313,-1,A,G,10046990,55688,9906070,10299286,140920
19,ENSG00000213024.4,49929504,chr19-49911460-C-T,rs1044167,-1,C,T,49911460,18044,49732896,50126112,178564
19,ENSG00000089327.8,35154735,chr19-35169849-C-T,rs1046345,1,C,T,35169849,15114,34958127,35351343,211722
19,ENSG00000123810.2,41364149,chr19-41376807-A-G,rs1046909,-1,A,G,41376807,12658,41167541,41560757,209266
19,ENSG00000184635.7,19900946,chr19-19935338-G-A,rs1048421,1,G,A,19935338,34392,19704338,20097554,231000
19,ENSG00000178297.7,2389761,chr19-2428255-A-G,rs1050009,1,A,G,2428255,38494,2193153,2586369,235102
19,ENSG00000168661.8,34926903,chr19-34908502-C-T,rs10518287,1,C,T,34908502,18401,34730295,35123511,178207
19,ENSG00000221923.3,52369923,chr19-52366799-C-G,rs1054612,1,C,G,52366799,3124,52173315,52566531,193484
19,ENSG00000130513.3,18386158,chr19-18388974-C-G,rs1055150,1,C,G,18388974,2816,18189550,18582766,199424
19,ENSG00000256087.1,52048838,chr19-51855916-C-T,rs1056294,-1,C,T,51855916,192922,51852230,52245446,3686
19,ENSG00000124299.7,33521791,chr19-33387292-A-G,rs1061338,-1,A,G,33387292,134499,33325183,33718399,62109
19,ENSG00000213967.5,23914886,chr19-23870949-C-T,rs1065019,1,C,T,23870949,43937,23718278,24111494,152671
19,ENSG00000125735.5,6670160,chr19-6668961-C-T,rs1077667,-1,C,T,6668961,1199,6473552,6866768,195409
19,ENSG00000065268.3,984345,chr19-990702-C-T,rs10854001,1,C,T,990702,6357,787737,1180953,202965
19,ENSG00000105186.7,32675180,chr19-32655508-T-C,rs1103851,-1,T,C,32655508,19672,32478572,32871788,176936
19,ENSG00000105619.8,54115657,chr19-54124919-A-G,rs11084311,-1,A,G,54124919,9262,53919049,54312265,205870
19,ENSG00000160953.8,1354959,chr19-1377159-C-T,rs11084893,1,C,T,1377159,22200,1158351,1551567,218808
19,ENSG00000141985.4,4400547,chr19-4368145-C-T,rs11085072,-1,C,T,4368145,32402,4203939,4597155,164206
19,ENSG00000141965.3,4791734,chr19-4794245-T-G,rs11085099,1,T,G,4794245,2511,4595126,4988342,199119
19,ENSG00000141965.3,4791734,chr19-4794245-T-A,rs11085099,1,T,A,4794245,2511,4595126,4988342,199119
19,ENSG00000116014.3,917333,chr19-975387-T-C,rs11085230,1,T,C,975387,58054,720725,1113941,254662
19,ENSG00000256229.1,20167214,chr19-20276525-G-A,rs11085305,1,G,A,20276525,109311,19970606,20363822,305919
19,ENSG00000079999.8,10503356,chr19-10422436-C-G,rs11085732,-1,C,G,10422436,80920,10306748,10699964,115688
19,ENSG00000127616.9,10961030,chr19-11017920-A-G,rs11085754,1,A,G,11017920,56890,10764422,11157638,253498
19,ENSG00000179115.5,12933711,chr19-12896644-C-T,rs11085825,-1,C,T,12896644,37067,12737103,13130319,159541
19,ENSG00000130175.4,11435635,chr19-11447636-A-G,rs111813645,1,A,G,11447636,12001,11239027,11632243,208609
19,ENSG00000104870.6,49512661,chr19-49513222-T-G,rs111981233,1,T,G,49513222,561,49316053,49709269,197169
19,ENSG00000099624.2,1241751,chr19-1150087-C-T,rs111984437,1,C,T,1150087,91664,1045143,1438359,104944
19,ENSG00000160877.4,13118264,chr19-13201861-C-G,rs113906375,1,C,G,13201861,83597,12921656,13314872,280205
19,ENSG00000018869.10,56393534,chr19-56273852-T-C,rs115099495,-1,T,C,56273852,119682,56196926,56590142,76926
19,ENSG00000077348.3,41397359,chr19-41410644-C-T,rs11549936,-1,C,T,41410644,13285,41200751,41593967,209893
19,ENSG00000077348.3,41397359,chr19-41410644-C-G,rs11549936,-1,C,G,41410644,13285,41200751,41593967,209893
19,ENSG00000077348.3,41397359,chr19-41410644-C-A,rs11549936,-1,C,A,41410644,13285,41200751,41593967,209893
19,ENSG00000104853.9,44955380,chr19-44900155-C-T,rs1160985,1,C,T,44900155,55225,44758772,45151988,141383
19,ENSG00000186230.5,57435325,chr19-57428251-C-T,rs11665675,1,C,T,57428251,7074,57238717,57631933,189534
19,ENSG00000063322.6,39391378,chr19-39395172-G-A,rs11665711,1,G,A,39395172,3794,39194770,39587986,200402
19,ENSG00000189144.6,37779586,chr19-37739025-G-A,rs11666245,-1,G,A,37739025,40561,37582978,37976194,156047
19,ENSG00000167634.6,54947505,chr19-54998497-G-A,rs11667105,-1,G,A,54998497,50992,54750897,55144113,247600
19,ENSG00000130669.11,39125802,chr19-39188014-T-C,rs11668093,1,T,C,39188014,62212,38929194,39322410,258820
19,ENSG00000174837.8,6887579,chr19-6920086-T-C,rs11668744,1,T,C,6920086,32507,6690971,7084187,229115
19,ENSG00000187994.6,38878275,chr19-38834970-T-C,rs11668766,-1,T,C,38834970,43305,38681667,39074883,153303
19,ENSG00000090554.6,49474215,chr19-49421951-A-C,rs11669675,1,A,C,49421951,52264,49277607,49670823,144344
19,ENSG00000183850.7,23117025,chr19-23134145-C-T,rs11670477,1,C,T,23134145,17120,22920417,23313633,213728
19,ENSG00000011304.10,797452,chr19-711637-C-A,rs11671100,1,C,A,711637,85815,600844,994060,110793
19,ENSG00000130309.4,17555649,chr19-17507002-G-A,rs11671357,1,G,A,17507002,48647,17359041,17752257,147961
19,ENSG00000187912.7,14583084,chr19-14596218-T-C,rs11671501,1,T,C,14596218,13134,14386476,14779692,209742
19,ENSG00000130299.10,17337553,chr19-17256283-T-C,rs11671659,1,T,C,17256283,81270,17140945,17534161,115338
19,ENSG00000010310.3,45668221,chr19-45669020-G-A,rs11671664,1,G,A,45669020,799,45471613,45864829,197407
19,ENSG00000105255.5,4304598,chr19-4304501-A-G,rs11671916,1,A,G,4304501,97,4107990,4501206,196511
19,ENSG00000099875.8,2051244,chr19-2173964-T-G,rs116853588,-1,T,G,2173964,122720,1854636,2247852,319328
19,ENSG00000130159.6,11529134,chr19-11510616-C-T,rs116893606,-1,C,T,11510616,18518,11332526,11725742,178090
19,ENSG00000123143.7,14433306,chr19-14363842-C-A,rs116910289,1,C,A,14363842,69464,14236698,14629914,127144
19,ENSG00000123143.7,14433306,chr19-14363842-C-T,rs116910289,1,C,T,14363842,69464,14236698,14629914,127144
19,ENSG00000099822.1,589881,chr19-658335-C-T,rs116941761,1,C,T,658335,68454,393273,786489,265062
19,ENSG00000182566.6,7732110,chr19-7731701-T-G,rs117034642,-1,T,G,7731701,409,7535502,7928718,196199
19,ENSG00000134815.12,47349315,chr19-47263212-A-G,rs117098219,1,A,G,47263212,86103,47152707,47545923,110505
19,ENSG00000188368.4,42302132,chr19-42183461-C-T,rs117187065,1,C,T,42183461,118671,42105524,42498740,77937
19,ENSG00000105583.4,12669415,chr19-12694610-C-T,rs117566511,-1,C,T,12694610,25195,12472807,12866023,221803
19,ENSG00000130881.6,33194330,chr19-33279980-C-T,rs117588766,1,C,T,33279980,85650,32997722,33390938,282258
19,ENSG00000105443.8,48469369,chr19-48538718-T-C,rs117651565,1,T,C,48538718,69349,48272761,48665977,265957
19,ENSG00000180257.8,52962881,chr19-53024808-C-T,rs117828954,-1,C,T,53024808,61927,52766273,53159489,258535
19,ENSG00000189164.8,37371099,chr19-37407574-C-T,rs117985733,1,C,T,37407574,36475,37174491,37567707,233083
19,ENSG00000099331.7,17075777,chr19-17046798-C-T,rs118025973,1,C,T,17046798,28979,16879169,17272385,167629
19,ENSG00000105429.7,42325635,chr19-42243077-G-A,rs11878620,1,G,A,42243077,82558,42129027,42522243,114050
19,ENSG00000174652.12,9435573,chr19-9421017-C-T,rs11880207,-1,C,T,9421017,14556,9238965,9632181,182052
19,ENSG00000099338.14,38335830,chr19-38490899-C-T,rs11880894,1,C,T,38490899,155069,38139222,38532438,351677
19,ENSG00000197933.6,11738946,chr19-11717595-A-G,rs11882565,-1,A,G,11717595,21351,11542338,11935554,175257
19,ENSG00000095066.6,12775552,chr19-12794432-C-A,rs1205170,-1,C,A,12794432,18880,12578944,12972160,215488
19,ENSG00000167815.7,12801800,chr19-12794432-C-A,rs1205170,-1,C,A,12794432,7368,12605192,12998408,189240
19,ENSG00000167619.6,42313309,chr19-42336734-G-A,rs1206036,1,G,A,42336734,23425,42116701,42509917,220033
19,ENSG00000197951.3,56595302,chr19-56573310-G-A,rs12104210,1,G,A,56573310,21992,56398694,56791910,174616
19,ENSG00000167654.11,3880685,chr19-3743705-G-A,rs12459269,1,G,A,3743705,136980,3684077,4077293,59628
19,ENSG00000126246.4,35742452,chr19-35739273-T-C,rs12459634,-1,T,C,35739273,3179,35545844,35939060,193429
19,ENSG00000160013.3,46625089,chr19-46623357-C-G,rs12459883,-1,C,G,46623357,1732,46428481,46821697,194876
19,ENSG00000244165.1,10111693,chr19-10111519-A-G,rs12460842,1,A,G,10111519,174,9915085,10308301,196434
19,ENSG00000105085.4,16628204,chr19-16578828-C-T,rs12461030,-1,C,T,16578828,49376,16431596,16824812,147232
19,ENSG00000133243.3,2015714,chr19-1988445-C-T,rs12461737,-1,C,T,1988445,27269,1819106,2212322,169339
19,ENSG00000248099.2,17821519,chr19-17816476-T-G,rs12462622,-1,T,G,17816476,5043,17624911,18018127,191565
19,ENSG00000181007.6,36418644,chr19-36367183-T-C,rs12462725,-1,T,C,36367183,51461,36222036,36615252,145147
19,ENSG00000142409.3,56121295,chr19-56008631-T-C,rs12462844,-1,T,C,56008631,112664,55924687,56317903,83944
19,ENSG00000063180.3,48646187,chr19-48618792-T-C,rs12608448,-1,T,C,48618792,27395,48449579,48842795,169213
19,ENSG00000171777.9,38426219,chr19-38234776-T-C,rs12610482,-1,T,C,38234776,191443,38229611,38622827,5165
19,ENSG00000089639.5,19643657,chr19-19603995-T-C,rs12611058,-1,T,C,19603995,39662,19447049,19840265,156946
19,ENSG00000171291.3,11848726,chr19-11851818-T-C,rs12972457,1,T,C,11851818,3092,11652118,12045334,199700
19,ENSG00000010361.7,49813292,chr19-49811481-A-C,rs12973635,-1,A,C,49811481,1811,49616684,50009900,194797
19,ENSG00000170608.1,45864326,chr19-45877352-G-A,rs12974366,1,G,A,45877352,13026,45667718,46060934,209634
19,ENSG00000186806.3,51342139,chr19-51299282-C-T,rs12976697,-1,C,T,51299282,42857,51145531,51538747,153751
19,ENSG00000182013.11,46471563,chr19-46471049-A-C,rs12978825,-1,A,C,46471049,514,46274955,46668171,196094
19,ENSG00000130545.10,6464271,chr19-6458718-C-T,rs12980141,1,C,T,6458718,5553,6267663,6660879,191055
19,ENSG00000104946.4,49877702,chr19-49905398-G-T,rs12980435,1,G,T,49905398,27696,49681094,50074310,224304
19,ENSG00000131355.9,14674844,chr19-14776080-A-C,rs12980660,-1,A,C,14776080,101236,14478236,14871452,297844
19,ENSG00000131355.9,14674844,chr19-14776080-A-G,rs12980660,-1,A,G,14776080,101236,14478236,14871452,297844
19,ENSG00000127507.11,14778560,chr19-14776080-A-C,rs12980660,-1,A,C,14776080,2480,14581952,14975168,194128
19,ENSG00000127507.11,14778560,chr19-14776080-A-G,rs12980660,-1,A,G,14776080,2480,14581952,14975168,194128
19,ENSG00000160961.6,14690048,chr19-14776080-A-C,rs12980660,1,A,C,14776080,86032,14493440,14886656,282640
19,ENSG00000160961.6,14690048,chr19-14776080-A-G,rs12980660,1,A,G,14776080,86032,14493440,14886656,282640
19,ENSG00000188785.6,57389854,chr19-57406904-C-G,rs12984074,1,C,G,57406904,17050,57193246,57586462,213658
19,ENSG00000142065.7,36379201,chr19-36536168-A-C,rs12984401,-1,A,C,36536168,156967,36182593,36575809,353575
19,ENSG00000099804.2,531760,chr19-533201-G-A,rs12984645,1,G,A,533201,1441,335152,728368,198049
19,ENSG00000105227.8,40413378,chr19-40401029-C-T,rs12985877,-1,C,T,40401029,12349,40216770,40609986,184259
19,ENSG00000105568.11,52190052,chr19-52190024-T-C,rs13344984,1,T,C,52190024,28,51993444,52386660,196580
19,ENSG00000183617.3,3762682,chr19-3762700-C-T,rs13960,1,C,T,3762700,18,3566074,3959290,196626
19,ENSG00000039987.2,12751791,chr19-12883437-C-T,rs140010597,1,C,T,12883437,131646,12555183,12948399,328254
19,ENSG00000039987.2,12751791,chr19-12883437-C-G,rs140010597,1,C,G,12883437,131646,12555183,12948399,328254
19,ENSG00000130818.4,9538645,chr19-9435653-C-A,rs1433060,-1,C,A,9435653,102992,9342037,9735253,93616
19,ENSG00000159915.6,44259886,chr19-44386512-A-G,rs148795043,1,A,G,44386512,126626,44063278,44456494,323234
19,ENSG00000181666.11,37334649,chr19-37164074-A-G,rs1533736,1,A,G,37164074,170575,37138041,37531257,26033
19,ENSG00000105136.13,57487750,chr19-57547168-A-G,rs1548476,1,A,G,57547168,59418,57291142,57684358,256026
19,ENSG00000176024.10,51927472,chr19-51900263-T-C,rs1549931,1,T,C,51900263,27209,51730864,52124080,169399
19,ENSG00000213889.5,45498443,chr19-45492798-G-A,rs1573606,1,G,A,45492798,5645,45301835,45695051,190963
19,ENSG00000197020.5,21767579,chr19-21680617-T-C,rs1589280,-1,T,C,21680617,86962,21570971,21964187,109646
19,ENSG00000104884.9,45370573,chr19-45368348-T-C,rs1618536,-1,T,C,45368348,2225,45173965,45567181,194383
19,ENSG00000125503.6,55117637,chr19-55066696-T-C,rs1654460,-1,T,C,55066696,50941,54921029,55314245,145667
19,ENSG00000197766.1,859664,chr19-867735-A-G,rs1683593,1,A,G,867735,8071,663056,1056272,204679
19,ENSG00000205155.1,35745651,chr19-35726432-C-T,rs16970648,1,C,T,35726432,19219,35549043,35942259,177389
19,ENSG00000125755.11,45863147,chr19-45809847-C-T,rs16980027,-1,C,T,45809847,53300,45666539,46059755,143308
19,ENSG00000142541.10,49487608,chr19-49454349-T-C,rs16981276,1,T,C,49454349,33259,49291000,49684216,163349
19,ENSG00000039650.4,49867576,chr19-49856551-C-T,rs16981492,-1,C,T,49856551,11025,49670968,50064184,185583
19,ENSG00000204673.5,49877355,chr19-49896837-C-T,rs16981522,-1,C,T,49896837,19482,49680747,50073963,216090
19,ENSG00000178150.3,48270081,chr19-48241088-T-C,rs16981853,1,T,C,48241088,28993,48073473,48466689,167615
19,ENSG00000167554.9,52336243,chr19-52333321-T-C,rs16983718,1,T,C,52333321,2922,52139635,52532851,193686
19,ENSG00000244482.3,54242791,chr19-54203996-G-A,rs16985475,-1,G,A,54203996,38795,54046183,54439399,157813
19,ENSG00000196110.2,9309838,chr19-9279548-A-G,rs16995366,-1,A,G,9279548,30290,9113230,9506446,166318
19,ENSG00000161091.7,3557586,chr19-3557007-A-G,rs1715092,-1,A,G,3557007,579,3360978,3754194,196029
19,ENSG00000090659.11,7747534,chr19-7744745-C-T,rs17159889,-1,C,T,7744745,2789,7550926,7944142,193819
19,ENSG00000090659.11,7747534,chr19-7744745-C-A,rs17159889,-1,C,A,7744745,2789,7550926,7944142,193819
19,ENSG00000099785.5,8413305,chr19-8443507-G-A,rs17160489,1,G,A,8443507,30202,8216697,8609913,226810
19,ENSG00000087076.3,48836491,chr19-48839109-C-G,rs17272645,-1,C,G,48839109,2618,48639883,49033099,199226
19,ENSG00000130810.14,10106362,chr19-10206539-G-A,rs17291414,1,G,A,10206539,100177,9909754,10302970,296785
19,ENSG00000083844.5,57191500,chr19-57111915-G-T,rs17305542,1,G,T,57111915,79585,56994892,57388108,117023
19,ENSG00000172006.6,2819868,chr19-2790396-G-A,rs1736176,1,G,A,2790396,29472,2623260,3016476,167136
19,ENSG00000104953.11,2977564,chr19-2977601-C-G,rs17681742,1,C,G,2977601,37,2780956,3174172,196645
19,ENSG00000070423.10,663214,chr19-741758-G-A,rs17684039,-1,G,A,741758,78544,466606,859822,275152
19,ENSG00000065989.9,10420538,chr19-10408734-G-T,rs17697965,1,G,T,10408734,11804,10223930,10617146,184804
19,ENSG00000108107.7,55385932,chr19-55385959-A-G,rs17700376,1,A,G,55385959,27,55189324,55582540,196635
19,ENSG00000069399.7,44748708,chr19-44737114-C-T,rs17728272,1,C,T,44737114,11594,44552100,44945316,185014
19,ENSG00000176920.10,48695971,chr19-48703029-A-G,rs1800021,1,A,G,48703029,7058,48499363,48892579,203666
19,ENSG00000167601.6,41219223,chr19-41341955-G-A,rs1800472,1,G,A,41341955,122732,41022615,41415831,319340
19,ENSG00000129932.2,3500674,chr19-3481580-T-C,rs1860192,-1,T,C,3481580,19094,3304066,3697282,177514
19,ENSG00000174788.4,7633719,chr19-7633434-C-T,rs1862514,-1,C,T,7633434,285,7437111,7830327,196323
19,ENSG00000160410.8,40576873,chr19-40750614-T-G,rs1870086,1,T,G,40750614,173741,40380265,40773481,370349
19,ENSG00000175489.6,18397622,chr19-18402784-T-C,rs1985157,-1,T,C,18402784,5162,18201014,18594230,201770
19,ENSG00000197016.6,56567468,chr19-56581001-C-T,rs2024395,1,C,T,56581001,13533,56370860,56764076,210141
19,ENSG00000008382.10,4343562,chr19-4355303-T-C,rs2041775,1,T,C,4355303,11741,4146954,4540170,208349
19,ENSG00000171747.3,38812945,chr19-38812203-A-G,rs2052569,-1,A,G,38812203,742,38616337,39009553,195866
19,ENSG00000065000.9,2151566,chr19-2110747-G-A,rs20567,-1,G,A,2110747,40819,1954958,2348174,155789
19,ENSG00000182141.4,21329410,chr19-21276231-C-T,rs2061915,-1,C,T,21276231,53179,21132802,21526018,143429
19,ENSG00000179909.9,57709204,chr19-57746752-G-A,rs2074080,-1,G,A,57746752,37548,57512596,57905812,234156
19,ENSG00000105771.8,43754962,chr19-43734195-A-G,rs2074634,-1,A,G,43734195,20767,43558354,43951570,175841
19,ENSG00000121417.9,57633168,chr19-57618090-A-T,rs2079033,1,A,T,57618090,15078,57436560,57829776,181530
19,ENSG00000121417.9,57633168,chr19-57618090-A-G,rs2079033,1,A,G,57618090,15078,57436560,57829776,181530
19,ENSG00000196684.6,16143685,chr19-16223187-G-A,rs2124902,1,G,A,16223187,79502,15947077,16340293,276110
19,ENSG00000105058.6,16185410,chr19-16223187-G-A,rs2124902,1,G,A,16223187,37777,15988802,16382018,234385
19,ENSG00000060566.7,4153631,chr19-4186146-C-T,rs2159981,1,C,T,4186146,32515,3957023,4350239,229123
19,ENSG00000196172.8,23758891,chr19-23838525-G-A,rs2194275,-1,G,A,23838525,79634,23562283,23955499,276242
19,ENSG00000127533.2,16888999,chr19-16894218-C-T,rs2227359,1,C,T,16894218,5219,16692391,17085607,201827
19,ENSG00000172270.12,572596,chr19-580388-C-G,rs2229664,1,C,G,580388,7792,375988,769204,204400
19,ENSG00000105258.3,36114875,chr19-36114892-C-T,rs2231568,-1,C,T,36114892,17,35918267,36311483,196625
19,ENSG00000105669.6,18919387,chr19-18831750-C-T,rs2238652,-1,C,T,18831750,87637,18722779,19115995,108971
19,ENSG00000051128.12,18941217,chr19-18831750-C-T,rs2238652,-1,C,T,18831750,109467,18744609,19137825,87141
19,ENSG00000012124.9,35329187,chr19-35340746-C-T,rs2239512,1,C,T,35340746,11559,35132579,35525795,208167
19,ENSG00000196365.5,5720146,chr19-5619315-T-G,rs2240239,-1,T,G,5619315,100831,5523538,5916754,95777
19,ENSG00000185236.6,8390360,chr19-8321422-G-A,rs2241592,1,G,A,8321422,68938,8193752,8586968,127670
19,ENSG00000124466.6,43465608,chr19-43450763-C-A,rs2247798,-1,C,A,43450763,14845,43269000,43662216,181763
19,ENSG00000127511.4,16829398,chr19-16925277-C-T,rs2250918,1,C,T,16925277,95879,16632790,17026006,292487
19,ENSG00000188493.8,40750477,chr19-40749595-C-G,rs2254343,-1,C,G,40749595,882,40553869,40947085,195726
19,ENSG00000254858.2,18193218,chr19-18195014-C-T,rs2271881,1,C,T,18195014,1796,17996610,18389826,198404
19,ENSG00000118162.8,47484219,chr19-47475414-G-A,rs2272295,-1,G,A,47475414,8805,47287611,47680827,187803
19,ENSG00000105612.3,12881449,chr19-12883901-A-G,rs2280742,-1,A,G,12883901,2452,12684841,13078057,199060
19,ENSG00000105668.2,35666516,chr19-35735098-T-C,rs2280743,1,T,C,35735098,68582,35469908,35863124,265190
19,ENSG00000159905.8,43951228,chr19-43954922-T-C,rs2284243,1,T,C,43954922,3694,43754620,44147836,200302
19,ENSG00000131845.9,57351271,chr19-57363586-C-G,rs2285604,1,C,G,57363586,12315,57154663,57547879,208923
19,ENSG00000167617.2,54473296,chr19-54471384-G-A,rs2287822,-1,G,A,54471384,1912,54276688,54669904,194696
19,ENSG00000160117.8,17281901,chr19-17306443-C-A,rs2288464,1,C,A,17306443,24542,17085293,17478509,221150
19,ENSG00000099341.5,38374571,chr19-38455542-G-A,rs2288888,1,G,A,38455542,80971,38177963,38571179,277579
19,ENSG00000121410.6,58353492,chr19-58393348-C-T,rs2289143,-1,C,T,58393348,39856,58156884,58550100,236464
19,ENSG00000167658.9,3985463,chr19-4013324-T-C,rs2289865,-1,T,C,4013324,27861,3788855,4182071,224469
19,ENSG00000188227.6,37506939,chr19-37507050-C-A,rs2291004,1,C,A,37507050,111,37310331,37703547,196719
19,ENSG00000171817.11,37594876,chr19-37507050-C-A,rs2291004,1,C,A,37507050,87826,37398268,37791484,108782
19,ENSG00000167384.5,44500522,chr19-44475997-C-T,rs2293164,-1,C,T,44475997,24525,44303914,44697130,172083
19,ENSG00000105146.7,57231023,chr19-57230880-C-T,rs2302060,1,C,T,57230880,143,57034415,57427631,196465
19,ENSG00000105656.4,18522070,chr19-18446847-C-T,rs2303692,-1,C,T,18446847,75223,18325462,18718678,121385
19,ENSG00000128626.6,38930944,chr19-38931064-C-T,rs2304115,1,C,T,38931064,120,38734336,39127552,196728
19,ENSG00000095752.1,55370463,chr19-55347858-G-A,rs2305785,-1,G,A,55347858,22605,55173855,55567071,174003
19,ENSG00000167578.11,40778247,chr19-40763171-T-C,rs2305797,1,T,C,40763171,15076,40581639,40974855,181532
19,ENSG00000105499.8,48110817,chr19-48105341-C-G,rs2307279,-1,C,G,48105341,5476,47914209,48307425,191132
19,ENSG00000221983.2,18571857,chr19-18581132-A-G,rs2314664,1,A,G,18581132,9275,18375249,18768465,205883
19,ENSG00000161618.4,49453225,chr19-49453753-C-T,rs2335183,1,C,T,49453753,528,49256617,49649833,197136
19,ENSG00000187187.7,39997060,chr19-40024036-T-C,rs234355,1,T,C,40024036,26976,39800452,40193668,223584
19,ENSG00000179922.3,55624566,chr19-55619339-C-T,rs2431798,-1,C,T,55619339,5227,55427958,55821174,191381
19,ENSG00000196357.6,36214665,chr19-36229488-C-T,rs2438517,-1,C,T,36229488,14823,36018057,36411273,211431
19,ENSG00000131409.6,50568435,chr19-50438550-A-G,rs2445828,-1,A,G,50438550,129885,50371827,50765043,66723
19,ENSG00000197857.7,12294883,chr19-12268264-G-A,rs2458997,-1,G,A,12268264,26619,12098275,12491491,169989
19,ENSG00000128011.4,39320863,chr19-39335957-A-G,rs251905,-1,A,G,39335957,15094,39124255,39517471,211702
19,ENSG00000188305.2,2282175,chr19-2266822-G-C,rs2523168,-1,G,C,2266822,15353,2085567,2478783,181255
19,ENSG00000188305.2,2282175,chr19-2266822-G-T,rs2523168,-1,G,T,2266822,15353,2085567,2478783,181255
19,ENSG00000167748.5,50823787,chr19-50824837-G-A,rs2560934,-1,G,A,50824837,1050,50627179,51020395,197658
19,ENSG00000205784.2,4902896,chr19-4933216-A-G,rs262567,-1,A,G,4933216,30320,4706288,5099504,226928
19,ENSG00000105072.3,16496394,chr19-16691198-T-C,rs2633339,1,T,C,16691198,194804,16299786,16693002,391412
19,ENSG00000180884.7,34964229,chr19-34943608-T-C,rs2651109,-1,T,C,34943608,20621,34767621,35160837,175987
19,ENSG00000071626.10,1407586,chr19-1457479-T-C,rs2656873,1,T,C,1457479,49893,1210978,1604194,246501
19,ENSG00000115266.6,1450121,chr19-1540507-A-G,rs2668433,1,A,G,1540507,90386,1253513,1646729,286994
19,ENSG00000090013.4,40465745,chr19-40457390-G-A,rs268692,-1,G,A,40457390,8355,40269137,40662353,188253
19,ENSG00000105383.9,51225080,chr19-51091973-A-G,rs2691270,1,A,G,51091973,133107,51028472,51421688,63501
19,ENSG00000174951.4,48752641,chr19-48719226-C-G,rs281395,-1,C,G,48719226,33415,48556033,48949249,163193
19,ENSG00000105371.7,10286955,chr19-10286562-C-T,rs281437,1,C,T,10286562,393,10090347,10483563,196215
19,ENSG00000188321.7,9324179,chr19-9324196-C-T,rs28384491,1,C,T,9324196,17,9127571,9520787,196625
19,ENSG00000181240.8,6433763,chr19-6436211-C-T,rs2860185,-1,C,T,6436211,2448,6237155,6630371,199056
19,ENSG00000161265.6,35745418,chr19-35741519-C-T,rs2871921,-1,C,T,35741519,3899,35548810,35942026,192709
19,ENSG00000229676.2,22634324,chr19-22656585-A-G,rs2885221,1,A,G,22656585,22261,22437716,22830932,218869
19,ENSG00000196867.1,56538948,chr19-56568579-G-A,rs2904239,1,G,A,56568579,29631,56342340,56735556,226239
19,ENSG00000120784.9,37655465,chr19-37665669-G-A,rs2927746,-1,G,A,37665669,10204,37458857,37852073,206812
19,ENSG00000105220.7,34365196,chr19-34428947-T-G,rs2965279,1,T,G,34428947,63751,34168588,34561804,260359
19,ENSG00000161298.11,36605313,chr19-36536315-A-G,rs2967465,1,A,G,36536315,68998,36408705,36801921,127610
19,ENSG00000196705.3,21142040,chr19-21191502-C-T,rs29727,1,C,T,21191502,49462,20945432,21338648,246070
19,ENSG00000105607.6,12891160,chr19-12951169-C-T,rs2974754,1,C,T,12951169,60009,12694552,13087768,256617
19,ENSG00000142408.2,53962937,chr19-53888428-T-A,rs307952,1,T,A,53888428,74509,53766329,54159545,122099
19,ENSG00000088256.3,3094362,chr19-3099984-T-C,rs308033,1,T,C,3099984,5622,2897754,3290970,202230
19,ENSG00000213015.3,55641002,chr19-55666330-C-T,rs310437,1,C,T,55666330,25328,55444394,55837610,221936
19,ENSG00000186020.7,36573292,chr19-36655792-T-C,rs3108210,-1,T,C,36655792,82500,36376684,36769900,279108
19,ENSG00000105287.7,46717114,chr19-46673568-T-C,rs314666,-1,T,C,46673568,43546,46520506,46913722,153062
19,ENSG00000130176.2,11538851,chr19-11365923-C-T,rs317914,1,C,T,11365923,172928,11342243,11735459,23680
19,ENSG00000237440.2,20565781,chr19-20543062-G-A,rs33930,-1,G,A,20543062,22719,20369173,20762389,173889
19,ENSG00000130758.2,40191426,chr19-40191154-T-C,rs339526,1,T,C,40191154,272,39994818,40388034,196336
19,ENSG00000125734.7,6737580,chr19-6739267-C-T,rs340141,-1,C,T,6739267,1687,6540972,6934188,198295
19,ENSG00000105520.5,11355432,chr19-11337256-A-C,rs34053641,1,A,C,11337256,18176,11158824,11552040,178432
19,ENSG00000167635.6,36215106,chr19-36224951-A-G,rs34242075,1,A,G,36224951,9845,36018498,36411714,206453
19,ENSG00000167232.8,23395471,chr19-23404477-C-T,rs34614912,-1,C,T,23404477,9006,23198863,23592079,205614
19,ENSG00000182310.7,51693330,chr19-51705239-G-A,rs34764077,1,G,A,51705239,11909,51496722,51889938,208517
19,ENSG00000182310.7,51693330,chr19-51705239-G-C,rs34764077,1,G,C,51705239,11909,51496722,51889938,208517
19,ENSG00000197256.5,11197545,chr19-11189232-C-T,rs34958840,-1,C,T,11189232,8313,11000937,11394153,188295
19,ENSG00000011478.6,45692666,chr19-45686603-C-T,rs35089411,1,C,T,45686603,6063,45496058,45889274,190545
19,ENSG00000130208.4,44914608,chr19-45039860-C-T,rs35242164,1,C,T,45039860,125252,44718000,45111216,321860
19,ENSG00000077463.9,4182563,chr19-4194093-G-A,rs352509,-1,G,A,4194093,11530,3985955,4379171,208138
19,ENSG00000077463.9,4182563,chr19-4194093-G-C,rs352509,-1,G,C,4194093,11530,3985955,4379171,208138
19,ENSG00000104894.6,49335406,chr19-49297570-A-G,rs354009,1,A,G,49297570,37836,49138798,49532014,158772
19,ENSG00000130383.5,5870540,chr19-5976749-T-C,rs35549731,-1,T,C,5976749,106209,5673932,6067148,302817
19,ENSG00000175691.6,2944971,chr19-2936537-G-A,rs35699176,-1,G,A,2936537,8434,2748363,3141579,188174
19,ENSG00000099337.2,38319845,chr19-38303728-T-C,rs35710536,1,T,C,38303728,16117,38123237,38516453,180491
19,ENSG00000179873.8,55831994,chr19-55956804-C-T,rs35751079,-1,C,T,55956804,124810,55635386,56028602,321418
19,ENSG00000126461.8,49642209,chr19-49812826-C-T,rs35816883,1,C,T,49812826,170617,49445601,49838817,367225
19,ENSG00000142252.5,45079260,chr19-45091337-T-C,rs3745157,1,T,C,45091337,12077,44882652,45275868,208685
19,ENSG00000167483.11,17527267,chr19-17341415-C-A,rs3745194,1,C,A,17341415,185852,17330659,17723875,10756
19,ENSG00000105245.4,40690651,chr19-40742104-C-T,rs3745213,-1,C,T,40742104,51453,40494043,40887259,248061
19,ENSG00000086544.1,40717112,chr19-40742104-C-T,rs3745213,1,C,T,40742104,24992,40520504,40913720,221600
19,ENSG00000104883.2,7489035,chr19-7488135-C-T,rs3745356,-1,C,T,7488135,900,7292427,7685643,195708
19,ENSG00000090971.3,55485188,chr19-55485572-G-A,rs3745450,1,G,A,55485572,384,55288580,55681796,196992
19,ENSG00000126467.5,49763306,chr19-49762292-T-G,rs3745477,-1,T,G,49762292,1014,49566698,49959914,195594
19,ENSG00000130813.12,10086317,chr19-9998174-A-G,rs3745594,1,A,G,9998174,88143,9889709,10282925,108465
19,ENSG00000213965.2,32691821,chr19-32827006-A-G,rs3746028,1,A,G,32827006,135185,32495213,32888429,331793
19,ENSG00000105676.7,19033603,chr19-19134962-A-G,rs3746259,1,A,G,19134962,101359,18836995,19230211,297967
19,ENSG00000167785.3,8832304,chr19-8871470-T-G,rs3752140,-1,T,G,8871470,39166,8635696,9028912,235774
19,ENSG00000142227.5,48325552,chr19-48343219-G-A,rs3760790,1,G,A,48343219,17667,48128944,48522160,214275
19,ENSG00000104915.9,13150375,chr19-13155172-C-T,rs3760911,-1,C,T,13155172,4797,12953767,13346983,201405
19,ENSG00000083845.3,58387269,chr19-58385345-C-T,rs3764536,1,C,T,58385345,1924,58190661,58583877,194684
19,ENSG00000161031.7,15479501,chr19-15460120-G-A,rs3764566,-1,G,A,15460120,19381,15282893,15676109,177227
19,ENSG00000170889.9,54200858,chr19-54206805-C-T,rs3786631,1,C,T,54206805,5947,54004250,54397466,202555
19,ENSG00000105053.5,50025372,chr19-50007899-C-T,rs3786676,-1,C,T,50007899,17473,49828764,50221980,179135
19,ENSG00000167642.6,38264573,chr19-38265224-C-T,rs3786870,1,C,T,38265224,651,38067965,38461181,197259
19,ENSG00000125650.2,6375933,chr19-6228206-C-T,rs3787064,-1,C,T,6228206,147727,6179325,6572541,48881
19,ENSG00000160505.9,55836540,chr19-55858800-C-T,rs379327,1,C,T,55858800,22260,55639932,56033148,218868
19,ENSG00000130725.2,58558611,chr19-58559684-C-T,rs3794963,-1,C,T,58559684,1073,58362003,58755219,197681
19,ENSG00000130725.2,58558611,chr19-58559684-C-G,rs3794963,-1,C,G,58559684,1073,58362003,58755219,197681
19,ENSG00000099326.3,58573335,chr19-58557629-C-T,rs3794966,-1,C,T,58557629,15706,58376727,58769943,180902
19,ENSG00000182986.7,52897635,chr19-52897507-C-A,rs3810115,-1,C,A,52897507,128,52701027,53094243,196480
19,ENSG00000160570.8,42217677,chr19-42390329-C-T,rs3810147,-1,C,T,42390329,172652,42021069,42414285,369260
19,ENSG00000105341.11,41439912,chr19-41398260-C-T,rs3810174,-1,C,T,41398260,41652,41243304,41636520,154956
19,ENSG00000086967.8,50432892,chr19-50431682-G-A,rs3810276,1,G,A,50431682,1210,50236284,50629500,195398
19,ENSG00000249471.2,58451622,chr19-58407433-C-T,rs3826680,1,C,T,58407433,44189,58255014,58648230,152419
19,ENSG00000169136.3,49929205,chr19-49928131-G-A,rs3826777,1,G,A,49928131,1074,49732597,50125813,195534
19,ENSG00000105516.5,48637379,chr19-48680027-G-A,rs3826838,-1,G,A,48680027,42648,48440771,48833987,239256
19,ENSG00000161277.6,36054285,chr19-36090734-G-A,rs3826995,-1,G,A,36090734,36449,35857677,36250893,233057
19,ENSG00000104964.9,3062495,chr19-3056215-G-A,rs3888377,-1,G,A,3056215,6280,2865887,3259103,190328
19,ENSG00000007255.5,45178237,chr19-45136458-A-G,rs3925162,-1,A,G,45136458,41779,44981629,45374845,154829
19,ENSG00000176222.6,43883964,chr19-43895154-A-G,rs396973,-1,A,G,43895154,11190,43687356,44080572,207798
19,ENSG00000167380.11,44165100,chr19-43984375-A-G,rs398981,1,A,G,43984375,180725,43968492,44361708,15883
19,ENSG00000196646.7,12163096,chr19-11990359-G-A,rs400606,1,G,A,11990359,172737,11966488,12359704,23871
19,ENSG00000104859.9,45039045,chr19-44867931-C-T,rs41290102,1,C,T,44867931,171114,44842437,45235653,25494
19,ENSG00000076924.6,7629545,chr19-7627063-A-G,rs4134831,-1,A,G,7627063,2482,7432937,7826153,194126
19,ENSG00000234465.4,43575801,chr19-43657346-C-G,rs4251871,1,C,G,43657346,81545,43379193,43772409,278153
19,ENSG00000130522.3,18281622,chr19-18284727-C-G,rs4254438,-1,C,G,18284727,3105,18085014,18478230,199713
19,ENSG00000130522.3,18281622,chr19-18284727-C-T,rs4254438,-1,C,T,18284727,3105,18085014,18478230,199713
19,ENSG00000180089.3,55228763,chr19-55228147-T-C,rs4255895,-1,T,C,55228147,616,55032155,55425371,195992
19,ENSG00000063176.9,48619506,chr19-48613847-C-T,rs433852,1,C,T,48613847,5659,48422898,48816114,190949
19,ENSG00000096996.9,18086934,chr19-18086825-G-A,rs436857,-1,G,A,18086825,109,17890326,18283542,196499
19,ENSG00000090006.12,40601369,chr19-40614471-G-T,rs4435368,1,G,T,40614471,13102,40404761,40797977,209710
19,ENSG00000090006.12,40601369,chr19-40614471-G-A,rs4435368,1,G,A,40614471,13102,40404761,40797977,209710
19,ENSG00000105750.8,20923251,chr19-20844593-A-G,rs4477841,1,A,G,20844593,78658,20726643,21119859,117950
19,ENSG00000248098.2,41397818,chr19-41397794-T-G,rs45500792,1,T,G,41397794,24,41201210,41594426,196584
19,ENSG00000126458.2,49640143,chr19-49690180-C-A,rs45613034,-1,C,A,49690180,50037,49443535,49836751,246645
19,ENSG00000119574.7,58519810,chr19-58336750-G-C,rs4801262,-1,G,C,58336750,183060,58323202,58716418,13548
19,ENSG00000083812.5,58467080,chr19-58488906-A-G,rs4801273,1,A,G,58488906,21826,58270472,58663688,218434
19,ENSG00000083807.4,58511992,chr19-58488906-A-G,rs4801273,-1,A,G,58488906,23086,58315384,58708600,173522
19,ENSG00000178229.6,57320472,chr19-57323938-C-T,rs4801468,1,C,T,57323938,3466,57123864,57517080,200074
19,ENSG00000178229.6,57320472,chr19-57323938-C-G,rs4801468,1,C,G,57323938,3466,57123864,57517080,200074
19,ENSG00000167378.3,43596134,chr19-43631041-G-C,rs4802188,-1,G,C,43631041,34907,43399526,43792742,231515
19,ENSG00000167378.3,43596134,chr19-43631041-G-A,rs4802188,-1,G,A,43631041,34907,43399526,43792742,231515
19,ENSG00000117877.5,45406644,chr19-45401501-T-C,rs4802252,1,T,C,45401501,5143,45210036,45603252,191465
19,ENSG00000142534.1,49496434,chr19-49486493-A-G,rs4802612,1,A,G,49486493,9941,49299826,49693042,186667
19,ENSG00000181027.5,46746057,chr19-46773197-G-A,rs4804000,1,G,A,46773197,27140,46549449,46942665,223748
19,ENSG00000105321.6,47256525,chr19-47277768-A-G,rs4804037,1,A,G,47277768,21243,47059917,47453133,217851
19,ENSG00000183401.5,11346519,chr19-11356065-C-G,rs4804161,1,C,G,11356065,9546,11149911,11543127,206154
19,ENSG00000079805.9,10718079,chr19-10756772-G-A,rs4804524,1,G,A,10756772,38693,10521471,10914687,235301
19,ENSG00000180061.4,55325341,chr19-55313218-G-A,rs4806659,-1,G,A,55313218,12123,55128733,55521949,184485
19,ENSG00000105618.8,54115754,chr19-54115811-G-A,rs4806711,1,G,A,54115811,57,53919146,54312362,196665
19,ENSG00000182087.6,1021123,chr19-1004824-G-A,rs4806908,-1,G,A,1004824,16299,824515,1217731,180309
19,ENSG00000095932.4,3480525,chr19-3390056-G-A,rs4806927,-1,G,A,3390056,90469,3283917,3677133,106139
19,ENSG00000105298.7,3626790,chr19-3631696-G-A,rs4806946,-1,G,A,3631696,4906,3430182,3823398,201514
19,ENSG00000167468.10,1103994,chr19-1099070-G-A,rs4806970,1,G,A,1099070,4924,907386,1300602,191684
19,ENSG00000171124.7,5851449,chr19-5954151-A-C,rs4807826,-1,A,C,5954151,102702,5654841,6048057,299310
19,ENSG00000197013.4,21505602,chr19-21569207-A-G,rs4808279,1,A,G,21569207,63605,21308994,21702210,260213
19,ENSG00000072958.3,16197911,chr19-16194197-A-G,rs4808467,1,A,G,16194197,3714,16001303,16394519,192894
19,ENSG00000081665.7,19821750,chr19-19810158-C-A,rs4808993,-1,C,A,19810158,11592,19625142,20018358,185016
19,ENSG00000081665.7,19821750,chr19-19810158-C-T,rs4808993,-1,C,T,19810158,11592,19625142,20018358,185016
19,ENSG00000160229.6,20776304,chr19-20690398-A-G,rs4809099,1,A,G,20690398,85906,20579696,20972912,110702
19,ENSG00000141933.6,507497,chr19-556632-A-G,rs4919850,1,A,G,556632,49135,310889,704105,245743
19,ENSG00000089351.7,35000323,chr19-34999957-C-G,rs4997929,1,C,G,34999957,366,34803715,35196931,196242
19,ENSG00000105197.4,39480838,chr19-39397809-C-T,rs519575,1,C,T,39397809,83029,39284230,39677446,113579
19,ENSG00000090932.5,39498947,chr19-39397809-C-T,rs519575,1,C,T,39397809,101138,39302339,39695555,95470
19,ENSG00000063241.2,55461642,chr19-55627209-T-C,rs522669,-1,T,C,55627209,165567,55265034,55658250,362175
19,ENSG00000105699.9,35249002,chr19-35228117-C-T,rs541169,1,C,T,35228117,20885,35052394,35445610,175723
19,ENSG00000220201.3,10309880,chr19-10284792-G-A,rs5497,-1,G,A,10284792,25088,10113272,10506488,171520
19,ENSG00000130332.8,2328586,chr19-2356267-G-A,rs55769436,-1,G,A,2356267,27681,2131978,2525194,224289
19,ENSG00000130477.9,17688354,chr19-17618978-T-G,rs56257446,-1,T,G,17618978,69376,17491746,17884962,127232
19,ENSG00000131400.2,50365639,chr19-50435226-G-A,rs57092106,-1,G,A,50435226,69587,50169031,50562247,266195
19,ENSG00000197619.7,52008211,chr19-51920136-A-G,rs57230999,-1,A,G,51920136,88075,51811603,52204819,108533
19,ENSG00000256771.1,19865882,chr19-19860347-T-C,rs58205702,1,T,C,19860347,5535,19669274,20062490,191073
19,ENSG00000104921.9,7702131,chr19-7546231-T-C,rs586551,-1,T,C,7546231,155900,7505523,7898739,40708
19,ENSG00000090372.7,46746450,chr19-46714657-A-C,rs588712,-1,A,C,46714657,31793,46549842,46943058,164815
19,ENSG00000167595.8,35758153,chr19-35663156-G-A,rs59627042,1,G,A,35663156,94997,35561545,35954761,101611
19,ENSG00000121413.7,58098231,chr19-58090085-G-A,rs61736354,-1,G,A,58090085,8146,57901623,58294839,188462
19,ENSG00000121413.7,58098231,chr19-58090085-G-C,rs61736354,-1,G,C,58090085,8146,57901623,58294839,188462
19,ENSG00000176293.13,58059282,chr19-58090085-G-A,rs61736354,1,G,A,58090085,30803,57862674,58255890,227411
19,ENSG00000176293.13,58059282,chr19-58090085-G-C,rs61736354,1,G,C,58090085,30803,57862674,58255890,227411
19,ENSG00000167618.4,54502831,chr19-54633172-C-T,rs61739171,1,C,T,54633172,130341,54306223,54699439,326949
19,ENSG00000132003.4,13795443,chr19-13796991-C-T,rs62108166,1,C,T,13796991,1548,13598835,13992051,198156
19,ENSG00000176531.5,43504746,chr19-43529945-G-C,rs62115749,-1,G,C,43529945,25199,43308138,43701354,221807
19,ENSG00000204920.4,43984188,chr19-43984200-G-A,rs62116613,1,G,A,43984200,12,43787580,44180796,196620
19,ENSG00000204604.3,52857619,chr19-52858585-A-G,rs62117499,-1,A,G,52858585,966,52661011,53054227,197574
19,ENSG00000182472.3,38744474,chr19-38719953-G-A,rs62119115,-1,G,A,38719953,24521,38547866,38941082,172087
19,ENSG00000186567.7,44671482,chr19-44618732-A-C,rs62119261,1,A,C,44618732,52750,44474874,44868090,143858
19,ENSG00000104872.5,49451814,chr19-49459635-G-A,rs62128062,-1,G,A,49459635,7821,49255206,49648422,204429
19,ENSG00000175221.7,893187,chr19-887226-G-T,rs62132322,-1,G,T,887226,5961,696579,1089795,190647
19,ENSG00000130165.5,11559230,chr19-11501498-T-C,rs625417,-1,T,C,11501498,57732,11362622,11755838,138876
19,ENSG00000105193.3,39435949,chr19-39435961-C-T,rs640000,-1,C,T,39435961,12,39239341,39632557,196620
19,ENSG00000167608.6,54173160,chr19-54173068-T-C,rs641738,-1,T,C,54173068,92,53976552,54369768,196516
19,ENSG00000104824.8,38849986,chr19-38865036-G-A,rs6508822,-1,G,A,38865036,15050,38653378,39046594,211658
19,ENSG00000105497.2,51571283,chr19-51572369-G-A,rs6509552,1,G,A,51572369,1086,51374675,51767891,197694
19,ENSG00000173581.2,55648212,chr19-55703818-G-A,rs6509955,1,G,A,55703818,55606,55451604,55844820,252214
19,ENSG00000174586.4,58362751,chr19-58352784-T-C,rs6510137,-1,T,C,58352784,9967,58166143,58559359,186641
19,ENSG00000127666.7,4831712,chr19-4830616-T-C,rs6510827,-1,T,C,4830616,1096,4635104,5028320,195512
19,ENSG00000037757.8,13764522,chr19-13758437-G-A,rs6511887,1,G,A,13758437,6085,13567914,13961130,190523
19,ENSG00000105711.5,35030470,chr19-35034040-G-A,rs67486287,1,G,A,35034040,3570,34833862,35227078,200178
19,ENSG00000105711.5,35030470,chr19-35034040-G-C,rs67486287,1,G,C,35034040,3570,34833862,35227078,200178
19,ENSG00000104783.5,43780973,chr19-43761943-T-C,rs679084,-1,T,C,43761943,19030,43584365,43977581,177578
19,ENSG00000105559.5,48868617,chr19-48793397-C-T,rs684959,-1,C,T,48793397,75220,48672009,49065225,121388
19,ENSG00000130312.1,17305872,chr19-17306756-C-T,rs6903,1,C,T,17306756,884,17109264,17502480,197492
19,ENSG00000125753.8,45507479,chr19-45379704-T-A,rs6966,1,T,A,45379704,127775,45310871,45704087,68833
19,ENSG00000132002.2,14518397,chr19-14514978-G-A,rs7003,-1,G,A,14514978,3419,14321789,14715005,193189
19,ENSG00000104969.4,2783273,chr19-2754794-G-A,rs7009,-1,G,A,2754794,28479,2586665,2979881,168129
19,ENSG00000167562.6,52570287,chr19-52494305-A-G,rs707314,1,A,G,52494305,75982,52373679,52766895,120626
19,ENSG00000177051.3,45730896,chr19-45692498-A-C,rs7245708,-1,A,C,45692498,38398,45534288,45927504,158210
19,ENSG00000099622.8,1269332,chr19-1442971-C-T,rs7245774,1,C,T,1442971,173639,1072724,1465940,370247
19,ENSG00000105131.2,15232448,chr19-15101493-T-C,rs7246549,-1,T,C,15101493,130955,15035840,15429056,65653
19,ENSG00000170906.9,54102855,chr19-53918182-G-A,rs7246670,1,G,A,53918182,184673,53906247,54299463,11935
19,ENSG00000125743.5,45691953,chr19-45687273-A-G,rs7246757,-1,A,G,45687273,4680,45495345,45888561,191928
19,ENSG00000179218.6,12938609,chr19-12977872-C-T,rs7246919,1,C,T,12977872,39263,12742001,13135217,235871
19,ENSG00000197124.5,20039505,chr19-20048942-C-T,rs7246955,-1,C,T,20048942,9437,19842897,20236113,206045
19,ENSG00000178531.3,7926135,chr19-8121379-G-A,rs7247560,-1,G,A,8121379,195244,7729527,8122743,391852
19,ENSG00000104823.3,38831794,chr19-38827366-C-T,rs7248208,-1,C,T,38827366,4428,38635186,39028402,192180
19,ENSG00000160392.8,40348397,chr19-40347585-C-T,rs7249146,-1,C,T,40347585,812,40151789,40545005,195796
19,ENSG00000090674.10,7522624,chr19-7698025-G-A,rs7249360,1,G,A,7698025,175401,7326016,7719232,372009
19,ENSG00000196605.2,9768617,chr19-9604623-G-C,rs7249421,-1,G,C,9604623,163994,9572009,9965225,32614
19,ENSG00000197405.2,47309861,chr19-47292712-C-T,rs7250152,1,C,T,47292712,17149,47113253,47506469,179459
19,ENSG00000115268.3,1438396,chr19-1438866-C-T,rs7251165,1,C,T,1438866,470,1241788,1635004,197078
19,ENSG00000249115.2,35612735,chr19-35436251-C-A,rs7252554,1,C,A,35436251,176484,35416127,35809343,20124
19,ENSG00000064666.7,1026608,chr19-1027798-A-C,rs7253254,1,A,C,1027798,1190,830000,1223216,197798
19,ENSG00000198182.6,37719761,chr19-37756356-T-C,rs7254828,-1,T,C,37756356,36595,37523153,37916369,233203
19,ENSG00000205138.2,35995188,chr19-35822638-G-C,rs7254923,1,G,C,35822638,172550,35798580,36191796,24058
19,ENSG00000042753.6,46850846,chr19-46820983-G-A,rs7255228,-1,G,A,46820983,29863,46654238,47047454,166745
19,ENSG00000105643.3,18008170,chr19-18013156-C-T,rs7255589,1,C,T,18013156,4986,17811562,18204778,201594
19,ENSG00000104903.3,13102858,chr19-13123308-G-A,rs7256436,-1,G,A,13123308,20450,12906250,13299466,217058
19,ENSG00000220008.1,2292024,chr19-2169122-T-G,rs7256735,-1,T,G,2169122,122902,2095416,2488632,73706
19,ENSG00000169021.3,29213151,chr19-29403898-A-G,rs7256832,-1,A,G,29403898,190747,29016543,29409759,387355
19,ENSG00000167766.11,52638355,chr19-52615776-T-C,rs7257138,-1,T,C,52615776,22579,52441747,52834963,174029
19,ENSG00000172687.8,21359000,chr19-21461994-G-A,rs7257584,1,G,A,21461994,102994,21162392,21555608,299602
19,ENSG00000228300.7,1275530,chr19-1275089-T-G,rs7257836,1,T,G,1275089,441,1078922,1472138,196167
19,ENSG00000189042.7,36687612,chr19-36687445-A-G,rs7259256,1,A,G,36687445,167,36491004,36884220,196441
19,ENSG00000131849.8,58440153,chr19-58439756-T-C,rs7259841,-1,T,C,58439756,397,58243545,58636761,196211
19,ENSG00000131849.8,58440153,chr19-58439756-T-G,rs7259841,-1,T,G,58439756,397,58243545,58636761,196211
19,ENSG00000104805.10,48900312,chr19-48897377-C-T,rs7260579,1,C,T,48897377,2935,48703704,49096920,193673
19,ENSG00000167657.5,3971099,chr19-3853532-T-C,rs72975109,-1,T,C,3853532,117567,3774491,4167707,79041
19,ENSG00000076826.4,7595863,chr19-7597004-G-C,rs72992520,1,G,C,7597004,1141,7399255,7792471,197749
19,ENSG00000074181.2,15200995,chr19-15383118-G-A,rs72994068,-1,G,A,15383118,182123,15004387,15397603,378731
19,ENSG00000129933.11,19320829,chr19-19496039-C-T,rs73002973,1,C,T,19496039,175210,19124221,19517437,371818
19,ENSG00000160113.3,17245919,chr19-17237270-G-A,rs73012579,-1,G,A,17237270,8649,17049311,17442527,187959
19,ENSG00000197380.5,46661182,chr19-46539194-A-G,rs73054610,-1,A,G,46539194,121988,46464574,46857790,74620
19,ENSG00000251369.2,57559863,chr19-57567169-A-G,rs73060424,-1,A,G,57567169,7306,57363255,57756471,203914
19,ENSG00000152439.6,57499938,chr19-57567169-A-G,rs73060424,1,A,G,57567169,67231,57303330,57696546,263839
19,ENSG00000105063.12,55259017,chr19-55227680-G-A,rs73068639,-1,G,A,55227680,31337,55062409,55455625,165271
19,ENSG00000131848.4,56314839,chr19-56266223-T-C,rs73069649,-1,T,C,56266223,48616,56118231,56511447,147992
19,ENSG00000104899.2,2249323,chr19-2241328-G-T,rs733846,1,G,T,2241328,7995,2052715,2445931,188613
19,ENSG00000197134.5,22052484,chr19-22187022-C-T,rs7343144,1,C,T,22187022,134538,21855876,22249092,331146
19,ENSG00000188000.2,9178979,chr19-9153725-G-A,rs73494602,1,G,A,9153725,25254,8982371,9375587,171354
19,ENSG00000130803.9,9140397,chr19-9153725-G-A,rs73494602,1,G,A,9153725,13328,8943789,9337005,209936
19,ENSG00000178078.5,4338827,chr19-4323997-C-T,rs73534876,-1,C,T,4323997,14830,4142219,4535435,181778
19,ENSG00000076944.7,7637110,chr19-7636862-T-C,rs7359905,1,T,C,7636862,248,7440502,7833718,196360
19,ENSG00000167685.8,56141287,chr19-56193310-C-A,rs73617569,1,C,A,56193310,52023,55944679,56337895,248631
19,ENSG00000173809.11,32719753,chr19-32654739-C-T,rs736452,1,C,T,32654739,65014,32523145,32916361,131594
19,ENSG00000130300.3,17377342,chr19-17373316-C-T,rs73930549,-1,C,T,17373316,4026,17180734,17573950,192582
19,ENSG00000133246.4,8502640,chr19-8477121-A-G,rs7408960,-1,A,G,8477121,25519,8306032,8699248,171089
19,ENSG00000142039.2,41310172,chr19-41331842-G-A,rs747857,1,G,A,41331842,21670,41113564,41506780,218278
19,ENSG00000125648.8,6459792,chr19-6472919-C-A,rs74800876,-1,C,A,6472919,13127,6263184,6656400,209735
19,ENSG00000176533.7,2702694,chr19-2675680-T-C,rs75162160,-1,T,C,2675680,27014,2506086,2899302,169594
19,ENSG00000064687.7,1040107,chr19-1068809-G-A,rs75181293,1,G,A,1068809,28702,843499,1236715,225310
19,ENSG00000104960.10,49851159,chr19-49854876-T-G,rs75478119,1,T,G,49854876,3717,49654551,50047767,200325
19,ENSG00000188051.5,17448668,chr19-17430208-A-G,rs754847,-1,A,G,17430208,18460,17252060,17645276,178148
19,ENSG00000123815.6,40716886,chr19-40724964-G-A,rs755635,-1,G,A,40724964,8078,40520278,40913494,204686
19,ENSG00000186111.3,3700468,chr19-3688526-C-T,rs75760304,-1,C,T,3688526,11942,3503860,3897076,184666
19,ENSG00000254901.1,19192152,chr19-19198895-G-A,rs75833713,-1,G,A,19198895,6743,18995544,19388760,203351
19,ENSG00000254901.1,19192152,chr19-19198895-G-C,rs75833713,-1,G,C,19198895,6743,18995544,19388760,203351
19,ENSG00000130254.5,5622776,chr19-5454039-G-A,rs75921881,-1,G,A,5454039,168737,5426168,5819384,27871
19,ENSG00000176472.5,43533188,chr19-43553946-T-C,rs762507,1,T,C,43553946,20758,43336580,43729796,217366
19,ENSG00000105248.10,4247080,chr19-4378830-C-A,rs77425329,1,C,A,4378830,131750,4050472,4443688,328358
19,ENSG00000126259.10,35856911,chr19-35700416-C-T,rs77680881,1,C,T,35700416,156495,35660303,36053519,40113
19,ENSG00000105472.6,50723364,chr19-50627238-T-C,rs77757123,1,T,C,50627238,96126,50526756,50919972,100482
19,ENSG00000105323.10,41264372,chr19-41170011-C-T,rs78144186,1,C,T,41170011,94361,41067764,41460980,102247
19,ENSG00000105323.10,41264372,chr19-41170011-C-A,rs78144186,1,C,A,41170011,94361,41067764,41460980,102247
19,ENSG00000104904.4,2269520,chr19-2238720-C-A,rs78481493,1,C,A,2238720,30800,2072912,2466128,165808
19,ENSG00000170954.6,53132910,chr19-52944989-A-C,rs78842293,-1,A,C,52944989,187921,52936302,53329518,8687
19,ENSG00000167671.6,4457794,chr19-4444745-A-G,rs78869060,-1,A,G,4444745,13049,4261186,4654402,183559
19,ENSG00000115257.9,1490408,chr19-1490704-G-A,rs791470,-1,G,A,1490704,296,1293800,1687016,196904
19,ENSG00000233927.2,8321496,chr19-8355699-G-A,rs79293855,1,G,A,8355699,34203,8124888,8518104,230811
19,ENSG00000130518.7,18274452,chr19-18299559-G-A,rs79534846,-1,G,A,18299559,25107,18077844,18471060,221715
19,ENSG00000187650.2,5904872,chr19-5900460-C-T,rs79569934,1,C,T,5900460,4412,5708264,6101480,192196
19,ENSG00000171649.5,57584145,chr19-57666390-C-T,rs79655520,1,C,T,57666390,82245,57387537,57780753,278853
19,ENSG00000121406.3,57527356,chr19-57666390-C-T,rs79655520,1,C,T,57666390,139034,57330748,57723964,335642
19,ENSG00000239382.4,36014213,chr19-35848908-T-C,rs80321803,-1,T,C,35848908,165305,35817605,36210821,31303
19,ENSG00000072954.1,16661139,chr19-16650266-C-A,rs8101030,1,C,A,16650266,10873,16464531,16857747,185735
19,ENSG00000171469.6,9621232,chr19-9681224-G-T,rs8101075,-1,G,T,9681224,59992,9424624,9817840,256600
19,ENSG00000130377.8,6135667,chr19-6167403-A-G,rs8101237,1,A,G,6167403,31736,5939059,6332275,228344
19,ENSG00000104983.3,45995467,chr19-46002268-T-C,rs8101646,1,T,C,46002268,6801,45798859,46192075,203409
19,ENSG00000197937.5,53159053,chr19-53176696-T-C,rs8102278,-1,T,C,53176696,17643,52962445,53355661,214251
19,ENSG00000197019.4,40425992,chr19-40333757-A-C,rs8103796,-1,A,C,40333757,92235,40229384,40622600,104373
19,ENSG00000007264.8,3786381,chr19-3781586-C-G,rs8105735,-1,C,G,3781586,4795,3589773,3982989,191813
19,ENSG00000166704.7,58002820,chr19-57984292-G-C,rs8105738,-1,G,C,57984292,18528,57806212,58199428,178080
19,ENSG00000104972.10,54630484,chr19-54611998-T-A,rs8105809,1,T,A,54611998,18486,54433876,54827092,178122
19,ENSG00000053501.7,17215357,chr19-17395367-T-C,rs8106139,1,T,C,17395367,180010,17018749,17411965,376618
19,ENSG00000064545.8,19138478,chr19-18983417-A-C,rs8107145,-1,A,C,18983417,155061,18941870,19335086,41547
19,ENSG00000132016.6,13906117,chr19-13864563-A-G,rs8107465,-1,A,G,13864563,41554,13709509,14102725,155054
19,ENSG00000074219.8,49362416,chr19-49367386-T-C,rs8107548,-1,T,C,49367386,4970,49165808,49559024,201578
19,ENSG00000196268.6,21397133,chr19-21403434-T-C,rs8107999,1,T,C,21403434,6301,21200525,21593741,202909
19,ENSG00000105519.5,5914254,chr19-5903796-G-T,rs8108064,1,G,T,5903796,10458,5717646,6110862,186150
19,ENSG00000188171.8,20661571,chr19-20679944-C-T,rs8108244,-1,C,T,20679944,18373,20464963,20858179,214981
19,ENSG00000167460.9,16076495,chr19-16074749-G-A,rs8109288,1,G,A,16074749,1746,15879887,16273103,194862
19,ENSG00000105374.4,51372654,chr19-51372692-C-T,rs8109405,-1,C,T,51372692,38,51176046,51569262,196646
19,ENSG00000189114.5,45178784,chr19-45219485-G-A,rs8109764,1,G,A,45219485,40701,44982176,45375392,237309
19,ENSG00000181035.8,19063994,chr19-19063428-C-T,rs8110629,1,C,T,19063428,566,18867386,19260602,196042
19,ENSG00000131941.2,33064888,chr19-33224440-C-T,rs8110876,-1,C,T,33224440,159552,32868280,33261496,356160
19,ENSG00000105492.10,51531670,chr19-51470447-A-G,rs8110997,-1,A,G,51470447,61223,51335062,51728278,135385
19,ENSG00000262874.1,51390591,chr19-51391484-G-A,rs8111906,-1,G,A,51391484,893,51193983,51587199,197501
19,ENSG00000105401.1,10403542,chr19-10409388-G-A,rs8112449,-1,G,A,10409388,5846,10206934,10600150,202454
19,ENSG00000089335.14,34677678,chr19-34644604-T-G,rs8112651,1,T,G,34644604,33074,34481070,34874286,163534
19,ENSG00000186026.5,44072159,chr19-44087207-G-A,rs8113249,1,G,A,44087207,15048,43875551,44268767,211656
19,ENSG00000167600.7,41193219,chr19-41193981-G-C,rs8192793,1,G,C,41193981,762,40996611,41389827,197370
19,ENSG00000104907.7,13116740,chr19-13155336-C-T,rs879989,-1,C,T,13155336,38596,12920132,13313348,235204
19,ENSG00000130520.3,18323076,chr19-18374112-G-T,rs888663,-1,G,T,18374112,51036,18126468,18519684,247644
19,ENSG00000142453.6,10871553,chr19-10907727-G-A,rs892011,1,G,A,10907727,36174,10674945,11068161,232782
19,ENSG00000188505.3,39196964,chr19-39194269-A-C,rs892015,1,A,C,39194269,2695,39000356,39393572,193913
19,ENSG00000169169.9,49691116,chr19-49691588-C-A,rs892149,1,C,A,49691588,472,49494508,49887724,197080
19,ENSG00000179954.7,55488436,chr19-55492645-T-C,rs929794,1,T,C,55492645,4209,55291828,55685044,200817
19,ENSG00000099821.6,633537,chr19-630844-C-G,rs9304924,-1,C,G,630844,2693,436929,830145,193915
19,ENSG00000196466.5,12401271,chr19-12438271-C-T,rs9676510,-1,C,T,12438271,37000,12204663,12597879,233608
19,ENSG00000196267.6,52171621,chr19-52184435-G-A,rs997703,-1,G,A,52184435,12814,51975013,52368229,209422
19,ENSG00000012061.9,45423917,chr19-45451943-G-T,rs1018765,-1,G,T,45451943,28026,45227309,45620525,224634
19,ENSG00000141994.9,5791163,chr19-5775326-G-C,rs1026466,-1,G,C,5775326,15837,5594555,5987771,180771
19,ENSG00000105245.4,40690651,chr19-40686512-C-T,rs10401344,-1,C,T,40686512,4139,40494043,40887259,192469
19,ENSG00000167618.4,54502831,chr19-54517577-C-T,rs10401651,1,C,T,54517577,14746,54306223,54699439,211354
19,ENSG00000189190.6,52786807,chr19-52793157-G-T,rs10402737,-1,G,T,52793157,6350,52590199,52983415,202958
19,ENSG00000011478.6,45692666,chr19-45688570-C-T,rs10403723,1,C,T,45688570,4096,45496058,45889274,192512
19,ENSG00000197050.5,37078433,chr19-36885854-G-A,rs10403906,1,G,A,36885854,192579,36881825,37275041,4029
19,ENSG00000105136.13,57487750,chr19-57581676-C-A,rs10405036,1,C,A,57581676,93926,57291142,57684358,290534
19,ENSG00000105136.13,57487750,chr19-57581676-C-T,rs10405036,1,C,T,57581676,93926,57291142,57684358,290534
19,ENSG00000117877.5,45406644,chr19-45452623-T-C,rs10405048,1,T,C,45452623,45979,45210036,45603252,242587
19,ENSG00000028277.12,42132446,chr19-42045782-C-T,rs10407506,-1,C,T,42045782,86664,41935838,42329054,109944
19,ENSG00000073050.5,43575527,chr19-43504258-A-C,rs10408863,-1,A,C,43504258,71269,43378919,43772135,125339
19,ENSG00000104972.10,54630484,chr19-54643313-G-A,rs10410382,1,G,A,54643313,12829,54433876,54827092,209437
19,ENSG00000161888.5,11155782,chr19-11062453-G-A,rs10411606,-1,G,A,11062453,93329,10959174,11352390,103279
19,ENSG00000079313.5,1848483,chr19-2002391-T-G,rs10413498,-1,T,G,2002391,153908,1651875,2045091,350516
19,ENSG00000127452.3,9819079,chr19-9828416-C-T,rs10413737,-1,C,T,9828416,9337,9622471,10015687,205945
19,ENSG00000105723.6,42242602,chr19-42081822-T-G,rs10414151,-1,T,G,42081822,160780,42045994,42439210,35828
19,ENSG00000188000.2,9178979,chr19-9203459-T-G,rs10415904,1,T,G,9203459,24480,8982371,9375587,221088
19,ENSG00000089335.14,34677678,chr19-34792543-G-A,rs10416755,1,G,A,34792543,114865,34481070,34874286,311473
19,ENSG00000089639.5,19643657,chr19-19609015-C-G,rs10417097,-1,C,G,19609015,34642,19447049,19840265,161966
19,ENSG00000170954.6,53132910,chr19-53145820-A-G,rs10423215,-1,A,G,53145820,12910,52936302,53329518,209518
19,ENSG00000186230.5,57435325,chr19-57344761-A-T,rs10423532,1,A,T,57344761,90564,57238717,57631933,106044
19,ENSG00000104859.9,45039045,chr19-45136730-G-A,rs10425380,1,G,A,45136730,97685,44842437,45235653,294293
19,ENSG00000167654.11,3880685,chr19-3750624-A-C,rs1046271,1,A,C,3750624,130061,3684077,4077293,66547
19,ENSG00000105401.1,10403542,chr19-10467167-C-A,rs1051738,-1,C,A,10467167,63625,10206934,10600150,260233
19,ENSG00000105401.1,10403542,chr19-10467167-C-T,rs1051738,-1,C,T,10467167,63625,10206934,10600150,260233
19,ENSG00000130159.6,11529134,chr19-11505992-A-G,rs1062958,-1,A,G,11505992,23142,11332526,11725742,173466
19,ENSG00000167617.2,54473296,chr19-54468529-T-C,rs10853871,-1,T,C,54468529,4767,54276688,54669904,191841
19,ENSG00000105287.7,46717114,chr19-46704397-G-A,rs11083846,-1,G,A,46704397,12717,46520506,46913722,183891
19,ENSG00000170889.9,54200858,chr19-54202904-A-C,rs11084316,1,A,C,54202904,2046,54004250,54397466,198654
19,ENSG00000083817.6,57578911,chr19-57660630-T-C,rs11084514,-1,T,C,57660630,81719,57382303,57775519,278327
19,ENSG00000008382.10,4343562,chr19-4368145-C-T,rs11085072,1,C,T,4368145,24583,4146954,4540170,221191
19,ENSG00000105639.13,17847982,chr19-17913462-T-C,rs11086082,-1,T,C,17913462,65480,17651374,18044590,262088
19,ENSG00000260001.1,7914830,chr19-8072959-A-C,rs111332402,1,A,C,8072959,158129,7718222,8111438,354737
19,ENSG00000130812.5,10102678,chr19-10029499-G-A,rs112645523,-1,G,A,10029499,73179,9906070,10299286,123429
19,ENSG00000174586.4,58362751,chr19-58396333-G-A,rs112710702,-1,G,A,58396333,33582,58166143,58559359,230190
19,ENSG00000105205.5,39738029,chr19-39678029-G-A,rs113169072,-1,G,A,39678029,60000,39541421,39934637,136608
19,ENSG00000205744.4,6481787,chr19-6381626-G-A,rs113337492,-1,G,A,6381626,100161,6285179,6678395,96447
19,ENSG00000105755.2,43527201,chr19-43581675-C-T,rs11407,-1,C,T,43581675,54474,43330593,43723809,251082
19,ENSG00000174788.4,7633719,chr19-7748256-G-T,rs11465362,-1,G,T,7748256,114537,7437111,7830327,311145
19,ENSG00000161265.6,35745418,chr19-35577259-G-A,rs114852218,-1,G,A,35577259,168159,35548810,35942026,28449
19,ENSG00000212123.3,5784746,chr19-5782920-C-A,rs115109202,-1,C,A,5782920,1826,5588138,5981354,194782
19,ENSG00000169136.3,49929205,chr19-49917414-C-A,rs1152239,1,C,A,49917414,11791,49732597,50125813,184817
19,ENSG00000105186.7,32675180,chr19-32672252-G-A,rs115273093,-1,G,A,32672252,2928,32478572,32871788,193680
19,ENSG00000065268.3,984345,chr19-991129-G-A,rs11538683,1,G,A,991129,6784,787737,1180953,203392
19,ENSG00000039650.4,49867576,chr19-49796609-G-A,rs115475578,-1,G,A,49796609,70967,49670968,50064184,125641
19,ENSG00000204673.5,49877355,chr19-49796609-G-A,rs115475578,-1,G,A,49796609,80746,49680747,50073963,115862
19,ENSG00000125734.7,6737580,chr19-6709063-C-T,rs11569429,-1,C,T,6709063,28517,6540972,6934188,168091
19,ENSG00000167733.8,5681027,chr19-5829581-A-G,rs11666494,1,A,G,5829581,148554,5484419,5877635,345162
19,ENSG00000105576.9,12723932,chr19-12908740-C-T,rs11667458,-1,C,T,12908740,184808,12527324,12920540,381416
19,ENSG00000141933.6,507497,chr19-455661-A-G,rs11667579,1,A,G,455661,51836,310889,704105,144772
19,ENSG00000160352.9,21082203,chr19-21130037-T-C,rs11667905,1,T,C,21130037,47834,20885595,21278811,244442
19,ENSG00000011132.6,3761692,chr19-3757411-C-T,rs11668141,-1,C,T,3757411,4281,3565084,3958300,192327
19,ENSG00000244482.3,54242791,chr19-54245208-C-T,rs11668526,-1,C,T,54245208,2417,54046183,54439399,199025
19,ENSG00000174951.4,48752641,chr19-48788938-A-G,rs11668745,-1,A,G,48788938,36297,48556033,48949249,232905
19,ENSG00000127511.4,16829398,chr19-17000864-T-C,rs11669497,1,T,C,17000864,171466,16632790,17026006,368074
19,ENSG00000130544.6,7069703,chr19-7000999-G-A,rs11669654,1,G,A,7000999,68704,6873095,7266311,127904
19,ENSG00000213799.4,53333749,chr19-53194115-T-G,rs11669754,1,T,G,53194115,139634,53137141,53530357,56974
19,ENSG00000160014.11,46601330,chr19-46577993-G-A,rs11670297,1,G,A,46577993,23337,46404722,46797938,173271
19,ENSG00000174652.12,9435573,chr19-9453501-G-T,rs11670509,-1,G,T,9453501,17928,9238965,9632181,214536
19,ENSG00000196705.3,21142040,chr19-21230335-C-T,rs11671410,1,C,T,21230335,88295,20945432,21338648,284903
19,ENSG00000213638.2,1905399,chr19-1750448-T-A,rs11673055,1,T,A,1750448,154951,1708791,2102007,41657
19,ENSG00000213638.2,1905399,chr19-1750448-T-G,rs11673055,1,T,G,1750448,154951,1708791,2102007,41657
19,ENSG00000161640.10,49961172,chr19-49893006-T-C,rs11673399,-1,T,C,49893006,68166,49764564,50157780,128442
19,ENSG00000076662.4,10339624,chr19-10327765-C-T,rs11673632,-1,C,T,10327765,11859,10143016,10536232,184749
19,ENSG00000105290.4,35868574,chr19-36043371-T-C,rs116855108,1,T,C,36043371,174797,35671966,36065182,371405
19,ENSG00000105672.8,35641745,chr19-35644881-G-A,rs117704954,1,G,A,35644881,3136,35445137,35838353,199744
19,ENSG00000064961.12,3572944,chr19-3574075-G-A,rs117786787,1,G,A,3574075,1131,3376336,3769552,197739
19,ENSG00000072071.11,14206169,chr19-14370633-C-T,rs117809409,-1,C,T,14370633,164464,14009561,14402777,361072
19,ENSG00000079385.14,42528481,chr19-42668795-A-G,rs117831884,-1,A,G,42668795,140314,42331873,42725089,336922
19,ENSG00000024422.5,47713422,chr19-47715155-G-A,rs118085184,1,G,A,47715155,1733,47516814,47910030,198341
19,ENSG00000171777.9,38426219,chr19-38489953-G-A,rs11880126,-1,G,A,38489953,63734,38229611,38622827,260342
19,ENSG00000172009.9,2785503,chr19-2650036-T-C,rs11880582,1,T,C,2650036,135467,2588895,2982111,61141
19,ENSG00000171649.5,57584145,chr19-57660933-C-A,rs11881170,1,C,A,57660933,76788,57387537,57780753,273396
19,ENSG00000127507.11,14778560,chr19-14777242-T-C,rs11881701,-1,T,C,14777242,1318,14581952,14975168,195290
19,ENSG00000180257.8,52962881,chr19-52962729-G-A,rs11883049,-1,G,A,52962729,152,52766273,53159489,196456
19,ENSG00000076944.7,7637110,chr19-7657750-G-A,rs11883223,1,G,A,7657750,20640,7440502,7833718,217248
19,ENSG00000248099.2,17821519,chr19-17824817-T-C,rs11888,-1,T,C,17824817,3298,17624911,18018127,199906
19,ENSG00000095059.10,12681880,chr19-12794432-C-A,rs1205170,-1,C,A,12794432,112552,12485272,12878488,309160
19,ENSG00000105479.10,48321971,chr19-48313550-A-G,rs1235043,-1,A,G,48313550,8421,48125363,48518579,188187
19,ENSG00000104998.1,14031762,chr19-14018588-G-A,rs12460424,1,G,A,14018588,13174,13835154,14228370,183434
19,ENSG00000179134.8,39342421,chr19-39517580-A-C,rs12461523,1,A,C,39517580,175159,39145813,39539029,371767
19,ENSG00000196365.5,5720146,chr19-5555087-A-G,rs12461806,-1,A,G,5555087,165059,5523538,5916754,31549
19,ENSG00000105329.4,41353922,chr19-41226518-T-C,rs12462203,-1,T,C,41226518,127404,41157314,41550530,69204
19,ENSG00000076650.1,33081181,chr19-33045777-A-C,rs12462426,1,A,C,33045777,35404,32884573,33277789,161204
19,ENSG00000104979.3,13774456,chr19-13661811-G-A,rs12462927,1,G,A,13661811,112645,13577848,13971064,83963
19,ENSG00000115268.3,1438396,chr19-1309370-G-A,rs12609567,1,G,A,1309370,129026,1241788,1635004,67582
19,ENSG00000105677.5,35545626,chr19-35395516-G-A,rs12609661,1,G,A,35395516,150110,35349018,35742234,46498
19,ENSG00000121417.9,57633168,chr19-57754824-C-T,rs12609667,1,C,T,57754824,121656,57436560,57829776,318264
19,ENSG00000104973.8,49818289,chr19-49832615-A-G,rs1290652,1,A,G,49832615,14326,49621681,50014897,210934
19,ENSG00000130311.5,17309563,chr19-17414505-T-C,rs12972417,1,T,C,17414505,104942,17112955,17506171,301550
19,ENSG00000105321.6,47256525,chr19-47200561-C-T,rs12973505,1,C,T,47200561,55964,47059917,47453133,140644
19,ENSG00000125657.2,6531026,chr19-6517911-C-T,rs12974682,1,C,T,6517911,13115,6334418,6727634,183493
19,ENSG00000141905.11,3366583,chr19-3414090-G-A,rs12975319,1,G,A,3414090,47507,3169975,3563191,244115
19,ENSG00000196268.6,21397133,chr19-21253936-C-T,rs12977122,1,C,T,21253936,143197,21200525,21593741,53411
19,ENSG00000167766.11,52638355,chr19-52644517-G-A,rs12980672,-1,G,A,52644517,6162,52441747,52834963,202770
19,ENSG00000167766.11,52638355,chr19-52644517-G-C,rs12980672,-1,G,C,52644517,6162,52441747,52834963,202770
19,ENSG00000186115.5,15898074,chr19-15938038-G-A,rs12980757,-1,G,A,15938038,39964,15701466,16094682,236572
19,ENSG00000152454.2,57947706,chr19-57841154-G-A,rs12981244,-1,G,A,57841154,106552,57751098,58144314,90056
19,ENSG00000104888.4,49441527,chr19-49297912-T-C,rs12982246,-1,T,C,49297912,143615,49244919,49638135,52993
19,ENSG00000134815.12,47349315,chr19-47301962-C-T,rs12983014,1,C,T,47301962,47353,47152707,47545923,149255
19,ENSG00000105750.8,20923251,chr19-20965579-T-G,rs12983125,1,T,G,20965579,42328,20726643,21119859,238936
19,ENSG00000186272.7,57411161,chr19-57406904-C-G,rs12984074,1,C,G,57406904,4257,57214553,57607769,192351
19,ENSG00000105483.10,48255912,chr19-48255702-T-C,rs12984288,-1,T,C,48255702,210,48059304,48452520,196398
19,ENSG00000172081.8,2096326,chr19-2273147-C-T,rs13140,-1,C,T,2273147,176821,1899718,2292934,373429
19,ENSG00000161618.4,49453225,chr19-49451898-G-C,rs1343703,1,G,C,49451898,1327,49256617,49649833,195281
19,ENSG00000130517.5,18340598,chr19-18333999-A-T,rs1363119,1,A,T,18333999,6599,18143990,18537206,190009
19,ENSG00000130517.5,18340598,chr19-18333999-A-G,rs1363119,1,A,G,18333999,6599,18143990,18537206,190009
19,ENSG00000181029.6,7680833,chr19-7497110-T-C,rs1363938,1,T,C,7497110,183723,7484225,7877441,12885
19,ENSG00000197619.7,52008211,chr19-51887473-C-A,rs1433082,-1,C,A,51887473,120738,51811603,52204819,75870
19,ENSG00000105640.6,17859910,chr19-17933791-G-A,rs1433127,1,G,A,17933791,73881,17663302,18056518,270489
19,ENSG00000037757.8,13764522,chr19-13772285-A-G,rs1469071,1,A,G,13772285,7763,13567914,13961130,204371
19,ENSG00000205517.6,11419314,chr19-11461837-G-T,rs1531101,-1,G,T,11461837,42523,11222706,11615922,239131
19,ENSG00000205517.6,11419314,chr19-11461837-G-C,rs1531101,-1,G,C,11461837,42523,11222706,11615922,239131
19,ENSG00000178201.3,57457140,chr19-57547168-A-G,rs1548476,-1,A,G,57547168,90028,57260532,57653748,286636
19,ENSG00000123144.5,12734684,chr19-12564245-T-C,rs1560161,-1,T,C,12564245,170439,12538076,12931292,26169
19,ENSG00000105173.8,29811991,chr19-29976136-G-C,rs162923,1,G,C,29976136,164145,29615383,30008599,360753
19,ENSG00000105472.6,50723364,chr19-50907860-T-C,rs1654553,1,T,C,50907860,184496,50526756,50919972,381104
19,ENSG00000160439.9,55063148,chr19-55041455-A-G,rs1671214,-1,A,G,55041455,21693,54866540,55259756,174915
19,ENSG00000079462.2,42302624,chr19-42330599-A-G,rs1676222,-1,A,G,42330599,27975,42106016,42499232,224583
19,ENSG00000187556.5,13877134,chr19-13779391-A-G,rs16979344,1,A,G,13779391,97743,13680526,14073742,98865
19,ENSG00000105443.8,48469369,chr19-48318500-G-A,rs16981988,1,G,A,48318500,150869,48272761,48665977,45739
19,ENSG00000172006.6,2819868,chr19-2782451-G-A,rs16991385,1,G,A,2782451,37417,2623260,3016476,159191
19,ENSG00000186111.3,3700468,chr19-3675727-A-G,rs16991994,-1,A,G,3675727,24741,3503860,3897076,171867
19,ENSG00000130520.3,18323076,chr19-18199868-G-C,rs16995485,-1,G,C,18199868,123208,18126468,18519684,73400
19,ENSG00000064545.8,19138478,chr19-19254591-C-T,rs16996008,-1,C,T,19254591,116113,18941870,19335086,312721
19,ENSG00000105514.2,11339657,chr19-11325166-C-T,rs172757,-1,C,T,11325166,14491,11143049,11536265,182117
19,ENSG00000073008.8,44643910,chr19-44564743-T-C,rs1727761,1,T,C,44564743,79167,44447302,44840518,117441
19,ENSG00000105364.8,10252214,chr19-10206539-G-A,rs17291414,1,G,A,10206539,45675,10055606,10448822,150933
19,ENSG00000105146.7,57231023,chr19-57111915-G-T,rs17305542,1,G,T,57111915,119108,57034415,57427631,77500
19,ENSG00000130299.10,17337553,chr19-17173636-T-C,rs17534314,1,T,C,17173636,163917,17140945,17534161,32691
19,ENSG00000189114.5,45178784,chr19-45103881-G-A,rs17562787,1,G,A,45103881,74903,44982176,45375392,121705
19,ENSG00000099822.1,589881,chr19-760948-A-G,rs17604253,1,A,G,760948,171067,393273,786489,367675
19,ENSG00000167685.8,56141287,chr19-56011557-C-T,rs17608620,1,C,T,56011557,129730,55944679,56337895,66878
19,ENSG00000174837.8,6887579,chr19-6951556-A-G,rs17704999,1,A,G,6951556,63977,6690971,7084187,260585
19,ENSG00000127616.9,10961030,chr19-10948504-C-T,rs17842117,1,C,T,10948504,12526,10764422,11157638,184082
19,ENSG00000096996.9,18086934,chr19-18062031-A-G,rs17878533,-1,A,G,18062031,24903,17890326,18283542,171705
19,ENSG00000096996.9,18086934,chr19-18062031-A-C,rs17878533,-1,A,C,18062031,24903,17890326,18283542,171705
19,ENSG00000087088.14,48954875,chr19-49097335-G-A,rs1806713,1,G,A,49097335,142460,48758267,49151483,339068
19,ENSG00000161091.7,3557586,chr19-3481580-T-C,rs1860192,-1,T,C,3481580,76006,3360978,3754194,120602
19,ENSG00000076924.6,7629545,chr19-7633434-C-T,rs1862514,-1,C,T,7633434,3889,7432937,7826153,200497
19,ENSG00000197857.7,12294883,chr19-12111566-C-G,rs1866382,-1,C,G,12111566,183317,12098275,12491491,13291
19,ENSG00000123815.6,40716886,chr19-40750614-T-G,rs1870086,-1,T,G,40750614,33728,40520278,40913494,230336
19,ENSG00000126266.2,35351552,chr19-35332532-G-T,rs1894310,1,G,T,35332532,19020,35154944,35548160,177588
19,ENSG00000105656.4,18522070,chr19-18402784-T-C,rs1985157,-1,T,C,18402784,119286,18325462,18718678,77322
19,ENSG00000142279.6,34481758,chr19-34471156-G-C,rs1990972,1,G,C,34471156,10602,34285150,34678366,186006
19,ENSG00000220008.1,2292024,chr19-2477279-C-T,rs2024144,-1,C,T,2477279,185255,2095416,2488632,381863
19,ENSG00000105053.5,50025372,chr19-50009349-G-A,rs2033262,-1,G,A,50009349,16023,49828764,50221980,180585
19,ENSG00000142556.13,52028379,chr19-52179259-A-G,rs2059810,-1,A,G,52179259,150880,51831771,52224987,347488
19,ENSG00000120784.9,37655465,chr19-37793150-G-A,rs2075283,-1,G,A,37793150,137685,37458857,37852073,334293
19,ENSG00000167658.9,3985463,chr19-4042925-A-G,rs2121137,-1,A,G,4042925,57462,3788855,4182071,254070
19,ENSG00000131355.9,14674844,chr19-14629631-T-C,rs2126979,-1,T,C,14629631,45213,14478236,14871452,151395
19,ENSG00000077463.9,4182563,chr19-4186398-T-G,rs2159983,-1,T,G,4186398,3835,3985955,4379171,200443
19,ENSG00000160111.6,17026810,chr19-16890740-G-A,rs2227349,-1,G,A,16890740,136070,16830202,17223418,60538
19,ENSG00000251369.2,57559863,chr19-57444351-G-A,rs2240037,-1,G,A,57444351,115512,57363255,57756471,81096
19,ENSG00000064932.9,1174268,chr19-1366546-G-A,rs2240241,-1,G,A,1366546,192278,977660,1370876,388886
19,ENSG00000007264.8,3786381,chr19-3621722-G-A,rs2240505,-1,G,A,3621722,164659,3589773,3982989,31949
19,ENSG00000142541.10,49487608,chr19-49487409-A-C,rs2271953,1,A,C,49487409,199,49291000,49684216,196409
19,ENSG00000099331.7,17075777,chr19-17185870-G-A,rs2279004,1,G,A,17185870,110093,16879169,17272385,306701
19,ENSG00000121406.3,57527356,chr19-57608396-C-T,rs2285669,1,C,T,57608396,81040,57330748,57723964,277648
19,ENSG00000121406.3,57527356,chr19-57608396-C-G,rs2285669,1,C,G,57608396,81040,57330748,57723964,277648
19,ENSG00000104960.10,49851159,chr19-49813497-C-T,rs2286948,1,C,T,49813497,37662,49654551,50047767,158946
19,ENSG00000178078.5,4338827,chr19-4284600-A-C,rs2287713,-1,A,C,4284600,54227,4142219,4535435,142381
19,ENSG00000198258.5,9827918,chr19-9973616-C-G,rs2287813,1,C,G,9973616,145698,9631310,10024526,342306
19,ENSG00000198258.5,9827918,chr19-9973616-C-T,rs2287813,1,C,T,9973616,145698,9631310,10024526,342306
19,ENSG00000063244.6,55655035,chr19-55461583-T-G,rs2303088,1,T,G,55461583,193452,55458427,55851643,3156
19,ENSG00000167460.9,16076495,chr19-16086567-C-T,rs2303150,1,C,T,16086567,10072,15879887,16273103,206680
19,ENSG00000186010.9,19516225,chr19-19546334-C-T,rs2304097,1,C,T,19546334,30109,19319617,19712833,226717
19,ENSG00000123810.2,41364149,chr19-41539214-T-C,rs2317313,-1,T,C,41539214,175065,41167541,41560757,371673
19,ENSG00000105258.3,36114875,chr19-36221754-C-T,rs2432045,-1,C,T,36221754,106879,35918267,36311483,303487
19,ENSG00000167671.6,4457794,chr19-4442532-T-C,rs243382,-1,T,C,4442532,15262,4261186,4654402,181346
19,ENSG00000198521.5,21836182,chr19-21836895-A-G,rs2435048,-1,A,G,21836895,713,21639574,22032790,197321
19,ENSG00000181894.9,58150789,chr19-58197140-C-T,rs2445857,-1,C,T,58197140,46351,57954181,58347397,242959
19,ENSG00000160953.8,1354959,chr19-1476433-C-T,rs2456163,1,C,T,1476433,121474,1158351,1551567,318082
19,ENSG00000062370.9,44356680,chr19-44497294-A-G,rs2571108,-1,A,G,44497294,140614,44160072,44553288,337222
19,ENSG00000182318.4,58326994,chr19-58278729-T-C,rs260503,1,T,C,58278729,48265,58130386,58523602,148343
19,ENSG00000126246.4,35742452,chr19-35795632-C-T,rs2619200,-1,C,T,35795632,53180,35545844,35939060,249788
19,ENSG00000072954.1,16661139,chr19-16691198-T-C,rs2633339,1,T,C,16691198,30059,16464531,16857747,226667
19,ENSG00000105447.7,48445983,chr19-48584410-T-C,rs2665582,1,T,C,48584410,138427,48249375,48642591,335035
19,ENSG00000022556.10,54966374,chr19-54970301-T-C,rs269913,1,T,C,54970301,3927,54769766,55162982,200535
19,ENSG00000127666.7,4831712,chr19-4841139-A-G,rs2779180,-1,A,G,4841139,9427,4635104,5028320,206035
19,ENSG00000176920.10,48695971,chr19-48714004-A-G,rs281385,1,A,G,48714004,18033,48499363,48892579,214641
19,ENSG00000063180.3,48646187,chr19-48661695-A-G,rs281392,-1,A,G,48661695,15508,48449579,48842795,212116
19,ENSG00000065989.9,10420538,chr19-10308108-A-G,rs281416,1,A,G,10308108,112430,10223930,10617146,84178
19,ENSG00000105612.3,12881449,chr19-12938601-C-T,rs28365950,-1,C,T,12938601,57152,12684841,13078057,253760
19,ENSG00000129968.10,1885496,chr19-1806464-G-A,rs28397595,-1,G,A,1806464,79032,1688888,2082104,117576
19,ENSG00000077348.3,41397359,chr19-41422796-C-T,rs284653,-1,C,T,41422796,25437,41200751,41593967,222045
19,ENSG00000176472.5,43533188,chr19-43570060-A-T,rs2854510,1,A,T,43570060,36872,43336580,43729796,233480
19,ENSG00000176472.5,43533188,chr19-43570060-A-G,rs2854510,1,A,G,43570060,36872,43336580,43729796,233480
19,ENSG00000153885.7,33796870,chr19-33762494-G-A,rs285689,1,G,A,33762494,34376,33600262,33993478,162232
19,ENSG00000197044.6,11767000,chr19-11678744-G-A,rs286293,1,G,A,11678744,88256,11570392,11963608,108352
19,ENSG00000173809.11,32719753,chr19-32754972-C-T,rs2868186,1,C,T,32754972,35219,32523145,32916361,231827
19,ENSG00000141965.3,4791734,chr19-4772437-C-T,rs2885717,1,C,T,4772437,19297,4595126,4988342,177311
19,ENSG00000121289.11,32971958,chr19-32953550-A-G,rs2944021,-1,A,G,32953550,18408,32775350,33168566,178200
19,ENSG00000179115.5,12933711,chr19-12960268-G-A,rs2965216,-1,G,A,12960268,26557,12737103,13130319,223165
19,ENSG00000167815.7,12801800,chr19-12960268-G-A,rs2965216,-1,G,A,12960268,158468,12605192,12998408,355076
19,ENSG00000197766.1,859664,chr19-896506-A-G,rs2965285,1,A,G,896506,36842,663056,1056272,233450
19,ENSG00000189042.7,36687612,chr19-36536315-A-G,rs2967465,1,A,G,36536315,151297,36491004,36884220,45311
19,ENSG00000167785.3,8832304,chr19-8809491-G-T,rs2967745,-1,G,T,8809491,22813,8635696,9028912,173795
19,ENSG00000069399.7,44748708,chr19-44814896-G-T,rs2968180,1,G,T,44814896,66188,44552100,44945316,262796
19,ENSG00000104907.7,13116740,chr19-12951169-C-T,rs2974754,-1,C,T,12951169,165571,12920132,13313348,31037
19,ENSG00000060558.2,3136033,chr19-3098247-A-G,rs308037,1,A,G,3098247,37786,2939425,3332641,158822
19,ENSG00000105371.7,10286955,chr19-10286727-C-T,rs3093030,1,C,T,10286727,228,10090347,10483563,196380
19,ENSG00000198464.7,52297169,chr19-52305733-A-G,rs321913,1,A,G,52305733,8564,52100561,52493777,205172
19,ENSG00000196214.5,52269587,chr19-52334684-C-T,rs321921,1,C,T,52334684,65097,52072979,52466195,261705
19,ENSG00000127220.3,17303425,chr19-17276367-A-G,rs34084277,-1,A,G,17276367,27058,17106817,17500033,169550
19,ENSG00000130175.4,11435635,chr19-11432642-T-C,rs34088,1,T,C,11432642,2993,11239027,11632243,193615
19,ENSG00000167772.6,8364155,chr19-8438461-G-C,rs34099346,1,G,C,8438461,74306,8167547,8560763,270914
19,ENSG00000167772.6,8364155,chr19-8438461-G-A,rs34099346,1,G,A,8438461,74306,8167547,8560763,270914
19,ENSG00000187650.2,5904872,chr19-5940334-G-A,rs34185207,1,G,A,5940334,35462,5708264,6101480,232070
19,ENSG00000197213.3,56197920,chr19-56222056-C-A,rs34187696,-1,C,A,56222056,24136,56001312,56394528,220744
19,ENSG00000105325.8,3506311,chr19-3603229-C-T,rs34620121,1,C,T,3603229,96918,3309703,3702919,293526
19,ENSG00000105711.5,35030470,chr19-34958582-T-C,rs34687332,1,T,C,34958582,71888,34833862,35227078,124720
19,ENSG00000130545.10,6464271,chr19-6461705-G-T,rs348357,1,G,T,6461705,2566,6267663,6660879,194042
19,ENSG00000104833.4,6502309,chr19-6461705-G-T,rs348357,-1,G,T,6461705,40604,6305701,6698917,156004
19,ENSG00000125648.8,6459792,chr19-6461705-G-T,rs348357,-1,G,T,6461705,1913,6263184,6656400,198521
19,ENSG00000181240.8,6433763,chr19-6455403-A-T,rs348365,-1,A,T,6455403,21640,6237155,6630371,218248
19,ENSG00000181240.8,6433763,chr19-6455403-A-G,rs348365,-1,A,G,6455403,21640,6237155,6630371,218248
19,ENSG00000011422.6,43670169,chr19-43795740-T-C,rs349045,-1,T,C,43795740,125571,43473561,43866777,322179
19,ENSG00000130724.3,58555105,chr19-58516795-G-C,rs35430780,-1,G,C,58516795,38310,58358497,58751713,158298
19,ENSG00000176490.3,2721372,chr19-2722052-C-A,rs35558603,-1,C,A,2722052,680,2524764,2917980,197288
19,ENSG00000176490.3,2721372,chr19-2722052-C-T,rs35558603,-1,C,T,2722052,680,2524764,2917980,197288
19,ENSG00000132016.6,13906117,chr19-13856728-C-T,rs35647811,-1,C,T,13856728,49389,13709509,14102725,147219
19,ENSG00000249709.1,12551482,chr19-12410890-C-T,rs36058989,-1,C,T,12410890,140592,12354874,12748090,56016
19,ENSG00000087086.7,48965309,chr19-49155618-T-G,rs3745300,1,T,G,49155618,190309,48768701,49161917,386917
19,ENSG00000126464.7,49591182,chr19-49653072-A-G,rs3745470,1,A,G,49653072,61890,49394574,49787790,258498
19,ENSG00000130810.14,10106362,chr19-10113850-C-T,rs3745600,1,C,T,10113850,7488,9909754,10302970,204096
19,ENSG00000181666.11,37334649,chr19-37363678-C-T,rs3745764,1,C,T,37363678,29029,37138041,37531257,225637
19,ENSG00000099804.2,531760,chr19-511453-A-G,rs3745924,1,A,G,511453,20307,335152,728368,176301
19,ENSG00000130758.2,40191426,chr19-40213503-C-T,rs3746006,1,C,T,40213503,22077,39994818,40388034,218685
19,ENSG00000006638.6,3606875,chr19-3618930-G-A,rs3746125,-1,G,A,3618930,12055,3410267,3803483,208663
19,ENSG00000160961.6,14690048,chr19-14717925-G-A,rs3752185,1,G,A,14717925,27877,14493440,14886656,224485
19,ENSG00000160961.6,14690048,chr19-14717925-G-T,rs3752185,1,G,T,14717925,27877,14493440,14886656,224485
19,ENSG00000099817.6,1095375,chr19-1041353-A-G,rs3752229,-1,A,G,1041353,54022,898767,1291983,142586
19,ENSG00000104870.6,49512661,chr19-49453433-C-T,rs3760670,1,C,T,49453433,59228,49316053,49709269,137380
19,ENSG00000142534.1,49496434,chr19-49581115-C-A,rs3760706,1,C,A,49581115,84681,49299826,49693042,281289
19,ENSG00000125910.3,3178769,chr19-3176172-A-G,rs3760960,1,A,G,3176172,2597,2982161,3375377,194011
19,ENSG00000187912.7,14583084,chr19-14447009-A-G,rs3786654,1,A,G,14447009,136075,14386476,14779692,60533
19,ENSG00000099338.14,38335830,chr19-38267150-A-G,rs3786873,1,A,G,38267150,68680,38139222,38532438,127928
19,ENSG00000166704.7,58002820,chr19-57972341-A-G,rs3810128,-1,A,G,57972341,30479,57806212,58199428,166129
19,ENSG00000130312.1,17305872,chr19-17339207-T-C,rs3810206,1,T,C,17339207,33335,17109264,17502480,229943
19,ENSG00000167414.3,46636202,chr19-46635389-G-T,rs3810295,-1,G,T,46635389,813,46439594,46832810,195795
19,ENSG00000125746.8,45639397,chr19-45621259-C-T,rs3816045,-1,C,T,45621259,18138,45442789,45836005,178470
19,ENSG00000105568.11,52190052,chr19-52206739-G-T,rs3826653,1,G,T,52206739,16687,51993444,52386660,213295
19,ENSG00000083807.4,58511992,chr19-58407433-C-T,rs3826680,-1,C,T,58407433,104559,58315384,58708600,92049
19,ENSG00000105668.2,35666516,chr19-35734719-G-A,rs3848663,1,G,A,35734719,68203,35469908,35863124,264811
19,ENSG00000104884.9,45370573,chr19-45356900-G-A,rs3916856,-1,G,A,45356900,13673,45173965,45567181,182935
19,ENSG00000204920.4,43984188,chr19-43983933-A-G,rs397706,1,A,G,43983933,255,43787580,44180796,196353
19,ENSG00000099821.6,633537,chr19-624405-G-A,rs41558812,-1,G,A,624405,9132,436929,830145,187476
19,ENSG00000018869.10,56393534,chr19-56575446-C-T,rs4239476,-1,C,T,56575446,181912,56196926,56590142,378520
19,ENSG00000130475.9,17751477,chr19-17767913-A-G,rs4239635,1,A,G,17767913,16436,17554869,17948085,213044
19,ENSG00000104783.5,43780973,chr19-43659703-C-T,rs4251856,-1,C,T,43659703,121270,43584365,43977581,75338
19,ENSG00000182013.11,46471563,chr19-46428805-A-G,rs427250,-1,A,G,46428805,42758,46274955,46668171,153850
19,ENSG00000167637.11,43827321,chr19-43891337-G-A,rs429027,1,G,A,43891337,64016,43630713,44023929,260624
19,ENSG00000167380.11,44165100,chr19-44094715-T-G,rs4429390,1,T,G,44094715,70385,43968492,44361708,126223
19,ENSG00000132002.2,14518397,chr19-14481942-G-A,rs4461186,-1,G,A,14481942,36455,14321789,14715005,160153
19,ENSG00000188171.8,20661571,chr19-20621885-T-C,rs4483974,-1,T,C,20621885,39686,20464963,20858179,156922
19,ENSG00000105176.12,29942239,chr19-30108876-G-A,rs454282,1,G,A,30108876,166637,29745631,30138847,363245
19,ENSG00000104885.9,2163933,chr19-2098064-A-T,rs45506200,1,A,T,2098064,65869,1967325,2360541,130739
19,ENSG00000224420.2,49689594,chr19-49690180-C-A,rs45613034,1,C,A,49690180,586,49492986,49886202,197194
19,ENSG00000105227.8,40413378,chr19-40428074-C-G,rs4622626,-1,C,G,40428074,14696,40216770,40609986,211304
19,ENSG00000121410.6,58353492,chr19-58360360-C-A,rs4801266,-1,C,A,58360360,6868,58156884,58550100,203476
19,ENSG00000249471.2,58451622,chr19-58488906-A-G,rs4801273,1,A,G,58488906,37284,58255014,58648230,233892
19,ENSG00000105427.4,42390297,chr19-42500246-T-C,rs4802138,-1,T,C,42500246,109949,42193689,42586905,306557
19,ENSG00000099337.2,38319845,chr19-38358156-A-G,rs4802351,1,A,G,38358156,38311,38123237,38516453,234919
19,ENSG00000161609.4,49388249,chr19-49368828-G-A,rs4802597,1,G,A,49368828,19421,49191641,49584857,177187
19,ENSG00000167748.5,50823787,chr19-50800047-A-C,rs4802742,-1,A,C,50800047,23740,50627179,51020395,172868
19,ENSG00000182310.7,51693330,chr19-51623881-C-T,rs4802831,1,C,T,51623881,69449,51496722,51889938,127159
19,ENSG00000197937.5,53159053,chr19-53168784-T-C,rs4803055,-1,T,C,53168784,9731,52962445,53355661,206339
19,ENSG00000248098.2,41397818,chr19-41412149-G-A,rs4803464,1,G,A,41412149,14331,41201210,41594426,210939
19,ENSG00000105341.11,41439912,chr19-41412149-G-A,rs4803464,-1,G,A,41412149,27763,41243304,41636520,168845
19,ENSG00000176531.5,43504746,chr19-43524879-G-C,rs4803640,-1,G,C,43524879,20133,43308138,43701354,216741
19,ENSG00000167642.6,38264573,chr19-38237000-A-T,rs4803899,1,A,T,38237000,27573,38067965,38461181,169035
19,ENSG00000257704.1,47274885,chr19-47284247-G-A,rs4804044,1,G,A,47284247,9362,47078277,47471493,205970
19,ENSG00000257704.1,47274885,chr19-47284247-G-C,rs4804044,1,G,C,47284247,9362,47078277,47471493,205970
19,ENSG00000171017.5,7888510,chr19-7718688-G-T,rs4804227,1,G,T,7718688,169822,7691902,8085118,26786
19,ENSG00000130811.5,10119899,chr19-9931200-A-G,rs4804476,-1,A,G,9931200,188699,9923291,10316507,7909
19,ENSG00000132004.7,12696631,chr19-12536469-G-A,rs4804716,-1,G,A,12536469,160162,12500023,12893239,36446
19,ENSG00000095932.4,3480525,chr19-3487535-T-C,rs4806939,-1,T,C,3487535,7010,3283917,3677133,203618
19,ENSG00000099860.3,2476127,chr19-2313801-G-A,rs4807223,1,G,A,2313801,162326,2279519,2672735,34282
19,ENSG00000105426.8,5340812,chr19-5289511-A-G,rs4807709,-1,A,G,5289511,51301,5144204,5537420,145307
19,ENSG00000105135.9,15125786,chr19-15072820-A-G,rs4808189,-1,A,G,15072820,52966,14929178,15322394,143642
19,ENSG00000130304.10,17470524,chr19-17484891-A-G,rs4808652,1,A,G,17484891,14367,17273916,17667132,210975
19,ENSG00000130309.4,17555649,chr19-17557324-C-T,rs4808666,1,C,T,17557324,1675,17359041,17752257,198283
19,ENSG00000074181.2,15200995,chr19-15270061-T-C,rs4809125,-1,T,C,15270061,69066,15004387,15397603,265674
19,ENSG00000171606.12,58183061,chr19-58233567-G-A,rs48524,1,G,A,58233567,50506,57986453,58379669,247114
19,ENSG00000087076.3,48836491,chr19-48875737-A-G,rs500079,-1,A,G,48875737,39246,48639883,49033099,235854
19,ENSG00000006712.9,39391106,chr19-39397809-C-T,rs519575,-1,C,T,39397809,6703,39194498,39587714,203311
19,ENSG00000060566.7,4153631,chr19-4330639-T-C,rs56083157,1,T,C,4330639,177008,3957023,4350239,373616
19,ENSG00000118162.8,47484219,chr19-47545258-T-C,rs56162770,-1,T,C,47545258,61039,47287611,47680827,257647
19,ENSG00000105699.9,35249002,chr19-35228035-C-T,rs564117,1,C,T,35228035,20967,35052394,35445610,175641
19,ENSG00000088256.3,3094362,chr19-3177281-C-T,rs567806,1,C,T,3177281,82919,2897754,3290970,279527
19,ENSG00000131408.7,50376457,chr19-50435226-G-A,rs57092106,1,G,A,50435226,58769,50179849,50573065,255377
19,ENSG00000133243.3,2015714,chr19-2007912-C-T,rs57274573,-1,C,T,2007912,7802,1819106,2212322,188806
19,ENSG00000160013.3,46625089,chr19-46492517-C-T,rs57318042,-1,C,T,46492517,132572,46428481,46821697,64036
19,ENSG00000179909.9,57709204,chr19-57746021-G-T,rs57990162,-1,G,T,57746021,36817,57512596,57905812,233425
19,ENSG00000083828.8,57769676,chr19-57740100-G-A,rs58789890,1,G,A,57740100,29576,57573068,57966284,167032
19,ENSG00000132003.4,13795443,chr19-13850312-G-T,rs59136837,1,G,T,13850312,54869,13598835,13992051,251477
19,ENSG00000032444.9,7535717,chr19-7554443-G-A,rs598023,1,G,A,7554443,18726,7339109,7732325,215334
19,ENSG00000104886.3,2236329,chr19-2385393-G-A,rs60235468,-1,G,A,2385393,149064,2039721,2432937,345672
19,ENSG00000256683.1,51986840,chr19-52067333-C-T,rs61742061,-1,C,T,52067333,80493,51790232,52183448,277101
19,ENSG00000105583.4,12669415,chr19-12669365-G-A,rs62108388,-1,G,A,12669365,50,12472807,12866023,196558
19,ENSG00000142065.7,36379201,chr19-36258657-G-A,rs62113151,-1,G,A,36258657,120544,36182593,36575809,76064
19,ENSG00000160117.8,17281901,chr19-17332474-G-A,rs62128106,1,G,A,17332474,50573,17085293,17478509,247181
19,ENSG00000104805.10,48900312,chr19-48872419-T-C,rs638050,1,T,C,48872419,27893,48703704,49096920,168715
19,ENSG00000090932.5,39498947,chr19-39435961-C-T,rs640000,1,C,T,39435961,62986,39302339,39695555,133622
19,ENSG00000213015.3,55641002,chr19-55636562-G-C,rs644230,1,G,C,55636562,4440,55444394,55837610,192168
19,ENSG00000104824.8,38849986,chr19-38990844-T-C,rs649150,-1,T,C,38990844,140858,38653378,39046594,337466
19,ENSG00000063322.6,39391378,chr19-39217471-A-G,rs6508849,1,A,G,39217471,173907,39194770,39587986,22701
19,ENSG00000125753.8,45507479,chr19-45478557-G-T,rs6509214,1,G,T,45478557,28922,45310871,45704087,167686
19,ENSG00000125753.8,45507479,chr19-45478557-G-C,rs6509214,1,G,C,45478557,28922,45310871,45704087,167686
19,ENSG00000126460.5,49581316,chr19-49516906-C-T,rs6509434,1,C,T,49516906,64410,49384708,49777924,132198
19,ENSG00000167634.6,54947505,chr19-55051034-A-G,rs6509916,-1,A,G,55051034,103529,54750897,55144113,300137
19,ENSG00000218891.1,55580848,chr19-55567356-C-T,rs6509945,-1,C,T,55567356,13492,55384240,55777456,183116
19,ENSG00000012124.9,35329187,chr19-35293263-A-G,rs6510476,1,A,G,35293263,35924,35132579,35525795,160684
19,ENSG00000167595.8,35758153,chr19-35647577-A-G,rs6510502,1,A,G,35647577,110576,35561545,35954761,86032
19,ENSG00000167595.8,35758153,chr19-35647577-A-C,rs6510502,1,A,C,35647577,110576,35561545,35954761,86032
19,ENSG00000205138.2,35995188,chr19-36061179-C-T,rs6510516,1,C,T,36061179,65991,35798580,36191796,262599
19,ENSG00000104953.11,2977564,chr19-2989699-T-C,rs6510730,1,T,C,2989699,12135,2780956,3174172,208743
19,ENSG00000105518.7,11346268,chr19-11235576-A-C,rs6511729,-1,A,C,11235576,110692,11149660,11542876,85916
19,ENSG00000053501.7,17215357,chr19-17135122-G-A,rs6512171,1,G,A,17135122,80235,17018749,17411965,116373
19,ENSG00000161914.3,11505839,chr19-11500344-C-T,rs657435,-1,C,T,11500344,5495,11309231,11702447,191113
19,ENSG00000142347.9,8577442,chr19-8403267-C-T,rs6603065,-1,C,T,8403267,174175,8380834,8774050,22433
19,ENSG00000131848.4,56314839,chr19-56139954-G-A,rs669866,-1,G,A,56139954,174885,56118231,56511447,21723
19,ENSG00000131398.8,50329377,chr19-50362278-A-G,rs676314,-1,A,G,50362278,32901,50132769,50525985,229509
19,ENSG00000130669.11,39125802,chr19-39132206-C-T,rs692191,1,C,T,39132206,6404,38929194,39322410,203012
19,ENSG00000170909.9,54100803,chr19-53993315-G-A,rs71365417,-1,G,A,53993315,107488,53904195,54297411,89120
19,ENSG00000095066.6,12775552,chr19-12700231-T-C,rs722572,-1,T,C,12700231,75321,12578944,12972160,121287
19,ENSG00000142039.2,41310172,chr19-41304739-A-G,rs7245398,1,A,G,41304739,5433,41113564,41506780,191175
19,ENSG00000175691.6,2944971,chr19-2923162-A-G,rs7248226,-1,A,G,2923162,21809,2748363,3141579,174799
19,ENSG00000178982.4,38619188,chr19-38767337-A-T,rs7248248,1,A,T,38767337,148149,38422580,38815796,344757
19,ENSG00000086544.1,40717112,chr19-40734407-G-A,rs7248468,1,G,A,40734407,17295,40520504,40913720,213903
19,ENSG00000142528.10,50026005,chr19-50024739-C-T,rs7249945,1,C,T,50024739,1266,49829397,50222613,195342
19,ENSG00000188785.6,57389854,chr19-57349717-T-C,rs7250371,1,T,C,57349717,40137,57193246,57586462,156471
19,ENSG00000130479.5,17719480,chr19-17546866-G-A,rs7250417,1,G,A,17546866,172614,17522872,17916088,23994
19,ENSG00000105185.5,32581190,chr19-32668135-A-G,rs7251263,1,A,G,32668135,86945,32384582,32777798,283553
19,ENSG00000105695.8,35292161,chr19-35284538-A-G,rs7251432,1,A,G,35284538,7623,35095553,35488769,188985
19,ENSG00000142512.9,51417642,chr19-51594208-A-C,rs7252645,-1,A,C,51594208,176566,51221034,51614250,373174
19,ENSG00000153879.2,33373709,chr19-33330342-T-G,rs7253865,1,T,G,33330342,43367,33177101,33570317,153241
19,ENSG00000196605.2,9768617,chr19-9584332-A-G,rs7253981,-1,A,G,9584332,184285,9572009,9965225,12323
19,ENSG00000171469.6,9621232,chr19-9584332-A-G,rs7253981,-1,A,G,9584332,36900,9424624,9817840,159708
19,ENSG00000178386.6,44052036,chr19-44060954-G-T,rs7254182,1,G,T,44060954,8918,43855428,44248644,205526
19,ENSG00000089351.7,35000323,chr19-35084260-C-T,rs7254457,1,C,T,35084260,83937,34803715,35196931,280545
19,ENSG00000243207.2,10106395,chr19-10084208-C-T,rs7255032,1,C,T,10084208,22187,9909787,10303003,174421
19,ENSG00000131941.2,33064888,chr19-33197589-C-T,rs7255462,-1,C,T,33197589,132701,32868280,33261496,329309
19,ENSG00000006015.12,18588798,chr19-18710354-C-T,rs7256552,1,C,T,18710354,121556,18392190,18785406,318164
19,ENSG00000169021.3,29213151,chr19-29089466-G-A,rs7257556,-1,G,A,29089466,123685,29016543,29409759,72923
19,ENSG00000160113.3,17245919,chr19-17229591-C-T,rs7258100,-1,C,T,17229591,16328,17049311,17442527,180280
19,ENSG00000125755.11,45863147,chr19-45853290-T-C,rs7258364,-1,T,C,45853290,9857,45666539,46059755,186751
19,ENSG00000070423.10,663214,chr19-728476-G-T,rs7258499,-1,G,T,728476,65262,466606,859822,261870
19,ENSG00000175489.6,18397622,chr19-18414891-A-T,rs7258891,-1,A,T,18414891,17269,18201014,18594230,213877
19,ENSG00000172270.12,572596,chr19-565641-T-C,rs72972167,1,T,C,565641,6955,375988,769204,189653
19,ENSG00000099875.8,2051244,chr19-2217204-G-A,rs72985483,-1,G,A,2217204,165960,1854636,2247852,362568
19,ENSG00000198429.5,11887782,chr19-11985493-A-G,rs72988696,1,A,G,11985493,97711,11691174,12084390,294319
19,ENSG00000127540.4,1605462,chr19-1579618-C-T,rs72989710,-1,C,T,1579618,25844,1408854,1802070,170764
19,ENSG00000104880.11,7348937,chr19-7423875-T-C,rs72994557,1,T,C,7423875,74938,7152329,7545545,271546
19,ENSG00000181896.6,19668839,chr19-19547423-C-A,rs73004906,1,C,A,19547423,121416,19472231,19865447,75192
19,ENSG00000188051.5,17448668,chr19-17401653-A-G,rs73018431,-1,A,G,17401653,47015,17252060,17645276,149593
19,ENSG00000186567.7,44671482,chr19-44477583-T-C,rs73036497,1,T,C,44477583,193899,44474874,44868090,2709
19,ENSG00000187902.6,55443300,chr19-55478213-G-A,rs73057168,-1,G,A,55478213,34913,55246692,55639908,231521
19,ENSG00000178229.6,57320472,chr19-57433318-C-T,rs73065212,1,C,T,57433318,112846,57123864,57517080,309454
19,ENSG00000171574.11,58408649,chr19-58527517-G-T,rs73066245,1,G,T,58527517,118868,58212041,58605257,315476
19,ENSG00000118160.7,47471893,chr19-47318117-C-T,rs73554060,-1,C,T,47318117,153776,47275285,47668501,42832
19,ENSG00000086967.8,50432892,chr19-50467752-C-A,rs736769,1,C,A,50467752,34860,50236284,50629500,231468
19,ENSG00000130477.9,17688354,chr19-17602165-C-T,rs73922140,-1,C,T,17602165,86189,17491746,17884962,110419
19,ENSG00000189013.8,54803611,chr19-54881501-T-G,rs73932253,1,T,G,54881501,77890,54607003,55000219,274498
19,ENSG00000104825.12,38899969,chr19-38801051-A-G,rs73933058,1,A,G,38801051,98918,38703361,39096577,97690
19,ENSG00000178297.7,2389761,chr19-2430234-T-C,rs743578,1,T,C,2430234,40473,2193153,2586369,237081
19,ENSG00000160888.5,13150411,chr19-13001323-G-A,rs74551279,1,G,A,13001323,149088,12953803,13347019,47520
19,ENSG00000196724.6,57935402,chr19-57844874-A-G,rs74643639,-1,A,G,57844874,90528,57738794,58132010,106080
19,ENSG00000105193.3,39435949,chr19-39434416-A-G,rs74712803,-1,A,G,39434416,1533,39239341,39632557,195075
19,ENSG00000223802.2,18896158,chr19-18762771-C-T,rs74736618,-1,C,T,18762771,133387,18699550,19092766,63221
19,ENSG00000221923.3,52369923,chr19-52377746-G-C,rs74760116,1,G,C,52377746,7823,52173315,52566531,204431
19,ENSG00000221923.3,52369923,chr19-52377746-G-T,rs74760116,1,G,T,52377746,7823,52173315,52566531,204431
19,ENSG00000121413.7,58098231,chr19-58285848-G-C,rs74771247,-1,G,C,58285848,187617,57901623,58294839,384225
19,ENSG00000099864.10,708935,chr19-729850-G-A,rs74812357,1,G,A,729850,20915,512327,905543,217523
19,ENSG00000099864.10,708935,chr19-729850-G-T,rs74812357,1,G,T,729850,20915,512327,905543,217523
19,ENSG00000132017.5,13952509,chr19-13849748-T-C,rs7507168,1,T,C,13849748,102761,13755901,14149117,93847
19,ENSG00000183647.5,57599885,chr19-57684839-G-A,rs752150,1,G,A,57684839,84954,57403277,57796493,281562
19,ENSG00000187187.7,39997060,chr19-39867023-C-T,rs75241092,1,C,T,39867023,130037,39800452,40193668,66571
19,ENSG00000197256.5,11197545,chr19-11194569-T-C,rs754528,-1,T,C,11194569,2976,11000937,11394153,193632
19,ENSG00000099785.5,8413305,chr19-8394076-C-T,rs754671,1,C,T,8394076,19229,8216697,8609913,177379
19,ENSG00000168813.9,32345610,chr19-32280056-G-A,rs75471356,1,G,A,32280056,65554,32149002,32542218,131054
19,ENSG00000179873.8,55831994,chr19-55738079-A-G,rs755804,-1,A,G,55738079,93915,55635386,56028602,102693
19,ENSG00000130270.8,1812276,chr19-1811409-C-T,rs75759084,-1,C,T,1811409,867,1615668,2008884,195741
19,ENSG00000213889.5,45498443,chr19-45509757-A-G,rs758761,1,A,G,45509757,11314,45301835,45695051,207922
19,ENSG00000104812.8,48993309,chr19-49105783-C-T,rs76688659,-1,C,T,49105783,112474,48796701,49189917,309082
19,ENSG00000130377.8,6135667,chr19-6148777-C-T,rs76790614,1,C,T,6148777,13110,5939059,6332275,209718
19,ENSG00000105404.5,41959321,chr19-41849368-T-C,rs76856583,-1,T,C,41849368,109953,41762713,42155929,86655
19,ENSG00000104853.9,44955380,chr19-44906745-G-A,rs769449,1,G,A,44906745,48635,44758772,45151988,147973
19,ENSG00000196684.6,16143685,chr19-16070626-C-T,rs77830959,1,C,T,16070626,73059,15947077,16340293,123549
19,ENSG00000181588.12,1568325,chr19-1673757-C-T,rs78522833,-1,C,T,1673757,105432,1371717,1764933,302040
19,ENSG00000104983.3,45995467,chr19-45935930-C-T,rs78558452,1,C,T,45935930,59537,45798859,46192075,137071
19,ENSG00000065000.9,2151566,chr19-2173105-C-T,rs78591932,-1,C,T,2173105,21539,1954958,2348174,218147
19,ENSG00000160570.8,42217677,chr19-42091904-T-C,rs78816499,-1,T,C,42091904,125773,42021069,42414285,70835
19,ENSG00000257446.1,12052961,chr19-11978889-G-A,rs79043756,-1,G,A,11978889,74072,11856353,12249569,122536
19,ENSG00000130382.6,6279975,chr19-6227568-G-A,rs79422852,-1,G,A,6227568,52407,6083367,6476583,144201
19,ENSG00000105519.5,5914254,chr19-5900460-C-T,rs79569934,1,C,T,5900460,13794,5717646,6110862,182814
19,ENSG00000176222.6,43883964,chr19-43962052-T-A,rs8099924,-1,T,A,43962052,78088,43687356,44080572,274696
19,ENSG00000161277.6,36054285,chr19-36194788-T-C,rs8102020,-1,T,C,36194788,140503,35857677,36250893,337111
19,ENSG00000090372.7,46746450,chr19-46784893-C-A,rs8105903,-1,C,A,46784893,38443,46549842,46943058,235051
19,ENSG00000126247.4,36140066,chr19-35968334-T-C,rs8105993,1,T,C,35968334,171732,35943458,36336674,24876
19,ENSG00000125656.3,6361531,chr19-6378637-G-C,rs8106382,1,G,C,6378637,17106,6164923,6558139,213714
19,ENSG00000129990.8,55180289,chr19-55162756-T-C,rs8107736,-1,T,C,55162756,17533,54983681,55376897,179075
19,ENSG00000156413.7,5839702,chr19-5785801-G-A,rs8107987,-1,G,A,5785801,53901,5643094,6036310,142707
19,ENSG00000105499.8,48110817,chr19-48141972-G-T,rs8108486,-1,G,T,48141972,31155,47914209,48307425,227763
19,ENSG00000181007.6,36418644,chr19-36385941-A-C,rs8111845,-1,A,C,36385941,32703,36222036,36615252,163905
19,ENSG00000198131.7,58228914,chr19-58248313-G-A,rs8112340,1,G,A,58248313,19399,58032306,58425522,216007
19,ENSG00000229676.2,22634324,chr19-22641717-T-C,rs8112981,1,T,C,22641717,7393,22437716,22830932,204001
19,ENSG00000180061.4,55325341,chr19-55322817-G-A,rs8113016,-1,G,A,55322817,2524,55128733,55521949,194084
19,ENSG00000168661.8,34926903,chr19-34851013-A-G,rs8113147,1,A,G,34851013,75890,34730295,35123511,120718
19,ENSG00000228300.7,1275530,chr19-1245701-G-A,rs8113509,1,G,A,1245701,29829,1078922,1472138,166779
19,ENSG00000176909.6,48719725,chr19-48748498-G-A,rs838143,-1,G,A,48748498,28773,48523117,48916333,225381
19,ENSG00000119574.7,58519810,chr19-58554585-T-C,rs873104,-1,T,C,58554585,34775,58323202,58716418,231383
19,ENSG00000177191.1,41427374,chr19-41391769-G-A,rs878082,-1,G,A,41391769,35605,41230766,41623982,161003
19,ENSG00000131409.6,50568435,chr19-50514578-G-A,rs889131,-1,G,A,50514578,53857,50371827,50765043,142751
19,ENSG00000185453.7,48170680,chr19-48039157-C-A,rs891015,1,C,A,48039157,131523,47974072,48367288,65085
19,ENSG00000123143.7,14433306,chr19-14563423-C-T,rs891089,1,C,T,14563423,130117,14236698,14629914,326725
19,ENSG00000125503.6,55117637,chr19-55133074-G-A,rs891186,-1,G,A,55133074,15437,54921029,55314245,212045
19,ENSG00000063127.10,49325191,chr19-49364656-G-A,rs919364,-1,G,A,49364656,39465,49128583,49521799,236073
19,ENSG00000105467.3,48364367,chr19-48365921-C-T,rs919804,1,C,T,48365921,1554,48167759,48560975,198162
19,ENSG00000182986.7,52897635,chr19-52948038-T-C,rs9304742,-1,T,C,52948038,50403,52701027,53094243,247011
19,ENSG00000196081.4,23250394,chr19-23384249-T-G,rs9305004,-1,T,G,23384249,133855,23053786,23447002,330463
19,ENSG00000011243.10,15418988,chr19-15534958-G-A,rs939501,-1,G,A,15534958,115970,15222380,15615596,312578
19,ENSG00000083814.7,57727624,chr19-57711583-A-G,rs9438914,-1,A,G,57711583,16041,57531016,57924232,180567
19,ENSG00000010310.3,45668221,chr19-45697518-C-T,rs9636135,1,C,T,45697518,29297,45471613,45864829,225905
19,ENSG00000188505.3,39196964,chr19-39187438-T-C,rs9676717,1,T,C,39187438,9526,39000356,39393572,187082
19,ENSG00000133246.4,8502640,chr19-8502591-T-C,rs968502,-1,T,C,8502591,49,8306032,8699248,196559
19,ENSG00000104804.3,48898744,chr19-48893480-G-A,rs9941490,-1,G,A,48893480,5264,48702136,49095352,191344
19,ENSG00000216490.1,18173813,chr19-17984468-G-A,rs10153455,1,G,A,17984468,189345,17977205,18370421,7263
19,ENSG00000197128.5,57477566,chr19-57558696-A-C,rs10221464,-1,A,C,57558696,81130,57280958,57674174,277738
19,ENSG00000189042.7,36687612,chr19-36669627-T-C,rs10402182,1,T,C,36669627,17985,36491004,36884220,178623
19,ENSG00000125755.11,45863147,chr19-45810500-G-C,rs10402263,-1,G,C,45810500,52647,45666539,46059755,143961
19,ENSG00000167491.10,19405675,chr19-19546691-G-A,rs10402308,1,G,A,19546691,141016,19209067,19602283,337624
19,ENSG00000087903.7,6110500,chr19-6047952-G-A,rs10402841,-1,G,A,6047952,62548,5913892,6307108,134060
19,ENSG00000167378.3,43596134,chr19-43635030-C-T,rs10402946,-1,C,T,43635030,38896,43399526,43792742,235504
19,ENSG00000180061.4,55325341,chr19-55262222-A-G,rs10403164,-1,A,G,55262222,63119,55128733,55521949,133489
19,ENSG00000081665.7,19821750,chr19-19886791-T-A,rs10403255,-1,T,A,19886791,65041,19625142,20018358,261649
19,ENSG00000197020.5,21767579,chr19-21803490-C-T,rs10403430,-1,C,T,21803490,35911,21570971,21964187,232519
19,ENSG00000177191.1,41427374,chr19-41419289-C-T,rs10404506,-1,C,T,41419289,8085,41230766,41623982,188523
19,ENSG00000105613.3,12838515,chr19-12672004-A-G,rs10406655,1,A,G,12672004,166511,12641907,13035123,30097
19,ENSG00000160961.6,14690048,chr19-14693371-A-G,rs10407394,1,A,G,14693371,3323,14493440,14886656,199931
19,ENSG00000127533.2,16888999,chr19-16877975-G-A,rs10407613,1,G,A,16877975,11024,16692391,17085607,185584
19,ENSG00000220008.1,2292024,chr19-2282367-A-G,rs10407772,-1,A,G,2282367,9657,2095416,2488632,186951
19,ENSG00000083844.5,57191500,chr19-57224448-C-T,rs10408146,1,C,T,57224448,32948,56994892,57388108,229556
19,ENSG00000105364.8,10252214,chr19-10222312-C-T,rs10409243,1,C,T,10222312,29902,10055606,10448822,166706
19,ENSG00000197841.7,34734243,chr19-34782445-C-T,rs10409480,1,C,T,34782445,48202,34537635,34930851,244810
19,ENSG00000182310.7,51693330,chr19-51651652-A-G,rs10412972,1,A,G,51651652,41678,51496722,51889938,154930
19,ENSG00000133243.3,2015714,chr19-2002391-T-G,rs10413498,-1,T,G,2002391,13323,1819106,2212322,183285
19,ENSG00000018869.10,56393534,chr19-56450042-G-A,rs10415307,-1,G,A,56450042,56508,56196926,56590142,253116
19,ENSG00000018869.10,56393534,chr19-56450042-G-T,rs10415307,-1,G,T,56450042,56508,56196926,56590142,253116
19,ENSG00000254858.2,18193218,chr19-18344893-C-T,rs10415319,1,C,T,18344893,151675,17996610,18389826,348283
19,ENSG00000221983.2,18571857,chr19-18692362-T-G,rs10419226,1,T,G,18692362,120505,18375249,18768465,317113
19,ENSG00000125731.7,6767435,chr19-6814549-T-A,rs10419572,-1,T,A,6814549,47114,6570827,6964043,243722
19,ENSG00000130511.8,18419398,chr19-18346153-G-C,rs10421536,1,G,C,18346153,73245,18222790,18616006,123363
19,ENSG00000254415.2,51646825,chr19-51544519-G-A,rs10423948,-1,G,A,51544519,102306,51450217,51843433,94302
19,ENSG00000167595.8,35758153,chr19-35577979-A-G,rs10424120,1,A,G,35577979,180174,35561545,35954761,16434
19,ENSG00000160007.11,46860997,chr19-46989218-G-A,rs10425259,1,G,A,46989218,128221,46664389,47057605,324829
19,ENSG00000083828.8,57769676,chr19-57788698-C-A,rs10425889,1,C,A,57788698,19022,57573068,57966284,215630
19,ENSG00000197937.5,53159053,chr19-53194155-A-T,rs10426161,-1,A,T,53194155,35102,52962445,53355661,231710
19,ENSG00000074842.2,4670342,chr19-4651257-G-A,rs10426502,-1,G,A,4651257,19085,4473734,4866950,177523
19,ENSG00000197380.5,46661182,chr19-46575924-C-T,rs10432269,-1,C,T,46575924,85258,46464574,46857790,111350
19,ENSG00000083807.4,58511992,chr19-58581872-T-C,rs10448,-1,T,C,58581872,69880,58315384,58708600,266488
19,ENSG00000249471.2,58451622,chr19-58581872-T-C,rs10448,1,T,C,58581872,130250,58255014,58648230,326858
19,ENSG00000196172.8,23758891,chr19-23870949-C-T,rs1065019,-1,C,T,23870949,112058,23562283,23955499,308666
19,ENSG00000104885.9,2163933,chr19-2158749-A-G,rs1074047,1,A,G,2158749,5184,1967325,2360541,191424
19,ENSG00000011451.8,15449956,chr19-15483253-C-T,rs10854145,-1,C,T,15483253,33297,15253348,15646564,229905
19,ENSG00000037757.8,13764522,chr19-13748453-C-T,rs109083,1,C,T,13748453,16069,13567914,13961130,180539
19,ENSG00000105486.7,48170344,chr19-48193421-C-G,rs11083921,-1,C,G,48193421,23077,47973736,48366952,219685
19,ENSG00000105609.11,54257273,chr19-54439042-G-C,rs11084341,-1,G,C,54439042,181769,54060665,54453881,378377
19,ENSG00000099821.6,633537,chr19-611373-C-T,rs11085144,-1,C,T,611373,22164,436929,830145,174444
19,ENSG00000104980.2,7943666,chr19-7750804-G-T,rs111296792,-1,G,T,7750804,192862,7747058,8140274,3746
19,ENSG00000127527.7,16471970,chr19-16339063-C-A,rs111776577,-1,C,A,16339063,132907,16275362,16668578,63701
19,ENSG00000105072.3,16496394,chr19-16339063-C-A,rs111776577,1,C,A,16339063,157331,16299786,16693002,39277
19,ENSG00000248098.2,41397818,chr19-41379846-G-C,rs112708650,1,G,C,41379846,17972,41201210,41594426,178636
19,ENSG00000152443.8,57746815,chr19-57913583-G-A,rs112780606,1,G,A,57913583,166768,57550207,57943423,363376
19,ENSG00000179168.8,38388034,chr19-38497905-G-A,rs112801907,-1,G,A,38497905,109871,38191426,38584642,306479
19,ENSG00000099326.3,58573335,chr19-58446205-G-A,rs112807223,-1,G,A,58446205,127130,58376727,58769943,69478
19,ENSG00000104808.3,48933699,chr19-48977799-C-G,rs113600772,1,C,G,48977799,44100,48737091,49130307,240708
19,ENSG00000170954.6,53132910,chr19-53073351-C-T,rs114810540,-1,C,T,53073351,59559,52936302,53329518,137049
19,ENSG00000170954.6,53132910,chr19-53073351-C-A,rs114810540,-1,C,A,53073351,59559,52936302,53329518,137049
19,ENSG00000198521.5,21836182,chr19-21772578-G-A,rs115053831,-1,G,A,21772578,63604,21639574,22032790,133004
19,ENSG00000087088.14,48954875,chr19-48758444-C-T,rs11665841,1,C,T,48758444,196431,48758267,49151483,177
19,ENSG00000160117.8,17281901,chr19-17340378-A-G,rs11666309,1,A,G,17340378,58477,17085293,17478509,255085
19,ENSG00000129437.4,51082887,chr19-51095412-A-G,rs11666870,-1,A,G,51095412,12525,50886279,51279495,209133
19,ENSG00000130725.2,58558611,chr19-58402864-A-G,rs11666928,-1,A,G,58402864,155747,58362003,58755219,40861
19,ENSG00000022556.10,54966374,chr19-55029687-A-G,rs11670590,1,A,G,55029687,63313,54769766,55162982,259921
19,ENSG00000196365.5,5720146,chr19-5599141-G-A,rs11670776,-1,G,A,5599141,121005,5523538,5916754,75603
19,ENSG00000167384.5,44500522,chr19-44518663-T-C,rs11670955,-1,T,C,44518663,18141,44303914,44697130,214749
19,ENSG00000104983.3,45995467,chr19-45947956-C-T,rs11672738,1,C,T,45947956,47511,45798859,46192075,149097
19,ENSG00000077348.3,41397359,chr19-41360047-G-A,rs117031209,-1,G,A,41360047,37312,41200751,41593967,159296
19,ENSG00000131409.6,50568435,chr19-50684017-C-T,rs117120439,-1,C,T,50684017,115582,50371827,50765043,312190
19,ENSG00000197256.5,11197545,chr19-11015521-T-C,rs117210556,-1,T,C,11015521,182024,11000937,11394153,14584
19,ENSG00000125652.2,6372794,chr19-6396284-G-T,rs117230333,1,G,T,6396284,23490,6176186,6569402,220098
19,ENSG00000118160.7,47471893,chr19-47419614-A-G,rs117390197,-1,A,G,47419614,52279,47275285,47668501,144329
19,ENSG00000099795.1,14572066,chr19-14483117-G-A,rs117714987,-1,G,A,14483117,88949,14375458,14768674,107659
19,ENSG00000089847.7,4182689,chr19-4180315-C-T,rs117833511,1,C,T,4180315,2374,3986081,4379297,194234
19,ENSG00000180855.10,12441021,chr19-12515647-T-C,rs11878413,-1,T,C,12515647,74626,12244413,12637629,271234
19,ENSG00000105427.4,42390297,chr19-42243077-G-A,rs11878620,-1,G,A,42243077,147220,42193689,42586905,49388
19,ENSG00000130669.11,39125802,chr19-39220263-C-T,rs11879005,1,C,T,39220263,94461,38929194,39322410,291069
19,ENSG00000105671.6,18919715,chr19-18764758-C-T,rs11879043,1,C,T,18764758,154957,18723107,19116323,41651
19,ENSG00000130477.9,17688354,chr19-17639398-C-A,rs11879994,-1,C,A,17639398,48956,17491746,17884962,147652
19,ENSG00000126264.4,35902529,chr19-35902517-C-A,rs11880605,1,C,A,35902517,12,35705921,36099137,196596
19,ENSG00000127616.9,10961030,chr19-10881151-G-A,rs11880628,1,G,A,10881151,79879,10764422,11157638,116729
19,ENSG00000130844.11,53538145,chr19-53557514-A-G,rs11881050,1,A,G,53557514,19369,53341537,53734753,215977
19,ENSG00000131355.9,14674844,chr19-14777242-T-C,rs11881701,-1,T,C,14777242,102398,14478236,14871452,299006
19,ENSG00000188505.3,39196964,chr19-39209665-T-G,rs11882959,1,T,G,39209665,12701,39000356,39393572,209309
19,ENSG00000188171.8,20661571,chr19-20759623-C-A,rs11882961,-1,C,A,20759623,98052,20464963,20858179,294660
19,ENSG00000126458.2,49640143,chr19-49632149-T-G,rs11883023,-1,T,G,49632149,7994,49443535,49836751,188614
19,ENSG00000105642.8,17967107,chr19-17936712-C-T,rs12151269,1,C,T,17936712,30395,17770499,18163715,166213
19,ENSG00000125740.7,45467996,chr19-45590147-C-T,rs12460145,1,C,T,45590147,122151,45271388,45664604,318759
19,ENSG00000179873.8,55831994,chr19-55809297-G-A,rs12461110,-1,G,A,55809297,22697,55635386,56028602,173911
19,ENSG00000104863.5,49114370,chr19-49161260-G-T,rs12461291,1,G,T,49161260,46890,48917762,49310978,243498
19,ENSG00000104863.5,49114370,chr19-49161260-G-A,rs12461291,1,G,A,49161260,46890,48917762,49310978,243498
19,ENSG00000123810.2,41364149,chr19-41226518-T-C,rs12462203,-1,T,C,41226518,137631,41167541,41560757,58977
19,ENSG00000220201.3,10309880,chr19-10314339-T-C,rs12462703,-1,T,C,10314339,4459,10113272,10506488,201067
19,ENSG00000160113.3,17245919,chr19-17247892-G-A,rs12463159,-1,G,A,17247892,1973,17049311,17442527,198581
19,ENSG00000141934.3,291403,chr19-418556-G-A,rs12609625,-1,G,A,418556,127153,94795,488011,323761
19,ENSG00000174586.4,58362751,chr19-58357114-G-T,rs12609654,-1,G,T,58357114,5637,58166143,58559359,190971
19,ENSG00000105516.5,48637379,chr19-48749732-C-T,rs12611028,-1,C,T,48749732,112353,48440771,48833987,308961
19,ENSG00000167619.6,42313309,chr19-42484691-G-A,rs12611218,1,G,A,42484691,171382,42116701,42509917,367990
19,ENSG00000167619.6,42313309,chr19-42484691-G-T,rs12611218,1,G,T,42484691,171382,42116701,42509917,367990
19,ENSG00000204524.3,57240632,chr19-57352545-C-T,rs12709968,1,C,T,57352545,111913,57044024,57437240,308521
19,ENSG00000213024.4,49929504,chr19-49901682-T-G,rs1290754,-1,T,G,49901682,27822,49732896,50126112,168786
19,ENSG00000169136.3,49929205,chr19-49901682-T-G,rs1290754,1,T,G,49901682,27523,49732597,50125813,169085
19,ENSG00000131941.2,33064888,chr19-33046190-T-C,rs12972060,-1,T,C,33046190,18698,32868280,33261496,177910
19,ENSG00000182472.3,38744474,chr19-38628854-A-C,rs12976749,-1,A,C,38628854,115620,38547866,38941082,80988
19,ENSG00000171124.7,5851449,chr19-5998456-A-G,rs12978722,-1,A,G,5998456,147007,5654841,6048057,343615
19,ENSG00000197928.4,53254873,chr19-53431384-G-A,rs12981260,-1,G,A,53431384,176511,53058265,53451481,373119
19,ENSG00000105750.8,20923251,chr19-20987542-A-G,rs12981807,1,A,G,20987542,64291,20726643,21119859,260899
19,ENSG00000072958.3,16197911,chr19-16244324-A-G,rs12982021,1,A,G,16244324,46413,16001303,16394519,243021
19,ENSG00000204604.3,52857619,chr19-52846597-C-T,rs12982980,-1,C,T,52846597,11022,52661011,53054227,185586
19,ENSG00000180089.3,55228763,chr19-55249092-G-A,rs12983684,-1,G,A,55249092,20329,55032155,55425371,216937
19,ENSG00000126267.3,35648323,chr19-35605074-G-A,rs12984673,1,G,A,35605074,43249,35451715,35844931,153359
19,ENSG00000076928.11,41883184,chr19-41725256-A-T,rs12985771,1,A,T,41725256,157928,41686576,42079792,38680
19,ENSG00000076928.11,41883184,chr19-41725256-A-C,rs12985771,1,A,C,41725256,157928,41686576,42079792,38680
19,ENSG00000088053.7,55038264,chr19-54867666-T-C,rs13345741,-1,T,C,54867666,170598,54841656,55234872,26010
19,ENSG00000065268.3,984345,chr19-1010023-C-T,rs13627,1,C,T,1010023,25678,787737,1180953,222286
19,ENSG00000105193.3,39435949,chr19-39268683-C-G,rs142031126,-1,C,G,39268683,167266,39239341,39632557,29342
19,ENSG00000161551.7,51887951,chr19-51887473-C-A,rs1433082,-1,C,A,51887473,478,51691343,52084559,196130
19,ENSG00000105323.10,41264372,chr19-41377293-G-A,rs1529717,1,G,A,41377293,112921,41067764,41460980,309529
19,ENSG00000204673.5,49877355,chr19-49841395-A-G,rs1545474,-1,A,G,49841395,35960,49680747,50073963,160648
19,ENSG00000184635.7,19900946,chr19-19776299-C-T,rs1560189,1,C,T,19776299,124647,19704338,20097554,71961
19,ENSG00000170909.9,54100803,chr19-53999537-G-A,rs158199,-1,G,A,53999537,101266,53904195,54297411,95342
19,ENSG00000125733.10,6739680,chr19-6836900-C-T,rs1651879,1,C,T,6836900,97220,6543072,6936288,293828
19,ENSG00000197766.1,859664,chr19-865835-T-C,rs1651896,1,T,C,865835,6171,663056,1056272,202779
19,ENSG00000160439.9,55063148,chr19-54994189-C-T,rs1654504,-1,C,T,54994189,68959,54866540,55259756,127649
19,ENSG00000153885.7,33796870,chr19-33843009-C-T,rs166988,1,C,T,33843009,46139,33600262,33993478,242747
19,ENSG00000175221.7,893187,chr19-859214-C-A,rs1683564,-1,C,A,859214,33973,696579,1089795,162635
19,ENSG00000105617.3,54159721,chr19-54026364-G-A,rs16960092,-1,G,A,54026364,133357,53963113,54356329,63251
19,ENSG00000131944.4,32972242,chr19-32922053-T-C,rs16967583,1,T,C,32922053,50189,32775634,33168850,146419
19,ENSG00000132003.4,13795443,chr19-13779391-A-G,rs16979344,1,A,G,13779391,16052,13598835,13992051,180556
19,ENSG00000141971.7,17420047,chr19-17420100-G-T,rs16981816,1,G,T,17420100,53,17223439,17616655,196661
19,ENSG00000166704.7,58002820,chr19-58002180-G-A,rs16988362,-1,G,A,58002180,640,57806212,58199428,195968
19,ENSG00000242852.2,12484816,chr19-12314455-T-C,rs17001926,-1,T,C,12314455,170361,12288208,12681424,26247
19,ENSG00000181029.6,7680833,chr19-7693308-C-T,rs17159840,1,C,T,7693308,12475,7484225,7877441,209083
19,ENSG00000125656.3,6361531,chr19-6206185-C-T,rs17468222,1,C,T,6206185,155346,6164923,6558139,41262
19,ENSG00000124299.7,33521791,chr19-33369952-C-T,rs17530508,-1,C,T,33369952,151839,33325183,33718399,44769
19,ENSG00000105771.8,43754962,chr19-43730363-T-C,rs17560331,-1,T,C,43730363,24599,43558354,43951570,172009
19,ENSG00000153879.2,33373709,chr19-33232799-T-G,rs17694094,1,T,G,33232799,140910,33177101,33570317,55698
19,ENSG00000130309.4,17555649,chr19-17568439-G-A,rs17724020,1,G,A,17568439,12790,17359041,17752257,209398
19,ENSG00000089335.14,34677678,chr19-34842272-C-T,rs17775427,1,C,T,34842272,164594,34481070,34874286,361202
19,ENSG00000105699.9,35249002,chr19-35099016-C-T,rs17775666,1,C,T,35099016,149986,35052394,35445610,46622
19,ENSG00000105514.2,11339657,chr19-11314407-T-G,rs17842633,-1,T,G,11314407,25250,11143049,11536265,171358
19,ENSG00000105341.11,41439912,chr19-41354391-A-G,rs1800469,-1,A,G,41354391,85521,41243304,41636520,111087
19,ENSG00000129347.14,10566010,chr19-10557997-A-G,rs1982074,-1,A,G,10557997,8013,10369402,10762618,188595
19,ENSG00000178093.8,19515548,chr19-19333177-T-C,rs2011503,-1,T,C,19333177,182371,19318940,19712156,14237
19,ENSG00000072954.1,16661139,chr19-16493866-T-C,rs2059155,1,T,C,16493866,167273,16464531,16857747,29335
19,ENSG00000099875.8,2051244,chr19-2199352-T-C,rs2074554,-1,T,C,2199352,148108,1854636,2247852,344716
19,ENSG00000185761.5,1513019,chr19-1615797-G-T,rs2074888,-1,G,T,1615797,102778,1316411,1709627,299386
19,ENSG00000185761.5,1513019,chr19-1615797-G-A,rs2074888,-1,G,A,1615797,102778,1316411,1709627,299386
19,ENSG00000071626.10,1407586,chr19-1391362-A-G,rs2074898,1,A,G,1391362,16224,1210978,1604194,180384
19,ENSG00000167642.6,38264573,chr19-38381695-C-A,rs2074981,1,C,A,38381695,117122,38067965,38461181,313730
19,ENSG00000167468.10,1103994,chr19-1106846-C-T,rs2075710,1,C,T,1106846,2852,907386,1300602,199460
19,ENSG00000160014.11,46601330,chr19-46565124-G-A,rs2099362,1,G,A,46565124,36206,46404722,46797938,160402
19,ENSG00000197619.7,52008211,chr19-51837473-T-G,rs2109657,-1,T,G,51837473,170738,51811603,52204819,25870
19,ENSG00000186300.5,2841475,chr19-2707211-G-A,rs2159918,1,G,A,2707211,134264,2644867,3038083,62344
19,ENSG00000074855.5,17334855,chr19-17353602-G-A,rs2162889,-1,G,A,17353602,18747,17138247,17531463,215355
19,ENSG00000161888.5,11155782,chr19-11146306-G-A,rs2163839,-1,G,A,11146306,9476,10959174,11352390,187132
19,ENSG00000142530.4,50476848,chr19-50406508-C-T,rs2230245,-1,C,T,50406508,70340,50280240,50673456,126268
19,ENSG00000099783.5,8444975,chr19-8308268-T-C,rs2232775,1,T,C,8308268,136707,8248367,8641583,59901
19,ENSG00000104899.2,2249323,chr19-2201899-G-A,rs2240130,1,G,A,2201899,47424,2052715,2445931,149184
19,ENSG00000105298.7,3626790,chr19-3621722-G-A,rs2240505,-1,G,A,3621722,5068,3430182,3823398,191540
19,ENSG00000039650.4,49867576,chr19-49866809-C-T,rs2257103,-1,C,T,49866809,767,49670968,50064184,195841
19,ENSG00000105656.4,18522070,chr19-18595694-G-A,rs2283617,-1,G,A,18595694,73624,18325462,18718678,270232
19,ENSG00000125734.7,6737580,chr19-6696331-A-G,rs2287848,-1,A,G,6696331,41249,6540972,6934188,155359
19,ENSG00000167748.5,50823787,chr19-50804800-A-C,rs2288417,-1,A,C,50804800,18987,50627179,51020395,177621
19,ENSG00000156413.7,5839702,chr19-5776190-C-T,rs2290778,-1,C,T,5776190,63512,5643094,6036310,133096
19,ENSG00000126251.4,35371068,chr19-35352183-G-A,rs2301151,1,G,A,35352183,18885,35174460,35567676,177723
19,ENSG00000185897.5,35358460,chr19-35352183-G-A,rs2301151,1,G,A,35352183,6277,35161852,35555068,190331
19,ENSG00000070404.3,676392,chr19-675513-T-G,rs2301742,1,T,G,675513,879,479784,873000,195729
19,ENSG00000129911.3,1863579,chr19-1817867-C-T,rs2304612,-1,C,T,1817867,45712,1666971,2060187,150896
19,ENSG00000161265.6,35745418,chr19-35758620-G-A,rs231237,-1,G,A,35758620,13202,35548810,35942026,209810
19,ENSG00000161618.4,49453225,chr19-49511720-G-A,rs2335534,1,G,A,49511720,58495,49256617,49649833,255103
19,ENSG00000248099.2,17821519,chr19-17823209-G-A,rs2382987,-1,G,A,17823209,1690,17624911,18018127,198298
19,ENSG00000125503.6,55117637,chr19-55103555-T-C,rs2532060,-1,T,C,55103555,14082,54921029,55314245,182526
19,ENSG00000185453.7,48170680,chr19-48027959-T-G,rs2560966,1,T,G,48027959,142721,47974072,48367288,53887
19,ENSG00000160410.8,40576873,chr19-40644181-C-A,rs2561562,1,C,A,40644181,67308,40380265,40773481,263916
19,ENSG00000176472.5,43533188,chr19-43521049-T-C,rs2599454,1,T,C,43521049,12139,43336580,43729796,184469
19,ENSG00000124466.6,43465608,chr19-43450962-A-G,rs2599476,-1,A,G,43450962,14646,43269000,43662216,181962
19,ENSG00000127663.8,4969113,chr19-5086923-A-C,rs2613780,1,A,C,5086923,117810,4772505,5165721,314418
19,ENSG00000229676.2,22634324,chr19-22802703-C-T,rs2617781,1,C,T,22802703,168379,22437716,22830932,364987
19,ENSG00000196268.6,21397133,chr19-21482835-T-C,rs2650781,1,T,C,21482835,85702,21200525,21593741,282310
19,ENSG00000167634.6,54947505,chr19-54970301-T-C,rs269913,-1,T,C,54970301,22796,54750897,55144113,219404
19,ENSG00000213799.4,53333749,chr19-53446227-A-G,rs2708751,1,A,G,53446227,112478,53137141,53530357,309086
19,ENSG00000105677.5,35545626,chr19-35554870-A-G,rs2733739,1,A,G,35554870,9244,35349018,35742234,205852
19,ENSG00000076662.4,10339624,chr19-10336058-G-A,rs281413,-1,G,A,10336058,3566,10143016,10536232,193042
19,ENSG00000130813.12,10086317,chr19-10098169-C-G,rs28379440,1,C,G,10098169,11852,9889709,10282925,208460
19,ENSG00000130812.5,10102678,chr19-10098169-C-G,rs28379440,-1,C,G,10098169,4509,9906070,10299286,192099
19,ENSG00000174652.12,9435573,chr19-9324196-C-T,rs28384491,-1,C,T,9324196,111377,9238965,9632181,85231
19,ENSG00000171291.3,11848726,chr19-11720774-C-G,rs286278,1,C,G,11720774,127952,11652118,12045334,68656
19,ENSG00000028277.12,42132446,chr19-42051066-G-A,rs28711705,-1,G,A,42051066,81380,41935838,42329054,115228
19,ENSG00000004777.10,35775564,chr19-35741519-C-T,rs2871921,1,C,T,35741519,34045,35578956,35972172,162563
19,ENSG00000167785.3,8832304,chr19-8705681-A-T,rs2913929,-1,A,T,8705681,126623,8635696,9028912,69985
19,ENSG00000178982.4,38619188,chr19-38563051-T-C,rs2960339,1,T,C,38563051,56137,38422580,38815796,140471
19,ENSG00000105755.2,43527201,chr19-43594811-C-G,rs304725,-1,C,G,43594811,67610,43330593,43723809,264218
19,ENSG00000105371.7,10286955,chr19-10285660-C-T,rs3093032,1,C,T,10285660,1295,10090347,10483563,195313
19,ENSG00000130175.4,11435635,chr19-11442095-A-G,rs313624,1,A,G,11442095,6460,11239027,11632243,203068
19,ENSG00000130164.6,11089463,chr19-11165166-G-A,rs3185010,1,G,A,11165166,75703,10892855,11286071,272311
19,ENSG00000105639.13,17847982,chr19-17826949-C-T,rs3212798,-1,C,T,17826949,21033,17651374,18044590,175575
19,ENSG00000167555.8,52397849,chr19-52377513-C-T,rs324087,1,C,T,52377513,20336,52201241,52594457,176272
19,ENSG00000167555.8,52397849,chr19-52377513-C-G,rs324087,1,C,G,52377513,20336,52201241,52594457,176272
19,ENSG00000171747.3,38812945,chr19-38931317-A-G,rs33988199,-1,A,G,38931317,118372,38616337,39009553,314980
19,ENSG00000161243.3,39032549,chr19-38931317-A-G,rs33988199,-1,A,G,38931317,101232,38835941,39229157,95376
19,ENSG00000187266.7,11384314,chr19-11432642-T-C,rs34088,-1,T,C,11432642,48328,11187706,11580922,244936
19,ENSG00000099785.5,8413305,chr19-8438461-G-C,rs34099346,1,G,C,8438461,25156,8216697,8609913,221764
19,ENSG00000099785.5,8413305,chr19-8438461-G-A,rs34099346,1,G,A,8438461,25156,8216697,8609913,221764
19,ENSG00000249115.2,35612735,chr19-35459272-A-G,rs34536858,1,A,G,35459272,153463,35416127,35809343,43145
19,ENSG00000167766.11,52638355,chr19-52606851-G-A,rs34577894,-1,G,A,52606851,31504,52441747,52834963,165104
19,ENSG00000104833.4,6502309,chr19-6543206-T-C,rs348372,-1,T,C,6543206,40897,6305701,6698917,237505
19,ENSG00000167751.7,50873439,chr19-50748548-A-G,rs35372578,1,A,G,50748548,124891,50676831,51070047,71717
19,ENSG00000161609.4,49388249,chr19-49279364-G-A,rs353999,1,G,A,49279364,108885,49191641,49584857,87723
19,ENSG00000104894.6,49335406,chr19-49383919-T-C,rs35828275,1,T,C,49383919,48513,49138798,49532014,245121
19,ENSG00000090932.5,39498947,chr19-39372241-C-T,rs36265,1,C,T,39372241,126706,39302339,39695555,69902
19,ENSG00000204920.4,43984188,chr19-43804850-C-T,rs364691,1,C,T,43804850,179338,43787580,44180796,17270
19,ENSG00000123815.6,40716886,chr19-40804704-A-G,rs3733828,-1,A,G,40804704,87818,40520278,40913494,284426
19,ENSG00000177380.8,49119544,chr19-49196609-C-T,rs3745301,1,C,T,49196609,77065,48922936,49316152,273673
19,ENSG00000169169.9,49691116,chr19-49673914-G-A,rs3745469,1,G,A,49673914,17202,49494508,49887724,179406
19,ENSG00000167414.3,46636202,chr19-46525641-C-T,rs3745792,-1,C,T,46525641,110561,46439594,46832810,86047
19,ENSG00000183617.3,3762682,chr19-3762500-C-T,rs3746118,1,C,T,3762500,182,3566074,3959290,196426
19,ENSG00000105650.12,18226475,chr19-18031872-T-C,rs374614,-1,T,C,18031872,194603,18029867,18423083,2005
19,ENSG00000169515.4,46413564,chr19-46392960-A-G,rs3764613,-1,A,G,46392960,20604,46216956,46610172,176004
19,ENSG00000213015.3,55641002,chr19-55658238-C-T,rs3786648,1,C,T,55658238,17236,55444394,55837610,213844
19,ENSG00000125910.3,3178769,chr19-3178374-G-A,rs3786944,1,G,A,3178374,395,2982161,3375377,196213
19,ENSG00000234465.4,43575801,chr19-43586043-A-C,rs3817,1,A,C,43586043,10242,43379193,43772409,206850
19,ENSG00000181035.8,19063994,chr19-19164926-C-T,rs3890384,1,C,T,19164926,100932,18867386,19260602,297540
19,ENSG00000126243.3,35936374,chr19-35851151-C-T,rs396178,1,C,T,35851151,85223,35739766,36132982,111385
19,ENSG00000167637.11,43827321,chr19-43984375-A-G,rs398981,1,A,G,43984375,157054,43630713,44023929,353662
19,ENSG00000167608.6,54173160,chr19-54193607-A-C,rs4042,-1,A,C,54193607,20447,53976552,54369768,217055
19,ENSG00000167608.6,54173160,chr19-54193607-A-G,rs4042,-1,A,G,54193607,20447,53976552,54369768,217055
19,ENSG00000105270.7,36032873,chr19-35858850-G-A,rs404299,-1,G,A,35858850,174023,35836265,36229481,22585
19,ENSG00000196110.2,9309838,chr19-9305351-C-T,rs41375152,-1,C,T,9305351,4487,9113230,9506446,192121
19,ENSG00000088256.3,3094362,chr19-3123115-C-T,rs415647,1,C,T,3123115,28753,2897754,3290970,225361
19,ENSG00000170889.9,54200858,chr19-54252131-A-G,rs417523,1,A,G,54252131,51273,54004250,54397466,247881
19,ENSG00000104953.11,2977564,chr19-2993429-T-C,rs435806,1,T,C,2993429,15865,2780956,3174172,212473
19,ENSG00000105146.7,57231023,chr19-57248257-C-T,rs4474796,1,C,T,57248257,17234,57034415,57427631,213842
19,ENSG00000104884.9,45370573,chr19-45344875-C-T,rs4476273,-1,C,T,45344875,25698,45173965,45567181,170910
19,ENSG00000174886.7,5903790,chr19-5995439-T-C,rs452767,-1,T,C,5995439,91649,5707182,6100398,288257
19,ENSG00000012124.9,35329187,chr19-35345037-C-T,rs45453699,1,C,T,35345037,15850,35132579,35525795,212458
19,ENSG00000167815.7,12801800,chr19-12691339-C-A,rs45478502,-1,C,A,12691339,110461,12605192,12998408,86147
19,ENSG00000104774.6,12666742,chr19-12691339-C-A,rs45478502,-1,C,A,12691339,24597,12470134,12863350,221205
19,ENSG00000251369.2,57559863,chr19-57541945-A-G,rs45533235,-1,A,G,57541945,17918,57363255,57756471,178690
19,ENSG00000167618.4,54502831,chr19-54524792-C-T,rs4632258,1,C,T,54524792,21961,54306223,54699439,218569
19,ENSG00000142534.1,49496434,chr19-49445355-A-G,rs4801799,1,A,G,49445355,51079,49299826,49693042,145529
19,ENSG00000099338.14,38335830,chr19-38358156-A-G,rs4802351,1,A,G,38358156,22326,38139222,38532438,218934
19,ENSG00000196417.6,53395149,chr19-53431351-A-G,rs4803113,1,A,G,53431351,36202,53198541,53591757,232810
19,ENSG00000130203.4,44905796,chr19-45020201-G-A,rs4803790,1,G,A,45020201,114405,44709188,45102404,311013
19,ENSG00000177045.4,45769252,chr19-45735668-G-T,rs4803852,-1,G,T,45735668,33584,45572644,45965860,163024
19,ENSG00000105287.7,46717114,chr19-46715342-T-G,rs4803995,-1,T,G,46715342,1772,46520506,46913722,194836
19,ENSG00000105321.6,47256525,chr19-47284247-G-C,rs4804044,1,G,C,47284247,27722,47059917,47453133,224330
19,ENSG00000105321.6,47256525,chr19-47284247-G-A,rs4804044,1,G,A,47284247,27722,47059917,47453133,224330
19,ENSG00000260001.1,7914830,chr19-7718688-G-T,rs4804227,1,G,T,7718688,196142,7718222,8111438,466
19,ENSG00000130159.6,11529134,chr19-11572345-T-C,rs4804605,-1,T,C,11572345,43211,11332526,11725742,239819
19,ENSG00000198551.4,11597483,chr19-11618382-T-C,rs4804612,1,T,C,11618382,20899,11400875,11794091,217507
19,ENSG00000257103.2,34172504,chr19-34136314-T-C,rs4805072,1,T,C,34136314,36190,33975896,34369112,160418
19,ENSG00000011132.6,3761692,chr19-3804703-T-C,rs4806954,-1,T,C,3804703,43011,3565084,3958300,239619
19,ENSG00000167658.9,3985463,chr19-3939705-G-A,rs4806966,-1,G,A,3939705,45758,3788855,4182071,150850
19,ENSG00000074181.2,15200995,chr19-15284812-T-A,rs4808278,-1,T,A,15284812,83817,15004387,15397603,280425
19,ENSG00000130816.8,10194953,chr19-10284792-G-A,rs5497,-1,G,A,10284792,89839,9998345,10391561,286447
19,ENSG00000090339.3,10271120,chr19-10285007-A-G,rs5498,1,A,G,10285007,13887,10074512,10467728,210495
19,ENSG00000060558.2,3136033,chr19-3097299-G-A,rs56177650,1,G,A,3097299,38734,2939425,3332641,157874
19,ENSG00000175691.6,2944971,chr19-2935745-G-A,rs60447818,-1,G,A,2935745,9226,2748363,3141579,187382
19,ENSG00000180448.4,1067167,chr19-1251398-C-T,rs60724761,1,C,T,1251398,184231,870559,1263775,380839
19,ENSG00000160633.6,5623083,chr19-5466555-A-G,rs611121,1,A,G,5466555,156528,5426475,5819691,40080
19,ENSG00000141994.9,5791163,chr19-5772939-G-A,rs61180947,-1,G,A,5772939,18224,5594555,5987771,178384
19,ENSG00000197608.6,52095765,chr19-52067333-C-T,rs61742061,-1,C,T,52067333,28432,51899157,52292373,168176
19,ENSG00000075702.9,36054897,chr19-36183447-C-T,rs61743957,1,C,T,36183447,128550,35858289,36251505,325158
19,ENSG00000167578.11,40778247,chr19-40800745-C-T,rs61750953,1,C,T,40800745,22498,40581639,40974855,219106
19,ENSG00000198464.7,52297169,chr19-52319375-G-A,rs62110455,1,G,A,52319375,22206,52100561,52493777,218814
19,ENSG00000076924.6,7629545,chr19-7576904-T-C,rs62111357,-1,T,C,7576904,52641,7432937,7826153,143967
19,ENSG00000167685.8,56141287,chr19-56008436-G-A,rs62123587,1,G,A,56008436,132851,55944679,56337895,63757
19,ENSG00000090661.6,8209370,chr19-8182669-G-A,rs62124529,1,G,A,8182669,26701,8012762,8405978,169907
19,ENSG00000223638.3,55759097,chr19-55598565-A-G,rs62127845,1,A,G,55598565,160532,55562489,55955705,36076
19,ENSG00000229292.1,55769118,chr19-55598565-A-G,rs62127845,1,A,G,55598565,170553,55572510,55965726,26055
19,ENSG00000142546.8,49580556,chr19-49459635-G-A,rs62128062,-1,G,A,49459635,120921,49383948,49777164,75687
19,ENSG00000130312.1,17305872,chr19-17362612-C-G,rs62128113,1,C,G,17362612,56740,17109264,17502480,253348
19,ENSG00000105523.2,48615076,chr19-48595522-C-T,rs62130308,-1,C,T,48595522,19554,48418468,48811684,177054
19,ENSG00000077009.7,3933069,chr19-3890924-C-T,rs62133058,1,C,T,3890924,42145,3736461,4129677,154463
19,ENSG00000142039.2,41310172,chr19-41227240-G-C,rs6508974,1,G,C,41227240,82932,41113564,41506780,113676
19,ENSG00000117877.5,45406644,chr19-45479522-T-G,rs6509215,1,T,G,45479522,72878,45210036,45603252,269486
19,ENSG00000105136.13,57487750,chr19-57486566-C-T,rs6510081,1,C,T,57486566,1184,57291142,57684358,195424
19,ENSG00000213965.2,32691821,chr19-32692763-C-T,rs6510277,1,C,T,32692763,942,32495213,32888429,197550
19,ENSG00000213965.2,32691821,chr19-32692763-C-A,rs6510277,1,C,A,32692763,942,32495213,32888429,197550
19,ENSG00000188305.2,2282175,chr19-2103840-G-A,rs6510642,-1,G,A,2103840,178335,2085567,2478783,18273
19,ENSG00000105664.4,18791305,chr19-18791783-T-G,rs6511002,-1,T,G,18791783,478,18594697,18987913,197086
19,ENSG00000099331.7,17075777,chr19-17060772-A-G,rs6512161,1,A,G,17060772,15005,16879169,17272385,181603
19,ENSG00000180884.7,34964229,chr19-35022333-T-C,rs66528626,-1,T,C,35022333,58104,34767621,35160837,254712
19,ENSG00000196684.6,16143685,chr19-16186097-C-T,rs67000086,1,C,T,16186097,42412,15947077,16340293,239020
19,ENSG00000105426.8,5340812,chr19-5515217-C-T,rs675136,-1,C,T,5515217,174405,5144204,5537420,371013
19,ENSG00000062822.6,50384347,chr19-50297869-G-A,rs71355136,1,G,A,50297869,86478,50187739,50580955,110130
19,ENSG00000064961.12,3572944,chr19-3767267-C-T,rs7239,1,C,T,3767267,194323,3376336,3769552,390931
19,ENSG00000198182.6,37719761,chr19-37784218-T-C,rs7245855,-1,T,C,37784218,64457,37523153,37916369,261065
19,ENSG00000186818.6,54662995,chr19-54549255-G-T,rs7247291,1,G,T,54549255,113740,54466387,54859603,82868
19,ENSG00000105726.11,19663676,chr19-19684751-C-A,rs7247433,-1,C,A,19684751,21075,19467068,19860284,217683
19,ENSG00000090971.3,55485188,chr19-55454268-C-T,rs7247719,1,C,T,55454268,30920,55288580,55681796,165688
19,ENSG00000176531.5,43504746,chr19-43455962-A-C,rs7248167,-1,A,C,43455962,48784,43308138,43701354,147824
19,ENSG00000256771.1,19865882,chr19-19812291-A-G,rs7248808,1,A,G,19812291,53591,19669274,20062490,143017
19,ENSG00000176401.4,39532852,chr19-39575925-G-T,rs7248933,-1,G,T,39575925,43073,39336244,39729460,239681
19,ENSG00000127507.11,14778560,chr19-14737655-T-A,rs7248991,-1,T,A,14737655,40905,14581952,14975168,155703
19,ENSG00000089351.7,35000323,chr19-35044032-C-T,rs7249282,1,C,T,35044032,43709,34803715,35196931,240317
19,ENSG00000174837.8,6887579,chr19-6967463-G-T,rs7249830,1,G,T,6967463,79884,6690971,7084187,276492
19,ENSG00000178201.3,57457140,chr19-57446464-A-G,rs7250024,-1,A,G,57446464,10676,57260532,57653748,185932
19,ENSG00000127220.3,17303425,chr19-17266803-C-G,rs7250266,-1,C,G,17266803,36622,17106817,17500033,159986
19,ENSG00000096996.9,18086934,chr19-18090947-C-T,rs7250425,-1,C,T,18090947,4013,17890326,18283542,200621
19,ENSG00000167671.6,4457794,chr19-4510518-G-A,rs7250947,-1,G,A,4510518,52724,4261186,4654402,249332
19,ENSG00000105641.2,17871945,chr19-17817095-G-A,rs7251749,1,G,A,17817095,54850,17675337,18068553,141758
19,ENSG00000172270.12,572596,chr19-577426-T-G,rs7252138,1,T,G,577426,4830,375988,769204,201438
19,ENSG00000254004.1,36528271,chr19-36506642-C-G,rs7252262,-1,C,G,36506642,21629,36331663,36724879,174979
19,ENSG00000254004.1,36528271,chr19-36506642-C-A,rs7252262,-1,C,A,36506642,21629,36331663,36724879,174979
19,ENSG00000172006.6,2819868,chr19-2748599-A-G,rs7252598,1,A,G,2748599,71269,2623260,3016476,125339
19,ENSG00000130810.14,10106362,chr19-10184448-G-A,rs7253062,1,G,A,10184448,78086,9909754,10302970,274694
19,ENSG00000196867.1,56538948,chr19-56442734-C-A,rs7253217,1,C,A,56442734,96214,56342340,56735556,100394
19,ENSG00000179855.5,3585478,chr19-3623536-A-G,rs7253265,1,A,G,3623536,38058,3388870,3782086,234666
19,ENSG00000105245.4,40690651,chr19-40635529-G-A,rs7254268,-1,G,A,40635529,55122,40494043,40887259,141486
19,ENSG00000189190.6,52786807,chr19-52904544-C-T,rs7254555,-1,C,T,52904544,117737,52590199,52983415,314345
19,ENSG00000196967.4,37172695,chr19-37327956-G-A,rs7258912,-1,G,A,37327956,155261,36976087,37369303,351869
19,ENSG00000130299.10,17337553,chr19-17351983-G-A,rs7259703,1,G,A,17351983,14430,17140945,17534161,211038
19,ENSG00000105255.5,4304598,chr19-4180693-T-G,rs7260071,1,T,G,4180693,123905,4107990,4501206,72703
19,ENSG00000123146.12,14381444,chr19-14390732-A-G,rs7260110,1,A,G,14390732,9288,14184836,14578052,205896
19,ENSG00000141933.6,507497,chr19-522740-A-G,rs72970279,1,A,G,522740,15243,310889,704105,211851
19,ENSG00000105519.5,5914254,chr19-5763318-C-T,rs72983161,1,C,T,5763318,150936,5717646,6110862,45672
19,ENSG00000099330.3,17226226,chr19-17401653-A-G,rs73018431,1,A,G,17401653,175427,17029618,17422834,372035
19,ENSG00000118162.8,47484219,chr19-47585297-T-C,rs73033595,-1,T,C,47585297,101078,47287611,47680827,297686
19,ENSG00000167614.8,54415464,chr19-54340255-A-G,rs73061003,1,A,G,54340255,75209,54218856,54612072,121399
19,ENSG00000167617.2,54473296,chr19-54478404-C-T,rs73064143,-1,C,T,54478404,5108,54276688,54669904,201716
19,ENSG00000175489.6,18397622,chr19-18456229-C-T,rs731945,-1,C,T,18456229,58607,18201014,18594230,255215
19,ENSG00000125753.8,45507479,chr19-45588621-C-T,rs73570937,1,C,T,45588621,81142,45310871,45704087,277750
19,ENSG00000133247.8,55339876,chr19-55486914-C-T,rs73932655,1,C,T,55486914,147038,55143268,55536484,343646
19,ENSG00000105695.8,35292161,chr19-35221646-G-A,rs7409420,1,G,A,35221646,70515,35095553,35488769,126093
19,ENSG00000198453.7,36916332,chr19-36824660-G-A,rs74679698,1,G,A,36824660,91672,36719724,37112940,104936
19,ENSG00000105278.5,3869038,chr19-3891396-C-T,rs74809366,-1,C,T,3891396,22358,3672430,4065646,218966
19,ENSG00000073008.8,44643910,chr19-44660404-T-C,rs754340,1,T,C,44660404,16494,44447302,44840518,213102
19,ENSG00000161914.3,11505839,chr19-11449532-T-G,rs755000,-1,T,G,11449532,56307,11309231,11702447,140301
19,ENSG00000099822.1,589881,chr19-647251-G-A,rs757331,1,G,A,647251,57370,393273,786489,253978
19,ENSG00000186111.3,3700468,chr19-3660621-A-G,rs757454,-1,A,G,3660621,39847,3503860,3897076,156761
19,ENSG00000104872.5,49451814,chr19-49492486-G-A,rs76997502,-1,G,A,49492486,40672,49255206,49648422,237280
19,ENSG00000083812.5,58467080,chr19-58571901-G-A,rs77537775,1,G,A,58571901,104821,58270472,58663688,301429
19,ENSG00000105668.2,35666516,chr19-35775463-G-A,rs77750939,1,G,A,35775463,108947,35469908,35863124,305555
19,ENSG00000161277.6,36054285,chr19-35907512-C-A,rs77782321,-1,C,A,35907512,146773,35857677,36250893,49835
19,ENSG00000126262.2,35448257,chr19-35459404-G-A,rs78036837,1,G,A,35459404,11147,35251649,35644865,207755
19,ENSG00000221923.3,52369923,chr19-52373965-G-A,rs780726,1,G,A,52373965,4042,52173315,52566531,200650
19,ENSG00000181240.8,6433763,chr19-6423328-T-C,rs78225015,-1,T,C,6423328,10435,6237155,6630371,186173
19,ENSG00000167733.8,5681027,chr19-5790529-T-C,rs78614307,1,T,C,5790529,109502,5484419,5877635,306110
19,ENSG00000064607.11,19033517,chr19-19079965-C-A,rs78696337,-1,C,A,19079965,46448,18836909,19230125,243056
19,ENSG00000160469.9,55283997,chr19-55207438-T-C,rs78703538,1,T,C,55207438,76559,55087389,55480605,120049
19,ENSG00000076944.7,7637110,chr19-7625798-C-T,rs794081,1,C,T,7625798,11312,7440502,7833718,185296
19,ENSG00000104969.4,2783273,chr19-2779423-A-G,rs79528039,-1,A,G,2779423,3850,2586665,2979881,192758
19,ENSG00000105612.3,12881449,chr19-12899706-A-G,rs8012,-1,A,G,12899706,18257,12684841,13078057,214865
19,ENSG00000060566.7,4153631,chr19-4005783-C-T,rs8100558,1,C,T,4005783,147848,3957023,4350239,48760
19,ENSG00000105379.4,51366388,chr19-51479780-T-C,rs8101768,-1,T,C,51479780,113392,51169780,51562996,310000
19,ENSG00000141965.3,4791734,chr19-4804512-T-C,rs8102626,1,T,C,4804512,12778,4595126,4988342,209386
19,ENSG00000187187.7,39997060,chr19-40153729-G-A,rs8102848,1,G,A,40153729,156669,39800452,40193668,353277
19,ENSG00000126460.5,49581316,chr19-49566637-A-G,rs8102979,1,A,G,49566637,14679,49384708,49777924,181929
19,ENSG00000167483.11,17527267,chr19-17412060-T-C,rs8103068,1,T,C,17412060,115207,17330659,17723875,81401
19,ENSG00000177464.3,45602212,chr19-45475344-A-C,rs8105114,-1,A,C,45475344,126868,45405604,45798820,69740
19,ENSG00000161671.10,50476507,chr19-50451327-C-T,rs8105250,1,C,T,50451327,25180,50279899,50673115,171428
19,ENSG00000181027.5,46746057,chr19-46784893-C-A,rs8105903,1,C,A,46784893,38836,46549449,46942665,235444
19,ENSG00000104957.8,13747895,chr19-13805596-T-C,rs8106232,1,T,C,13805596,57701,13551287,13944503,254309
19,ENSG00000130811.5,10119899,chr19-9935728-G-C,rs8107511,-1,G,C,9935728,184171,9923291,10316507,12437
19,ENSG00000130811.5,10119899,chr19-9935728-G-A,rs8107511,-1,G,A,9935728,184171,9923291,10316507,12437
19,ENSG00000121410.6,58353492,chr19-58297788-T-G,rs8107581,-1,T,G,58297788,55704,58156884,58550100,140904
19,ENSG00000126456.10,49665857,chr19-49679440-T-C,rs8109314,-1,T,C,49679440,13583,49469249,49862465,210191
19,ENSG00000126456.10,49665857,chr19-49679440-T-A,rs8109314,-1,T,A,49679440,13583,49469249,49862465,210191
19,ENSG00000182013.11,46471563,chr19-46446405-C-T,rs8109759,-1,C,T,46446405,25158,46274955,46668171,171450
19,ENSG00000167460.9,16076495,chr19-16084227-G-A,rs8110506,1,G,A,16084227,7732,15879887,16273103,204340
19,ENSG00000105401.1,10403542,chr19-10447570-T-C,rs8110715,-1,T,C,10447570,44028,10206934,10600150,240636
19,ENSG00000126246.4,35742452,chr19-35612615-T-C,rs8110747,-1,T,C,35612615,129837,35545844,35939060,66771
19,ENSG00000011478.6,45692666,chr19-45664843-A-G,rs8111428,1,A,G,45664843,27823,45496058,45889274,168785
19,ENSG00000187994.6,38878275,chr19-38838877-C-T,rs8111670,-1,C,T,38838877,39398,38681667,39074883,157210
19,ENSG00000132024.11,13906201,chr19-13912682-T-C,rs8111764,1,T,C,13912682,6481,13709593,14102809,203089
19,ENSG00000182986.7,52897635,chr19-52913715-G-A,rs8112177,-1,G,A,52913715,16080,52701027,53094243,212688
19,ENSG00000249709.1,12551482,chr19-12390621-A-G,rs8112445,-1,A,G,12390621,160861,12354874,12748090,35747
19,ENSG00000160013.3,46625089,chr19-46643712-T-A,rs8113318,-1,T,A,46643712,18623,46428481,46821697,215231
19,ENSG00000126249.1,34404399,chr19-34378819-A-G,rs8191378,1,A,G,34378819,25580,34207791,34601007,171028
19,ENSG00000256060.1,57363551,chr19-57352233-G-T,rs862700,1,G,T,57352233,11318,57166943,57560159,185290
19,ENSG00000186230.5,57435325,chr19-57352233-G-T,rs862700,1,G,T,57352233,83092,57238717,57631933,113516
19,ENSG00000263002.1,44141554,chr19-44228505-C-G,rs922063,1,C,G,44228505,86951,43944946,44338162,283559
19,ENSG00000263002.1,44141554,chr19-44228505-C-T,rs922063,1,C,T,44228505,86951,43944946,44338162,283559
19,ENSG00000234906.2,44946051,chr19-44808857-G-A,rs922387,1,G,A,44808857,137194,44749443,45142659,59414
19,ENSG00000197933.6,11738946,chr19-11560612-A-G,rs974697,-1,A,G,11560612,178334,11542338,11935554,18274
19,ENSG00000141858.7,14090751,chr19-14058322-A-G,rs9749255,-1,A,G,14058322,32429,13894143,14287359,164179
19,ENSG00000197134.5,22052484,chr19-22117205-T-G,rs987711,1,T,G,22117205,64721,21855876,22249092,261329
18,ENSG00000141380.8,26090613,chr18-26159350-T-C,rs10048370,-1,T,C,26159350,68737,25894005,26287221,265345
18,ENSG00000134504.7,26548553,chr18-26559729-G-A,rs10454720,-1,G,A,26559729,11176,26351945,26745161,207784
18,ENSG00000134779.8,36829002,chr18-36818951-C-T,rs1045781,-1,C,T,36818951,10051,36632394,37025610,186557
18,ENSG00000176624.8,51197681,chr18-51159098-G-A,rs10502915,-1,G,A,51159098,38583,51001073,51394289,158025
18,ENSG00000166845.8,54357906,chr18-54255524-T-C,rs11083047,1,T,C,54255524,102382,54161298,54554514,94226
18,ENSG00000101751.5,54269517,chr18-54255524-T-C,rs11083047,1,T,C,54255524,13993,54072909,54466125,182615
18,ENSG00000187323.6,52340197,chr18-52499139-A-G,rs112391890,1,A,G,52499139,158942,52143589,52536805,355550
18,ENSG00000176014.6,12308241,chr18-12308794-G-A,rs11267036,1,G,A,12308794,553,12111633,12504849,197161
18,ENSG00000176014.6,12308241,chr18-12308794-G-C,rs11267036,1,G,C,12308794,553,12111633,12504849,197161
18,ENSG00000085415.10,12948011,chr18-12991394-T-C,rs11663049,1,T,C,12991394,43383,12751403,13144619,239991
18,ENSG00000141458.5,23586506,chr18-23487112-A-G,rs11663645,-1,A,G,23487112,99394,23389898,23783114,97214
18,ENSG00000119541.4,63422476,chr18-63429686-T-C,rs118023911,-1,T,C,63429686,7210,63225868,63619084,203818
18,ENSG00000170579.8,4455307,chr18-4491031-T-C,rs12150808,-1,T,C,4491031,35724,4258699,4651915,232332
18,ENSG00000197705.4,32773023,chr18-32703014-A-G,rs12455936,-1,A,G,32703014,70009,32576415,32969631,126599
18,ENSG00000154832.9,50287692,chr18-50184289-T-A,rs12457149,-1,T,A,50184289,103403,50091084,50484300,93205
18,ENSG00000141644.12,50281523,chr18-50184289-T-A,rs12457149,-1,T,A,50184289,97234,50084915,50478131,99374
18,ENSG00000197563.4,62187056,chr18-62067511-T-C,rs12458329,-1,T,C,62067511,119545,61990448,62383664,77063
18,ENSG00000198081.5,5295726,chr18-5290283-A-G,rs12522,-1,A,G,5290283,5443,5099118,5492334,191165
18,ENSG00000141664.4,62523025,chr18-62428753-T-C,rs12607917,1,T,C,62428753,94272,62326417,62719633,102336
18,ENSG00000134278.9,12658107,chr18-12593637-G-A,rs12955162,-1,G,A,12593637,64470,12461499,12854715,132138
18,ENSG00000175354.11,12884237,chr18-12864763-A-G,rs12955302,-1,A,G,12864763,19474,12687629,13080845,177134
18,ENSG00000172175.7,58671465,chr18-58585107-T-C,rs12956101,1,T,C,58585107,86358,58474857,58868073,110250
18,ENSG00000128789.13,12703042,chr18-12669613-C-A,rs12965990,1,C,A,12669613,33429,12506434,12899650,163179
18,ENSG00000141437.5,31760880,chr18-31576019-T-C,rs1449083,-1,T,C,31576019,184861,31564272,31957488,11747
18,ENSG00000167220.5,47150500,chr18-47147723-C-T,rs16948914,-1,C,T,47147723,2777,46953892,47347108,193831
18,ENSG00000176105.8,812242,chr18-807819-A-G,rs16950778,-1,A,G,807819,4423,615634,1008850,192185
18,ENSG00000153339.8,31943128,chr18-31907056-A-G,rs16962567,-1,A,G,31907056,36072,31746520,32139736,160536
18,ENSG00000134758.8,32091874,chr18-31986219-T-C,rs16962615,1,T,C,31986219,105655,31895266,32288482,90953
18,ENSG00000141391.8,12407929,chr18-12414849-G-C,rs16977185,1,G,C,12414849,6920,12211321,12604537,203528
18,ENSG00000152217.10,44680888,chr18-44834455-G-A,rs16978191,1,G,A,44834455,153567,44484280,44877496,350175
18,ENSG00000132874.6,45615476,chr18-45565606-G-C,rs16978406,1,G,C,45565606,49870,45418868,45812084,146738
18,ENSG00000166342.13,72867987,chr18-72850642-A-G,rs17086478,-1,A,G,72850642,17345,72671379,73064595,179263
18,ENSG00000166347.12,74291963,chr18-74276516-A-G,rs17230973,-1,A,G,74276516,15447,74095355,74488571,181161
18,ENSG00000172466.9,35344420,chr18-35386085-A-G,rs17646608,-1,A,G,35386085,41665,35147812,35541028,238273
18,ENSG00000141425.11,36067559,chr18-36132745-G-A,rs17672308,-1,G,A,36132745,65186,35870951,36264167,261794
18,ENSG00000101558.8,9914016,chr18-9887860-G-A,rs17732496,1,G,A,9887860,26156,9717408,10110624,170452
18,ENSG00000141428.10,35972679,chr18-35989086-A-G,rs17739348,1,A,G,35989086,16407,35776071,36169287,213015
18,ENSG00000141447.11,24397824,chr18-24540972-T-C,rs17798101,-1,T,C,24540972,143148,24201216,24594432,339756
18,ENSG00000150637.3,69947873,chr18-69871588-A-G,rs1788103,-1,A,G,69871588,76285,69751265,70144481,120323
18,ENSG00000134755.9,31102421,chr18-31062163-G-A,rs1790694,-1,G,A,31062163,40258,30905813,31299029,156350
18,ENSG00000118680.7,3262133,chr18-3282221-G-A,rs1791111,1,G,A,3282221,20088,3065525,3458741,216696
18,ENSG00000122490.12,79951653,chr18-79942025-T-C,rs1835410,-1,T,C,79942025,9628,79755045,80148261,186980
18,ENSG00000154845.10,9614559,chr18-9712101-C-T,rs1893126,-1,C,T,9712101,97542,9417951,9811167,294150
18,ENSG00000168461.6,9708301,chr18-9712101-C-T,rs1893126,1,C,T,9712101,3800,9511693,9904909,200408
18,ENSG00000176890.10,657653,chr18-675787-C-T,rs2260821,1,C,T,675787,18134,461045,854261,214742
18,ENSG00000066926.5,57586702,chr18-57571588-A-G,rs2272783,-1,A,G,57571588,15114,57390094,57783310,181494
18,ENSG00000158270.9,500701,chr18-475530-A-T,rs2621165,-1,A,T,475530,25171,304093,697309,171437
18,ENSG00000158270.9,500701,chr18-475530-A-C,rs2621165,-1,A,C,475530,25171,304093,697309,171437
18,ENSG00000175322.5,14132435,chr18-14058311-C-A,rs2869796,-1,C,A,14058311,74124,13935827,14329043,122484
18,ENSG00000101544.4,80109262,chr18-80197495-C-T,rs2886235,1,C,T,80197495,88233,79912654,80305870,284841
18,ENSG00000186496.4,35377337,chr18-35384085-C-T,rs2978360,-1,C,T,35384085,6748,35180729,35573945,203356
18,ENSG00000141429.6,35581740,chr18-35480279-A-G,rs355319,1,A,G,35480279,101461,35385132,35778348,95147
18,ENSG00000153391.9,35497960,chr18-35499248-T-C,rs355338,-1,T,C,35499248,1288,35301352,35694568,197896
18,ENSG00000101605.7,3219968,chr18-3246393-C-G,rs3819221,-1,C,G,3246393,26425,3023360,3416576,223033
18,ENSG00000075336.6,74148523,chr18-74078811-C-T,rs41472344,1,C,T,74078811,69712,73951915,74345131,126896
18,ENSG00000101654.11,13726673,chr18-13726082-G-A,rs4393641,1,G,A,13726082,591,13530065,13923281,196017
18,ENSG00000091157.7,56651359,chr18-56698232-T-C,rs475035,1,T,C,56698232,46873,56454751,56847967,243481
18,ENSG00000178184.10,80247514,chr18-80187442-T-C,rs4799141,-1,T,C,80187442,60072,80050906,80444122,136536
18,ENSG00000179981.8,75210797,chr18-75262352-T-C,rs4891252,1,T,C,75262352,51555,75014189,75407405,248163
18,ENSG00000167315.10,49813533,chr18-49619613-A-G,rs4939879,-1,A,G,49619613,193920,49616925,50010141,2688
18,ENSG00000130856.10,76822557,chr18-76886452-C-T,rs517637,1,C,T,76886452,63895,76625949,77019165,260503
18,ENSG00000166974.5,35041413,chr18-35158096-C-T,rs537695,1,C,T,35158096,116683,34844805,35238021,313291
18,ENSG00000150636.10,68798080,chr18-68837691-G-A,rs567495,1,G,A,68837691,39611,68601472,68994688,236219
18,ENSG00000141404.7,11689264,chr18-11794052-A-G,rs58144032,1,A,G,11794052,104788,11492656,11885872,301396
18,ENSG00000154889.11,11908317,chr18-11887658-G-A,rs593713,-1,G,A,11887658,20659,11711709,12104925,175949
18,ENSG00000255112.1,11851413,chr18-11882269-T-A,rs602201,1,T,A,11882269,30856,11654805,12048021,227464
18,ENSG00000134759.9,36129899,chr18-36178473-A-G,rs610492,1,A,G,36178473,48574,35933291,36326507,245182
18,ENSG00000134762.11,31042742,chr18-31069009-C-T,rs61731921,-1,C,T,31069009,26267,30846134,31239350,222875
18,ENSG00000134762.11,31042742,chr18-31069009-C-A,rs61731921,-1,C,A,31069009,26267,30846134,31239350,222875
18,ENSG00000101577.4,3013144,chr18-2946835-T-A,rs641287,-1,T,A,2946835,66309,2816536,3209752,130299
18,ENSG00000134265.6,10526027,chr18-10525521-G-C,rs649777,1,G,C,10525521,506,10329419,10722635,196102
18,ENSG00000101639.11,12991362,chr18-12976468-G-T,rs6505774,1,G,T,12976468,14894,12794754,13187970,181714
18,ENSG00000154839.4,50375046,chr18-50335486-G-A,rs6650676,1,G,A,50335486,39560,50178438,50571654,157048
18,ENSG00000152240.4,46104385,chr18-46114173-A-C,rs7226736,1,A,C,46114173,9788,45907777,46300993,206396
18,ENSG00000101596.8,2655726,chr18-2641859-C-T,rs7229070,1,C,T,2641859,13867,2459118,2852334,182741
18,ENSG00000170677.4,70289045,chr18-70266469-G-A,rs7240210,1,G,A,70266469,22576,70092437,70485653,174032
18,ENSG00000167216.10,46917602,chr18-46776717-T-G,rs7240457,1,T,G,46776717,140885,46720994,47114210,55723
18,ENSG00000166562.3,59139884,chr18-59141274-G-A,rs7241012,1,G,A,59141274,1390,58943276,59336492,197998
18,ENSG00000078142.4,41955234,chr18-41978622-G-T,rs7242727,1,G,T,41978622,23388,41758626,42151842,219996
18,ENSG00000078142.4,41955234,chr18-41978622-G-A,rs7242727,1,G,A,41978622,23388,41758626,42151842,219996
18,ENSG00000101489.10,37565798,chr18-37495287-A-G,rs72891035,-1,A,G,37495287,70511,37369190,37762406,126097
18,ENSG00000152234.7,46098296,chr18-46099143-T-C,rs72903438,-1,T,C,46099143,847,45901688,46294904,197455
18,ENSG00000046604.7,31498177,chr18-31493410-C-T,rs72938851,1,C,T,31493410,4767,31301569,31694785,191841
18,ENSG00000101493.6,76495242,chr18-76461482-A-C,rs72982096,-1,A,C,76461482,33760,76298634,76691850,162848
18,ENSG00000101746.9,34224913,chr18-34357672-C-T,rs76234118,-1,C,T,34357672,132759,34028305,34421521,329367
18,ENSG00000101574.9,2571505,chr18-2533131-T-C,rs770224,-1,T,C,2533131,38374,2374897,2768113,158234
18,ENSG00000049759.11,58044226,chr18-58067418-T-C,rs79642458,1,T,C,58067418,23192,57847618,58240834,219800
18,ENSG00000141434.6,32190039,chr18-32013940-A-G,rs8083251,1,A,G,32013940,176099,31993431,32386647,20509
18,ENSG00000154040.15,24139062,chr18-24118576-C-T,rs8083625,1,C,T,24118576,20486,23942454,24335670,176122
18,ENSG00000133313.9,74496363,chr18-74510230-A-G,rs8084058,1,A,G,74510230,13867,74299755,74692971,210475
18,ENSG00000226742.2,79964643,chr18-79986623-T-C,rs8086024,1,T,C,79986623,21980,79768035,80161251,218588
18,ENSG00000186814.5,35290229,chr18-35291918-C-T,rs8089948,-1,C,T,35291918,1689,35093621,35486837,198297
18,ENSG00000197046.4,45825675,chr18-45830415-G-A,rs894050,1,G,A,45830415,4740,45629067,46022283,201348
18,ENSG00000197046.4,45825675,chr18-45830415-G-T,rs894050,1,G,T,45830415,4740,45629067,46022283,201348
18,ENSG00000132205.5,2847006,chr18-2856484-C-A,rs894761,1,C,A,2856484,9478,2650398,3043614,206086
18,ENSG00000101745.9,9136781,chr18-8984512-C-T,rs9304026,1,C,T,8984512,152269,8940173,9333389,44339
18,ENSG00000079134.6,268047,chr18-165503-G-A,rs948263,-1,G,A,165503,102544,71439,464655,94064
18,ENSG00000141452.3,23503511,chr18-23502740-T-C,rs9954865,1,T,C,23502740,771,23306903,23700119,195837
18,ENSG00000141469.9,45724181,chr18-45692233-T-C,rs9959467,1,T,C,45692233,31948,45527573,45920789,164660
18,ENSG00000141384.6,26226445,chr18-26201546-A-G,rs10468885,1,A,G,26201546,24899,26029837,26423053,171709
18,ENSG00000141469.9,45724181,chr18-45708779-T-C,rs10502869,1,T,C,45708779,15402,45527573,45920789,181206
18,ENSG00000085415.10,12948011,chr18-12962000-G-A,rs11080616,1,G,A,12962000,13989,12751403,13144619,210597
18,ENSG00000198796.5,58629091,chr18-58564676-C-T,rs111521599,-1,C,T,58564676,64415,58432483,58825699,132193
18,ENSG00000186812.6,35241034,chr18-35204982-C-T,rs11662050,1,C,T,35204982,36052,35044426,35437642,160556
18,ENSG00000101752.6,21740792,chr18-21721947-A-G,rs11662591,1,A,G,21721947,18845,21544184,21937400,177763
18,ENSG00000101782.9,23453287,chr18-23553973-G-A,rs11663558,1,G,A,23553973,100686,23256679,23649895,297294
18,ENSG00000141452.3,23503511,chr18-23553973-G-A,rs11663558,1,G,A,23553973,50462,23306903,23700119,247070
18,ENSG00000134504.7,26548553,chr18-26464023-C-A,rs117338826,-1,C,A,26464023,84530,26351945,26745161,112078
18,ENSG00000141424.6,36129340,chr18-36060616-G-A,rs118148296,-1,G,A,36060616,68724,35932732,36325948,127884
18,ENSG00000168461.6,9708301,chr18-9728231-C-T,rs11877030,1,C,T,9728231,19930,9511693,9904909,216538
18,ENSG00000196628.7,55588192,chr18-55629992-G-A,rs12104073,-1,G,A,55629992,41800,55391584,55784800,238408
18,ENSG00000134444.8,62187255,chr18-62161754-A-G,rs12327015,1,A,G,62161754,25501,61990647,62383863,171107
18,ENSG00000101546.7,80034434,chr18-79918327-A-G,rs12454768,1,A,G,79918327,116107,79837826,80231042,80501
18,ENSG00000153391.9,35497960,chr18-35462473-G-C,rs12962513,-1,G,C,35462473,35487,35301352,35694568,161121
18,ENSG00000177426.14,3450172,chr18-3594106-C-G,rs12967944,1,C,G,3594106,143934,3253564,3646780,340542
18,ENSG00000134755.9,31102421,chr18-31190267-C-T,rs16961417,-1,C,T,31190267,87846,30905813,31299029,284454
18,ENSG00000134755.9,31102421,chr18-31190267-C-G,rs16961417,-1,C,G,31190267,87846,30905813,31299029,284454
18,ENSG00000172466.9,35344420,chr18-35366968-G-A,rs16966700,-1,G,A,35366968,22548,35147812,35541028,219156
18,ENSG00000134265.6,10526027,chr18-10531109-A-G,rs16974725,1,A,G,10531109,5082,10329419,10722635,201690
18,ENSG00000166401.9,63970081,chr18-64056205-T-G,rs17072514,1,T,G,64056205,86124,63773473,64166689,282732
18,ENSG00000166401.9,63970081,chr18-64056205-T-C,rs17072514,1,T,C,64056205,86124,63773473,64166689,282732
18,ENSG00000101577.4,3013144,chr18-2943797-C-G,rs17556090,-1,C,G,2943797,69347,2816536,3209752,127261
18,ENSG00000082212.6,50879118,chr18-51063348-T-C,rs17663887,1,T,C,51063348,184230,50682510,51075726,380838
18,ENSG00000101638.7,46757053,chr18-46761613-C-T,rs17707231,-1,C,T,46761613,4560,46560445,46953661,201168
18,ENSG00000101695.3,32018825,chr18-32033272-G-C,rs17718949,1,G,C,32033272,14447,31822217,32215433,211055
18,ENSG00000141639.6,50560087,chr18-50557151-C-T,rs17741772,1,C,T,50557151,2936,50363479,50756695,193672
18,ENSG00000183287.7,59697423,chr18-59874574-G-A,rs17771727,-1,G,A,59874574,177151,59500815,59894031,373759
18,ENSG00000242550.1,63907958,chr18-63775676-G-A,rs17781440,1,G,A,63775676,132282,63711350,64104566,64326
18,ENSG00000150637.3,69947873,chr18-69873132-T-G,rs1788101,-1,T,G,69873132,74741,69751265,70144481,121867
18,ENSG00000066926.5,57586702,chr18-57568045-T-C,rs1790619,-1,T,C,57568045,18657,57390094,57783310,177951
18,ENSG00000101608.5,3247801,chr18-3342153-T-G,rs1822435,1,T,G,3342153,94352,3051193,3444409,290960
18,ENSG00000133313.9,74496363,chr18-74501373-G-A,rs2303463,1,G,A,74501373,5010,74299755,74692971,201618
18,ENSG00000101574.9,2571505,chr18-2571847-A-G,rs2677895,-1,A,G,2571847,342,2374897,2768113,196950
18,ENSG00000221887.4,63949301,chr18-63853127-T-C,rs2689416,1,T,C,63853127,96174,63752693,64145909,100434
18,ENSG00000132874.6,45615476,chr18-45724638-G-A,rs28994269,1,G,A,45724638,109162,45418868,45812084,305770
18,ENSG00000134440.6,57621836,chr18-57671424-G-A,rs317838,-1,G,A,57671424,49588,57425228,57818444,246196
18,ENSG00000101544.4,80109262,chr18-79915085-T-C,rs35025619,1,T,C,79915085,194177,79912654,80305870,2431
18,ENSG00000101605.7,3219968,chr18-3254660-C-T,rs3786457,-1,C,T,3254660,34692,3023360,3416576,231300
18,ENSG00000154040.15,24139062,chr18-24129035-G-A,rs3816822,1,G,A,24129035,10027,23942454,24335670,186581
18,ENSG00000154845.10,9614559,chr18-9704772-C-G,rs3897633,-1,C,G,9704772,90213,9417951,9811167,286821
18,ENSG00000141682.10,59899996,chr18-59909081-C-T,rs4447521,1,C,T,59909081,9085,59703388,60096604,205693
18,ENSG00000166342.13,72867987,chr18-72948516-G-T,rs4516317,-1,G,T,72948516,80529,72671379,73064595,277137
18,ENSG00000141759.9,79988563,chr18-80035232-A-T,rs4644918,-1,A,T,80035232,46669,79791955,80185171,243277
18,ENSG00000118680.7,3262133,chr18-3363597-T-C,rs4798085,1,T,C,3363597,101464,3065525,3458741,298072
18,ENSG00000134758.8,32091874,chr18-32159267-A-G,rs4799636,1,A,G,32159267,67393,31895266,32288482,264001
18,ENSG00000171791.9,63319769,chr18-63126688-T-C,rs4987852,-1,T,C,63126688,193081,63123161,63516377,3527
18,ENSG00000167216.10,46917602,chr18-46787116-A-G,rs545344,1,A,G,46787116,130486,46720994,47114210,66122
18,ENSG00000178342.3,79797938,chr18-79755031-G-A,rs58190761,1,G,A,79755031,42907,79601330,79994546,153701
18,ENSG00000176014.6,12308241,chr18-12280923-A-G,rs6505744,1,A,G,12280923,27318,12111633,12504849,169290
18,ENSG00000178184.10,80247514,chr18-80144701-C-G,rs6506810,-1,C,G,80144701,102813,80050906,80444122,93795
18,ENSG00000178184.10,80247514,chr18-80144701-C-T,rs6506810,-1,C,T,80144701,102813,80050906,80444122,93795
18,ENSG00000154839.4,50375046,chr18-50547611-C-A,rs6508005,1,C,A,50547611,172565,50178438,50571654,369173
18,ENSG00000168234.6,24014754,chr18-23988403-C-T,rs6508073,1,C,T,23988403,26351,23818146,24211362,170257
18,ENSG00000179981.8,75210797,chr18-75345377-G-T,rs6566083,1,G,T,75345377,134580,75014189,75407405,331188
18,ENSG00000079134.6,268047,chr18-182139-A-G,rs692846,-1,A,G,182139,85908,71439,464655,110700
18,ENSG00000226742.2,79964643,chr18-79935384-T-A,rs7230837,1,T,A,79935384,29259,79768035,80161251,167349
18,ENSG00000134049.3,47176364,chr18-47277739-A-C,rs7231801,-1,A,C,47277739,101375,46979756,47372972,297983
18,ENSG00000141665.6,74147834,chr18-73957932-T-C,rs7233034,-1,T,C,73957932,189902,73951226,74344442,6706
18,ENSG00000131196.11,79395930,chr18-79303413-A-C,rs7233974,1,A,C,79303413,92517,79199322,79592538,104091
18,ENSG00000166562.3,59139884,chr18-59204946-G-A,rs7244741,1,G,A,59204946,65062,58943276,59336492,261670
18,ENSG00000134759.9,36129899,chr18-36032866-T-C,rs7245183,1,T,C,36032866,97033,35933291,36326507,99575
18,ENSG00000075643.3,36187497,chr18-36211841-G-A,rs73430987,1,G,A,36211841,24344,35990889,36384105,220952
18,ENSG00000075643.3,36187497,chr18-36211841-G-T,rs73430987,1,G,T,36211841,24344,35990889,36384105,220952
18,ENSG00000152240.4,46104385,chr18-46209054-T-C,rs74427086,1,T,C,46209054,104669,45907777,46300993,301277
18,ENSG00000101624.5,12702723,chr18-12568203-T-C,rs78167074,-1,T,C,12568203,134520,12506115,12899331,62088
18,ENSG00000180011.5,75209139,chr18-75172515-G-A,rs787583,-1,G,A,75172515,36624,75012531,75405747,159984
18,ENSG00000168675.12,13278105,chr18-13471200-C-T,rs8084766,1,C,T,13471200,193095,13081497,13474713,389703
18,ENSG00000128791.6,9334773,chr18-9264692-A-G,rs8086519,1,A,G,9264692,70081,9138165,9531381,126527
18,ENSG00000167315.10,49813533,chr18-49748969-T-C,rs8087313,-1,T,C,49748969,64564,49616925,50010141,132044
18,ENSG00000078142.4,41955234,chr18-41805374-T-C,rs8087509,1,T,C,41805374,149860,41758626,42151842,46748
18,ENSG00000122490.12,79951653,chr18-80068684-C-G,rs8094631,-1,C,G,80068684,117031,79755045,80148261,313639
18,ENSG00000130856.10,76822557,chr18-76690378-G-T,rs8095258,1,G,T,76690378,132179,76625949,77019165,64429
18,ENSG00000130856.10,76822557,chr18-76690378-G-A,rs8095258,1,G,A,76690378,132179,76625949,77019165,64429
18,ENSG00000082397.10,5543997,chr18-5651994-T-G,rs8096594,-1,T,G,5651994,107997,5347389,5740605,304605
18,ENSG00000186814.5,35290229,chr18-35370092-A-G,rs8096611,-1,A,G,35370092,79863,35093621,35486837,276471
18,ENSG00000170677.4,70289045,chr18-70321790-T-C,rs8097573,1,T,C,70321790,32745,70092437,70485653,229353
18,ENSG00000141391.8,12407929,chr18-12446690-G-T,rs919,1,G,T,12446690,38761,12211321,12604537,235369
18,ENSG00000141380.8,26090613,chr18-26091223-G-A,rs994729,-1,G,A,26091223,610,25894005,26287221,197218
18,ENSG00000176624.8,51197681,chr18-51140256-A-G,rs9949574,-1,A,G,51140256,57425,51001073,51394289,139183
18,ENSG00000119541.4,63422476,chr18-63457686-G-A,rs9965098,-1,G,A,63457686,35210,63225868,63619084,231818
18,ENSG00000166974.5,35041413,chr18-34925737-C-A,rs9967275,1,C,A,34925737,115676,34844805,35238021,80932
18,ENSG00000154889.11,11908317,chr18-11884938-C-T,rs10083973,-1,C,T,11884938,23379,11711709,12104925,173229
18,ENSG00000154059.4,24426670,chr18-24451000-C-T,rs10502446,1,C,T,24451000,24330,24230062,24623278,220938
18,ENSG00000221887.4,63949301,chr18-63809220-G-T,rs10503087,1,G,T,63809220,140081,63752693,64145909,56527
18,ENSG00000141664.4,62523025,chr18-62586528-C-T,rs1052315,1,C,T,62586528,63503,62326417,62719633,260111
18,ENSG00000132199.11,712630,chr18-674440-A-C,rs11081251,-1,A,C,674440,38190,516022,909238,158418
18,ENSG00000141429.6,35581740,chr18-35468437-A-G,rs11659769,1,A,G,35468437,113303,35385132,35778348,83305
18,ENSG00000134779.8,36829002,chr18-36753989-A-G,rs11660592,-1,A,G,36753989,75013,36632394,37025610,121595
18,ENSG00000158201.4,21704774,chr18-21681452-C-T,rs11662721,-1,C,T,21681452,23322,21508166,21901382,173286
18,ENSG00000074657.8,58864877,chr18-58933140-G-T,rs117001517,1,G,T,58933140,68263,58668269,59061485,264871
18,ENSG00000130856.10,76822557,chr18-76946479-G-T,rs118181340,1,G,T,76946479,123922,76625949,77019165,320530
18,ENSG00000177426.14,3450172,chr18-3597840-C-T,rs12455764,1,C,T,3597840,147668,3253564,3646780,344276
18,ENSG00000141622.7,46334018,chr18-46422305-C-A,rs12607419,1,C,A,46422305,88287,46137410,46530626,284895
18,ENSG00000122490.12,79951653,chr18-79956624-G-A,rs12953577,-1,G,A,79956624,4971,79755045,80148261,201579
18,ENSG00000128789.13,12703042,chr18-12593637-G-A,rs12955162,1,G,A,12593637,109405,12506434,12899650,87203
18,ENSG00000176014.6,12308241,chr18-12345823-C-A,rs12956849,1,C,A,12345823,37582,12111633,12504849,234190
18,ENSG00000074695.4,59359265,chr18-59429370-G-A,rs1444485,-1,G,A,59429370,70105,59162657,59555873,266713
18,ENSG00000141384.6,26226445,chr18-26191911-A-G,rs16942191,1,A,G,26191911,34534,26029837,26423053,162074
18,ENSG00000168502.12,8717371,chr18-8794094-T-G,rs16954178,1,T,G,8794094,76723,8520763,8913979,273331
18,ENSG00000101695.3,32018825,chr18-32195735-A-G,rs16962793,1,A,G,32195735,176910,31822217,32215433,373518
18,ENSG00000141404.7,11689264,chr18-11561843-T-C,rs16976488,1,T,C,11561843,127421,11492656,11885872,69187
18,ENSG00000134046.6,54224669,chr18-54331827-A-G,rs17470798,-1,A,G,54331827,107158,54028061,54421277,303766
18,ENSG00000141391.8,12407929,chr18-12470602-G-A,rs17615158,1,G,A,12470602,62673,12211321,12604537,259281
18,ENSG00000141469.9,45724181,chr18-45660866-G-A,rs17670646,1,G,A,45660866,63315,45527573,45920789,133293
18,ENSG00000049759.11,58044226,chr18-58228556-A-G,rs192659,1,A,G,58228556,184330,57847618,58240834,380938
18,ENSG00000134769.14,34710298,chr18-34526454-A-G,rs1962503,1,A,G,34526454,183844,34513690,34906906,12764
18,ENSG00000166562.3,59139884,chr18-59153086-G-T,rs2085632,1,G,T,59153086,13202,58943276,59336492,209810
18,ENSG00000166401.9,63970081,chr18-63880584-C-T,rs2114382,1,C,T,63880584,89497,63773473,64166689,107111
18,ENSG00000177576.5,49487234,chr18-49575632-T-C,rs2276269,-1,T,C,49575632,88398,49290626,49683842,285006
18,ENSG00000179981.8,75210797,chr18-75276950-G-T,rs2581642,1,G,T,75276950,66153,75014189,75407405,262761
18,ENSG00000101639.11,12991362,chr18-12817816-A-G,rs2847286,1,A,G,12817816,173546,12794754,13187970,23062
18,ENSG00000186496.4,35377337,chr18-35391071-A-G,rs2909352,-1,A,G,35391071,13734,35180729,35573945,210342
18,ENSG00000133313.9,74496363,chr18-74507221-C-T,rs36089221,1,C,T,74507221,10858,74299755,74692971,207466
18,ENSG00000066926.5,57586702,chr18-57620295-C-T,rs3745063,-1,C,T,57620295,33593,57390094,57783310,230201
18,ENSG00000167216.10,46917602,chr18-46729818-C-T,rs3893060,1,C,T,46729818,187784,46720994,47114210,8824
18,ENSG00000168461.6,9708301,chr18-9704772-C-G,rs3897633,1,C,G,9704772,3529,9511693,9904909,193079
18,ENSG00000082397.10,5543997,chr18-5361053-G-C,rs3928990,-1,G,C,5361053,182944,5347389,5740605,13664
18,ENSG00000215421.4,74597870,chr18-74560889-G-A,rs4263028,1,G,A,74560889,36981,74401262,74794478,159627
18,ENSG00000166377.13,79069394,chr18-79057565-C-G,rs474539,1,C,G,79057565,11829,78872786,79266002,184779
18,ENSG00000118680.7,3262133,chr18-3380117-C-T,rs4797108,1,C,T,3380117,117984,3065525,3458741,314592
18,ENSG00000154040.15,24139062,chr18-24142734-G-A,rs4800550,1,G,A,24142734,3672,23942454,24335670,200280
18,ENSG00000197046.4,45825675,chr18-45834764-T-C,rs490696,1,T,C,45834764,9089,45629067,46022283,205697
18,ENSG00000186812.6,35241034,chr18-35064562-A-G,rs535547,1,A,G,35064562,176472,35044426,35437642,20136
18,ENSG00000141385.3,12377227,chr18-12474506-A-G,rs548598,-1,A,G,12474506,97279,12180619,12573835,293887
18,ENSG00000101751.5,54269517,chr18-54218564-T-C,rs570867,1,T,C,54218564,50953,54072909,54466125,145655
18,ENSG00000158270.9,500701,chr18-526548-G-A,rs62088175,-1,G,A,526548,25847,304093,697309,222455
18,ENSG00000226742.2,79964643,chr18-79933268-G-A,rs62101198,1,G,A,79933268,31375,79768035,80161251,165233
18,ENSG00000141759.9,79988563,chr18-79933268-G-A,rs62101198,-1,G,A,79933268,55295,79791955,80185171,141313
18,ENSG00000132205.5,2847006,chr18-2887593-C-T,rs678805,1,C,T,2887593,40587,2650398,3043614,237195
18,ENSG00000170677.4,70289045,chr18-70293168-G-C,rs713129,1,G,C,70293168,4123,70092437,70485653,200731
18,ENSG00000178184.10,80247514,chr18-80066306-G-A,rs7227096,-1,G,A,80066306,181208,80050906,80444122,15400
18,ENSG00000080986.6,2571557,chr18-2593663-G-A,rs7233405,1,G,A,2593663,22106,2374949,2768165,218714
18,ENSG00000119541.4,63422476,chr18-63607897-A-G,rs7233652,-1,A,G,63607897,185421,63225868,63619084,382029
18,ENSG00000101557.8,158557,chr18-286176-A-G,rs7240209,1,A,G,286176,127619,-38051,355165,324227
18,ENSG00000101574.9,2571505,chr18-2594550-T-C,rs7244453,-1,T,C,2594550,23045,2374897,2768113,219653
18,ENSG00000180011.5,75209139,chr18-75076670-A-G,rs7359804,-1,A,G,75076670,132469,75012531,75405747,64139
18,ENSG00000141644.12,50281523,chr18-50181937-T-C,rs76182653,-1,T,C,50181937,99586,50084915,50478131,97022
18,ENSG00000154832.9,50287692,chr18-50181937-T-C,rs76182653,-1,T,C,50181937,105755,50091084,50484300,90853
18,ENSG00000152240.4,46104385,chr18-46276761-G-A,rs77784260,1,G,A,46276761,172376,45907777,46300993,368984
18,ENSG00000101670.5,49562057,chr18-49692045-C-T,rs8084139,1,C,T,49692045,129988,49365449,49758665,326596
18,ENSG00000141424.6,36129340,chr18-36130014-G-C,rs8084554,-1,G,C,36130014,674,35932732,36325948,197282
18,ENSG00000172175.7,58671465,chr18-58562395-A-T,rs8090585,1,A,T,58562395,109070,58474857,58868073,87538
18,ENSG00000141380.8,26090613,chr18-25961494-G-A,rs8091309,-1,G,A,25961494,129119,25894005,26287221,67489
18,ENSG00000085415.10,12948011,chr18-12774982-A-G,rs888271,1,A,G,12774982,173029,12751403,13144619,23579
18,ENSG00000177150.7,13726558,chr18-13865248-G-A,rs9303794,-1,G,A,13865248,138690,13529950,13923166,335298
18,ENSG00000141434.6,32190039,chr18-32011581-G-A,rs9947471,1,G,A,32011581,178458,31993431,32386647,18150
17,ENSG00000108823.11,50166005,chr17-50136769-C-A,rs1007558,1,C,A,50136769,29236,49969397,50362613,167372
17,ENSG00000154258.10,69060927,chr17-69206390-T-C,rs1011789,-1,T,C,69206390,145463,68864319,69257535,342071
17,ENSG00000108666.4,32342173,chr17-32331987-T-A,rs1019152,-1,T,A,32331987,10186,32145565,32538781,186422
17,ENSG00000166260.6,54968654,chr17-55078305-C-T,rs1026961,-1,C,T,55078305,109651,54772046,55165262,306259
17,ENSG00000108852.10,43907536,chr17-43916513-C-G,rs1035284,-1,C,G,43916513,8977,43710928,44104144,205585
17,ENSG00000196689.6,3609411,chr17-3544620-C-T,rs1039519,-1,C,T,3544620,64791,3412803,3806019,131817
17,ENSG00000108518.7,4948530,chr17-5088399-T-C,rs10438722,-1,T,C,5088399,139869,4751922,5145138,336477
17,ENSG00000120063.4,65056740,chr17-65001905-C-T,rs10853057,-1,C,T,65001905,54835,64860132,65253348,141773
17,ENSG00000133030.12,17042457,chr17-17105884-T-C,rs11078372,1,T,C,17105884,63427,16845849,17239065,260035
17,ENSG00000205544.3,7404097,chr17-7407154-A-C,rs11078674,-1,A,C,7407154,3057,7207489,7600705,199665
17,ENSG00000129226.8,7579638,chr17-7487376-T-C,rs11078681,1,T,C,7487376,92262,7383030,7776246,104346
17,ENSG00000109063.7,10657309,chr17-10682706-T-C,rs11078857,-1,T,C,10682706,25397,10460701,10853917,222005
17,ENSG00000167100.10,50130160,chr17-49980509-G-A,rs11079881,-1,G,A,49980509,149651,49933552,50326768,46957
17,ENSG00000109084.8,28319200,chr17-28318965-G-A,rs11080054,1,G,A,28318965,235,28122592,28515808,196373
17,ENSG00000166750.4,35243072,chr17-35244527-G-A,rs11080327,1,G,A,35244527,1455,35046464,35439680,198063
17,ENSG00000142494.7,19533854,chr17-19695170-G-A,rs111233471,1,G,A,19695170,161316,19337246,19730462,357924
17,ENSG00000214087.4,81683797,chr17-81671775-C-T,rs11150805,-1,C,T,81671775,12022,81487189,81880405,184586
17,ENSG00000187624.7,410325,chr17-409857-G-A,rs11150882,1,G,A,409857,468,213717,606933,196140
17,ENSG00000074356.11,3846246,chr17-3750465-C-T,rs112808026,-1,C,T,3750465,95781,3649638,4042854,100827
17,ENSG00000006025.6,47821794,chr17-47891962-C-T,rs112811776,-1,C,T,47891962,70168,47625186,48018402,266776
17,ENSG00000004142.6,28357527,chr17-28394772-C-A,rs1128162,-1,C,A,28394772,37245,28160919,28554135,233853
17,ENSG00000173801.11,41786711,chr17-41917616-G-A,rs112918580,-1,G,A,41917616,130905,41590103,41983319,327513
17,ENSG00000141551.9,82273700,chr17-82239473-G-A,rs1131633,-1,G,A,82239473,34227,82077092,82470308,162381
17,ENSG00000177302.7,18314994,chr17-18148792-G-A,rs114274755,-1,G,A,18148792,166202,18118386,18511602,30406
17,ENSG00000175711.4,83051770,chr17-83048511-G-A,rs1143006,-1,G,A,83048511,3259,82855162,83248378,193349
17,ENSG00000121060.10,56914049,chr17-56889444-A-G,rs11540270,-1,A,G,56889444,24605,56717441,57110657,172003
17,ENSG00000177303.4,75515537,chr17-75506555-T-C,rs115438731,-1,T,C,75506555,8982,75318929,75712145,187626
17,ENSG00000161920.5,4731428,chr17-4635876-G-T,rs11568113,1,G,T,4635876,95552,4534820,4928036,101056
17,ENSG00000007171.11,27800529,chr17-27923083-G-T,rs1157502,-1,G,T,27923083,122554,27603921,27997137,319162
17,ENSG00000176155.10,82212819,chr17-82311594-C-T,rs116065945,-1,C,T,82311594,98775,82016211,82409427,295383
17,ENSG00000136449.9,50508439,chr17-50504915-G-A,rs11649849,1,G,A,50504915,3524,50311831,50705047,193084
17,ENSG00000141219.10,73232433,chr17-73180195-C-T,rs11650133,1,C,T,73180195,52238,73035825,73429041,144370
17,ENSG00000205045.3,35537678,chr17-35537613-A-G,rs11650473,-1,A,G,35537613,65,35341070,35734286,196543
17,ENSG00000075461.4,66964707,chr17-67036944-A-G,rs11650741,1,A,G,67036944,72237,66768099,67161315,268845
17,ENSG00000176749.3,32486993,chr17-32516592-G-A,rs11651743,1,G,A,32516592,29599,32290385,32683601,226207
17,ENSG00000236383.1,43228623,chr17-43179443-G-A,rs11653231,-1,G,A,43179443,49180,43032015,43425231,147428
17,ENSG00000108924.7,55264960,chr17-55330231-A-G,rs11657291,1,A,G,55330231,65271,55068352,55461568,261879
17,ENSG00000072210.12,19648751,chr17-19709632-T-C,rs11657623,1,T,C,19709632,60881,19452143,19845359,257489
17,ENSG00000108406.4,59565610,chr17-59526143-A-G,rs11658504,1,A,G,59526143,39467,59369002,59762218,157141
17,ENSG00000181408.2,82371765,chr17-82311161-C-T,rs117247165,1,C,T,82311161,60604,82175157,82568373,136004
17,ENSG00000161664.1,44170704,chr17-44206926-C-T,rs117467674,1,C,T,44206926,36222,43974096,44367312,232830
17,ENSG00000154262.7,69141895,chr17-69063421-G-T,rs117519040,-1,G,T,69063421,78474,68945287,69338503,118134
17,ENSG00000189120.2,47851163,chr17-47748018-A-G,rs117549066,-1,A,G,47748018,103145,47654555,48047771,93463
17,ENSG00000173894.6,79778148,chr17-79723452-G-A,rs117605502,1,G,A,79723452,54696,79581540,79974756,141912
17,ENSG00000132382.9,4555384,chr17-4555340-C-T,rs117790724,-1,C,T,4555340,44,4358776,4751992,196564
17,ENSG00000132382.9,4555384,chr17-4555340-C-G,rs117790724,-1,C,G,4555340,44,4358776,4751992,196564
17,ENSG00000179859.7,7916289,chr17-7834780-C-T,rs117899186,-1,C,T,7834780,81509,7719681,8112897,115099
17,ENSG00000108702.2,34363233,chr17-34502465-A-C,rs118003219,-1,A,C,34502465,139232,34166625,34559841,335840
17,ENSG00000256618.1,22523415,chr17-22683802-C-T,rs118171966,1,C,T,22683802,160387,22326807,22720023,356995
17,ENSG00000185504.11,81552353,chr17-81544353-G-A,rs11869448,-1,G,A,81544353,8000,81355745,81748961,188608
17,ENSG00000161905.7,4641678,chr17-4654394-G-A,rs11870424,-1,G,A,4654394,12716,4445070,4838286,209324
17,ENSG00000141480.12,4710632,chr17-4654394-G-A,rs11870424,1,G,A,4654394,56238,4514024,4907240,140370
17,ENSG00000129657.8,77140969,chr17-77168804-A-G,rs11871056,1,A,G,77168804,27835,76944361,77337577,224443
17,ENSG00000065559.7,12020877,chr17-11965045-A-G,rs12449769,1,A,G,11965045,55832,11824269,12217485,140776
17,ENSG00000168961.11,27631188,chr17-27637753-C-T,rs12449977,1,C,T,27637753,6565,27434580,27827796,203173
17,ENSG00000171298.8,80101581,chr17-80102793-A-C,rs12450199,1,A,C,80102793,1212,79904973,80298189,197820
17,ENSG00000185359.7,81684011,chr17-81715184-G-A,rs12452231,1,G,A,81715184,31173,81487403,81880619,227781
17,ENSG00000154945.6,50707914,chr17-50747561-T-C,rs12452333,-1,T,C,50747561,39647,50511306,50904522,236255
17,ENSG00000141540.5,74213571,chr17-74239422-C-A,rs12452652,1,C,A,74239422,25851,74016963,74410179,222459
17,ENSG00000121053.4,58192726,chr17-58192760-T-C,rs12602891,1,T,C,58192760,34,57996118,58389334,196642
17,ENSG00000005100.8,5468982,chr17-5444636-A-T,rs12603094,-1,A,T,5444636,24346,5272374,5665590,172262
17,ENSG00000136492.3,61863528,chr17-61856635-A-C,rs12603878,-1,A,C,61856635,6893,61666920,62060136,189715
17,ENSG00000262814.1,81703367,chr17-81540246-G-A,rs12675,1,G,A,81540246,163121,81506759,81899975,33487
17,ENSG00000189050.9,59964740,chr17-59856808-A-G,rs1292043,-1,A,G,59856808,107932,59768132,60161348,88676
17,ENSG00000172057.4,39927601,chr17-39872867-C-G,rs12936231,-1,C,G,39872867,54734,39730993,40124209,141874
17,ENSG00000181031.11,352807,chr17-218895-G-C,rs12941133,-1,G,C,218895,133912,156199,549415,62696
17,ENSG00000136451.3,57988254,chr17-57915502-T-C,rs12941179,-1,T,C,57915502,72752,57791646,58184862,123856
17,ENSG00000177469.10,42423256,chr17-42386961-A-T,rs12947808,-1,A,T,42386961,36295,42226648,42619864,160313
17,ENSG00000141456.9,4704137,chr17-4789759-G-A,rs12951761,-1,G,A,4789759,85622,4507529,4900745,282230
17,ENSG00000154263.11,69228824,chr17-69187535-C-G,rs12953127,-1,C,G,69187535,41289,69032216,69425432,155319
17,ENSG00000187531.7,81918176,chr17-82016855-T-C,rs13087,-1,T,C,82016855,98679,81721568,82114784,295287
17,ENSG00000221926.5,15684311,chr17-15593463-C-T,rs146110909,-1,C,T,15593463,90848,15487703,15880919,105760
17,ENSG00000221926.5,15684311,chr17-15593463-C-A,rs146110909,-1,C,A,15593463,90848,15487703,15880919,105760
17,ENSG00000006042.5,32928153,chr17-32970468-A-C,rs1557752,1,A,C,32970468,42315,32731545,33124761,238923
17,ENSG00000141504.7,7627821,chr17-7658178-G-A,rs1641510,-1,G,A,7658178,30357,7431213,7824429,226965
17,ENSG00000181513.9,45135687,chr17-45139448-G-T,rs16939884,1,G,T,45139448,3761,44939079,45332295,200369
17,ENSG00000006062.8,45317020,chr17-45346524-T-C,rs16939964,-1,T,C,45346524,29504,45120412,45513628,226112
17,ENSG00000108424.4,47649919,chr17-47693188-T-C,rs16942912,1,T,C,47693188,43269,47453311,47846527,239877
17,ENSG00000198740.4,49362250,chr17-49455151-G-A,rs16948122,-1,G,A,49455151,92901,49165642,49558858,289509
17,ENSG00000184619.3,8376704,chr17-8376006-T-C,rs1695213,-1,T,C,8376006,698,8180096,8573312,195910
17,ENSG00000132535.11,7217627,chr17-7076954-C-T,rs16956478,-1,C,T,7076954,140673,7021019,7414235,55935
17,ENSG00000205309.7,17303373,chr17-17304918-G-A,rs16961516,1,G,A,17304918,1545,17106765,17499981,198153
17,ENSG00000168259.7,42017439,chr17-42112875-C-T,rs16967499,-1,C,T,42112875,95436,41820831,42214047,292044
17,ENSG00000188878.9,75941042,chr17-75952150-A-G,rs16968345,-1,A,G,75952150,11108,75744434,76137650,207716
17,ENSG00000129654.6,76141245,chr17-76070395-T-C,rs16968495,-1,T,C,76070395,70850,75944637,76337853,125758
17,ENSG00000175931.7,76453152,chr17-76446860-A-G,rs16968960,-1,A,G,76446860,6292,76256544,76649760,190316
17,ENSG00000154803.7,17237168,chr17-17228555-T-C,rs1708618,-1,T,C,17228555,8613,17040560,17433776,187995
17,ENSG00000167740.3,4143197,chr17-4032749-C-T,rs17175962,1,C,T,4032749,110448,3946589,4339805,86160
17,ENSG00000141349.3,44070735,chr17-43995281-C-T,rs1731902,1,C,T,43995281,75454,43874127,44267343,121154
17,ENSG00000108423.9,59892943,chr17-59781345-C-T,rs17581463,-1,C,T,59781345,111598,59696335,60089551,85010
17,ENSG00000141510.9,7687490,chr17-7581464-G-A,rs17607,-1,G,A,7581464,106026,7490882,7884098,90582
17,ENSG00000183153.4,40364737,chr17-40523355-C-T,rs17634993,-1,C,T,40523355,158618,40168129,40561345,355226
17,ENSG00000109046.9,27294114,chr17-27338610-C-T,rs17714734,1,C,T,27338610,44496,27097506,27490722,241104
17,ENSG00000174282.7,7479631,chr17-7354136-G-T,rs17732672,-1,G,T,7354136,125495,7283023,7676239,71113
17,ENSG00000153933.5,56834151,chr17-56763132-G-A,rs17760549,1,G,A,56763132,71019,56637543,57030759,125589
17,ENSG00000141198.9,54900852,chr17-54967964-G-A,rs17817950,1,G,A,54967964,67112,54704244,55097460,263720
17,ENSG00000132359.9,2796438,chr17-2793022-C-T,rs178573,1,C,T,2793022,3416,2599830,2993046,193192
17,ENSG00000108821.8,50201631,chr17-50170328-C-T,rs1801191,-1,C,T,50170328,31303,50005023,50398239,165305
17,ENSG00000108561.4,5439155,chr17-5414172-C-A,rs1806263,-1,C,A,5414172,24983,5242547,5635763,171625
17,ENSG00000167842.11,5486566,chr17-5416428-A-C,rs1806264,1,A,C,5416428,70138,5289958,5683174,126470
17,ENSG00000185156.4,8799365,chr17-8800102-C-T,rs1826925,-1,C,T,8800102,737,8602757,8995973,197345
17,ENSG00000198920.4,6640711,chr17-6700347-G-A,rs184295,-1,G,A,6700347,59636,6444103,6837319,256244
17,ENSG00000067191.10,39197669,chr17-39213163-G-A,rs1859262,-1,G,A,39213163,15494,39001061,39394277,212102
17,ENSG00000108592.9,63827663,chr17-63742600-G-A,rs1877318,-1,G,A,63742600,85063,63631055,64024271,111545
17,ENSG00000091542.7,18183828,chr17-18328782-G-A,rs1979277,1,G,A,18328782,144954,17987220,18380436,341562
17,ENSG00000131899.6,18225635,chr17-18328782-G-A,rs1979277,1,G,A,18328782,103147,18029027,18422243,299755
17,ENSG00000166579.10,8435884,chr17-8496321-G-T,rs1979734,1,G,T,8496321,60437,8239276,8632492,257045
17,ENSG00000108379.5,46818692,chr17-46743059-T-C,rs199536,-1,T,C,46743059,75633,46622084,47015300,120975
17,ENSG00000196704.6,68248043,chr17-68227876-A-G,rs2005775,1,A,G,68227876,20167,68051435,68444651,176441
17,ENSG00000178789.3,74531475,chr17-74487632-G-A,rs2007766,-1,G,A,74487632,43843,74334867,74728083,152765
17,ENSG00000198933.4,47694161,chr17-47713757-T-G,rs2013383,1,T,G,47713757,19596,47497553,47890769,216204
17,ENSG00000198933.4,47694161,chr17-47713757-T-A,rs2013383,1,T,A,47713757,19596,47497553,47890769,216204
17,ENSG00000167711.9,1742871,chr17-1745000-C-T,rs2070862,1,C,T,1745000,2129,1546263,1939479,198737
17,ENSG00000154025.10,18952165,chr17-18969208-A-G,rs2074273,1,A,G,18969208,17043,18755557,19148773,213651
17,ENSG00000004660.10,3893053,chr17-3904738-A-G,rs2074989,-1,A,G,3904738,11685,3696445,4089661,208293
17,ENSG00000068097.8,60078921,chr17-60079066-G-A,rs2087840,-1,G,A,60079066,145,59882313,60275529,196753
17,ENSG00000091622.10,6556555,chr17-6578174-T-C,rs2165844,-1,T,C,6578174,21619,6359947,6753163,218227
17,ENSG00000133028.5,10697533,chr17-10694694-C-T,rs2175039,-1,C,T,10694694,2839,10500925,10894141,193769
17,ENSG00000125430.4,14301081,chr17-14350631-G-A,rs2199999,1,G,A,14350631,49550,14104473,14497689,246158
17,ENSG00000213977.3,3668578,chr17-3688528-A-G,rs220488,-1,A,G,3688528,19950,3471970,3865186,216558
17,ENSG00000040531.10,3636760,chr17-3650765-G-A,rs222779,1,G,A,3650765,14005,3440152,3833368,210613
17,ENSG00000183979.6,81902238,chr17-82083590-G-A,rs2229425,1,G,A,82083590,181352,81705630,82098846,377960
17,ENSG00000132517.10,5035426,chr17-4956069-C-T,rs2230257,-1,C,T,4956069,79357,4838818,5232034,117251
17,ENSG00000125445.5,75261879,chr17-75246854-A-G,rs2242231,1,A,G,75246854,15025,75065271,75458487,181583
17,ENSG00000141560.8,82716706,chr17-82722573-G-T,rs2243523,1,G,T,82722573,5867,82520098,82913314,202475
17,ENSG00000197417.7,3636250,chr17-3616660-G-T,rs224498,-1,G,T,3616660,19590,3439642,3832858,177018
17,ENSG00000108671.4,32444510,chr17-32572316-A-G,rs225218,1,A,G,32572316,127806,32247902,32641118,324414
17,ENSG00000005884.12,50056110,chr17-50072022-C-T,rs2269772,1,C,T,50072022,15912,49859502,50252718,212520
17,ENSG00000108797.6,42682531,chr17-42683904-A-C,rs2271029,1,A,C,42683904,1373,42485923,42879139,197981
17,ENSG00000167695.8,732596,chr17-782400-G-T,rs2273454,1,G,T,782400,49804,535988,929204,246412
17,ENSG00000161544.4,76537709,chr17-76540680-G-T,rs2289607,-1,G,T,76540680,2971,76341101,76734317,199579
17,ENSG00000214447.3,44899774,chr17-44876041-A-G,rs2289674,1,A,G,44876041,23733,44703166,45096382,172875
17,ENSG00000213859.3,7352162,chr17-7350340-T-C,rs2292068,1,T,C,7350340,1822,7155554,7548770,194786
17,ENSG00000083454.16,3696155,chr17-3694724-T-C,rs2318104,-1,T,C,3694724,1431,3499547,3892763,195177
17,ENSG00000141294.4,47831670,chr17-47844540-T-C,rs2325752,1,T,C,47844540,12870,47635062,48028278,209478
17,ENSG00000132141.8,34961460,chr17-34826300-C-G,rs234824,-1,C,G,34826300,135160,34764852,35158068,61448
17,ENSG00000126860.5,31321622,chr17-31320890-T-G,rs2525563,-1,T,G,31320890,732,31125014,31518230,195876
17,ENSG00000064300.4,49495293,chr17-49489224-C-A,rs2537710,1,C,A,49489224,6069,49298685,49691901,190539
17,ENSG00000129204.11,5116032,chr17-5310096-C-T,rs2585266,1,C,T,5310096,194064,4919424,5312640,390672
17,ENSG00000141570.6,79797077,chr17-79816336-T-C,rs2587507,-1,T,C,79816336,19259,79600469,79993685,215867
17,ENSG00000108439.4,47941571,chr17-47975427-A-G,rs2597172,1,A,G,47975427,33856,47744963,48138179,230464
17,ENSG00000161929.9,5234860,chr17-5223379-A-G,rs2641256,-1,A,G,5223379,11481,5038252,5431468,185127
17,ENSG00000089685.7,78214253,chr17-78226226-T-C,rs28612787,1,T,C,78226226,11973,78017645,78410861,208581
17,ENSG00000108395.8,59106880,chr17-59061932-G-A,rs2877926,-1,G,A,59061932,44948,58910272,59303488,151660
17,ENSG00000154957.6,11997475,chr17-12140928-G-C,rs28921112,-1,G,C,12140928,143453,11800867,12194083,340061
17,ENSG00000154957.6,11997475,chr17-12140928-G-A,rs28921112,-1,G,A,12140928,143453,11800867,12194083,340061
17,ENSG00000141068.8,27456448,chr17-27545063-C-T,rs2945385,1,C,T,27545063,88615,27259840,27653056,285223
17,ENSG00000141337.6,68291495,chr17-68483075-A-G,rs2952278,1,A,G,68483075,191580,68094887,68488103,388188
17,ENSG00000108559.6,5419662,chr17-5381185-T-C,rs3026109,-1,T,C,5381185,38477,5223054,5616270,158131
17,ENSG00000170004.12,7888789,chr17-7721745-T-C,rs307627,1,T,C,7721745,167044,7692181,8085397,29564
17,ENSG00000108262.9,29589648,chr17-29651676-C-T,rs3098949,-1,C,T,29651676,62028,29393040,29786256,258636
17,ENSG00000007314.6,63972918,chr17-63999149-G-T,rs3181027,-1,G,T,63999149,26231,63776310,64169526,222839
17,ENSG00000167723.9,3557812,chr17-3556729-T-C,rs322960,-1,T,C,3556729,1083,3361204,3754420,195525
17,ENSG00000131467.4,42833397,chr17-42989954-T-C,rs323496,1,T,C,42989954,156557,42636789,43030005,353165
17,ENSG00000167862.4,75012670,chr17-75006887-C-T,rs34014427,1,C,T,75006887,5783,74816062,75209278,190825
17,ENSG00000177294.6,6776215,chr17-6760434-A-G,rs34195599,1,A,G,6760434,15781,6579607,6972823,180827
17,ENSG00000175906.2,43398993,chr17-43407654-G-A,rs34228036,1,G,A,43407654,8661,43202385,43595601,205269
17,ENSG00000185105.4,81947233,chr17-81942024-G-A,rs34319293,-1,G,A,81942024,5209,81750625,82143841,191399
17,ENSG00000184557.2,78360077,chr17-78459935-C-T,rs34438166,-1,C,T,78459935,99858,78163469,78556685,296466
17,ENSG00000184557.2,78360077,chr17-78459935-C-G,rs34438166,-1,C,G,78459935,99858,78163469,78556685,296466
17,ENSG00000108932.6,68291127,chr17-68305422-C-T,rs34497818,-1,C,T,68305422,14295,68094519,68487735,210903
17,ENSG00000175866.10,81035151,chr17-81094956-G-A,rs34534119,1,G,A,81094956,59805,80838543,81231759,256413
17,ENSG00000141582.9,79839440,chr17-80013440-C-T,rs34603877,-1,C,T,80013440,174000,79642832,80036048,370608
17,ENSG00000167131.10,44899729,chr17-44908404-C-T,rs34637106,1,C,T,44908404,8675,44703121,45096337,205283
17,ENSG00000185298.8,81666737,chr17-81658983-T-C,rs34675863,1,T,C,81658983,7754,81470129,81863345,188854
17,ENSG00000173818.12,80415167,chr17-80415678-G-A,rs35549084,1,G,A,80415678,511,80218559,80611775,197119
17,ENSG00000072818.6,7336529,chr17-7323638-G-A,rs35776863,1,G,A,7323638,12891,7139921,7533137,183717
17,ENSG00000187838.10,7394525,chr17-7342038-C-T,rs35933585,-1,C,T,7342038,52487,7197917,7591133,144121
17,ENSG00000167363.8,82735615,chr17-82773222-G-A,rs36087138,1,G,A,82773222,37607,82539007,82932223,234215
17,ENSG00000136444.5,50478860,chr17-50485811-C-T,rs3744531,1,C,T,50485811,6951,50282252,50675468,203559
17,ENSG00000196544.6,8190180,chr17-8320815-T-C,rs3744646,-1,T,C,8320815,130635,7993572,8386788,327243
17,ENSG00000108679.5,78979923,chr17-78807115-C-T,rs3744796,-1,C,T,78807115,172808,78783315,79176531,23800
17,ENSG00000187607.9,15699752,chr17-15708181-T-C,rs3760299,1,T,C,15708181,8429,15503144,15896360,205037
17,ENSG00000166685.5,73193055,chr17-73193043-A-G,rs3764359,1,A,G,73193043,12,72996447,73389663,196596
17,ENSG00000092871.11,35063707,chr17-35105735-G-T,rs3785754,-1,G,T,35105735,42028,34867099,35260315,238636
17,ENSG00000189152.5,19127589,chr17-19287629-G-A,rs3785787,1,G,A,19287629,160040,18930981,19324197,356648
17,ENSG00000108389.4,58514638,chr17-58462906-C-T,rs3803752,-1,C,T,58462906,51732,58318030,58711246,144876
17,ENSG00000073670.7,44758988,chr17-44904286-A-G,rs3826425,1,A,G,44904286,145298,44562380,44955596,341906
17,ENSG00000182156.5,79730943,chr17-79733322-G-A,rs3923265,1,G,A,79733322,2379,79534335,79927551,198987
17,ENSG00000170425.2,15945130,chr17-15834610-C-T,rs3925260,1,C,T,15834610,110520,15748522,16141738,86088
17,ENSG00000171634.11,67825503,chr17-67818266-C-G,rs3936134,1,C,G,67818266,7237,67628895,68022111,189371
17,ENSG00000091947.4,44014963,chr17-43997533-G-A,rs3964442,-1,G,A,43997533,17430,43818355,44211571,179178
17,ENSG00000169660.10,82418347,chr17-82419530-T-C,rs4074069,1,T,C,82419530,1183,82221739,82614955,197791
17,ENSG00000087157.11,78378649,chr17-78407903-G-A,rs4129767,1,G,A,78407903,29254,78182041,78575257,225862
17,ENSG00000035862.7,78925387,chr17-78955009-G-A,rs4133225,-1,G,A,78955009,29622,78728779,79121995,226230
17,ENSG00000259024.1,15563561,chr17-15607542-C-T,rs41346256,-1,C,T,15607542,43981,15366953,15760169,240589
17,ENSG00000232859.3,27893365,chr17-27985442-A-G,rs4239213,-1,A,G,27985442,92077,27696757,28089973,288685
17,ENSG00000136485.8,63550477,chr17-63483656-C-T,rs4313,1,C,T,63483656,66821,63353869,63747085,129787
17,ENSG00000141232.4,50866354,chr17-50898313-C-T,rs4389180,-1,C,T,50898313,31959,50669746,51062962,228567
17,ENSG00000141569.5,75896951,chr17-75892192-C-T,rs4398150,-1,C,T,75892192,4759,75700343,76093559,191849
17,ENSG00000132478.4,75784806,chr17-75892192-C-T,rs4398150,1,C,T,75892192,107386,75588198,75981414,303994
17,ENSG00000072778.12,7219938,chr17-7213534-C-A,rs446994,1,C,A,7213534,6404,7023330,7416546,190204
17,ENSG00000108960.3,55421835,chr17-55393744-T-G,rs4476230,-1,T,G,55393744,28091,55225227,55618443,168517
17,ENSG00000005243.4,48037797,chr17-48226196-G-A,rs4534896,-1,G,A,48226196,188399,47841189,48234405,385007
17,ENSG00000108950.6,68601367,chr17-68756343-A-G,rs4541139,-1,A,G,68756343,154976,68404759,68797975,351584
17,ENSG00000170291.8,7252215,chr17-7260420-A-G,rs4562,1,A,G,7260420,8205,7055607,7448823,204813
17,ENSG00000167850.3,74546115,chr17-74470080-G-A,rs4788837,-1,G,A,74470080,76035,74349507,74742723,120573
17,ENSG00000129667.6,76501423,chr17-76484633-T-C,rs4789302,-1,T,C,76484633,16790,76304815,76698031,179818
17,ENSG00000141580.10,82648444,chr17-82613184-A-G,rs4789704,-1,A,G,82613184,35260,82451836,82845052,161348
17,ENSG00000171302.9,79009764,chr17-78968227-G-A,rs4789907,-1,G,A,78968227,41537,78813156,79206372,155071
17,ENSG00000170310.5,9575820,chr17-9457771-C-T,rs4791838,-1,C,T,9457771,118049,9379212,9772428,78559
17,ENSG00000175832.7,43546340,chr17-43579424-C-A,rs4792900,-1,C,A,43579424,33084,43349732,43742948,229692
17,ENSG00000184451.4,42681843,chr17-42578807-G-A,rs4793244,-1,G,A,42578807,103036,42485235,42878451,93572
17,ENSG00000132507.13,7307628,chr17-7304878-C-T,rs4796398,1,C,T,7304878,2750,7111020,7504236,193858
17,ENSG00000161513.6,74872994,chr17-74872953-G-A,rs492095,-1,G,A,74872953,41,74676386,75069602,196567
17,ENSG00000182628.7,59155186,chr17-59199202-G-C,rs493740,-1,G,C,59199202,44016,58958578,59351794,240624
17,ENSG00000161960.9,7572825,chr17-7574159-A-G,rs4968214,1,A,G,7574159,1334,7376217,7769433,197942
17,ENSG00000168792.2,29567037,chr17-29568510-T-C,rs497993,-1,T,C,29568510,1473,29370429,29763645,198081
17,ENSG00000091592.9,5584509,chr17-5770807-T-C,rs4985687,-1,T,C,5770807,186298,5387901,5781117,382906
17,ENSG00000141314.7,32265832,chr17-32271124-A-C,rs5002530,1,A,C,32271124,5292,32069224,32462440,201900
17,ENSG00000181856.10,7281718,chr17-7280727-G-A,rs5412,1,G,A,7280727,991,7085110,7478326,195617
17,ENSG00000108352.5,40177470,chr17-40208512-C-T,rs55673000,1,C,T,40208512,31042,39980862,40374078,227650
17,ENSG00000171928.8,18781183,chr17-18790039-G-A,rs56156915,1,G,A,18790039,8856,18584575,18977791,205464
17,ENSG00000034152.13,21284711,chr17-21379298-C-T,rs56369900,1,C,T,21379298,94587,21088103,21481319,291195
17,ENSG00000141736.7,39700064,chr17-39669996-A-G,rs5638,1,A,G,39669996,30068,39503456,39896672,166540
17,ENSG00000108651.3,31901708,chr17-31811171-T-G,rs58436179,-1,T,G,31811171,90537,31705100,32098316,106071
17,ENSG00000184361.7,45262094,chr17-45257282-C-A,rs60163605,-1,C,A,45257282,4812,45065486,45458702,191796
17,ENSG00000136436.9,48831035,chr17-48840842-A-G,rs612720,1,A,G,48840842,9807,48634427,49027643,206415
17,ENSG00000167693.12,979776,chr17-825992-G-A,rs61731765,-1,G,A,825992,153784,783168,1176384,42824
17,ENSG00000167280.10,79074824,chr17-79083494-A-G,rs61756761,1,A,G,79083494,8670,78878216,79271432,205278
17,ENSG00000256806.1,6651762,chr17-6637034-C-A,rs62061480,1,C,A,6637034,14728,6455154,6848370,181880
17,ENSG00000167524.8,28614185,chr17-28527846-C-T,rs62066766,-1,C,T,28527846,86339,28417577,28810793,110269
17,ENSG00000179604.7,73312001,chr17-73278341-C-A,rs62073188,-1,C,A,73278341,33660,73115393,73508609,162948
17,ENSG00000187997.6,78146385,chr17-78157867-C-T,rs62079083,1,C,T,78157867,11482,77949777,78342993,208090
17,ENSG00000108298.4,39200283,chr17-39176710-C-A,rs626657,1,C,A,39176710,23573,39003675,39396891,173035
17,ENSG00000177728.9,75456635,chr17-75459847-C-A,rs6501805,1,C,A,75459847,3212,75260027,75653243,199820
17,ENSG00000257949.1,75979240,chr17-75991292-T-C,rs6501847,1,T,C,75991292,12052,75782632,76175848,208660
17,ENSG00000180787.5,5078467,chr17-5053297-A-G,rs6502832,1,A,G,5053297,25170,4881859,5275075,171438
17,ENSG00000008838.11,40054408,chr17-40035671-A-G,rs6503534,-1,A,G,40035671,18737,39857800,40251016,177871
17,ENSG00000167447.7,59210035,chr17-59210093-A-G,rs6503905,1,A,G,59210093,58,59013427,59406643,196666
17,ENSG00000153982.5,59220511,chr17-59278823-G-A,rs6503913,1,G,A,59278823,58312,59023903,59417119,254920
17,ENSG00000141293.9,48430214,chr17-48330072-T-C,rs6504172,-1,T,C,48330072,100142,48233606,48626822,96466
17,ENSG00000109118.7,28951518,chr17-28933638-C-A,rs6505098,-1,C,A,28933638,17880,28754910,29148126,178728
17,ENSG00000109118.7,28951518,chr17-28933638-C-T,rs6505098,-1,C,T,28933638,17880,28754910,29148126,178728
17,ENSG00000181481.7,30971039,chr17-30938603-T-G,rs6505219,1,T,G,30938603,32436,30774431,31167647,164172
17,ENSG00000132386.5,1762060,chr17-1762309-G-A,rs66498906,1,G,A,1762309,249,1565452,1958668,196857
17,ENSG00000176974.11,18363550,chr17-18360643-G-C,rs669340,-1,G,C,18360643,2907,18166942,18560158,193701
17,ENSG00000170160.10,16690241,chr17-16797711-A-T,rs678522,1,A,T,16797711,107470,16493633,16886849,304078
17,ENSG00000187775.10,78577396,chr17-78490091-T-C,rs691323,-1,T,C,78490091,87305,78380788,78774004,109303
17,ENSG00000189159.9,75154512,chr17-75030368-G-A,rs71380857,-1,G,A,75030368,124144,74957904,75351120,72464
17,ENSG00000131477.5,42761227,chr17-42723621-T-C,rs7209643,1,T,C,42723621,37606,42564619,42957835,159002
17,ENSG00000180616.3,73165010,chr17-73170963-T-C,rs7210080,1,T,C,73170963,5953,72968402,73361618,202561
17,ENSG00000141295.8,47841273,chr17-47848524-A-G,rs7212099,-1,A,G,47848524,7251,47644665,48037881,203859
17,ENSG00000108825.11,42980528,chr17-42955268-G-A,rs7212564,-1,G,A,42955268,25260,42783920,43177136,171348
17,ENSG00000005882.6,50095351,chr17-50093531-G-A,rs7212617,1,G,A,50093531,1820,49898743,50291959,194788
17,ENSG00000181396.7,82418586,chr17-82421063-T-C,rs7213057,-1,T,C,82421063,2477,82221978,82615194,199085
17,ENSG00000129195.9,6444455,chr17-6437195-A-C,rs7214517,1,A,C,6437195,7260,6247847,6641063,189348
17,ENSG00000108771.6,42112714,chr17-42142007-T-C,rs7214921,-1,T,C,42142007,29293,41916106,42309322,225901
17,ENSG00000181350.7,16492193,chr17-16465438-A-G,rs7215641,-1,A,G,16465438,26755,16295585,16688801,169853
17,ENSG00000168517.5,45161875,chr17-45261574-G-C,rs7215764,1,G,C,45261574,99699,44965267,45358483,296307
17,ENSG00000132388.8,4366675,chr17-4303948-T-A,rs7216130,-1,T,A,4303948,62727,4170067,4563283,133881
17,ENSG00000167302.5,81239055,chr17-81273998-G-A,rs7216728,-1,G,A,81273998,34943,81042447,81435663,231551
17,ENSG00000167302.5,81239055,chr17-81273998-G-T,rs7216728,-1,G,T,81273998,34943,81042447,81435663,231551
17,ENSG00000126353.2,40565472,chr17-40600717-G-T,rs7216890,-1,G,T,40600717,35245,40368864,40762080,231853
17,ENSG00000161958.5,7439512,chr17-7492230-A-G,rs7217258,1,A,G,7492230,52718,7242904,7636120,249326
17,ENSG00000186532.7,1829902,chr17-1807298-C-T,rs7219095,-1,C,T,1807298,22604,1633294,2026510,174004
17,ENSG00000172809.7,74203678,chr17-74200252-C-A,rs7219464,1,C,A,74200252,3426,74007070,74400286,193182
17,ENSG00000213246.1,58352201,chr17-58353389-G-A,rs7219859,-1,G,A,58353389,1188,58155593,58548809,197796
17,ENSG00000173812.4,41688885,chr17-41742434-T-C,rs7221179,1,T,C,41742434,53549,41492277,41885493,250157
17,ENSG00000167105.3,50274466,chr17-50279635-A-G,rs7221526,1,A,G,50279635,5169,50077858,50471074,201777
17,ENSG00000167083.2,49210574,chr17-49203553-T-C,rs7222840,-1,T,C,49203553,7021,49013966,49407182,189587
17,ENSG00000214226.4,56833920,chr17-56791264-A-C,rs7224488,-1,A,C,56791264,42656,56637312,57030528,153952
17,ENSG00000205710.3,4899536,chr17-4926522-G-T,rs72835079,1,G,T,4926522,26986,4702928,5096144,223594
17,ENSG00000184185.4,21376357,chr17-21539286-C-T,rs72842005,1,C,T,21539286,162929,21179749,21572965,359537
17,ENSG00000121057.7,57085246,chr17-56982827-T-G,rs72842344,1,T,G,56982827,102419,56888638,57281854,94189
17,ENSG00000170175.6,7445061,chr17-7425815-G-A,rs72842820,1,G,A,7425815,19246,7248453,7641669,177362
17,ENSG00000180901.5,75047225,chr17-75068856-G-A,rs72844534,1,G,A,75068856,21631,74850617,75243833,218239
17,ENSG00000141556.14,82752065,chr17-82929318-G-A,rs729123,1,G,A,82929318,177253,82555457,82948673,373861
17,ENSG00000108576.4,30235697,chr17-30238408-T-C,rs73263896,-1,T,C,30238408,2711,30039089,30432305,199319
17,ENSG00000185527.7,81656542,chr17-81621316-T-C,rs73369283,-1,T,C,81621316,35226,81459934,81853150,161382
17,ENSG00000129646.8,76308276,chr17-76304210-A-G,rs73996304,-1,A,G,76304210,4066,76111668,76504884,192542
17,ENSG00000170412.11,74432088,chr17-74400997-T-C,rs7406641,1,T,C,74400997,31091,74235480,74628696,165517
17,ENSG00000108883.6,44899445,chr17-44932518-G-A,rs744281,-1,G,A,44932518,33073,44702837,45096053,229681
17,ENSG00000141574.2,82333766,chr17-82376017-A-G,rs7502317,-1,A,G,82376017,42251,82137158,82530374,238859
17,ENSG00000259207.2,47253827,chr17-47271687-G-A,rs75563753,1,G,A,47271687,17860,47057219,47450435,214468
17,ENSG00000108375.7,58417534,chr17-58347349-T-C,rs757485,-1,T,C,58347349,70185,58220926,58614142,126423
17,ENSG00000168646.7,65561648,chr17-65565474-G-T,rs757558,-1,G,T,65565474,3826,65365040,65758256,200434
17,ENSG00000141367.5,59619895,chr17-59426291-G-C,rs758382,1,G,C,59426291,193604,59423287,59816503,3004
17,ENSG00000011052.16,51153590,chr17-51160591-C-A,rs76221971,1,C,A,51160591,7001,50956982,51350198,203609
17,ENSG00000171475.8,40219304,chr17-40241730-T-C,rs76277587,1,T,C,40241730,22426,40022696,40415912,219034
17,ENSG00000011028.8,62627670,chr17-62588972-C-T,rs76402483,1,C,T,62588972,38698,62431062,62824278,157910
17,ENSG00000154229.6,66302613,chr17-66367135-A-G,rs764523,1,A,G,66367135,64522,66106005,66499221,261130
17,ENSG00000089558.2,42181142,chr17-42248694-C-A,rs76806513,-1,C,A,42248694,67552,41984534,42377750,264160
17,ENSG00000172123.7,35432500,chr17-35429737-T-G,rs772291,-1,T,G,35429737,2763,35235892,35629108,193845
17,ENSG00000172716.11,35373621,chr17-35351808-A-G,rs77814639,-1,A,G,35351808,21813,35177013,35570229,174795
17,ENSG00000168591.10,44186972,chr17-43998999-G-C,rs77900930,1,G,C,43998999,187973,43990364,44383580,8635
17,ENSG00000182446.8,81637112,chr17-81647108-T-C,rs78163298,-1,T,C,81647108,9996,81440504,81833720,206604
17,ENSG00000196169.10,74326226,chr17-74396639-G-A,rs78857211,1,G,A,74396639,70413,74129618,74522834,267021
17,ENSG00000070540.7,68457496,chr17-68433167-T-C,rs79199626,-1,T,C,68433167,24329,68260888,68654104,172279
17,ENSG00000121058.4,56961050,chr17-57040838-G-A,rs80086912,-1,G,A,57040838,79788,56764442,57157658,276396
17,ENSG00000121058.4,56961050,chr17-57040838-G-T,rs80086912,-1,G,T,57040838,79788,56764442,57157658,276396
17,ENSG00000006695.5,14069504,chr17-14109705-G-C,rs8064562,1,G,C,14109705,40201,13872896,14266112,236809
17,ENSG00000204815.3,41930617,chr17-41771314-G-A,rs8066392,1,G,A,41771314,159303,41734009,42127225,37305
17,ENSG00000174292.7,7381089,chr17-7369744-C-T,rs8066451,1,C,T,7369744,11345,7184481,7577697,185263
17,ENSG00000131480.3,42844580,chr17-42927357-T-C,rs8067341,1,T,C,42927357,82777,42647972,43041188,279385
17,ENSG00000073605.12,39918635,chr17-39895095-A-G,rs8067378,-1,A,G,39895095,23540,39722027,40115243,173068
17,ENSG00000186075.7,39868202,chr17-39895095-A-G,rs8067378,1,A,G,39895095,26893,39671594,40064810,223501
17,ENSG00000182963.4,44830287,chr17-44854825-C-T,rs8067689,-1,C,T,44854825,24538,44633679,45026895,221146
17,ENSG00000167895.8,78130771,chr17-78136611-T-C,rs8068430,1,T,C,78136611,5840,77934163,78327379,202448
17,ENSG00000169696.8,81977629,chr17-81904948-A-G,rs8069388,1,A,G,81904948,72681,81781021,82174237,123927
17,ENSG00000109103.5,28552624,chr17-28626747-G-A,rs8072815,-1,G,A,28626747,74123,28356016,28749232,270731
17,ENSG00000182173.7,75516528,chr17-75517075-G-A,rs8074291,1,G,A,75517075,547,75319920,75713136,197155
17,ENSG00000161653.4,44004622,chr17-44000862-G-A,rs8074997,1,G,A,44000862,3760,43808014,44201230,192848
17,ENSG00000006282.13,50547174,chr17-50548567-C-G,rs8076632,1,C,G,50548567,1393,50350566,50743782,198001
17,ENSG00000181523.7,80220333,chr17-80207628-C-T,rs8078181,-1,C,T,80207628,12705,80023725,80416941,183903
17,ENSG00000178921.8,8249289,chr17-8225842-A-G,rs8078338,1,A,G,8225842,23447,8052681,8445897,173161
17,ENSG00000130935.4,67717936,chr17-67891506-A-G,rs8079291,1,A,G,67891506,173570,67521328,67914544,370178
17,ENSG00000224877.2,81239318,chr17-81201316-C-T,rs8079383,1,C,T,81201316,38002,81042710,81435926,158606
17,ENSG00000198231.6,63774170,chr17-63652522-A-G,rs8080211,1,A,G,63652522,121648,63577562,63970778,74960
17,ENSG00000176108.5,80991841,chr17-80997483-A-C,rs8081168,1,A,C,80997483,5642,80795233,81188449,202250
17,ENSG00000177427.7,18260662,chr17-18164090-A-G,rs854804,1,A,G,18164090,96572,18064054,18457270,100036
17,ENSG00000132470.8,75721459,chr17-75754778-C-G,rs8669,1,C,G,75754778,33319,75524851,75918067,229927
17,ENSG00000183010.11,81937300,chr17-81852587-A-G,rs876016,-1,A,G,81852587,84713,81740692,82133908,111895
17,ENSG00000126351.7,40062965,chr17-40096407-G-A,rs883871,1,G,A,40096407,33442,39866357,40259573,230050
17,ENSG00000129673.4,76467603,chr17-76483732-C-T,rs885140,1,C,T,76483732,16129,76270995,76664211,212737
17,ENSG00000108826.11,50373184,chr17-50355720-G-A,rs886568,-1,G,A,50355720,17464,50176576,50569792,179144
17,ENSG00000172171.5,30906238,chr17-30916337-A-T,rs9891656,-1,A,T,30916337,10099,30709630,31102846,206707
17,ENSG00000181222.10,7484366,chr17-7675361-A-G,rs9895829,1,A,G,7675361,190995,7287758,7680974,387603
17,ENSG00000141741.6,39730532,chr17-39739722-A-G,rs9896940,-1,A,G,39739722,9190,39533924,39927140,205798
17,ENSG00000141698.10,41836232,chr17-41836332-C-T,rs9897034,-1,C,T,41836332,100,41639624,42032840,196708
17,ENSG00000172992.6,45051632,chr17-45038945-C-T,rs9898793,-1,C,T,45038945,12687,44855024,45248240,183921
17,ENSG00000073584.13,40647818,chr17-40617695-C-G,rs9902509,-1,C,G,40617695,30123,40451210,40844426,166485
17,ENSG00000092931.6,76738119,chr17-76737427-C-T,rs9902624,1,C,T,76737427,692,76541511,76934727,195916
17,ENSG00000141576.8,76240493,chr17-76239124-A-C,rs9903178,-1,A,C,76239124,1369,76043885,76437101,195239
17,ENSG00000073861.1,47733236,chr17-47831335-G-A,rs9904966,1,G,A,47831335,98099,47536628,47929844,294707
17,ENSG00000161714.6,45132515,chr17-45306158-G-A,rs9906772,-1,G,A,45306158,173643,44935907,45329123,370251
17,ENSG00000108506.6,61927982,chr17-62072573-C-T,rs9907047,-1,C,T,62072573,144591,61731374,62124590,341199
17,ENSG00000177602.4,3723903,chr17-3724179-C-T,rs9907144,1,C,T,3724179,276,3527295,3920511,196884
17,ENSG00000083457.6,3801188,chr17-3724179-C-T,rs9907144,-1,C,T,3724179,77009,3604580,3997796,119599
17,ENSG00000236320.2,35560819,chr17-35548265-G-A,rs9907259,-1,G,A,35548265,12554,35364211,35757427,184054
17,ENSG00000007312.7,63932331,chr17-63791011-A-G,rs9907702,-1,A,G,63791011,141320,63735723,64128939,55288
17,ENSG00000169738.1,82037697,chr17-82034939-A-G,rs9908344,-1,A,G,82034939,2758,81841089,82234305,193850
17,ENSG00000181284.2,7435435,chr17-7564144-A-C,rs9908405,1,A,C,7564144,128709,7238827,7632043,325317
17,ENSG00000132481.1,75878581,chr17-75877313-A-G,rs9908862,-1,A,G,75877313,1268,75681973,76075189,195340
17,ENSG00000124422.6,21043011,chr17-21010843-G-A,rs9909279,-1,G,A,21010843,32168,20846403,21239619,164440
17,ENSG00000182557.3,4433940,chr17-4544941-C-T,rs9910749,1,C,T,4544941,111001,4237332,4630548,307609
17,ENSG00000179477.4,8087716,chr17-8068322-G-A,rs9911427,-1,G,A,8068322,19394,7891108,8284324,177214
17,ENSG00000012048.13,43125364,chr17-42938902-T-A,rs9914903,-1,T,A,42938902,186462,42928756,43321972,10146
17,ENSG00000109111.9,28662205,chr17-28671404-C-T,rs9915436,1,C,T,28671404,9199,28465597,28858813,205807
17,ENSG00000182534.7,76710965,chr17-76710142-T-C,rs9915664,-1,T,C,76710142,823,76514357,76907573,195785
17,ENSG00000161405.11,39864312,chr17-39805567-G-T,rs9941391,-1,G,T,39805567,58745,39667704,40060920,137863
17,ENSG00000087191.7,63827431,chr17-63706193-T-G,rs9944483,1,T,G,63706193,121238,63630823,64024039,75370
17,ENSG00000161395.7,39688057,chr17-39651445-A-C,rs9972882,-1,A,C,39651445,36612,39491449,39884665,159996
17,ENSG00000184060.5,30921945,chr17-30832311-G-A,rs999797,1,G,A,30832311,89634,30725337,31118553,106974
17,ENSG00000126860.5,31321622,chr17-31203691-G-A,rs1013948,-1,G,A,31203691,117931,31125014,31518230,78677
17,ENSG00000129214.9,7630135,chr17-7818613-G-A,rs10153304,1,G,A,7818613,188478,7433527,7826743,385086
17,ENSG00000198720.7,29593132,chr17-29585397-C-A,rs1017529,1,C,A,29585397,7735,29396524,29789740,188873
17,ENSG00000131470.9,42577729,chr17-42666681-A-G,rs1046097,-1,A,G,42666681,88952,42381121,42774337,285560
17,ENSG00000108799.6,42745040,chr17-42666681-A-G,rs1046097,-1,A,G,42666681,78359,42548432,42941648,118249
17,ENSG00000109089.7,74987632,chr17-75019707-G-C,rs10512599,1,G,C,75019707,32075,74791024,75184240,228683
17,ENSG00000108797.6,42682531,chr17-42760742-A-G,rs1078523,1,A,G,42760742,78211,42485923,42879139,274819
17,ENSG00000108797.6,42682531,chr17-42760742-A-C,rs1078523,1,A,C,42760742,78211,42485923,42879139,274819
17,ENSG00000108406.4,59565610,chr17-59700978-A-C,rs10853015,1,A,C,59700978,135368,59369002,59762218,331976
17,ENSG00000055483.10,78840814,chr17-78782658-T-C,rs11077395,-1,T,C,78782658,58156,78644206,79037422,138452
17,ENSG00000006695.5,14069504,chr17-14130647-C-T,rs11078224,1,C,T,14130647,61143,13872896,14266112,257751
17,ENSG00000181350.7,16492193,chr17-16486184-G-A,rs11078349,-1,G,A,16486184,6009,16295585,16688801,190599
17,ENSG00000175662.12,17972400,chr17-17972697-A-G,rs11078408,-1,A,G,17972697,297,17775792,18169008,196905
17,ENSG00000174282.7,7479631,chr17-7521618-C-T,rs11078691,-1,C,T,7521618,41987,7283023,7676239,238595
17,ENSG00000141294.4,47831670,chr17-47834936-C-T,rs11079797,1,C,T,47834936,3266,47635062,48028278,199874
17,ENSG00000189120.2,47851163,chr17-47878707-A-G,rs11079799,-1,A,G,47878707,27544,47654555,48047771,224152
17,ENSG00000189120.2,47851163,chr17-47878707-A-C,rs11079799,-1,A,C,47878707,27544,47654555,48047771,224152
17,ENSG00000064300.4,49495293,chr17-49469180-T-C,rs11079871,1,T,C,49469180,26113,49298685,49691901,170495
17,ENSG00000034152.13,21284711,chr17-21201314-A-G,rs1109515,1,A,G,21201314,83397,21088103,21481319,113211
17,ENSG00000185298.8,81666737,chr17-81663208-A-G,rs11150804,1,A,G,81663208,3529,81470129,81863345,193079
17,ENSG00000167524.8,28614185,chr17-28444547-A-G,rs111661889,-1,A,G,28444547,169638,28417577,28810793,26970
17,ENSG00000214941.2,15999704,chr17-15831302-G-A,rs112427653,-1,G,A,15831302,168402,15803096,16196312,28206
17,ENSG00000007312.7,63932331,chr17-63960008-G-T,rs113937879,-1,G,T,63960008,27677,63735723,64128939,224285
17,ENSG00000186765.7,81528377,chr17-81510993-G-A,rs1139405,1,G,A,81510993,17384,81331769,81724985,179224
17,ENSG00000073350.8,75525697,chr17-75620784-C-A,rs11470,1,C,A,75620784,95087,75329089,75722305,291695
17,ENSG00000121104.3,49764131,chr17-49599829-T-C,rs11539921,-1,T,C,49599829,164302,49567523,49960739,32306
17,ENSG00000185245.5,4932277,chr17-4892991-C-T,rs11556635,1,C,T,4892991,39286,4735669,5128885,157322
17,ENSG00000205710.3,4899536,chr17-4892991-C-T,rs11556635,1,C,T,4892991,6545,4702928,5096144,190063
17,ENSG00000108439.4,47941571,chr17-47950486-G-A,rs11650043,1,G,A,47950486,8915,47744963,48138179,205523
17,ENSG00000108641.9,19362723,chr17-19551061-T-C,rs11650156,-1,T,C,19551061,188338,19166115,19559331,384946
17,ENSG00000166750.4,35243072,chr17-35265572-C-T,rs11651240,1,C,T,35265572,22500,35046464,35439680,219108
17,ENSG00000171962.9,17972862,chr17-18018847-C-T,rs11652819,1,C,T,18018847,45985,17776254,18169470,242593
17,ENSG00000132359.9,2796438,chr17-2812520-C-T,rs11652853,1,C,T,2812520,16082,2599830,2993046,212690
17,ENSG00000108666.4,32342173,chr17-32390203-A-G,rs11653160,-1,A,G,32390203,48030,32145565,32538781,244638
17,ENSG00000161405.11,39864312,chr17-40013441-C-T,rs11655821,-1,C,T,40013441,149129,39667704,40060920,345737
17,ENSG00000006062.8,45317020,chr17-45317647-T-C,rs117350379,-1,T,C,45317647,627,45120412,45513628,197235
17,ENSG00000188554.7,43171214,chr17-43189010-C-A,rs117796976,1,C,A,43189010,17796,42974606,43367822,214404
17,ENSG00000176170.7,76384609,chr17-76564789-A-G,rs118003258,1,A,G,76564789,180180,76188001,76581217,376788
17,ENSG00000087157.11,78378649,chr17-78408574-C-T,rs11871028,1,C,T,78408574,29925,78182041,78575257,226533
17,ENSG00000175866.10,81035151,chr17-81128530-T-C,rs11871062,1,T,C,81128530,93379,80838543,81231759,289987
17,ENSG00000167850.3,74546115,chr17-74479064-T-C,rs11871595,-1,T,C,74479064,67051,74349507,74742723,129557
17,ENSG00000141499.10,7688477,chr17-7640576-C-T,rs12051767,1,C,T,7640576,47901,7491869,7885085,148707
17,ENSG00000072310.10,17836986,chr17-17763092-C-G,rs12103424,-1,C,G,17763092,73894,17640378,18033594,122714
17,ENSG00000170291.8,7252215,chr17-7260031-A-G,rs1215,1,A,G,7260031,7816,7055607,7448823,204424
17,ENSG00000108599.8,19977828,chr17-19967410-G-A,rs12325682,-1,G,A,19967410,10418,19781220,20174436,186190
17,ENSG00000125691.7,38853721,chr17-38848532-C-T,rs1239175,-1,C,T,38848532,5189,38657113,39050329,191419
17,ENSG00000073670.7,44758988,chr17-44677409-C-T,rs12450654,1,C,T,44677409,81579,44562380,44955596,115029
17,ENSG00000109084.8,28319200,chr17-28218462-C-A,rs12452097,1,C,A,28218462,100738,28122592,28515808,95870
17,ENSG00000196388.4,4997033,chr17-4814149-G-A,rs12452111,-1,G,A,4814149,182884,4800425,5193641,13724
17,ENSG00000133030.12,17042457,chr17-17040309-A-C,rs12601422,1,A,C,17040309,2148,16845849,17239065,194460
17,ENSG00000181031.11,352807,chr17-237970-A-C,rs12603796,-1,A,C,237970,114837,156199,549415,81771
17,ENSG00000189050.9,59964740,chr17-59851958-T-C,rs1292068,-1,T,C,59851958,112782,59768132,60161348,83826
17,ENSG00000013306.10,44324823,chr17-44179062-G-A,rs12937692,-1,G,A,44179062,145761,44128215,44521431,50847
17,ENSG00000141504.7,7627821,chr17-7579461-T-C,rs12942088,-1,T,C,7579461,48360,7431213,7824429,148248
17,ENSG00000108384.9,58692602,chr17-58567455-T-C,rs12944693,1,T,C,58567455,125147,58495994,58889210,71461
17,ENSG00000182628.7,59155186,chr17-59132952-G-A,rs12945875,-1,G,A,59132952,22234,58958578,59351794,174374
17,ENSG00000174327.6,7036015,chr17-7057898-G-A,rs12950215,1,G,A,7057898,21883,6839407,7232623,218491
17,ENSG00000141562.11,82458741,chr17-82491821-C-T,rs1317685,1,C,T,82491821,33080,82262133,82655349,229688
17,ENSG00000141562.11,82458741,chr17-82491821-C-G,rs1317685,1,C,G,82491821,33080,82262133,82655349,229688
17,ENSG00000187824.3,10730023,chr17-10814772-C-T,rs1373122,-1,C,T,10814772,84749,10533415,10926631,281357
17,ENSG00000108924.7,55264960,chr17-55284477-T-G,rs1477141,1,T,G,55284477,19517,55068352,55461568,216125
17,ENSG00000129195.9,6444455,chr17-6361532-T-G,rs1514028,1,T,G,6361532,82923,6247847,6641063,113685
17,ENSG00000005884.12,50056110,chr17-50052486-C-T,rs1557687,1,C,T,50052486,3624,49859502,50252718,192984
17,ENSG00000108852.10,43907536,chr17-43913494-C-T,rs1631484,-1,C,T,43913494,5958,43710928,44104144,202566
17,ENSG00000161381.8,39151637,chr17-39131878-C-T,rs16495,-1,C,T,39131878,19759,38955029,39348245,176849
17,ENSG00000161664.1,44170704,chr17-43989997-T-C,rs16940439,1,T,C,43989997,180707,43974096,44367312,15901
17,ENSG00000004897.6,47189295,chr17-47277987-C-G,rs16941802,-1,C,G,47277987,88692,46992687,47385903,285300
17,ENSG00000141279.7,47531108,chr17-47693188-T-C,rs16942912,1,T,C,47693188,162080,47334500,47727716,358688
17,ENSG00000108510.4,62065278,chr17-62111248-A-G,rs16945866,-1,A,G,62111248,45970,61868670,62261886,242578
17,ENSG00000108604.10,63842685,chr17-63674133-A-G,rs16947032,-1,A,G,63674133,168552,63646077,64039293,28056
17,ENSG00000198740.4,49362250,chr17-49549049-T-C,rs16948257,-1,T,C,49549049,186799,49165642,49558858,383407
17,ENSG00000005882.6,50095351,chr17-50094913-A-G,rs16948691,1,A,G,50094913,438,49898743,50291959,196170
17,ENSG00000132517.10,5035426,chr17-5201895-G-A,rs16954473,-1,G,A,5201895,166469,4838818,5232034,363077
17,ENSG00000141198.9,54900852,chr17-54831239-C-T,rs16955175,1,C,T,54831239,69613,54704244,55097460,126995
17,ENSG00000141198.9,54900852,chr17-54831239-C-G,rs16955175,1,C,G,54831239,69613,54704244,55097460,126995
17,ENSG00000183011.8,7857559,chr17-7787792-G-T,rs16956952,-1,G,T,7787792,69767,7660951,8054167,126841
17,ENSG00000121064.8,56978131,chr17-56942368-T-C,rs16957876,1,T,C,56942368,35763,56781523,57174739,160845
17,ENSG00000141027.13,16215534,chr17-16374264-C-T,rs16959630,-1,C,T,16374264,158730,16018926,16412142,355338
17,ENSG00000170315.6,16381091,chr17-16482781-T-C,rs16959749,1,T,C,16482781,101690,16184483,16577699,298298
17,ENSG00000161547.8,76737331,chr17-76752153-G-C,rs16969259,-1,G,C,76752153,14822,76540723,76933939,211430
17,ENSG00000126861.3,31297239,chr17-31305974-A-G,rs16972178,-1,A,G,31305974,8735,31100631,31493847,205343
17,ENSG00000133195.6,73092688,chr17-73153977-C-A,rs16977537,-1,C,A,73153977,61289,72896080,73289296,257897
17,ENSG00000154803.7,17237168,chr17-17244311-C-T,rs1708628,-1,C,T,17244311,7143,17040560,17433776,203751
17,ENSG00000186868.10,45894554,chr17-45704381-C-T,rs1724425,1,C,T,45704381,190173,45697946,46091162,6435
17,ENSG00000141576.8,76240493,chr17-76222525-T-C,rs17508653,-1,T,C,76222525,17968,76043885,76437101,178640
17,ENSG00000172716.11,35373621,chr17-35374471-T-C,rs17548596,-1,T,C,35374471,850,35177013,35570229,197458
17,ENSG00000168591.10,44186972,chr17-44278330-C-T,rs17614452,1,C,T,44278330,91358,43990364,44383580,287966
17,ENSG00000167183.1,47957883,chr17-48143648-T-G,rs17618704,-1,T,G,48143648,185765,47761275,48154491,382373
17,ENSG00000108829.9,50397523,chr17-50459774-A-G,rs17641254,-1,A,G,50459774,62251,50200915,50594131,258859
17,ENSG00000167740.3,4143197,chr17-4104397-C-A,rs17763879,1,C,A,4104397,38800,3946589,4339805,157808
17,ENSG00000167543.9,29568701,chr17-29544007-A-G,rs17766675,1,A,G,29544007,24694,29372093,29765309,171914
17,ENSG00000167895.8,78130771,chr17-78139331-G-T,rs17773854,1,G,T,78139331,8560,77934163,78327379,205168
17,ENSG00000109063.7,10657309,chr17-10722486-T-C,rs17816912,-1,T,C,10722486,65177,10460701,10853917,261785
17,ENSG00000136436.9,48831035,chr17-48873507-A-G,rs178467,1,A,G,48873507,42472,48634427,49027643,239080
17,ENSG00000198783.3,34961540,chr17-35121799-T-C,rs1871892,1,T,C,35121799,160259,34764932,35158148,356867
17,ENSG00000131771.7,39626952,chr17-39639407-T-G,rs1874224,1,T,G,39639407,12455,39430344,39823560,209063
17,ENSG00000072818.6,7336529,chr17-7334027-T-C,rs2047803,1,T,C,7334027,2502,7139921,7533137,194106
17,ENSG00000087111.14,28571524,chr17-28547296-G-A,rs2070139,-1,G,A,28547296,24228,28374916,28768132,172380
17,ENSG00000215644.4,81804150,chr17-81847258-G-A,rs2070871,1,G,A,81847258,43108,81607542,82000758,239716
17,ENSG00000141522.6,81871337,chr17-81847258-G-A,rs2070871,-1,G,A,81847258,24079,81674729,82067945,172529
17,ENSG00000006740.10,12789498,chr17-12940809-A-G,rs2072256,1,A,G,12940809,151311,12592890,12986106,347919
17,ENSG00000108405.3,3916465,chr17-3904738-A-G,rs2074989,-1,A,G,3904738,11727,3719857,4113073,184881
17,ENSG00000141510.9,7687490,chr17-7583790-A-G,rs2075230,-1,A,G,7583790,103700,7490882,7884098,92908
17,ENSG00000072210.12,19648751,chr17-19734840-A-G,rs2108967,1,A,G,19734840,86089,19452143,19845359,282697
17,ENSG00000136449.9,50508439,chr17-50458686-T-C,rs2125902,1,T,C,50458686,49753,50311831,50705047,146855
17,ENSG00000087191.7,63827431,chr17-63728247-G-A,rs2137144,1,G,A,63728247,99184,63630823,64024039,97424
17,ENSG00000256806.1,6651762,chr17-6663871-A-G,rs218663,1,A,G,6663871,12109,6455154,6848370,208717
17,ENSG00000186075.7,39868202,chr17-40017100-C-T,rs2227331,1,C,T,40017100,148898,39671594,40064810,345506
17,ENSG00000072778.12,7219938,chr17-7229237-C-G,rs222837,1,C,G,7229237,9299,7023330,7416546,205907
17,ENSG00000072778.12,7219938,chr17-7229237-C-T,rs222837,1,C,T,7229237,9299,7023330,7416546,205907
17,ENSG00000181481.7,30971039,chr17-30953423-G-A,rs2232276,1,G,A,30953423,17616,30774431,31167647,178992
17,ENSG00000153933.5,56834151,chr17-56834568-G-A,rs2235092,1,G,A,56834568,417,56637543,57030759,197025
17,ENSG00000168646.7,65561648,chr17-65558473-G-A,rs2240308,-1,G,A,65558473,3175,65365040,65758256,193433
17,ENSG00000141543.4,80147128,chr17-80140033-G-A,rs2241886,-1,G,A,80140033,7095,79950520,80343736,189513
17,ENSG00000128482.9,19411232,chr17-19551420-G-A,rs2247436,1,G,A,19551420,140188,19214624,19607840,336796
17,ENSG00000224877.2,81239318,chr17-81239762-T-C,rs2255166,1,T,C,81239762,444,81042710,81435926,197052
17,ENSG00000214226.4,56833920,chr17-56735154-C-A,rs227666,-1,C,A,56735154,98766,56637312,57030528,97842
17,ENSG00000070540.7,68457496,chr17-68434373-G-A,rs2287301,-1,G,A,68434373,23123,68260888,68654104,173485
17,ENSG00000141349.3,44070735,chr17-44061024-C-T,rs228762,1,C,T,44061024,9711,43874127,44267343,186897
17,ENSG00000125319.8,44141930,chr17-44018516-T-C,rs228781,1,T,C,44018516,123414,43945322,44338538,73194
17,ENSG00000214447.3,44899774,chr17-44883641-C-T,rs2289677,1,C,T,44883641,16133,44703166,45096382,180475
17,ENSG00000181513.9,45135687,chr17-45254998-A-G,rs2291448,1,A,G,45254998,119311,44939079,45332295,315919
17,ENSG00000083457.6,3801188,chr17-3695750-C-T,rs2293880,-1,C,T,3695750,105438,3604580,3997796,91170
17,ENSG00000011143.11,58219255,chr17-58305116-C-T,rs2301868,-1,C,T,58305116,85861,58022647,58415863,282469
17,ENSG00000011052.16,51153590,chr17-51153539-C-T,rs2302254,1,C,T,51153539,51,50956982,51350198,196557
17,ENSG00000181523.7,80220333,chr17-80201684-T-C,rs2304856,-1,T,C,80201684,18649,80023725,80416941,177959
17,ENSG00000213977.3,3668578,chr17-3694724-T-C,rs2318104,-1,T,C,3694724,26146,3471970,3865186,222754
17,ENSG00000141295.8,47841273,chr17-47844540-T-C,rs2325752,-1,T,C,47844540,3267,47644665,48037881,199875
17,ENSG00000183018.3,4498881,chr17-4497551-A-C,rs2326064,1,A,C,4497551,1330,4302273,4695489,195278
17,ENSG00000196704.6,68248043,chr17-68263144-C-T,rs2362726,1,C,T,68263144,15101,68051435,68444651,211709
17,ENSG00000092931.6,76738119,chr17-76748932-C-T,rs2429452,1,C,T,76748932,10813,76541511,76934727,207421
17,ENSG00000176974.11,18363550,chr17-18362153-C-T,rs2461837,-1,C,T,18362153,1397,18166942,18560158,195211
17,ENSG00000213246.1,58352201,chr17-58326988-A-G,rs2526378,-1,A,G,58326988,25213,58155593,58548809,171395
17,ENSG00000154920.10,50373229,chr17-50211709-C-A,rs2586502,1,C,A,50211709,161520,50176621,50569837,35088
17,ENSG00000108556.7,4903098,chr17-4892012-C-T,rs2586532,-1,C,T,4892012,11086,4706490,5099706,185522
17,ENSG00000213859.3,7352162,chr17-7332498-C-G,rs28712647,1,C,G,7332498,19664,7155554,7548770,176944
17,ENSG00000004660.10,3893053,chr17-3896924-C-G,rs28930668,-1,C,G,3896924,3871,3696445,4089661,200479
17,ENSG00000004660.10,3893053,chr17-3896924-C-T,rs28930668,-1,C,T,3896924,3871,3696445,4089661,200479
17,ENSG00000177602.4,3723903,chr17-3729298-C-T,rs2915555,1,C,T,3729298,5395,3527295,3920511,202003
17,ENSG00000004142.6,28357527,chr17-28338742-C-A,rs3093720,-1,C,A,28338742,18785,28160919,28554135,177823
17,ENSG00000170689.7,48626358,chr17-48679683-G-A,rs3096645,-1,G,A,48679683,53325,48429750,48822966,249933
17,ENSG00000108578.8,30291944,chr17-30331992-C-T,rs3110095,-1,C,T,30331992,40048,30095336,30488552,236656
17,ENSG00000258315.1,7014782,chr17-6974080-G-A,rs311734,1,G,A,6974080,40702,6818174,7211390,155906
17,ENSG00000005156.5,34980512,chr17-34986292-G-A,rs3135966,1,G,A,34986292,5780,34783904,35177120,202388
17,ENSG00000108298.4,39200283,chr17-39145832-C-T,rs34266566,1,C,T,39145832,54451,39003675,39396891,142157
17,ENSG00000175155.3,59331655,chr17-59404122-C-T,rs34557869,1,C,T,59404122,72467,59135047,59528263,269075
17,ENSG00000161921.10,4739928,chr17-4903019-G-A,rs34563587,-1,G,A,4903019,163091,4543320,4936536,359699
17,ENSG00000129204.11,5116032,chr17-5029546-C-T,rs346818,1,C,T,5029546,86486,4919424,5312640,110122
17,ENSG00000198231.6,63774170,chr17-63949976-G-A,rs34684062,1,G,A,63949976,175806,63577562,63970778,372414
17,ENSG00000182156.5,79730943,chr17-79722218-C-T,rs35246623,1,C,T,79722218,8725,79534335,79927551,187883
17,ENSG00000167711.9,1742871,chr17-1745728-C-T,rs35259159,1,C,T,1745728,2857,1546263,1939479,199465
17,ENSG00000185105.4,81947233,chr17-81976318-C-A,rs35344256,-1,C,A,81976318,29085,81750625,82143841,225693
17,ENSG00000173801.11,41786711,chr17-41784385-C-T,rs35569264,-1,C,T,41784385,2326,41590103,41983319,194282
17,ENSG00000173838.6,62808314,chr17-62667879-A-C,rs35769372,-1,A,C,62667879,140435,62611706,63004922,56173
17,ENSG00000167100.10,50130160,chr17-50090211-C-T,rs36103008,-1,C,T,50090211,39949,49933552,50326768,156659
17,ENSG00000187997.6,78146385,chr17-78166053-C-T,rs3644,1,C,T,78166053,19668,77949777,78342993,216276
17,ENSG00000219200.5,7012624,chr17-7113665-A-T,rs367953,1,A,T,7113665,101041,6816016,7209232,297649
17,ENSG00000108423.9,59892943,chr17-59707167-C-A,rs3744382,-1,C,A,59707167,185776,59696335,60089551,10832
17,ENSG00000072134.10,19237366,chr17-19403853-G-C,rs3744391,1,G,C,19403853,166487,19040758,19433974,363095
17,ENSG00000072134.10,19237366,chr17-19403853-G-T,rs3744391,1,G,T,19403853,166487,19040758,19433974,363095
17,ENSG00000181856.10,7281718,chr17-7289936-G-A,rs3744405,1,G,A,7289936,8218,7085110,7478326,204826
17,ENSG00000141570.6,79797077,chr17-79784892-G-A,rs3751957,-1,G,A,79784892,12185,79600469,79993685,184423
17,ENSG00000187838.10,7394525,chr17-7416823-C-T,rs3752031,-1,C,T,7416823,22298,7197917,7591133,218906
17,ENSG00000007202.7,28645158,chr17-28738193-T-C,rs3809797,-1,T,C,28738193,93035,28448550,28841766,289643
17,ENSG00000159111.8,47831541,chr17-47826797-A-G,rs3809869,-1,A,G,47826797,4744,47634933,48028149,191864
17,ENSG00000184988.2,43211875,chr17-43019464-G-A,rs382571,1,G,A,43019464,192411,43015267,43408483,4197
17,ENSG00000141293.9,48430214,chr17-48432085-C-T,rs3826397,-1,C,T,48432085,1871,48233606,48626822,198479
17,ENSG00000178971.8,8248056,chr17-8229445-T-C,rs3826543,-1,T,C,8229445,18611,8051448,8444664,177997
17,ENSG00000214087.4,81683797,chr17-81655869-T-C,rs3830068,-1,T,C,81655869,27928,81487189,81880405,168680
17,ENSG00000182446.8,81637112,chr17-81655869-T-C,rs3830068,-1,T,C,81655869,18757,81440504,81833720,215365
17,ENSG00000141480.12,4710632,chr17-4783119-A-C,rs3851,1,A,C,4783119,72487,4514024,4907240,269095
17,ENSG00000169738.1,82037697,chr17-82022880-C-A,rs3934983,-1,C,A,82022880,14817,81841089,82234305,181791
17,ENSG00000181396.7,82418586,chr17-82436204-G-C,rs4072532,-1,G,C,82436204,17618,82221978,82615194,214226
17,ENSG00000181396.7,82418586,chr17-82436204-G-A,rs4072532,-1,G,A,82436204,17618,82221978,82615194,214226
17,ENSG00000177728.9,75456635,chr17-75545929-G-A,rs4073422,1,G,A,75545929,89294,75260027,75653243,285902
17,ENSG00000132386.5,1762060,chr17-1942656-T-C,rs4073661,1,T,C,1942656,180596,1565452,1958668,377204
17,ENSG00000240505.2,16972118,chr17-16987505-T-C,rs4075606,-1,T,C,16987505,15387,16775510,17168726,211995
17,ENSG00000108370.10,65137370,chr17-65106939-C-T,rs413223,1,C,T,65106939,30431,64940762,65333978,166177
17,ENSG00000109046.9,27294114,chr17-27362796-A-G,rs4239230,1,A,G,27362796,68682,27097506,27490722,265290
17,ENSG00000108950.6,68601367,chr17-68731783-C-T,rs4368217,-1,C,T,68731783,130416,68404759,68797975,327024
17,ENSG00000179598.4,17206333,chr17-17211272-A-G,rs4399589,-1,A,G,17211272,4939,17009725,17402941,201547
17,ENSG00000171475.8,40219304,chr17-40258097-G-T,rs4566234,1,G,T,40258097,38793,40022696,40415912,235401
17,ENSG00000197417.7,3636250,chr17-3610425-G-A,rs465563,-1,G,A,3610425,25825,3439642,3832858,170783
17,ENSG00000171634.11,67825503,chr17-67782457-G-A,rs4791114,1,G,A,67782457,43046,67628895,68022111,153562
17,ENSG00000109113.11,28717868,chr17-28898919-C-T,rs4795473,-1,C,T,28898919,181051,28521260,28914476,377659
17,ENSG00000131242.10,31391675,chr17-31491876-A-G,rs4795613,1,A,G,31491876,100201,31195067,31588283,296809
17,ENSG00000176749.3,32486993,chr17-32497063-G-A,rs4795701,1,G,A,32497063,10070,32290385,32683601,206678
17,ENSG00000168961.11,27631188,chr17-27568007-G-A,rs4795747,1,G,A,27568007,63181,27434580,27827796,133427
17,ENSG00000131462.2,42609683,chr17-42455590-C-T,rs4796664,1,C,T,42455590,154093,42413075,42806291,42515
17,ENSG00000141756.11,41813004,chr17-41940220-G-A,rs4796744,1,G,A,41940220,127216,41616396,42009612,323824
17,ENSG00000171298.8,80101581,chr17-80084052-G-A,rs4889814,1,G,A,80084052,17529,79904973,80298189,179079
17,ENSG00000131759.12,40309180,chr17-40447297-A-G,rs4890114,1,A,G,40447297,138117,40112572,40505788,334725
17,ENSG00000141127.8,18858131,chr17-18795758-A-G,rs4924927,1,A,G,18795758,62373,18661523,19054739,134235
17,ENSG00000178789.3,74531475,chr17-74676064-C-A,rs495713,-1,C,A,74676064,144589,74334867,74728083,341197
17,ENSG00000136492.3,61863528,chr17-61863272-C-T,rs4988340,-1,C,T,61863272,256,61666920,62060136,196352
17,ENSG00000167447.7,59210035,chr17-59294071-A-G,rs534242,1,A,G,59294071,84036,59013427,59406643,280644
17,ENSG00000212658.1,41302851,chr17-41137194-A-G,rs55667536,-1,A,G,41137194,165657,41106243,41499459,30951
17,ENSG00000132475.3,75779779,chr17-75764739-G-A,rs55715426,-1,G,A,75764739,15040,75583171,75976387,181568
17,ENSG00000132481.1,75878581,chr17-75764739-G-A,rs55715426,-1,G,A,75764739,113842,75681973,76075189,82766
17,ENSG00000132478.4,75784806,chr17-75651349-C-T,rs55853884,1,C,T,75651349,133457,75588198,75981414,63151
17,ENSG00000187624.7,410325,chr17-386653-G-A,rs56161639,1,G,A,386653,23672,213717,606933,172936
17,ENSG00000141524.9,78128755,chr17-78250065-C-T,rs57949244,-1,C,T,78250065,121310,77932147,78325363,317918
17,ENSG00000177303.4,75515537,chr17-75538665-T-G,rs58631882,-1,T,G,75538665,23128,75318929,75712145,219736
17,ENSG00000170049.5,7929856,chr17-8035059-C-T,rs60415448,-1,C,T,8035059,105203,7733248,8126464,301811
17,ENSG00000129673.4,76467603,chr17-76489222-T-G,rs61088918,1,T,G,76489222,21619,76270995,76664211,218227
17,ENSG00000177885.8,75405678,chr17-75266931-C-T,rs61739324,-1,C,T,75266931,138747,75209070,75602286,57861
17,ENSG00000175931.7,76453152,chr17-76468754-C-T,rs61739395,-1,C,T,76468754,15602,76256544,76649760,212210
17,ENSG00000175931.7,76453152,chr17-76468754-C-A,rs61739395,-1,C,A,76468754,15602,76256544,76649760,212210
17,ENSG00000182557.3,4433940,chr17-4541790-G-A,rs62066360,1,G,A,4541790,107850,4237332,4630548,304458
17,ENSG00000180616.3,73165010,chr17-73157397-G-A,rs62071603,1,G,A,73157397,7613,72968402,73361618,188995
17,ENSG00000078687.11,78005056,chr17-77889088-C-T,rs62078513,1,C,T,77889088,115968,77808448,78201664,80640
17,ENSG00000182534.7,76710965,chr17-76752247-T-C,rs62086788,-1,T,C,76752247,41282,76514357,76907573,237890
17,ENSG00000167693.12,979776,chr17-999562-G-A,rs62640032,-1,G,A,999562,19786,783168,1176384,216394
17,ENSG00000168792.2,29567037,chr17-29564846-A-G,rs636000,-1,A,G,29564846,2191,29370429,29763645,194417
17,ENSG00000171595.8,74274234,chr17-74282731-A-G,rs6501705,1,A,G,74282731,8497,74077626,74470842,205105
17,ENSG00000175711.4,83051770,chr17-83083462-A-G,rs6502044,-1,A,G,83083462,31692,82855162,83248378,228300
17,ENSG00000108523.11,4940268,chr17-5053297-A-G,rs6502832,1,A,G,5053297,113029,4743660,5136876,309637
17,ENSG00000007171.11,27800529,chr17-27937085-T-G,rs6505066,-1,T,G,27937085,136556,27603921,27997137,333164
17,ENSG00000161513.6,74872994,chr17-74894376-T-A,rs689992,-1,T,A,74894376,21382,74676386,75069602,217990
17,ENSG00000180901.5,75047225,chr17-74904329-A-C,rs690476,1,A,C,74904329,142896,74850617,75243833,53712
17,ENSG00000141527.10,80170030,chr17-80209612-T-C,rs709678,1,T,C,80209612,39582,79973422,80366638,236190
17,ENSG00000184060.5,30921945,chr17-30935755-T-C,rs7208859,1,T,C,30935755,13810,30725337,31118553,210418
17,ENSG00000131473.10,41918951,chr17-42029141-A-G,rs7210636,-1,A,G,42029141,110190,41722343,42115559,306798
17,ENSG00000185156.4,8799365,chr17-8900268-T-C,rs7210930,-1,T,C,8900268,100903,8602757,8995973,297511
17,ENSG00000179314.9,6070379,chr17-5991699-G-A,rs7211811,1,G,A,5991699,78680,5873771,6266987,117928
17,ENSG00000170921.9,62966235,chr17-63094193-A-G,rs7213524,1,A,G,63094193,127958,62769627,63162843,324566
17,ENSG00000132507.13,7307628,chr17-7370758-C-T,rs7214863,1,C,T,7370758,63130,7111020,7504236,259738
17,ENSG00000177294.6,6776215,chr17-6741036-T-G,rs7215766,1,T,G,6741036,35179,6579607,6972823,161429
17,ENSG00000174292.7,7381089,chr17-7492230-A-G,rs7217258,1,A,G,7492230,111141,7184481,7577697,307749
17,ENSG00000169660.10,82418347,chr17-82413572-A-G,rs7217458,1,A,G,82413572,4775,82221739,82614955,191833
17,ENSG00000094804.4,40287879,chr17-40366397-C-T,rs7218663,1,C,T,40366397,78518,40091271,40484487,275126
17,ENSG00000007314.6,63972918,chr17-63968195-G-A,rs7218917,-1,G,A,63968195,4723,63776310,64169526,191885
17,ENSG00000172171.5,30906238,chr17-30841302-G-A,rs7219607,-1,G,A,30841302,64936,30709630,31102846,131672
17,ENSG00000172171.5,30906238,chr17-30841302-G-T,rs7219607,-1,G,T,30841302,64936,30709630,31102846,131672
17,ENSG00000173065.8,28842790,chr17-29014416-A-G,rs7220474,-1,A,G,29014416,171626,28646182,29039398,368234
17,ENSG00000030582.10,44345302,chr17-44307733-G-A,rs7221978,1,G,A,44307733,37569,44148694,44541910,159039
17,ENSG00000108953.10,1400222,chr17-1352208-G-C,rs7224258,-1,G,C,1352208,48014,1203614,1596830,148594
17,ENSG00000239704.4,15467621,chr17-15514705-A-C,rs72824497,-1,A,C,15514705,47084,15271013,15664229,243692
17,ENSG00000161958.5,7439512,chr17-7310241-C-G,rs72840907,1,C,G,7310241,129271,7242904,7636120,67337
17,ENSG00000170004.12,7888789,chr17-8025664-T-C,rs72841487,1,T,C,8025664,136875,7692181,8085397,333483
17,ENSG00000176108.5,80991841,chr17-81036173-A-G,rs72851872,1,A,G,81036173,44332,80795233,81188449,240940
17,ENSG00000182173.7,75516528,chr17-75541512-C-T,rs72851957,1,C,T,75541512,24984,75319920,75713136,221592
17,ENSG00000196544.6,8190180,chr17-8340280-C-T,rs73250854,-1,C,T,8340280,150100,7993572,8386788,346708
17,ENSG00000181610.7,57850044,chr17-57957658-A-C,rs73315832,-1,A,C,57957658,107614,57653436,58046652,304222
17,ENSG00000121073.7,49707964,chr17-49514247-T-G,rs734194,-1,T,G,49514247,193717,49511356,49904572,2891
17,ENSG00000185504.11,81552353,chr17-81516973-T-C,rs7342974,-1,T,C,81516973,35380,81355745,81748961,161228
17,ENSG00000076351.7,28406212,chr17-28396803-C-T,rs739439,-1,C,T,28396803,9409,28209604,28602820,187199
17,ENSG00000062716.4,59707654,chr17-59815934-A-G,rs74256802,1,A,G,59815934,108280,59511046,59904262,304888
17,ENSG00000141378.11,59707430,chr17-59815934-A-G,rs74256802,-1,A,G,59815934,108504,59510822,59904038,305112
17,ENSG00000244045.3,28357647,chr17-28413082-G-A,rs74256941,1,G,A,28413082,55435,28161039,28554255,252043
17,ENSG00000167131.10,44899729,chr17-44932518-G-A,rs744281,1,G,A,44932518,32789,44703121,45096337,229397
17,ENSG00000132141.8,34961460,chr17-34831774-T-C,rs744298,-1,T,C,34831774,129686,34764852,35158068,66922
17,ENSG00000185379.14,35119860,chr17-35053870-C-T,rs74818874,-1,C,T,35053870,65990,34923252,35316468,130618
17,ENSG00000185379.14,35119860,chr17-35053870-C-A,rs74818874,-1,C,A,35053870,65990,34923252,35316468,130618
17,ENSG00000108828.9,43022385,chr17-42894710-G-A,rs74933984,-1,G,A,42894710,127675,42825777,43218993,68933
17,ENSG00000108828.9,43022385,chr17-42894710-G-T,rs74933984,-1,G,T,42894710,127675,42825777,43218993,68933
17,ENSG00000167703.9,1628834,chr17-1681030-A-G,rs7503397,-1,A,G,1681030,52196,1432226,1825442,248804
17,ENSG00000175906.2,43398993,chr17-43410083-G-A,rs75854888,1,G,A,43410083,11090,43202385,43595601,207698
17,ENSG00000183688.4,445939,chr17-497719-A-G,rs759974,-1,A,G,497719,51780,249331,642547,248388
17,ENSG00000236383.1,43228623,chr17-43347027-G-T,rs76063231,-1,G,T,43347027,118404,43032015,43425231,315012
17,ENSG00000108671.4,32444510,chr17-32298712-A-G,rs763545,1,A,G,32298712,145798,32247902,32641118,50810
17,ENSG00000091622.10,6556555,chr17-6570204-C-T,rs76525613,-1,C,T,6570204,13649,6359947,6753163,210257
17,ENSG00000063015.12,29006033,chr17-28988520-C-A,rs76813379,-1,C,A,28988520,17513,28809425,29202641,179095
17,ENSG00000109016.12,21126964,chr17-21206913-C-T,rs77011344,1,C,T,21206913,79949,20930356,21323572,276557
17,ENSG00000141698.10,41836232,chr17-41807103-C-T,rs77237766,-1,C,T,41807103,29129,41639624,42032840,167479
17,ENSG00000125445.5,75261879,chr17-75278477-G-A,rs77860123,1,G,A,75278477,16598,75065271,75458487,213206
17,ENSG00000185722.9,4263979,chr17-4420839-C-G,rs78057571,-1,C,G,4420839,156860,4067371,4460587,353468
17,ENSG00000185722.9,4263979,chr17-4420839-C-T,rs78057571,-1,C,T,4420839,156860,4067371,4460587,353468
17,ENSG00000177374.7,2055103,chr17-1968876-T-C,rs78116599,1,T,C,1968876,86227,1858495,2251711,110381
17,ENSG00000166260.6,54968654,chr17-54834860-G-A,rs78309177,-1,G,A,54834860,133794,54772046,55165262,62814
17,ENSG00000167900.6,78187052,chr17-78234103-C-T,rs78780583,-1,C,T,78234103,47051,77990444,78383660,243659
17,ENSG00000169733.6,82051811,chr17-81954288-G-A,rs79066457,-1,G,A,81954288,97523,81855203,82248419,99085
17,ENSG00000167840.9,5111841,chr17-5007944-T-C,rs79554147,-1,T,C,5007944,103897,4915233,5308449,92711
17,ENSG00000182963.4,44830287,chr17-44773706-G-A,rs79592537,-1,G,A,44773706,56581,44633679,45026895,140027
17,ENSG00000173812.4,41688885,chr17-41714986-T-G,rs79715822,1,T,G,41714986,26101,41492277,41885493,222709
17,ENSG00000154945.6,50707914,chr17-50743979-G-A,rs79777439,-1,G,A,50743979,36065,50511306,50904522,232673
17,ENSG00000128422.10,41624575,chr17-41709861-G-A,rs80303456,-1,G,A,41709861,85286,41427967,41821183,281894
17,ENSG00000073584.13,40647818,chr17-40594044-G-C,rs803119,-1,G,C,40594044,53774,40451210,40844426,142834
17,ENSG00000091542.7,18183828,chr17-18142976-T-C,rs8065026,1,T,C,18142976,40852,17987220,18380436,155756
17,ENSG00000173894.6,79778148,chr17-79723327-A-G,rs8065292,1,A,G,79723327,54821,79581540,79974756,141787
17,ENSG00000132510.6,7834217,chr17-7855428-C-T,rs8065467,1,C,T,7855428,21211,7637609,8030825,217819
17,ENSG00000108309.7,44308601,chr17-44289209-C-G,rs8067711,1,C,G,44289209,19392,44111993,44505209,177216
17,ENSG00000172301.5,31859244,chr17-31831625-G-A,rs8068039,-1,G,A,31831625,27619,31662636,32055852,168989
17,ENSG00000205045.3,35537678,chr17-35513246-A-G,rs8068906,-1,A,G,35513246,24432,35341070,35734286,172176
17,ENSG00000161714.6,45132515,chr17-45151932-A-C,rs8070447,-1,A,C,45151932,19417,44935907,45329123,216025
17,ENSG00000153944.5,57256523,chr17-57290729-C-T,rs8071867,1,C,T,57290729,34206,57059915,57453131,230814
17,ENSG00000141574.2,82333766,chr17-82415501-G-T,rs8072110,-1,G,T,82415501,81735,82137158,82530374,278343
17,ENSG00000170412.11,74432088,chr17-74393831-G-A,rs8073071,1,G,A,74393831,38257,74235480,74628696,158351
17,ENSG00000167842.11,5486566,chr17-5523795-T-C,rs8074853,1,T,C,5523795,37229,5289958,5683174,233837
17,ENSG00000008283.10,63446306,chr17-63549340-G-A,rs8076942,-1,G,A,63549340,103034,63249698,63642914,299642
17,ENSG00000141696.6,41811949,chr17-41655431-G-A,rs8077123,-1,G,A,41655431,156518,41615341,42008557,40090
17,ENSG00000243678.6,51166411,chr17-51132389-G-A,rs8078191,1,G,A,51132389,34022,50969803,51363019,162586
17,ENSG00000108582.5,30378927,chr17-30340264-G-A,rs8079175,1,G,A,30340264,38663,30182319,30575535,157945
17,ENSG00000161940.6,7023050,chr17-7093521-A-G,rs8079569,1,A,G,7093521,70471,6826442,7219658,267079
17,ENSG00000092929.5,75844404,chr17-75931877-G-C,rs8081004,-1,G,C,75931877,87473,75647796,76041012,284081
17,ENSG00000184640.10,77281499,chr17-77450037-T-G,rs8081324,1,T,G,77450037,168538,77084891,77478107,365146
17,ENSG00000129646.8,76308276,chr17-76258437-T-C,rs8082199,-1,T,C,76258437,49839,76111668,76504884,146769
17,ENSG00000121053.4,58192726,chr17-58242569-A-C,rs8178289,1,A,C,58242569,49843,57996118,58389334,246451
17,ENSG00000167716.12,1724704,chr17-1917456-G-A,rs882495,1,G,A,1917456,192752,1528096,1921312,389360
17,ENSG00000125450.5,75205679,chr17-75208435-T-C,rs899326,1,T,C,75208435,2756,75009071,75402287,199364
17,ENSG00000133193.7,73232394,chr17-73337395-T-C,rs904388,-1,T,C,73337395,105001,73035786,73429002,301609
17,ENSG00000008838.11,40054408,chr17-39977669-G-A,rs921651,-1,G,A,39977669,76739,39857800,40251016,119869
17,ENSG00000177469.10,42423256,chr17-42402831-G-A,rs9252,-1,G,A,42402831,20425,42226648,42619864,176183
17,ENSG00000167720.7,2303950,chr17-2296099-T-C,rs927572,1,T,C,2296099,7851,2107342,2500558,188757
17,ENSG00000108946.7,68512430,chr17-68361311-C-A,rs9284341,1,C,A,68361311,151119,68315822,68709038,45489
17,ENSG00000141068.8,27456448,chr17-27522312-T-C,rs940015,1,T,C,27522312,65864,27259840,27653056,262472
17,ENSG00000175106.10,15563483,chr17-15586837-G-C,rs949426,-1,G,C,15586837,23354,15366875,15760091,219962
17,ENSG00000221995.3,29078857,chr17-29009544-T-C,rs9652879,-1,T,C,29009544,69313,28882249,29275465,127295
17,ENSG00000172123.7,35432500,chr17-35412930-G-A,rs9889442,-1,G,A,35412930,19570,35235892,35629108,177038
17,ENSG00000166685.5,73193055,chr17-73243459-C-T,rs9890798,1,C,T,73243459,50404,72996447,73389663,247012
17,ENSG00000133026.7,8630725,chr17-8574230-A-G,rs9890899,-1,A,G,8574230,56495,8434117,8827333,140113
17,ENSG00000126858.11,32142502,chr17-32132039-T-C,rs9891455,1,T,C,32132039,10463,31945894,32339110,186145
17,ENSG00000236320.2,35560819,chr17-35545238-G-A,rs9897663,-1,G,A,35545238,15581,35364211,35757427,181027
17,ENSG00000236320.2,35560819,chr17-35545238-G-T,rs9897663,-1,G,T,35545238,15581,35364211,35757427,181027
17,ENSG00000132530.11,6756046,chr17-6899220-A-C,rs9897943,1,A,C,6899220,143174,6559438,6952654,339782
17,ENSG00000259224.1,7481446,chr17-7419121-G-T,rs9899036,1,G,T,7419121,62325,7284838,7678054,134283
17,ENSG00000072849.6,5486178,chr17-5493377-C-T,rs9901132,-1,C,T,5493377,7199,5289570,5682786,203807
17,ENSG00000109066.8,74776499,chr17-74841693-G-A,rs9901283,1,G,A,74841693,65194,74579891,74973107,261802
17,ENSG00000141569.5,75896951,chr17-75900965-A-G,rs9902371,-1,A,G,75900965,4014,75700343,76093559,200622
17,ENSG00000179604.7,73312001,chr17-73315555-G-A,rs9902729,-1,G,A,73315555,3554,73115393,73508609,200162
17,ENSG00000127804.6,2511888,chr17-2514341-A-C,rs9903321,-1,A,C,2514341,2453,2315280,2708496,199061
17,ENSG00000121075.3,61452422,chr17-61418877-T-C,rs9905140,1,T,C,61418877,33545,61255814,61649030,163063
17,ENSG00000141316.6,32991847,chr17-33080328-G-A,rs9906088,1,G,A,33080328,88481,32795239,33188455,285089
17,ENSG00000089685.7,78214253,chr17-78232549-C-T,rs9907137,1,C,T,78232549,18296,78017645,78410861,214904
17,ENSG00000161395.7,39688057,chr17-39615493-T-C,rs9907501,-1,T,C,39615493,72564,39491449,39884665,124044
17,ENSG00000136490.3,63700125,chr17-63791011-A-G,rs9907702,-1,A,G,63791011,90886,63503517,63896733,287494
17,ENSG00000198336.4,47209348,chr17-47075548-C-A,rs9908463,1,C,A,47075548,133800,47012740,47405956,62808
17,ENSG00000177302.7,18314994,chr17-18344707-T-C,rs9909104,-1,T,C,18344707,29713,18118386,18511602,226321
17,ENSG00000075461.4,66964707,chr17-67038851-C-A,rs9910905,1,C,A,67038851,74144,66768099,67161315,270752
17,ENSG00000129226.8,7579638,chr17-7542055-C-T,rs9912001,1,C,T,7542055,37583,7383030,7776246,159025
17,ENSG00000168646.7,65561648,chr17-65567788-A-C,rs1017020,-1,A,C,65567788,6140,65365040,65758256,202748
17,ENSG00000129244.4,7650926,chr17-7657424-C-T,rs1050540,1,C,T,7657424,6498,7454318,7847534,203106
17,ENSG00000223510.2,14236862,chr17-14074847-A-G,rs10521253,-1,A,G,14074847,162015,14040254,14433470,34593
17,ENSG00000108479.5,75765192,chr17-75822791-G-A,rs1106343,-1,G,A,75822791,57599,75568584,75961800,254207
17,ENSG00000172809.7,74203678,chr17-74049111-T-A,rs11077722,1,T,A,74049111,154567,74007070,74400286,42041
17,ENSG00000172809.7,74203678,chr17-74049111-T-G,rs11077722,1,T,G,74049111,154567,74007070,74400286,42041
17,ENSG00000141574.2,82333766,chr17-82359291-A-G,rs11077988,-1,A,G,82359291,25525,82137158,82530374,222133
17,ENSG00000141562.11,82458741,chr17-82446450-G-T,rs11077994,1,G,T,82446450,12291,82262133,82655349,184317
17,ENSG00000006695.5,14069504,chr17-14207584-A-G,rs11078234,1,A,G,14207584,138080,13872896,14266112,334688
17,ENSG00000008838.11,40054408,chr17-40033540-T-C,rs11078934,-1,T,C,40033540,20868,39857800,40251016,175740
17,ENSG00000007312.7,63932331,chr17-63965481-A-G,rs11079516,-1,A,G,63965481,33150,63735723,64128939,229758
17,ENSG00000186765.7,81528377,chr17-81458645-A-G,rs111269853,1,A,G,81458645,69732,81331769,81724985,126876
17,ENSG00000178502.4,41865423,chr17-41673050-A-C,rs111335146,-1,A,C,41673050,192373,41668815,42062031,4235
17,ENSG00000141564.9,80544838,chr17-80396348-G-A,rs112152354,1,G,A,80396348,148490,80348230,80741446,48118
17,ENSG00000129197.9,5420182,chr17-5594629-G-A,rs113050992,1,G,A,5594629,174447,5223574,5616790,371055
17,ENSG00000177731.8,18258738,chr17-18148792-G-A,rs114274755,-1,G,A,18148792,109946,18062130,18455346,86662
17,ENSG00000083454.16,3696155,chr17-3650288-G-A,rs114724281,-1,G,A,3650288,45867,3499547,3892763,150741
17,ENSG00000129214.9,7630135,chr17-7559238-G-A,rs11552708,1,G,A,7559238,70897,7433527,7826743,125711
17,ENSG00000167193.7,1456232,chr17-1495634-G-A,rs11559105,-1,G,A,1495634,39402,1259624,1652840,236010
17,ENSG00000187838.10,7394525,chr17-7422804-A-G,rs11652328,-1,A,G,7422804,28279,7197917,7591133,224887
17,ENSG00000168259.7,42017439,chr17-41934914-C-T,rs11652920,-1,C,T,41934914,82525,41820831,42214047,114083
17,ENSG00000132141.8,34961460,chr17-34796763-T-C,rs11653855,-1,T,C,34796763,164697,34764852,35158068,31911
17,ENSG00000073670.7,44758988,chr17-44578375-G-A,rs11654001,1,G,A,44578375,180613,44562380,44955596,15995
17,ENSG00000108439.4,47941571,chr17-47883499-T-C,rs11654010,1,T,C,47883499,58072,47744963,48138179,138536
17,ENSG00000167182.10,47896236,chr17-47883499-T-C,rs11654010,1,T,C,47883499,12737,47699628,48092844,183871
17,ENSG00000196704.6,68248043,chr17-68243952-G-A,rs11658645,1,G,A,68243952,4091,68051435,68444651,192517
17,ENSG00000169738.1,82037697,chr17-82024601-T-C,rs11659000,-1,T,C,82024601,13096,81841089,82234305,183512
17,ENSG00000187607.9,15699752,chr17-15698649-G-A,rs117200551,1,G,A,15698649,1103,15503144,15896360,195505
17,ENSG00000108582.5,30378927,chr17-30332001-A-C,rs117221215,1,A,C,30332001,46926,30182319,30575535,149682
17,ENSG00000169696.8,81977629,chr17-81992184-C-A,rs117574737,1,C,A,81992184,14555,81781021,82174237,211163
17,ENSG00000171861.6,782353,chr17-709178-G-A,rs118039311,1,G,A,709178,73175,585745,978961,123433
17,ENSG00000185379.14,35119860,chr17-35237460-A-G,rs11868175,-1,A,G,35237460,117600,34923252,35316468,314208
17,ENSG00000070540.7,68457496,chr17-68284941-T-C,rs11869470,-1,T,C,68284941,172555,68260888,68654104,24053
17,ENSG00000185813.4,81911399,chr17-82004134-A-G,rs11869686,-1,A,G,82004134,92735,81714791,82108007,289343
17,ENSG00000167302.5,81239055,chr17-81288651-T-C,rs12103824,-1,T,C,81288651,49596,81042447,81435663,246204
17,ENSG00000141570.6,79797077,chr17-79789145-A-G,rs12150587,-1,A,G,79789145,7932,79600469,79993685,188676
17,ENSG00000141540.5,74213571,chr17-74303078-T-C,rs12449937,1,T,C,74303078,89507,74016963,74410179,286115
17,ENSG00000169710.5,82098236,chr17-82048551-G-A,rs12452625,-1,G,A,82048551,49685,81901628,82294844,146923
17,ENSG00000171595.8,74274234,chr17-74239422-C-A,rs12452652,1,C,A,74239422,34812,74077626,74470842,161796
17,ENSG00000109016.12,21126964,chr17-21152632-A-G,rs12600689,1,A,G,21152632,25668,20930356,21323572,222276
17,ENSG00000181885.12,7262478,chr17-7269290-A-G,rs12601936,-1,A,G,7269290,6812,7065870,7459086,203420
17,ENSG00000129654.6,76141245,chr17-76188289-T-C,rs12602521,-1,T,C,76188289,47044,75944637,76337853,243652
17,ENSG00000108950.6,68601367,chr17-68566603-C-T,rs12603521,-1,C,T,68566603,34764,68404759,68797975,161844
17,ENSG00000179604.7,73312001,chr17-73284583-T-C,rs12795,-1,T,C,73284583,27418,73115393,73508609,169190
17,ENSG00000129195.9,6444455,chr17-6440203-C-A,rs12947557,1,C,A,6440203,4252,6247847,6641063,192356
17,ENSG00000129667.6,76501423,chr17-76503318-G-A,rs12948783,-1,G,A,76503318,1895,76304815,76698031,198503
17,ENSG00000131242.10,31391675,chr17-31535981-A-G,rs1548471,1,A,G,31535981,144306,31195067,31588283,340914
17,ENSG00000108433.10,46923160,chr17-46797087-C-T,rs1563304,1,C,T,46797087,126073,46726552,47119768,70535
17,ENSG00000186868.10,45894554,chr17-45707411-G-A,rs1617406,1,G,A,45707411,187143,45697946,46091162,9465
17,ENSG00000221926.5,15684311,chr17-15665794-C-T,rs163369,-1,C,T,15665794,18517,15487703,15880919,178091
17,ENSG00000120088.9,45784320,chr17-45679603-A-G,rs1635288,1,A,G,45679603,104717,45587712,45980928,91891
17,ENSG00000184922.7,45221885,chr17-45162714-C-T,rs16939893,1,C,T,45162714,59171,45025277,45418493,137437
17,ENSG00000141349.3,44070735,chr17-43935741-C-G,rs16940397,1,C,G,43935741,134994,43874127,44267343,61614
17,ENSG00000224383.2,63998351,chr17-64020486-C-T,rs16947352,1,C,T,64020486,22135,63801743,64194959,218743
17,ENSG00000183688.4,445939,chr17-615160-T-C,rs16953975,-1,T,C,615160,169221,249331,642547,365829
17,ENSG00000256806.1,6651762,chr17-6635354-T-C,rs16955991,1,T,C,6635354,16408,6455154,6848370,180200
17,ENSG00000087095.7,28042677,chr17-28022972-G-A,rs16964148,1,G,A,28022972,19705,27846069,28239285,176903
17,ENSG00000161405.11,39864312,chr17-39965864-G-A,rs16965465,-1,G,A,39965864,101552,39667704,40060920,298160
17,ENSG00000131462.2,42609683,chr17-42749299-C-T,rs16967975,1,C,T,42749299,139616,42413075,42806291,336224
17,ENSG00000108733.3,35578571,chr17-35498477-C-T,rs16971026,-1,C,T,35498477,80094,35381963,35775179,116514
17,ENSG00000166685.5,73193055,chr17-73235653-A-G,rs16977549,1,A,G,73235653,42598,72996447,73389663,239206
17,ENSG00000167721.5,2336457,chr17-2505381-T-C,rs17221733,-1,T,C,2505381,168924,2139849,2533065,365532
17,ENSG00000108848.9,50719603,chr17-50647469-C-T,rs17562467,1,C,T,50647469,72134,50522995,50916211,124474
17,ENSG00000125450.5,75205679,chr17-75259727-C-T,rs17568408,1,C,T,75259727,54048,75009071,75402287,250656
17,ENSG00000166750.4,35243072,chr17-35219913-T-C,rs17629798,1,T,C,35219913,23159,35046464,35439680,173449
17,ENSG00000073584.13,40647818,chr17-40581901-A-G,rs17709159,-1,A,G,40581901,65917,40451210,40844426,130691
17,ENSG00000141198.9,54900852,chr17-54793753-G-T,rs17709877,1,G,T,54793753,107099,54704244,55097460,89509
17,ENSG00000176749.3,32486993,chr17-32300645-T-C,rs17732573,1,T,C,32300645,186348,32290385,32683601,10260
17,ENSG00000108375.7,58417534,chr17-58521630-T-A,rs17741424,-1,T,A,58521630,104096,58220926,58614142,300704
17,ENSG00000132388.8,4366675,chr17-4310710-G-A,rs17764251,-1,G,A,4310710,55965,4170067,4563283,140643
17,ENSG00000141314.7,32265832,chr17-32279282-G-T,rs17780388,1,G,T,32279282,13450,32069224,32462440,210058
17,ENSG00000174282.7,7479631,chr17-7448844-T-C,rs17806566,-1,T,C,7448844,30787,7283023,7676239,165821
17,ENSG00000171928.8,18781183,chr17-18973283-A-C,rs17842752,1,A,C,18973283,192100,18584575,18977791,388708
17,ENSG00000141295.8,47841273,chr17-47840239-T-C,rs17856536,-1,T,C,47840239,1034,47644665,48037881,195574
17,ENSG00000185862.4,31314054,chr17-31168361-C-T,rs17878945,-1,C,T,31168361,145693,31117446,31510662,50915
17,ENSG00000126860.5,31321622,chr17-31456226-T-C,rs178870,-1,T,C,31456226,134604,31125014,31518230,331212
17,ENSG00000091622.10,6556555,chr17-6553611-C-T,rs1867274,-1,C,T,6553611,2944,6359947,6753163,193664
17,ENSG00000170425.2,15945130,chr17-15774570-T-G,rs1971159,1,T,G,15774570,170560,15748522,16141738,26048
17,ENSG00000132530.11,6756046,chr17-6753506-T-C,rs1983181,1,T,C,6753506,2540,6559438,6952654,194068
17,ENSG00000167861.10,74972759,chr17-74949750-C-T,rs1994718,-1,C,T,74949750,23009,74776151,75169367,173599
17,ENSG00000170412.11,74432088,chr17-74487632-G-A,rs2007766,1,G,A,74487632,55544,74235480,74628696,252152
17,ENSG00000132361.9,2711764,chr17-2803299-T-C,rs2028000,-1,T,C,2803299,91535,2515156,2908372,288143
17,ENSG00000184988.2,43211875,chr17-43377341-G-A,rs2061872,1,G,A,43377341,165466,43015267,43408483,362074
17,ENSG00000184988.2,43211875,chr17-43377341-G-C,rs2061872,1,G,C,43377341,165466,43015267,43408483,362074
17,ENSG00000258315.1,7014782,chr17-6996757-G-A,rs2073438,1,G,A,6996757,18025,6818174,7211390,178583
17,ENSG00000189152.5,19127589,chr17-19014602-C-T,rs2074280,1,C,T,19014602,112987,18930981,19324197,83621
17,ENSG00000154920.10,50373229,chr17-50465329-G-A,rs2231510,1,G,A,50465329,92100,50176621,50569837,288708
17,ENSG00000076351.7,28406212,chr17-28398249-G-A,rs2239908,-1,G,A,28398249,7963,28209604,28602820,188645
17,ENSG00000172716.11,35373621,chr17-35391058-G-T,rs2263090,-1,G,T,35391058,17437,35177013,35570229,214045
17,ENSG00000181222.10,7484366,chr17-7348829-G-T,rs2292067,1,G,T,7348829,135537,7287758,7680974,61071
17,ENSG00000179598.4,17206333,chr17-17222727-G-A,rs2292527,-1,G,A,17222727,16394,17009725,17402941,213002
17,ENSG00000178789.3,74531475,chr17-74474006-G-A,rs2293189,-1,G,A,74474006,57469,74334867,74728083,139139
17,ENSG00000108474.7,16217210,chr17-16025270-T-G,rs2301652,1,T,G,16025270,191940,16020602,16413818,4668
17,ENSG00000125445.5,75261879,chr17-75286555-C-T,rs2306219,1,C,T,75286555,24676,75065271,75458487,221284
17,ENSG00000068489.7,59155746,chr17-59192067-T-C,rs2333465,1,T,C,59192067,36321,58959138,59352354,232929
17,ENSG00000108651.3,31901708,chr17-31916564-C-A,rs2344312,-1,C,A,31916564,14856,31705100,32098316,211464
17,ENSG00000010244.10,32350157,chr17-32393554-G-C,rs2344977,1,G,C,32393554,43397,32153549,32546765,240005
17,ENSG00000092931.6,76738119,chr17-76737017-G-A,rs237057,1,G,A,76737017,1102,76541511,76934727,195506
17,ENSG00000186395.5,40822614,chr17-40884625-G-A,rs2524300,-1,G,A,40884625,62011,40626006,41019222,258619
17,ENSG00000108468.9,48101478,chr17-47964961-C-T,rs2525109,-1,C,T,47964961,136517,47904870,48298086,60091
17,ENSG00000136450.6,58007246,chr17-57938458-C-G,rs2585844,-1,C,G,57938458,68788,57810638,58203854,127820
17,ENSG00000180787.5,5078467,chr17-4892012-C-T,rs2586532,1,C,T,4892012,186455,4881859,5275075,10153
17,ENSG00000182628.7,59155186,chr17-59291909-C-G,rs2599298,-1,C,G,59291909,136723,58958578,59351794,333331
17,ENSG00000182628.7,59155186,chr17-59291909-C-A,rs2599298,-1,C,A,59291909,136723,58958578,59351794,333331
17,ENSG00000064300.4,49495293,chr17-49467548-G-A,rs2671629,1,G,A,49467548,27745,49298685,49691901,168863
17,ENSG00000131747.9,40417896,chr17-40380731-A-G,rs2715556,-1,A,G,40380731,37165,40221288,40614504,159443
17,ENSG00000256618.1,22523415,chr17-22527783-A-C,rs2738971,1,A,C,22527783,4368,22326807,22720023,200976
17,ENSG00000214226.4,56833920,chr17-56749803-G-A,rs28532299,-1,G,A,56749803,84117,56637312,57030528,112491
17,ENSG00000186075.7,39868202,chr17-39764941-T-C,rs2941509,1,T,C,39764941,103261,39671594,40064810,93347
17,ENSG00000083457.6,3801188,chr17-3730802-G-A,rs2976234,-1,G,A,3730802,70386,3604580,3997796,126222
17,ENSG00000179477.4,8087716,chr17-8085729-G-T,rs3027302,-1,G,T,8085729,1987,7891108,8284324,194621
17,ENSG00000182963.4,44830287,chr17-44926116-T-C,rs3169733,-1,T,C,44926116,95829,44633679,45026895,292437
17,ENSG00000087111.14,28571524,chr17-28750313-A-G,rs3181215,-1,A,G,28750313,178789,28374916,28768132,375397
17,ENSG00000182446.8,81637112,chr17-81558634-A-G,rs3208787,-1,A,G,81558634,78478,81440504,81833720,118130
17,ENSG00000167100.10,50130160,chr17-50273064-C-T,rs34052864,-1,C,T,50273064,142904,49933552,50326768,339512
17,ENSG00000141219.10,73232433,chr17-73088979-C-T,rs34207139,1,C,T,73088979,143454,73035825,73429041,53154
17,ENSG00000169718.12,82065804,chr17-81942024-G-A,rs34319293,-1,G,A,81942024,123780,81869196,82262412,72828
17,ENSG00000132376.13,1516612,chr17-1388867-T-C,rs34544955,-1,T,C,1388867,127745,1320004,1713220,68863
17,ENSG00000108961.8,8288670,chr17-8263180-G-A,rs34778863,1,G,A,8263180,25490,8092062,8485278,171118
17,ENSG00000175711.4,83051770,chr17-82970798-G-C,rs35355170,-1,G,C,82970798,80972,82855162,83248378,115636
17,ENSG00000108784.3,42536241,chr17-42620270-T-C,rs35635959,1,T,C,42620270,84029,42339633,42732849,280637
17,ENSG00000161533.5,75979166,chr17-75835819-T-C,rs3744026,-1,T,C,75835819,143347,75782558,76175774,53261
17,ENSG00000129657.8,77140969,chr17-77214492-A-C,rs3744063,1,A,C,77214492,73523,76944361,77337577,270131
17,ENSG00000068097.8,60078921,chr17-60072384-G-A,rs3744375,-1,G,A,60072384,6537,59882313,60275529,190071
17,ENSG00000154258.10,69060927,chr17-68869442-T-C,rs3744491,-1,T,C,68869442,191485,68864319,69257535,5123
17,ENSG00000170703.10,48817229,chr17-48863054-A-G,rs3744605,-1,A,G,48863054,45825,48620621,49013837,242433
17,ENSG00000171302.9,79009764,chr17-78827178-A-C,rs3744791,-1,A,C,78827178,182586,78813156,79206372,14022
17,ENSG00000070444.8,2401060,chr17-2403401-C-T,rs3760228,-1,C,T,2403401,2341,2204452,2597668,198949
17,ENSG00000070444.8,2401060,chr17-2403401-C-A,rs3760228,-1,C,A,2403401,2341,2204452,2597668,198949
17,ENSG00000198231.6,63774170,chr17-63946431-T-C,rs3785568,1,T,C,63946431,172261,63577562,63970778,368869
17,ENSG00000167925.9,42194494,chr17-42155150-G-A,rs3785900,-1,G,A,42155150,39344,41997886,42391102,157264
17,ENSG00000132382.9,4555384,chr17-4555303-G-C,rs3809849,-1,G,C,4555303,81,4358776,4751992,196527
17,ENSG00000212658.1,41302851,chr17-41174658-G-A,rs383813,-1,G,A,41174658,128193,41106243,41499459,68415
17,ENSG00000185105.4,81947233,chr17-82022880-C-A,rs3934983,-1,C,A,82022880,75647,81750625,82143841,272255
17,ENSG00000205710.3,4899536,chr17-4903803-T-C,rs3966782,1,T,C,4903803,4267,4702928,5096144,200875
17,ENSG00000181408.2,82371765,chr17-82386714-G-A,rs4073961,1,G,A,82386714,14949,82175157,82568373,211557
17,ENSG00000108528.9,4940046,chr17-5057947-A-G,rs411799,-1,A,G,5057947,117901,4743438,5136654,314509
17,ENSG00000154945.6,50707914,chr17-50656384-G-C,rs4148411,-1,G,C,50656384,51530,50511306,50904522,145078
17,ENSG00000181513.9,45135687,chr17-45119179-G-A,rs4362432,1,G,A,45119179,16508,44939079,45332295,180100
17,ENSG00000120063.4,65056740,chr17-64997083-T-C,rs4377192,-1,T,C,64997083,59657,64860132,65253348,136951
17,ENSG00000108523.11,4940268,chr17-4866123-C-T,rs4436834,1,C,T,4866123,74145,4743660,5136876,122463
17,ENSG00000108840.10,44123641,chr17-44118647-A-C,rs453789,-1,A,C,44118647,4994,43927033,44320249,191614
17,ENSG00000259224.1,7481446,chr17-7394133-A-G,rs4613118,1,A,G,7394133,87313,7284838,7678054,109295
17,ENSG00000213977.3,3668578,chr17-3610425-G-A,rs465563,-1,G,A,3610425,58153,3471970,3865186,138455
17,ENSG00000129673.4,76467603,chr17-76491653-T-C,rs4788926,1,T,C,76491653,24050,76270995,76664211,220658
17,ENSG00000167863.6,75046969,chr17-75106316-G-T,rs4789142,-1,G,T,75106316,59347,74850361,75243577,255955
17,ENSG00000004660.10,3893053,chr17-3900779-A-G,rs4790548,-1,A,G,3900779,7726,3696445,4089661,204334
17,ENSG00000167711.9,1742871,chr17-1606612-A-G,rs4790708,1,A,G,1606612,136259,1546263,1939479,60349
17,ENSG00000178921.8,8249289,chr17-8213797-A-G,rs4792590,1,A,G,8213797,35492,8052681,8445897,161116
17,ENSG00000159314.5,45432870,chr17-45317812-A-G,rs4792849,-1,A,G,45317812,115058,45236262,45629478,81550
17,ENSG00000136436.9,48831035,chr17-48971599-C-T,rs4794008,1,C,T,48971599,140564,48634427,49027643,337172
17,ENSG00000006282.13,50547174,chr17-50541888-C-A,rs4794159,1,C,A,50541888,5286,50350566,50743782,191322
17,ENSG00000108960.3,55421835,chr17-55437447-C-T,rs4794586,-1,C,T,55437447,15612,55225227,55618443,212220
17,ENSG00000153933.5,56834151,chr17-56772968-A-G,rs4794665,1,A,G,56772968,61183,56637543,57030759,135425
17,ENSG00000126858.11,32142502,chr17-32242917-G-A,rs4795682,1,G,A,32242917,100415,31945894,32339110,297023
17,ENSG00000072818.6,7336529,chr17-7366054-C-T,rs4796409,1,C,T,7366054,29525,7139921,7533137,226133
17,ENSG00000161594.5,41837825,chr17-41727537-A-G,rs4796691,1,A,G,41727537,110288,41641217,42034433,86320
17,ENSG00000141696.6,41811949,chr17-41940220-G-A,rs4796744,-1,G,A,41940220,128271,41615341,42008557,324879
17,ENSG00000177302.7,18314994,chr17-18269823-G-A,rs4925157,-1,G,A,18269823,45171,18118386,18511602,151437
17,ENSG00000177885.8,75405678,chr17-75393064-G-A,rs56150553,-1,G,A,75393064,12614,75209070,75602286,183994
17,ENSG00000172421.3,62380553,chr17-62570090-A-G,rs56186083,1,A,G,62570090,189537,62183945,62577161,386145
17,ENSG00000177303.4,75515537,chr17-75517933-A-G,rs56311450,-1,A,G,75517933,2396,75318929,75712145,199004
17,ENSG00000126353.2,40565472,chr17-40553583-C-T,rs56320214,-1,C,T,40553583,11889,40368864,40762080,184719
17,ENSG00000141026.2,17477000,chr17-17472459-G-A,rs56352670,1,G,A,17472459,4541,17280392,17673608,192067
17,ENSG00000174292.7,7381089,chr17-7360708-G-A,rs56360822,1,G,A,7360708,20381,7184481,7577697,176227
17,ENSG00000205309.7,17303373,chr17-17331326-G-A,rs56383549,1,G,A,17331326,27953,17106765,17499981,224561
17,ENSG00000108559.6,5419662,chr17-5499637-A-G,rs5862,-1,A,G,5499637,79975,5223054,5616270,276583
17,ENSG00000168792.2,29567037,chr17-29577304-A-G,rs601364,-1,A,G,29577304,10267,29370429,29763645,206875
17,ENSG00000175832.7,43546340,chr17-43612936-C-A,rs60478331,-1,C,A,43612936,66596,43349732,43742948,263204
17,ENSG00000183011.8,7857559,chr17-8048438-G-A,rs61730298,-1,G,A,8048438,190879,7660951,8054167,387487
17,ENSG00000214087.4,81683797,chr17-81672654-G-A,rs61742298,-1,G,A,81672654,11143,81487189,81880405,185465
17,ENSG00000183684.6,81891586,chr17-82036043-C-T,rs61746217,-1,C,T,82036043,144457,81694978,82088194,341065
17,ENSG00000213859.3,7352162,chr17-7272525-C-T,rs62059189,1,C,T,7272525,79637,7155554,7548770,116971
17,ENSG00000173762.2,82317608,chr17-82394427-G-A,rs62079523,-1,G,A,82394427,76819,82121000,82514216,273427
17,ENSG00000108932.6,68291127,chr17-68363420-G-A,rs62085868,-1,G,A,68363420,72293,68094519,68487735,268901
17,ENSG00000161381.8,39151637,chr17-39074161-C-G,rs6503745,-1,C,G,39074161,77476,38955029,39348245,119132
17,ENSG00000108395.8,59106880,chr17-58986806-A-G,rs6503890,-1,A,G,58986806,120074,58910272,59303488,76534
17,ENSG00000108829.9,50397523,chr17-50524273-C-G,rs6504667,-1,C,G,50524273,126750,50200915,50594131,323358
17,ENSG00000015532.5,50346126,chr17-50270271-C-T,rs66670847,1,C,T,50270271,75855,50149518,50542734,120753
17,ENSG00000173868.7,49230787,chr17-49248355-T-C,rs686112,-1,T,C,49248355,17568,49034179,49427395,214176
17,ENSG00000087157.11,78378649,chr17-78490091-T-C,rs691323,1,T,C,78490091,111442,78182041,78575257,308050
17,ENSG00000167083.2,49210574,chr17-49257937-T-C,rs705970,-1,T,C,49257937,47363,49013966,49407182,243971
17,ENSG00000091542.7,18183828,chr17-18305230-G-A,rs7207123,1,G,A,18305230,121402,17987220,18380436,318010
17,ENSG00000005884.12,50056110,chr17-50033339-G-A,rs7208910,1,G,A,50033339,22771,49859502,50252718,173837
17,ENSG00000133195.6,73092688,chr17-73170963-T-C,rs7210080,-1,T,C,73170963,78275,72896080,73289296,274883
17,ENSG00000004139.8,28371694,chr17-28359195-C-T,rs7210719,1,C,T,28359195,12499,28175086,28568302,184109
17,ENSG00000132481.1,75878581,chr17-75764063-C-T,rs7211385,-1,C,T,75764063,114518,75681973,76075189,82090
17,ENSG00000136444.5,50478860,chr17-50495287-G-C,rs7212436,1,G,C,50495287,16427,50282252,50675468,213035
17,ENSG00000108666.4,32342173,chr17-32517366-C-T,rs7212466,-1,C,T,32517366,175193,32145565,32538781,371801
17,ENSG00000182173.7,75516528,chr17-75465849-T-A,rs7212620,1,T,A,75465849,50679,75319920,75713136,145929
17,ENSG00000175155.3,59331655,chr17-59351739-A-G,rs7213014,1,A,G,59351739,20084,59135047,59528263,216692
17,ENSG00000170689.7,48626358,chr17-48459096-T-C,rs7213163,-1,T,C,48459096,167262,48429750,48822966,29346
17,ENSG00000161664.1,44170704,chr17-44179236-A-G,rs7214540,1,A,G,44179236,8532,43974096,44367312,205140
17,ENSG00000197566.4,16653850,chr17-16478950-G-C,rs7214658,-1,G,C,16478950,174900,16457242,16850458,21708
17,ENSG00000197566.4,16653850,chr17-16478950-G-A,rs7214658,-1,G,A,16478950,174900,16457242,16850458,21708
17,ENSG00000167525.8,28711888,chr17-28895970-G-T,rs7215315,-1,G,T,28895970,184082,28515280,28908496,380690
17,ENSG00000108771.6,42112714,chr17-42155060-T-G,rs7218506,-1,T,G,42155060,42346,41916106,42309322,238954
17,ENSG00000013306.10,44324823,chr17-44307733-G-A,rs7221978,-1,G,A,44307733,17090,44128215,44521431,179518
17,ENSG00000033627.9,42458878,chr17-42422263-A-G,rs7224135,1,A,G,42422263,36615,42262270,42655486,159993
17,ENSG00000131475.1,42773449,chr17-42782248-A-G,rs7226262,1,A,G,42782248,8799,42576841,42970057,205407
17,ENSG00000091640.3,4967817,chr17-5050461-G-A,rs72828872,-1,G,A,5050461,82644,4771209,5164425,279252
17,ENSG00000133026.7,8630725,chr17-8813322-C-T,rs72848124,-1,C,T,8813322,182597,8434117,8827333,379205
17,ENSG00000073350.8,75525697,chr17-75541512-C-T,rs72851957,1,C,T,75541512,15815,75329089,75722305,212423
17,ENSG00000108312.10,44219675,chr17-44161981-T-C,rs730228,-1,T,C,44161981,57694,44023067,44416283,138914
17,ENSG00000108298.4,39200283,chr17-39181481-T-C,rs73304968,1,T,C,39181481,18802,39003675,39396891,177806
17,ENSG00000005156.5,34980512,chr17-34811526-G-A,rs734612,1,G,A,34811526,168986,34783904,35177120,27622
17,ENSG00000219200.5,7012624,chr17-6941534-A-G,rs73976112,1,A,G,6941534,71090,6816016,7209232,125518
17,ENSG00000136504.7,49788681,chr17-49956225-C-G,rs73989048,1,C,G,49956225,167544,49592073,49985289,364152
17,ENSG00000187775.10,78577396,chr17-78485098-G-A,rs74001373,-1,G,A,78485098,92298,78380788,78774004,104310
17,ENSG00000185298.8,81666737,chr17-81573423-C-T,rs7405450,1,C,T,81573423,93314,81470129,81863345,103294
17,ENSG00000186834.2,45148475,chr17-44958711-C-T,rs74252799,1,C,T,44958711,189764,44951867,45345083,6844
17,ENSG00000170291.8,7252215,chr17-7162236-A-T,rs75060477,1,A,T,7162236,89979,7055607,7448823,106629
17,ENSG00000181523.7,80220333,chr17-80253549-G-A,rs75123972,-1,G,A,80253549,33216,80023725,80416941,229824
17,ENSG00000185504.11,81552353,chr17-81669566-C-T,rs75433965,-1,C,T,81669566,117213,81355745,81748961,313821
17,ENSG00000109063.7,10657309,chr17-10739713-A-G,rs75656180,-1,A,G,10739713,82404,10460701,10853917,279012
17,ENSG00000213246.1,58352201,chr17-58347349-T-C,rs757485,-1,T,C,58347349,4852,58155593,58548809,191756
17,ENSG00000142507.5,4796164,chr17-4654566-G-A,rs76577060,1,G,A,4654566,141598,4599556,4992772,55010
17,ENSG00000161958.5,7439512,chr17-7263341-C-T,rs77549883,1,C,T,7263341,176171,7242904,7636120,20437
17,ENSG00000198740.4,49362250,chr17-49221604-C-T,rs77624269,-1,C,T,49221604,140646,49165642,49558858,55962
17,ENSG00000091947.4,44014963,chr17-43998999-G-C,rs77900930,-1,G,C,43998999,15964,43818355,44211571,180644
17,ENSG00000181350.7,16492193,chr17-16442439-G-T,rs78133126,-1,G,T,16442439,49754,16295585,16688801,146854
17,ENSG00000176563.4,42798861,chr17-42786243-G-A,rs78645838,1,G,A,42786243,12618,42602253,42995469,183990
17,ENSG00000108309.7,44308601,chr17-44489753-T-C,rs78965384,1,T,C,44489753,181152,44111993,44505209,377760
17,ENSG00000129204.11,5116032,chr17-5007944-T-C,rs79554147,1,T,C,5007944,108088,4919424,5312640,88520
17,ENSG00000159199.8,48892787,chr17-48703467-A-G,rs8064938,1,A,G,48703467,189320,48696179,49089395,7288
17,ENSG00000154803.7,17237168,chr17-17196403-G-T,rs8066234,-1,G,T,17196403,40765,17040560,17433776,155843
17,ENSG00000171298.8,80101581,chr17-80126932-A-G,rs8068856,1,A,G,80126932,25351,79904973,80298189,221959
17,ENSG00000175866.10,81035151,chr17-81130962-C-T,rs8073182,1,C,T,81130962,95811,80838543,81231759,292419
17,ENSG00000214140.4,76540044,chr17-76625216-C-T,rs8073763,1,C,T,76625216,85172,76343436,76736652,281780
17,ENSG00000141569.5,75896951,chr17-75817169-C-T,rs8074216,-1,C,T,75817169,79782,75700343,76093559,116826
17,ENSG00000141569.5,75896951,chr17-75817169-C-A,rs8074216,-1,C,A,75817169,79782,75700343,76093559,116826
17,ENSG00000214941.2,15999704,chr17-16014591-G-A,rs8074888,-1,G,A,16014591,14887,15803096,16196312,211495
17,ENSG00000187624.7,410325,chr17-438357-C-T,rs8076098,1,C,T,438357,28032,213717,606933,224640
17,ENSG00000109047.5,9905271,chr17-9885452-G-A,rs8077150,-1,G,A,9885452,19819,9708663,10101879,176789
17,ENSG00000141030.6,17281246,chr17-17199937-G-A,rs8077299,-1,G,A,17199937,81309,17084638,17477854,115299
17,ENSG00000188522.8,19004764,chr17-18921239-A-G,rs874637,-1,A,G,18921239,83525,18808156,19201372,113083
17,ENSG00000141294.4,47831670,chr17-47819112-T-C,rs878171,1,T,C,47819112,12558,47635062,48028278,184050
17,ENSG00000186532.7,1829902,chr17-1917456-G-A,rs882495,-1,G,A,1917456,87554,1633294,2026510,284162
17,ENSG00000179409.6,752264,chr17-806902-G-A,rs910921,-1,G,A,806902,54638,555656,948872,251246
17,ENSG00000073969.13,46590669,chr17-46785767-T-C,rs916888,1,T,C,46785767,195098,46394061,46787277,391706
17,ENSG00000131470.9,42577729,chr17-42402831-G-A,rs9252,-1,G,A,42402831,174898,42381121,42774337,21710
17,ENSG00000108352.5,40177470,chr17-40075600-T-C,rs939348,1,T,C,40075600,101870,39980862,40374078,94738
17,ENSG00000244045.3,28357647,chr17-28440862-G-T,rs9675204,1,G,T,28440862,83215,28161039,28554255,279823
17,ENSG00000176845.8,83079609,chr17-83049928-C-T,rs9890743,1,C,T,83049928,29681,82883001,83276217,166927
17,ENSG00000184361.7,45262094,chr17-45229396-T-C,rs9893052,-1,T,C,45229396,32698,45065486,45458702,163910
17,ENSG00000170175.6,7445061,chr17-7595476-T-C,rs9895255,1,T,C,7595476,150415,7248453,7641669,347023
17,ENSG00000108379.5,46818692,chr17-46860026-G-A,rs9895603,-1,G,A,46860026,41334,46622084,47015300,237942
17,ENSG00000141258.7,2337501,chr17-2421612-T-C,rs9898228,1,T,C,2421612,84111,2140893,2534109,280719
17,ENSG00000141551.9,82273700,chr17-82298552-T-C,rs9898788,-1,T,C,82298552,24852,82077092,82470308,221460
17,ENSG00000108556.7,4903098,chr17-4835866-T-G,rs9900036,-1,T,G,4835866,67232,4706490,5099706,129376
17,ENSG00000121058.4,56961050,chr17-57153096-C-T,rs9900645,-1,C,T,57153096,192046,56764442,57157658,388654
17,ENSG00000108846.11,50634881,chr17-50799903-A-G,rs9901362,1,A,G,50799903,165022,50438273,50831489,361630
17,ENSG00000129226.8,7579638,chr17-7580783-C-A,rs9901673,1,C,A,7580783,1145,7383030,7776246,197753
17,ENSG00000129226.8,7579638,chr17-7580783-C-T,rs9901673,1,C,T,7580783,1145,7383030,7776246,197753
17,ENSG00000182156.5,79730943,chr17-79706516-A-G,rs9902367,1,A,G,79706516,24427,79534335,79927551,172181
17,ENSG00000169683.2,82023305,chr17-82060591-A-C,rs9903578,1,A,C,82060591,37286,81826697,82219913,233894
17,ENSG00000214447.3,44899774,chr17-44930583-T-C,rs9908100,1,T,C,44930583,30809,44703166,45096382,227417
17,ENSG00000224877.2,81239318,chr17-81168719-G-C,rs9911980,1,G,C,81168719,70599,81042710,81435926,126009
17,ENSG00000141127.8,18858131,chr17-18662110-G-A,rs9912852,1,G,A,18662110,196021,18661523,19054739,587
17,ENSG00000108825.11,42980528,chr17-42857428-C-T,rs9914497,-1,C,T,42857428,123100,42783920,43177136,73508
17,ENSG00000065320.4,9021510,chr17-9107126-C-T,rs9914560,1,C,T,9107126,85616,8824902,9218118,282224
17,ENSG00000181031.11,352807,chr17-222292-C-T,rs9915268,-1,C,T,222292,130515,156199,549415,66093
16,ENSG00000183196.4,75495441,chr16-75486019-G-A,rs100912,-1,G,A,75486019,9422,75298833,75692049,187186
16,ENSG00000197912.8,89508403,chr16-89582837-A-G,rs101151,1,A,G,89582837,74434,89311795,89705011,271042
16,ENSG00000102858.7,4624826,chr16-4690476-T-C,rs1045520,1,T,C,4690476,65650,4428218,4821434,262258
16,ENSG00000102858.7,4624826,chr16-4690476-T-G,rs1045520,1,T,G,4690476,65650,4428218,4821434,262258
16,ENSG00000213380.7,69339564,chr16-69342783-C-T,rs1048818,-1,C,T,69342783,3219,69142956,69536172,199827
16,ENSG00000140905.5,81096395,chr16-81080578-C-T,rs10514513,-1,C,T,81080578,15817,80899787,81293003,180791
16,ENSG00000140718.14,53704156,chr16-53874572-T-C,rs10521305,1,T,C,53874572,170416,53507548,53900764,367024
16,ENSG00000131153.3,85688954,chr16-85678254-C-T,rs1053328,-1,C,T,85678254,10700,85492346,85885562,185908
16,ENSG00000100726.9,1493360,chr16-1510885-A-G,rs1053730,1,A,G,1510885,17525,1296752,1689968,214133
16,ENSG00000161996.13,649365,chr16-522855-G-T,rs1054363,1,G,T,522855,126510,452757,845973,70098
16,ENSG00000141002.11,89873592,chr16-90013519-C-T,rs10852628,1,C,T,90013519,139927,89676984,90070200,336535
16,ENSG00000184857.7,8797639,chr16-8811197-T-A,rs11074924,-1,T,A,8811197,13558,8601031,8994247,210166
16,ENSG00000184857.7,8797639,chr16-8811197-T-C,rs11074924,-1,T,C,8811197,13558,8601031,8994247,210166
16,ENSG00000141012.7,88856947,chr16-88829729-C-T,rs11076720,-1,C,T,88829729,27218,88660339,89053555,169390
16,ENSG00000103227.12,970984,chr16-940631-C-T,rs112029446,-1,C,T,940631,30353,774376,1167592,166255
16,ENSG00000196408.7,1981469,chr16-1983798-G-C,rs1122949,-1,G,C,1983798,2329,1784861,2178077,198937
16,ENSG00000185883.5,2513952,chr16-2439969-C-T,rs11248924,1,C,T,2439969,73983,2317344,2710560,122625
16,ENSG00000149932.11,29962079,chr16-29992435-C-T,rs112533759,1,C,T,29992435,30356,29765471,30158687,226964
16,ENSG00000149923.9,30075994,chr16-29992435-C-T,rs112533759,1,C,T,29992435,83559,29879386,30272602,113049
16,ENSG00000181019.8,69726560,chr16-69726438-A-G,rs114238154,-1,A,G,69726438,122,69529952,69923168,196486
16,ENSG00000103313.6,3256633,chr16-3066294-A-C,rs115567031,-1,A,C,3066294,190339,3060025,3453241,6269
16,ENSG00000103313.6,3256633,chr16-3066294-A-G,rs115567031,-1,A,G,3066294,190339,3060025,3453241,6269
16,ENSG00000135709.8,85027795,chr16-85055589-T-C,rs11642445,1,T,C,85055589,27794,84831187,85224403,224402
16,ENSG00000167977.4,2682523,chr16-2663728-G-A,rs11642560,1,G,A,2663728,18795,2485915,2879131,177813
16,ENSG00000259803.1,89200537,chr16-89084627-T-C,rs11642779,-1,T,C,89084627,115910,89003929,89397145,80698
16,ENSG00000102870.4,30787205,chr16-30774503-C-T,rs11642862,-1,C,T,30774503,12702,30590597,30983813,183906
16,ENSG00000155393.8,50065970,chr16-50057424-C-T,rs11649294,1,C,T,50057424,8546,49869362,50262578,188062
16,ENSG00000059145.13,1414704,chr16-1370637-C-T,rs116678909,-1,C,T,1370637,44067,1218096,1611312,152541
16,ENSG00000185164.10,18562097,chr16-18757454-A-G,rs117059302,-1,A,G,18757454,195357,18365489,18758705,391965
16,ENSG00000103260.3,715118,chr16-770938-G-A,rs117105357,1,G,A,770938,55820,518510,911726,252428
16,ENSG00000167186.6,19067614,chr16-19071502-A-G,rs117361580,1,A,G,19071502,3888,18871006,19264222,200496
16,ENSG00000007516.8,1333645,chr16-1371163-G-A,rs117421297,1,G,A,1371163,37518,1137037,1530253,234126
16,ENSG00000122257.14,24539566,chr16-24399434-G-A,rs117606263,1,G,A,24399434,140132,24342958,24736174,56476
16,ENSG00000158805.7,89721537,chr16-89700230-C-G,rs117963037,1,C,G,89700230,21307,89524929,89918145,175301
16,ENSG00000167964.7,2148625,chr16-2336423-A-G,rs118055416,1,A,G,2336423,187798,1952017,2345233,384406
16,ENSG00000167930.11,234821,chr16-314025-C-T,rs118125792,1,C,T,314025,79204,38213,431429,275812
16,ENSG00000140835.7,71526426,chr16-71719011-C-A,rs11859729,1,C,A,71719011,192585,71329818,71723034,389193
16,ENSG00000168434.8,23453189,chr16-23428676-T-C,rs11861636,-1,T,C,23428676,24513,23256581,23649797,172095
16,ENSG00000132207.12,30193875,chr16-30352750-A-G,rs11862806,1,A,G,30352750,158875,29997267,30390483,355483
16,ENSG00000162004.10,726443,chr16-735279-A-G,rs11864516,-1,A,G,735279,8836,529835,923051,205444
16,ENSG00000161999.6,684334,chr16-735279-A-G,rs11864516,-1,A,G,735279,50945,487726,880942,247553
16,ENSG00000129993.10,88977207,chr16-88950086-A-C,rs12102677,-1,A,C,88950086,27121,88780599,89173815,169487
16,ENSG00000184697.5,3018183,chr16-2832196-G-T,rs12373,-1,G,T,2832196,185987,2821575,3214791,10621
16,ENSG00000168488.13,28822999,chr16-28999976-G-A,rs12446189,1,G,A,28999976,176977,28626391,29019607,373585
16,ENSG00000008517.12,3065640,chr16-3072281-G-A,rs12447486,1,G,A,3072281,6641,2869032,3262248,203249
16,ENSG00000140945.10,82626969,chr16-82789422-C-A,rs12447750,1,C,A,82789422,162453,82430361,82823577,359061
16,ENSG00000159648.7,57976544,chr16-57988232-C-T,rs12600304,1,C,T,57988232,11688,57779936,58173152,208296
16,ENSG00000154102.5,85751096,chr16-85813882-C-T,rs12919297,-1,C,T,85813882,62786,85554488,85947704,259394
16,ENSG00000167965.12,2205454,chr16-2175822-G-A,rs12921326,1,G,A,2175822,29632,2008846,2402062,166976
16,ENSG00000140968.5,85899162,chr16-85870070-T-C,rs12930347,1,T,C,85870070,29092,85702554,86095770,167516
16,ENSG00000140941.7,87392336,chr16-87436277-G-A,rs12931123,1,G,A,87436277,43941,87195728,87588944,240549
16,ENSG00000162104.5,4116442,chr16-4037511-G-A,rs12933423,-1,G,A,4037511,78931,3919834,4313050,117677
16,ENSG00000140798.10,48155993,chr16-48329160-C-A,rs13331795,-1,C,A,48329160,173167,47959385,48352601,369775
16,ENSG00000102893.11,47461331,chr16-47650137-T-C,rs13332639,1,T,C,47650137,188806,47264723,47657939,385414
16,ENSG00000140931.15,66604704,chr16-66523515-A-G,rs13334391,1,A,G,66523515,81189,66408096,66801312,115419
16,ENSG00000140995.12,89948755,chr16-89971188-G-A,rs13336336,1,G,A,89971188,22433,89752147,90145363,219041
16,ENSG00000127585.7,705801,chr16-754760-C-T,rs13336445,-1,C,T,754760,48959,509193,902409,245567
16,ENSG00000140682.14,31472152,chr16-31467390-G-A,rs13337037,1,G,A,31467390,4762,31275544,31668760,191846
16,ENSG00000166816.9,75116780,chr16-75261741-C-A,rs13337397,-1,C,A,75261741,144961,74920172,75313388,341569
16,ENSG00000189067.8,11586919,chr16-11585674-A-G,rs1345442,-1,A,G,11585674,1245,11390311,11783527,195363
16,ENSG00000166123.9,46884362,chr16-46935824-A-G,rs1542292,1,A,G,46935824,51462,46687754,47080970,248070
16,ENSG00000086504.10,370538,chr16-373696-C-T,rs1573735,-1,C,T,373696,3158,173930,567146,199766
16,ENSG00000167968.7,2236444,chr16-2242841-A-C,rs160554,1,A,C,2242841,6397,2039836,2433052,203005
16,ENSG00000167969.7,2251587,chr16-2275041-A-G,rs161426,-1,A,G,2275041,23454,2054979,2448195,220062
16,ENSG00000166743.5,20697680,chr16-20640701-T-C,rs163234,-1,T,C,20640701,56979,20501072,20894288,139629
16,ENSG00000089486.10,4538773,chr16-4544634-G-A,rs1659497,-1,G,A,4544634,5861,4342165,4735381,202469
16,ENSG00000103415.7,4476398,chr16-4545106-G-C,rs1659498,1,G,C,4545106,68708,4279790,4673006,265316
16,ENSG00000125149.6,67109941,chr16-67065821-A-G,rs16957144,1,A,G,67065821,44120,66913333,67306549,152488
16,ENSG00000133392.10,15857028,chr16-15902668-C-T,rs169983,-1,C,T,15902668,45640,15660420,16053636,242248
16,ENSG00000213853.5,10580598,chr16-10603165-C-T,rs17604279,-1,C,T,10603165,22567,10383990,10777206,219175
16,ENSG00000103089.4,74774820,chr16-74821962-A-C,rs17683948,-1,A,C,74821962,47142,74578212,74971428,243750
16,ENSG00000091651.4,46689659,chr16-46606680-T-G,rs17728559,1,T,G,46606680,82979,46493051,46886267,113629
16,ENSG00000158486.8,21159441,chr16-21238712-G-A,rs17764140,-1,G,A,21238712,79271,20962833,21356049,275879
16,ENSG00000180209.7,30374802,chr16-30528714-A-G,rs17839547,1,A,G,30528714,153912,30178194,30571410,350520
16,ENSG00000198931.6,88811928,chr16-88809263-T-C,rs1799842,-1,T,C,88809263,2665,88615320,89008536,193943
16,ENSG00000006194.6,3283491,chr16-3288343-G-C,rs188761,1,G,C,3288343,4852,3086883,3480099,201460
16,ENSG00000140749.7,21652608,chr16-21597151-G-A,rs194548,-1,G,A,21597151,55457,21456000,21849216,141151
16,ENSG00000186153.11,78099654,chr16-78074077-A-G,rs1950157,1,A,G,78074077,25577,77903046,78296262,171031
16,ENSG00000167394.8,31074240,chr16-31118621-C-T,rs1978487,-1,C,T,31118621,44381,30877632,31270848,240989
16,ENSG00000103363.10,2777280,chr16-2774929-C-G,rs2009509,-1,C,G,2774929,2351,2580672,2973888,194257
16,ENSG00000103540.12,19523857,chr16-19556707-C-G,rs2028265,1,C,G,19556707,32850,19327249,19720465,229458
16,ENSG00000005194.10,57447385,chr16-57606941-G-A,rs2044787,-1,G,A,57606941,159556,57250777,57643993,356164
16,ENSG00000196557.6,1153106,chr16-1203529-T-C,rs2050114,1,T,C,1203529,50423,956498,1349714,247031
16,ENSG00000149926.9,30031271,chr16-30070046-G-T,rs2071390,-1,G,T,30070046,38775,29834663,30227879,235383
16,ENSG00000103245.8,740997,chr16-733004-T-C,rs2071951,-1,T,C,733004,7993,544389,937605,188615
16,ENSG00000232196.2,3372668,chr16-3485028-G-A,rs2074524,-1,G,A,3485028,112360,3176060,3569276,308968
16,ENSG00000118557.11,72172155,chr16-72322213-G-C,rs2161659,-1,G,C,72322213,150058,71975547,72368763,346666
16,ENSG00000153815.9,81444808,chr16-81366572-A-G,rs2161728,1,A,G,81366572,78236,81248200,81641416,118372
16,ENSG00000217555.6,66552576,chr16-66552856-G-A,rs2232725,1,G,A,66552856,280,66355968,66749184,196888
16,ENSG00000187741.9,89816647,chr16-89783175-C-T,rs2239360,-1,C,T,89783175,33472,89620039,90013255,163136
16,ENSG00000140993.5,3305430,chr16-3258357-G-A,rs224230,-1,G,A,3258357,47073,3108822,3502038,149535
16,ENSG00000065054.8,2026902,chr16-1947613-A-G,rs2252523,1,A,G,1947613,79289,1830294,2223510,117319
16,ENSG00000103168.12,84187057,chr16-84180359-G-A,rs2278043,-1,G,A,84180359,6698,83990449,84383665,189910
16,ENSG00000154099.12,84145308,chr16-84180359-G-A,rs2278043,1,G,A,84180359,35051,83948700,84341916,231659
16,ENSG00000103528.12,19168240,chr16-19211391-T-G,rs229018,1,T,G,19211391,43151,18971632,19364848,239759
16,ENSG00000135698.5,82170224,chr16-82164278-G-A,rs2303266,-1,G,A,82164278,5946,81973616,82366832,190662
16,ENSG00000103021.5,58249936,chr16-58222005-C-A,rs2432555,1,C,A,58222005,27931,58053328,58446544,168677
16,ENSG00000103034.10,58500143,chr16-58499805-G-T,rs2432560,1,G,T,58499805,338,58303535,58696751,196270
16,ENSG00000156886.10,31393335,chr16-31396207-C-T,rs2472050,1,C,T,31396207,2872,31196727,31589943,199480
16,ENSG00000063854.7,1826825,chr16-1852104-A-G,rs2492883,-1,A,G,1852104,25279,1630217,2023433,221887
16,ENSG00000161980.5,53608,chr16-53423-C-A,rs2541593,-1,C,A,53423,185,-143000,250216,196423
16,ENSG00000103023.7,58295025,chr16-58218939-C-T,rs2550370,-1,C,T,58218939,76086,58098417,58491633,120522
16,ENSG00000103148.9,138673,chr16-137510-A-G,rs2562188,-1,A,G,137510,1163,-57935,335281,195445
16,ENSG00000074071.8,1773134,chr16-1769432-G-A,rs2575329,-1,G,A,1769432,3702,1576526,1969742,192906
16,ENSG00000153060.3,10694930,chr16-10670588-C-T,rs2719695,-1,C,T,10670588,24342,10498322,10891538,172266
16,ENSG00000159579.8,57186329,chr16-57046616-C-A,rs289723,1,C,A,57046616,139713,56989721,57382937,56895
16,ENSG00000167978.10,2752638,chr16-2764161-G-A,rs3094775,1,G,A,2764161,11523,2556030,2949246,208131
16,ENSG00000188536.7,172876,chr16-78055-G-A,rs3176373,1,G,A,78055,94821,-23732,369484,101787
16,ENSG00000206172.4,176680,chr16-78055-G-A,rs3176373,1,G,A,78055,98625,-19928,373288,97983
16,ENSG00000077238.8,27313974,chr16-27226081-A-G,rs34561002,1,A,G,27226081,87893,27117366,27510582,108715
16,ENSG00000118898.9,4937148,chr16-4870334-A-G,rs35103368,-1,A,G,4870334,66814,4740540,5133756,129794
16,ENSG00000005339.7,3880713,chr16-3899052-T-C,rs35671987,-1,T,C,3899052,18339,3684105,4077321,214947
16,ENSG00000169627.7,30193666,chr16-30162703-G-A,rs35983149,-1,G,A,30162703,30963,29997058,30390274,165645
16,ENSG00000172824.9,66988594,chr16-66801488-G-A,rs363199,1,G,A,66801488,187106,66791986,67185202,9502
16,ENSG00000064270.7,84368538,chr16-84475762-C-G,rs368047,1,C,G,84475762,107224,84171930,84565146,303832
16,ENSG00000103005.5,58001407,chr16-57996149-T-C,rs3743553,1,T,C,57996149,5258,57804799,58198015,191350
16,ENSG00000103066.8,68245373,chr16-68231336-G-A,rs3743738,1,G,A,68231336,14037,68048765,68441981,182571
16,ENSG00000205078.5,77199408,chr16-77194068-G-A,rs3743763,1,G,A,77194068,5340,77002800,77396016,191268
16,ENSG00000131149.13,85613322,chr16-85678082-G-A,rs3751717,1,G,A,85678082,64760,85416714,85809930,261368
16,ENSG00000149922.6,30091924,chr16-30091839-C-A,rs3809627,-1,C,A,30091839,85,29895316,30288532,196523
16,ENSG00000103550.9,19718227,chr16-19711044-T-C,rs3829539,-1,T,C,19711044,7183,19521619,19914835,189425
16,ENSG00000129925.5,381978,chr16-310303-T-C,rs3842949,-1,T,C,310303,71675,185370,578586,124933
16,ENSG00000185905.3,29745990,chr16-29667246-T-C,rs3851019,-1,T,C,29667246,78744,29549382,29942598,117864
16,ENSG00000182108.5,10942468,chr16-11048863-T-C,rs3901386,-1,T,C,11048863,106395,10745860,11139076,303003
16,ENSG00000166847.5,23641466,chr16-23681084-A-G,rs40076,1,A,G,23681084,39618,23444858,23838074,236226
16,ENSG00000103342.8,11915956,chr16-11864525-A-G,rs407719,-1,A,G,11864525,51431,11719348,12112564,145177
16,ENSG00000103126.10,352723,chr16-325198-C-T,rs426884,-1,C,T,325198,27525,156115,549331,169083
16,ENSG00000188897.3,11527245,chr16-11495905-A-C,rs4520857,-1,A,C,11495905,31340,11330637,11723853,165268
16,ENSG00000181938.9,58392471,chr16-58404793-T-C,rs45439399,1,T,C,58404793,12322,58195863,58589079,208930
16,ENSG00000141013.10,90022680,chr16-89981987-C-T,rs45610233,1,C,T,89981987,40693,89826072,90219288,155915
16,ENSG00000169246.11,21405319,chr16-21601241-G-A,rs474843,-1,G,A,21601241,195922,21208711,21601927,392530
16,ENSG00000174628.12,19718280,chr16-19855699-C-T,rs4782294,1,C,T,19855699,137419,19521672,19914888,334027
16,ENSG00000158545.10,88570403,chr16-88628968-A-G,rs4782307,1,A,G,88628968,58565,88373795,88767011,255173
16,ENSG00000125124.6,56520024,chr16-56509230-G-A,rs4783943,-1,G,A,56509230,10794,56323416,56716632,185814
16,ENSG00000162062.10,2460109,chr16-2460602-C-T,rs4786284,1,C,T,2460602,493,2263501,2656717,197101
16,ENSG00000140832.5,71626184,chr16-71581917-G-A,rs4788809,1,G,A,71581917,44267,71429576,71822792,152341
16,ENSG00000103365.10,23510494,chr16-23476710-A-G,rs4968006,-1,A,G,23476710,33784,23313886,23707102,162824
16,ENSG00000103253.12,727106,chr16-748622-A-G,rs4984923,1,A,G,748622,21516,530498,923714,218124
16,ENSG00000103051.13,70523554,chr16-70656263-A-G,rs4985555,-1,A,G,70656263,132709,70326946,70720162,329317
16,ENSG00000103199.8,4767162,chr16-4766101-T-C,rs58729822,-1,T,C,4766101,1061,4570554,4963770,195547
16,ENSG00000125170.6,57486493,chr16-57487362-T-C,rs604965,-1,T,C,57487362,869,57289885,57683101,197477
16,ENSG00000103275.14,1309636,chr16-1434454-T-C,rs61743495,1,T,C,1434454,124818,1113028,1506244,321426
16,ENSG00000205937.6,2268126,chr16-2395338-T-C,rs62040695,-1,T,C,2395338,127212,2071518,2464734,323820
16,ENSG00000184860.4,82011470,chr16-82011637-C-A,rs62046301,-1,C,A,82011637,167,81814862,82208078,196775
16,ENSG00000167191.6,19884848,chr16-19864823-C-T,rs6497416,-1,C,T,19864823,20025,19688240,20081456,176583
16,ENSG00000103037.6,58515517,chr16-58522832-C-T,rs6499961,1,C,T,58522832,7315,58318909,58712125,203923
16,ENSG00000127578.6,630985,chr16-734507-C-T,rs67935101,1,C,T,734507,103522,434377,827593,300130
16,ENSG00000140876.7,77722514,chr16-77718311-C-A,rs7184635,1,C,A,77718311,4203,77525906,77919122,192405
16,ENSG00000103202.7,397199,chr16-399162-T-C,rs7185254,1,T,C,399162,1963,200591,593807,198571
16,ENSG00000176715.11,89093852,chr16-89100686-T-C,rs7188200,1,T,C,89100686,6834,88897244,89290460,203442
16,ENSG00000040199.13,71724701,chr16-71646099-C-T,rs7188675,-1,C,T,71646099,78602,71528093,71921309,118006
16,ENSG00000169715.10,56625781,chr16-56639378-G-T,rs7190725,1,G,T,56639378,13597,56429173,56822389,210205
16,ENSG00000168411.8,74666877,chr16-74664845-G-C,rs7191863,-1,G,C,74664845,2032,74470269,74863485,194576
16,ENSG00000185338.4,11256204,chr16-11074057-C-A,rs7192790,-1,C,A,11074057,182147,11059596,11452812,14461
16,ENSG00000011638.6,21158674,chr16-21172956-A-G,rs7192830,1,A,G,21172956,14282,20962066,21355282,210890
16,ENSG00000204991.6,89828475,chr16-89769915-C-T,rs7195066,1,C,T,89769915,58560,89631867,90025083,138048
16,ENSG00000103496.10,31033558,chr16-31080754-G-A,rs7196726,1,G,A,31080754,47196,30836950,31230166,243804
16,ENSG00000104731.9,87765986,chr16-87701921-G-A,rs7199037,-1,G,A,87701921,64065,87569378,87962594,132543
16,ENSG00000103248.12,86555235,chr16-86575003-T-G,rs7199466,-1,T,G,86575003,19768,86358627,86751843,216376
16,ENSG00000172828.8,66961266,chr16-66924068-T-C,rs7203638,1,T,C,66924068,37198,66764658,67157874,159410
16,ENSG00000166669.9,10386061,chr16-10433756-C-A,rs7205853,1,C,A,10433756,47695,10189453,10582669,244303
16,ENSG00000185947.9,31873807,chr16-31862552-T-C,rs7205943,1,T,C,31862552,11255,31677199,32070415,185353
16,ENSG00000185669.5,88686507,chr16-88740578-C-T,rs726884,-1,C,T,88740578,54071,88489899,88883115,250679
16,ENSG00000007541.10,569968,chr16-670833-C-T,rs72773407,1,C,T,670833,100865,373360,766576,297473
16,ENSG00000129636.8,47461063,chr16-47427671-C-T,rs72800651,-1,C,T,47427671,33392,47264455,47657671,163216
16,ENSG00000167397.10,31094797,chr16-31005649-T-C,rs729482,-1,T,C,31005649,89148,30898189,31291405,107460
16,ENSG00000003249.8,90019456,chr16-90000776-G-A,rs73283869,-1,G,A,90000776,18680,89822848,90216064,177928
16,ENSG00000067836.7,4802633,chr16-4980780-G-A,rs73510408,-1,G,A,4980780,178147,4606025,4999241,374755
16,ENSG00000161981.6,53828,chr16-51277-G-T,rs74003635,1,G,T,51277,2551,-142780,250436,194057
16,ENSG00000158717.6,88706408,chr16-88708513-C-T,rs7404845,-1,C,T,88708513,2105,88509800,88903016,198713
16,ENSG00000158717.6,88706408,chr16-88708513-C-A,rs7404845,-1,C,A,88708513,2105,88509800,88903016,198713
16,ENSG00000174177.8,88706503,chr16-88708513-C-T,rs7404845,1,C,T,88708513,2010,88509895,88903111,198618
16,ENSG00000174177.8,88706503,chr16-88708513-C-A,rs7404845,1,C,A,88708513,2010,88509895,88903111,198618
16,ENSG00000179889.14,14975026,chr16-15087670-T-G,rs7405315,1,T,G,15087670,112644,14778418,15171634,309252
16,ENSG00000179889.14,14975026,chr16-15087670-T-C,rs7405315,1,T,C,15087670,112644,14778418,15171634,309252
16,ENSG00000038532.9,10944564,chr16-10794552-G-C,rs74591482,1,G,C,10794552,150012,10747956,11141172,46596
16,ENSG00000006327.9,3020368,chr16-3020627-C-T,rs74758164,1,C,T,3020627,259,2823760,3216976,196867
16,ENSG00000167526.9,89560682,chr16-89464901-C-T,rs74829481,1,C,T,89464901,95781,89364074,89757290,100827
16,ENSG00000176953.6,28950937,chr16-28965699-G-A,rs7500321,1,G,A,28965699,14762,28754329,29147545,211370
16,ENSG00000169682.13,28974778,chr16-28965699-G-A,rs7500321,1,G,A,28965699,9079,28778170,29171386,187529
16,ENSG00000232258.2,8590511,chr16-8596737-A-G,rs7500465,-1,A,G,8596737,6226,8393903,8787119,202834
16,ENSG00000103510.14,31117664,chr16-31082633-C-T,rs750952,1,C,T,31082633,35031,30921056,31314272,161577
16,ENSG00000177238.9,31214119,chr16-31082768-T-C,rs750953,1,T,C,31082768,131351,31017511,31410727,65257
16,ENSG00000140848.12,57092583,chr16-57084469-T-C,rs75257814,1,T,C,57084469,8114,56895975,57289191,188494
16,ENSG00000167371.12,29812193,chr16-29887802-G-T,rs75331747,1,G,T,29887802,75609,29615585,30008801,272217
16,ENSG00000079616.8,29790751,chr16-29887802-G-T,rs75331747,1,G,T,29887802,97051,29594143,29987359,293659
16,ENSG00000149930.13,29973868,chr16-29887802-G-T,rs75331747,1,G,T,29887802,86066,29777260,30170476,110542
16,ENSG00000103356.10,23557350,chr16-23400238-T-C,rs75969326,-1,T,C,23400238,157112,23360742,23753958,39496
16,ENSG00000140937.8,65122063,chr16-64982262-C-G,rs76181686,-1,C,G,64982262,139801,64925455,65318671,56807
16,ENSG00000186260.11,14071319,chr16-14125980-C-A,rs762767,1,C,A,14125980,54661,13874711,14267927,251269
16,ENSG00000103335.14,88785220,chr16-88698766-T-G,rs78069475,-1,T,G,88698766,86454,88588612,88981828,110154
16,ENSG00000196155.7,67279532,chr16-67277715-C-G,rs78132437,1,C,G,67277715,1817,67082924,67476140,194791
16,ENSG00000149925.12,30065760,chr16-30179570-G-A,rs79623117,1,G,A,30179570,113810,29869152,30262368,310418
16,ENSG00000149929.10,29995617,chr16-30179570-G-A,rs79623117,-1,G,A,30179570,183953,29799009,30192225,380561
16,ENSG00000153406.9,4474625,chr16-4527068-G-A,rs8044698,-1,G,A,4527068,52443,4278017,4671233,249051
16,ENSG00000131650.9,2964275,chr16-2858702-C-T,rs8046218,1,C,T,2858702,105573,2767667,3160883,91035
16,ENSG00000169955.6,30534858,chr16-30697737-T-C,rs8046436,-1,T,C,30697737,162879,30338250,30731466,359487
16,ENSG00000162076.8,2883215,chr16-2882820-G-A,rs8046450,1,G,A,2882820,395,2686607,3079823,196213
16,ENSG00000102935.7,49856112,chr16-49676179-A-T,rs8048188,-1,A,T,49676179,179933,49659504,50052720,16675
16,ENSG00000131634.9,1533666,chr16-1533633-T-C,rs8048206,1,T,C,1533633,33,1337058,1730274,196575
16,ENSG00000213937.3,3012923,chr16-3111651-G-A,rs8048848,1,G,A,3111651,98728,2816315,3209531,295336
16,ENSG00000140854.8,57735770,chr16-57603822-A-G,rs8048880,1,A,G,57603822,131948,57539162,57932378,64660
16,ENSG00000103479.9,53434471,chr16-53479143-T-C,rs8049033,1,T,C,53479143,44672,53237863,53631079,241280
16,ENSG00000099381.12,30957754,chr16-30926478-G-A,rs8050588,1,G,A,30926478,31276,30761146,31154362,165332
16,ENSG00000159625.10,57694806,chr16-57688040-T-C,rs8051301,1,T,C,57688040,6766,57498198,57891414,189842
16,ENSG00000196470.7,48385413,chr16-48356601-G-T,rs8053839,-1,G,T,48356601,28812,48188805,48582021,167796
16,ENSG00000169189.12,27268772,chr16-27211489-G-A,rs8055597,-1,G,A,27211489,57283,27072164,27465380,139325
16,ENSG00000140830.4,72093620,chr16-71981507-T-C,rs8056712,-1,T,C,71981507,112113,71897012,72290228,84495
16,ENSG00000103319.7,22206278,chr16-22270829-G-A,rs8059570,1,G,A,22270829,64551,22009670,22402886,261159
16,ENSG00000140986.7,1954689,chr16-2051590-T-C,rs8059880,-1,T,C,2051590,96901,1758081,2151297,293509
16,ENSG00000102871.11,67159909,chr16-67157812-A-G,rs8060496,-1,A,G,67157812,2097,66963301,67356517,194511
16,ENSG00000051108.10,56932142,chr16-56896339-T-C,rs8063291,1,T,C,56896339,35803,56735534,57128750,160805
16,ENSG00000205832.6,4556340,chr16-4536528-C-T,rs860891,1,C,T,4536528,19812,4359732,4752948,176796
16,ENSG00000237172.3,67150998,chr16-67148096-A-G,rs9033,-1,A,G,67148096,2902,66954390,67347606,193706
16,ENSG00000197302.6,31713244,chr16-31683942-A-G,rs9674389,1,A,G,31683942,29302,31516636,31909852,167306
16,ENSG00000103150.4,83899115,chr16-83933864-G-A,rs9923900,1,G,A,83933864,34749,83702507,84095723,231357
16,ENSG00000066654.8,20741818,chr16-20918280-G-A,rs9925327,-1,G,A,20918280,176462,20545210,20938426,373070
16,ENSG00000099365.5,31010638,chr16-31002858-C-T,rs9926533,-1,C,T,31002858,7780,30814030,31207246,188828
16,ENSG00000159593.9,66830976,chr16-66716137-G-T,rs9926649,-1,G,T,66716137,114839,66634368,67027584,81769
16,ENSG00000188215.4,20900358,chr16-20773171-A-C,rs9927521,-1,A,C,20773171,127187,20703750,21096966,69421
16,ENSG00000059122.12,2911931,chr16-2942113-T-C,rs9930148,1,T,C,2942113,30182,2715323,3108539,226790
16,ENSG00000087237.6,56961950,chr16-56973280-T-C,rs9930761,1,T,C,56973280,11330,56765342,57158558,207938
16,ENSG00000167508.5,88663091,chr16-88651945-C-T,rs9932581,-1,C,T,88651945,11146,88466483,88859699,185462
16,ENSG00000166548.10,66550122,chr16-66557826-A-G,rs9933115,-1,A,G,66557826,7704,66353514,66746730,204312
16,ENSG00000179918.14,30445874,chr16-30463535-G-A,rs9934579,-1,G,A,30463535,17661,30249266,30642482,214269
16,ENSG00000103174.6,5033935,chr16-5035335-T-C,rs9937510,-1,T,C,5035335,1400,4837327,5230543,198008
16,ENSG00000103174.6,5033935,chr16-5032288-A-T,rs1001171,-1,A,T,5032288,1647,4837327,5230543,194961
16,ENSG00000118894.9,5097795,chr16-5107527-T-C,rs10459836,-1,T,C,5107527,9732,4901187,5294403,206340
16,ENSG00000129636.8,47461063,chr16-47486253-C-T,rs10459879,-1,C,T,47486253,25190,47264455,47657671,221798
16,ENSG00000103494.7,53703859,chr16-53900060-C-T,rs1074903,-1,C,T,53900060,196201,53507251,53900467,392809
16,ENSG00000141013.10,90022680,chr16-89841595-G-A,rs1079558,1,G,A,89841595,181085,89826072,90219288,15523
16,ENSG00000140859.10,57802491,chr16-57767438-A-G,rs10852557,-1,A,G,57767438,35053,57605883,57999099,161555
16,ENSG00000040199.13,71724701,chr16-71669072-C-T,rs11075895,-1,C,T,71669072,55629,71528093,71921309,140979
16,ENSG00000087258.9,56191489,chr16-56290521-C-A,rs11076151,1,C,A,56290521,99032,55994881,56388097,295640
16,ENSG00000196470.7,48385413,chr16-48346421-A-G,rs11076565,-1,A,G,48346421,38992,48188805,48582021,157616
16,ENSG00000162076.8,2883215,chr16-2904915-T-C,rs11076933,1,T,C,2904915,21700,2686607,3079823,218308
16,ENSG00000213853.5,10580598,chr16-10618026-A-C,rs112414296,-1,A,C,10618026,37428,10383990,10777206,234036
16,ENSG00000259803.1,89200537,chr16-89156343-C-T,rs112924269,-1,C,T,89156343,44194,89003929,89397145,152414
16,ENSG00000103061.6,68310946,chr16-68358153-G-T,rs114313536,-1,G,T,68358153,47207,68114338,68507554,243815
16,ENSG00000103067.7,68236127,chr16-68304045-T-C,rs11548855,-1,T,C,68304045,67918,68039519,68432735,264526
16,ENSG00000140832.5,71626184,chr16-71721949-T-C,rs11639902,1,T,C,71721949,95765,71429576,71822792,292373
16,ENSG00000125148.6,56608584,chr16-56610353-G-T,rs11642055,1,G,T,56610353,1769,56411976,56805192,198377
16,ENSG00000125148.6,56608584,chr16-56610353-G-A,rs11642055,1,G,A,56610353,1769,56411976,56805192,198377
16,ENSG00000166669.9,10386061,chr16-10243637-T-C,rs11642454,1,T,C,10243637,142424,10189453,10582669,54184
16,ENSG00000140968.5,85899162,chr16-85969786-T-C,rs11642511,1,T,C,85969786,70624,85702554,86095770,267232
16,ENSG00000007541.10,569968,chr16-426796-C-G,rs116962191,1,C,G,426796,143172,373360,766576,53436
16,ENSG00000007541.10,569968,chr16-426796-C-A,rs116962191,1,C,A,426796,143172,373360,766576,53436
16,ENSG00000140939.10,67170497,chr16-67198781-A-G,rs11700,1,A,G,67198781,28284,66973889,67367105,224892
16,ENSG00000170100.9,89217703,chr16-89065603-T-C,rs117098882,1,T,C,89065603,152100,89021095,89414311,44508
16,ENSG00000087263.11,56451554,chr16-56481051-C-T,rs117178556,1,C,T,56481051,29497,56254946,56648162,226105
16,ENSG00000187535.9,1612072,chr16-1510302-G-T,rs117559520,-1,G,T,1510302,101770,1415464,1808680,94838
16,ENSG00000187535.9,1612072,chr16-1510302-G-C,rs117559520,-1,G,C,1510302,101770,1415464,1808680,94838
16,ENSG00000258839.1,89918862,chr16-89973761-C-A,rs117776146,1,C,A,89973761,54899,89722254,90115470,251507
16,ENSG00000005513.9,981770,chr16-988890-G-A,rs117976932,1,G,A,988890,7120,785162,1178378,203728
16,ENSG00000166246.7,4734537,chr16-4747355-G-A,rs118086912,1,G,A,4747355,12818,4537929,4931145,209426
16,ENSG00000159618.11,57542643,chr16-57626506-C-T,rs11864487,1,C,T,57626506,83863,57346035,57739251,280471
16,ENSG00000103202.7,397199,chr16-337867-C-T,rs11866815,1,C,T,337867,59332,200591,593807,137276
16,ENSG00000103126.10,352723,chr16-427619-C-G,rs1204510,-1,C,G,427619,74896,156115,549331,271504
16,ENSG00000177238.9,31214119,chr16-31373327-C-T,rs12448775,1,C,T,31373327,159208,31017511,31410727,355816
16,ENSG00000161996.13,649365,chr16-737827-A-C,rs12449156,1,A,C,737827,88462,452757,845973,285070
16,ENSG00000198650.6,71577092,chr16-71386674-T-A,rs12597949,-1,T,A,71386674,190418,71380484,71773700,6190
16,ENSG00000140848.12,57092583,chr16-57080103-A-G,rs12598418,1,A,G,57080103,12480,56895975,57289191,184128
16,ENSG00000102931.3,57245259,chr16-57080103-A-G,rs12598418,1,A,G,57080103,165156,57048651,57441867,31452
16,ENSG00000205078.5,77199408,chr16-77242918-A-G,rs12599800,1,A,G,77242918,43510,77002800,77396016,240118
16,ENSG00000135698.5,82170224,chr16-82136912-C-T,rs13330853,-1,C,T,82136912,33312,81973616,82366832,163296
16,ENSG00000140718.14,53704156,chr16-53853530-G-T,rs13337591,1,G,T,53853530,149374,53507548,53900764,345982
16,ENSG00000167969.7,2251587,chr16-2278789-G-A,rs150928,-1,G,A,2278789,27202,2054979,2448195,223810
16,ENSG00000183793.9,15378294,chr16-15397627-C-T,rs153002,-1,C,T,15397627,19333,15181686,15574902,215941
16,ENSG00000103248.12,86555235,chr16-86588830-A-G,rs16941554,-1,A,G,86588830,33595,86358627,86751843,230203
16,ENSG00000103091.10,74985123,chr16-74826991-G-A,rs16947532,-1,G,A,74826991,158132,74788515,75181731,38476
16,ENSG00000103091.10,74985123,chr16-74826991-G-C,rs16947532,-1,G,C,74826991,158132,74788515,75181731,38476
16,ENSG00000166454.5,81035842,chr16-81040555-T-G,rs16954505,1,T,G,81040555,4713,80839234,81232450,201321
16,ENSG00000175595.9,13920154,chr16-13882748-C-T,rs16963100,1,C,T,13882748,37406,13723546,14116762,159202
16,ENSG00000153406.9,4474625,chr16-4386577-G-A,rs17136989,-1,G,A,4386577,88048,4278017,4671233,108560
16,ENSG00000232258.2,8590511,chr16-8423676-A-G,rs17145828,-1,A,G,8423676,166835,8393903,8787119,29773
16,ENSG00000063854.7,1826825,chr16-1922815-T-C,rs1742402,-1,T,C,1922815,95990,1630217,2023433,292598
16,ENSG00000182831.7,9091644,chr16-9093618-A-G,rs17567304,1,A,G,9093618,1974,8895036,9288252,198582
16,ENSG00000182831.7,9091644,chr16-9093618-A-C,rs17567304,1,A,C,9093618,1974,8895036,9288252,198582
16,ENSG00000158805.7,89721537,chr16-89881049-A-G,rs17784386,1,A,G,89881049,159512,89524929,89918145,356120
16,ENSG00000089280.13,31180139,chr16-31096606-T-C,rs17878544,1,T,C,31096606,83533,30983531,31376747,113075
16,ENSG00000169189.12,27268772,chr16-27426650-G-A,rs179762,-1,G,A,27426650,157878,27072164,27465380,354486
16,ENSG00000154102.5,85751096,chr16-85800554-T-C,rs1800647,-1,T,C,85800554,49458,85554488,85947704,246066
16,ENSG00000157335.14,70173787,chr16-70102302-T-C,rs1808417,1,T,C,70102302,71485,69977179,70370395,125123
16,ENSG00000099365.5,31010638,chr16-30959620-T-C,rs1870293,-1,T,C,30959620,51018,30814030,31207246,145590
16,ENSG00000130731.11,636305,chr16-650970-C-T,rs2076142,-1,C,T,650970,14665,439697,832913,211273
16,ENSG00000162069.10,3036944,chr16-3028543-T-G,rs2079244,-1,T,G,3028543,8401,2840336,3233552,188207
16,ENSG00000122386.6,3112586,chr16-3084753-A-G,rs2092015,1,A,G,3084753,27833,2915978,3309194,168775
16,ENSG00000125166.7,58734316,chr16-58797825-G-A,rs2118019,-1,G,A,58797825,63509,58537708,58930924,260117
16,ENSG00000133392.10,15857028,chr16-15847727-A-C,rs215573,-1,A,C,15847727,9301,15660420,16053636,187307
16,ENSG00000103047.2,68843531,chr16-68823386-T-C,rs2276330,1,T,C,68823386,20145,68646923,69040139,176463
16,ENSG00000169715.10,56625781,chr16-56659349-G-T,rs2291957,1,G,T,56659349,33568,56429173,56822389,230176
16,ENSG00000127586.11,788620,chr16-797743-C-T,rs2294451,1,C,T,797743,9123,592012,985228,205731
16,ENSG00000167394.8,31074240,chr16-31269826-A-G,rs2359661,-1,A,G,31269826,195586,30877632,31270848,392194
16,ENSG00000159387.7,55324203,chr16-55478410-T-G,rs243864,1,T,G,55478410,154207,55127595,55520811,350815
16,ENSG00000198736.7,1943199,chr16-2035679-C-T,rs2516781,-1,C,T,2035679,92480,1746591,2139807,289088
16,ENSG00000140986.7,1954689,chr16-2038584-A-G,rs2531213,-1,A,G,2038584,83895,1758081,2151297,280503
16,ENSG00000007384.9,72631,chr16-157612-T-C,rs2541638,-1,T,C,157612,84981,-123977,269239,281589
16,ENSG00000076344.11,275944,chr16-162329-G-A,rs2541644,-1,G,A,162329,113615,79336,472552,82993
16,ENSG00000206172.4,176680,chr16-161106-T-G,rs2541645,1,T,G,161106,15574,-19928,373288,181034
16,ENSG00000103316.6,21278290,chr16-21271579-G-A,rs2629093,-1,G,A,21271579,6711,21081682,21474898,189897
16,ENSG00000131650.9,2964275,chr16-3016167-G-C,rs2717701,1,G,C,3016167,51892,2767667,3160883,248500
16,ENSG00000178952.4,28846348,chr16-28814728-C-T,rs28472312,-1,C,T,28814728,31620,28649740,29042956,164988
16,ENSG00000102974.10,67562526,chr16-67666952-G-A,rs28700163,1,G,A,67666952,104426,67365918,67759134,301034
16,ENSG00000099381.12,30957754,chr16-31094233-A-C,rs2884737,1,A,C,31094233,136479,30761146,31154362,333087
16,ENSG00000129925.5,381978,chr16-345396-G-A,rs2885415,-1,G,A,345396,36582,185370,578586,160026
16,ENSG00000172775.11,57186039,chr16-57091454-A-G,rs289721,-1,A,G,57091454,94585,56989431,57382647,102023
16,ENSG00000087237.6,56961950,chr16-56997298-T-C,rs289736,1,T,C,56997298,35348,56765342,57158558,231956
16,ENSG00000135686.8,84648511,chr16-84597764-G-A,rs2925064,1,G,A,84597764,50747,84451903,84845119,145861
16,ENSG00000162066.10,2520371,chr16-2697856-C-T,rs3094475,1,C,T,2697856,177485,2323763,2716979,374093
16,ENSG00000103363.10,2777280,chr16-2729235-C-G,rs3094481,-1,C,G,2729235,48045,2580672,2973888,148563
16,ENSG00000103363.10,2777280,chr16-2729235-C-T,rs3094481,-1,C,T,2729235,48045,2580672,2973888,148563
16,ENSG00000103363.10,2777280,chr16-2729235-C-A,rs3094481,-1,C,A,2729235,48045,2580672,2973888,148563
16,ENSG00000162078.7,2830303,chr16-2729235-C-G,rs3094481,1,C,G,2729235,101068,2633695,3026911,95540
16,ENSG00000162078.7,2830303,chr16-2729235-C-T,rs3094481,1,C,T,2729235,101068,2633695,3026911,95540
16,ENSG00000162078.7,2830303,chr16-2729235-C-A,rs3094481,1,C,A,2729235,101068,2633695,3026911,95540
16,ENSG00000103152.7,78225,chr16-76220-G-A,rs34456770,1,G,A,76220,2005,-118383,274833,194603
16,ENSG00000150281.6,30896614,chr16-31078020-A-G,rs35041466,1,A,G,31078020,181406,30700006,31093222,378014
16,ENSG00000126602.6,3717524,chr16-3621438-C-T,rs35192564,-1,C,T,3621438,96086,3520916,3914132,100522
16,ENSG00000131153.3,85688954,chr16-85685312-C-A,rs35444818,-1,C,A,85685312,3642,85492346,85885562,192966
16,ENSG00000217555.6,66552576,chr16-66618110-A-G,rs355943,1,A,G,66618110,65534,66355968,66749184,262142
16,ENSG00000067365.10,8621698,chr16-8554256-A-C,rs36048732,1,A,C,8554256,67442,8425090,8818306,129166
16,ENSG00000167964.7,2148625,chr16-2145555-T-C,rs36227,1,T,C,2145555,3070,1952017,2345233,193538
16,ENSG00000155330.5,46831180,chr16-46740389-C-T,rs36463,-1,C,T,46740389,90791,46634572,47027788,105817
16,ENSG00000103034.10,58500143,chr16-58530960-C-T,rs37059,1,C,T,58530960,30817,58303535,58696751,227425
16,ENSG00000167508.5,88663091,chr16-88655928-G-A,rs3736111,-1,G,A,88655928,7163,88466483,88859699,189445
16,ENSG00000179889.14,14975026,chr16-14889311-C-G,rs3743531,1,C,G,14889311,85715,14778418,15171634,110893
16,ENSG00000103227.12,970984,chr16-954554-C-T,rs3751667,-1,C,T,954554,16430,774376,1167592,180178
16,ENSG00000125170.6,57486493,chr16-57486778-A-G,rs3760067,-1,A,G,57486778,285,57289885,57683101,196893
16,ENSG00000079616.8,29790751,chr16-29661882-T-C,rs3764276,1,T,C,29661882,128869,29594143,29987359,67739
16,ENSG00000156858.7,30650960,chr16-30517290-A-G,rs3764322,1,A,G,30517290,133670,30454352,30847568,62938
16,ENSG00000162004.10,726443,chr16-790597-C-T,rs3765265,-1,C,T,790597,64154,529835,923051,260762
16,ENSG00000127580.11,690398,chr16-714040-G-A,rs3809663,-1,G,A,714040,23642,493790,887006,220250
16,ENSG00000156886.10,31393335,chr16-31486560-G-A,rs3813008,1,G,A,31486560,93225,31196727,31589943,289833
16,ENSG00000156886.10,31393335,chr16-31486560-G-C,rs3813008,1,G,C,31486560,93225,31196727,31589943,289833
16,ENSG00000132613.9,70686053,chr16-70709122-C-T,rs3813909,-1,C,T,70709122,23069,70489445,70882661,219677
16,ENSG00000103064.9,68264526,chr16-68283733-G-A,rs3961283,1,G,A,68283733,19207,68067918,68461134,215815
16,ENSG00000167962.8,2009821,chr16-1960137-G-A,rs397435,-1,G,A,1960137,49684,1813213,2206429,146924
16,ENSG00000140990.10,1959538,chr16-1960137-G-A,rs397435,1,G,A,1960137,599,1762930,2156146,197207
16,ENSG00000168404.8,74700862,chr16-74672838-A-C,rs4072222,-1,A,C,74672838,28024,74504254,74897470,168584
16,ENSG00000140749.7,21652608,chr16-21610925-C-T,rs41468646,-1,C,T,21610925,41683,21456000,21849216,154925
16,ENSG00000008516.11,3046561,chr16-3074919-A-G,rs4349147,1,A,G,3074919,28358,2849953,3243169,224966
16,ENSG00000204991.6,89828475,chr16-89972378-C-A,rs4424910,1,C,A,89972378,143903,89631867,90025083,340511
16,ENSG00000166847.5,23641466,chr16-23598069-T-C,rs442764,1,T,C,23598069,43397,23444858,23838074,153211
16,ENSG00000167981.4,3443504,chr16-3357258-A-G,rs4578649,-1,A,G,3357258,86246,3246896,3640112,110362
16,ENSG00000153060.3,10694930,chr16-10691460-G-A,rs4636907,-1,G,A,10691460,3470,10498322,10891538,193138
16,ENSG00000184602.5,11668455,chr16-11490092-A-G,rs4781112,1,A,G,11490092,178363,11471847,11865063,18245
16,ENSG00000167186.6,19067614,chr16-19036900-A-C,rs4782198,1,A,C,19036900,30714,18871006,19264222,165894
16,ENSG00000181938.9,58392471,chr16-58410750-A-G,rs4784933,1,A,G,58410750,18279,58195863,58589079,214887
16,ENSG00000140948.7,87493024,chr16-87456092-T-C,rs4843613,-1,T,C,87456092,36932,87296416,87689632,159676
16,ENSG00000140795.8,46748344,chr16-46856054-C-A,rs4967576,-1,C,A,46856054,107710,46551736,46944952,304318
16,ENSG00000085721.8,15094272,chr16-15074903-T-C,rs4985147,-1,T,C,15074903,19369,14897664,15290880,177239
16,ENSG00000157322.11,69951334,chr16-70114605-G-A,rs4985397,1,G,A,70114605,163271,69754726,70147942,359879
16,ENSG00000010539.7,3235158,chr16-3207868-G-A,rs548927,-1,G,A,3207868,27290,3038550,3431766,169318
16,ENSG00000167515.6,88857127,chr16-88731518-A-G,rs55924855,1,A,G,88731518,125609,88660519,89053735,70999
16,ENSG00000133393.8,15888603,chr16-15874737-G-A,rs56275653,-1,G,A,15874737,13866,15691995,16085211,182742
16,ENSG00000188897.3,11527245,chr16-11492360-G-A,rs56761637,-1,G,A,11492360,34885,11330637,11723853,161723
16,ENSG00000223496.1,70251940,chr16-70428037-G-A,rs57804197,-1,G,A,70428037,176097,70055332,70448548,372705
16,ENSG00000176715.11,89093852,chr16-89010039-C-A,rs58333036,1,C,A,89010039,83813,88897244,89290460,112795
16,ENSG00000075399.7,89720898,chr16-89598376-G-A,rs60900454,-1,G,A,89598376,122522,89524290,89917506,74086
16,ENSG00000121270.11,48247539,chr16-48170167-T-A,rs61739606,-1,T,A,48170167,77372,48050931,48444147,119236
16,ENSG00000155714.9,22001116,chr16-22146261-C-T,rs61744122,-1,C,T,22146261,145145,21804508,22197724,341753
16,ENSG00000155714.9,22001116,chr16-22146261-C-A,rs61744122,-1,C,A,22146261,145145,21804508,22197724,341753
16,ENSG00000058600.11,22297409,chr16-22228719-T-C,rs62044766,1,T,C,22228719,68690,22100801,22494017,127918
16,ENSG00000158717.6,88706408,chr16-88737574-C-G,rs6500493,-1,C,G,88737574,31166,88509800,88903016,227774
16,ENSG00000103510.14,31117664,chr16-31072003-G-A,rs6565217,1,G,A,31072003,45661,30921056,31314272,150947
16,ENSG00000167965.12,2205454,chr16-2380175-A-G,rs6600193,1,A,G,2380175,174721,2008846,2402062,371329
16,ENSG00000189067.8,11586919,chr16-11548386-T-C,rs7102,-1,T,C,11548386,38533,11390311,11783527,158075
16,ENSG00000007516.8,1333645,chr16-1445242-T-G,rs710900,1,T,G,1445242,111597,1137037,1530253,308205
16,ENSG00000140798.10,48155993,chr16-48129624-G-A,rs7184973,-1,G,A,48129624,26369,47959385,48352601,170239
16,ENSG00000102996.4,58025754,chr16-57884364-G-A,rs7190372,1,G,A,57884364,141390,57829146,58222362,55218
16,ENSG00000169957.7,30526566,chr16-30341447-A-G,rs7190535,-1,A,G,30341447,185119,30329958,30723174,11489
16,ENSG00000166548.10,66550122,chr16-66566576-G-A,rs7193473,-1,G,A,66566576,16454,66353514,66746730,213062
16,ENSG00000089505.12,66566439,chr16-66566576-G-A,rs7193473,1,G,A,66566576,137,66369831,66763047,196745
16,ENSG00000008517.12,3065640,chr16-3002959-G-T,rs7200391,1,G,T,3002959,62681,2869032,3262248,133927
16,ENSG00000008517.12,3065640,chr16-3002959-G-A,rs7200391,1,G,A,3002959,62681,2869032,3262248,133927
16,ENSG00000162073.9,2969348,chr16-2816898-C-A,rs7201208,1,C,A,2816898,152450,2772740,3165956,44158
16,ENSG00000103275.14,1309636,chr16-1487873-G-T,rs7202502,1,G,T,1487873,178237,1113028,1506244,374845
16,ENSG00000103275.14,1309636,chr16-1487873-G-A,rs7202502,1,G,A,1487873,178237,1113028,1506244,374845
16,ENSG00000140835.7,71526426,chr16-71511585-C-T,rs7202662,1,C,T,71511585,14841,71329818,71723034,181767
16,ENSG00000149925.12,30065760,chr16-30166486-C-T,rs7202714,1,C,T,30166486,100726,29869152,30262368,297334
16,ENSG00000242612.1,401885,chr16-558264-G-A,rs7203312,1,G,A,558264,156379,205277,598493,352987
16,ENSG00000127578.6,630985,chr16-605809-G-A,rs72767876,1,G,A,605809,25176,434377,827593,171432
16,ENSG00000090565.10,425649,chr16-605809-G-A,rs72767876,1,G,A,605809,180160,229041,622257,376768
16,ENSG00000103528.12,19168240,chr16-19143689-C-T,rs72779541,1,C,T,19143689,24551,18971632,19364848,172057
16,ENSG00000102897.5,20900771,chr16-21058324-C-T,rs72780846,1,C,T,21058324,157553,20704163,21097379,354161
16,ENSG00000158545.10,88570403,chr16-88708513-C-T,rs7404845,1,C,T,88708513,138110,88373795,88767011,334718
16,ENSG00000158545.10,88570403,chr16-88708513-C-A,rs7404845,1,C,A,88708513,138110,88373795,88767011,334718
16,ENSG00000103496.10,31033558,chr16-31113086-A-G,rs749767,1,A,G,31113086,79528,30836950,31230166,276136
16,ENSG00000178188.10,28863843,chr16-28965699-G-A,rs7500321,1,G,A,28965699,101856,28667235,29060451,298464
16,ENSG00000140955.6,84191157,chr16-84238932-A-G,rs75063301,1,A,G,84238932,47775,83994549,84387765,244383
16,ENSG00000149927.13,30011027,chr16-29887802-G-T,rs75331747,-1,G,T,29887802,123225,29814419,30207635,73383
16,ENSG00000103502.8,29863226,chr16-29887802-G-T,rs75331747,-1,G,T,29887802,24576,29666618,30059834,221184
16,ENSG00000102882.7,30123220,chr16-30114519-G-C,rs7542,-1,G,C,30114519,8701,29926612,30319828,187907
16,ENSG00000006194.6,3283491,chr16-3467427-A-C,rs76498019,1,A,C,3467427,183936,3086883,3480099,380544
16,ENSG00000141012.7,88856947,chr16-88865101-G-A,rs76746996,-1,G,A,88865101,8154,88660339,89053555,204762
16,ENSG00000140995.12,89948755,chr16-90026667-G-A,rs77270200,1,G,A,90026667,77912,89752147,90145363,274520
16,ENSG00000007520.3,1351878,chr16-1338908-C-T,rs77633104,-1,C,T,1338908,12970,1155270,1548486,183638
16,ENSG00000176387.5,67431121,chr16-67277715-C-G,rs78132437,1,C,G,67277715,153406,67234513,67627729,43202
16,ENSG00000187741.9,89816647,chr16-89638523-C-T,rs78545310,-1,C,T,89638523,178124,89620039,90013255,18484
16,ENSG00000103351.8,3501004,chr16-3632547-T-G,rs78599052,1,T,G,3632547,131543,3304396,3697612,328151
16,ENSG00000051523.6,88651053,chr16-88602824-A-G,rs78729051,-1,A,G,88602824,48229,88454445,88847661,148379
16,ENSG00000213398.3,67944120,chr16-67958069-C-T,rs78818722,-1,C,T,67958069,13949,67747512,68140728,210557
16,ENSG00000140988.10,1964826,chr16-1963851-G-A,rs79381233,-1,G,A,1963851,975,1768218,2161434,195633
16,ENSG00000161981.6,53828,chr16-47610-G-A,rs798675,1,G,A,47610,6218,-142780,250436,190390
16,ENSG00000197943.5,81779291,chr16-81842674-G-T,rs8043593,1,G,T,81842674,63383,81582683,81975899,259991
16,ENSG00000103335.14,88785220,chr16-88781029-T-C,rs8043839,-1,T,C,88781029,4191,88588612,88981828,192417
16,ENSG00000065054.8,2026902,chr16-2004154-G-A,rs8045887,1,G,A,2004154,22748,1830294,2223510,173860
16,ENSG00000131634.9,1533666,chr16-1543605-C-T,rs8049972,1,C,T,1543605,9939,1337058,1730274,206547
16,ENSG00000140682.14,31472152,chr16-31393250-T-C,rs8050500,1,T,C,31393250,78902,31275544,31668760,117706
16,ENSG00000140876.7,77722514,chr16-77713547-A-G,rs8051061,1,A,G,77713547,8967,77525906,77919122,187641
16,ENSG00000182108.5,10942468,chr16-10926398-A-G,rs8052709,-1,A,G,10926398,16070,10745860,11139076,180538
16,ENSG00000103222.13,15949616,chr16-15897592-T-G,rs8052957,1,T,G,15897592,52024,15753008,16146224,144584
16,ENSG00000127561.8,1989970,chr16-1971104-T-C,rs8055439,1,T,C,1971104,18866,1793362,2186578,177742
16,ENSG00000011638.6,21158674,chr16-21178771-G-A,rs8055894,1,G,A,21178771,20097,20962066,21355282,216705
16,ENSG00000141002.11,89873592,chr16-89967502-C-A,rs8057380,1,C,A,89967502,93910,89676984,90070200,290518
16,ENSG00000034713.3,75566379,chr16-75528286-T-C,rs8058586,1,T,C,75528286,38093,75369771,75762987,158515
16,ENSG00000013364.14,29820462,chr16-30002136-G-A,rs8058765,1,G,A,30002136,181674,29623854,30017070,378282
16,ENSG00000185324.17,89686689,chr16-89748399-T-C,rs8058895,1,T,C,89748399,61710,89490081,89883297,258318
16,ENSG00000205832.6,4556340,chr16-4621728-T-G,rs8059151,1,T,G,4621728,65388,4359732,4752948,261996
16,ENSG00000003249.8,90019456,chr16-90013126-A-G,rs8059973,-1,A,G,90013126,6330,89822848,90216064,190278
16,ENSG00000168872.10,70346903,chr16-70440031-G-A,rs8062183,1,G,A,70440031,93128,70150295,70543511,289736
16,ENSG00000051108.10,56932142,chr16-56883257-G-T,rs8063406,1,G,T,56883257,48885,56735534,57128750,147723
16,ENSG00000153066.7,11742857,chr16-11671758-G-A,rs8191288,-1,G,A,11671758,71099,11546249,11939465,125509
16,ENSG00000174177.8,88706503,chr16-88707330-C-T,rs881633,1,C,T,88707330,827,88509895,88903111,197435
16,ENSG00000089486.10,4538773,chr16-4390592-C-T,rs917305,-1,C,T,4390592,148181,4342165,4735381,48427
16,ENSG00000189091.7,70523816,chr16-70693421-G-T,rs936299,1,G,T,70693421,169605,70327208,70720424,366213
16,ENSG00000132600.11,68311019,chr16-68296094-G-A,rs9788810,1,G,A,68296094,14925,68114411,68507627,181683
16,ENSG00000188827.6,3611606,chr16-3536230-C-T,rs9790,-1,C,T,3536230,75376,3414998,3808214,121232
16,ENSG00000167191.6,19884848,chr16-20045947-C-T,rs9923019,-1,C,T,20045947,161099,19688240,20081456,357707
16,ENSG00000185883.5,2513952,chr16-2337342-A-C,rs9924128,1,A,C,2337342,176610,2317344,2710560,19998
16,ENSG00000185883.5,2513952,chr16-2337342-A-G,rs9924128,1,A,G,2337342,176610,2317344,2710560,19998
16,ENSG00000197912.8,89508403,chr16-89561665-G-A,rs9930567,1,G,A,89561665,53262,89311795,89705011,249870
16,ENSG00000179965.7,30407606,chr16-30463535-G-A,rs9934579,1,G,A,30463535,55929,30210998,30604214,252537
16,ENSG00000175643.7,11345459,chr16-11343922-C-T,rs9936459,1,C,T,11343922,1537,11148851,11542067,195071
16,ENSG00000080603.12,30699171,chr16-30605167-G-A,rs9937653,1,G,A,30605167,94004,30502563,30895779,102604
16,ENSG00000103528.12,19168240,chr16-19143368-A-G,rs10454701,1,A,G,19143368,24872,18971632,19364848,171736
16,ENSG00000167394.8,31074240,chr16-31183958-C-T,rs1052352,-1,C,T,31183958,109718,30877632,31270848,306326
16,ENSG00000180035.6,30395420,chr16-30481502-C-T,rs1064524,1,C,T,30481502,86082,30198812,30592028,282690
16,ENSG00000103313.6,3256633,chr16-3180887-T-G,rs1076573,-1,T,G,3180887,75746,3060025,3453241,120862
16,ENSG00000132613.9,70686053,chr16-70529368-A-G,rs11075766,-1,A,G,70529368,156685,70489445,70882661,39923
16,ENSG00000167513.4,88803789,chr16-88829729-C-T,rs11076720,1,C,T,88829729,25940,88607181,89000397,222548
16,ENSG00000118894.9,5097795,chr16-5138184-T-C,rs11076882,-1,T,C,5138184,40389,4901187,5294403,236997
16,ENSG00000167981.4,3443504,chr16-3395112-C-T,rs11077333,-1,C,T,3395112,48392,3246896,3640112,148216
16,ENSG00000159461.9,56425545,chr16-56321909-C-T,rs1108657,-1,C,T,56321909,103636,56228937,56622153,92972
16,ENSG00000129993.10,88977207,chr16-89172319-T-G,rs1109821,-1,T,G,89172319,195112,88780599,89173815,391720
16,ENSG00000176953.6,28950937,chr16-28869680-G-T,rs11150623,1,G,T,28869680,81257,28754329,29147545,115351
16,ENSG00000167930.11,234821,chr16-243563-T-C,rs11248914,1,T,C,243563,8742,38213,431429,205350
16,ENSG00000162004.10,726443,chr16-538512-C-A,rs112669437,-1,C,A,538512,187931,529835,923051,8677
16,ENSG00000169682.13,28974778,chr16-28986676-G-A,rs1131543,1,G,A,28986676,11898,28778170,29171386,208506
16,ENSG00000176723.5,31442789,chr16-31431280-G-A,rs113646124,-1,G,A,31431280,11509,31246181,31639397,185099
16,ENSG00000166783.13,15643154,chr16-15793271-C-T,rs114258721,-1,C,T,15793271,150117,15446546,15839762,346725
16,ENSG00000197471.6,29663247,chr16-29662712-T-C,rs11574552,1,T,C,29662712,535,29466639,29859855,196073
16,ENSG00000179918.14,30445874,chr16-30496018-C-T,rs11574943,-1,C,T,30496018,50144,30249266,30642482,246752
16,ENSG00000175643.7,11345459,chr16-11326285-C-G,rs11640306,1,C,G,11326285,19174,11148851,11542067,177434
16,ENSG00000158805.7,89721537,chr16-89525645-G-A,rs11643271,1,G,A,89525645,195892,89524929,89918145,716
16,ENSG00000141012.7,88856947,chr16-88767606-A-C,rs11643303,-1,A,C,88767606,89341,88660339,89053555,107267
16,ENSG00000166592.7,66925535,chr16-66976846-C-T,rs11645675,-1,C,T,66976846,51311,66728927,67122143,247919
16,ENSG00000090238.7,30096213,chr16-29915150-T-C,rs11646118,-1,T,C,29915150,181063,29899605,30292821,15545
16,ENSG00000175938.5,30949068,chr16-30953987-G-A,rs11647243,1,G,A,30953987,4919,30752460,31145676,201527
16,ENSG00000184602.5,11668455,chr16-11693858-G-C,rs11648550,1,G,C,11693858,25403,11471847,11865063,222011
16,ENSG00000140848.12,57092583,chr16-57091421-G-A,rs11649098,1,G,A,57091421,1162,56895975,57289191,195446
16,ENSG00000158717.6,88706408,chr16-88700532-C-T,rs11649140,-1,C,T,88700532,5876,88509800,88903016,190732
16,ENSG00000184939.8,68539291,chr16-68539444-G-A,rs116895279,1,G,A,68539444,153,68342683,68735899,196761
16,ENSG00000140859.10,57802491,chr16-57670371-G-A,rs117394905,-1,G,A,57670371,132120,57605883,57999099,64488
16,ENSG00000103310.6,21211574,chr16-21251675-C-A,rs117548295,-1,C,A,21251675,40101,21014966,21408182,236709
16,ENSG00000189067.8,11586919,chr16-11598669-C-G,rs117638322,-1,C,G,11598669,11750,11390311,11783527,208358
16,ENSG00000167395.9,31074422,chr16-30885159-G-A,rs11859376,1,G,A,30885159,189263,30877814,31271030,7345
16,ENSG00000102886.10,30113537,chr16-30119172-C-A,rs11865086,-1,C,A,30119172,5635,29916929,30310145,202243
16,ENSG00000198931.6,88811928,chr16-88842710-C-T,rs11865929,-1,C,T,88842710,30782,88615320,89008536,227390
16,ENSG00000102904.10,67806889,chr16-67845382-G-A,rs11866455,1,G,A,67845382,38493,67610281,68003497,235101
16,ENSG00000166669.9,10386061,chr16-10460937-A-G,rs12165003,1,A,G,10460937,74876,10189453,10582669,271484
16,ENSG00000103351.8,3501004,chr16-3355994-A-G,rs1228348,1,A,G,3355994,145010,3304396,3697612,51598
16,ENSG00000140632.11,4847288,chr16-4784377-A-C,rs12443659,-1,A,C,4784377,62911,4650680,5043896,133697
16,ENSG00000184110.9,28711464,chr16-28826752-A-G,rs12448482,1,A,G,28826752,115288,28514856,28908072,311896
16,ENSG00000005339.7,3880713,chr16-3935080-G-T,rs12598924,-1,G,T,3935080,54367,3684105,4077321,250975
16,ENSG00000130731.11,636305,chr16-707166-T-C,rs12599342,-1,T,C,707166,70861,439697,832913,267469
16,ENSG00000140941.7,87392336,chr16-87263784-G-T,rs12919692,1,G,T,87263784,128552,87195728,87588944,68056
16,ENSG00000103381.7,12803887,chr16-12773853-A-G,rs12920195,-1,A,G,12773853,30034,12607279,13000495,166574
16,ENSG00000131634.9,1533666,chr16-1729694-C-T,rs12920634,1,C,T,1729694,196028,1337058,1730274,392636
16,ENSG00000059145.13,1414704,chr16-1325936-C-A,rs12925270,-1,C,A,1325936,88768,1218096,1611312,107840
16,ENSG00000103202.7,397199,chr16-291664-G-A,rs12926617,1,G,A,291664,105535,200591,593807,91073
16,ENSG00000166451.9,81007214,chr16-81016195-T-C,rs12928638,1,T,C,81016195,8981,80810606,81203822,205589
16,ENSG00000174628.12,19718280,chr16-19586089-A-G,rs12929400,1,A,G,19586089,132191,19521672,19914888,64417
16,ENSG00000167508.5,88663091,chr16-88646359-A-G,rs12933505,-1,A,G,88646359,16732,88466483,88859699,179876
16,ENSG00000149922.6,30091924,chr16-29910690-C-T,rs12933766,-1,C,T,29910690,181234,29895316,30288532,15374
16,ENSG00000140987.14,3401004,chr16-3384934-A-G,rs13331981,-1,A,G,3384934,16070,3204396,3597612,180538
16,ENSG00000013364.14,29820462,chr16-29839384-C-T,rs13332078,1,C,T,29839384,18922,29623854,30017070,215530
16,ENSG00000153060.3,10694930,chr16-10690624-T-G,rs13335556,-1,T,G,10690624,4306,10498322,10891538,192302
16,ENSG00000167965.12,2205454,chr16-2075833-T-C,rs13337626,1,T,C,2075833,129621,2008846,2402062,66987
16,ENSG00000184857.7,8797639,chr16-8654860-G-A,rs1420087,-1,G,A,8654860,142779,8601031,8994247,53829
16,ENSG00000103091.10,74985123,chr16-74886293-G-A,rs14308,-1,G,A,74886293,98830,74788515,75181731,97778
16,ENSG00000140905.5,81096395,chr16-81112371-C-T,rs145784865,-1,C,T,81112371,15976,80899787,81293003,212584
16,ENSG00000103121.4,81006885,chr16-80976945-C-T,rs16954366,-1,C,T,80976945,29940,80810277,81203493,166668
16,ENSG00000159761.9,67666814,chr16-67617976-G-A,rs16957489,1,G,A,67617976,48838,67470206,67863422,147770
16,ENSG00000204991.6,89828475,chr16-89814436-A-G,rs17232120,1,A,G,89814436,14039,89631867,90025083,182569
16,ENSG00000172775.11,57186039,chr16-57149012-C-A,rs17372662,-1,C,A,57149012,37027,56989431,57382647,159581
16,ENSG00000102934.5,57284672,chr16-57194096-A-G,rs17373185,-1,A,G,57194096,90576,57088064,57481280,106032
16,ENSG00000141098.7,67719316,chr16-67593732-G-T,rs17686899,-1,G,T,67593732,125584,67522708,67915924,71024
16,ENSG00000124067.11,67968637,chr16-67860723-G-C,rs17687442,-1,G,C,67860723,107914,67772029,68165245,88694
16,ENSG00000140876.7,77722514,chr16-77751116-A-C,rs17696958,1,A,C,77751116,28602,77525906,77919122,225210
16,ENSG00000262246.1,4416596,chr16-4489941-A-C,rs17761715,-1,A,C,4489941,73345,4219988,4613204,269953
16,ENSG00000135698.5,82170224,chr16-82244385-T-C,rs1844722,-1,T,C,82244385,74161,81973616,82366832,270769
16,ENSG00000169715.10,56625781,chr16-56637784-T-C,rs1846692,1,T,C,56637784,12003,56429173,56822389,208611
16,ENSG00000181938.9,58392471,chr16-58443471-G-A,rs1862802,1,G,A,58443471,51000,58195863,58589079,247608
16,ENSG00000181938.9,58392471,chr16-58443471-G-T,rs1862802,1,G,T,58443471,51000,58195863,58589079,247608
16,ENSG00000186260.11,14071319,chr16-13892567-C-T,rs1895560,1,C,T,13892567,178752,13874711,14267927,17856
16,ENSG00000103111.10,77191190,chr16-77250116-A-G,rs1946282,1,A,G,77250116,58926,76994582,77387798,255534
16,ENSG00000167397.10,31094797,chr16-31118621-C-T,rs1978487,-1,C,T,31118621,23824,30898189,31291405,220432
16,ENSG00000103489.7,17470960,chr16-17278824-T-C,rs2045498,-1,T,C,17278824,192136,17274352,17667568,4472
16,ENSG00000167968.7,2236444,chr16-2061229-A-G,rs2074969,1,A,G,2061229,175215,2039836,2433052,21393
16,ENSG00000127561.8,1989970,chr16-1984660-T-C,rs2075812,1,T,C,1984660,5310,1793362,2186578,191298
16,ENSG00000140990.10,1959538,chr16-1984660-T-C,rs2075812,1,T,C,1984660,25122,1762930,2156146,221730
16,ENSG00000196408.7,1981469,chr16-1984660-T-C,rs2075812,-1,T,C,1984660,3191,1784861,2178077,199799
16,ENSG00000126602.6,3717524,chr16-3636162-A-C,rs2158442,-1,A,C,3636162,81362,3520916,3914132,115246
16,ENSG00000133393.8,15888603,chr16-15825677-C-T,rs216163,-1,C,T,15825677,62926,15691995,16085211,133682
16,ENSG00000010539.7,3235158,chr16-3289435-G-C,rs220379,-1,G,C,3289435,54277,3038550,3431766,250885
16,ENSG00000063854.7,1826825,chr16-1680310-A-G,rs2235487,-1,A,G,1680310,146515,1630217,2023433,50093
16,ENSG00000178773.10,89575758,chr16-89760315-G-A,rs2238526,1,G,A,89760315,184557,89379150,89772366,381165
16,ENSG00000005194.10,57447385,chr16-57451005-G-A,rs223863,-1,G,A,57451005,3620,57250777,57643993,200228
16,ENSG00000077238.8,27313974,chr16-27347627-A-G,rs2239348,1,A,G,27347627,33653,27117366,27510582,230261
16,ENSG00000140988.10,1964826,chr16-1998825-C-G,rs2240691,-1,C,G,1998825,33999,1768218,2161434,230607
16,ENSG00000140988.10,1964826,chr16-1998825-C-T,rs2240691,-1,C,T,1998825,33999,1768218,2161434,230607
16,ENSG00000140993.5,3305430,chr16-3115050-C-T,rs224177,-1,C,T,3115050,190380,3108822,3502038,6228
16,ENSG00000067365.10,8621698,chr16-8628772-G-C,rs2270286,1,G,C,8628772,7074,8425090,8818306,203682
16,ENSG00000051108.10,56932142,chr16-56902546-A-G,rs2289117,1,A,G,56902546,29596,56735534,57128750,167012
16,ENSG00000132600.11,68311019,chr16-68255080-T-G,rs2290700,1,T,G,68255080,55939,68114411,68507627,140669
16,ENSG00000180185.7,1826941,chr16-1764439-A-G,rs2294619,1,A,G,1764439,62502,1630333,2023549,134106
16,ENSG00000103174.6,5033935,chr16-5021669-A-C,rs2340713,-1,A,C,5021669,12266,4837327,5230543,184342
16,ENSG00000171724.2,77788564,chr16-77932936-T-G,rs2435078,1,T,G,77932936,144372,77591956,77985172,340980
16,ENSG00000213853.5,10580598,chr16-10654836-G-C,rs2541556,-1,G,C,10654836,74238,10383990,10777206,270846
16,ENSG00000188536.7,172876,chr16-161106-T-G,rs2541645,1,T,G,161106,11770,-23732,369484,184838
16,ENSG00000167971.12,2196605,chr16-2156590-A-G,rs258282,-1,A,G,2156590,40015,1999997,2393213,156593
16,ENSG00000154102.5,85751096,chr16-85804897-T-C,rs2599090,-1,T,C,85804897,53801,85554488,85947704,250409
16,ENSG00000197272.2,28506834,chr16-28322090-G-A,rs2650492,-1,G,A,28322090,184744,28310226,28703442,11864
16,ENSG00000070770.3,58198106,chr16-58228088-G-T,rs2731770,-1,G,T,58228088,29982,58001498,58394714,226590
16,ENSG00000182685.3,2210863,chr16-2096907-C-T,rs28495326,-1,C,T,2096907,113956,2014255,2407471,82652
16,ENSG00000170100.9,89217703,chr16-89228103-C-T,rs28638280,1,C,T,89228103,10400,89021095,89414311,207008
16,ENSG00000170100.9,89217703,chr16-89228103-C-G,rs28638280,1,C,G,89228103,10400,89021095,89414311,207008
16,ENSG00000135686.8,84648511,chr16-84594173-T-A,rs2914835,1,T,A,84594173,54338,84451903,84845119,142270
16,ENSG00000156886.10,31393335,chr16-31381987-G-A,rs2929,1,G,A,31381987,11348,31196727,31589943,185260
16,ENSG00000103227.12,970984,chr16-974083-G-A,rs34319385,-1,G,A,974083,3099,774376,1167592,199707
16,ENSG00000157353.11,70454595,chr16-70483738-G-A,rs34329336,1,G,A,70483738,29143,70257987,70651203,225751
16,ENSG00000048462.5,11965210,chr16-12148016-G-C,rs350224,1,G,C,12148016,182806,11768602,12161818,379414
16,ENSG00000185905.3,29745990,chr16-29844761-G-A,rs35916172,-1,G,A,29844761,98771,29549382,29942598,295379
16,ENSG00000135740.11,67248979,chr16-67196519-C-T,rs3730406,1,C,T,67196519,52460,67052371,67445587,144148
16,ENSG00000182831.7,9091644,chr16-9120023-A-C,rs3743832,1,A,C,9120023,28379,8895036,9288252,224987
16,ENSG00000185324.17,89686689,chr16-89685786-G-A,rs3751700,1,G,A,89685786,903,89490081,89883297,195705
16,ENSG00000242612.1,401885,chr16-424180-G-A,rs3760048,1,G,A,424180,22295,205277,598493,218903
16,ENSG00000140682.14,31472152,chr16-31459219-T-C,rs3813002,1,T,C,31459219,12933,31275544,31668760,183675
16,ENSG00000121281.7,50266551,chr16-50285118-T-C,rs3826170,1,T,C,50285118,18567,50069943,50463159,215175
16,ENSG00000169203.11,29499452,chr16-29667246-T-C,rs3851019,-1,T,C,29667246,167794,29302844,29696060,364402
16,ENSG00000086504.10,370538,chr16-322597-A-G,rs3916990,-1,A,G,322597,47941,173930,567146,148667
16,ENSG00000140945.10,82626969,chr16-82680269-C-T,rs4081995,1,C,T,82680269,53300,82430361,82823577,249908
16,ENSG00000131148.3,85799544,chr16-85895413-G-A,rs413529,-1,G,A,85895413,95869,85602936,85996152,292477
16,ENSG00000197943.5,81779291,chr16-81817172-A-G,rs4243216,1,A,G,81817172,37881,81582683,81975899,234489
16,ENSG00000197943.5,81779291,chr16-81817172-A-C,rs4243216,1,A,C,81817172,37881,81582683,81975899,234489
16,ENSG00000217555.6,66552576,chr16-66672649-T-A,rs4258603,1,T,A,66672649,120073,66355968,66749184,316681
16,ENSG00000217555.6,66552576,chr16-66672649-T-C,rs4258603,1,T,C,66672649,120073,66355968,66749184,316681
16,ENSG00000140743.3,22374619,chr16-22330782-C-T,rs4275840,-1,C,T,22330782,43837,22178011,22571227,152771
16,ENSG00000090581.5,1351931,chr16-1418749-A-C,rs4318206,1,A,C,1418749,66818,1155323,1548539,263426
16,ENSG00000159792.4,67893254,chr16-67724875-C-T,rs4474673,1,C,T,67724875,168379,67696646,68089862,28229
16,ENSG00000006007.7,19522098,chr16-19393323-A-G,rs4780805,-1,A,G,19393323,128775,19325490,19718706,67833
16,ENSG00000182108.5,10942468,chr16-10941102-A-G,rs4781025,-1,A,G,10941102,1366,10745860,11139076,195242
16,ENSG00000095906.11,1782960,chr16-1593246-C-T,rs4786363,1,C,T,1593246,189714,1586352,1979568,6894
16,ENSG00000104731.9,87765986,chr16-87922506-G-A,rs4843739,-1,G,A,87922506,156520,87569378,87962594,353128
16,ENSG00000088682.9,57447479,chr16-57631112-G-A,rs56064937,1,G,A,57631112,183633,57250871,57644087,380241
16,ENSG00000149925.12,30065760,chr16-29996004-C-T,rs56183743,1,C,T,29996004,69756,29869152,30262368,126852
16,ENSG00000149926.9,30031271,chr16-29996004-C-T,rs56183743,-1,C,T,29996004,35267,29834663,30227879,161341
16,ENSG00000140983.7,668132,chr16-554814-A-G,rs56918124,1,A,G,554814,113318,471524,864740,83290
16,ENSG00000167526.9,89560682,chr16-89598376-G-A,rs60900454,1,G,A,89598376,37694,89364074,89757290,234302
16,ENSG00000174177.8,88706503,chr16-88744251-T-C,rs62048195,1,T,C,88744251,37748,88509895,88903111,234356
16,ENSG00000205423.7,50025225,chr16-49892463-G-T,rs6500264,1,G,T,49892463,132762,49828617,50221833,63846
16,ENSG00000090863.7,74607114,chr16-74467958-C-G,rs6564117,-1,C,G,74467958,139156,74410506,74803722,57452
16,ENSG00000184517.7,75148524,chr16-75166189-A-C,rs6564214,1,A,C,75166189,17665,74951916,75345132,214273
16,ENSG00000156968.7,15395754,chr16-15403697-A-G,rs66615285,1,A,G,15403697,7943,15199146,15592362,204551
16,ENSG00000003249.8,90019456,chr16-90014444-C-T,rs66701606,-1,C,T,90014444,5012,89822848,90216064,191596
16,ENSG00000103148.9,138673,chr16-254804-A-T,rs7189020,-1,A,T,254804,116131,-57935,335281,312739
16,ENSG00000157423.12,71230722,chr16-71373627-A-G,rs7191938,-1,A,G,71373627,142905,71034114,71427330,339513
16,ENSG00000103522.11,27402174,chr16-27224774-C-T,rs7192633,1,C,T,27224774,177400,27205566,27598782,19208
16,ENSG00000169896.11,31259975,chr16-31259742-G-A,rs7193943,1,G,A,31259742,233,31063367,31456583,196375
16,ENSG00000177455.6,28931971,chr16-28847190-C-G,rs7193993,1,C,G,28847190,84781,28735363,29128579,111827
16,ENSG00000177455.6,28931971,chr16-28847190-C-T,rs7193993,1,C,T,28847190,84781,28735363,29128579,111827
16,ENSG00000140835.7,71526426,chr16-71539915-A-G,rs7194638,1,A,G,71539915,13489,71329818,71723034,210097
16,ENSG00000213658.5,28985052,chr16-29008973-C-T,rs7201546,1,C,T,29008973,23921,28788444,29181660,220529
16,ENSG00000103269.9,675671,chr16-748536-C-A,rs72773434,1,C,A,748536,72865,479063,872279,269473
16,ENSG00000103021.5,58249936,chr16-58295465-C-T,rs72786184,1,C,T,58295465,45529,58053328,58446544,242137
16,ENSG00000149932.11,29962079,chr16-29809974-C-G,rs72798129,1,C,G,29809974,152105,29765471,30158687,44503
16,ENSG00000149932.11,29962079,chr16-29809974-C-T,rs72798129,1,C,T,29809974,152105,29765471,30158687,44503
16,ENSG00000059122.12,2911931,chr16-2936430-T-C,rs739716,1,T,C,2936430,24499,2715323,3108539,221107
16,ENSG00000161981.6,53828,chr16-112241-G-A,rs74614704,1,G,A,112241,58413,-142780,250436,255021
16,ENSG00000166743.5,20697680,chr16-20553068-G-A,rs7499304,-1,G,A,20553068,144612,20501072,20894288,51996
16,ENSG00000166743.5,20697680,chr16-20553068-G-T,rs7499304,-1,G,T,20553068,144612,20501072,20894288,51996
16,ENSG00000103429.6,14632951,chr16-14630732-G-A,rs7501119,1,G,A,14630732,2219,14436343,14829559,194389
16,ENSG00000196993.4,28751787,chr16-28878650-C-T,rs75273069,1,C,T,28878650,126863,28555179,28948395,323471
16,ENSG00000167515.6,88857127,chr16-88702696-C-T,rs752843,1,C,T,88702696,154431,88660519,89053735,42177
16,ENSG00000167515.6,88857127,chr16-88702696-C-G,rs752843,1,C,G,88702696,154431,88660519,89053735,42177
16,ENSG00000140807.4,50548396,chr16-50445072-G-A,rs753111,1,G,A,50445072,103324,50351788,50745004,93284
16,ENSG00000103248.12,86555235,chr16-86513676-G-T,rs75593355,-1,G,T,86513676,41559,86358627,86751843,155049
16,ENSG00000162076.8,2883215,chr16-2913260-C-G,rs757166,1,C,G,2913260,30045,2686607,3079823,226653
16,ENSG00000162076.8,2883215,chr16-2913260-C-T,rs757166,1,C,T,2913260,30045,2686607,3079823,226653
16,ENSG00000168807.11,69187164,chr16-69382756-T-C,rs75927521,1,T,C,69382756,195592,68990556,69383772,392200
16,ENSG00000008517.12,3065640,chr16-3065324-G-C,rs76580947,1,G,C,3065324,316,2869032,3262248,196292
16,ENSG00000008516.11,3046561,chr16-3065324-G-C,rs76580947,1,G,C,3065324,18763,2849953,3243169,215371
16,ENSG00000154099.12,84145308,chr16-84034343-C-T,rs77294087,1,C,T,84034343,110965,83948700,84341916,85643
16,ENSG00000232258.2,8590511,chr16-8475685-T-C,rs77546719,-1,T,C,8475685,114826,8393903,8787119,81782
16,ENSG00000174109.3,1420747,chr16-1338908-C-T,rs77633104,-1,C,T,1338908,81839,1224139,1617355,114769
16,ENSG00000103404.10,23149452,chr16-23206231-G-C,rs78367348,-1,G,C,23206231,56779,22952844,23346060,253387
16,ENSG00000103404.10,23149452,chr16-23206231-G-A,rs78367348,-1,G,A,23206231,56779,22952844,23346060,253387
16,ENSG00000149929.10,29995617,chr16-30120456-G-A,rs78564187,-1,G,A,30120456,124839,29799009,30192225,321447
16,ENSG00000038358.10,67873052,chr16-67958069-C-T,rs78818722,1,C,T,67958069,85017,67676444,68069660,281625
16,ENSG00000140986.7,1954689,chr16-1947384-C-G,rs79075024,-1,C,G,1947384,7305,1758081,2151297,189303
16,ENSG00000140986.7,1954689,chr16-1947384-C-T,rs79075024,-1,C,T,1947384,7305,1758081,2151297,189303
16,ENSG00000166123.9,46884362,chr16-47022953-G-A,rs79195630,1,G,A,47022953,138591,46687754,47080970,335199
16,ENSG00000197599.8,1444556,chr16-1405899-C-T,rs8044833,-1,C,T,1405899,38657,1247948,1641164,157951
16,ENSG00000103056.7,68448508,chr16-68394423-A-G,rs8050499,-1,A,G,68394423,54085,68251900,68645116,142523
16,ENSG00000188897.3,11527245,chr16-11510016-A-G,rs8050631,-1,A,G,11510016,17229,11330637,11723853,179379
16,ENSG00000155330.5,46831180,chr16-46842664-C-T,rs8053297,-1,C,T,46842664,11484,46634572,47027788,208092
16,ENSG00000087250.4,56589528,chr16-56615725-C-T,rs8055724,1,C,T,56615725,26197,56392920,56786136,222805
16,ENSG00000034713.3,75566379,chr16-75549610-A-G,rs8057684,1,A,G,75549610,16769,75369771,75762987,179839
16,ENSG00000141013.10,90022680,chr16-90013126-A-G,rs8059973,1,A,G,90013126,9554,89826072,90219288,187054
16,ENSG00000153048.6,8869006,chr16-8772464-A-C,rs8060255,-1,A,C,8772464,96542,8672398,9065614,100066
16,ENSG00000103089.4,74774820,chr16-74796446-C-T,rs8060911,-1,C,T,74796446,21626,74578212,74971428,218234
16,ENSG00000159618.11,57542643,chr16-57602393-C-T,rs8062400,1,C,T,57602393,59750,57346035,57739251,256358
16,ENSG00000103066.8,68245373,chr16-68310460-A-C,rs8063446,1,A,C,68310460,65087,68048765,68441981,261695
16,ENSG00000103199.8,4767162,chr16-4797168-G-A,rs8118,-1,G,A,4797168,30006,4570554,4963770,226614
16,ENSG00000141002.11,89873592,chr16-90023055-C-G,rs870856,1,C,G,90023055,149463,89676984,90070200,346071
16,ENSG00000167005.8,56451332,chr16-56287207-A-G,rs899239,-1,A,G,56287207,164125,56254724,56647940,32483
16,ENSG00000011638.6,21158674,chr16-21187175-C-G,rs9889185,1,C,G,21187175,28501,20962066,21355282,225109
16,ENSG00000070915.5,56865207,chr16-56798390-C-T,rs9927884,1,C,T,56798390,66817,56668599,57061815,129791
16,ENSG00000178188.10,28863843,chr16-28990139-A-C,rs9929088,1,A,C,28990139,126296,28667235,29060451,322904
16,ENSG00000127585.7,705801,chr16-666287-C-A,rs9934288,-1,C,A,666287,39514,509193,902409,157094
16,ENSG00000102858.7,4624826,chr16-4646653-T-C,rs9939503,1,T,C,4646653,21827,4428218,4821434,218435
15,ENSG00000128944.8,40382721,chr15-40421575-A-G,rs1001528,1,A,G,40421575,38854,40186113,40579329,235462
15,ENSG00000166140.12,40807089,chr15-40811095-A-G,rs10152371,1,A,G,40811095,4006,40610481,41003697,200614
15,ENSG00000186073.7,36579626,chr15-36711692-G-A,rs10468086,1,G,A,36711692,132066,36383018,36776234,328674
15,ENSG00000041357.11,78540444,chr15-78549011-T-C,rs1052035,1,T,C,78549011,8567,78343836,78737052,205175
15,ENSG00000157450.11,58987663,chr15-58893557-C-T,rs1079087,1,C,T,58893557,94106,58791055,59184271,102502
15,ENSG00000129003.11,62060447,chr15-61910283-C-T,rs10851704,-1,C,T,61910283,150164,61863839,62257055,46444
15,ENSG00000128829.6,39934115,chr15-40025591-T-G,rs11070245,1,T,G,40025591,91476,39737507,40130723,288084
15,ENSG00000171989.4,59206843,chr15-59290430-C-T,rs11071425,1,C,T,59290430,83587,59010235,59403451,280195
15,ENSG00000183496.5,82046018,chr15-81887952-A-G,rs11073021,-1,A,G,81887952,158066,81849410,82242626,38542
15,ENSG00000140525.13,89243979,chr15-89192987-C-T,rs1109794,1,C,T,89192987,50992,89047371,89440587,145616
15,ENSG00000140525.13,89243979,chr15-89192987-C-G,rs1109794,1,C,G,89192987,50992,89047371,89440587,145616
15,ENSG00000184508.6,90932549,chr15-90957222-G-A,rs11554300,-1,G,A,90957222,24673,90735941,91129157,221281
15,ENSG00000103647.8,68578993,chr15-68731330-G-A,rs115701798,1,G,A,68731330,152337,68382385,68775601,348945
15,ENSG00000140450.7,97960703,chr15-97961563-C-T,rs115948118,1,C,T,97961563,860,97764095,98157311,197468
15,ENSG00000136379.7,80695310,chr15-80692946-A-G,rs11629662,1,A,G,80692946,2364,80498702,80891918,194244
15,ENSG00000129009.8,74173710,chr15-74179953-A-G,rs11631944,1,A,G,74179953,6243,73977102,74370318,202851
15,ENSG00000183655.10,85794925,chr15-85711256-T-C,rs11632005,-1,T,C,85711256,83669,85598317,85991533,112939
15,ENSG00000068305.12,99565984,chr15-99514532-A-C,rs11636538,1,A,C,99514532,51452,99369376,99762592,145156
15,ENSG00000138604.4,69160635,chr15-69117301-A-G,rs11636590,1,A,G,69117301,43334,68964027,69357243,153274
15,ENSG00000157823.11,89893994,chr15-89885523-C-T,rs11638138,-1,C,T,89885523,8471,89697386,90090602,188137
15,ENSG00000103811.10,78945046,chr15-78939176-A-G,rs11638844,-1,A,G,78939176,5870,78748438,79141654,190738
15,ENSG00000198690.5,30903915,chr15-30889629-C-T,rs116880342,1,C,T,30889629,14286,30707307,31100523,182322
15,ENSG00000229474.2,44711323,chr15-44670486-C-T,rs117096146,-1,C,T,44670486,40837,44514715,44907931,155771
15,ENSG00000128973.7,68229728,chr15-68055369-A-G,rs117764220,-1,A,G,68055369,174359,68033120,68426336,22249
15,ENSG00000248905.4,33194714,chr15-33029351-G-A,rs117877616,-1,G,A,33029351,165363,32998106,33391322,31245
15,ENSG00000183208.8,90234209,chr15-90325777-T-C,rs11854123,1,T,C,90325777,91568,90037601,90430817,288176
15,ENSG00000104140.6,40874234,chr15-40866390-C-G,rs11856227,-1,C,G,40866390,7844,40677626,41070842,188764
15,ENSG00000140459.11,74367646,chr15-74423833-G-A,rs11856835,-1,G,A,74423833,56187,74171038,74564254,252795
15,ENSG00000166965.8,90954884,chr15-90946475-G-A,rs11857545,1,G,A,90946475,8409,90758276,91151492,188199
15,ENSG00000137834.9,66702236,chr15-66774225-C-T,rs11858577,1,C,T,66774225,71989,66505628,66898844,268597
15,ENSG00000138613.9,63277605,chr15-63278141-T-A,rs11858705,1,T,A,63278141,536,63080997,63474213,197144
15,ENSG00000169032.4,66386912,chr15-66458313-C-T,rs12050736,1,C,T,66458313,71401,66190304,66583520,268009
15,ENSG00000103671.5,64387836,chr15-64234618-A-G,rs12101870,1,A,G,64234618,153218,64191228,64584444,43390
15,ENSG00000140577.10,90529923,chr15-90391576-G-A,rs12437529,1,G,A,90391576,138347,90333315,90726531,58261
15,ENSG00000180979.5,42548793,chr15-42451896-A-G,rs12440118,-1,A,G,42451896,96897,42352185,42745401,99711
15,ENSG00000182117.4,34343136,chr15-34282129-T-C,rs12591967,-1,T,C,34282129,61007,34146528,34539744,135601
15,ENSG00000140280.9,51737655,chr15-51773435-A-G,rs12592771,-1,A,G,51773435,35780,51541047,51934263,232388
15,ENSG00000175265.13,34437808,chr15-34378923-A-C,rs12593958,-1,A,C,34378923,58885,34241200,34634416,137723
15,ENSG00000175265.13,34437808,chr15-34378923-A-T,rs12593958,-1,A,T,34378923,58885,34241200,34634416,137723
15,ENSG00000137770.9,44427629,chr15-44589766-A-G,rs12594905,1,A,G,44589766,162137,44231021,44624237,358745
15,ENSG00000166762.11,43648844,chr15-43801729-T-C,rs12702,-1,T,C,43801729,152885,43452236,43845452,349493
15,ENSG00000067221.9,73992295,chr15-73954581-A-G,rs12899085,-1,A,G,73954581,37714,73795687,74188903,158894
15,ENSG00000140479.12,101489707,chr15-101392873-G-C,rs12903394,-1,G,C,101392873,96834,101293099,101686315,99774
15,ENSG00000140479.12,101489707,chr15-101392873-G-T,rs12903394,-1,G,T,101392873,96834,101293099,101686315,99774
15,ENSG00000167173.13,75201882,chr15-75008916-G-A,rs12906126,1,G,A,75008916,192966,75005274,75398490,3642
15,ENSG00000167173.13,75201882,chr15-75008916-G-T,rs12906126,1,G,T,75008916,192966,75005274,75398490,3642
15,ENSG00000166262.10,49620818,chr15-49715151-A-C,rs12906463,-1,A,C,49715151,94333,49424210,49817426,290941
15,ENSG00000186628.8,82806069,chr15-82825299-T-C,rs12907810,-1,T,C,82825299,19230,82609461,83002677,215838
15,ENSG00000182175.9,93089211,chr15-93204220-T-G,rs12908897,-1,T,G,93204220,115009,92892603,93285819,311617
15,ENSG00000166946.8,43185403,chr15-43265944-A-G,rs12909095,1,A,G,43265944,80541,42988795,43382011,277149
15,ENSG00000166557.8,79311112,chr15-79185840-G-C,rs12917405,1,G,C,79185840,125272,79114504,79507720,71336
15,ENSG00000140374.11,76311469,chr15-76187068-C-A,rs13379729,-1,C,A,76187068,124401,76114861,76508077,72207
15,ENSG00000138617.10,65286883,chr15-65248488-T-C,rs1561889,-1,T,C,65248488,38395,65090275,65483491,158213
15,ENSG00000166035.6,58431991,chr15-58391498-T-C,rs16940167,1,T,C,58391498,40493,58235383,58628599,156115
15,ENSG00000140511.7,88895544,chr15-88861821-C-A,rs16942383,-1,C,A,88861821,33723,88698936,89092152,162885
15,ENSG00000140511.7,88895544,chr15-88861821-C-G,rs16942383,-1,C,G,88861821,33723,88698936,89092152,162885
15,ENSG00000074621.8,65621938,chr15-65638545-A-G,rs16948889,1,A,G,65638545,16607,65425330,65818546,213215
15,ENSG00000166938.8,66293568,chr15-66238394-G-A,rs16949724,1,G,A,66238394,55174,66096960,66490176,141434
15,ENSG00000169018.5,68277745,chr15-68425661-C-T,rs16952059,1,C,T,68425661,147916,68081137,68474353,344524
15,ENSG00000188467.6,48120990,chr15-48075725-C-T,rs16960537,1,C,T,48075725,45265,47924382,48317598,151343
15,ENSG00000140323.4,40358219,chr15-40350676-G-T,rs16970633,1,G,T,40350676,7543,40161611,40554827,189065
15,ENSG00000198794.7,74995563,chr15-75017945-C-T,rs16973530,1,C,T,75017945,22382,74798955,75192171,218990
15,ENSG00000198794.7,74995563,chr15-75017945-C-A,rs16973530,1,C,A,75017945,22382,74798955,75192171,218990
15,ENSG00000140534.9,89575469,chr15-89595695-A-G,rs16974170,1,A,G,89595695,20226,89378861,89772077,216834
15,ENSG00000137857.11,45129994,chr15-45287750-C-T,rs1706824,1,C,T,45287750,157756,44933386,45326602,354364
15,ENSG00000166503.4,83207823,chr15-83181209-C-T,rs17158059,-1,C,T,83181209,26614,83011215,83404431,169994
15,ENSG00000179455.6,23565674,chr15-23733808-A-G,rs1717837,1,A,G,23733808,168134,23369066,23762282,364742
15,ENSG00000166839.11,64911902,chr15-64892293-C-A,rs1719273,1,C,A,64892293,19609,64715294,65108510,176999
15,ENSG00000064726.5,83067252,chr15-83053307-A-G,rs17507300,-1,A,G,83053307,13945,82870644,83263860,182663
15,ENSG00000259494.1,88467388,chr15-88270901-G-A,rs17765281,-1,G,A,88270901,196487,88270780,88663996,121
15,ENSG00000172345.8,81324141,chr15-81293903-T-C,rs17875577,-1,T,C,81293903,30238,81127533,81520749,166370
15,ENSG00000172349.11,81196879,chr15-81293903-T-C,rs17875577,1,T,C,81293903,97024,81000271,81393487,293632
15,ENSG00000182511.7,90884504,chr15-90885725-C-T,rs1894400,1,C,T,90885725,1221,90687896,91081112,197829
15,ENSG00000128739.15,24954987,chr15-24920629-A-G,rs2075814,1,A,G,24920629,34358,24758379,25151595,162250
15,ENSG00000137875.4,52112775,chr15-52109736-A-G,rs2231297,-1,A,G,52109736,3039,51916167,52309383,193569
15,ENSG00000176454.8,34367196,chr15-34357430-G-A,rs2279685,-1,G,A,34357430,9766,34170588,34563804,186842
15,ENSG00000140545.10,88913379,chr15-88899375-C-T,rs2280214,-1,C,T,88899375,14004,88716771,89109987,182604
15,ENSG00000140521.6,89334824,chr15-89220372-G-A,rs2283433,-1,G,A,89220372,114452,89138216,89531432,82156
15,ENSG00000138621.7,75023590,chr15-75018053-T-G,rs2289582,1,T,G,75018053,5537,74826982,75220198,191071
15,ENSG00000138621.7,75023590,chr15-75018053-T-C,rs2289582,1,T,C,75018053,5537,74826982,75220198,191071
15,ENSG00000103932.6,41544257,chr15-41527124-C-T,rs2297380,-1,C,T,41527124,17133,41347649,41740865,179475
15,ENSG00000069956.7,52019219,chr15-52075611-C-T,rs2414127,1,C,T,52075611,56392,51822611,52215827,253000
15,ENSG00000169857.3,34039204,chr15-34039581-G-A,rs2684941,-1,G,A,34039581,377,33842596,34235812,196985
15,ENSG00000171763.13,45402336,chr15-45289297-T-C,rs2687512,1,T,C,45289297,113039,45205728,45598944,83569
15,ENSG00000188089.9,42051190,chr15-42023793-G-A,rs2724938,-1,G,A,42023793,27397,41854582,42247798,169211
15,ENSG00000103978.10,42273433,chr15-42359484-A-C,rs28364363,-1,A,C,42359484,86051,42076825,42470041,282659
15,ENSG00000197299.5,90717346,chr15-90770086-T-C,rs28385043,1,T,C,90770086,52740,90520738,90913954,249348
15,ENSG00000136404.11,83107645,chr15-83050490-T-C,rs28429062,1,T,C,83050490,57155,82911037,83304253,139453
15,ENSG00000137822.8,43371101,chr15-43528225-C-T,rs28438815,1,C,T,43528225,157124,43174493,43567709,353732
15,ENSG00000172575.6,38564814,chr15-38565861-T-C,rs28438860,-1,T,C,38565861,1047,38368206,38761422,197655
15,ENSG00000114062.11,25439024,chr15-25277238-A-G,rs28567889,-1,A,G,25277238,161786,25242416,25635632,34822
15,ENSG00000140350.10,68820895,chr15-68799311-A-T,rs2958407,-1,A,T,68799311,21584,68624287,69017503,175024
15,ENSG00000140471.12,100602184,chr15-100727844-A-G,rs304130,-1,A,G,100727844,125660,100405576,100798792,322268
15,ENSG00000140403.7,78264562,chr15-78270761-A-C,rs3169166,1,A,C,78270761,6199,78067954,78461170,202807
15,ENSG00000169758.8,76059985,chr15-75942616-C-A,rs335719,1,C,A,75942616,117369,75863377,76256593,79239
15,ENSG00000169752.12,76012424,chr15-75943008-C-T,rs335720,-1,C,T,75943008,69416,75815816,76209032,127192
15,ENSG00000182718.11,60397986,chr15-60224546-T-G,rs338420,-1,T,G,60224546,173440,60201378,60594594,23168
15,ENSG00000140368.8,76995126,chr15-77019664-A-G,rs34192860,1,A,G,77019664,24538,76798518,77191734,221146
15,ENSG00000028528.10,64095982,chr15-64127175-G-T,rs34257057,1,G,T,64127175,31193,63899374,64292590,227801
15,ENSG00000183475.8,100602589,chr15-100536916-G-A,rs34734667,1,G,A,100536916,65673,100405981,100799197,130935
15,ENSG00000241839.4,64841915,chr15-64840747-G-T,rs35145019,1,G,T,64840747,1168,64645307,65038523,195440
15,ENSG00000168806.6,43330573,chr15-43330067-C-G,rs3742970,-1,C,G,43330067,506,43133965,43527181,196102
15,ENSG00000168806.6,43330573,chr15-43330067-C-A,rs3742970,-1,C,A,43330067,506,43133965,43527181,196102
15,ENSG00000168803.10,43330672,chr15-43330067-C-G,rs3742970,1,C,G,43330067,605,43134064,43527280,196003
15,ENSG00000168803.10,43330672,chr15-43330067-C-A,rs3742970,1,C,A,43330067,605,43134064,43527280,196003
15,ENSG00000166133.12,40569299,chr15-40458541-A-G,rs3743143,1,A,G,40458541,110758,40372691,40765907,85850
15,ENSG00000136383.6,84817356,chr15-84641323-G-A,rs3748373,1,G,A,84641323,176033,84620748,85013964,20575
15,ENSG00000250021.2,89912882,chr15-89871410-C-G,rs3759831,-1,C,G,89871410,41472,89716274,90109490,155136
15,ENSG00000128886.7,43776966,chr15-43799188-G-A,rs3784275,-1,G,A,43799188,22222,43580358,43973574,218830
15,ENSG00000242028.1,43800599,chr15-43799188-G-A,rs3784275,1,G,A,43799188,1411,43603991,43997207,195197
15,ENSG00000183476.8,78092561,chr15-78127969-T-C,rs3784330,1,T,C,78127969,35408,77895953,78289169,232016
15,ENSG00000136425.8,78131445,chr15-78127969-T-C,rs3784330,-1,T,C,78127969,3476,77934837,78328053,193132
15,ENSG00000137876.5,55196941,chr15-55197214-A-G,rs3809540,-1,A,G,55197214,273,55000333,55393549,196881
15,ENSG00000137876.5,55196941,chr15-55197214-A-C,rs3809540,-1,A,C,55197214,273,55000333,55393549,196881
15,ENSG00000166411.9,78149362,chr15-78171144-G-A,rs3825847,1,G,A,78171144,21782,77952754,78345970,218390
15,ENSG00000178718.5,74956772,chr15-75026141-G-A,rs3850093,-1,G,A,75026141,69369,74760164,75153380,265977
15,ENSG00000140553.11,90935285,chr15-90813274-T-C,rs401549,1,T,C,90813274,122011,90738677,91131893,74597
15,ENSG00000181026.12,88621340,chr15-88710319-T-C,rs4293349,1,T,C,88710319,88979,88424732,88817948,285587
15,ENSG00000172183.10,88639016,chr15-88722088-G-A,rs4534816,1,G,A,88722088,83072,88442408,88835624,279680
15,ENSG00000255529.3,57706714,chr15-57562509-C-G,rs4774963,1,C,G,57562509,144205,57510106,57903322,52403
15,ENSG00000103657.8,63833948,chr15-63850340-T-C,rs4777160,-1,T,C,63850340,16392,63637340,64030556,213000
15,ENSG00000172379.13,80404382,chr15-80356654-C-T,rs4778786,1,C,T,80356654,47728,80207774,80600990,148880
15,ENSG00000185418.10,101724473,chr15-101643133-T-A,rs479913,-1,T,A,101643133,81340,101527865,101921081,115268
15,ENSG00000159556.5,76336773,chr15-76336099-A-G,rs4886490,1,A,G,76336099,674,76140165,76533381,195934
15,ENSG00000167202.6,78077711,chr15-78062588-A-G,rs4886999,-1,A,G,78062588,15123,77881103,78274319,181485
15,ENSG00000137841.7,40307935,chr15-40305028-G-A,rs4924450,-1,G,A,40305028,2907,40111327,40504543,193701
15,ENSG00000166821.4,89690754,chr15-89674066-C-T,rs4932138,-1,C,T,89674066,16688,89494146,89887362,179920
15,ENSG00000182253.10,99105080,chr15-99180229-T-C,rs4965451,1,T,C,99180229,75149,98908472,99301688,271757
15,ENSG00000131871.9,101277485,chr15-101127021-T-C,rs4965789,-1,T,C,101127021,150464,101080877,101474093,46144
15,ENSG00000179335.14,74615836,chr15-74722228-T-C,rs4986879,1,T,C,74722228,106392,74419228,74812444,303000
15,ENSG00000179151.7,74696024,chr15-74722228-T-C,rs4986879,-1,T,C,74722228,26204,74499416,74892632,222812
15,ENSG00000069966.14,52191392,chr15-52180454-T-G,rs55860410,-1,T,G,52180454,10938,51994784,52388000,185670
15,ENSG00000188869.8,81374213,chr15-81224224-A-G,rs55889255,-1,A,G,81224224,149989,81177605,81570821,46619
15,ENSG00000187446.7,41231268,chr15-41135666-C-T,rs561821,1,C,T,41135666,95602,41034660,41427876,101006
15,ENSG00000080644.10,78620996,chr15-78596058-G-A,rs578776,-1,G,A,78596058,24938,78424388,78817604,171670
15,ENSG00000137767.9,45635029,chr15-45643195-C-A,rs594516,1,C,A,45643195,8166,45438421,45831637,204774
15,ENSG00000136371.5,79897014,chr15-79883674-T-C,rs60269787,-1,T,C,79883674,13340,79700406,80093622,183268
15,ENSG00000174442.7,66505326,chr15-66315577-C-T,rs62011715,1,C,T,66315577,189749,66308718,66701934,6859
15,ENSG00000103599.15,67254786,chr15-67263767-C-G,rs62014647,1,C,G,67263767,8981,67058178,67451394,205589
15,ENSG00000067141.11,73052463,chr15-73144739-C-T,rs62016850,1,C,T,73144739,92276,72855855,73249071,288884
15,ENSG00000067141.11,73052463,chr15-73144739-C-A,rs62016850,1,C,A,73144739,92276,72855855,73249071,288884
15,ENSG00000184984.8,33968497,chr15-34064787-G-A,rs643827,1,G,A,34064787,96290,33771889,34165105,292898
15,ENSG00000128928.4,40405795,chr15-40269689-A-C,rs6492939,1,A,C,40269689,136106,40209187,40602403,60502
15,ENSG00000156958.10,49170247,chr15-49351722-C-T,rs6493363,1,C,T,49351722,181475,48973639,49366855,378083
15,ENSG00000140548.5,90001324,chr15-90094960-T-C,rs6496622,1,T,C,90094960,93636,89804716,90197932,290244
15,ENSG00000128891.11,40565042,chr15-40553398-A-G,rs6582,-1,A,G,40553398,11644,40368434,40761650,184964
15,ENSG00000156970.7,40161069,chr15-40102658-G-A,rs675173,1,G,A,40102658,58411,39964461,40357677,138197
15,ENSG00000138594.8,51829653,chr15-51752061-C-T,rs689884,1,C,T,51752061,77592,51633045,52026261,119016
15,ENSG00000196391.6,90352284,chr15-90376934-G-A,rs716175,1,G,A,90376934,24650,90155676,90548892,221258
15,ENSG00000140284.6,50182196,chr15-50234943-C-T,rs7162842,1,C,T,50234943,52747,49985588,50378804,249355
15,ENSG00000103723.8,82709875,chr15-82729563-C-T,rs7163848,-1,C,T,82729563,19688,82513267,82906483,216296
15,ENSG00000184254.10,100879831,chr15-100933463-T-C,rs7165387,1,T,C,100933463,53632,100683223,101076439,250240
15,ENSG00000137812.13,40594249,chr15-40585124-A-G,rs7172947,1,A,G,40585124,9125,40397641,40790857,187483
15,ENSG00000169105.6,40470984,chr15-40433360-T-C,rs7176449,1,T,C,40433360,37624,40274376,40667592,158984
15,ENSG00000074696.7,65530463,chr15-65706364-T-C,rs7176565,1,T,C,65706364,175901,65333855,65727071,372509
15,ENSG00000159459.7,43106038,chr15-42944507-C-A,rs7178732,-1,C,A,42944507,161531,42909430,43302646,35077
15,ENSG00000185043.6,90233941,chr15-90197078-A-G,rs7178860,-1,A,G,90197078,36863,90037333,90430549,159745
15,ENSG00000128923.6,58771302,chr15-58840584-C-T,rs7181998,1,C,T,58840584,69282,58574694,58967910,265890
15,ENSG00000131876.12,101295248,chr15-101111318-C-A,rs72633251,-1,C,A,101111318,183930,101098640,101491856,12678
15,ENSG00000103994.10,42491141,chr15-42480407-T-C,rs72711747,-1,T,C,42480407,10734,42294533,42687749,185874
15,ENSG00000188626.5,28712421,chr15-28833959-C-T,rs72714162,-1,C,T,28833959,121538,28515813,28909029,318146
15,ENSG00000170113.11,22786644,chr15-22964676-T-C,rs7403282,1,T,C,22964676,178032,22590036,22983252,374640
15,ENSG00000166073.4,39920266,chr15-39944364-G-A,rs74501688,-1,G,A,39944364,24098,39723658,40116874,220706
15,ENSG00000166949.10,67065602,chr15-67142737-G-A,rs745103,1,G,A,67142737,77135,66868994,67262210,273743
15,ENSG00000047346.8,52679388,chr15-52811706-T-C,rs7496443,-1,T,C,52811706,132318,52482780,52875996,328926
15,ENSG00000074603.14,65517689,chr15-65385704-G-A,rs75957309,-1,G,A,65385704,131985,65321081,65714297,64623
15,ENSG00000069974.10,55289813,chr15-55217315-C-G,rs76059106,-1,C,G,55217315,72498,55093205,55486421,124110
15,ENSG00000177971.6,75640224,chr15-75552612-C-T,rs76621678,-1,C,T,75552612,87612,75443616,75836832,108996
15,ENSG00000188659.5,82262818,chr15-82151483-C-T,rs78664413,1,C,T,82151483,111335,82066210,82459426,85273
15,ENSG00000167196.9,75903878,chr15-75863252-C-T,rs78890153,1,C,T,75863252,40626,75707270,76100486,155982
15,ENSG00000128833.8,52295804,chr15-52276610-G-A,rs80072979,-1,G,A,52276610,19194,52099196,52492412,177414
15,ENSG00000136378.9,78811464,chr15-78756895-C-T,rs8024939,-1,C,T,78756895,54569,78614856,79008072,142039
15,ENSG00000261652.2,55408495,chr15-55361393-A-G,rs8027135,1,A,G,55361393,47102,55211887,55605103,149506
15,ENSG00000136381.8,78438216,chr15-78325571-T-C,rs8027394,1,T,C,78325571,112645,78241608,78634824,83963
15,ENSG00000157470.7,59438186,chr15-59624708-A-G,rs8028337,1,A,G,59624708,186522,59241578,59634794,383130
15,ENSG00000103852.8,99249581,chr15-99253969-A-G,rs8028374,-1,A,G,99253969,4388,99052973,99446189,200996
15,ENSG00000128849.9,57376505,chr15-57456781-A-G,rs8028787,1,A,G,57456781,80276,57179897,57573113,276884
15,ENSG00000176463.8,91853708,chr15-92024507-G-A,rs8029024,1,G,A,92024507,170799,91657100,92050316,367407
15,ENSG00000184716.9,43800220,chr15-43721311-G-C,rs8033995,-1,G,C,43721311,78909,43603612,43996828,117699
15,ENSG00000140264.14,43792320,chr15-43721311-G-C,rs8033995,1,G,C,43721311,71009,43595712,43988928,125599
15,ENSG00000166823.5,89751249,chr15-89784576-A-G,rs8035089,-1,A,G,89784576,33327,89554641,89947857,229935
15,ENSG00000169609.8,83011639,chr15-82994253-A-G,rs8043020,-1,A,G,82994253,17386,82815031,83208247,179222
15,ENSG00000140451.8,64825647,chr15-64858638-G-A,rs832882,-1,G,A,64858638,32991,64629039,65022255,229599
15,ENSG00000169330.4,79432336,chr15-79388407-G-A,rs9920077,1,G,A,79388407,43929,79235728,79628944,152679
15,ENSG00000129028.4,70892433,chr15-71074673-C-T,rs10438292,-1,C,T,71074673,182240,70695825,71089041,378848
15,ENSG00000183208.8,90234209,chr15-90273107-C-T,rs1059495,1,C,T,90273107,38898,90037601,90430817,235506
15,ENSG00000067221.9,73992295,chr15-74179858-C-T,rs10910,-1,C,T,74179858,187563,73795687,74188903,384171
15,ENSG00000069869.11,55993612,chr15-56095733-C-T,rs11071247,-1,C,T,56095733,102121,55797004,56190220,298729
15,ENSG00000137831.9,70763558,chr15-70632953-A-G,rs11072211,-1,A,G,70632953,130605,70566950,70960166,66003
15,ENSG00000196547.9,90903302,chr15-90810354-C-T,rs11073953,1,C,T,90810354,92948,90706694,91099910,103660
15,ENSG00000140534.9,89575469,chr15-89646817-A-G,rs1110060,1,A,G,89646817,71348,89378861,89772077,267956
15,ENSG00000166839.11,64911902,chr15-65021558-C-T,rs111388106,1,C,T,65021558,109656,64715294,65108510,306264
15,ENSG00000074696.7,65530463,chr15-65579360-G-T,rs11484,1,G,T,65579360,48897,65333855,65727071,245505
15,ENSG00000103740.5,78234565,chr15-78214974-G-A,rs11629576,-1,G,A,78214974,19591,78037957,78431173,177017
15,ENSG00000136379.7,80695310,chr15-80753784-A-G,rs11633987,1,A,G,80753784,58474,80498702,80891918,255082
15,ENSG00000169371.9,75625725,chr15-75626854-G-A,rs11634828,-1,G,A,75626854,1129,75429117,75822333,197737
15,ENSG00000136381.8,78438216,chr15-78299935-C-T,rs11635324,1,C,T,78299935,138281,78241608,78634824,58327
15,ENSG00000140391.9,77071109,chr15-77043549-C-T,rs11636648,-1,C,T,77043549,27560,76874501,77267717,169048
15,ENSG00000178718.5,74956772,chr15-74973708-G-C,rs11636892,-1,G,C,74973708,16936,74760164,75153380,213544
15,ENSG00000172349.11,81196879,chr15-81275632-A-C,rs11637363,1,A,C,81275632,78753,81000271,81393487,275361
15,ENSG00000136404.11,83107645,chr15-83158544-T-C,rs116957980,1,T,C,83158544,50899,82911037,83304253,247507
15,ENSG00000092439.8,50686797,chr15-50682811-T-C,rs117035204,-1,T,C,50682811,3986,50490189,50883405,192622
15,ENSG00000255529.3,57706714,chr15-57823447-G-A,rs117293196,1,G,A,57823447,116733,57510106,57903322,313341
15,ENSG00000166819.7,89679367,chr15-89605263-A-G,rs117485236,-1,A,G,89605263,74104,89482759,89875975,122504
15,ENSG00000182511.7,90884504,chr15-90725917-A-G,rs11858756,1,A,G,90725917,158587,90687896,91081112,38021
15,ENSG00000137877.8,41894053,chr15-41853738-G-C,rs1197660,-1,G,C,41853738,40315,41697445,42090661,156293
15,ENSG00000103811.10,78945046,chr15-78939136-T-C,rs12148472,-1,T,C,78939136,5910,78748438,79141654,190698
15,ENSG00000140511.7,88895544,chr15-89082675-G-A,rs12324723,-1,G,A,89082675,187131,88698936,89092152,383739
15,ENSG00000183476.8,78092561,chr15-78115151-T-C,rs12440984,1,T,C,78115151,22590,77895953,78289169,219198
15,ENSG00000136425.8,78131445,chr15-78115151-T-C,rs12440984,-1,T,C,78115151,16294,77934837,78328053,180314
15,ENSG00000156232.5,82809628,chr15-82853993-C-T,rs12442119,1,C,T,82853993,44365,82613020,83006236,240973
15,ENSG00000182253.10,99105080,chr15-99166034-T-C,rs12442235,1,T,C,99166034,60954,98908472,99301688,257562
15,ENSG00000159556.5,76336773,chr15-76408460-C-A,rs12591100,1,C,A,76408460,71687,76140165,76533381,268295
15,ENSG00000140416.14,63042747,chr15-63029995-C-G,rs12593321,1,C,G,63029995,12752,62846139,63239355,183856
15,ENSG00000137834.9,66702236,chr15-66602953-C-T,rs12595240,1,C,T,66602953,99283,66505628,66898844,97325
15,ENSG00000140284.6,50182196,chr15-50356743-C-T,rs12903381,1,C,T,50356743,174547,49985588,50378804,371155
15,ENSG00000182718.11,60397986,chr15-60397796-G-T,rs12904906,-1,G,T,60397796,190,60201378,60594594,196418
15,ENSG00000186628.8,82806069,chr15-82799903-C-A,rs12910606,-1,C,A,82799903,6166,82609461,83002677,190442
15,ENSG00000186628.8,82806069,chr15-82799903-C-T,rs12910606,-1,C,T,82799903,6166,82609461,83002677,190442
15,ENSG00000140157.10,22838666,chr15-22882723-A-C,rs12913456,1,A,C,22882723,44057,22642058,23035274,240665
15,ENSG00000140479.12,101489707,chr15-101390413-T-C,rs12917106,-1,T,C,101390413,99294,101293099,101686315,97314
15,ENSG00000176454.8,34367196,chr15-34366218-G-T,rs1390425,-1,G,T,34366218,978,34170588,34563804,195630
15,ENSG00000185880.8,44736528,chr15-44670026-C-T,rs146795158,1,C,T,44670026,66502,44539920,44933136,130106
15,ENSG00000168781.14,43590208,chr15-43527252-A-G,rs147141458,-1,A,G,43527252,62956,43393600,43786816,133652
15,ENSG00000166823.5,89751249,chr15-89773018-G-C,rs16943576,-1,G,C,89773018,21769,89554641,89947857,218377
15,ENSG00000069966.14,52191392,chr15-52204736-C-T,rs16964764,-1,C,T,52204736,13344,51994784,52388000,209952
15,ENSG00000171766.10,45378544,chr15-45221952-C-A,rs1706829,-1,C,A,45221952,156592,45181936,45575152,40016
15,ENSG00000154237.7,100919357,chr15-101066089-C-T,rs17161161,1,C,T,101066089,146732,100722749,101115965,343340
15,ENSG00000140368.8,76995126,chr15-77083841-C-A,rs17466257,1,C,A,77083841,88715,76798518,77191734,285323
15,ENSG00000166503.4,83207823,chr15-83053307-A-G,rs17507300,-1,A,G,83053307,154516,83011215,83404431,42092
15,ENSG00000137806.4,41402496,chr15-41491616-A-G,rs1757463,-1,A,G,41491616,89120,41205888,41599104,285728
15,ENSG00000172345.8,81324141,chr15-81311952-A-T,rs17875563,-1,A,T,81311952,12189,81127533,81520749,184419
15,ENSG00000103995.8,48811069,chr15-48750722-A-G,rs1841968,-1,A,G,48750722,60347,48614461,49007677,136261
15,ENSG00000166821.4,89690754,chr15-89530925-G-T,rs1972873,-1,G,T,89530925,159829,89494146,89887362,36779
15,ENSG00000136378.9,78811464,chr15-78740932-A-C,rs2017296,-1,A,C,78740932,70532,78614856,79008072,126076
15,ENSG00000259330.1,40323692,chr15-40330740-A-G,rs2118960,1,A,G,40330740,7048,40127084,40520300,203656
15,ENSG00000137841.7,40307935,chr15-40297933-G-A,rs2229690,-1,G,A,40297933,10002,40111327,40504543,186606
15,ENSG00000183655.10,85794925,chr15-85734837-C-T,rs2241266,-1,C,T,85734837,60088,85598317,85991533,136520
15,ENSG00000140403.7,78264562,chr15-78292764-C-T,rs2280364,1,C,T,78292764,28202,78067954,78461170,224810
15,ENSG00000140323.4,40358219,chr15-40412960-T-C,rs2289329,1,T,C,40412960,54741,40161611,40554827,251349
15,ENSG00000103852.8,99249581,chr15-99386235-T-C,rs2289558,-1,T,C,99386235,136654,99052973,99446189,333262
15,ENSG00000104142.6,40894450,chr15-40767189-T-C,rs2301176,1,T,C,40767189,127261,40697842,41091058,69347
15,ENSG00000140474.7,74843156,chr15-74850420-T-G,rs2305668,-1,T,G,74850420,7264,74646548,75039764,203872
15,ENSG00000184984.8,33968497,chr15-33950279-C-T,rs2339349,1,C,T,33950279,18218,33771889,34165105,178390
15,ENSG00000140374.11,76311469,chr15-76181919-T-G,rs2469560,-1,T,G,76181919,129550,76114861,76508077,67058
15,ENSG00000169752.12,76012424,chr15-75940641-C-T,rs2648437,-1,C,T,75940641,71783,75815816,76209032,124825
15,ENSG00000140598.9,82262734,chr15-82099415-A-G,rs2665121,-1,A,G,82099415,163319,82066126,82459342,33289
15,ENSG00000137767.9,45635029,chr15-45659353-A-G,rs2733250,1,A,G,45659353,24324,45438421,45831637,220932
15,ENSG00000103978.10,42273433,chr15-42406093-C-T,rs28364510,-1,C,T,42406093,132660,42076825,42470041,329268
15,ENSG00000185088.8,63157477,chr15-63156806-G-A,rs28377261,-1,G,A,63156806,671,62960869,63354085,195937
15,ENSG00000137875.4,52112775,chr15-52155317-G-A,rs28437132,-1,G,A,52155317,42542,51916167,52309383,239150
15,ENSG00000186073.7,36579626,chr15-36491612-C-T,rs28483239,1,C,T,36491612,88014,36383018,36776234,108594
15,ENSG00000185442.6,92655775,chr15-92635945-T-C,rs285757,-1,T,C,92635945,19830,92459167,92852383,176778
15,ENSG00000137842.2,43133586,chr15-43046953-C-A,rs28605464,1,C,A,43046953,86633,42936978,43330194,109975
15,ENSG00000166946.8,43185403,chr15-43220406-G-A,rs28723492,1,G,A,43220406,35003,42988795,43382011,231611
15,ENSG00000185043.6,90233941,chr15-90149821-A-G,rs2970353,-1,A,G,90149821,84120,90037333,90430549,112488
15,ENSG00000140471.12,100602184,chr15-100723964-G-C,rs304125,-1,G,C,100723964,121780,100405576,100798792,318388
15,ENSG00000103769.5,65869491,chr15-65913256-G-A,rs333542,1,G,A,65913256,43765,65672883,66066099,240373
15,ENSG00000156970.7,40161069,chr15-40258459-T-G,rs34071118,1,T,G,40258459,97390,39964461,40357677,293998
15,ENSG00000156970.7,40161069,chr15-40258459-T-A,rs34071118,1,T,A,40258459,97390,39964461,40357677,293998
15,ENSG00000246922.4,65115200,chr15-64943580-A-G,rs34988193,-1,A,G,64943580,171620,64918592,65311808,24988
15,ENSG00000090487.6,64989914,chr15-65023397-T-G,rs35328312,-1,T,G,65023397,33483,64793306,65186522,230091
15,ENSG00000140563.10,94231561,chr15-94325538-C-T,rs35920993,1,C,T,94325538,93977,94034953,94428169,290585
15,ENSG00000068305.12,99565984,chr15-99712498-G-A,rs3730059,1,G,A,99712498,146514,99369376,99762592,343122
15,ENSG00000261652.2,55408495,chr15-55498332-C-T,rs3743205,1,C,T,55498332,89837,55211887,55605103,286445
15,ENSG00000183578.5,51094906,chr15-51083632-T-C,rs3803369,-1,T,C,51083632,11274,50898298,51291514,185334
15,ENSG00000103723.8,82709875,chr15-82831014-G-A,rs3814281,-1,G,A,82831014,121139,82513267,82906483,317747
15,ENSG00000092531.5,42495634,chr15-42558182-A-G,rs3986280,1,A,G,42558182,62548,42299026,42692242,259156
15,ENSG00000138615.4,65211473,chr15-65300413-A-G,rs4315292,-1,A,G,65300413,88940,65014865,65408081,285548
15,ENSG00000185115.4,29269822,chr15-29298675-G-A,rs4436748,-1,G,A,29298675,28853,29073214,29466430,225461
15,ENSG00000169684.9,78565520,chr15-78395583-C-T,rs4516196,1,C,T,78395583,169937,78368912,78762128,26671
15,ENSG00000188266.9,78507577,chr15-78395583-C-T,rs4516196,1,C,T,78395583,111994,78310969,78704185,84614
15,ENSG00000128833.8,52295804,chr15-52489059-A-G,rs4774625,-1,A,G,52489059,193255,52099196,52492412,389863
15,ENSG00000137876.5,55196941,chr15-55142155-T-G,rs4774747,-1,T,G,55142155,54786,55000333,55393549,141822
15,ENSG00000166938.8,66293568,chr15-66280354-A-G,rs4776774,1,A,G,66280354,13214,66096960,66490176,183394
15,ENSG00000140459.11,74367646,chr15-74370924-C-A,rs4886595,-1,C,A,74370924,3278,74171038,74564254,199886
15,ENSG00000174197.12,41660405,chr15-41617595-A-T,rs4924564,1,A,T,41617595,42810,41463797,41857013,153798
15,ENSG00000182768.7,90265672,chr15-90309095-G-C,rs4932320,1,G,C,90309095,43423,90069064,90462280,240031
15,ENSG00000140545.10,88913379,chr15-88908973-G-A,rs4932450,-1,G,A,88908973,4406,88716771,89109987,192202
15,ENSG00000136383.6,84817356,chr15-84914744-C-T,rs4980346,1,C,T,84914744,97388,84620748,85013964,293996
15,ENSG00000168806.6,43330573,chr15-43328245-T-C,rs514438,-1,T,C,43328245,2328,43133965,43527181,194280
15,ENSG00000159289.6,74082550,chr15-73994588-C-T,rs5742914,-1,C,T,73994588,87962,73885942,74279158,108646
15,ENSG00000167202.6,78077711,chr15-78044961-C-T,rs61732053,-1,C,T,78044961,32750,77881103,78274319,163858
15,ENSG00000134160.8,31101725,chr15-31131902-A-C,rs62038949,-1,A,C,31131902,30177,30905117,31298333,226785
15,ENSG00000137770.9,44427629,chr15-44283283-G-A,rs6493103,1,G,A,44283283,144346,44231021,44624237,52262
15,ENSG00000136371.5,79897014,chr15-79862640-C-T,rs6495446,-1,C,T,79862640,34374,79700406,80093622,162234
15,ENSG00000103657.8,63833948,chr15-63890192-A-G,rs7164126,-1,A,G,63890192,56244,63637340,64030556,252852
15,ENSG00000177971.6,75640224,chr15-75635851-T-G,rs7166281,-1,T,G,75635851,4373,75443616,75836832,192235
15,ENSG00000128872.5,51751597,chr15-51725899-A-C,rs7174616,1,A,C,51725899,25698,51554989,51948205,170910
15,ENSG00000188467.6,48120990,chr15-48301054-T-G,rs7174935,1,T,G,48301054,180064,47924382,48317598,376672
15,ENSG00000140548.5,90001324,chr15-90089728-C-T,rs7177558,1,C,T,90089728,88404,89804716,90197932,285012
15,ENSG00000259332.2,79923744,chr15-79865700-A-C,rs7177659,-1,A,C,79865700,58044,79727136,80120352,138564
15,ENSG00000140463.9,72686207,chr15-72819376-T-C,rs7178889,1,T,C,72819376,133169,72489599,72882815,329777
15,ENSG00000104067.11,29822468,chr15-29738128-T-C,rs7183108,-1,T,C,29738128,84340,29625860,30019076,112268
15,ENSG00000167178.10,74130586,chr15-73959174-C-T,rs72745376,1,C,T,73959174,171412,73933978,74327194,25196
15,ENSG00000188095.3,89776332,chr15-89725389-A-G,rs72754531,1,A,G,89725389,50943,89579724,89972940,145665
15,ENSG00000184508.6,90932549,chr15-90976616-C-T,rs72759311,-1,C,T,90976616,44067,90735941,91129157,240675
15,ENSG00000103591.8,67254661,chr15-67121499-G-A,rs7359174,-1,G,A,67121499,133162,67058053,67451269,63446
15,ENSG00000104055.10,43266928,chr15-43267033-T-C,rs748404,-1,T,C,43267033,105,43070320,43463536,196713
15,ENSG00000138617.10,65286883,chr15-65234463-A-C,rs755115,-1,A,C,65234463,52420,65090275,65483491,144188
15,ENSG00000170236.10,50546666,chr15-50418631-C-G,rs75830155,-1,C,G,50418631,128035,50350058,50743274,68573
15,ENSG00000103742.6,65422947,chr15-65385704-G-A,rs75957309,-1,G,A,65385704,37243,65226339,65619555,159365
15,ENSG00000069667.11,61229302,chr15-61070315-A-G,rs76435117,-1,A,G,61070315,158987,61032694,61425910,37621
15,ENSG00000128917.5,40929340,chr15-40979859-G-A,rs76495904,1,G,A,40979859,50519,40732732,41125948,247127
15,ENSG00000167196.9,75903878,chr15-76017267-C-T,rs76614553,1,C,T,76017267,113389,75707270,76100486,309997
15,ENSG00000138621.7,75023590,chr15-75012413-C-T,rs78434425,1,C,T,75012413,11177,74826982,75220198,185431
15,ENSG00000188659.5,82262818,chr15-82114009-C-T,rs79764646,1,C,T,82114009,148809,82066210,82459426,47799
15,ENSG00000181991.11,88467708,chr15-88481368-A-C,rs8023760,1,A,C,88481368,13660,88271100,88664316,210268
15,ENSG00000184277.8,101652381,chr15-101505374-T-C,rs8033723,-1,T,C,101505374,147007,101455773,101848989,49601
15,ENSG00000184254.10,100879831,chr15-100828306-G-A,rs8033826,1,G,A,100828306,51525,100683223,101076439,145083
15,ENSG00000172575.6,38564814,chr15-38591164-A-G,rs8036582,-1,A,G,38591164,26350,38368206,38761422,222958
15,ENSG00000169330.4,79432336,chr15-79321882-A-G,rs8037898,1,A,G,79321882,110454,79235728,79628944,86154
15,ENSG00000174442.7,66505326,chr15-66678422-G-A,rs8037955,1,G,A,66678422,173096,66308718,66701934,369704
15,ENSG00000159433.7,42575606,chr15-42694939-C-A,rs8039217,1,C,A,42694939,119333,42378998,42772214,315941
15,ENSG00000140464.14,73994716,chr15-74041697-T-C,rs893814,1,T,C,74041697,46981,73798108,74191324,243589
15,ENSG00000140443.9,98648539,chr15-98717374-A-G,rs907813,1,A,G,98717374,68835,98451931,98845147,265443
15,ENSG00000178802.12,74890042,chr15-74839618-A-G,rs936227,1,A,G,74839618,50424,74693434,75086650,146184
15,ENSG00000197361.4,63597387,chr15-63524203-T-C,rs9672511,1,T,C,63524203,73184,63400779,63793995,123424
15,ENSG00000140497.11,74873365,chr15-74698995-G-A,rs9672559,-1,G,A,74698995,174370,74676757,75069973,22238
15,ENSG00000171763.13,45402336,chr15-45448014-T-C,rs9806724,1,T,C,45448014,45678,45205728,45598944,242286
15,ENSG00000128891.11,40565042,chr15-40456519-C-T,rs9972363,-1,C,T,40456519,108523,40368434,40761650,88085
15,ENSG00000176463.8,91853708,chr15-91664955-T-C,rs10048007,1,T,C,91664955,188753,91657100,92050316,7855
15,ENSG00000103599.15,67254786,chr15-67338574-G-C,rs10163085,1,G,C,67338574,83788,67058178,67451394,280396
15,ENSG00000170776.14,85380603,chr15-85441932-T-G,rs10220820,1,T,G,85441932,61329,85183995,85577211,257937
15,ENSG00000140575.8,90388242,chr15-90407126-C-T,rs10520689,1,C,T,90407126,18884,90191634,90584850,215492
15,ENSG00000173575.10,92900324,chr15-92973681-C-G,rs10520717,1,C,G,92973681,73357,92703716,93096932,269965
15,ENSG00000104140.6,40874234,chr15-40911538-G-A,rs1077918,-1,G,A,40911538,37304,40677626,41070842,233912
15,ENSG00000069966.14,52191392,chr15-52209659-A-G,rs11070885,-1,A,G,52209659,18267,51994784,52388000,214875
15,ENSG00000140451.8,64825647,chr15-65021558-C-T,rs111388106,-1,C,T,65021558,195911,64629039,65022255,392519
15,ENSG00000140263.9,45023195,chr15-44916471-G-A,rs111769507,1,G,A,44916471,106724,44826587,45219803,89884
15,ENSG00000166965.8,90954884,chr15-91017831-G-T,rs11542638,1,G,T,91017831,62947,90758276,91151492,259555
15,ENSG00000137880.4,40764068,chr15-40754685-C-A,rs11558807,1,C,A,40754685,9383,40567460,40960676,187225
15,ENSG00000140534.9,89575469,chr15-89555523-C-G,rs11629542,1,C,G,89555523,19946,89378861,89772077,176662
15,ENSG00000172345.8,81324141,chr15-81275632-A-C,rs11637363,-1,A,C,81275632,48509,81127533,81520749,148099
15,ENSG00000137767.9,45635029,chr15-45654433-T-C,rs11637833,1,T,C,45654433,19404,45438421,45831637,216012
15,ENSG00000169371.9,75625725,chr15-75506965-G-A,rs11638974,-1,G,A,75506965,118760,75429117,75822333,77848
15,ENSG00000140598.9,82262734,chr15-82143988-G-A,rs117120364,-1,G,A,82143988,118746,82066126,82459342,77862
15,ENSG00000188779.6,67825509,chr15-67938195-G-A,rs117397768,1,G,A,67938195,112686,67628901,68022117,309294
15,ENSG00000064726.5,83067252,chr15-83082668-A-C,rs11855722,-1,A,C,83082668,15416,82870644,83263860,212024
15,ENSG00000064726.5,83067252,chr15-83082668-A-T,rs11855722,-1,A,T,83082668,15416,82870644,83263860,212024
15,ENSG00000156232.5,82809628,chr15-82627794-A-T,rs11855735,1,A,T,82627794,181834,82613020,83006236,14774
15,ENSG00000166821.4,89690754,chr15-89530308-C-T,rs11857014,-1,C,T,89530308,160446,89494146,89887362,36162
15,ENSG00000198838.6,33310967,chr15-33414389-A-G,rs11858356,1,A,G,33414389,103422,33114359,33507575,300030
15,ENSG00000166035.6,58431991,chr15-58522863-C-T,rs12324536,1,C,T,58522863,90872,58235383,58628599,287480
15,ENSG00000166035.6,58431991,chr15-58522863-C-A,rs12324536,1,C,A,58522863,90872,58235383,58628599,287480
15,ENSG00000166825.9,89814852,chr15-89822800-C-T,rs12440213,-1,C,T,89822800,7948,89618244,90011460,204556
15,ENSG00000140471.12,100602184,chr15-100584624-C-T,rs12441485,-1,C,T,100584624,17560,100405576,100798792,179048
15,ENSG00000137764.14,67542703,chr15-67568249-G-A,rs12441715,1,G,A,67568249,25546,67346095,67739311,222154
15,ENSG00000140563.10,94231561,chr15-94047915-A-G,rs12443435,1,A,G,94047915,183646,94034953,94428169,12962
15,ENSG00000137842.2,43133586,chr15-43148458-G-A,rs12594277,1,G,A,43148458,14872,42936978,43330194,211480
15,ENSG00000104131.8,44537147,chr15-44576792-T-C,rs12595838,1,T,C,44576792,39645,44340539,44733755,236253
15,ENSG00000181827.10,56243879,chr15-56361927-G-C,rs12905782,-1,G,C,56361927,118048,56047271,56440487,314656
15,ENSG00000136381.8,78438216,chr15-78336614-T-C,rs12913251,1,T,C,78336614,101602,78241608,78634824,95006
15,ENSG00000166133.12,40569299,chr15-40437201-A-G,rs1453184,1,A,G,40437201,132098,40372691,40765907,64510
15,ENSG00000241839.4,64841915,chr15-64895658-A-C,rs1522745,1,A,C,64895658,53743,64645307,65038523,250351
15,ENSG00000166411.9,78149362,chr15-78120674-A-G,rs1542101,1,A,G,78120674,28688,77952754,78345970,167920
15,ENSG00000136425.8,78131445,chr15-78205251-T-C,rs1554377,-1,T,C,78205251,73806,77934837,78328053,270414
15,ENSG00000140511.7,88895544,chr15-88840623-C-A,rs16942324,-1,C,A,88840623,54921,88698936,89092152,141687
15,ENSG00000137831.9,70763558,chr15-70780903-T-C,rs16954853,-1,T,C,70780903,17345,70566950,70960166,213953
15,ENSG00000067369.8,43493156,chr15-43507675-A-G,rs16957793,-1,A,G,43507675,14519,43296548,43689764,211127
15,ENSG00000198146.4,34988287,chr15-34864781-A-G,rs16959966,-1,A,G,34864781,123506,34791679,35184895,73102
15,ENSG00000137877.8,41894053,chr15-41918821-T-C,rs1704395,-1,T,C,41918821,24768,41697445,42090661,221376
15,ENSG00000171763.13,45402336,chr15-45326036-G-A,rs1706799,1,G,A,45326036,76300,45205728,45598944,120308
15,ENSG00000259494.1,88467388,chr15-88277808-T-C,rs17184851,-1,T,C,88277808,189580,88270780,88663996,7028
15,ENSG00000140391.9,77071109,chr15-77098528-A-G,rs17466480,-1,A,G,77098528,27419,76874501,77267717,224027
15,ENSG00000103723.8,82709875,chr15-82558175-G-A,rs17507216,-1,G,A,82558175,151700,82513267,82906483,44908
15,ENSG00000138600.5,50765706,chr15-50608409-G-C,rs17520378,-1,G,C,50608409,157297,50569098,50962314,39311
15,ENSG00000183476.8,78092561,chr15-78169115-A-G,rs17674205,1,A,G,78169115,76554,77895953,78289169,273162
15,ENSG00000128833.8,52295804,chr15-52412181-A-G,rs17707717,-1,A,G,52412181,116377,52099196,52492412,312985
15,ENSG00000197535.9,52528880,chr15-52510881-C-T,rs17708103,-1,C,T,52510881,17999,52332272,52725488,178609
15,ENSG00000159433.7,42575606,chr15-42417979-G-A,rs17708630,1,G,A,42417979,157627,42378998,42772214,38981
15,ENSG00000159433.7,42575606,chr15-42417979-G-C,rs17708630,1,G,C,42417979,157627,42378998,42772214,38981
15,ENSG00000172349.11,81196879,chr15-81297107-G-A,rs17875502,1,G,A,81297107,100228,81000271,81393487,296836
15,ENSG00000185418.10,101724473,chr15-101693057-G-A,rs1908160,-1,G,A,101693057,31416,101527865,101921081,165192
15,ENSG00000131871.9,101277485,chr15-101148500-C-T,rs2045161,-1,C,T,101148500,128985,101080877,101474093,67623
15,ENSG00000140284.6,50182196,chr15-50183225-C-T,rs2052759,1,C,T,50183225,1029,49985588,50378804,197637
15,ENSG00000166839.11,64911902,chr15-64917681-A-C,rs2056497,1,A,C,64917681,5779,64715294,65108510,202387
15,ENSG00000169612.3,82986210,chr15-82995189-T-C,rs2123157,1,T,C,82995189,8979,82789602,83182818,205587
15,ENSG00000166813.10,89655467,chr15-89521408-C-G,rs2218128,-1,C,G,89521408,134059,89458859,89852075,62549
15,ENSG00000166912.11,30991628,chr15-31076469-G-T,rs2241495,-1,G,T,31076469,84841,30795020,31188236,281449
15,ENSG00000174444.9,66504855,chr15-66586562-A-G,rs2245586,-1,A,G,66586562,81707,66308247,66701463,278315
15,ENSG00000069943.5,55319222,chr15-55327598-T-C,rs2290344,1,T,C,55327598,8376,55122614,55515830,204984
15,ENSG00000137857.11,45129994,chr15-45174894-A-G,rs2292468,1,A,G,45174894,44900,44933386,45326602,241508
15,ENSG00000033800.9,68054315,chr15-67890832-G-A,rs2448137,1,G,A,67890832,163483,67857707,68250923,33125
15,ENSG00000198901.9,90994535,chr15-91110805-A-G,rs2520605,-1,A,G,91110805,116270,90797927,91191143,312878
15,ENSG00000104112.4,51681503,chr15-51699864-C-T,rs2607118,1,C,T,51699864,18361,51484895,51878111,214969
15,ENSG00000136371.5,79897014,chr15-79846229-C-T,rs2733103,-1,C,T,79846229,50785,79700406,80093622,145823
15,ENSG00000136371.5,79897014,chr15-79846229-C-G,rs2733103,-1,C,G,79846229,50785,79700406,80093622,145823
15,ENSG00000166887.11,42208304,chr15-42395065-G-A,rs28364458,-1,G,A,42395065,186761,42011696,42404912,383369
15,ENSG00000140553.11,90935285,chr15-90770086-T-C,rs28385043,1,T,C,90770086,165199,90738677,91131893,31409
15,ENSG00000182950.2,75724041,chr15-75646738-C-T,rs28454227,1,C,T,75646738,77303,75527433,75920649,119305
15,ENSG00000168803.10,43330672,chr15-43296690-C-A,rs28594657,1,C,A,43296690,33982,43134064,43527280,162626
15,ENSG00000166949.10,67065602,chr15-66956959-A-G,rs2899721,1,A,G,66956959,108643,66868994,67262210,87965
15,ENSG00000140264.14,43792320,chr15-43966699-C-T,rs2929275,1,C,T,43966699,174379,43595712,43988928,370987
15,ENSG00000180979.5,42548793,chr15-42406353-A-G,rs3115881,-1,A,G,42406353,142440,42352185,42745401,54168
15,ENSG00000140545.10,88913379,chr15-88912537-C-G,rs34239095,-1,C,G,88912537,842,88716771,89109987,195766
15,ENSG00000128463.7,34225016,chr15-34350108-C-G,rs347797,1,C,G,34350108,125092,34028408,34421624,321700
15,ENSG00000128463.7,34225016,chr15-34350108-C-T,rs347797,1,C,T,34350108,125092,34028408,34421624,321700
15,ENSG00000104081.9,40108879,chr15-40254996-G-A,rs34855281,-1,G,A,40254996,146117,39912271,40305487,342725
15,ENSG00000170113.11,22786644,chr15-22752734-T-C,rs35698504,1,T,C,22752734,33910,22590036,22983252,162698
15,ENSG00000166947.6,43221018,chr15-43081731-T-C,rs35900502,-1,T,C,43081731,139287,43024410,43417626,57321
15,ENSG00000183578.5,51094906,chr15-51002798-G-A,rs3743045,-1,G,A,51002798,92108,50898298,51291514,104500
15,ENSG00000183578.5,51094906,chr15-51002798-G-T,rs3743045,-1,G,T,51002798,92108,50898298,51291514,104500
15,ENSG00000188095.3,89776332,chr15-89749380-A-C,rs3743115,1,A,C,89749380,26952,89579724,89972940,169656
15,ENSG00000183655.10,85794925,chr15-85717469-C-T,rs3765096,-1,C,T,85717469,77456,85598317,85991533,119152
15,ENSG00000166797.6,64093838,chr15-64115182-C-T,rs3784382,-1,C,T,64115182,21344,63897230,64290446,217952
15,ENSG00000092439.8,50686797,chr15-50500677-G-A,rs3803373,-1,G,A,50500677,186120,50490189,50883405,10488
15,ENSG00000171989.4,59206843,chr15-59208378-T-C,rs3816814,1,T,C,59208378,1535,59010235,59403451,198143
15,ENSG00000140265.8,43371043,chr15-43523801-C-T,rs3862138,-1,C,T,43523801,152758,43174435,43567651,349366
15,ENSG00000138615.4,65211473,chr15-65070697-C-A,rs4238400,-1,C,A,65070697,140776,65014865,65408081,55832
15,ENSG00000167004.7,43746438,chr15-43932470-A-G,rs4270152,1,A,G,43932470,186032,43549830,43943046,382640
15,ENSG00000196547.9,90903302,chr15-90822992-G-A,rs441399,1,G,A,90822992,80310,90706694,91099910,116298
15,ENSG00000184254.10,100879831,chr15-100900850-T-C,rs4646675,1,T,C,100900850,21019,100683223,101076439,217627
15,ENSG00000069869.11,55993612,chr15-55917970-G-A,rs4774833,-1,G,A,55917970,75642,55797004,56190220,120966
15,ENSG00000185088.8,63157477,chr15-63019781-T-C,rs4775601,-1,T,C,63019781,137696,62960869,63354085,58912
15,ENSG00000188659.5,82262818,chr15-82245013-A-C,rs4778672,1,A,C,82245013,17805,82066210,82459426,178803
15,ENSG00000167202.6,78077711,chr15-78052580-G-A,rs4886554,-1,G,A,78052580,25131,77881103,78274319,171477
15,ENSG00000156218.8,83654123,chr15-83824899-T-C,rs5015595,1,T,C,83824899,170776,83457515,83850731,367384
15,ENSG00000185043.6,90233941,chr15-90189710-G-T,rs55662939,-1,G,T,90189710,44231,90037333,90430549,152377
15,ENSG00000140374.11,76311469,chr15-76310823-A-G,rs56372945,-1,A,G,76310823,646,76114861,76508077,195962
15,ENSG00000103932.6,41544257,chr15-41420738-C-A,rs62001419,-1,C,A,41420738,123519,41347649,41740865,73089
15,ENSG00000073417.10,84981856,chr15-84971348-A-G,rs62022524,1,A,G,84971348,10508,84785248,85178464,186100
15,ENSG00000156970.7,40161069,chr15-40039001-C-T,rs62621371,1,C,T,40039001,122068,39964461,40357677,74540
15,ENSG00000140323.4,40358219,chr15-40269689-A-C,rs6492939,1,A,C,40269689,88530,40161611,40554827,108078
15,ENSG00000157450.11,58987663,chr15-58846907-G-A,rs6494041,1,G,A,58846907,140756,58791055,59184271,55852
15,ENSG00000075131.5,66356685,chr15-66308291-C-T,rs6494562,-1,C,T,66308291,48394,66160077,66553293,148214
15,ENSG00000103888.10,80779370,chr15-80882203-G-A,rs6495528,1,G,A,80882203,102833,80582762,80975978,299441
15,ENSG00000117899.6,80989819,chr15-80908355-T-C,rs6495533,-1,T,C,80908355,81464,80793211,81186427,115144
15,ENSG00000242866.3,43618800,chr15-43798656-T-C,rs654276,-1,T,C,43798656,179856,43422192,43815408,376464
15,ENSG00000166140.12,40807089,chr15-40813728-T-G,rs690347,1,T,G,40813728,6639,40610481,41003697,203247
15,ENSG00000104093.8,51622771,chr15-51623608-A-G,rs7163359,-1,A,G,51623608,837,51426163,51819379,197445
15,ENSG00000128928.4,40405795,chr15-40361837-A-G,rs7165012,1,A,G,40361837,43958,40209187,40602403,152650
15,ENSG00000128918.9,58065711,chr15-58260407-T-C,rs7165301,-1,T,C,58260407,194696,57869103,58262319,391304
15,ENSG00000259332.2,79923744,chr15-79834133-C-T,rs7166109,-1,C,T,79834133,89611,79727136,80120352,106997
15,ENSG00000103811.10,78945046,chr15-78836547-G-A,rs7168915,-1,G,A,78836547,108499,78748438,79141654,88109
15,ENSG00000140527.10,89690811,chr15-89683716-C-A,rs7169981,1,C,A,89683716,7095,89494203,89887419,189513
15,ENSG00000137834.9,66702236,chr15-66764233-T-C,rs7173030,1,T,C,66764233,61997,66505628,66898844,258605
15,ENSG00000172575.6,38564814,chr15-38618343-G-T,rs7173588,-1,G,T,38618343,53529,38368206,38761422,250137
15,ENSG00000169609.8,83011639,chr15-82895007-T-C,rs7174726,-1,T,C,82895007,116632,82815031,83208247,79976
15,ENSG00000136378.9,78811464,chr15-78858944-G-A,rs7174727,-1,G,A,78858944,47480,78614856,79008072,244088
15,ENSG00000069667.11,61229302,chr15-61198841-A-G,rs7177846,-1,A,G,61198841,30461,61032694,61425910,166147
15,ENSG00000154237.7,100919357,chr15-100938754-G-A,rs7179502,1,G,A,100938754,19397,100722749,101115965,216005
15,ENSG00000187446.7,41231268,chr15-41046071-C-T,rs7182660,1,C,T,41046071,185197,41034660,41427876,11411
15,ENSG00000140398.8,75347039,chr15-75185782-G-A,rs72732818,1,G,A,75185782,161257,75150431,75543647,35351
15,ENSG00000166145.9,40844048,chr15-40867107-C-T,rs72735657,1,C,T,40867107,23059,40647440,41040656,219667
15,ENSG00000166557.8,79311112,chr15-79350807-G-A,rs72740329,1,G,A,79350807,39695,79114504,79507720,236303
15,ENSG00000128973.7,68229728,chr15-68403450-G-A,rs72745265,-1,G,A,68403450,173722,68033120,68426336,370330
15,ENSG00000182253.10,99105080,chr15-99281840-G-A,rs72758808,1,G,A,99281840,176760,98908472,99301688,373368
15,ENSG00000137841.7,40307935,chr15-40262864-T-C,rs731497,-1,T,C,40262864,45071,40111327,40504543,151537
15,ENSG00000169105.6,40470984,chr15-40345524-T-G,rs73397311,1,T,G,40345524,125460,40274376,40667592,71148
15,ENSG00000104142.6,40894450,chr15-40810469-A-G,rs745032,1,A,G,40810469,83981,40697842,41091058,112627
15,ENSG00000128915.7,60479142,chr15-60373917-T-C,rs74857903,-1,T,C,60373917,105225,60282534,60675750,91383
15,ENSG00000182636.4,23687305,chr15-23703424-G-A,rs7497973,-1,G,A,23703424,16119,23490697,23883913,212727
15,ENSG00000131873.5,101252048,chr15-101163370-G-T,rs75054387,-1,G,T,101163370,88678,101055440,101448656,107930
15,ENSG00000140464.14,73994716,chr15-73818121-G-A,rs75317475,1,G,A,73818121,176595,73798108,74191324,20013
15,ENSG00000129003.11,62060447,chr15-62131727-T-C,rs75821421,-1,T,C,62131727,71280,61863839,62257055,267888
15,ENSG00000169410.4,75579315,chr15-75552612-C-T,rs76621678,-1,C,T,75552612,26703,75382707,75775923,169905
15,ENSG00000173548.8,75647912,chr15-75697715-C-T,rs76807356,1,C,T,75697715,49803,75451304,75844520,246411
15,ENSG00000214575.4,82647363,chr15-82714479-A-G,rs78605789,-1,A,G,82714479,67116,82450755,82843971,263724
15,ENSG00000103995.8,48811069,chr15-48794675-T-C,rs78632947,-1,T,C,48794675,16394,48614461,49007677,180214
15,ENSG00000182175.9,93089211,chr15-93083263-T-C,rs80242818,-1,T,C,93083263,5948,92892603,93285819,190660
15,ENSG00000168970.14,41828116,chr15-41871925-A-G,rs8024419,1,A,G,41871925,43809,41631508,42024724,240417
15,ENSG00000159322.11,72783758,chr15-72760499-T-C,rs8024644,-1,T,C,72760499,23259,72587150,72980366,173349
15,ENSG00000103978.10,42273433,chr15-42148607-A-G,rs80260937,-1,A,G,42148607,124826,42076825,42470041,71782
15,ENSG00000259330.1,40323692,chr15-40249253-A-G,rs8029043,1,A,G,40249253,74439,40127084,40520300,122169
15,ENSG00000166477.7,51971778,chr15-51852107-G-A,rs8031045,-1,G,A,51852107,119671,51775170,52168386,76937
15,ENSG00000166192.10,72118403,chr15-71950842-G-A,rs8032280,1,G,A,71950842,167561,71921795,72315011,29047
15,ENSG00000184277.8,101652381,chr15-101561555-A-G,rs8038697,-1,A,G,101561555,90826,101455773,101848989,105782
15,ENSG00000179151.7,74696024,chr15-74759278-C-A,rs8038819,-1,C,A,74759278,63254,74499416,74892632,259862
15,ENSG00000166938.8,66293568,chr15-66263816-A-G,rs8040520,1,A,G,66263816,29752,66096960,66490176,166856
15,ENSG00000261652.2,55408495,chr15-55485590-T-C,rs8043049,1,T,C,55485590,77095,55211887,55605103,273703
15,ENSG00000180304.8,64703281,chr15-64863329-C-T,rs832886,-1,C,T,64863329,160048,64506673,64899889,356656
15,ENSG00000103740.5,78234565,chr15-78077473-G-C,rs9047,-1,G,C,78077473,157092,78037957,78431173,39516
15,ENSG00000103740.5,78234565,chr15-78077473-G-A,rs9047,-1,G,A,78077473,157092,78037957,78431173,39516
15,ENSG00000074696.7,65530463,chr15-65555584-G-A,rs919999,1,G,A,65555584,25121,65333855,65727071,221729
15,ENSG00000140403.7,78264562,chr15-78373969-A-C,rs9920189,1,A,C,78373969,109407,78067954,78461170,306015
15,ENSG00000183208.8,90234209,chr15-90085545-T-C,rs9972549,1,T,C,90085545,148664,90037601,90430817,47944
14,ENSG00000126214.14,103629211,chr14-103574964-C-A,rs10129298,1,C,A,103574964,54247,103432603,103825819,142361
14,ENSG00000157379.9,24299780,chr14-24291558-G-A,rs10134537,-1,G,A,24291558,8222,24103172,24496388,188386
14,ENSG00000151327.7,35046272,chr14-35048404-G-C,rs10136692,1,G,C,35048404,2132,34849664,35242880,198740
14,ENSG00000165948.6,94081310,chr14-94106085-T-G,rs10139429,1,T,G,94106085,24775,93884702,94277918,221383
14,ENSG00000181803.3,20641691,chr14-20514750-G-A,rs10139456,-1,G,A,20514750,126941,20445083,20838299,69667
14,ENSG00000100721.6,95714125,chr14-95684228-A-G,rs10141005,-1,A,G,95684228,29897,95517517,95910733,166711
14,ENSG00000119684.11,75051467,chr14-75058746-G-A,rs10142770,-1,G,A,75058746,7279,74854859,75248075,203887
14,ENSG00000092203.7,21477195,chr14-21439685-G-A,rs10143061,1,G,A,21439685,37510,21280587,21673803,159098
14,ENSG00000185567.6,104978374,chr14-105020176-C-T,rs10143367,-1,C,T,105020176,41802,104781766,105174982,238410
14,ENSG00000214274.5,20688764,chr14-20737520-C-T,rs10144370,1,C,T,20737520,48756,20492156,20885372,245364
14,ENSG00000196943.7,24299850,chr14-24211928-T-C,rs10144791,1,T,C,24211928,87922,24103242,24496458,108686
14,ENSG00000100441.5,24429954,chr14-24429988-C-T,rs10146759,1,C,T,24429988,34,24233346,24626562,196642
14,ENSG00000184304.10,29927847,chr14-29847927-A-G,rs10147856,-1,A,G,29847927,79920,29731239,30124455,116688
14,ENSG00000092330.11,24242623,chr14-24243087-T-G,rs10148135,-1,T,G,24243087,464,24046015,24439231,197072
14,ENSG00000184227.3,73537143,chr14-73610781-C-T,rs10150828,1,C,T,73610781,73638,73340535,73733751,270246
14,ENSG00000139910.15,26598033,chr14-26544822-T-G,rs10151855,-1,T,G,26544822,53211,26401425,26794641,143397
14,ENSG00000139910.15,26598033,chr14-26544822-T-C,rs10151855,-1,T,C,26544822,53211,26401425,26794641,143397
14,ENSG00000072110.9,68979302,chr14-68985371-A-G,rs10220411,-1,A,G,68985371,6069,68782694,69175910,202677
14,ENSG00000136305.6,24307977,chr14-24330152-C-A,rs10483285,-1,C,A,24330152,22175,24111369,24504585,218783
14,ENSG00000100906.6,35404749,chr14-35275633-G-T,rs1064248,-1,G,T,35275633,129116,35208141,35601357,67492
14,ENSG00000100906.6,35404749,chr14-35275633-G-A,rs1064248,-1,G,A,35275633,129116,35208141,35601357,67492
14,ENSG00000198252.7,52730166,chr14-52770503-G-A,rs10873061,1,G,A,52770503,40337,52533558,52926774,236945
14,ENSG00000100485.7,50231578,chr14-50070370-C-T,rs11157723,-1,C,T,50070370,161208,50034970,50428186,35400
14,ENSG00000258289.2,64914455,chr14-64933351-C-T,rs11158569,1,C,T,64933351,18896,64717847,65111063,215504
14,ENSG00000257365.2,64986895,chr14-64933351-C-T,rs11158569,1,C,T,64933351,53544,64790287,65183503,143064
14,ENSG00000092010.10,24136194,chr14-24137907-A-G,rs11574509,1,A,G,24137907,1713,23939586,24332802,198321
14,ENSG00000177465.4,73591873,chr14-73627771-C-T,rs11621630,1,C,T,73627771,35898,73395265,73788481,232506
14,ENSG00000165804.9,21098655,chr14-21077514-G-A,rs11621987,-1,G,A,21077514,21141,20902047,21295263,175467
14,ENSG00000165555.5,77423523,chr14-77446519-A-C,rs11623826,-1,A,C,77446519,22996,77226915,77620131,219604
14,ENSG00000126215.9,103715451,chr14-103561220-C-T,rs11625397,-1,C,T,103561220,154231,103518843,103912059,42377
14,ENSG00000119599.12,72926464,chr14-72905021-T-C,rs11629006,1,T,C,72905021,21443,72729856,73123072,175165
14,ENSG00000155463.7,22766688,chr14-22725709-C-T,rs11629374,1,C,T,22725709,40979,22570080,22963296,155629
14,ENSG00000134001.7,67360328,chr14-67383660-G-A,rs116606923,1,G,A,67383660,23332,67163720,67556936,219940
14,ENSG00000099814.8,104865268,chr14-104918911-G-A,rs117723806,1,G,A,104918911,53643,104668660,105061876,250251
14,ENSG00000183576.8,99480859,chr14-99385405-C-T,rs117842008,-1,C,T,99385405,95454,99284251,99677467,101154
14,ENSG00000089737.10,94081202,chr14-94077591-C-T,rs11844679,-1,C,T,94077591,3611,93884594,94277810,192997
14,ENSG00000139985.4,70452174,chr14-70462133-C-G,rs11846259,1,C,G,70462133,9959,70255566,70648782,206567
14,ENSG00000119698.7,94174322,chr14-94346805-A-T,rs12101216,1,A,T,94346805,172483,93977714,94370930,369091
14,ENSG00000100836.6,23321457,chr14-23305857-G-A,rs12147021,1,G,A,23305857,15600,23124849,23518065,181008
14,ENSG00000100836.6,23321457,chr14-23305857-G-C,rs12147021,1,G,C,23305857,15600,23124849,23518065,181008
14,ENSG00000198668.6,90397029,chr14-90382760-G-A,rs12147703,1,G,A,90382760,14269,90200421,90593637,182339
14,ENSG00000126790.7,59484408,chr14-59489437-A-T,rs1253111,-1,A,T,59489437,5029,59287800,59681016,201637
14,ENSG00000140009.14,64294371,chr14-64267309-G-A,rs1256044,-1,G,A,64267309,27062,64097763,64490979,169546
14,ENSG00000131323.10,102777449,chr14-102764421-G-C,rs12588969,1,G,C,102764421,13028,102580841,102974057,183580
14,ENSG00000165943.4,93184897,chr14-93179363-A-G,rs1263373,-1,A,G,93179363,5534,92988289,93381505,191074
14,ENSG00000170270.4,93207065,chr14-93180064-T-C,rs1270629,-1,T,C,93180064,27001,93010457,93403673,169607
14,ENSG00000152315.4,90061994,chr14-89875494-A-G,rs1286939,1,A,G,89875494,186500,89865386,90258602,10108
14,ENSG00000165934.8,92121969,chr14-92281856-C-A,rs12883551,1,C,A,92281856,159887,91925361,92318577,356495
14,ENSG00000165934.8,92121969,chr14-92281856-C-T,rs12883551,1,C,T,92281856,159887,91925361,92318577,356495
14,ENSG00000080815.13,73136507,chr14-73247400-C-G,rs12883707,1,C,G,73247400,110893,72939899,73333115,307501
14,ENSG00000100478.10,31025649,chr14-30891075-C-T,rs12884979,1,C,T,30891075,134574,30829041,31222257,62034
14,ENSG00000183092.11,100587417,chr14-100538878-T-C,rs12893951,-1,T,C,100538878,48539,100390809,100784025,148069
14,ENSG00000133985.2,70641916,chr14-70656805-A-G,rs12895136,1,A,G,70656805,14889,70445308,70838524,211497
14,ENSG00000100433.11,88323269,chr14-88188507-T-C,rs12896330,-1,T,C,88188507,134762,88126661,88519877,61846
14,ENSG00000087301.4,52552505,chr14-52369781-T-C,rs1458113,-1,T,C,52369781,182724,52355897,52749113,13884
14,ENSG00000119699.3,75981995,chr14-75982578-G-A,rs146047341,-1,G,A,75982578,583,75785387,76178603,197191
14,ENSG00000139988.5,67701886,chr14-67771970-T-C,rs1474796,1,T,C,67771970,70084,67505278,67898494,266692
14,ENSG00000140105.11,100375347,chr14-100341818-G-A,rs1570305,-1,G,A,100341818,33529,100178739,100571955,163079
14,ENSG00000165959.5,95319908,chr14-95261968-A-G,rs17091981,-1,A,G,95261968,57940,95123300,95516516,138668
14,ENSG00000100612.8,60165398,chr14-60271639-C-T,rs17097262,-1,C,T,60271639,106241,59968790,60362006,302849
14,ENSG00000100949.10,24271597,chr14-24325699-C-T,rs17102928,-1,C,T,24325699,54102,24074989,24468205,250710
14,ENSG00000165548.5,77181798,chr14-77066572-C-G,rs17105279,1,C,G,77066572,115226,76985190,77378406,81382
14,ENSG00000198807.7,36661860,chr14-36822155-T-C,rs17105423,1,T,C,36822155,160295,36465252,36858468,356903
14,ENSG00000100678.14,70188951,chr14-70184477-T-C,rs17107951,-1,T,C,70184477,4474,69992343,70385559,192134
14,ENSG00000165355.7,39432433,chr14-39402962-T-C,rs17109203,-1,T,C,39402962,29471,39235825,39629041,167137
14,ENSG00000187790.6,45135930,chr14-45314343-T-C,rs17115982,1,T,C,45314343,178413,44939322,45332538,375021
14,ENSG00000100804.14,23034900,chr14-23025025-C-T,rs17125731,-1,C,T,23025025,9875,22838292,23231508,186733
14,ENSG00000178974.4,55271421,chr14-55342778-T-C,rs17128417,1,T,C,55342778,71357,55074813,55468029,267965
14,ENSG00000136319.6,20305951,chr14-20395652-G-A,rs1713417,-1,G,A,20395652,89701,20109343,20502559,286309
14,ENSG00000139908.10,24205696,chr14-24177263-T-C,rs17199551,1,T,C,24177263,28433,24009088,24402304,168175
14,ENSG00000119718.5,75002921,chr14-75047125-G-A,rs175080,1,G,A,75047125,44204,74806313,75199529,240812
14,ENSG00000198718.7,44962190,chr14-45013504-A-G,rs17634474,1,A,G,45013504,51314,44765582,45158798,247922
14,ENSG00000213920.4,24216066,chr14-24210800-G-A,rs17693590,-1,G,A,24210800,5266,24019458,24412674,191342
14,ENSG00000100596.2,77616637,chr14-77554924-G-C,rs17751727,-1,G,C,77554924,61713,77420029,77813245,134895
14,ENSG00000139899.6,24429668,chr14-24432227-C-T,rs17795094,-1,C,T,24432227,2559,24233060,24626276,199167
14,ENSG00000133962.3,91732086,chr14-91842981-A-G,rs1884840,-1,A,G,91842981,110895,91535478,91928694,307503
14,ENSG00000100744.10,96363526,chr14-96389657-A-C,rs1899588,1,A,C,96389657,26131,96166918,96560134,222739
14,ENSG00000089916.12,76151922,chr14-76191413-G-A,rs1900126,1,G,A,76191413,39491,75955314,76348530,236099
14,ENSG00000100504.11,50944483,chr14-50879841-G-A,rs1953877,-1,G,A,50879841,64642,50747875,51141091,131966
14,ENSG00000100445.11,24442776,chr14-24511286-A-G,rs1956917,-1,A,G,24511286,68510,24246168,24639384,265118
14,ENSG00000100592.10,59188667,chr14-59334082-A-C,rs1957409,1,A,C,59334082,145415,58992059,59385275,342023
14,ENSG00000100453.7,24634190,chr14-24670208-T-A,rs1957521,-1,T,A,24670208,36018,24437582,24830798,232626
14,ENSG00000073712.9,52951050,chr14-52923330-T-A,rs1958025,-1,T,A,52923330,27720,52754442,53147658,168888
14,ENSG00000070269.9,56579798,chr14-56774732-A-C,rs198230,1,A,C,56774732,194934,56383190,56776406,391542
14,ENSG00000092009.6,24508265,chr14-24515137-G-C,rs2007316,-1,G,C,24515137,6872,24311657,24704873,203480
14,ENSG00000157326.14,23953770,chr14-24020396-T-G,rs2146432,1,T,G,24020396,66626,23757162,24150378,263234
14,ENSG00000100526.13,54397007,chr14-54408796-A-G,rs2179896,1,A,G,54408796,11789,54200399,54593615,208397
14,ENSG00000042088.9,89955927,chr14-89809801-G-A,rs2183526,1,G,A,89809801,146126,89759319,90152535,50482
14,ENSG00000100461.12,22919149,chr14-23026034-C-T,rs2230087,-1,C,T,23026034,106885,22722541,23115757,303493
14,ENSG00000140092.10,91947694,chr14-91873564-C-T,rs2267990,-1,C,T,91873564,74130,91751086,92144302,122478
14,ENSG00000119632.3,94129604,chr14-94129652-T-C,rs2273514,-1,T,C,94129652,48,93932996,94326212,196656
14,ENSG00000092140.10,30559158,chr14-30598884-G-A,rs229261,1,G,A,30598884,39726,30362550,30755766,236334
14,ENSG00000255526.1,24232352,chr14-24213631-G-A,rs2295319,-1,G,A,24213631,18721,24035744,24428960,177887
14,ENSG00000213231.7,95686426,chr14-95670438-C-A,rs2296310,1,C,A,95670438,15988,95489818,95883034,180620
14,ENSG00000139998.9,64972336,chr14-64947654-T-C,rs2296326,-1,T,C,64947654,24682,64775728,65168944,171926
14,ENSG00000129484.9,20343635,chr14-20313202-A-G,rs2297732,1,A,G,20313202,30433,20147027,20540243,166175
14,ENSG00000092094.5,20454812,chr14-20441657-G-A,rs2319196,-1,G,A,20441657,13155,20258204,20651420,183453
14,ENSG00000090061.12,99481409,chr14-99336128-C-T,rs2400632,1,C,T,99336128,145281,99284801,99678017,51327
14,ENSG00000142208.11,104795748,chr14-104780652-C-T,rs2494739,-1,C,T,104780652,15096,104599140,104992356,181512
14,ENSG00000129559.8,24232367,chr14-24252695-A-G,rs2748531,-1,A,G,24252695,20328,24035759,24428975,216936
14,ENSG00000196405.7,100065422,chr14-100193629-A-G,rs2757526,1,A,G,100193629,128207,99868814,100262030,324815
14,ENSG00000213983.5,23567791,chr14-23556131-C-T,rs28403575,-1,C,T,23556131,11660,23371183,23764399,184948
14,ENSG00000185347.12,105491246,chr14-105466757-C-T,rs28725385,1,C,T,105466757,24489,105294638,105687854,172119
14,ENSG00000168282.3,49620799,chr14-49619845-C-T,rs3007030,1,C,T,49619845,954,49424191,49817407,195654
14,ENSG00000165502.6,49620626,chr14-49619845-C-T,rs3007030,-1,C,T,49619845,781,49424018,49817234,195827
14,ENSG00000129566.7,20413501,chr14-20356535-C-T,rs3093936,-1,C,T,20356535,56966,20216893,20610109,139642
14,ENSG00000092098.10,24147498,chr14-24258855-G-A,rs34597632,1,G,A,24258855,111357,23950890,24344106,307965
14,ENSG00000050130.12,59484517,chr14-59483958-A-C,rs34741399,1,A,C,59483958,559,59287909,59681125,196049
14,ENSG00000129534.9,45253202,chr14-45231029-A-C,rs34842824,-1,A,C,45231029,22173,45056594,45449810,174435
14,ENSG00000184986.6,105526583,chr14-105533894-G-A,rs4075105,1,G,A,105533894,7311,105329975,105723191,203919
14,ENSG00000133943.14,91114073,chr14-91114928-T-C,rs41299205,1,T,C,91114928,855,90917465,91310681,197463
14,ENSG00000179454.7,44961947,chr14-44982834-A-G,rs4141578,-1,A,G,44982834,20887,44765339,45158555,217495
14,ENSG00000100625.6,60724351,chr14-60916029-G-A,rs4151351,-1,G,A,60916029,191678,60527743,60920959,388286
14,ENSG00000186469.4,51860612,chr14-51849521-G-A,rs4243583,1,G,A,51849521,11091,51664004,52057220,185517
14,ENSG00000139921.8,51240247,chr14-51256822-G-A,rs4261445,1,G,A,51256822,16575,51043639,51436855,213183
14,ENSG00000119614.2,74239449,chr14-74285327-G-A,rs45446193,1,G,A,74285327,45878,74042841,74436057,242486
14,ENSG00000196663.10,102362941,chr14-102210392-G-A,rs45508291,1,G,A,102210392,152549,102166333,102559549,44059
14,ENSG00000053770.7,57268971,chr14-57135810-T-G,rs4901766,1,T,G,57135810,133161,57072363,57465579,63447
14,ENSG00000151838.6,59576812,chr14-59664148-C-T,rs4901951,-1,C,T,59664148,87336,59380204,59773420,283944
14,ENSG00000151838.6,59576812,chr14-59664148-C-G,rs4901951,-1,C,G,59664148,87336,59380204,59773420,283944
14,ENSG00000100564.4,67600268,chr14-67585166-G-T,rs4902494,-1,G,T,67585166,15102,67403660,67796876,181506
14,ENSG00000119669.3,77028708,chr14-76962761-T-G,rs4903521,-1,T,G,76962761,65947,76832100,77225316,130661
14,ENSG00000198894.3,77098258,chr14-77130055-C-T,rs4903544,1,C,T,77130055,31797,76901650,77294866,228405
14,ENSG00000140030.4,88005135,chr14-87972104-G-C,rs4904408,1,G,C,87972104,33031,87808527,88201743,163577
14,ENSG00000185271.6,20436166,chr14-20430758-A-G,rs4982086,-1,A,G,20430758,5408,20239558,20632774,191200
14,ENSG00000165801.5,21070304,chr14-21073878-C-T,rs4982405,1,C,T,21073878,3574,20873696,21266912,200182
14,ENSG00000183828.8,105181312,chr14-105179842-G-A,rs4983590,-1,G,A,105179842,1470,104984704,105377920,195138
14,ENSG00000157227.8,22836585,chr14-22801387-C-T,rs5027249,1,C,T,22801387,35198,22639977,23033193,161410
14,ENSG00000155465.13,22815435,chr14-22801387-C-T,rs5027249,-1,C,T,22801387,14048,22618827,23012043,182560
14,ENSG00000196497.10,24188816,chr14-24378577-C-A,rs56082702,-1,C,A,24378577,189761,23992208,24385424,386369
14,ENSG00000129562.5,22589224,chr14-22586674-T-C,rs5742747,-1,T,C,22586674,2550,22392616,22785832,194058
14,ENSG00000092108.15,30622319,chr14-30770901-C-T,rs61976746,1,C,T,30770901,148582,30425711,30818927,345190
14,ENSG00000063761.11,77800109,chr14-77892016-G-C,rs61990742,1,G,C,77892016,91907,77603501,77996717,288515
14,ENSG00000165410.10,34714593,chr14-34716139-A-G,rs6571678,-1,A,G,34716139,1546,34517985,34911201,198154
14,ENSG00000087302.4,51989546,chr14-52184409-T-C,rs6572835,1,T,C,52184409,194863,51792938,52186154,391471
14,ENSG00000176903.3,73714384,chr14-73696147-T-C,rs6574138,-1,T,C,73696147,18237,73517776,73910992,178371
14,ENSG00000092051.10,23578790,chr14-23665826-T-C,rs71414000,-1,T,C,23665826,87036,23382182,23775398,283644
14,ENSG00000183648.3,92121706,chr14-92122573-T-A,rs7151027,-1,T,A,92122573,867,91925098,92318314,197475
14,ENSG00000119673.10,73569213,chr14-73561413-T-G,rs7151745,1,T,G,73561413,7800,73372605,73765821,188808
14,ENSG00000185650.7,68793067,chr14-68741052-G-A,rs7152120,-1,G,A,68741052,52015,68596459,68989675,144593
14,ENSG00000089902.7,102592649,chr14-102659764-C-T,rs7152144,1,C,T,102659764,67115,102396041,102789257,263723
14,ENSG00000197776.3,49693120,chr14-49739055-A-G,rs7156717,1,A,G,49739055,45935,49496512,49889728,242543
14,ENSG00000139914.6,24130659,chr14-24049930-T-C,rs7157257,1,T,C,24049930,80729,23934051,24327267,115879
14,ENSG00000180008.8,55027236,chr14-55118840-C-T,rs7158989,1,C,T,55118840,91604,54830628,55223844,288212
14,ENSG00000100714.9,64388353,chr14-64534491-G-A,rs7160634,1,G,A,64534491,146138,64191745,64584961,342746
14,ENSG00000100628.6,93976570,chr14-93975915-T-G,rs72700358,-1,T,G,93975915,655,93779962,94173178,195953
14,ENSG00000175699.8,93997301,chr14-93975915-T-G,rs72700358,1,T,G,93975915,21386,93800693,94193909,175222
14,ENSG00000023608.4,61762420,chr14-61762964-C-A,rs72714597,1,C,A,61762964,544,61565812,61959028,197152
14,ENSG00000140057.4,96392128,chr14-96273326-G-A,rs75170279,1,G,A,96273326,118802,96195520,96588736,77806
14,ENSG00000140057.4,96392128,chr14-96273326-G-T,rs75170279,1,G,T,96273326,118802,96195520,96588736,77806
14,ENSG00000179627.9,104801101,chr14-104844539-C-T,rs75232889,1,C,T,104844539,43438,104604493,104997709,240046
14,ENSG00000179627.9,104801101,chr14-104844539-C-A,rs75232889,1,C,A,104844539,43438,104604493,104997709,240046
14,ENSG00000081181.3,67619920,chr14-67583774-C-T,rs75288035,1,C,T,67583774,36146,67423312,67816528,160462
14,ENSG00000100650.10,69767142,chr14-69863457-T-C,rs77366387,1,T,C,69863457,96315,69570534,69963750,292923
14,ENSG00000187630.9,23988929,chr14-23989543-G-A,rs77491846,1,G,A,23989543,614,23792321,24185537,197222
14,ENSG00000054983.11,87993182,chr14-87992401-C-T,rs78187751,-1,C,T,87992401,781,87796574,88189790,195827
14,ENSG00000089775.6,64503838,chr14-64441933-A-G,rs8003567,-1,A,G,64441933,61905,64307230,64700446,134703
14,ENSG00000179933.4,23095505,chr14-23095803-C-T,rs8003631,1,C,T,23095803,298,22898897,23292113,196906
14,ENSG00000176438.7,95516650,chr14-95444800-C-T,rs8007302,-1,C,T,95444800,71850,95320042,95713258,124758
14,ENSG00000126787.8,55191585,chr14-55198077-T-G,rs8009660,-1,T,G,55198077,6492,54994977,55388193,203100
14,ENSG00000100908.9,24141591,chr14-24139938-T-C,rs8010715,-1,T,C,24139938,1653,23944983,24338199,194955
14,ENSG00000100439.6,22598300,chr14-22599022-T-C,rs8011143,1,T,C,22599022,722,22401692,22794908,197330
14,ENSG00000232070.4,21101103,chr14-20978068-G-T,rs8016111,1,G,T,20978068,123035,20904495,21297711,73573
14,ENSG00000119608.7,74876145,chr14-74771558-T-C,rs8016513,-1,T,C,74771558,104587,74679537,75072753,92021
14,ENSG00000197119.7,100306444,chr14-100188685-A-T,rs8017586,-1,A,T,100188685,117759,100109836,100503052,78849
14,ENSG00000139946.5,56118411,chr14-56299376-T-G,rs8018553,1,T,G,56299376,180965,55921803,56315019,377573
14,ENSG00000140043.6,73851831,chr14-73852011-A-G,rs8020267,1,A,G,73852011,180,73655223,74048439,196788
14,ENSG00000140006.7,63641871,chr14-63638461-G-A,rs8020893,-1,G,A,63638461,3410,63445263,63838479,193198
14,ENSG00000100505.9,51095105,chr14-51224810-T-C,rs8021773,-1,T,C,51224810,129705,50898497,51291713,326313
14,ENSG00000140044.8,75428022,chr14-75551071-G-A,rs8022514,1,G,A,75551071,123049,75231414,75624630,319657
14,ENSG00000156127.6,75522469,chr14-75551071-G-A,rs8022514,1,G,A,75551071,28602,75325861,75719077,225210
14,ENSG00000100580.7,77377094,chr14-77359403-A-C,rs8022676,-1,A,C,77359403,17691,77180486,77573702,178917
14,ENSG00000182512.4,95535050,chr14-95535046-A-C,rs911681,1,A,C,95535046,4,95338442,95731658,196604
14,ENSG00000015133.13,91417820,chr14-91238844-G-A,rs933528,-1,G,A,91238844,178976,91221212,91614428,17632
14,ENSG00000092036.12,22957090,chr14-22979659-T-C,rs941724,-1,T,C,22979659,22569,22760482,23153698,219177
14,ENSG00000184990.8,104753147,chr14-104714640-G-A,rs9672065,1,G,A,104714640,38507,104556539,104949755,158101
14,ENSG00000100600.9,92748627,chr14-92704648-C-T,rs9791,-1,C,T,92704648,43979,92552019,92945235,152629
14,ENSG00000100564.4,67600268,chr14-67599127-G-A,rs10131404,-1,G,A,67599127,1141,67403660,67796876,195467
14,ENSG00000119720.13,90331941,chr14-90165924-A-G,rs10132426,-1,A,G,90165924,166017,90135333,90528549,30591
14,ENSG00000140104.9,104985788,chr14-105075694-C-T,rs10134401,1,C,T,105075694,89906,104789180,105182396,286514
14,ENSG00000165410.10,34714593,chr14-34722332-A-G,rs10135305,-1,A,G,34722332,7739,34517985,34911201,204347
14,ENSG00000139998.9,64972336,chr14-64910892-G-A,rs10136659,-1,G,A,64910892,61444,64775728,65168944,135164
14,ENSG00000139985.4,70452174,chr14-70525540-A-G,rs10137299,1,A,G,70525540,73366,70255566,70648782,269974
14,ENSG00000119632.3,94129604,chr14-94125513-G-T,rs10139084,-1,G,T,94125513,4091,93932996,94326212,192517
14,ENSG00000100554.7,67359804,chr14-67393402-G-A,rs10139585,-1,G,A,67393402,33598,67163196,67556412,230206
14,ENSG00000179008.4,60486063,chr14-60618487-T-C,rs10142842,-1,T,C,60618487,132424,60289455,60682671,329032
14,ENSG00000140153.12,102139897,chr14-102204884-A-G,rs10144363,1,A,G,102204884,64987,101943289,102336505,261595
14,ENSG00000119699.3,75981995,chr14-76010903-C-A,rs10146195,-1,C,A,76010903,28908,75785387,76178603,225516
14,ENSG00000100445.11,24442776,chr14-24429988-C-T,rs10146759,-1,C,T,24429988,12788,24246168,24639384,183820
14,ENSG00000119673.10,73569213,chr14-73610781-C-T,rs10150828,1,C,T,73610781,41568,73372605,73765821,238176
14,ENSG00000100483.8,50116572,chr14-50123160-G-A,rs10151119,-1,G,A,50123160,6588,49919964,50313180,203196
14,ENSG00000129562.5,22589224,chr14-22589178-G-A,rs1051101,-1,G,A,22589178,46,22392616,22785832,196562
14,ENSG00000129562.5,22589224,chr14-22589178-G-T,rs1051101,-1,G,T,22589178,46,22392616,22785832,196562
14,ENSG00000081181.3,67619920,chr14-67677474-A-G,rs1059238,1,A,G,67677474,57554,67423312,67816528,254162
14,ENSG00000100583.4,77377379,chr14-77462182-A-G,rs1061638,1,A,G,77462182,84803,77180771,77573987,281411
14,ENSG00000119669.3,77028708,chr14-76960182-C-T,rs10873298,-1,C,T,76960182,68526,76832100,77225316,128082
14,ENSG00000197119.7,100306444,chr14-100300327-G-A,rs10873515,-1,G,A,100300327,6117,100109836,100503052,190491
14,ENSG00000165525.11,49852788,chr14-50014242-C-T,rs11157718,-1,C,T,50014242,161454,49656180,50049396,358062
14,ENSG00000197930.8,52695558,chr14-52684472-T-A,rs11157928,-1,T,A,52684472,11086,52498950,52892166,185522
14,ENSG00000139990.13,69153119,chr14-69086688-C-G,rs11158784,-1,C,G,69086688,66431,68956511,69349727,130177
14,ENSG00000092094.5,20454812,chr14-20440194-A-G,rs11160682,-1,A,G,20440194,14618,20258204,20651420,181990
14,ENSG00000196792.6,31026379,chr14-31044811-C-T,rs117642945,-1,C,T,31044811,18432,30829771,31222987,215040
14,ENSG00000170270.4,93207065,chr14-93087371-A-G,rs11845823,-1,A,G,93087371,119694,93010457,93403673,76914
14,ENSG00000100814.12,20333279,chr14-20382104-G-A,rs11850456,-1,G,A,20382104,48825,20136671,20529887,245433
14,ENSG00000100664.6,103334237,chr14-103320219-G-A,rs11850831,1,G,A,103320219,14018,103137629,103530845,182590
14,ENSG00000119608.7,74876145,chr14-74872747-A-G,rs11851433,-1,A,G,74872747,3398,74679537,75072753,193210
14,ENSG00000196405.7,100065422,chr14-100029755-A-G,rs1190986,1,A,G,100029755,35667,99868814,100262030,160941
14,ENSG00000198805.6,20469406,chr14-20489274-T-C,rs12147450,1,T,C,20489274,19868,20272798,20666014,216476
14,ENSG00000092199.12,21269442,chr14-21121452-A-G,rs1243474,-1,A,G,21121452,147990,21072834,21466050,48618
14,ENSG00000100823.6,20455226,chr14-20537948-A-G,rs1243701,1,A,G,20537948,82722,20258618,20651834,279330
14,ENSG00000100592.10,59188667,chr14-59296987-A-G,rs1253021,1,A,G,59296987,108320,58992059,59385275,304928
14,ENSG00000092009.6,24508265,chr14-24698305-A-G,rs12879771,-1,A,G,24698305,190040,24311657,24704873,386648
14,ENSG00000092096.10,23352912,chr14-23343028-G-C,rs12882406,-1,G,C,23343028,9884,23156304,23549520,186724
14,ENSG00000157227.8,22836585,chr14-22803905-T-C,rs12884337,1,T,C,22803905,32680,22639977,23033193,163928
14,ENSG00000140030.4,88005135,chr14-88063247-G-A,rs12885067,1,G,A,88063247,58112,87808527,88201743,254720
14,ENSG00000198208.6,74923260,chr14-74764134-A-G,rs12885527,-1,A,G,74764134,159126,74726652,75119868,37482
14,ENSG00000183648.3,92121706,chr14-92122344-G-C,rs12886834,-1,G,C,92122344,638,91925098,92318314,197246
14,ENSG00000183648.3,92121706,chr14-92122344-G-A,rs12886834,-1,G,A,92122344,638,91925098,92318314,197246
14,ENSG00000165782.6,20461434,chr14-20489607-A-G,rs12891826,-1,A,G,20489607,28173,20264826,20658042,224781
14,ENSG00000183484.7,105065430,chr14-104951166-G-T,rs146582718,-1,G,T,104951166,114264,104868822,105262038,82344
14,ENSG00000139946.5,56118411,chr14-56021722-A-G,rs1480658,1,A,G,56021722,96689,55921803,56315019,99919
14,ENSG00000235194.3,23302859,chr14-23393165-A-G,rs17091453,-1,A,G,23393165,90306,23106251,23499467,286914
14,ENSG00000197616.7,23408273,chr14-23409993-T-C,rs17091776,-1,T,C,23409993,1720,23211665,23604881,198328
14,ENSG00000070367.11,57268905,chr14-57403936-C-T,rs17093196,-1,C,T,57403936,135031,57072297,57465513,331639
14,ENSG00000100867.10,23636364,chr14-23652122-G-A,rs17095582,1,G,A,23652122,15758,23439756,23832972,212366
14,ENSG00000198133.4,67488721,chr14-67430605-G-A,rs17104317,-1,G,A,67430605,58116,67292113,67685329,138492
14,ENSG00000119599.12,72926464,chr14-73008768-C-T,rs17123359,1,C,T,73008768,82304,72729856,73123072,278912
14,ENSG00000133962.3,91732086,chr14-91813639-T-G,rs17127600,-1,T,G,91813639,81553,91535478,91928694,278161
14,ENSG00000129566.7,20413501,chr14-20413368-T-C,rs1713434,-1,T,C,20413368,133,20216893,20610109,196475
14,ENSG00000255526.1,24232352,chr14-24197845-C-T,rs17184526,-1,C,T,24197845,34507,24035744,24428960,162101
14,ENSG00000213231.7,95686426,chr14-95673747-G-A,rs1748932,1,G,A,95673747,12679,95489818,95883034,183929
14,ENSG00000100721.6,95714125,chr14-95682872-T-G,rs1748951,-1,T,G,95682872,31253,95517517,95910733,165355
14,ENSG00000070269.9,56579798,chr14-56728364-A-G,rs1754758,1,A,G,56728364,148566,56383190,56776406,345174
14,ENSG00000151445.10,77457601,chr14-77472234-C-T,rs17751424,-1,C,T,77472234,14633,77260993,77654209,211241
14,ENSG00000182512.4,95535050,chr14-95526094-C-T,rs17756537,1,C,T,95526094,8956,95338442,95731658,187652
14,ENSG00000100593.12,77498816,chr14-77461737-C-T,rs17824238,-1,C,T,77461737,37079,77302208,77695424,159529
14,ENSG00000131966.6,58200149,chr14-58211339-G-A,rs17832891,1,G,A,58211339,11190,58003541,58396757,207798
14,ENSG00000258289.2,64914455,chr14-64942378-C-T,rs17880758,1,C,T,64942378,27923,64717847,65111063,224531
14,ENSG00000257365.2,64986895,chr14-64942378-C-T,rs17880758,1,C,T,64942378,44517,64790287,65183503,152091
14,ENSG00000100473.10,30874559,chr14-30858598-T-C,rs179666,1,T,C,30858598,15961,30677951,31071167,180647
14,ENSG00000100473.10,30874559,chr14-30858598-T-G,rs179666,1,T,G,30858598,15961,30677951,31071167,180647
14,ENSG00000183576.8,99480859,chr14-99356682-G-A,rs1810114,-1,G,A,99356682,124177,99284251,99677467,72431
14,ENSG00000092051.10,23578790,chr14-23668806-A-G,rs1885592,-1,A,G,23668806,90016,23382182,23775398,286624
14,ENSG00000140022.4,81400324,chr14-81563073-C-T,rs1885600,-1,C,T,81563073,162749,81203716,81596932,359357
14,ENSG00000165949.8,94110736,chr14-94103451-C-T,rs1950346,1,C,T,94103451,7285,93914128,94307344,189323
14,ENSG00000213903.4,24311502,chr14-24505826-C-T,rs1951133,1,C,T,24505826,194324,24114894,24508110,390932
14,ENSG00000197249.8,94388602,chr14-94349784-G-A,rs1956174,-1,G,A,94349784,38818,94191994,94585210,157790
14,ENSG00000100852.8,32077304,chr14-31992169-C-T,rs1958918,1,C,T,31992169,85135,31880696,32273912,111473
14,ENSG00000184304.10,29927847,chr14-29857762-C-T,rs1958990,-1,C,T,29857762,70085,29731239,30124455,126523
14,ENSG00000126790.7,59484408,chr14-59565278-G-A,rs1980580,-1,G,A,59565278,80870,59287800,59681016,277478
14,ENSG00000232070.4,21101103,chr14-21249741-T-C,rs2065093,1,T,C,21249741,148638,20904495,21297711,345246
14,ENSG00000089775.6,64503838,chr14-64468652-A-C,rs2230490,-1,A,C,64468652,35186,64307230,64700446,161422
14,ENSG00000129473.5,23306833,chr14-23126512-A-G,rs2236135,1,A,G,23126512,180321,23110225,23503441,16287
14,ENSG00000023608.4,61762420,chr14-61644488-A-G,rs2251624,1,A,G,61644488,117932,61565812,61959028,78676
14,ENSG00000100815.6,92040059,chr14-91932944-C-T,rs2256767,-1,C,T,91932944,107115,91843451,92236667,89493
14,ENSG00000119640.4,75064024,chr14-74949297-C-T,rs2268614,-1,C,T,74949297,114727,74867416,75260632,81881
14,ENSG00000100764.9,90256553,chr14-90264599-T-C,rs2282031,1,T,C,90264599,8046,90059945,90453161,204654
14,ENSG00000100596.2,77616637,chr14-77549554-C-T,rs2284230,-1,C,T,77549554,67083,77420029,77813245,129525
14,ENSG00000119723.10,73950302,chr14-74114818-G-A,rs2300191,1,G,A,74114818,164516,73753694,74146910,361124
14,ENSG00000092036.12,22957090,chr14-23003226-T-C,rs2331896,-1,T,C,23003226,46136,22760482,23153698,242744
14,ENSG00000157326.14,23953770,chr14-23985715-C-T,rs2332152,1,C,T,23985715,31945,23757162,24150378,228553
14,ENSG00000187630.9,23988929,chr14-23985715-C-T,rs2332152,1,C,T,23985715,3214,23792321,24185537,193394
14,ENSG00000140092.10,91947694,chr14-91856072-T-C,rs2402076,-1,T,C,91856072,91622,91751086,92144302,104986
14,ENSG00000100883.7,34982992,chr14-35161113-C-A,rs2415263,1,C,A,35161113,178121,34786384,35179600,374729
14,ENSG00000139977.8,57390586,chr14-57572874-T-C,rs268804,1,T,C,57572874,182288,57193978,57587194,378896
14,ENSG00000176903.3,73714384,chr14-73752265-T-C,rs2878733,-1,T,C,73752265,37881,73517776,73910992,234489
14,ENSG00000136319.6,20305951,chr14-20286553-G-A,rs3209531,-1,G,A,20286553,19398,20109343,20502559,177210
14,ENSG00000126215.9,103715451,chr14-103714056-C-T,rs3212028,-1,C,T,103714056,1395,103518843,103912059,195213
14,ENSG00000196497.10,24188816,chr14-24341164-T-C,rs3212243,-1,T,C,24341164,152348,23992208,24385424,348956
14,ENSG00000184990.8,104753147,chr14-104757516-T-C,rs35165446,1,T,C,104757516,4369,104556539,104949755,200977
14,ENSG00000100433.11,88323269,chr14-88183529-A-G,rs3559,-1,A,G,88183529,139740,88126661,88519877,56868
14,ENSG00000165501.11,49598940,chr14-49527305-G-T,rs36023440,1,G,T,49527305,71635,49402332,49795548,124973
14,ENSG00000165948.6,94081310,chr14-94093097-A-G,rs36103194,1,A,G,94093097,11787,93884702,94277918,208395
14,ENSG00000136367.9,23551765,chr14-23392602-A-G,rs365990,-1,A,G,23392602,159163,23355157,23748373,37445
14,ENSG00000131323.10,102777449,chr14-102964210-C-A,rs3818287,1,C,A,102964210,186761,102580841,102974057,383369
14,ENSG00000129484.9,20343635,chr14-20264016-C-G,rs3938669,1,C,G,20264016,79619,20147027,20540243,116989
14,ENSG00000066739.7,96363341,chr14-96397990-A-G,rs41301765,-1,A,G,96397990,34649,96166733,96559949,231257
14,ENSG00000100911.9,24146610,chr14-24064802-C-T,rs4144200,-1,C,T,24064802,81808,23950002,24343218,114800
14,ENSG00000184916.4,105168776,chr14-105294984-C-T,rs4403997,-1,C,T,105294984,126208,104972168,105365384,322816
14,ENSG00000157379.9,24299780,chr14-24290803-G-A,rs4568,-1,G,A,24290803,8977,24103172,24496388,187631
14,ENSG00000136305.6,24307977,chr14-24290803-G-A,rs4568,-1,G,A,24290803,17174,24111369,24504585,179434
14,ENSG00000186469.4,51860612,chr14-51829703-A-G,rs4901159,1,A,G,51829703,30909,51664004,52057220,165699
14,ENSG00000176153.10,64942745,chr14-64878085-C-T,rs4902327,-1,C,T,64878085,64660,64746137,65139353,131948
14,ENSG00000139988.5,67701886,chr14-67575779-A-G,rs4902491,1,A,G,67575779,126107,67505278,67898494,70501
14,ENSG00000184227.3,73537143,chr14-73609231-T-C,rs4903128,1,T,C,73609231,72088,73340535,73733751,268696
14,ENSG00000177465.4,73591873,chr14-73609231-T-C,rs4903128,1,T,C,73609231,17358,73395265,73788481,213966
14,ENSG00000063761.11,77800109,chr14-77869596-A-G,rs4903661,1,A,G,77869596,69487,77603501,77996717,266095
14,ENSG00000054983.11,87993182,chr14-87999401-A-C,rs4904410,-1,A,C,87999401,6219,87796574,88189790,202827
14,ENSG00000089737.10,94081202,chr14-94088017-A-T,rs4905157,-1,A,T,94088017,6815,93884594,94277810,203423
14,ENSG00000256053.2,103562960,chr14-103400983-A-G,rs4906319,1,A,G,103400983,161977,103366352,103759568,34631
14,ENSG00000155465.13,22815435,chr14-22808794-G-A,rs4982676,-1,G,A,22808794,6641,22618827,23012043,189967
14,ENSG00000071246.5,76761468,chr14-76841481-G-A,rs5014291,1,G,A,76841481,80013,76564860,76958076,276621
14,ENSG00000133985.2,70641916,chr14-70650838-A-G,rs58429259,1,A,G,70650838,8922,70445308,70838524,205530
14,ENSG00000179627.9,104801101,chr14-104682730-A-G,rs59766306,1,A,G,104682730,118371,104604493,104997709,78237
14,ENSG00000179627.9,104801101,chr14-104682730-A-C,rs59766306,1,A,C,104682730,118371,104604493,104997709,78237
14,ENSG00000165617.8,58637962,chr14-58503058-T-C,rs61974553,1,T,C,58503058,134904,58441354,58834570,61704
14,ENSG00000183092.11,100587417,chr14-100641937-C-T,rs61993017,-1,C,T,100641937,54520,100390809,100784025,251128
14,ENSG00000092295.7,24263177,chr14-24266155-G-C,rs6573653,-1,G,C,24266155,2978,24066569,24459785,199586
14,ENSG00000100450.6,24609685,chr14-24418823-A-G,rs6573793,-1,A,G,24418823,190862,24413077,24806293,5746
14,ENSG00000185347.12,105491246,chr14-105441305-C-T,rs6576094,1,C,T,105441305,49941,105294638,105687854,146667
14,ENSG00000100591.3,77458093,chr14-77280504-C-G,rs71413457,1,C,G,77280504,177589,77261485,77654701,19019
14,ENSG00000087302.4,51989546,chr14-52028763-C-T,rs7144523,1,C,T,52028763,39217,51792938,52186154,235825
14,ENSG00000087302.4,51989546,chr14-52028763-C-G,rs7144523,1,C,G,52028763,39217,51792938,52186154,235825
14,ENSG00000119682.10,74713080,chr14-74521984-G-A,rs7145480,-1,G,A,74521984,191096,74516472,74909688,5512
14,ENSG00000140105.11,100375347,chr14-100489859-G-A,rs7156672,-1,G,A,100489859,114512,100178739,100571955,311120
14,ENSG00000165943.4,93184897,chr14-93163614-C-T,rs7157141,-1,C,T,93163614,21283,92988289,93381505,175325
14,ENSG00000196943.7,24299850,chr14-24248585-C-T,rs7158744,1,C,T,24248585,51265,24103242,24496458,145343
14,ENSG00000050130.12,59484517,chr14-59608600-A-T,rs726462,1,A,T,59608600,124083,59287909,59681125,320691
14,ENSG00000100485.7,50231578,chr14-50145739-C-T,rs726798,-1,C,T,50145739,85839,50034970,50428186,110769
14,ENSG00000151838.6,59576812,chr14-59566300-A-G,rs72714041,-1,A,G,59566300,10512,59380204,59773420,186096
14,ENSG00000029364.7,69398692,chr14-69525177-A-G,rs7350750,1,A,G,69525177,126485,69202084,69595300,323093
14,ENSG00000165389.6,34462240,chr14-34377603-T-C,rs74046048,-1,T,C,34377603,84637,34265632,34658848,111971
14,ENSG00000073712.9,52951050,chr14-52944673-C-T,rs7494379,-1,C,T,52944673,6377,52754442,53147658,190231
14,ENSG00000054690.9,67533290,chr14-67427391-C-T,rs75452946,1,C,T,67427391,105899,67336682,67729898,90709
14,ENSG00000100647.7,69611596,chr14-69631637-A-G,rs762049,1,A,G,69631637,20041,69414988,69808204,216649
14,ENSG00000100744.10,96363526,chr14-96317079-G-A,rs76710123,1,G,A,96317079,46447,96166918,96560134,150161
14,ENSG00000133943.14,91114073,chr14-91108136-G-T,rs76920016,1,G,T,91108136,5937,90917465,91310681,190671
14,ENSG00000015133.13,91417820,chr14-91536899-A-G,rs77541482,-1,A,G,91536899,119079,91221212,91614428,315687
14,ENSG00000015133.13,91417820,chr14-91536899-A-C,rs77541482,-1,A,C,91536899,119079,91221212,91614428,315687
14,ENSG00000196663.10,102362941,chr14-102429567-G-A,rs77694582,1,G,A,102429567,66626,102166333,102559549,263234
14,ENSG00000156030.8,73760303,chr14-73685259-C-T,rs77766862,-1,C,T,73685259,75044,73563695,73956911,121564
14,ENSG00000119636.11,74019349,chr14-73950293-G-T,rs78801603,1,G,T,73950293,69056,73822741,74215957,127552
14,ENSG00000176438.7,95516650,chr14-95436723-A-C,rs78849563,-1,A,C,95436723,79927,95320042,95713258,116681
14,ENSG00000165548.5,77181798,chr14-77159225-G-A,rs79934998,1,G,A,77159225,22573,76985190,77378406,174035
14,ENSG00000125384.6,52314312,chr14-52348463-G-A,rs80004022,1,G,A,52348463,34151,52117704,52510920,230759
14,ENSG00000100462.11,22929376,chr14-22778478-T-C,rs8013531,-1,T,C,22778478,150898,22732768,23125984,45710
14,ENSG00000205476.4,99604207,chr14-99585602-G-A,rs8015948,-1,G,A,99585602,18605,99407599,99800815,178003
14,ENSG00000165801.5,21070304,chr14-21069908-C-A,rs8019890,1,C,A,21069908,396,20873696,21266912,196212
14,ENSG00000100678.14,70188951,chr14-70134008-T-G,rs8022074,-1,T,G,70134008,54943,69992343,70385559,141665
14,ENSG00000100628.6,93976570,chr14-93837018-G-A,rs8023077,-1,G,A,93837018,139552,93779962,94173178,57056
14,ENSG00000176473.9,100376485,chr14-100426412-G-A,rs941924,1,G,A,100426412,49927,100179877,100573093,246535
14,ENSG00000140044.8,75428022,chr14-75335815-C-T,rs9671843,1,C,T,75335815,92207,75231414,75624630,104401
14,ENSG00000092010.10,24136194,chr14-24108807-C-T,rs973639,1,C,T,24108807,27387,23939586,24332802,169221
14,ENSG00000232070.4,21101103,chr14-20955642-A-G,rs10132319,1,A,G,20955642,145461,20904495,21297711,51147
14,ENSG00000139899.6,24429668,chr14-24434948-A-G,rs10134603,-1,A,G,24434948,5280,24233060,24626276,201888
14,ENSG00000179627.9,104801101,chr14-104958095-G-C,rs10137166,1,G,C,104958095,156994,104604493,104997709,353602
14,ENSG00000139880.14,23057520,chr14-23086863-A-G,rs10140923,-1,A,G,23086863,29343,22860912,23254128,225951
14,ENSG00000166428.8,104924879,chr14-105020176-C-T,rs10143367,1,C,T,105020176,95297,104728271,105121487,291905
14,ENSG00000072415.4,67241435,chr14-67076707-A-G,rs10144870,1,A,G,67076707,164728,67044827,67438043,31880
14,ENSG00000119655.4,74493305,chr14-74505305-A-T,rs10146812,-1,A,T,74505305,12000,74296697,74689913,208608
14,ENSG00000092054.11,23435660,chr14-23395407-T-C,rs10149618,-1,T,C,23395407,40253,23239052,23632268,156355
14,ENSG00000183648.3,92121706,chr14-92101525-A-G,rs10150904,-1,A,G,92101525,20181,91925098,92318314,176427
14,ENSG00000100478.10,31025649,chr14-30882579-C-T,rs10431648,1,C,T,30882579,143070,30829041,31222257,53538
14,ENSG00000100804.14,23034900,chr14-22987106-T-C,rs1043675,-1,T,C,22987106,47794,22838292,23231508,148814
14,ENSG00000133985.2,70641916,chr14-70672024-G-C,rs1050651,1,G,C,70672024,30108,70445308,70838524,226716
14,ENSG00000179454.7,44961947,chr14-44829411-T-C,rs111272844,-1,T,C,44829411,132536,44765339,45158555,64072
14,ENSG00000183576.8,99480859,chr14-99394503-A-G,rs11160518,-1,A,G,99394503,86356,99284251,99677467,110252
14,ENSG00000196943.7,24299850,chr14-24259088-G-T,rs1126432,1,G,T,24259088,40762,24103242,24496458,155846
14,ENSG00000196943.7,24299850,chr14-24259088-G-A,rs1126432,1,G,A,24259088,40762,24103242,24496458,155846
14,ENSG00000182400.10,39170333,chr14-39142041-T-C,rs114629800,-1,T,C,39142041,28292,38973725,39366941,168316
14,ENSG00000139998.9,64972336,chr14-65013490-T-C,rs11627382,-1,T,C,65013490,41154,64775728,65168944,237762
14,ENSG00000119707.9,73058534,chr14-72905021-T-C,rs11629006,1,T,C,72905021,153513,72861926,73255142,43095
14,ENSG00000100908.9,24141591,chr14-24108267-G-T,rs11629199,-1,G,T,24108267,33324,23944983,24338199,163284
14,ENSG00000184227.3,73537143,chr14-73536934-T-C,rs116671619,1,T,C,73536934,209,73340535,73733751,196399
14,ENSG00000042317.12,88385657,chr14-88325329-G-C,rs116917931,1,G,C,88325329,60328,88189049,88582265,136280
14,ENSG00000139985.4,70452174,chr14-70365396-C-T,rs117068537,1,C,T,70365396,86778,70255566,70648782,109830
14,ENSG00000092096.10,23352912,chr14-23305902-G-A,rs118050704,-1,G,A,23305902,47010,23156304,23549520,149598
14,ENSG00000165807.3,64549961,chr14-64670823-T-A,rs11846264,1,T,A,64670823,120862,64353353,64746569,317470
14,ENSG00000169413.2,20781268,chr14-20791876-A-G,rs11847602,1,A,G,20791876,10608,20584660,20977876,207216
14,ENSG00000100450.6,24609685,chr14-24703423-A-C,rs11848199,-1,A,C,24703423,93738,24413077,24806293,290346
14,ENSG00000181803.3,20641691,chr14-20658247-T-C,rs12372906,-1,T,C,20658247,16556,20445083,20838299,213164
14,ENSG00000100599.10,92513781,chr14-92431777-G-A,rs12432774,1,G,A,92431777,82004,92317173,92710389,114604
14,ENSG00000129484.9,20343635,chr14-20537917-A-G,rs1243702,1,A,G,20537917,194282,20147027,20540243,390890
14,ENSG00000100592.10,59188667,chr14-59269488-A-G,rs1253002,1,A,G,59269488,80821,58992059,59385275,277429
14,ENSG00000140009.14,64294371,chr14-64343287-G-A,rs1256114,-1,G,A,64343287,48916,64097763,64490979,245524
14,ENSG00000205476.4,99604207,chr14-99411275-C-T,rs1257262,-1,C,T,99411275,192932,99407599,99800815,3676
14,ENSG00000181619.10,59465380,chr14-59425073-C-T,rs1271183,-1,C,T,59425073,40307,59268772,59661988,156301
14,ENSG00000119714.6,91244704,chr14-91367649-A-G,rs1285813,-1,A,G,91367649,122945,91048096,91441312,319553
14,ENSG00000172590.13,22829887,chr14-22803905-T-C,rs12884337,1,T,C,22803905,25982,22633279,23026495,170626
14,ENSG00000165959.5,95319908,chr14-95345207-C-T,rs12884539,-1,C,T,95345207,25299,95123300,95516516,221907
14,ENSG00000165501.11,49598940,chr14-49619922-G-A,rs12887767,1,G,A,49619922,20982,49402332,49795548,217590
14,ENSG00000198805.6,20469406,chr14-20489607-A-G,rs12891826,1,A,G,20489607,20201,20272798,20666014,216809
14,ENSG00000140105.11,100375347,chr14-100378031-C-A,rs12897338,-1,C,A,100378031,2684,100178739,100571955,199292
14,ENSG00000140105.11,100375347,chr14-100378031-C-T,rs12897338,-1,C,T,100378031,2684,100178739,100571955,199292
14,ENSG00000072110.9,68979302,chr14-68874043-G-T,rs1475034,-1,G,T,68874043,105259,68782694,69175910,91349
14,ENSG00000087302.4,51989546,chr14-52006468-G-T,rs1476285,1,G,T,52006468,16922,51792938,52186154,213530
14,ENSG00000100865.10,102362890,chr14-102331718-G-A,rs1543540,-1,G,A,102331718,31172,102166282,102559498,165436
14,ENSG00000258289.2,64914455,chr14-64843649-C-T,rs1570295,1,C,T,64843649,70806,64717847,65111063,125802
14,ENSG00000198894.3,77098258,chr14-77094135-A-G,rs158123,1,A,G,77094135,4123,76901650,77294866,192485
14,ENSG00000170054.10,94476197,chr14-94628581-G-A,rs17091175,-1,G,A,94628581,152384,94279589,94672805,348992
14,ENSG00000213231.7,95686426,chr14-95674812-C-T,rs17093221,1,C,T,95674812,11614,95489818,95883034,184994
14,ENSG00000227051.4,96039362,chr14-95914899-C-T,rs17093543,1,C,T,95914899,124463,95842754,96235970,72145
14,ENSG00000092148.7,31207793,chr14-31086377-G-C,rs17097715,-1,G,C,31086377,121416,31011185,31404401,75192
14,ENSG00000100714.9,64388353,chr14-64326863-T-C,rs17101774,1,T,C,64326863,61490,64191745,64584961,135118
14,ENSG00000100433.11,88323269,chr14-88202156-A-G,rs17124250,-1,A,G,88202156,121113,88126661,88519877,75495
14,ENSG00000087303.11,52069059,chr14-52018479-G-A,rs17124893,-1,G,A,52018479,50580,51872451,52265667,146028
14,ENSG00000100532.7,54509906,chr14-54608509-G-A,rs17127660,1,G,A,54608509,98603,54313298,54706514,295211
14,ENSG00000139908.10,24205696,chr14-24197845-C-T,rs17184526,1,C,T,24197845,7851,24009088,24402304,188757
14,ENSG00000172717.10,67189393,chr14-67132611-G-C,rs17781208,1,G,C,67132611,56782,66992785,67386001,139826
14,ENSG00000172717.10,67189393,chr14-67132611-G-A,rs17781208,1,G,A,67132611,56782,66992785,67386001,139826
14,ENSG00000100557.5,57493857,chr14-57532149-C-T,rs17795775,-1,C,T,57532149,38292,57297249,57690465,234900
14,ENSG00000165555.5,77423523,chr14-77461737-C-T,rs17824238,-1,C,T,77461737,38214,77226915,77620131,234822
14,ENSG00000182512.4,95535050,chr14-95546128-A-G,rs17835086,1,A,G,95546128,11078,95338442,95731658,207686
14,ENSG00000092108.15,30622319,chr14-30758630-C-T,rs179547,1,C,T,30758630,136311,30425711,30818927,332919
14,ENSG00000165617.8,58637962,chr14-58702602-C-G,rs1846834,1,C,G,58702602,64640,58441354,58834570,261248
14,ENSG00000140090.12,92323165,chr14-92377336-T-C,rs1884678,1,T,C,92377336,54171,92126557,92519773,250779
14,ENSG00000020577.9,54567128,chr14-54638123-G-A,rs1886460,1,G,A,54638123,70995,54370520,54763736,267603
14,ENSG00000073712.9,52951050,chr14-52978517-T-C,rs1888597,-1,T,C,52978517,27467,52754442,53147658,224075
14,ENSG00000131323.10,102777449,chr14-102818542-A-G,rs1956160,1,A,G,102818542,41093,102580841,102974057,237701
14,ENSG00000119698.7,94174322,chr14-94349784-G-A,rs1956174,1,G,A,94349784,175462,93977714,94370930,372070
14,ENSG00000165389.6,34462240,chr14-34363239-A-G,rs1958584,-1,A,G,34363239,99001,34265632,34658848,97607
14,ENSG00000129521.8,33951074,chr14-33982750-C-T,rs2035423,-1,C,T,33982750,31676,33754466,34147682,228284
14,ENSG00000063761.11,77800109,chr14-77625076-A-G,rs2037933,1,A,G,77625076,175033,77603501,77996717,21575
14,ENSG00000100596.2,77616637,chr14-77625076-A-G,rs2037933,-1,A,G,77625076,8439,77420029,77813245,205047
14,ENSG00000119669.3,77028708,chr14-76965415-A-G,rs2041962,-1,A,G,76965415,63293,76832100,77225316,133315
14,ENSG00000133962.3,91732086,chr14-91864475-G-A,rs2052204,-1,G,A,91864475,132389,91535478,91928694,328997
14,ENSG00000119718.5,75002921,chr14-74821815-A-G,rs2058918,1,A,G,74821815,181106,74806313,75199529,15502
14,ENSG00000100580.7,77377094,chr14-77557439-C-T,rs2272589,-1,C,T,77557439,180345,77180486,77573702,376953
14,ENSG00000257365.2,64986895,chr14-64805062-G-A,rs2277503,1,G,A,64805062,181833,64790287,65183503,14775
14,ENSG00000213906.4,24310140,chr14-24210671-C-T,rs2295322,1,C,T,24210671,99469,24113532,24506748,97139
14,ENSG00000140092.10,91947694,chr14-91888773-C-A,rs2430353,-1,C,A,91888773,58921,91751086,92144302,137687
14,ENSG00000165792.11,20989980,chr14-20987933-C-A,rs2741729,1,C,A,20987933,2047,20793372,21186588,194561
14,ENSG00000140104.9,104985788,chr14-104918718-C-T,rs2841267,1,C,T,104918718,67070,104789180,105182396,129538
14,ENSG00000100883.7,34982992,chr14-35167405-A-C,rs28723612,1,A,C,35167405,184413,34786384,35179600,381021
14,ENSG00000119640.4,75064024,chr14-75048990-C-T,rs28756980,-1,C,T,75048990,15034,74867416,75260632,181574
14,ENSG00000170348.4,75176612,chr14-75047123-T-C,rs28756992,-1,T,C,75047123,129489,74980004,75373220,67119
14,ENSG00000213920.4,24216066,chr14-24238273-G-A,rs34354104,-1,G,A,24238273,22207,24019458,24412674,218815
14,ENSG00000134001.7,67360328,chr14-67508319-A-G,rs34393725,1,A,G,67508319,147991,67163720,67556936,344599
14,ENSG00000100442.6,45134481,chr14-45231029-A-C,rs34842824,-1,A,C,45231029,96548,44937873,45331089,293156
14,ENSG00000092098.10,24147498,chr14-24260481-C-T,rs35755034,1,C,T,24260481,112983,23950890,24344106,309591
14,ENSG00000198252.7,52730166,chr14-52724929-G-A,rs3783447,1,G,A,52724929,5237,52533558,52926774,191371
14,ENSG00000100600.9,92748627,chr14-92711055-C-T,rs3783933,-1,C,T,92711055,37572,92552019,92945235,159036
14,ENSG00000198668.6,90397029,chr14-90406669-T-G,rs3814843,1,T,G,90406669,9640,90200421,90593637,206248
14,ENSG00000165948.6,94081310,chr14-94100621-G-T,rs3818118,1,G,T,94100621,19311,93884702,94277918,215919
14,ENSG00000165948.6,94081310,chr14-94100621-G-A,rs3818118,1,G,A,94100621,19311,93884702,94277918,215919
14,ENSG00000140030.4,88005135,chr14-87916754-A-G,rs382299,1,A,G,87916754,88381,87808527,88201743,108227
14,ENSG00000126790.7,59484408,chr14-59390859-T-C,rs3850302,-1,T,C,59390859,93549,59287800,59681016,103059
14,ENSG00000119650.8,75985763,chr14-75972811-C-T,rs3917172,1,C,T,75972811,12952,75789155,76182371,183656
14,ENSG00000165502.6,49620626,chr14-49641944-T-C,rs41345247,-1,T,C,49641944,21318,49424018,49817234,217926
14,ENSG00000139910.15,26598033,chr14-26663456-T-C,rs4141701,-1,T,C,26663456,65423,26401425,26794641,262031
14,ENSG00000054983.11,87993182,chr14-87920050-G-A,rs437801,-1,G,A,87920050,73132,87796574,88189790,123476
14,ENSG00000100814.12,20333279,chr14-20325734-C-A,rs45451995,-1,C,A,20325734,7545,20136671,20529887,189063
14,ENSG00000100505.9,51095105,chr14-51172859-G-A,rs4898682,-1,G,A,51172859,77754,50898497,51291713,274362
14,ENSG00000198208.6,74923260,chr14-74874115-G-A,rs4903262,-1,G,A,74874115,49145,74726652,75119868,147463
14,ENSG00000090061.12,99481409,chr14-99346338-A-G,rs4905830,1,A,G,99346338,135071,99284801,99678017,61537
14,ENSG00000165801.5,21070304,chr14-21062373-G-A,rs4982401,1,G,A,21062373,7931,20873696,21266912,188677
14,ENSG00000100739.6,96256210,chr14-96241120-A-G,rs5224,1,A,G,96241120,15090,96059602,96452818,181518
14,ENSG00000213145.5,105486886,chr14-105476010-C-G,rs55662446,1,C,G,105476010,10876,105290278,105683494,185732
14,ENSG00000156050.4,73950094,chr14-73806802-C-T,rs55776319,-1,C,T,73806802,143292,73753486,74146702,53316
14,ENSG00000187105.4,73558947,chr14-73676315-T-C,rs56277391,-1,T,C,73676315,117368,73362339,73755555,313976
14,ENSG00000006432.10,70809513,chr14-70865550-C-T,rs58788626,-1,C,T,70865550,56037,70612905,71006121,252645
14,ENSG00000185347.12,105491246,chr14-105431071-G-A,rs60686524,1,G,A,105431071,60175,105294638,105687854,136433
14,ENSG00000089775.6,64503838,chr14-64456448-G-T,rs6573559,-1,G,T,64456448,47390,64307230,64700446,149218
14,ENSG00000125378.10,53956825,chr14-53765279-T-C,rs7140669,-1,T,C,53765279,191546,53760217,54153433,5062
14,ENSG00000100601.5,77708023,chr14-77664236-C-T,rs7151836,-1,C,T,77664236,43787,77511415,77904631,152821
14,ENSG00000165782.6,20461434,chr14-20338136-G-T,rs7153417,-1,G,T,20338136,123298,20264826,20658042,73310
14,ENSG00000197555.5,71320476,chr14-71284403-C-T,rs7155371,1,C,T,71284403,36073,71123868,71517084,160535
14,ENSG00000100628.6,93976570,chr14-93814731-T-C,rs7157081,-1,T,C,93814731,161839,93779962,94173178,34769
14,ENSG00000166170.9,103562657,chr14-103611274-T-C,rs7157116,-1,T,C,103611274,48617,103366049,103759265,245225
14,ENSG00000125954.7,64914493,chr14-64983912-G-T,rs7160073,1,G,T,64983912,69419,64717885,65111101,266027
14,ENSG00000092330.11,24242623,chr14-24204769-G-A,rs7160883,-1,G,A,24204769,37854,24046015,24439231,158754
14,ENSG00000165929.8,91867536,chr14-92057795-A-G,rs723303,-1,A,G,92057795,190259,91670928,92064144,386867
14,ENSG00000166126.6,102922663,chr14-103112491-A-G,rs72706644,1,A,G,103112491,189828,102726055,103119271,386436
14,ENSG00000165943.4,93184897,chr14-93369923-G-A,rs72708599,-1,G,A,93369923,185026,92988289,93381505,381634
14,ENSG00000054690.9,67533290,chr14-67546192-C-T,rs72721031,1,C,T,67546192,12902,67336682,67729898,209510
14,ENSG00000185271.6,20436166,chr14-20251262-A-G,rs73581370,-1,A,G,20251262,184904,20239558,20632774,11704
14,ENSG00000119711.8,74084453,chr14-73960151-T-C,rs740505,-1,T,C,73960151,124302,73887845,74281061,72306
14,ENSG00000119614.2,74239449,chr14-74226321-G-T,rs74457160,1,G,T,74226321,13128,74042841,74436057,183480
14,ENSG00000100564.4,67600268,chr14-67538430-T-C,rs753683,-1,T,C,67538430,61838,67403660,67796876,134770
14,ENSG00000119689.10,74881916,chr14-74935171-C-T,rs75897219,1,C,T,74935171,53255,74685308,75078524,249863
14,ENSG00000015133.13,91417820,chr14-91285642-A-G,rs76612086,-1,A,G,91285642,132178,91221212,91614428,64430
14,ENSG00000100941.4,39175254,chr14-39002321-A-G,rs78875157,1,A,G,39002321,172933,38978646,39371862,23675
14,ENSG00000100721.6,95714125,chr14-95696081-G-A,rs78986913,-1,G,A,95696081,18044,95517517,95910733,178564
14,ENSG00000129562.5,22589224,chr14-22594730-C-T,rs8003791,-1,C,T,22594730,5506,22392616,22785832,202114
14,ENSG00000185215.4,103123461,chr14-103150781-G-A,rs8004470,1,G,A,103150781,27320,102926853,103320069,223928
14,ENSG00000165410.10,34714593,chr14-34715335-T-C,rs8005490,-1,T,C,34715335,742,34517985,34911201,197350
14,ENSG00000100647.7,69611596,chr14-69568783-T-C,rs8008869,1,T,C,69568783,42813,69414988,69808204,153795
14,ENSG00000139974.11,60981245,chr14-61121731-C-A,rs80106619,1,C,A,61121731,140486,60784637,61177853,337094
14,ENSG00000009830.6,77320883,chr14-77482223-A-G,rs8010861,-1,A,G,77482223,161340,77124275,77517491,357948
14,ENSG00000156127.6,75522469,chr14-75439679-T-C,rs8013023,1,T,C,75439679,82790,75325861,75719077,113818
14,ENSG00000119608.7,74876145,chr14-74942580-C-T,rs8017577,-1,C,T,74942580,66435,74679537,75072753,263043
14,ENSG00000119608.7,74876145,chr14-74942580-C-A,rs8017577,-1,C,A,74942580,66435,74679537,75072753,263043
14,ENSG00000139921.8,51240247,chr14-51045115-G-T,rs8018259,1,G,T,51045115,195132,51043639,51436855,1476
14,ENSG00000119725.10,73886859,chr14-73852011-A-G,rs8020267,1,A,G,73852011,34848,73690251,74083467,161760
14,ENSG00000186469.4,51860612,chr14-51852063-C-T,rs8021633,1,C,T,51852063,8549,51664004,52057220,188059
14,ENSG00000100577.14,77321036,chr14-77321363-C-G,rs8177538,1,C,G,77321363,327,77124428,77517644,196935
14,ENSG00000042088.9,89955927,chr14-89956320-T-C,rs942190,1,T,C,89956320,393,89759319,90152535,197001
14,ENSG00000140022.4,81400324,chr14-81454892-G-T,rs961096,-1,G,T,81454892,54568,81203716,81596932,251176
14,ENSG00000179841.7,64465499,chr14-64595268-A-G,rs971736,1,A,G,64595268,129769,64268891,64662107,326377
14,ENSG00000100664.6,103334237,chr14-103255911-C-A,rs9743995,1,C,A,103255911,78326,103137629,103530845,118282
14,ENSG00000071246.5,76761468,chr14-76801039-C-G,rs9972223,1,C,G,76801039,39571,76564860,76958076,236179
13,ENSG00000139508.10,28718970,chr13-28750546-C-T,rs1005969,-1,C,T,28750546,31576,28522362,28915578,228184
13,ENSG00000186184.11,27621892,chr13-27625231-T-A,rs10492487,1,T,A,27625231,3339,27425284,27818500,199947
13,ENSG00000151287.12,102773786,chr13-102788397-C-T,rs111300036,-1,C,T,102788397,14611,102577178,102970394,211219
13,ENSG00000150403.13,113491021,chr13-113521558-A-G,rs11164137,1,A,G,113521558,30537,113294413,113687629,227145
13,ENSG00000150403.13,113491021,chr13-113521558-A-T,rs11164137,1,A,T,113521558,30537,113294413,113687629,227145
13,ENSG00000185950.7,109786583,chr13-109893359-C-T,rs111919531,-1,C,T,109893359,106776,109589975,109983191,303384
13,ENSG00000136167.8,46182177,chr13-46126507-G-T,rs11342,-1,G,T,46126507,55670,45985569,46378785,140938
13,ENSG00000139842.10,113209613,chr13-113326272-G-A,rs113680829,1,G,A,113326272,116659,113013005,113406221,313267
13,ENSG00000139746.10,79406255,chr13-79314341-T-C,rs1155848,-1,T,C,79314341,91914,79209647,79602863,104694
13,ENSG00000205863.4,23897006,chr13-23900585-G-A,rs11617793,-1,G,A,23900585,3579,23700398,24093614,200187
13,ENSG00000165416.9,52652836,chr13-52735754-C-T,rs11619426,1,C,T,52735754,82918,52456228,52849444,279526
13,ENSG00000120685.13,39038089,chr13-38997676-G-A,rs117116799,-1,G,A,38997676,40413,38841481,39234697,156195
13,ENSG00000120697.4,36999340,chr13-37093871-G-C,rs1199960,-1,G,C,37093871,94531,36802732,37195948,291139
13,ENSG00000187676.6,31199975,chr13-31240181-T-C,rs12428887,1,T,C,31240181,40206,31003367,31396583,236814
13,ENSG00000125247.11,100674795,chr13-100719133-G-A,rs1283213,-1,G,A,100719133,44338,100478187,100871403,240946
13,ENSG00000136153.13,75636330,chr13-75585853-A-G,rs12866456,1,A,G,75585853,50477,75439722,75832938,146131
13,ENSG00000118939.10,75549791,chr13-75556625-T-C,rs1323696,1,T,C,75556625,6834,75353183,75746399,203442
13,ENSG00000204899.5,72727629,chr13-72727590-T-C,rs1465896,-1,T,C,72727590,39,72531021,72924237,196569
13,ENSG00000136104.10,50909791,chr13-50811286-G-A,rs1570603,1,G,A,50811286,98505,50713183,51106399,98103
13,ENSG00000134873.4,95552720,chr13-95410192-T-C,rs16951074,1,T,C,95410192,142528,95356112,95749328,54080
13,ENSG00000174405.8,108215536,chr13-108184034-C-T,rs16972098,-1,C,T,108184034,31502,108018928,108412144,165106
13,ENSG00000102471.9,79481155,chr13-79357279-A-C,rs17071316,1,A,C,79357279,123876,79284547,79677763,72732
13,ENSG00000120675.4,43023586,chr13-43023570-C-T,rs17553284,1,C,T,43023570,16,42826978,43220194,196592
13,ENSG00000169508.6,99307399,chr13-99366033-A-G,rs1923896,-1,A,G,99366033,58634,99110791,99504007,255242
13,ENSG00000173988.7,46211943,chr13-46100774-G-A,rs1952187,1,G,A,46100774,111169,46015335,46408551,85439
13,ENSG00000136141.9,46553170,chr13-46578807-T-C,rs2005053,1,T,C,46578807,25637,46356562,46749778,222245
13,ENSG00000139835.8,113364130,chr13-113357874-G-T,rs2018093,-1,G,T,113357874,6256,113167522,113560738,190352
13,ENSG00000151773.6,43879740,chr13-43924877-T-C,rs2028812,-1,T,C,43924877,45137,43683132,44076348,241745
13,ENSG00000126226.14,113208669,chr13-113245883-G-A,rs2302756,-1,G,A,113245883,37214,113012061,113405277,233822
13,ENSG00000139618.9,32315508,chr13-32336191-T-C,rs2320236,1,T,C,32336191,20683,32118900,32512116,217291
13,ENSG00000122042.9,29850617,chr13-29850490-C-T,rs278037,-1,C,T,29850490,127,29654009,30047225,196481
13,ENSG00000068650.12,112690038,chr13-112781013-G-A,rs282625,1,G,A,112781013,90975,112493430,112886646,287583
13,ENSG00000132958.12,19503279,chr13-19527824-T-A,rs3002099,-1,T,A,19527824,24545,19306671,19699887,221153
13,ENSG00000088448.9,110915069,chr13-110790613-T-C,rs328801,-1,T,C,110790613,124456,110718461,111111677,72152
13,ENSG00000123179.8,49691486,chr13-49691973-T-C,rs3809325,-1,T,C,49691973,487,49494878,49888094,197095
13,ENSG00000150456.5,20773961,chr13-20755646-G-A,rs3923852,-1,G,A,20755646,18315,20577353,20970569,178293
13,ENSG00000133116.6,33016423,chr13-33013191-T-C,rs397703,1,T,C,33013191,3232,32819815,33213031,193376
13,ENSG00000184226.10,67230336,chr13-67242603-C-T,rs4132816,-1,C,T,67242603,12267,67033728,67426944,208875
13,ENSG00000125257.9,95301451,chr13-95246257-C-T,rs4148439,-1,C,T,95246257,55194,95104843,95498059,141414
13,ENSG00000139832.3,110561722,chr13-110471908-G-A,rs4284503,-1,G,A,110471908,89814,110365114,110758330,106794
13,ENSG00000180776.11,21459303,chr13-21362618-G-C,rs4770147,-1,G,C,21362618,96685,21262695,21655911,99923
13,ENSG00000126231.8,113158648,chr13-113176145-C-A,rs4907593,1,C,A,113176145,17497,112962040,113355256,214105
13,ENSG00000126231.8,113158648,chr13-113176145-C-T,rs4907593,1,C,T,113176145,17497,112962040,113355256,214105
13,ENSG00000136152.10,45464939,chr13-45459830-G-T,rs4942416,1,G,T,45459830,5109,45268331,45661547,191499
13,ENSG00000102547.13,49444064,chr13-49624022-G-A,rs4942859,-1,G,A,49624022,179958,49247456,49640672,376566
13,ENSG00000139505.9,25287488,chr13-25420938-A-G,rs514065,-1,A,G,25420938,133450,25090880,25484096,330058
13,ENSG00000023516.7,42272152,chr13-42124149-A-G,rs614000,1,A,G,42124149,148003,42075544,42468760,48605
13,ENSG00000174032.11,45418373,chr13-45530714-C-T,rs62637564,-1,C,T,45530714,112341,45221765,45614981,308949
13,ENSG00000136169.11,49444274,chr13-49553384-T-C,rs6561542,1,T,C,49553384,109110,49247666,49640882,305718
13,ENSG00000253710.1,52012398,chr13-52044661-T-C,rs6650383,1,T,C,52044661,32263,51815790,52209006,228871
13,ENSG00000120696.7,41194569,chr13-41144691-T-A,rs687410,-1,T,A,41144691,49878,40997961,41391177,146730
13,ENSG00000120696.7,41194569,chr13-41144691-T-G,rs687410,-1,T,G,41144691,49878,40997961,41391177,146730
13,ENSG00000136144.7,49585558,chr13-49634810-A-G,rs7320206,-1,A,G,49634810,49252,49388950,49782166,245860
13,ENSG00000179630.5,43879904,chr13-43915466-C-T,rs7322107,1,C,T,43915466,35562,43683296,44076512,232170
13,ENSG00000133112.12,45341183,chr13-45390657-C-T,rs7322491,-1,C,T,45390657,49474,45144575,45537791,246082
13,ENSG00000120659.10,42574152,chr13-42472261-G-A,rs7322806,1,G,A,42472261,101891,42377544,42770760,94717
13,ENSG00000102760.12,41457550,chr13-41473239-C-G,rs7328265,1,C,G,41473239,15689,41260942,41654158,212297
13,ENSG00000102760.12,41457550,chr13-41473239-C-T,rs7328265,1,C,T,41473239,15689,41260942,41654158,212297
13,ENSG00000139515.5,27920000,chr13-27945240-C-T,rs7333200,1,C,T,27945240,25240,27723392,28116608,221848
13,ENSG00000139515.5,27920000,chr13-27945240-C-A,rs7333200,1,C,A,27945240,25240,27723392,28116608,221848
13,ENSG00000178695.4,76886405,chr13-76804925-T-C,rs7335387,-1,T,C,76804925,81480,76689797,77083013,115128
13,ENSG00000102743.8,40789611,chr13-40779161-G-A,rs7337312,1,G,A,40779161,10450,40593003,40986219,186158
13,ENSG00000139597.11,32428130,chr13-32572361-A-G,rs7339139,-1,A,G,32572361,144231,32231522,32624738,340839
13,ENSG00000121743.3,20161052,chr13-20161167-C-T,rs73444434,-1,C,T,20161167,115,19964444,20357660,196723
13,ENSG00000213995.5,110615545,chr13-110639697-A-G,rs7394,1,A,G,110639697,24152,110418937,110812153,220760
13,ENSG00000183087.9,113864076,chr13-113882481-G-A,rs7490083,-1,G,A,113882481,18405,113667468,114060684,215013
13,ENSG00000102543.10,49247925,chr13-49054723-G-A,rs76381049,1,G,A,49054723,193202,49051317,49444533,3406
13,ENSG00000139517.6,27620529,chr13-27583898-G-C,rs76900683,-1,G,C,27583898,36631,27423921,27817137,159977
13,ENSG00000126217.15,112969214,chr13-112976094-G-A,rs78105344,1,G,A,112976094,6880,112772606,113165822,203488
13,ENSG00000102755.5,28495128,chr13-28305915-G-A,rs78547573,-1,G,A,28305915,189213,28298520,28691736,7395
13,ENSG00000165474.5,20192938,chr13-20194005-A-G,rs7987144,-1,A,G,20194005,1067,19996330,20389546,197675
13,ENSG00000130177.10,114234897,chr13-114242913-T-C,rs7994573,1,T,C,114242913,8016,114038289,114431505,204624
13,ENSG00000136143.7,48001273,chr13-47992487-G-A,rs7997802,-1,G,A,47992487,8786,47804665,48197881,187822
13,ENSG00000122034.8,27424619,chr13-27425320-T-C,rs7998978,1,T,C,27425320,701,27228011,27621227,197309
13,ENSG00000136161.7,48533080,chr13-48591739-G-A,rs8002098,-1,G,A,48591739,58659,48336472,48729688,255267
13,ENSG00000152207.3,48653929,chr13-48591739-G-A,rs8002098,1,G,A,48591739,62190,48457321,48850537,134418
13,ENSG00000080618.8,46105033,chr13-46067331-A-G,rs9316179,-1,A,G,46067331,37702,45908425,46301641,158906
13,ENSG00000102445.13,46387252,chr13-46397645-A-C,rs9316202,-1,A,C,46397645,10393,46190644,46583860,207001
13,ENSG00000102753.5,49792682,chr13-49619137-G-A,rs9316467,-1,G,A,49619137,173545,49596074,49989290,23063
13,ENSG00000165572.6,41132802,chr13-41246241-T-C,rs944790,-1,T,C,41246241,113439,40936194,41329410,310047
13,ENSG00000132950.14,19863649,chr13-19900631-G-A,rs9506395,-1,G,A,19900631,36982,19667041,20060257,233590
13,ENSG00000032742.12,20567157,chr13-20635498-A-G,rs9509311,1,A,G,20635498,68341,20370549,20763765,264949
13,ENSG00000150457.6,21061586,chr13-21020560-C-T,rs9509487,-1,C,T,21020560,41026,20864978,21258194,155582
13,ENSG00000134864.5,100588789,chr13-100565420-G-A,rs9513762,-1,G,A,100565420,23369,100392181,100785397,173239
13,ENSG00000102554.7,73059005,chr13-73065233-G-A,rs9530143,1,G,A,73065233,6228,72862397,73255613,202836
13,ENSG00000133106.10,42992241,chr13-42996885-A-G,rs9533339,-1,A,G,42996885,4644,42795633,43188849,201252
13,ENSG00000120658.8,43786972,chr13-43702297-T-C,rs9533592,-1,T,C,43702297,84675,43590364,43983580,111933
13,ENSG00000152213.3,49628507,chr13-49620258-G-A,rs9535274,1,G,A,49620258,8249,49431899,49825115,188359
13,ENSG00000136108.8,52455478,chr13-52456430-G-A,rs9536079,1,G,A,52456430,952,52258870,52652086,197560
13,ENSG00000134882.11,99200854,chr13-99267651-G-A,rs9554579,1,G,A,99267651,66797,99004246,99397462,263405
13,ENSG00000134905.10,110706116,chr13-110701763-T-C,rs9555724,-1,T,C,110701763,4353,110509508,110902724,192255
13,ENSG00000186009.3,113658198,chr13-113609816-C-T,rs9577593,-1,C,T,113609816,48382,113461590,113854806,148226
13,ENSG00000150401.10,113490711,chr13-113612442-G-A,rs9577594,-1,G,A,113612442,121731,113294103,113687319,318339
13,ENSG00000102699.5,24512778,chr13-24490516-C-A,rs9581073,-1,C,A,24490516,22262,24316170,24709386,174346
13,ENSG00000102606.11,111115310,chr13-111210920-A-C,rs9588382,1,A,C,111210920,95610,110918702,111311918,292218
13,ENSG00000152193.7,78659155,chr13-78582375-C-T,rs9593344,-1,C,T,78582375,76780,78462547,78855763,119828
13,ENSG00000253309.2,51339691,chr13-51268377-A-G,rs9596491,1,A,G,51268377,71314,51143083,51536299,125294
13,ENSG00000165487.8,21604170,chr13-21509207-G-A,rs9634371,-1,G,A,21509207,94963,21407562,21800778,101645
13,ENSG00000122034.8,27424619,chr13-27473132-A-G,rs1006353,1,A,G,27473132,48513,27228011,27621227,245121
13,ENSG00000123179.8,49691486,chr13-49674730-C-A,rs1061979,-1,C,A,49674730,16756,49494878,49888094,179852
13,ENSG00000133101.4,36432495,chr13-36511536-C-T,rs111710500,1,C,T,36511536,79041,36235887,36629103,275649
13,ENSG00000183087.9,113864076,chr13-113805304-A-G,rs111801150,-1,A,G,113805304,58772,113667468,114060684,137836
13,ENSG00000189167.6,32315363,chr13-32320601-G-A,rs11571591,-1,G,A,32320601,5238,32118755,32511971,201846
13,ENSG00000134905.10,110706116,chr13-110515871-C-T,rs11617144,-1,C,T,110515871,190245,110509508,110902724,6363
13,ENSG00000150893.9,38687077,chr13-38871014-A-C,rs117899494,1,A,C,38871014,183937,38490469,38883685,380545
13,ENSG00000139508.10,28718970,chr13-28612345-C-T,rs11843285,-1,C,T,28612345,106625,28522362,28915578,89983
13,ENSG00000125247.11,100674795,chr13-100650579-C-T,rs1283225,-1,C,T,100650579,24216,100478187,100871403,172392
13,ENSG00000102445.13,46387252,chr13-46334263-T-C,rs12865017,-1,T,C,46334263,52989,46190644,46583860,143619
13,ENSG00000136108.8,52455478,chr13-52429772-A-G,rs12870706,1,A,G,52429772,25706,52258870,52652086,170902
13,ENSG00000122033.9,27450564,chr13-27515408-G-A,rs12872402,-1,G,A,27515408,64844,27253956,27647172,261452
13,ENSG00000121741.10,19958727,chr13-19997867-T-G,rs12877070,1,T,G,19997867,39140,19762119,20155335,235748
13,ENSG00000186184.11,27621892,chr13-27592371-A-G,rs1575523,1,A,G,27592371,29521,27425284,27818500,167087
13,ENSG00000125257.9,95301451,chr13-95236428-T-A,rs16950824,-1,T,A,95236428,65023,95104843,95498059,131585
13,ENSG00000102780.11,42048648,chr13-42023148-A-G,rs17062732,1,A,G,42023148,25500,41852040,42245256,171108
13,ENSG00000151773.6,43879740,chr13-43870854-T-C,rs17065166,-1,T,C,43870854,8886,43683132,44076348,187722
13,ENSG00000005812.6,77027159,chr13-77111898-T-C,rs17067210,-1,T,C,77111898,84739,76830551,77223767,281347
13,ENSG00000179630.5,43879904,chr13-43898099-C-T,rs17462017,1,C,T,43898099,18195,43683296,44076512,214803
13,ENSG00000088387.12,98978064,chr13-99063254-C-T,rs17724691,-1,C,T,99063254,85190,98781456,99174672,281798
13,ENSG00000102781.9,30307551,chr13-30240825-G-A,rs202095,-1,G,A,30240825,66726,30110943,30504159,129882
13,ENSG00000165487.8,21604170,chr13-21574294-A-G,rs2185884,-1,A,G,21574294,29876,21407562,21800778,166732
13,ENSG00000139675.10,52642431,chr13-52764655-T-G,rs2214422,1,T,G,52764655,122224,52445823,52839039,318832
13,ENSG00000153495.6,111320642,chr13-111280751-C-G,rs2296353,1,C,G,111280751,39891,111124034,111517250,156717
13,ENSG00000187676.6,31199975,chr13-31263419-G-A,rs33962985,1,G,A,31263419,63444,31003367,31396583,260052
13,ENSG00000102760.12,41457550,chr13-41522908-A-G,rs348218,1,A,G,41522908,65358,41260942,41654158,261966
13,ENSG00000102699.5,24512778,chr13-24490319-G-A,rs3783076,-1,G,A,24490319,22459,24316170,24709386,174149
13,ENSG00000182957.8,24160720,chr13-24304328-A-G,rs3803218,1,A,G,24304328,143608,23964112,24357328,340216
13,ENSG00000118939.10,75549791,chr13-75622731-C-T,rs3818355,1,C,T,75622731,72940,75353183,75746399,269548
13,ENSG00000132952.7,30617920,chr13-30736835-T-C,rs4075132,1,T,C,30736835,118915,30421312,30814528,315523
13,ENSG00000102547.13,49444064,chr13-49512108-A-G,rs4340215,-1,A,G,49512108,68044,49247456,49640672,264652
13,ENSG00000150456.5,20773961,chr13-20782511-T-A,rs4617691,-1,T,A,20782511,8550,20577353,20970569,205158
13,ENSG00000169508.6,99307399,chr13-99115323-T-C,rs4772174,-1,T,C,99115323,192076,99110791,99504007,4532
13,ENSG00000213995.5,110615545,chr13-110592745-A-G,rs4773225,1,A,G,110592745,22800,110418937,110812153,173808
13,ENSG00000120659.10,42574152,chr13-42434041-A-G,rs4941428,1,A,G,42434041,140111,42377544,42770760,56497
13,ENSG00000152213.3,49628507,chr13-49625872-C-T,rs4941653,1,C,T,49625872,2635,49431899,49825115,193973
13,ENSG00000136169.11,49444274,chr13-49507222-C-T,rs4942833,1,C,T,49507222,62948,49247666,49640882,259556
13,ENSG00000133116.6,33016423,chr13-33036014-T-G,rs577912,1,T,G,33036014,19591,32819815,33213031,216199
13,ENSG00000136161.7,48533080,chr13-48579592-G-A,rs6561462,-1,G,A,48579592,46512,48336472,48729688,243120
13,ENSG00000153487.11,110713700,chr13-110696780-T-C,rs6650307,1,T,C,110696780,16920,110517092,110910308,179688
13,ENSG00000133121.14,33285755,chr13-33188636-G-A,rs703232,-1,G,A,33188636,97119,33089147,33482363,99489
13,ENSG00000134899.12,102846032,chr13-102907560-C-G,rs7317094,1,C,G,102907560,61528,102649424,103042640,258136
13,ENSG00000134899.12,102846032,chr13-102907560-C-T,rs7317094,1,C,T,102907560,61528,102649424,103042640,258136
13,ENSG00000198033.5,19181824,chr13-19159234-G-A,rs7319134,-1,G,A,19159234,22590,18985216,19378432,174018
13,ENSG00000134901.7,102798976,chr13-102952482-C-T,rs7322462,-1,C,T,102952482,153506,102602368,102995584,350114
13,ENSG00000174405.8,108215536,chr13-108220173-T-C,rs7322498,-1,T,C,108220173,4637,108018928,108412144,201245
13,ENSG00000152207.3,48653929,chr13-48636461-C-T,rs7332030,1,C,T,48636461,17468,48457321,48850537,179140
13,ENSG00000136146.8,48095104,chr13-48092625-C-G,rs7332363,-1,C,G,48092625,2479,47898496,48291712,194129
13,ENSG00000102595.12,96053401,chr13-96036394-C-G,rs7334508,-1,C,G,96036394,17007,95856793,96250009,179601
13,ENSG00000102738.6,40771190,chr13-40814340-G-A,rs7335572,-1,G,A,40814340,43150,40574582,40967798,239758
13,ENSG00000134873.4,95552720,chr13-95470832-T-G,rs7335697,1,T,G,95470832,81888,95356112,95749328,114720
13,ENSG00000204977.5,49997042,chr13-50174148-G-A,rs796906,1,G,A,50174148,177106,49800434,50193650,373714
13,ENSG00000102606.11,111115310,chr13-111228468-G-A,rs7982732,1,G,A,111228468,113158,110918702,111311918,309766
13,ENSG00000130177.10,114234897,chr13-114202747-T-G,rs7987202,1,T,G,114202747,32150,114038289,114431505,164458
13,ENSG00000133106.10,42992241,chr13-42949965-G-C,rs7989235,-1,G,C,42949965,42276,42795633,43188849,154332
13,ENSG00000102678.6,21671073,chr13-21750516-T-C,rs80139898,1,T,C,21750516,79443,21474465,21867681,276051
13,ENSG00000102796.6,51804163,chr13-51839852-A-T,rs9285180,-1,A,T,51839852,35689,51607555,52000771,232297
13,ENSG00000126216.8,112588153,chr13-112620037-C-A,rs942919,-1,C,A,112620037,31884,112391545,112784761,228492
13,ENSG00000027001.7,23889400,chr13-23808832-T-G,rs9510867,-1,T,G,23808832,80568,23692792,24086008,116040
13,ENSG00000205863.4,23897006,chr13-23868707-C-T,rs9510917,-1,C,T,23868707,28299,23700398,24093614,168309
13,ENSG00000132958.12,19503279,chr13-19390579-A-G,rs9512911,-1,A,G,19390579,112700,19306671,19699887,83908
13,ENSG00000134864.5,100588789,chr13-100661852-C-T,rs9513779,-1,C,T,100661852,73063,100392181,100785397,269671
13,ENSG00000139832.3,110561722,chr13-110557066-C-T,rs9521840,-1,C,T,110557066,4656,110365114,110758330,191952
13,ENSG00000120693.9,36920238,chr13-36982271-A-G,rs9532004,-1,A,G,36982271,62033,36723630,37116846,258641
13,ENSG00000102743.8,40789611,chr13-40875601-G-T,rs9532631,1,G,T,40875601,85990,40593003,40986219,282598
13,ENSG00000102763.9,41961109,chr13-42080053-G-A,rs9532991,-1,G,A,42080053,118944,41764501,42157717,315552
13,ENSG00000126226.14,113208669,chr13-113190140-C-G,rs9549687,-1,C,G,113190140,18529,113012061,113405277,178079
13,ENSG00000152749.7,94601857,chr13-94584571-A-G,rs9556403,1,A,G,94584571,17286,94405249,94798465,179322
13,ENSG00000179399.9,91398621,chr13-91443753-A-G,rs9560796,1,A,G,91443753,45132,91202013,91595229,241740
13,ENSG00000123178.9,49936340,chr13-49935648-C-A,rs9562941,-1,C,A,49935648,692,49739732,50132948,195916
13,ENSG00000120697.4,36999340,chr13-37019287-T-C,rs9566175,-1,T,C,37019287,19947,36802732,37195948,216555
13,ENSG00000126231.8,113158648,chr13-113288786-T-C,rs9577223,1,T,C,113288786,130138,112962040,113355256,326746
13,ENSG00000139835.8,113364130,chr13-113206586-G-A,rs9577481,-1,G,A,113206586,157544,113167522,113560738,39064
13,ENSG00000150401.10,113490711,chr13-113455830-C-A,rs9577553,-1,C,A,113455830,34881,113294103,113687319,161727
13,ENSG00000175198.9,100089093,chr13-99990007-G-A,rs9585310,1,G,A,99990007,99086,99892485,100285701,97522
13,ENSG00000169062.8,114281601,chr13-114221419-A-G,rs9590483,1,A,G,114221419,60182,114084993,114478209,136426
13,ENSG00000123191.9,52011450,chr13-51876621-C-T,rs9634848,-1,C,T,51876621,134829,51814842,52208058,61779
13,ENSG00000186009.3,113658198,chr13-113503763-G-T,rs9805651,-1,G,T,113503763,154435,113461590,113854806,42173
13,ENSG00000133106.10,42992241,chr13-43064635-G-A,rs1028735,-1,G,A,43064635,72394,42795633,43188849,269002
13,ENSG00000134897.9,102799119,chr13-102861594-A-G,rs1047769,1,A,G,102861594,62475,102602511,102995727,259083
13,ENSG00000130177.10,114234897,chr13-114317862-T-C,rs11147327,1,T,C,114317862,82965,114038289,114431505,279573
13,ENSG00000133111.3,36819222,chr13-36801278-G-A,rs11147618,1,G,A,36801278,17944,36622614,37015830,178664
13,ENSG00000132950.14,19863649,chr13-19762834-G-A,rs112534345,-1,G,A,19762834,100815,19667041,20060257,95793
13,ENSG00000150403.13,113491021,chr13-113671269-G-A,rs113303775,1,G,A,113671269,180248,113294413,113687629,376856
13,ENSG00000139514.7,29595688,chr13-29598614-G-T,rs11618507,-1,G,T,29598614,2926,29399080,29792296,199534
13,ENSG00000136100.7,52450634,chr13-52316832-C-T,rs116886428,-1,C,T,52316832,133802,52254026,52647242,62806
13,ENSG00000136144.7,49585558,chr13-49541268-A-C,rs12429621,-1,A,C,49541268,44290,49388950,49782166,152318
13,ENSG00000150456.5,20773961,chr13-20782309-C-T,rs12867715,-1,C,T,20782309,8348,20577353,20970569,204956
13,ENSG00000136153.13,75636330,chr13-75510501-T-C,rs1535728,1,T,C,75510501,125829,75439722,75832938,70779
13,ENSG00000136143.7,48001273,chr13-47884796-T-C,rs1555722,-1,T,C,47884796,116477,47804665,48197881,80131
13,ENSG00000125246.10,99606690,chr13-99416394-T-C,rs16956544,1,T,C,99416394,190296,99410082,99803298,6312
13,ENSG00000083544.8,60397220,chr13-60573683-T-C,rs17058237,1,T,C,60573683,176463,60200612,60593828,373071
13,ENSG00000023516.7,42272152,chr13-42291061-C-G,rs17063155,1,C,G,42291061,18909,42075544,42468760,215517
13,ENSG00000102804.9,44576330,chr13-44637070-T-C,rs17065987,-1,T,C,44637070,60740,44379722,44772938,257348
13,ENSG00000136141.9,46553170,chr13-46603568-C-T,rs17068454,1,C,T,46603568,50398,46356562,46749778,247006
13,ENSG00000136111.8,75482169,chr13-75297194-G-T,rs17325351,-1,G,T,75297194,184975,75285561,75678777,11633
13,ENSG00000151835.9,23433702,chr13-23497183-A-G,rs17390122,-1,A,G,23497183,63481,23237094,23630310,260089
13,ENSG00000179630.5,43879904,chr13-43984909-A-G,rs1822970,1,A,G,43984909,105005,43683296,44076512,301613
13,ENSG00000139684.8,46797161,chr13-46889684-A-G,rs2025296,-1,A,G,46889684,92523,46600553,46993769,289131
13,ENSG00000118939.10,75549791,chr13-75468640-A-G,rs2031506,1,A,G,75468640,81151,75353183,75746399,115457
13,ENSG00000134864.5,100588789,chr13-100575231-T-C,rs2066014,-1,T,C,100575231,13558,100392181,100785397,183050
13,ENSG00000133116.6,33016423,chr13-33023795-T-C,rs211243,1,T,C,33023795,7372,32819815,33213031,203980
13,ENSG00000136098.10,52159597,chr13-52135802-A-C,rs2296351,-1,A,C,52135802,23795,51962989,52356205,172813
13,ENSG00000136098.10,52159597,chr13-52135802-A-T,rs2296351,-1,A,T,52135802,23795,51962989,52356205,172813
13,ENSG00000213995.5,110615545,chr13-110493574-T-C,rs2391834,1,T,C,110493574,121971,110418937,110812153,74637
13,ENSG00000152192.5,78603552,chr13-78610294-C-A,rs2765066,-1,C,A,78610294,6742,78406944,78800160,203350
13,ENSG00000174015.5,45702320,chr13-45570073-A-G,rs2985935,1,A,G,45570073,132247,45505712,45898928,64361
13,ENSG00000126217.15,112969214,chr13-112963563-C-T,rs2993346,1,C,T,112963563,5651,112772606,113165822,190957
13,ENSG00000102606.11,111115310,chr13-111303756-A-G,rs3783083,1,A,G,111303756,188446,110918702,111311918,385054
13,ENSG00000152749.7,94601857,chr13-94601666-T-A,rs3897473,1,T,A,94601666,191,94405249,94798465,196417
13,ENSG00000152749.7,94601857,chr13-94601666-T-G,rs3897473,1,T,G,94601666,191,94405249,94798465,196417
13,ENSG00000139835.8,113364130,chr13-113369310-G-A,rs4907625,-1,G,A,113369310,5180,113167522,113560738,201788
13,ENSG00000139842.10,113209613,chr13-113160886-C-T,rs513479,1,C,T,113160886,48727,113013005,113406221,147881
13,ENSG00000132970.8,26557683,chr13-26749632-A-G,rs56009760,1,A,G,26749632,191949,26361075,26754291,388557
13,ENSG00000102595.12,96053401,chr13-95984098-T-C,rs61972948,-1,T,C,95984098,69303,95856793,96250009,127305
13,ENSG00000102699.5,24512778,chr13-24514056-T-C,rs6490945,-1,T,C,24514056,1278,24316170,24709386,197886
13,ENSG00000102753.5,49792682,chr13-49691674-G-A,rs6561557,-1,G,A,49691674,101008,49596074,49989290,95600
13,ENSG00000169062.8,114281601,chr13-114287680-T-C,rs7327124,1,T,C,114287680,6079,114084993,114478209,202687
13,ENSG00000136104.10,50909791,chr13-50899917-T-C,rs7332076,1,T,C,50899917,9874,50713183,51106399,186734
13,ENSG00000152213.3,49628507,chr13-49615863-G-A,rs7335220,1,G,A,49615863,12644,49431899,49825115,183964
13,ENSG00000153495.6,111320642,chr13-111125666-C-T,rs7335920,1,C,T,111125666,194976,111124034,111517250,1632
13,ENSG00000186184.11,27621892,chr13-27591404-G-T,rs74605989,1,G,T,27591404,30488,27425284,27818500,166120
13,ENSG00000133121.14,33285755,chr13-33195359-C-T,rs74714752,-1,C,T,33195359,90396,33089147,33482363,106212
13,ENSG00000150457.6,21061586,chr13-21117594-T-C,rs7491383,-1,T,C,21117594,56008,20864978,21258194,252616
13,ENSG00000132958.12,19503279,chr13-19650062-G-T,rs75390100,-1,G,T,19650062,146783,19306671,19699887,343391
13,ENSG00000205863.4,23897006,chr13-23822464-A-G,rs75674138,-1,A,G,23822464,74542,23700398,24093614,122066
13,ENSG00000126231.8,113158648,chr13-113062785-C-A,rs76087203,1,C,A,113062785,95863,112962040,113355256,100745
13,ENSG00000126226.14,113208669,chr13-113062785-C-A,rs76087203,-1,C,A,113062785,145884,113012061,113405277,50724
13,ENSG00000173988.7,46211943,chr13-46202584-G-A,rs77210954,1,G,A,46202584,9359,46015335,46408551,187249
13,ENSG00000152767.8,98143094,chr13-98148098-A-G,rs774695,1,A,G,98148098,5004,97946486,98339702,201612
13,ENSG00000102786.9,51453036,chr13-51338060-C-T,rs79458946,-1,C,T,51338060,114976,51256428,51649644,81632
13,ENSG00000032742.12,20567157,chr13-20548026-A-G,rs7999297,1,A,G,20548026,19131,20370549,20763765,177477
13,ENSG00000125247.11,100674795,chr13-100504239-G-A,rs837290,-1,G,A,100504239,170556,100478187,100871403,26052
13,ENSG00000139618.9,32315508,chr13-32172985-C-T,rs916732,1,C,T,32172985,142523,32118900,32512116,54085
13,ENSG00000132952.7,30617920,chr13-30772118-C-T,rs9315054,1,C,T,30772118,154198,30421312,30814528,350806
13,ENSG00000102554.7,73059005,chr13-72996935-A-C,rs9318132,1,A,C,72996935,62070,72862397,73255613,134538
13,ENSG00000102796.6,51804163,chr13-51843402-T-C,rs944168,-1,T,C,51843402,39239,51607555,52000771,235847
13,ENSG00000189403.9,30465936,chr13-30439642-A-G,rs9506310,-1,A,G,30439642,26294,30269328,30662544,170314
13,ENSG00000182957.8,24160720,chr13-24286102-A-G,rs9507300,1,A,G,24286102,125382,23964112,24357328,321990
13,ENSG00000152484.9,27171811,chr13-27346474-T-C,rs9512637,-1,T,C,27346474,174663,26975203,27368419,371271
13,ENSG00000122033.9,27450564,chr13-27503007-G-C,rs9512730,-1,G,C,27503007,52443,27253956,27647172,249051
13,ENSG00000151773.6,43879740,chr13-44010833-C-T,rs9525901,-1,C,T,44010833,131093,43683132,44076348,327701
13,ENSG00000126216.8,112588153,chr13-112584356-C-T,rs9550155,-1,C,T,112584356,3797,112391545,112784761,192811
13,ENSG00000122034.8,27424619,chr13-27414899-G-A,rs9554029,1,G,A,27414899,9720,27228011,27621227,186888
13,ENSG00000139832.3,110561722,chr13-110470785-T-A,rs9555706,-1,T,A,110470785,90937,110365114,110758330,105671
13,ENSG00000139832.3,110561722,chr13-110470785-T-G,rs9555706,-1,T,G,110470785,90937,110365114,110758330,105671
13,ENSG00000134873.4,95552720,chr13-95365787-G-T,rs9556473,1,G,T,95365787,186933,95356112,95749328,9675
13,ENSG00000134873.4,95552720,chr13-95365787-G-A,rs9556473,1,G,A,95365787,186933,95356112,95749328,9675
13,ENSG00000102572.9,98577107,chr13-98466746-T-G,rs9584855,-1,T,G,98466746,110361,98380499,98773715,86247
13,ENSG00000102471.9,79481155,chr13-79396164-G-A,rs9593396,1,G,A,79396164,84991,79284547,79677763,111617
12,ENSG00000196387.4,133080923,chr12-132924025-G-T,rs10357,1,G,T,132924025,156898,132884315,133277531,39710
12,ENSG00000139636.11,49110847,chr12-49188909-T-G,rs1039225,-1,T,G,49188909,78062,48914239,49307455,274670
12,ENSG00000139190.11,6470677,chr12-6462882-A-G,rs1045452,-1,A,G,6462882,7795,6274069,6667285,188813
12,ENSG00000110811.13,6828407,chr12-6839528-A-G,rs1047776,1,A,G,6839528,11121,6631799,7025015,207729
12,ENSG00000180574.3,10505890,chr12-10695201-A-G,rs10492348,1,A,G,10695201,189311,10309282,10702498,385919
12,ENSG00000183160.7,108598084,chr12-108679562-C-T,rs10507231,-1,C,T,108679562,81478,108401476,108794692,278086
12,ENSG00000139044.6,459939,chr12-553672-T-C,rs1056008,1,T,C,553672,93733,263331,656547,290341
12,ENSG00000139370.6,128823958,chr12-128801941-C-T,rs10734964,-1,C,T,128801941,22017,128627350,129020566,174591
12,ENSG00000155957.10,66169996,chr12-66066014-A-G,rs10735933,-1,A,G,66066014,103982,65973388,66366604,92626
12,ENSG00000111215.5,10849475,chr12-10986084-C-T,rs10772397,-1,C,T,10986084,136609,10652867,11046083,333217
12,ENSG00000111215.5,10849475,chr12-10986084-C-A,rs10772397,-1,C,A,10986084,136609,10652867,11046083,333217
12,ENSG00000135114.7,121039242,chr12-121038620-A-G,rs10774580,-1,A,G,121038620,622,120842634,121235850,195986
12,ENSG00000111666.5,101697640,chr12-101689424-A-G,rs10778139,1,A,G,101689424,8216,101501032,101894248,188392
12,ENSG00000111666.5,101697640,chr12-101689424-A-C,rs10778139,1,A,C,101689424,8216,101501032,101894248,188392
12,ENSG00000123395.10,52069978,chr12-52068035-G-A,rs10783487,1,G,A,52068035,1943,51873370,52266586,194665
12,ENSG00000118308.10,25052706,chr12-25074481-C-G,rs10842459,1,C,G,25074481,21775,24856098,25249314,218383
12,ENSG00000110841.8,27524206,chr12-27438994-C-T,rs10842916,1,C,T,27438994,85212,27327598,27720814,111396
12,ENSG00000123106.6,28190456,chr12-28102768-T-C,rs10843094,1,T,C,28102768,87688,27993848,28387064,108920
12,ENSG00000011105.7,3077379,chr12-3081470-G-A,rs10848786,1,G,A,3081470,4091,2880771,3273987,200699
12,ENSG00000078237.4,4321213,chr12-4220811-A-C,rs10849018,1,A,C,4220811,100402,4124605,4517821,96206
12,ENSG00000010292.7,6494102,chr12-6531101-G-A,rs10849485,1,G,A,6531101,36999,6297494,6690710,233607
12,ENSG00000180263.9,95217467,chr12-95322218-T-C,rs10859872,-1,T,C,95322218,104751,95020859,95414075,301359
12,ENSG00000151135.5,106955907,chr12-106929137-T-C,rs10861679,1,T,C,106929137,26770,106759299,107152515,169838
12,ENSG00000139620.8,48682238,chr12-48739942-C-T,rs10875867,-1,C,T,48739942,57704,48485630,48878846,254312
12,ENSG00000123360.7,54549601,chr12-54558958-T-C,rs10876566,1,T,C,54558958,9357,54352993,54746209,205965
12,ENSG00000197728.5,56041918,chr12-56007301-G-A,rs10876864,1,G,A,56007301,34617,55845310,56238526,161991
12,ENSG00000177192.8,131929276,chr12-131845986-G-T,rs10902456,1,G,T,131845986,83290,131732668,132125884,113318
12,ENSG00000177192.8,131929276,chr12-131845986-G-A,rs10902456,1,G,A,131845986,83290,131732668,132125884,113318
12,ENSG00000089250.13,117361626,chr12-117258359-G-A,rs1093329,-1,G,A,117258359,103267,117165018,117558234,93341
12,ENSG00000089250.13,117361626,chr12-117258359-G-C,rs1093329,-1,G,C,117258359,103267,117165018,117558234,93341
12,ENSG00000158023.5,121918592,chr12-121863832-T-C,rs11043223,1,T,C,121863832,54760,121721984,122115200,141848
12,ENSG00000111711.4,21501789,chr12-21508574-A-G,rs11046091,1,A,G,21508574,6785,21305181,21698397,203393
12,ENSG00000123095.4,26125037,chr12-26272088-T-C,rs11048444,-1,T,C,26272088,147051,25928429,26321645,343659
12,ENSG00000139131.8,32755897,chr12-32747042-T-C,rs11052215,-1,T,C,32747042,8855,32559289,32952505,187753
12,ENSG00000130038.5,3753109,chr12-3749908-G-A,rs11062786,-1,G,A,3749908,3201,3556501,3949717,193407
12,ENSG00000073614.6,389320,chr12-487446-C-T,rs11063222,-1,C,T,487446,98126,192712,585928,294734
12,ENSG00000010278.6,6200400,chr12-6253196-A-G,rs11064111,1,A,G,6253196,52796,6003792,6397008,249404
12,ENSG00000111640.8,6534517,chr12-6471210-A-G,rs11064213,1,A,G,6471210,63307,6337909,6731125,133301
12,ENSG00000089693.6,6753141,chr12-6757661-T-G,rs11064369,-1,T,G,6757661,4520,6556533,6949749,201128
12,ENSG00000111725.5,119668133,chr12-119709120-G-A,rs11064881,1,G,A,119709120,40987,119471525,119864741,237595
12,ENSG00000088986.6,120496113,chr12-120680369-G-A,rs11065208,1,G,A,120680369,184256,120299505,120692721,380864
12,ENSG00000177889.5,93441947,chr12-93468886-G-C,rs11107041,-1,G,C,93468886,26939,93245339,93638555,223547
12,ENSG00000028203.12,95217807,chr12-95323721-T-C,rs11107979,1,T,C,95323721,105914,95021199,95414415,302522
12,ENSG00000075415.8,98593686,chr12-98556712-C-T,rs11109527,1,C,T,98556712,36974,98397078,98790294,159634
12,ENSG00000120860.6,102061991,chr12-102021478-T-C,rs11111134,-1,T,C,102021478,40513,101865383,102258599,156095
12,ENSG00000167552.8,49189080,chr12-49126866-G-A,rs11168871,-1,G,A,49126866,62214,48992472,49385688,134394
12,ENSG00000181929.6,49018776,chr12-49161631-G-A,rs11168898,-1,G,A,49161631,142855,48822168,49215384,339463
12,ENSG00000181929.6,49018776,chr12-49161631-G-C,rs11168898,-1,G,C,49161631,142855,48822168,49215384,339463
12,ENSG00000123353.5,55818041,chr12-55799449-A-C,rs11171681,1,A,C,55799449,18592,55621433,56014649,178016
12,ENSG00000166226.7,69585459,chr12-69434901-G-A,rs11177669,1,G,A,69434901,150558,69388851,69782067,46050
12,ENSG00000166226.7,69585459,chr12-69434901-G-C,rs11177669,1,G,C,69434901,150558,69388851,69782067,46050
12,ENSG00000139351.10,101739462,chr12-101900877-A-G,rs112670859,-1,A,G,101900877,161415,101542854,101936070,358023
12,ENSG00000112787.7,132490151,chr12-132474624-T-C,rs112683685,1,T,C,132474624,15527,132293543,132686759,181081
12,ENSG00000161791.9,49707405,chr12-49556468-C-G,rs113209368,-1,C,G,49556468,150937,49510797,49904013,45671
12,ENSG00000139714.8,121669654,chr12-121576865-C-G,rs113467236,-1,C,G,121576865,92789,121473046,121866262,103819
12,ENSG00000174718.7,31959415,chr12-31973718-C-T,rs113925411,1,C,T,31973718,14303,31762807,32156023,210911
12,ENSG00000177875.3,48183644,chr12-48370783-G-T,rs11503876,1,G,T,48370783,187139,47987036,48380252,383747
12,ENSG00000182544.6,53252095,chr12-53205921-C-T,rs11574529,1,C,T,53205921,46174,53055487,53448703,150434
12,ENSG00000135476.7,53268299,chr12-53205921-C-T,rs11574529,1,C,T,53205921,62378,53071691,53464907,134230
12,ENSG00000139289.7,76031776,chr12-76171719-G-A,rs11611315,-1,G,A,76171719,139943,75835168,76228384,336551
12,ENSG00000182379.9,57216794,chr12-57219990-C-T,rs11612037,1,C,T,57219990,3196,57020186,57413402,199804
12,ENSG00000136052.5,104958290,chr12-104900141-G-A,rs116185014,-1,G,A,104900141,58149,104761682,105154898,138459
12,ENSG00000111196.5,10613609,chr12-10612901-C-T,rs116702057,-1,C,T,10612901,708,10417001,10810217,195900
12,ENSG00000188735.7,121712752,chr12-121788623-A-G,rs1168667,1,A,G,121788623,75871,121516144,121909360,272479
12,ENSG00000070019.3,14696599,chr12-14634711-C-T,rs117452271,-1,C,T,14634711,61888,14499991,14893207,134720
12,ENSG00000126746.12,6689375,chr12-6676779-T-C,rs117471807,-1,T,C,6676779,12596,6492767,6885983,184012
12,ENSG00000139168.3,42326094,chr12-42176456-T-C,rs117503242,-1,T,C,42176456,149638,42129486,42522702,46970
12,ENSG00000179295.10,112418947,chr12-112592827-G-T,rs117529015,1,G,T,112592827,173880,112222339,112615555,370488
12,ENSG00000179295.10,112418947,chr12-112592827-G-A,rs117529015,1,G,A,112592827,173880,112222339,112615555,370488
12,ENSG00000060982.10,24949101,chr12-24956385-G-A,rs117800976,-1,G,A,24956385,7284,24752493,25145709,203892
12,ENSG00000135517.5,56454657,chr12-56487830-G-A,rs117867773,-1,G,A,56487830,33173,56258049,56651265,229781
12,ENSG00000135124.9,121210129,chr12-121231342-A-G,rs1180051,1,A,G,121231342,21213,121013521,121406737,217821
12,ENSG00000177990.7,63668493,chr12-63786089-G-T,rs11829078,-1,G,T,63786089,117596,63471885,63865101,314204
12,ENSG00000123329.12,57479866,chr12-57467189-T-C,rs11830874,-1,T,C,57467189,12677,57283258,57676474,183931
12,ENSG00000087470.12,32679301,chr12-32754526-T-C,rs11830934,1,T,C,32754526,75225,32482693,32875909,271833
12,ENSG00000110900.10,30926748,chr12-30983384-A-G,rs11836457,1,A,G,30983384,56636,30730140,31123356,253244
12,ENSG00000111186.8,1629231,chr12-1534121-T-C,rs11837047,1,T,C,1534121,95110,1432623,1825839,101498
12,ENSG00000256436.1,11031407,chr12-10997434-G-T,rs12226919,-1,G,T,10997434,33973,10834799,11228015,162635
12,ENSG00000212126.3,10986912,chr12-10997434-G-T,rs12226919,-1,G,T,10997434,10522,10790304,11183520,207130
12,ENSG00000211584.8,47773238,chr12-47858356-G-A,rs12308082,1,G,A,47858356,85118,47576630,47969846,281726
12,ENSG00000166211.6,101475336,chr12-101599064-A-G,rs12317537,1,A,G,101599064,123728,101278728,101671944,320336
12,ENSG00000180481.6,75391089,chr12-75379684-G-A,rs12369556,1,G,A,75379684,11405,75194481,75587697,185203
12,ENSG00000184271.11,51218062,chr12-51190814-T-C,rs12423352,-1,T,C,51190814,27248,51021454,51414670,169360
12,ENSG00000057704.6,94650557,chr12-94823160-C-T,rs12580507,-1,C,T,94823160,172603,94453949,94847165,369211
12,ENSG00000139410.10,113422380,chr12-113412576-A-G,rs12815112,1,A,G,113412576,9804,113225772,113618988,186804
12,ENSG00000139218.12,45990574,chr12-45992065-C-T,rs12828693,-1,C,T,45992065,1491,45793966,46187182,198099
12,ENSG00000119242.4,123972831,chr12-123915003-T-C,rs1316952,-1,T,C,123915003,57828,123776223,124169439,138780
12,ENSG00000170442.6,52274645,chr12-52318711-G-A,rs13377620,1,G,A,52318711,44066,52078037,52471253,240674
12,ENSG00000078246.10,2890891,chr12-3052194-A-C,rs148964538,1,A,C,3052194,161303,2694283,3087499,357911
12,ENSG00000118307.12,25195160,chr12-25052787-T-C,rs1497258,-1,T,C,25052787,142373,24998552,25391768,54235
12,ENSG00000172322.8,9971409,chr12-9961876-G-T,rs1535651,1,G,T,9961876,9533,9774801,10168017,187075
12,ENSG00000172322.8,9971409,chr12-9961876-G-A,rs1535651,1,G,A,9961876,9533,9774801,10168017,187075
12,ENSG00000139372.10,103965872,chr12-104051964-A-G,rs1564892,1,A,G,104051964,86092,103769264,104162480,282700
12,ENSG00000139537.6,48904133,chr12-48862015-G-C,rs1565933,1,G,C,48862015,42118,48707525,49100741,154490
12,ENSG00000166888.4,57111362,chr12-57109992-C-T,rs167769,-1,C,T,57109992,1370,56914754,57307970,195238
12,ENSG00000139083.5,11649674,chr12-11754465-C-T,rs16907207,1,C,T,11754465,104791,11453066,11846282,301399
12,ENSG00000139132.9,32399558,chr12-32364432-A-C,rs16919801,1,A,C,32364432,35126,32202950,32596166,161482
12,ENSG00000123096.6,26195573,chr12-26056581-T-C,rs16929973,1,T,C,26056581,138992,25998965,26392181,57616
12,ENSG00000151176.3,113358587,chr12-113440586-T-G,rs16934262,1,T,G,113440586,81999,113161979,113555195,278607
12,ENSG00000111344.7,113135761,chr12-113244225-T-C,rs16942667,-1,T,C,113244225,108464,112939153,113332369,305072
12,ENSG00000139323.9,89526047,chr12-89360300-G-A,rs17016739,-1,G,A,89360300,165747,89329439,89722655,30861
12,ENSG00000166598.7,103930410,chr12-103751074-A-T,rs17034464,1,A,T,103751074,179336,103733802,104127018,17272
12,ENSG00000255150.1,104303739,chr12-104354534-A-C,rs17035376,1,A,C,104354534,50795,104107131,104500347,247403
12,ENSG00000136045.5,107685799,chr12-107619180-G-A,rs17039545,1,G,A,107619180,66619,107489191,107882407,129989
12,ENSG00000170581.8,56360107,chr12-56273820-T-C,rs17118439,-1,T,C,56273820,86287,56163499,56556715,110321
12,ENSG00000170581.8,56360107,chr12-56273820-T-G,rs17118439,-1,T,G,56273820,86287,56163499,56556715,110321
12,ENSG00000177627.5,48482498,chr12-48361859-A-G,rs17122920,1,A,G,48361859,120639,48285890,48679106,75969
12,ENSG00000139428.5,109573504,chr12-109591945-T-A,rs17183465,-1,T,A,109591945,18441,109376896,109770112,215049
12,ENSG00000084444.9,13044381,chr12-13090234-A-G,rs17212998,1,A,G,13090234,45853,12847773,13240989,242461
12,ENSG00000165714.6,12357078,chr12-12468633-T-G,rs17312055,1,T,G,12468633,111555,12160470,12553686,308163
12,ENSG00000188596.3,96489577,chr12-96520835-A-G,rs17316068,1,A,G,96520835,31258,96292969,96686185,227866
12,ENSG00000135439.6,57738742,chr12-57676062-A-G,rs17455386,-1,A,G,57676062,62680,57542134,57935350,133928
12,ENSG00000135437.5,55720393,chr12-55644976-T-G,rs17511746,1,T,G,55644976,75417,55523785,55917001,121191
12,ENSG00000197757.7,54028440,chr12-54221088-C-T,rs17779936,1,C,T,54221088,192648,53831832,54225048,389256
12,ENSG00000173598.9,93377925,chr12-93397457-A-G,rs17790482,1,A,G,93397457,19532,93181317,93574533,216140
12,ENSG00000174527.4,109347903,chr12-109197029-A-G,rs17848802,1,A,G,109197029,150874,109151295,109544511,45734
12,ENSG00000135447.10,54588659,chr12-54562960-A-G,rs1795814,-1,A,G,54562960,25699,54392051,54785267,170909
12,ENSG00000134283.12,42326167,chr12-42386766-G-A,rs1796384,1,G,A,42386766,60599,42129559,42522775,257207
12,ENSG00000182782.6,122703357,chr12-122716221-T-G,rs1798192,-1,T,G,122716221,12864,122506749,122899965,209472
12,ENSG00000182782.6,122703357,chr12-122716221-T-C,rs1798192,-1,T,C,122716221,12864,122506749,122899965,209472
12,ENSG00000255398.2,122716811,chr12-122716221-T-G,rs1798192,-1,T,G,122716221,590,122520203,122913419,196018
12,ENSG00000255398.2,122716811,chr12-122716221-T-C,rs1798192,-1,T,C,122716221,590,122520203,122913419,196018
12,ENSG00000166986.8,57488068,chr12-57530648-A-G,rs1802914,1,A,G,57530648,42580,57291460,57684676,239188
12,ENSG00000089127.7,112906962,chr12-112938526-C-A,rs1859331,1,C,A,112938526,31564,112710354,113103570,228172
12,ENSG00000175189.2,57434784,chr12-57625414-C-T,rs1871415,1,C,T,57625414,190630,57238176,57631392,387238
12,ENSG00000175189.2,57434784,chr12-57625414-C-G,rs1871415,1,C,G,57625414,190630,57238176,57631392,387238
12,ENSG00000205426.5,52291534,chr12-52301846-C-T,rs1894033,-1,C,T,52301846,10312,52094926,52488142,206920
12,ENSG00000215021.3,6970664,chr12-6787028-A-G,rs1922452,-1,A,G,6787028,183636,6774056,7167272,12972
12,ENSG00000060709.8,130716299,chr12-130716756-T-C,rs1997235,-1,T,C,130716756,457,130519691,130912907,197065
12,ENSG00000111331.7,112938474,chr12-112912991-G-T,rs2057778,1,G,T,112912991,25483,112741866,113135082,171125
12,ENSG00000177084.9,132687342,chr12-132856587-T-C,rs2062163,-1,T,C,132856587,169245,132490734,132883950,365853
12,ENSG00000171792.5,2877223,chr12-2869088-G-T,rs2074985,1,G,T,2869088,8135,2680615,3073831,188473
12,ENSG00000171792.5,2877223,chr12-2869088-G-A,rs2074985,1,G,A,2869088,8135,2680615,3073831,188473
12,ENSG00000135093.7,109052576,chr12-109224174-T-C,rs2075258,1,T,C,109224174,171598,108855968,109249184,368206
12,ENSG00000139433.4,109880541,chr12-109888648-G-A,rs2111540,-1,G,A,109888648,8107,109683933,110077149,204715
12,ENSG00000004478.5,2794970,chr12-2654835-G-A,rs216046,1,G,A,2654835,140135,2598362,2991578,56473
12,ENSG00000135441.3,55716046,chr12-55729581-G-A,rs2231462,1,G,A,55729581,13535,55519438,55912654,210143
12,ENSG00000135424.10,55707904,chr12-55729581-G-A,rs2231462,-1,G,A,55729581,21677,55511296,55904512,218285
12,ENSG00000135404.6,55729009,chr12-55729581-G-A,rs2231462,-1,G,A,55729581,572,55532401,55925617,197180
12,ENSG00000170439.5,55681736,chr12-55729581-G-A,rs2231462,1,G,A,55729581,47845,55485128,55878344,244453
12,ENSG00000123415.9,54188985,chr12-54182016-C-A,rs2233921,-1,C,A,54182016,6969,53992377,54385593,189639
12,ENSG00000110799.9,6124670,chr12-6078499-G-T,rs2238104,-1,G,T,6078499,46171,5928062,6321278,150437
12,ENSG00000139192.7,6452042,chr12-6460817-C-T,rs2243977,1,C,T,6460817,8775,6255434,6648650,205383
12,ENSG00000111254.2,4649051,chr12-4636147-C-T,rs2267546,-1,C,T,4636147,12904,4452443,4845659,183704
12,ENSG00000139219.12,48004476,chr12-47982508-G-A,rs2276454,-1,G,A,47982508,21968,47807868,48201084,174640
12,ENSG00000176915.10,132761832,chr12-132922180-A-G,rs2279314,-1,A,G,132922180,160348,132565224,132958440,356956
12,ENSG00000121380.7,12070939,chr12-12071609-C-T,rs2287154,1,C,T,12071609,670,11874331,12267547,197278
12,ENSG00000110851.7,107761137,chr12-107696741-A-G,rs2287214,-1,A,G,107696741,64396,107564529,107957745,132212
12,ENSG00000139579.7,56224342,chr12-56420869-G-A,rs2291739,1,G,A,56420869,196527,56027734,56420950,393135
12,ENSG00000135679.15,68808177,chr12-68824258-T-G,rs2291857,1,T,G,68824258,16081,68611569,69004785,212689
12,ENSG00000151491.7,15789388,chr12-15956739-T-G,rs2306181,-1,T,G,15956739,167351,15592780,15985996,363959
12,ENSG00000170456.10,31591136,chr12-31636497-G-A,rs2374165,-1,G,A,31636497,45361,31394528,31787744,241969
12,ENSG00000189046.5,109093472,chr12-109169746-G-T,rs246095,-1,G,T,109169746,76274,108896864,109290080,272882
12,ENSG00000189046.5,109093472,chr12-109169746-G-A,rs246095,-1,G,A,109169746,76274,108896864,109290080,272882
12,ENSG00000076248.4,109097597,chr12-109108309-C-T,rs2515913,1,C,T,109108309,10712,108900989,109294205,207320
12,ENSG00000170855.3,120446384,chr12-120317249-T-G,rs2522132,-1,T,G,120317249,129135,120249776,120642992,67473
12,ENSG00000204954.5,103957215,chr12-103954652-A-G,rs2576975,-1,A,G,103954652,2563,103760607,104153823,194045
12,ENSG00000087494.10,27972733,chr12-27855858-T-C,rs258402,-1,T,C,27855858,116875,27776125,28169341,79733
12,ENSG00000135469.9,56266942,chr12-56296064-G-A,rs2629445,1,G,A,56296064,29122,56070334,56463550,225730
12,ENSG00000110911.10,51026384,chr12-51167273-C-T,rs2640518,-1,C,T,51167273,140889,50829776,51222992,337497
12,ENSG00000139223.1,48472559,chr12-48530644-G-A,rs2705141,1,G,A,48530644,58085,48275951,48669167,254693
12,ENSG00000150977.9,123436684,chr12-123427242-A-C,rs28466887,-1,A,C,123427242,9442,123240076,123633292,187166
12,ENSG00000178878.7,12785659,chr12-12726123-G-A,rs34323,1,G,A,12726123,59536,12589051,12982267,137072
12,ENSG00000196917.4,122730844,chr12-122585671-G-A,rs36117464,-1,G,A,122585671,145173,122534236,122927452,51435
12,ENSG00000174989.7,116910950,chr12-117027459-C-T,rs3741466,1,C,T,117027459,116509,116714342,117107558,313117
12,ENSG00000089060.6,113335109,chr12-113208231-G-A,rs3741991,-1,G,A,113208231,126878,113138501,113531717,69730
12,ENSG00000174456.7,110048522,chr12-110011934-A-G,rs3759385,-1,A,G,110011934,36588,109851914,110245130,160020
12,ENSG00000166130.10,98644788,chr12-98677245-T-C,rs3815997,-1,T,C,98677245,32457,98448180,98841396,229065
12,ENSG00000134548.5,21526296,chr12-21569080-C-T,rs3816655,1,C,T,21569080,42784,21329688,21722904,239392
12,ENSG00000170515.7,56104559,chr12-56286961-C-T,rs3816804,1,C,T,56286961,182402,55907951,56301167,379010
12,ENSG00000173208.3,39619803,chr12-39620625-C-T,rs4072006,-1,C,T,39620625,822,39423195,39816411,197430
12,ENSG00000257218.1,120446444,chr12-120538568-T-C,rs4102203,1,T,C,120538568,92124,120249836,120643052,288732
12,ENSG00000151065.9,2004457,chr12-1988550-T-C,rs4141130,-1,T,C,1988550,15907,1807849,2201065,180701
12,ENSG00000183395.4,102197833,chr12-102005576-T-C,rs4272832,-1,T,C,102005576,192257,102001225,102394441,4351
12,ENSG00000127329.9,70637429,chr12-70478078-C-T,rs429295,-1,C,T,70478078,159351,70440821,70834037,37257
12,ENSG00000111321.5,6384162,chr12-6391677-G-A,rs4301834,1,G,A,6391677,7515,6187554,6580770,204123
12,ENSG00000082805.12,991223,chr12-1095510-T-G,rs4459369,1,T,G,1095510,104287,794615,1187831,300895
12,ENSG00000033030.9,122500932,chr12-122504688-A-C,rs4758660,-1,A,C,122504688,3756,122304324,122697540,200364
12,ENSG00000076067.6,56521820,chr12-56525050-T-G,rs4759247,1,T,G,56525050,3230,56325212,56718428,199838
12,ENSG00000135390.12,53676083,chr12-53678651-C-A,rs4759282,-1,C,A,53678651,2568,53479475,53872691,199176
12,ENSG00000172789.2,54033050,chr12-54085283-C-G,rs4759330,1,C,G,54085283,52233,53836442,54229658,248841
12,ENSG00000130787.8,122835457,chr12-122797985-G-A,rs4759393,1,G,A,122797985,37472,122638849,123032065,159136
12,ENSG00000111452.8,130953907,chr12-131091457-C-T,rs4759542,1,C,T,131091457,137550,130757299,131150515,334158
12,ENSG00000110934.5,51324174,chr12-51257372-G-A,rs4761935,-1,G,A,51257372,66802,51127566,51520782,129806
12,ENSG00000136048.9,101877580,chr12-101805189-T-C,rs4764820,1,T,C,101805189,72391,101680972,102074188,124217
12,ENSG00000197905.4,2959397,chr12-2836804-C-T,rs4765999,1,C,T,2836804,122593,2762789,3156005,74015
12,ENSG00000198324.8,111369095,chr12-111269073-C-T,rs4766566,-1,C,T,111269073,100022,111172487,111565703,96586
12,ENSG00000151239.9,43806317,chr12-43905901-C-G,rs4768537,-1,C,G,43905901,99584,43609709,44002925,296192
12,ENSG00000174600.9,108339311,chr12-108319807-A-C,rs4964249,-1,A,C,108319807,19504,108142703,108535919,177104
12,ENSG00000110880.6,108731518,chr12-108794139-G-A,rs4964758,-1,G,A,108794139,62621,108534910,108928126,259229
12,ENSG00000084112.8,108857583,chr12-108810035-G-A,rs4964759,-1,G,A,108810035,47548,108660975,109054191,149060
12,ENSG00000111671.5,6873303,chr12-6847298-C-T,rs5446,-1,C,T,6847298,26005,6676695,7069911,170603
12,ENSG00000166908.12,57591192,chr12-57459552-A-G,rs55852335,1,A,G,57459552,131640,57394584,57787800,64968
12,ENSG00000134291.7,47963596,chr12-47994319-G-A,rs55921916,1,G,A,47994319,30723,47766988,48160204,227331
12,ENSG00000089163.4,120302321,chr12-120325034-A-G,rs5634,1,A,G,120325034,22713,120105713,120498929,219321
12,ENSG00000185163.5,132144319,chr12-132141098-C-T,rs57037358,-1,C,T,132141098,3221,131947711,132340927,193387
12,ENSG00000175548.4,38316774,chr12-38369968-C-T,rs57227976,1,C,T,38369968,53194,38120166,38513382,249802
12,ENSG00000176834.9,118104011,chr12-118018428-G-A,rs5745806,-1,G,A,118018428,85583,117907403,118300619,111025
12,ENSG00000123358.14,52051442,chr12-52142353-T-C,rs58806906,1,T,C,52142353,90911,51854834,52248050,287519
12,ENSG00000127337.2,69359743,chr12-69358420-A-G,rs589448,1,A,G,69358420,1323,69163135,69556351,195285
12,ENSG00000197653.10,123762301,chr12-123838534-G-A,rs60509888,1,G,A,123838534,76233,123565693,123958909,272841
12,ENSG00000182870.8,132329589,chr12-132447891-C-T,rs61360001,-1,C,T,132447891,118302,132132981,132526197,314910
12,ENSG00000070018.4,12267044,chr12-12079713-C-T,rs61729499,-1,C,T,12079713,187331,12070436,12463652,9277
12,ENSG00000166578.4,113221094,chr12-113151957-A-G,rs61738692,-1,A,G,113151957,69137,113024486,113417702,127471
12,ENSG00000167566.11,49828413,chr12-49953905-T-C,rs61926092,-1,T,C,49953905,125492,49631805,50025021,322100
12,ENSG00000167566.11,49828413,chr12-49953905-T-G,rs61926092,-1,T,G,49953905,125492,49631805,50025021,322100
12,ENSG00000111644.3,6647432,chr12-6534150-T-C,rs6489721,-1,T,C,6534150,113282,6450824,6844040,83326
12,ENSG00000123338.8,54497752,chr12-54329244-G-A,rs6580981,1,G,A,54329244,168508,54301144,54694360,28100
12,ENSG00000133639.3,92145846,chr12-92112156-T-C,rs709240,-1,T,C,92112156,33690,91949238,92342454,162918
12,ENSG00000079337.10,47758880,chr12-47765938-T-G,rs7135791,-1,T,G,47765938,7058,47562272,47955488,203666
12,ENSG00000175727.7,122078756,chr12-122055478-A-C,rs7137049,1,A,C,122055478,23278,121882148,122275364,173330
12,ENSG00000188026.7,123533719,chr12-123617434-G-C,rs7137130,-1,G,C,123617434,83715,123337111,123730327,280323
12,ENSG00000111554.10,68332362,chr12-68283125-A-G,rs7138823,-1,A,G,68283125,49237,68135754,68528970,147371
12,ENSG00000178449.2,50112236,chr12-50145636-T-G,rs7138945,1,T,G,50145636,33400,49915628,50308844,230008
12,ENSG00000023697.8,15911332,chr12-15768488-C-T,rs7139242,1,C,T,15768488,142844,15714724,16107940,53764
12,ENSG00000013583.4,13000265,chr12-13049085-C-G,rs7294646,-1,C,G,13049085,48820,12803657,13196873,245428
12,ENSG00000151079.6,4809176,chr12-4824274-A-G,rs7297411,1,A,G,4824274,15098,4612568,5005784,211706
12,ENSG00000176422.9,56468578,chr12-56467674-A-G,rs7302925,1,A,G,56467674,904,56271970,56665186,195704
12,ENSG00000197837.3,14771131,chr12-14681274-G-A,rs7311859,-1,G,A,14681274,89857,14574523,14967739,106751
12,ENSG00000167778.4,53079390,chr12-53077434-C-A,rs7313065,-1,C,A,53077434,1956,52882782,53275998,194652
12,ENSG00000173451.2,71664301,chr12-71836723-G-A,rs73140665,1,G,A,71836723,172422,71467693,71860909,369030
12,ENSG00000139438.5,109713825,chr12-109641162-C-T,rs73200449,1,C,T,109641162,72663,109517217,109910433,123945
12,ENSG00000110906.8,109477300,chr12-109673762-A-G,rs73202426,-1,A,G,109673762,196462,109280692,109673908,393070
12,ENSG00000136040.4,94148577,chr12-94153695-A-C,rs73222637,1,A,C,94153695,5118,93951969,94345185,201726
12,ENSG00000110881.6,50057596,chr12-50175479-A-G,rs74493606,1,A,G,50175479,117883,49860988,50254204,314491
12,ENSG00000169372.7,93677375,chr12-93854521-A-G,rs74679374,1,A,G,93854521,177146,93480767,93873983,373754
12,ENSG00000111325.12,122975220,chr12-122853740-A-G,rs7485652,1,A,G,122853740,121480,122778612,123171828,75128
12,ENSG00000139344.3,95943331,chr12-95944219-A-G,rs7486703,1,A,G,95944219,888,95746723,96139939,197496
12,ENSG00000111424.6,47904994,chr12-47768697-A-T,rs7488942,-1,A,T,47768697,136297,47708386,48101602,60311
12,ENSG00000205323.4,55817724,chr12-55706813-C-T,rs75366241,-1,C,T,55706813,110911,55621116,56014332,85697
12,ENSG00000170627.5,54473602,chr12-54325468-G-A,rs76742390,-1,G,A,54325468,148134,54276994,54670210,48474
12,ENSG00000165935.5,27466810,chr12-27513163-G-A,rs76773891,1,G,A,27513163,46353,27270202,27663418,242961
12,ENSG00000174236.2,27696447,chr12-27699051-C-T,rs76851022,1,C,T,27699051,2604,27499839,27893055,199212
12,ENSG00000257594.1,89524796,chr12-89570834-G-A,rs76967749,-1,G,A,89570834,46038,89328188,89721404,242646
12,ENSG00000127325.13,69699303,chr12-69648659-A-T,rs776175,-1,A,T,69648659,50644,69502695,69895911,145964
12,ENSG00000170545.11,51270415,chr12-51174165-A-G,rs77629257,-1,A,G,51174165,96250,51073807,51467023,100358
12,ENSG00000167272.6,120581402,chr12-120488516-C-G,rs787820,-1,C,G,120488516,92886,120384794,120778010,103722
12,ENSG00000134287.4,48957487,chr12-48918757-C-T,rs78877829,-1,C,T,48918757,38730,48760879,49154095,157878
12,ENSG00000135643.4,70366290,chr12-70336421-G-A,rs7953935,1,G,A,70336421,29869,70169682,70562898,166739
12,ENSG00000139722.2,122896124,chr12-122889778-A-G,rs7956122,-1,A,G,122889778,6346,122699516,123092732,190262
12,ENSG00000134532.10,23949670,chr12-23788764-A-G,rs7956324,-1,A,G,23788764,160906,23753062,24146278,35702
12,ENSG00000111728.5,22334707,chr12-22454680-T-G,rs7957294,-1,T,G,22454680,119973,22138099,22531315,316581
12,ENSG00000064115.6,27014384,chr12-26977232-C-A,rs7958443,-1,C,A,26977232,37152,26817776,27210992,159456
12,ENSG00000182993.3,14803670,chr12-14802768-T-A,rs7959540,1,T,A,14802768,902,14607062,15000278,195706
12,ENSG00000010379.10,262836,chr12-407055-C-T,rs7968644,-1,C,T,407055,144219,66228,459444,340827
12,ENSG00000198015.7,93467514,chr12-93505751-C-T,rs7976441,1,C,T,93505751,38237,93270906,93664122,234845
12,ENSG00000118596.7,59596029,chr12-59692425-A-G,rs7976838,1,A,G,59692425,96396,59399421,59792637,293004
12,ENSG00000171823.6,1594581,chr12-1527964-T-G,rs7977125,-1,T,G,1527964,66617,1397973,1791189,129991
12,ENSG00000111639.3,6493262,chr12-6496039-T-C,rs7978461,-1,T,C,6496039,2777,6296654,6689870,199385
12,ENSG00000139644.7,49741557,chr12-49803725-G-A,rs7978693,1,G,A,49803725,62168,49544949,49938165,258776
12,ENSG00000187778.9,49568142,chr12-49535007-A-G,rs80011486,-1,A,G,49535007,33135,49371534,49764750,163473
12,ENSG00000184752.8,95003697,chr12-95003776-T-C,rs835044,-1,T,C,95003776,79,94807089,95200305,196687
12,ENSG00000111245.8,110920579,chr12-110915044-A-C,rs933296,-1,A,C,110915044,5535,110723971,111117187,191073
12,ENSG00000111142.9,95474152,chr12-95647435-C-T,rs9783406,1,C,T,95647435,173283,95277544,95670760,369891
12,ENSG00000139133.2,34022496,chr12-34218201-A-G,rs10083007,1,A,G,34218201,195705,33825888,34219104,392313
12,ENSG00000139044.6,459939,chr12-544818-T-C,rs1008587,1,T,C,544818,84879,263331,656547,281487
12,ENSG00000182993.3,14803670,chr12-14798407-A-G,rs1012682,1,A,G,14798407,5263,14607062,15000278,191345
12,ENSG00000123415.9,54188985,chr12-54179559-T-C,rs10161263,-1,T,C,54179559,9426,53992377,54385593,187182
12,ENSG00000110848.4,9760901,chr12-9874345-C-T,rs10219684,-1,C,T,9874345,113444,9564293,9957509,310052
12,ENSG00000184574.4,6635959,chr12-6638129-G-A,rs1045553,-1,G,A,6638129,2170,6439351,6832567,198778
12,ENSG00000111361.7,123633686,chr12-123621401-C-T,rs1050443,-1,C,T,123621401,12285,123437078,123830294,184323
12,ENSG00000111291.4,12950384,chr12-12851477-A-G,rs10505769,-1,A,G,12851477,98907,12753776,13146992,97701
12,ENSG00000181418.7,48999375,chr12-48836252-T-G,rs1057908,-1,T,G,48836252,163123,48802767,49195983,33485
12,ENSG00000181418.7,48999375,chr12-48836252-T-A,rs1057908,-1,T,A,48836252,163123,48802767,49195983,33485
12,ENSG00000110958.10,56688284,chr12-56597278-T-C,rs1064244,-1,T,C,56597278,91006,56491676,56884892,105602
12,ENSG00000180481.6,75391089,chr12-75467307-G-A,rs10732759,1,G,A,75467307,76218,75194481,75587697,272826
12,ENSG00000119242.4,123972831,chr12-123899403-T-C,rs10744163,-1,T,C,123899403,73428,123776223,124169439,123180
12,ENSG00000119242.4,123972831,chr12-123899403-T-G,rs10744163,-1,T,G,123899403,73428,123776223,124169439,123180
12,ENSG00000111262.4,4909905,chr12-5049401-G-C,rs10774297,1,G,C,5049401,139496,4713297,5106513,336104
12,ENSG00000139318.6,89352501,chr12-89200183-T-C,rs10777156,-1,T,C,89200183,152318,89155893,89549109,44290
12,ENSG00000136003.11,108562596,chr12-108546125-T-A,rs10778643,1,T,A,108546125,16471,108365988,108759204,180137
12,ENSG00000123342.11,55842936,chr12-55661069-A-C,rs10783768,-1,A,C,55661069,181867,55646328,56039544,14741
12,ENSG00000135114.7,121039242,chr12-121051574-C-T,rs10849835,-1,C,T,121051574,12332,120842634,121235850,208940
12,ENSG00000122965.6,113966325,chr12-113906258-A-G,rs10850237,-1,A,G,113906258,60067,113769717,114162933,136541
12,ENSG00000088992.13,117099416,chr12-117111934-A-C,rs10850762,-1,A,C,117111934,12518,116902808,117296024,209126
12,ENSG00000139344.3,95943331,chr12-95981904-T-C,rs10859995,1,T,C,95981904,38573,95746723,96139939,235181
12,ENSG00000059758.3,96400439,chr12-96353932-T-C,rs10860021,-1,T,C,96353932,46507,96203831,96597047,150101
12,ENSG00000120860.6,102061991,chr12-102203924-C-A,rs10860845,-1,C,A,102203924,141933,101865383,102258599,338541
12,ENSG00000136051.9,105107731,chr12-105283146-C-G,rs10861371,1,C,G,105283146,175415,104911123,105304339,372023
12,ENSG00000139219.12,48004476,chr12-47845347-C-T,rs10875692,-1,C,T,47845347,159129,47807868,48201084,37479
12,ENSG00000139223.1,48472559,chr12-48597854-T-C,rs10875841,1,T,C,48597854,125295,48275951,48669167,321903
12,ENSG00000123297.11,57782787,chr12-57668884-C-T,rs10876993,1,C,T,57668884,113903,57586179,57979395,82705
12,ENSG00000134283.12,42326167,chr12-42327023-G-T,rs10880288,1,G,T,42327023,856,42129559,42522775,197464
12,ENSG00000052126.9,19129733,chr12-18994496-G-A,rs11044375,1,G,A,18994496,135237,18933125,19326341,61371
12,ENSG00000111711.4,21501789,chr12-21525172-G-A,rs11046104,1,G,A,21525172,23383,21305181,21698397,219991
12,ENSG00000029153.10,27332836,chr12-27452505-G-A,rs11049015,1,G,A,27452505,119669,27136228,27529444,316277
12,ENSG00000213809.4,10390041,chr12-10384670-C-T,rs11053781,-1,C,T,10384670,5371,10193433,10586649,191237
12,ENSG00000168778.7,123671113,chr12-123657115-C-T,rs11057322,1,C,T,123657115,13998,123474505,123867721,182610
12,ENSG00000150990.3,124989131,chr12-124927529-T-C,rs11057913,-1,T,C,124927529,61602,124792523,125185739,135006
12,ENSG00000175727.7,122078756,chr12-122180738-C-G,rs11059505,1,C,G,122180738,101982,121882148,122275364,298590
12,ENSG00000006831.9,1691070,chr12-1529589-C-A,rs11061820,1,C,A,1529589,161481,1494462,1887678,35127
12,ENSG00000151062.8,1918652,chr12-2066446-G-A,rs11062100,-1,G,A,2066446,147794,1722044,2115260,344402
12,ENSG00000110799.9,6124670,chr12-6236926-A-G,rs11064099,-1,A,G,6236926,112256,5928062,6321278,308864
12,ENSG00000111652.4,6724046,chr12-6556153-A-C,rs11064253,1,A,C,6556153,167893,6527438,6920654,28715
12,ENSG00000167272.6,120581402,chr12-120403829-A-G,rs11065102,-1,A,G,120403829,177573,120384794,120778010,19035
12,ENSG00000089041.11,121132876,chr12-121052717-C-T,rs11065406,1,C,T,121052717,80159,120936268,121329484,116449
12,ENSG00000089053.7,121352411,chr12-121382889-G-A,rs11065546,-1,G,A,121382889,30478,121155803,121549019,227086
12,ENSG00000179941.5,76348415,chr12-76286580-G-A,rs11106529,-1,G,A,76286580,61835,76151807,76545023,134773
12,ENSG00000028203.12,95217807,chr12-95308609-T-C,rs11107973,1,T,C,95308609,90802,95021199,95414415,287410
12,ENSG00000111696.7,103841234,chr12-103924568-C-T,rs11111846,-1,C,T,103924568,83334,103644626,104037842,279942
12,ENSG00000111727.7,104064531,chr12-104061412-A-G,rs11111881,1,A,G,104061412,3119,103867923,104261139,193489
12,ENSG00000235162.4,105330691,chr12-105473229-G-A,rs11112542,1,G,A,105473229,142538,105134083,105527299,339146
12,ENSG00000136026.9,106248020,chr12-106241790-G-A,rs11112913,-1,G,A,106241790,6230,106051412,106444628,190378
12,ENSG00000165899.6,80099537,chr12-80243202-G-A,rs11114364,1,G,A,80243202,143665,79902929,80296145,340273
12,ENSG00000167528.8,48350919,chr12-48343787-T-C,rs11168534,-1,T,C,48343787,7132,48154311,48547527,189476
12,ENSG00000167550.6,49069979,chr12-49091590-C-G,rs11168854,-1,C,G,49091590,21611,48873371,49266587,218219
12,ENSG00000135503.7,51951699,chr12-51910615-C-T,rs11169953,1,C,T,51910615,41084,51755091,52148307,155524
12,ENSG00000151176.3,113358587,chr12-113410518-G-A,rs111711423,1,G,A,113410518,51931,113161979,113555195,248539
12,ENSG00000151176.3,113358587,chr12-113410518-G-C,rs111711423,1,G,C,113410518,51931,113161979,113555195,248539
12,ENSG00000076067.6,56521820,chr12-56477530-G-A,rs11171862,1,G,A,56477530,44290,56325212,56718428,152318
12,ENSG00000111530.6,67269358,chr12-67436492-A-C,rs11176735,1,A,C,67436492,167134,67072750,67465966,363742
12,ENSG00000187109.8,76084685,chr12-75909979-G-A,rs11180748,-1,G,A,75909979,174706,75888077,76281293,21902
12,ENSG00000111666.5,101697640,chr12-101699976-G-A,rs1124605,1,G,A,101699976,2336,101501032,101894248,198944
12,ENSG00000118971.3,4273762,chr12-4215378-T-C,rs113328221,1,T,C,4215378,58384,4077154,4470370,138224
12,ENSG00000111252.5,111405923,chr12-111320279-C-T,rs114719470,1,C,T,111320279,85644,111209315,111602531,110964
12,ENSG00000111057.6,52949118,chr12-52876467-C-T,rs115234364,1,C,T,52876467,72651,52752510,53145726,123957
12,ENSG00000110944.4,56338884,chr12-56361516-A-C,rs11575217,1,A,C,56361516,22632,56142276,56535492,219240
12,ENSG00000183735.5,64452120,chr12-64338514-A-G,rs11609829,1,A,G,64338514,113606,64255512,64648728,83002
12,ENSG00000139263.7,58920504,chr12-58924023-A-G,rs11611254,-1,A,G,58924023,3519,58723896,59117112,200127
12,ENSG00000166578.4,113221094,chr12-113047794-G-A,rs11614358,-1,G,A,113047794,173300,113024486,113417702,23308
12,ENSG00000161835.6,52006946,chr12-52009252-C-T,rs11614892,1,C,T,52009252,2306,51810338,52203554,198914
12,ENSG00000120820.8,104050187,chr12-104063767-G-A,rs116207492,-1,G,A,104063767,13580,103853579,104246795,210188
12,ENSG00000087494.10,27972733,chr12-28114659-T-G,rs116874782,-1,T,G,28114659,141926,27776125,28169341,338534
12,ENSG00000196876.6,51591233,chr12-51597438-T-C,rs117421828,1,T,C,51597438,6205,51394625,51787841,202813
12,ENSG00000061273.12,47819903,chr12-47763920-C-T,rs11830537,-1,C,T,47763920,55983,47623295,48016511,140625
12,ENSG00000111424.6,47904994,chr12-47796261-C-T,rs11831883,-1,C,T,47796261,108733,47708386,48101602,87875
12,ENSG00000110906.8,109477300,chr12-109642825-G-A,rs11832371,-1,G,A,109642825,165525,109280692,109673908,362133
12,ENSG00000110906.8,109477300,chr12-109642825-G-T,rs11832371,-1,G,T,109642825,165525,109280692,109673908,362133
12,ENSG00000060140.4,10674052,chr12-10657719-A-G,rs11837154,-1,A,G,10657719,16333,10477444,10870660,180275
12,ENSG00000186710.7,113149724,chr12-112970188-A-G,rs11837367,1,A,G,112970188,179536,112953116,113346332,17072
12,ENSG00000089693.6,6753141,chr12-6757986-G-A,rs12229492,-1,G,A,6757986,4845,6556533,6949749,201453
12,ENSG00000177990.7,63668493,chr12-63671518-T-G,rs12231958,-1,T,G,63671518,3025,63471885,63865101,199633
12,ENSG00000070018.4,12267044,chr12-12120503-A-G,rs12296239,-1,A,G,12120503,146541,12070436,12463652,50067
12,ENSG00000174989.7,116910950,chr12-117004499-G-A,rs12299065,1,G,A,117004499,93549,116714342,117107558,290157
12,ENSG00000135506.11,57694132,chr12-57785358-G-A,rs12306667,1,G,A,57785358,91226,57497524,57890740,287834
12,ENSG00000139428.5,109573504,chr12-109645420-G-A,rs12309873,-1,G,A,109645420,71916,109376896,109770112,268524
12,ENSG00000181929.6,49018776,chr12-49093000-T-C,rs12310622,-1,T,C,49093000,74224,48822168,49215384,270832
12,ENSG00000135127.6,119989236,chr12-120169835-G-A,rs12311126,1,G,A,120169835,180599,119792628,120185844,377207
12,ENSG00000139350.7,96907257,chr12-96894316-T-C,rs12319243,1,T,C,96894316,12941,96710649,97103865,183667
12,ENSG00000110851.7,107761137,chr12-107663860-T-C,rs12322163,-1,T,C,107663860,97277,107564529,107957745,99331
12,ENSG00000166130.10,98644788,chr12-98583137-G-T,rs12367211,-1,G,T,98583137,61651,98448180,98841396,134957
12,ENSG00000139629.9,51391406,chr12-51408872-C-T,rs12369067,-1,C,T,51408872,17466,51194798,51588014,214074
12,ENSG00000111335.8,112978519,chr12-112986653-C-T,rs12422608,1,C,T,112986653,8134,112781911,113175127,204742
12,ENSG00000118307.12,25195160,chr12-25177517-C-T,rs12423443,-1,C,T,25177517,17643,24998552,25391768,178965
12,ENSG00000110921.7,109573794,chr12-109677899-C-T,rs12426962,1,C,T,109677899,104105,109377186,109770402,300713
12,ENSG00000123416.9,49131395,chr12-49107615-C-T,rs1274726,-1,C,T,49107615,23780,48934787,49328003,172828
12,ENSG00000196387.4,133080923,chr12-132913877-T-C,rs1278607,1,T,C,132913877,167046,132884315,133277531,29562
12,ENSG00000064763.5,29149278,chr12-29144056-T-C,rs12825454,1,T,C,29144056,5222,28952670,29345886,191386
12,ENSG00000135404.6,55729009,chr12-55723916-C-G,rs13193,-1,C,G,55723916,5093,55532401,55925617,191515
12,ENSG00000151148.8,109477634,chr12-109644426-G-A,rs1344541,1,G,A,109644426,166792,109281026,109674242,363400
12,ENSG00000076555.10,109116587,chr12-109105679-C-A,rs1368557,1,C,A,109105679,10908,108919979,109313195,185700
12,ENSG00000139352.3,102957674,chr12-103069363-C-A,rs1401995,1,C,A,103069363,111689,102761066,103154282,308297
12,ENSG00000139352.3,102957674,chr12-103069363-C-T,rs1401995,1,C,T,103069363,111689,102761066,103154282,308297
12,ENSG00000151229.7,40106081,chr12-40227006-C-G,rs1491942,-1,C,G,40227006,120925,39909473,40302689,317533
12,ENSG00000130779.13,122422669,chr12-122504232-A-G,rs1499681,-1,A,G,122504232,81563,122226061,122619277,278171
12,ENSG00000134291.7,47963596,chr12-47954569-C-G,rs1541408,1,C,G,47954569,9027,47766988,48160204,187581
12,ENSG00000111639.3,6493262,chr12-6565889-T-G,rs1558333,-1,T,G,6565889,72627,6296654,6689870,269235
12,ENSG00000111371.10,46269043,chr12-46183958-A-G,rs15750,-1,A,G,46183958,85085,46072435,46465651,111523
12,ENSG00000110931.12,121296709,chr12-121354289-T-C,rs1617736,-1,T,C,121354289,57580,121100101,121493317,254188
12,ENSG00000076248.4,109097597,chr12-109131263-A-G,rs1642036,1,A,G,109131263,33666,108900989,109294205,230274
12,ENSG00000111348.4,14961601,chr12-14770413-C-A,rs16910246,-1,C,A,14770413,191188,14764993,15158209,5420
12,ENSG00000111348.4,14961601,chr12-14770413-C-T,rs16910246,-1,C,T,14770413,191188,14764993,15158209,5420
12,ENSG00000171823.6,1594581,chr12-1465164-A-G,rs16928471,-1,A,G,1465164,129417,1397973,1791189,67191
12,ENSG00000174456.7,110048522,chr12-109914556-G-A,rs16940680,-1,G,A,109914556,133966,109851914,110245130,62642
12,ENSG00000171310.6,104456948,chr12-104315967-G-A,rs17035358,1,G,A,104315967,140981,104260340,104653556,55627
12,ENSG00000151131.5,104986316,chr12-104856464-A-G,rs17036433,1,A,G,104856464,129852,104789708,105182924,66756
12,ENSG00000135437.5,55720393,chr12-55629199-T-G,rs17117817,1,T,G,55629199,91194,55523785,55917001,105414
12,ENSG00000135424.10,55707904,chr12-55685681-C-G,rs17117860,-1,C,G,55685681,22223,55511296,55904512,174385
12,ENSG00000135392.10,55829587,chr12-55953422-C-T,rs17118141,-1,C,T,55953422,123835,55632979,56026195,320443
12,ENSG00000139651.8,53180722,chr12-53104143-C-G,rs17123210,1,C,G,53104143,76579,52984114,53377330,120029
12,ENSG00000205426.5,52291534,chr12-52194345-C-T,rs17653752,-1,C,T,52194345,97189,52094926,52488142,99419
12,ENSG00000139433.4,109880541,chr12-109916731-C-T,rs17680262,-1,C,T,109916731,36190,109683933,110077149,232798
12,ENSG00000139574.6,53507484,chr12-53412871-C-T,rs17695156,-1,C,T,53412871,94613,53310876,53704092,101995
12,ENSG00000172789.2,54033050,chr12-53925445-C-T,rs17719724,1,C,T,53925445,107605,53836442,54229658,89003
12,ENSG00000139168.3,42326094,chr12-42411228-T-C,rs1796360,-1,T,C,42411228,85134,42129486,42522702,281742
12,ENSG00000167566.11,49828413,chr12-49887631-G-C,rs1878234,-1,G,C,49887631,59218,49631805,50025021,255826
12,ENSG00000121318.2,10826358,chr12-10850855-A-G,rs1972571,-1,A,G,10850855,24497,10629750,11022966,221105
12,ENSG00000111647.8,100142874,chr12-100060573-G-A,rs1994710,-1,G,A,100060573,82301,99946266,100339482,114307
12,ENSG00000089220.3,118136124,chr12-118137291-T-C,rs2088702,1,T,C,118137291,1167,117939516,118332732,197775
12,ENSG00000197905.4,2959397,chr12-3119735-C-T,rs2109206,1,C,T,3119735,160338,2762789,3156005,356946
12,ENSG00000182870.8,132329589,chr12-132493479-A-G,rs2141776,-1,A,G,132493479,163890,132132981,132526197,360498
12,ENSG00000010610.5,6789528,chr12-6642704-C-T,rs2178694,1,C,T,6642704,146824,6592920,6986136,49784
12,ENSG00000111196.5,10613609,chr12-10619180-C-T,rs2219382,-1,C,T,10619180,5571,10417001,10810217,202179
12,ENSG00000089157.11,120201111,chr12-120138461-T-C,rs2269940,-1,T,C,120138461,62650,120004503,120397719,133958
12,ENSG00000167780.7,53103486,chr12-53116149-C-T,rs2272296,1,C,T,53116149,12663,52906878,53300094,209271
12,ENSG00000174527.4,109347903,chr12-109201716-G-A,rs2284691,1,G,A,109201716,146187,109151295,109544511,50421
12,ENSG00000196531.6,56725299,chr12-56684836-A-G,rs2290893,-1,A,G,56684836,40463,56528691,56921907,156145
12,ENSG00000139726.6,122752824,chr12-122854811-C-G,rs2292137,1,C,G,122854811,101987,122556216,122949432,298595
12,ENSG00000139579.7,56224342,chr12-56134334-A-G,rs2292237,1,A,G,56134334,90008,56027734,56420950,106600
12,ENSG00000170627.5,54473602,chr12-54584141-T-A,rs2292490,-1,T,A,54584141,110539,54276994,54670210,307147
12,ENSG00000170627.5,54473602,chr12-54584141-T-G,rs2292490,-1,T,G,54584141,110539,54276994,54670210,307147
12,ENSG00000110871.9,120529158,chr12-120557529-G-A,rs2292681,-1,G,A,120557529,28371,120332550,120725766,224979
12,ENSG00000139546.6,53501283,chr12-53401581-C-A,rs2364598,1,C,A,53401581,99702,53304675,53697891,96906
12,ENSG00000135452.5,57745039,chr12-57735877-G-T,rs238527,1,G,T,57735877,9162,57548431,57941647,187446
12,ENSG00000136044.7,105236174,chr12-105096145-C-T,rs2440693,-1,C,T,105096145,140029,105039566,105432782,56579
12,ENSG00000111786.3,120469748,chr12-120317249-T-G,rs2522132,-1,T,G,120317249,152499,120273140,120666356,44109
12,ENSG00000139192.7,6452042,chr12-6479806-A-C,rs2532514,1,A,C,6479806,27764,6255434,6648650,224372
12,ENSG00000158023.5,121918592,chr12-121859126-T-C,rs2596143,1,T,C,121859126,59466,121721984,122115200,137142
12,ENSG00000139174.6,42589746,chr12-42530501-A-G,rs2600933,-1,A,G,42530501,59245,42393138,42786354,137363
12,ENSG00000177627.5,48482498,chr12-48489237-G-T,rs2731096,1,G,T,48489237,6739,48285890,48679106,203347
12,ENSG00000188026.7,123533719,chr12-123427242-A-C,rs28466887,-1,A,C,123427242,106477,123337111,123730327,90131
12,ENSG00000150977.9,123436684,chr12-123398397-G-A,rs28540654,-1,G,A,123398397,38287,123240076,123633292,158321
12,ENSG00000178449.2,50112236,chr12-49966136-G-A,rs296758,1,G,A,49966136,146100,49915628,50308844,50508
12,ENSG00000212126.3,10986912,chr12-10834637-C-A,rs34059605,-1,C,A,10834637,152275,10790304,11183520,44333
12,ENSG00000121749.11,71839759,chr12-71732067-A-C,rs34207834,1,A,C,71732067,107692,71643151,72036367,88916
12,ENSG00000139410.10,113422380,chr12-113377712-G-T,rs34474591,1,G,T,113377712,44668,113225772,113618988,151940
12,ENSG00000111481.5,54325131,chr12-54292096-C-T,rs35979828,1,C,T,54292096,33035,54128523,54521739,163573
12,ENSG00000130921.3,123233436,chr12-123221415-C-T,rs36121382,1,C,T,123221415,12021,123036828,123430044,184587
12,ENSG00000167588.7,50104008,chr12-49911431-G-T,rs368305,1,G,T,49911431,192577,49907400,50300616,4031
12,ENSG00000135093.7,109052576,chr12-109053663-G-A,rs3742028,1,G,A,109053663,1087,108855968,109249184,197695
12,ENSG00000139364.6,125186386,chr12-125012509-G-A,rs3751184,1,G,A,125012509,173877,124989778,125382994,22731
12,ENSG00000129315.5,48716707,chr12-48866175-G-T,rs3759148,-1,G,T,48866175,149468,48520099,48913315,346076
12,ENSG00000008323.11,6310682,chr12-6376495-T-C,rs3759324,1,T,C,6376495,65813,6114074,6507290,262421
12,ENSG00000076513.10,109999430,chr12-110011934-A-G,rs3759385,1,A,G,110011934,12504,109802822,110196038,209112
12,ENSG00000123360.7,54549601,chr12-54574117-C-T,rs3782411,1,C,T,54574117,24516,54352993,54746209,221124
12,ENSG00000011105.7,3077379,chr12-3225959-A-G,rs3782814,1,A,G,3225959,148580,2880771,3273987,345188
12,ENSG00000166886.8,57089114,chr12-57059089-T-C,rs3803017,1,T,C,57059089,30025,56892506,57285722,166583
12,ENSG00000111452.8,130953907,chr12-131040765-C-T,rs3847688,1,C,T,131040765,86858,130757299,131150515,283466
12,ENSG00000139112.6,10212877,chr12-10320339-G-A,rs3912115,1,G,A,10320339,107462,10016269,10409485,304070
12,ENSG00000139372.10,103965872,chr12-103969832-C-T,rs4135054,1,C,T,103969832,3960,103769264,104162480,200568
12,ENSG00000129317.10,43758790,chr12-43770654-T-C,rs4251467,-1,T,C,43770654,11864,43562182,43955398,208472
12,ENSG00000084444.9,13044381,chr12-13173927-T-C,rs4519177,1,T,C,13173927,129546,12847773,13240989,326154
12,ENSG00000123095.4,26125037,chr12-26078025-T-C,rs4580000,-1,T,C,26078025,47012,25928429,26321645,149596
12,ENSG00000111325.12,122975220,chr12-122797985-G-A,rs4759393,1,G,A,122797985,177235,122778612,123171828,19373
12,ENSG00000139620.8,48682238,chr12-48850564-G-A,rs4760635,-1,G,A,48850564,168326,48485630,48878846,364934
12,ENSG00000111445.9,118016703,chr12-118029748-A-G,rs4767654,1,A,G,118029748,13045,117820095,118213311,209653
12,ENSG00000063046.12,53006456,chr12-53037083-T-C,rs4919699,1,T,C,53037083,30627,52809848,53203064,227235
12,ENSG00000136045.5,107685799,chr12-107668029-C-T,rs4964604,1,C,T,107668029,17770,107489191,107882407,178838
12,ENSG00000255150.1,104303739,chr12-104350629-G-C,rs4964785,1,G,C,104350629,46890,104107131,104500347,243498
12,ENSG00000175970.6,120710458,chr12-120659184-A-G,rs541619,1,A,G,120659184,51274,120513850,120907066,145334
12,ENSG00000110811.13,6828407,chr12-6847298-C-T,rs5446,1,C,T,6847298,18891,6631799,7025015,215499
12,ENSG00000010626.10,6904822,chr12-6847298-C-T,rs5446,1,C,T,6847298,57524,6708214,7101430,139084
12,ENSG00000064102.9,26937981,chr12-26983693-G-T,rs56054487,-1,G,T,26983693,45712,26741373,27134589,242320
12,ENSG00000111328.2,123271856,chr12-123410506-C-T,rs56309603,-1,C,T,123410506,138650,123075248,123468464,335258
12,ENSG00000255398.2,122716811,chr12-122672004-T-C,rs598322,-1,T,C,122672004,44807,122520203,122913419,151801
12,ENSG00000179195.9,123973215,chr12-123879682-G-A,rs61743050,1,G,A,123879682,93533,123776607,124169823,103075
12,ENSG00000257218.1,120446444,chr12-120598945-T-C,rs637799,1,T,C,120598945,152501,120249836,120643052,349109
12,ENSG00000151948.7,128853478,chr12-128849348-C-T,rs6486735,1,C,T,128849348,4130,128656870,129050086,192478
12,ENSG00000212128.2,10909562,chr12-10966520-T-C,rs6488331,-1,T,C,10966520,56958,10712954,11106170,253566
12,ENSG00000135124.9,121210129,chr12-121111820-C-T,rs651221,1,C,T,121111820,98309,121013521,121406737,98299
12,ENSG00000110934.5,51324174,chr12-51360586-A-G,rs6580827,-1,A,G,51360586,36412,51127566,51520782,233020
12,ENSG00000123358.14,52051442,chr12-52151364-A-G,rs6580856,1,A,G,52151364,99922,51854834,52248050,296530
12,ENSG00000204856.7,110468845,chr12-110274407-T-G,rs6606683,1,T,G,110274407,194438,110272237,110665453,2170
12,ENSG00000204856.7,110468845,chr12-110274407-T-A,rs6606683,1,T,A,110274407,194438,110272237,110665453,2170
12,ENSG00000127329.9,70637429,chr12-70471798-G-A,rs669770,-1,G,A,70471798,165631,70440821,70834037,30977
12,ENSG00000127337.2,69359743,chr12-69344359-G-A,rs689415,1,G,A,69344359,15384,69163135,69556351,181224
12,ENSG00000123395.10,52069978,chr12-51875616-A-G,rs697629,1,A,G,51875616,194362,51873370,52266586,2246
12,ENSG00000197728.5,56041918,chr12-56095129-G-A,rs705708,1,G,A,56095129,53211,55845310,56238526,249819
12,ENSG00000047621.7,4538469,chr12-4387114-G-A,rs7131744,-1,G,A,4387114,151355,4341861,4735077,45253
12,ENSG00000182782.6,122703357,chr12-122728193-A-G,rs7131791,-1,A,G,122728193,24836,122506749,122899965,221444
12,ENSG00000050426.9,51048327,chr12-50926748-A-G,rs7135507,1,A,G,50926748,121579,50851719,51244935,75029
12,ENSG00000110876.8,108633894,chr12-108640091-G-A,rs7136041,-1,G,A,108640091,6197,108437286,108830502,202805
12,ENSG00000078246.10,2890891,chr12-2752165-C-T,rs71458014,1,C,T,2752165,138726,2694283,3087499,57882
12,ENSG00000012822.9,53727452,chr12-53923935-G-A,rs7297554,-1,G,A,53923935,196483,53530844,53924060,393091
12,ENSG00000136052.5,104958290,chr12-104877307-G-T,rs7299019,-1,G,T,104877307,80983,104761682,105154898,115625
12,ENSG00000136052.5,104958290,chr12-104877307-G-A,rs7299019,-1,G,A,104877307,80983,104761682,105154898,115625
12,ENSG00000102189.11,92929295,chr12-93031018-G-A,rs7300208,-1,G,A,93031018,101723,92732687,93125903,298331
12,ENSG00000013588.5,12891562,chr12-12789599-C-A,rs7301360,1,C,A,12789599,101963,12694954,13088170,94645
12,ENSG00000057704.6,94650557,chr12-94594711-C-A,rs7301498,-1,C,A,94594711,55846,94453949,94847165,140762
12,ENSG00000111602.7,56449426,chr12-56435308-T-C,rs7302060,-1,T,C,56435308,14118,56252818,56646034,182490
12,ENSG00000166225.4,69470388,chr12-69412967-A-G,rs7307739,1,A,G,69412967,57421,69273780,69666996,139187
12,ENSG00000139405.8,113185721,chr12-113156910-C-T,rs7309187,1,C,T,113156910,28811,112989113,113382329,167797
12,ENSG00000002016.11,949694,chr12-941088-G-A,rs7311151,-1,G,A,941088,8606,753086,1146302,188002
12,ENSG00000111644.3,6647432,chr12-6719809-A-G,rs7312263,-1,A,G,6719809,72377,6450824,6844040,268985
12,ENSG00000135390.12,53676083,chr12-53563802-T-C,rs7314664,-1,T,C,53563802,112281,53479475,53872691,84327
12,ENSG00000134551.7,10929236,chr12-11012152-G-A,rs7315843,1,G,A,11012152,82916,10732628,11125844,279524
12,ENSG00000184752.8,95003697,chr12-95004272-G-A,rs7316005,-1,G,A,95004272,575,94807089,95200305,197183
12,ENSG00000184967.2,132144457,chr12-132220238-G-A,rs73166871,1,G,A,132220238,75781,131947849,132341065,272389
12,ENSG00000111725.5,119668133,chr12-119615482-A-G,rs73221243,1,A,G,119615482,52651,119471525,119864741,143957
12,ENSG00000004700.11,21501635,chr12-21640900-T-C,rs74459792,-1,T,C,21640900,139265,21305027,21698243,335873
12,ENSG00000185163.5,132144319,chr12-132173241-C-T,rs7485855,-1,C,T,132173241,28922,131947711,132340927,225530
12,ENSG00000110888.12,30754514,chr12-30629601-T-C,rs75560605,-1,T,C,30629601,124913,30557906,30951122,71695
12,ENSG00000151079.6,4809176,chr12-4809744-A-G,rs758533,1,A,G,4809744,568,4612568,5005784,197176
12,ENSG00000172322.8,9971409,chr12-9999116-G-A,rs76016091,1,G,A,9999116,27707,9774801,10168017,224315
12,ENSG00000176422.9,56468578,chr12-56527155-T-C,rs774211,1,T,C,56527155,58577,56271970,56665186,255185
12,ENSG00000196935.4,63844700,chr12-63927707-C-T,rs78348533,1,C,T,63927707,83007,63648092,64041308,279615
12,ENSG00000111364.9,123602099,chr12-123572622-C-T,rs786452,1,C,T,123572622,29477,123405491,123798707,167131
12,ENSG00000135441.3,55716046,chr12-55713907-T-C,rs7959622,1,T,C,55713907,2139,55519438,55912654,194469
12,ENSG00000111653.15,6663119,chr12-6645025-A-G,rs7959658,-1,A,G,6645025,18094,6466511,6859727,178514
12,ENSG00000110925.2,51083596,chr12-51110573-C-A,rs7960475,-1,C,A,51110573,26977,50886988,51280204,223585
12,ENSG00000089163.4,120302321,chr12-120282235-T-C,rs7960743,1,T,C,120282235,20086,120105713,120498929,176522
12,ENSG00000111052.3,80937934,chr12-80744142-C-A,rs7963905,-1,C,A,80744142,193792,80741326,81134542,2816
12,ENSG00000198015.7,93467514,chr12-93391758-G-C,rs7964255,1,G,C,93391758,75756,93270906,93664122,120852
12,ENSG00000111728.5,22334707,chr12-22511869-C-T,rs7967059,-1,C,T,22511869,177162,22138099,22531315,373770
12,ENSG00000198270.6,112013165,chr12-112145643-A-C,rs79680080,-1,A,C,112145643,132478,111816557,112209773,329086
12,ENSG00000179256.2,14814182,chr12-14740163-T-C,rs7970697,-1,T,C,14740163,74019,14617574,15010790,122589
12,ENSG00000111321.5,6384162,chr12-6381577-T-C,rs7972647,1,T,C,6381577,2585,6187554,6580770,194023
12,ENSG00000171759.4,102917244,chr12-102932690-G-A,rs7973675,-1,G,A,102932690,15446,102720636,103113852,212054
12,ENSG00000180881.14,75326498,chr12-75477973-C-A,rs7974011,-1,C,A,75477973,151475,75129890,75523106,348083
12,ENSG00000188906.9,40224997,chr12-40194876-C-T,rs7975693,1,C,T,40194876,30121,40028389,40421605,166487
12,ENSG00000089022.8,111842228,chr12-112033912-T-C,rs80288216,1,T,C,112033912,191684,111645620,112038836,388292
12,ENSG00000178498.11,57604824,chr12-57599707-G-A,rs812315,1,G,A,57599707,5117,57408216,57801432,191491
12,ENSG00000089250.13,117361626,chr12-117324894-C-G,rs816293,-1,C,G,117324894,36732,117165018,117558234,159876
12,ENSG00000123349.8,53295542,chr12-53118660-T-C,rs822682,1,T,C,53118660,176882,53098934,53492150,19726
12,ENSG00000110987.4,122021884,chr12-121961047-A-C,rs830127,1,A,C,121961047,60837,121825276,122218492,135771
12,ENSG00000139537.6,48904133,chr12-48970608-G-A,rs833843,1,G,A,48970608,66475,48707525,49100741,263083
12,ENSG00000152944.4,27022558,chr12-27128393-A-G,rs841647,1,A,G,27128393,105835,26825950,27219166,302443
12,ENSG00000165714.6,12357078,chr12-12475285-T-C,rs888197,1,T,C,12475285,118207,12160470,12553686,314815
12,ENSG00000174243.4,48852163,chr12-48755642-C-T,rs953672,-1,C,T,48755642,96521,48655555,49048771,100087
12,ENSG00000174243.4,48852163,chr12-48755642-C-A,rs953672,-1,C,A,48755642,96521,48655555,49048771,100087
12,ENSG00000111254.2,4649051,chr12-4607406-C-A,rs997373,-1,C,A,4607406,41645,4452443,4845659,154963
12,ENSG00000010278.6,6200400,chr12-6182726-A-G,rs998908,1,A,G,6182726,17674,6003792,6397008,178934
12,ENSG00000087502.12,29381172,chr12-29282682-T-C,rs1006410,-1,T,C,29282682,98490,29184564,29577780,98118
12,ENSG00000166130.10,98644788,chr12-98613845-C-T,rs1048906,-1,C,T,98613845,30943,98448180,98841396,165665
12,ENSG00000111666.5,101697640,chr12-101640342-T-G,rs10507134,1,T,G,101640342,57298,101501032,101894248,139310
12,ENSG00000204954.5,103957215,chr12-103851268-G-A,rs10507170,-1,G,A,103851268,105947,103760607,104153823,90661
12,ENSG00000121318.2,10826358,chr12-10892913-T-C,rs10772380,-1,T,C,10892913,66555,10629750,11022966,263163
12,ENSG00000121318.2,10826358,chr12-10892913-T-G,rs10772380,-1,T,G,10892913,66555,10629750,11022966,263163
12,ENSG00000246705.2,14774405,chr12-14942773-T-C,rs10772822,1,T,C,14942773,168368,14577797,14971013,364976
12,ENSG00000111445.9,118016703,chr12-118000658-G-A,rs10774976,1,G,A,118000658,16045,117820095,118213311,180563
12,ENSG00000166598.7,103930410,chr12-103931947-A-G,rs10778306,1,A,G,103931947,1537,103733802,104127018,198145
12,ENSG00000172602.5,48865870,chr12-48682253-T-C,rs10783277,-1,T,C,48682253,183617,48669262,49062478,12991
12,ENSG00000111196.5,10613609,chr12-10622596-T-C,rs1078437,-1,T,C,10622596,8987,10417001,10810217,205595
12,ENSG00000253719.2,74537835,chr12-74465857-T-A,rs10785121,1,T,A,74465857,71978,74341227,74734443,124630
12,ENSG00000136044.7,105236174,chr12-105336497-C-T,rs10861399,-1,C,T,105336497,100323,105039566,105432782,296931
12,ENSG00000065357.14,55931162,chr12-55924259-C-T,rs10876862,1,C,T,55924259,6903,55734554,56127770,189705
12,ENSG00000127337.2,69359743,chr12-69401076-G-A,rs10878976,1,G,A,69401076,41333,69163135,69556351,237941
12,ENSG00000064115.6,27014384,chr12-26854717-T-C,rs11048738,-1,T,C,26854717,159667,26817776,27210992,36941
12,ENSG00000064102.9,26937981,chr12-26888264-T-C,rs11048764,-1,T,C,26888264,49717,26741373,27134589,146891
12,ENSG00000123106.6,28190456,chr12-28295880-G-A,rs11049512,1,G,A,28295880,105424,27993848,28387064,302032
12,ENSG00000172243.13,10130199,chr12-10131112-T-C,rs11053624,-1,T,C,10131112,913,9933591,10326807,197521
12,ENSG00000173391.4,10172132,chr12-10131112-T-C,rs11053624,-1,T,C,10131112,41020,9975524,10368740,155588
12,ENSG00000255837.1,10998304,chr12-10989464-T-G,rs11054134,-1,T,G,10989464,8840,10801696,11194912,187768
12,ENSG00000013583.4,13000265,chr12-13035051-T-C,rs11055209,-1,T,C,13035051,34786,12803657,13196873,231394
12,ENSG00000111328.2,123271856,chr12-123142469-T-C,rs1106241,-1,T,C,123142469,129387,123075248,123468464,67221
12,ENSG00000111725.5,119668133,chr12-119515726-C-T,rs11064820,1,C,T,119515726,152407,119471525,119864741,44201
12,ENSG00000139428.5,109573504,chr12-109414094-C-T,rs11066523,-1,C,T,109414094,159410,109376896,109770112,37198
12,ENSG00000176834.9,118104011,chr12-118057080-C-A,rs11068793,-1,C,A,118057080,46931,117907403,118300619,149677
12,ENSG00000136048.9,101877580,chr12-101933531-T-C,rs11111093,1,T,C,101933531,55951,101680972,102074188,252559
12,ENSG00000136048.9,101877580,chr12-101933531-T-A,rs11111093,1,T,A,101933531,55951,101680972,102074188,252559
12,ENSG00000111727.7,104064531,chr12-104061562-G-A,rs11111882,1,G,A,104061562,2969,103867923,104261139,193639
12,ENSG00000214029.3,133130274,chr12-133127915-A-G,rs11147244,-1,A,G,133127915,2359,132933666,133326882,194249
12,ENSG00000134291.7,47963596,chr12-47982747-C-A,rs11168337,1,C,A,47982747,19151,47766988,48160204,215759
12,ENSG00000135390.12,53676083,chr12-53636454-G-T,rs11170624,-1,G,T,53636454,39629,53479475,53872691,156979
12,ENSG00000139579.7,56224342,chr12-56382802-G-A,rs11171821,1,G,A,56382802,158460,56027734,56420950,355068
12,ENSG00000111602.7,56449426,chr12-56477530-G-A,rs11171862,-1,G,A,56477530,28104,56252818,56646034,224712
12,ENSG00000185633.6,57237104,chr12-57342432-C-T,rs11172171,-1,C,T,57342432,105328,57040496,57433712,301936
12,ENSG00000173208.3,39619803,chr12-39808761-C-T,rs11173669,-1,C,T,39808761,188958,39423195,39816411,385566
12,ENSG00000153179.6,64610495,chr12-64641065-A-G,rs11175490,1,A,G,64641065,30570,64413887,64807103,227178
12,ENSG00000166226.7,69585459,chr12-69437922-C-A,rs11177670,1,C,A,69437922,147537,69388851,69782067,49071
12,ENSG00000121749.11,71839759,chr12-72016299-G-A,rs11179050,1,G,A,72016299,176540,71643151,72036367,373148
12,ENSG00000170442.6,52274645,chr12-52122398-G-T,rs111868817,1,G,T,52122398,152247,52078037,52471253,44361
12,ENSG00000135677.4,64759406,chr12-64881988-A-G,rs1147085,-1,A,G,64881988,122582,64562798,64956014,319190
12,ENSG00000183955.8,123384132,chr12-123484470-C-T,rs11497311,1,C,T,123484470,100338,123187524,123580740,296946
12,ENSG00000111321.5,6384162,chr12-6393576-G-A,rs11616188,1,G,A,6393576,9414,6187554,6580770,206022
12,ENSG00000118600.6,63779909,chr12-63902006-T-G,rs117782892,1,T,G,63902006,122097,63583301,63976517,318705
12,ENSG00000110871.9,120529158,chr12-120491660-G-T,rs117807066,-1,G,T,120491660,37498,120332550,120725766,159110
12,ENSG00000176422.9,56468578,chr12-56487830-G-A,rs117867773,1,G,A,56487830,19252,56271970,56665186,215860
12,ENSG00000123342.11,55842936,chr12-55746243-C-A,rs11829536,-1,C,A,55746243,96693,55646328,56039544,99915
12,ENSG00000151148.8,109477634,chr12-109406873-A-C,rs11835066,1,A,C,109406873,70761,109281026,109674242,125847
12,ENSG00000111186.8,1629231,chr12-1534947-G-A,rs12049927,1,G,A,1534947,94284,1432623,1825839,102324
12,ENSG00000060982.10,24949101,chr12-25061197-T-A,rs12228264,-1,T,A,25061197,112096,24752493,25145709,308704
12,ENSG00000198001.8,43758951,chr12-43587956-A-G,rs12230765,1,A,G,43587956,170995,43562343,43955559,25613
12,ENSG00000111252.5,111405923,chr12-111348810-T-G,rs12298196,1,T,G,111348810,57113,111209315,111602531,139495
12,ENSG00000078237.4,4321213,chr12-4209808-C-A,rs12307582,1,C,A,4209808,111405,4124605,4517821,85203
12,ENSG00000170439.5,55681736,chr12-55675354-C-T,rs12313602,1,C,T,55675354,6382,55485128,55878344,190226
12,ENSG00000177990.7,63668493,chr12-63560520-C-T,rs12314553,-1,C,T,63560520,107973,63471885,63865101,88635
12,ENSG00000182379.9,57216794,chr12-57118687-C-G,rs12368672,1,C,G,57118687,98107,57020186,57413402,98501
12,ENSG00000120800.4,101280105,chr12-101120067-C-T,rs12370673,1,C,T,101120067,160038,101083497,101476713,36570
12,ENSG00000139405.8,113185721,chr12-113305074-C-T,rs12422330,1,C,T,113305074,119353,112989113,113382329,315961
12,ENSG00000089127.7,112906962,chr12-112986653-C-T,rs12422608,1,C,T,112986653,79691,112710354,113103570,276299
12,ENSG00000151067.14,2052987,chr12-1955500-T-C,rs12423058,1,T,C,1955500,97487,1856379,2249595,99121
12,ENSG00000111667.9,6852150,chr12-6739726-G-A,rs12427243,1,G,A,6739726,112424,6655542,7048758,84184
12,ENSG00000229117.4,56116633,chr12-56045425-A-G,rs12580100,1,A,G,56045425,71208,55920025,56313241,125400
12,ENSG00000089157.11,120201111,chr12-120178003-G-A,rs12581892,-1,G,A,120178003,23108,120004503,120397719,173500
12,ENSG00000130037.3,5043879,chr12-4858367-T-C,rs12582063,1,T,C,4858367,185512,4847271,5240487,11096
12,ENSG00000120860.6,102061991,chr12-101929489-G-C,rs12582545,-1,G,C,101929489,132502,101865383,102258599,64106
12,ENSG00000198040.6,133037509,chr12-132913877-T-C,rs1278607,1,T,C,132913877,123632,132840901,133234117,72976
12,ENSG00000139410.10,113422380,chr12-113448209-T-C,rs12809961,1,T,C,113448209,25829,113225772,113618988,222437
12,ENSG00000123358.14,52051442,chr12-52172138-A-G,rs12824949,1,A,G,52172138,120696,51854834,52248050,317304
12,ENSG00000135424.10,55707904,chr12-55723916-C-G,rs13193,-1,C,G,55723916,16012,55511296,55904512,212620
12,ENSG00000196387.4,133080923,chr12-132921758-G-A,rs13273,1,G,A,132921758,159165,132884315,133277531,37443
12,ENSG00000122970.11,110124357,chr12-110071656-G-A,rs13313219,1,G,A,110071656,52701,109927749,110320965,143907
12,ENSG00000111696.7,103841234,chr12-103844051-T-G,rs1370780,-1,T,G,103844051,2817,103644626,104037842,199425
12,ENSG00000173064.5,112382431,chr12-112233644-G-A,rs144773988,-1,G,A,112233644,148787,112185823,112579039,47821
12,ENSG00000196876.6,51591233,chr12-51629035-G-T,rs1483000,1,G,T,51629035,37802,51394625,51787841,234410
12,ENSG00000155974.7,66679076,chr12-66599088-T-C,rs1493481,-1,T,C,66599088,79988,66482468,66875684,116620
12,ENSG00000135392.10,55829587,chr12-55641345-A-T,rs1534232,-1,A,T,55641345,188242,55632979,56026195,8366
12,ENSG00000135392.10,55829587,chr12-55641345-A-C,rs1534232,-1,A,C,55641345,188242,55632979,56026195,8366
12,ENSG00000179088.10,103495968,chr12-103581871-A-G,rs1593812,-1,A,G,103581871,85903,103299360,103692576,282511
12,ENSG00000135679.15,68808177,chr12-68883385-A-G,rs1663588,1,A,G,68883385,75208,68611569,69004785,271816
12,ENSG00000110841.8,27524206,chr12-27578871-A-G,rs16931559,1,A,G,27578871,54665,27327598,27720814,251273
12,ENSG00000139433.4,109880541,chr12-109930592-A-G,rs16940693,-1,A,G,109930592,50051,109683933,110077149,246659
12,ENSG00000022840.9,120534356,chr12-120398422-C-T,rs16950118,1,C,T,120398422,135934,120337748,120730964,60674
12,ENSG00000180481.6,75391089,chr12-75502908-A-C,rs1697752,1,A,C,75502908,111819,75194481,75587697,308427
12,ENSG00000075856.6,108561173,chr12-108453459-A-G,rs17040551,-1,A,G,108453459,107714,108364565,108757781,88894
12,ENSG00000127325.13,69699303,chr12-69664094-G-T,rs17106910,-1,G,T,69664094,35209,69502695,69895911,161399
12,ENSG00000123415.9,54188985,chr12-54307317-C-T,rs17110596,-1,C,T,54307317,118332,53992377,54385593,314940
12,ENSG00000123415.9,54188985,chr12-54307317-C-A,rs17110596,-1,C,A,54307317,118332,53992377,54385593,314940
12,ENSG00000139289.7,76031776,chr12-75847358-C-T,rs17115813,-1,C,T,75847358,184418,75835168,76228384,12190
12,ENSG00000135404.6,55729009,chr12-55685681-C-G,rs17117860,-1,C,G,55685681,43328,55532401,55925617,153280
12,ENSG00000197728.5,56041918,chr12-56126225-T-C,rs17118313,1,T,C,56126225,84307,55845310,56238526,280915
12,ENSG00000111057.6,52949118,chr12-52813655-G-A,rs17119475,1,G,A,52813655,135463,52752510,53145726,61145
12,ENSG00000183283.9,51238826,chr12-51103790-T-C,rs17125370,1,T,C,51103790,135036,51042218,51435434,61572
12,ENSG00000050426.9,51048327,chr12-51103790-T-C,rs17125370,1,T,C,51103790,55463,50851719,51244935,252071
12,ENSG00000171759.4,102917244,chr12-102847292-T-C,rs1722387,-1,T,C,102847292,69952,102720636,103113852,126656
12,ENSG00000111325.12,122975220,chr12-123091195-A-G,rs1727307,1,A,G,123091195,115975,122778612,123171828,312583
12,ENSG00000139547.6,56957608,chr12-56934660-C-T,rs17447003,-1,C,T,56934660,22948,56761000,57154216,173660
12,ENSG00000139055.2,14938537,chr12-14802967-G-A,rs17821751,-1,G,A,14802967,135570,14741929,15135145,61038
12,ENSG00000177981.5,48157515,chr12-47977812-G-A,rs1793949,-1,G,A,47977812,179703,47960907,48354123,16905
12,ENSG00000166578.4,113221094,chr12-113062323-G-A,rs1902953,-1,G,A,113062323,158771,113024486,113417702,37837
12,ENSG00000134532.10,23949670,chr12-24135219-T-C,rs1909355,-1,T,C,24135219,185549,23753062,24146278,382157
12,ENSG00000151233.6,42144874,chr12-41961798-T-C,rs1920697,-1,T,C,41961798,183076,41948266,42341482,13532
12,ENSG00000111790.9,26938470,chr12-27104833-G-A,rs2003380,1,G,A,27104833,166363,26741862,27135078,362971
12,ENSG00000110880.6,108731518,chr12-108884971-T-G,rs2111902,-1,T,G,108884971,153453,108534910,108928126,350061
12,ENSG00000139354.6,100573684,chr12-100677849-G-A,rs2114923,1,G,A,100677849,104165,100377076,100770292,300773
12,ENSG00000139726.6,122752824,chr12-122769991-A-G,rs2154,1,A,G,122769991,17167,122556216,122949432,213775
12,ENSG00000079337.10,47758880,chr12-47875627-A-G,rs2239186,-1,A,G,47875627,116747,47562272,47955488,313355
12,ENSG00000089163.4,120302321,chr12-120250322-T-C,rs2239208,1,T,C,120250322,51999,120105713,120498929,144609
12,ENSG00000139572.3,54364486,chr12-54524455-T-C,rs2252132,-1,T,C,54524455,159969,54167878,54561094,356577
12,ENSG00000157837.10,120904358,chr12-120971439-G-A,rs2254779,-1,G,A,120971439,67081,120707750,121100966,263689
12,ENSG00000182782.6,122703357,chr12-122859474-G-A,rs2271051,-1,G,A,122859474,156117,122506749,122899965,352725
12,ENSG00000110958.10,56688284,chr12-56752285-T-G,rs2277339,-1,T,G,56752285,64001,56491676,56884892,260609
12,ENSG00000111726.8,22046218,chr12-21925622-T-C,rs2277404,1,T,C,21925622,120596,21849610,22242826,76012
12,ENSG00000170473.12,55927894,chr12-55839734-G-A,rs2291267,-1,G,A,55839734,88160,55731286,56124502,108448
12,ENSG00000167566.11,49828413,chr12-49990566-T-C,rs2292721,-1,T,C,49990566,162153,49631805,50025021,358761
12,ENSG00000111713.2,21604847,chr12-21560468-T-C,rs2306180,-1,T,C,21560468,44379,21408239,21801455,152229
12,ENSG00000111181.8,214157,chr12-136662-A-G,rs2368834,-1,A,G,136662,77495,17549,410765,119113
12,ENSG00000175215.5,57846729,chr12-57731020-C-T,rs238523,-1,C,T,57731020,115709,57650121,58043337,80899
12,ENSG00000166908.12,57591192,chr12-57735877-G-T,rs238527,1,G,T,57735877,144685,57394584,57787800,341293
12,ENSG00000151239.9,43806317,chr12-43884686-A-G,rs2407782,-1,A,G,43884686,78369,43609709,44002925,274977
12,ENSG00000174243.4,48852163,chr12-48854831-G-A,rs2453481,-1,G,A,48854831,2668,48655555,49048771,199276
12,ENSG00000135144.3,113056730,chr12-113107069-C-T,rs2468355,1,C,T,113107069,50339,112860122,113253338,246947
12,ENSG00000087448.5,27780233,chr12-27852721-G-A,rs258396,1,G,A,27852721,72488,27583625,27976841,269096
12,ENSG00000089053.7,121352411,chr12-121350310-G-A,rs2668261,-1,G,A,121350310,2101,121155803,121549019,194507
12,ENSG00000135124.9,121210129,chr12-121195980-C-T,rs2686365,1,C,T,121195980,14149,121013521,121406737,182459
12,ENSG00000179715.8,47079621,chr12-46978487-C-T,rs2711721,1,C,T,46978487,101134,46883013,47276229,95474
12,ENSG00000150977.9,123436684,chr12-123433046-A-G,rs28531860,-1,A,G,123433046,3638,123240076,123633292,192970
12,ENSG00000090376.4,66189214,chr12-66103089-T-G,rs2870782,1,T,G,66103089,86125,65992606,66385822,110483
12,ENSG00000110881.6,50057596,chr12-49957170-T-C,rs296766,1,T,C,49957170,100426,49860988,50254204,96182
12,ENSG00000133687.10,29783942,chr12-29789364-G-C,rs302345,-1,G,C,29789364,5422,29587334,29980550,202030
12,ENSG00000135441.3,55716046,chr12-55723786-C-T,rs3138136,1,C,T,55723786,7740,55519438,55912654,204348
12,ENSG00000111537.4,68159740,chr12-68162395-A-C,rs3181032,-1,A,C,68162395,2655,67963132,68356348,199263
12,ENSG00000178878.7,12785659,chr12-12717761-T-C,rs34330,1,T,C,12717761,67898,12589051,12982267,128710
12,ENSG00000065361.7,56080165,chr12-56137837-C-T,rs35807059,1,C,T,56137837,57672,55883557,56276773,254280
12,ENSG00000188026.7,123533719,chr12-123583584-C-G,rs35958962,-1,C,G,123583584,49865,123337111,123730327,246473
12,ENSG00000135469.9,56266942,chr12-56080595-T-C,rs3741499,1,T,C,56080595,186347,56070334,56463550,10261
12,ENSG00000139620.8,48682238,chr12-48654955-G-T,rs3741628,-1,G,T,48654955,27283,48485630,48878846,169325
12,ENSG00000168778.7,123671113,chr12-123613277-A-G,rs3748268,1,A,G,123613277,57836,123474505,123867721,138772
12,ENSG00000165714.6,12357078,chr12-12465493-C-T,rs3751261,1,C,T,12465493,108415,12160470,12553686,305023
12,ENSG00000110851.7,107761137,chr12-107691793-G-T,rs3825256,-1,G,T,107691793,69344,107564529,107957745,127264
12,ENSG00000123395.10,52069978,chr12-51899716-G-A,rs3847859,1,G,A,51899716,170262,51873370,52266586,26346
12,ENSG00000135114.7,121039242,chr12-121050716-C-G,rs3850515,-1,C,G,121050716,11474,120842634,121235850,208082
12,ENSG00000111641.6,6568291,chr12-6385344-C-T,rs41393248,-1,C,T,6385344,182947,6371683,6764899,13661
12,ENSG00000198324.8,111369095,chr12-111344495-T-C,rs41466849,-1,T,C,111344495,24600,111172487,111565703,172008
12,ENSG00000151491.7,15789388,chr12-15651058-T-C,rs4237955,-1,T,C,15651058,138330,15592780,15985996,58278
12,ENSG00000139174.6,42589746,chr12-42674441-C-T,rs4315147,-1,C,T,42674441,84695,42393138,42786354,281303
12,ENSG00000139174.6,42589746,chr12-42674441-C-G,rs4315147,-1,C,G,42674441,84695,42393138,42786354,281303
12,ENSG00000171681.8,14365682,chr12-14289032-C-T,rs4363703,1,C,T,14289032,76650,14169074,14562290,119958
12,ENSG00000172322.8,9971409,chr12-9961838-T-C,rs4502063,1,T,C,9961838,9571,9774801,10168017,187037
12,ENSG00000166888.4,57111362,chr12-57132863-G-A,rs4759276,-1,G,A,57132863,21501,56914754,57307970,218109
12,ENSG00000075415.8,98593686,chr12-98784187-T-C,rs4762212,1,T,C,98784187,190501,98397078,98790294,387109
12,ENSG00000089693.6,6753141,chr12-6770036-T-C,rs4764622,-1,T,C,6770036,16895,6556533,6949749,213503
12,ENSG00000257218.1,120446444,chr12-120473983-G-A,rs540520,1,G,A,120473983,27539,120249836,120643052,224147
12,ENSG00000182196.8,122980681,chr12-122813355-C-T,rs55716280,1,C,T,122813355,167326,122784073,123177289,29282
12,ENSG00000176894.5,132687587,chr12-132625842-G-A,rs5745073,1,G,A,132625842,61745,132490979,132884195,134863
12,ENSG00000212126.3,10986912,chr12-10936035-T-G,rs61912262,-1,T,G,10936035,50877,10790304,11183520,145731
12,ENSG00000186666.4,49843106,chr12-50031663-C-T,rs61926112,-1,C,T,50031663,188557,49646498,50039714,385165
12,ENSG00000182199.6,57229711,chr12-57117002-G-C,rs61937568,1,G,C,57117002,112709,57033103,57426319,83899
12,ENSG00000111728.5,22334707,chr12-22411548-A-G,rs6487303,-1,A,G,22411548,76841,22138099,22531315,273449
12,ENSG00000111245.8,110920579,chr12-110836952-T-C,rs6490098,-1,T,C,110836952,83627,110723971,111117187,112981
12,ENSG00000134287.4,48957487,chr12-48949941-C-T,rs6580696,-1,C,T,48949941,7546,48760879,49154095,189062
12,ENSG00000134551.7,10929236,chr12-10986336-T-C,rs66679979,1,T,C,10986336,57100,10732628,11125844,253708
12,ENSG00000089041.11,121132876,chr12-121140044-T-C,rs672140,1,T,C,121140044,7168,120936268,121329484,203776
12,ENSG00000188596.3,96489577,chr12-96660187-T-C,rs7131786,1,T,C,96660187,170610,96292969,96686185,367218
12,ENSG00000111145.3,96194375,chr12-96192843-G-A,rs7132101,1,G,A,96192843,1532,95997767,96390983,195076
12,ENSG00000111254.2,4649051,chr12-4620643-T-C,rs7134765,-1,T,C,4620643,28408,4452443,4845659,168200
12,ENSG00000087470.12,32679301,chr12-32734276-A-G,rs7135097,1,A,G,32734276,54975,32482693,32875909,251583
12,ENSG00000135119.10,116738315,chr12-116657392-G-A,rs7136241,1,G,A,116657392,80923,116541707,116934923,115685
12,ENSG00000111335.8,112978519,chr12-113151096-A-G,rs7136744,1,A,G,113151096,172577,112781911,113175127,369185
12,ENSG00000127311.5,66302493,chr12-66270936-G-A,rs7137181,1,G,A,66270936,31557,66105885,66499101,165051
12,ENSG00000127329.9,70637429,chr12-70792964-T-G,rs7137586,-1,T,G,70792964,155535,70440821,70834037,352143
12,ENSG00000139200.7,6700815,chr12-6568437-A-G,rs71445110,-1,A,G,6568437,132378,6504207,6897423,64230
12,ENSG00000139044.6,459939,chr12-555328-G-A,rs71447498,1,G,A,555328,95389,263331,656547,291997
12,ENSG00000086598.4,123584552,chr12-123633942-A-C,rs7294420,1,A,C,123633942,49390,123387944,123781160,245998
12,ENSG00000112787.7,132490151,chr12-132478070-T-C,rs7296889,1,T,C,132478070,12081,132293543,132686759,184527
12,ENSG00000166211.6,101475336,chr12-101597972-A-C,rs7297322,1,A,C,101597972,122636,101278728,101671944,319244
12,ENSG00000184574.4,6635959,chr12-6542275-C-T,rs7297364,-1,C,T,6542275,93684,6439351,6832567,102924
12,ENSG00000076067.6,56521820,chr12-56435308-T-C,rs7302060,1,T,C,56435308,86512,56325212,56718428,110096
12,ENSG00000171823.6,1594581,chr12-1596686-A-G,rs7303661,-1,A,G,1596686,2105,1397973,1791189,198713
12,ENSG00000161800.8,50025494,chr12-49947682-T-C,rs7305290,-1,T,C,49947682,77812,49828886,50222102,118796
12,ENSG00000139344.3,95943331,chr12-95988866-A-G,rs7308827,1,A,G,95988866,45535,95746723,96139939,242143
12,ENSG00000073060.9,124863864,chr12-124939956-A-G,rs7309029,-1,A,G,124939956,76092,124667256,125060472,272700
12,ENSG00000159335.9,6766363,chr12-6722810-C-T,rs7309525,1,C,T,6722810,43553,6569755,6962971,153055
12,ENSG00000139193.3,6444955,chr12-6440585-T-C,rs7312492,1,T,C,6440585,4370,6248347,6641563,192238
12,ENSG00000139190.11,6470677,chr12-6440585-T-C,rs7312492,-1,T,C,6440585,30092,6274069,6667285,166516
12,ENSG00000033030.9,122500932,chr12-122413433-G-A,rs7313301,-1,G,A,122413433,87499,122304324,122697540,109109
12,ENSG00000198015.7,93467514,chr12-93524723-C-T,rs73369636,1,C,T,93524723,57209,93270906,93664122,253817
12,ENSG00000179941.5,76348415,chr12-76345044-C-G,rs73383520,-1,C,G,76345044,3371,76151807,76545023,193237
12,ENSG00000166881.5,57078791,chr12-56955255-G-A,rs746049,-1,G,A,56955255,123536,56882183,57275399,73072
12,ENSG00000060140.4,10674052,chr12-10530730-G-A,rs7486108,-1,G,A,10530730,143322,10477444,10870660,53286
12,ENSG00000173598.9,93377925,chr12-93557831-C-T,rs7488123,1,C,T,93557831,179906,93181317,93574533,376514
12,ENSG00000110987.4,122021884,chr12-122033994-C-T,rs75493897,1,C,T,122033994,12110,121825276,122218492,208718
12,ENSG00000111046.3,80707634,chr12-80739141-A-G,rs77188279,1,A,G,80739141,31507,80511026,80904242,228115
12,ENSG00000092841.13,56158359,chr12-56271104-C-T,rs773651,1,C,T,56271104,112745,55961751,56354967,309353
12,ENSG00000139269.2,57455307,chr12-57625712-C-T,rs774894,1,C,T,57625712,170405,57258699,57651915,367013
12,ENSG00000166987.9,57522824,chr12-57584957-C-T,rs775251,1,C,T,57584957,62133,57326216,57719432,258741
12,ENSG00000135439.6,57738742,chr12-57563014-C-T,rs775321,-1,C,T,57563014,175728,57542134,57935350,20880
12,ENSG00000111361.7,123633686,chr12-123606913-G-A,rs786439,-1,G,A,123606913,26773,123437078,123830294,169835
12,ENSG00000133858.11,71663848,chr12-71597075-G-A,rs79241756,-1,G,A,71597075,66773,71467240,71860456,129835
12,ENSG00000130038.5,3753109,chr12-3747398-G-A,rs79321752,-1,G,A,3747398,5711,3556501,3949717,190897
12,ENSG00000010278.6,6200400,chr12-6201684-A-G,rs7953334,1,A,G,6201684,1284,6003792,6397008,197892
12,ENSG00000151490.9,15322508,chr12-15167225-G-A,rs79555850,1,G,A,15167225,155283,15125900,15519116,41325
12,ENSG00000139173.4,43836081,chr12-43883270-G-A,rs7956766,1,G,A,43883270,47189,43639473,44032689,243797
12,ENSG00000183735.5,64452120,chr12-64511253-T-C,rs7959278,1,T,C,64511253,59133,64255512,64648728,255741
12,ENSG00000179256.2,14814182,chr12-14802768-T-A,rs7959540,-1,T,A,14802768,11414,14617574,15010790,185194
12,ENSG00000256436.1,11031407,chr12-11022859-A-C,rs7961372,-1,A,C,11022859,8548,10834799,11228015,188060
12,ENSG00000135407.6,57818734,chr12-57983284-C-T,rs7964378,-1,C,T,57983284,164550,57622126,58015342,361158
12,ENSG00000139531.7,55997276,chr12-56186042-C-T,rs79659813,1,C,T,56186042,188766,55800668,56193884,385374
12,ENSG00000070018.4,12267044,chr12-12085113-C-G,rs7972613,-1,C,G,12085113,181931,12070436,12463652,14677
12,ENSG00000184752.8,95003697,chr12-94967935-C-G,rs7974156,-1,C,G,94967935,35762,94807089,95200305,160846
12,ENSG00000110900.10,30926748,chr12-30915263-G-T,rs7975877,1,G,T,30915263,11485,30730140,31123356,185123
12,ENSG00000120868.9,98645290,chr12-98629196-T-C,rs7978134,1,T,C,98629196,16094,98448682,98841898,180514
12,ENSG00000088986.6,120496113,chr12-120514819-G-C,rs7979366,1,G,C,120514819,18706,120299505,120692721,215314
12,ENSG00000255374.1,11092313,chr12-11225664-C-T,rs80325732,-1,C,T,11225664,133351,10895705,11288921,329959
12,ENSG00000196465.5,56152256,chr12-56086799-G-A,rs877636,1,G,A,56086799,65457,55955648,56348864,131151
12,ENSG00000174236.2,27696447,chr12-27699497-T-C,rs929952,1,T,C,27699497,3050,27499839,27893055,199658
12,ENSG00000139168.3,42326094,chr12-42482315-T-C,rs935893,-1,T,C,42482315,156221,42129486,42522702,352829
12,ENSG00000111653.15,6663119,chr12-6539032-A-G,rs9634157,-1,A,G,6539032,124087,6466511,6859727,72521
12,ENSG00000076108.7,56630326,chr12-56445047-T-A,rs9737784,-1,T,A,56445047,185279,56433718,56826934,11329
11,ENSG00000175634.8,67428494,chr11-67435355-G-A,rs10274,1,G,A,67435355,6861,67231886,67625102,203469
11,ENSG00000176148.10,33039572,chr11-33044928-G-A,rs1033720,1,G,A,33044928,5356,32842964,33236180,201964
11,ENSG00000162105.9,71252577,chr11-71255951-C-T,rs10431158,-1,C,T,71255951,3374,71055969,71449185,199982
11,ENSG00000177963.7,207708,chr11-252942-G-A,rs1045577,1,G,A,252942,45234,11100,404316,241842
11,ENSG00000110514.13,47270156,chr11-47273075-T-C,rs10501321,1,T,C,47273075,2919,47073548,47466764,199527
11,ENSG00000137497.12,72080542,chr11-72203680-T-G,rs10501409,-1,T,G,72203680,123138,71883934,72277150,319746
11,ENSG00000110777.7,111379275,chr11-111350829-C-A,rs10502141,-1,C,A,111350829,28446,111182667,111575883,168162
11,ENSG00000142102.11,289126,chr11-295527-T-C,rs1060819,1,T,C,295527,6401,92518,485734,203009
11,ENSG00000149084.7,43680738,chr11-43856384-C-A,rs1061810,1,C,A,43856384,175646,43484130,43877346,372254
11,ENSG00000110619.12,3057423,chr11-3244903-T-C,rs10766825,-1,T,C,3244903,187480,2860815,3254031,384088
11,ENSG00000166199.8,43880831,chr11-43915395-T-C,rs10768994,1,T,C,43915395,34564,43684223,44077439,231172
11,ENSG00000154134.10,124865432,chr11-124877437-A-G,rs10790713,1,A,G,124877437,12005,124668824,125062040,208613
11,ENSG00000172818.5,65787063,chr11-65791795-A-G,rs10791824,1,A,G,65791795,4732,65590455,65983671,201340
11,ENSG00000254470.2,65780976,chr11-65791795-A-G,rs10791824,-1,A,G,65791795,10819,65584368,65977584,207427
11,ENSG00000165490.8,82901736,chr11-82968539-T-G,rs10792668,1,T,G,82968539,66803,82705128,83098344,263411
11,ENSG00000137513.5,78574864,chr11-78567746-T-C,rs10793334,-1,T,C,78567746,7118,78378256,78771472,189490
11,ENSG00000020922.7,94493844,chr11-94333827-A-G,rs10831203,-1,A,G,94333827,160017,94297236,94690452,36591
11,ENSG00000135387.14,34051731,chr11-33974250-A-G,rs10836136,1,A,G,33974250,77481,33855123,34248339,119127
11,ENSG00000188124.2,6771976,chr11-6921245-C-A,rs10839658,-1,C,A,6921245,149269,6575368,6968584,345877
11,ENSG00000166387.6,7513999,chr11-7507459-G-A,rs10839795,1,G,A,7507459,6540,7317391,7710607,190068
11,ENSG00000166436.10,8682665,chr11-8680289-C-T,rs10840106,-1,C,T,8680289,2376,8486057,8879273,194232
11,ENSG00000180425.6,114400511,chr11-114262912-G-T,rs10891639,-1,G,T,114262912,137599,114203903,114597119,59009
11,ENSG00000186660.13,58579063,chr11-58599088-A-G,rs10896795,1,A,G,58599088,20025,58382455,58775671,216633
11,ENSG00000255151.1,59086307,chr11-59105487-C-A,rs10896919,1,C,A,59105487,19180,58889699,59282915,215788
11,ENSG00000137501.11,85811141,chr11-85787404-C-G,rs10898402,-1,C,G,85787404,23737,85614533,86007749,172871
11,ENSG00000021300.7,73646581,chr11-73654650-C-T,rs10898929,1,C,T,73654650,8069,73449973,73843189,204677
11,ENSG00000177595.12,805231,chr11-810882-G-T,rs10902222,-1,G,T,810882,5651,608623,1001839,202259
11,ENSG00000150316.7,94973556,chr11-94996328-T-C,rs11021003,-1,T,C,94996328,22772,94776948,95170164,219380
11,ENSG00000149231.7,96389912,chr11-96388691-C-T,rs11021568,-1,C,T,96388691,1221,96193304,96586520,195387
11,ENSG00000110328.5,11622005,chr11-11613202-A-C,rs11021956,-1,A,C,11613202,8803,11425397,11818613,187805
11,ENSG00000186104.6,14892231,chr11-14839971-T-G,rs11023350,-1,T,G,14839971,52260,14695623,15088839,144348
11,ENSG00000171714.10,22193085,chr11-22318628-A-G,rs11026507,1,A,G,22318628,125543,21996477,22389693,322151
11,ENSG00000205213.8,27472790,chr11-27330437-G-A,rs11029950,-1,G,A,27330437,142353,27276182,27669398,54255
11,ENSG00000135378.3,32829927,chr11-32829289-G-T,rs11032012,1,G,T,32829289,638,32633319,33026535,195970
11,ENSG00000085063.10,33736423,chr11-33777867-T-G,rs11032377,-1,T,G,33777867,41444,33539815,33933031,238052
11,ENSG00000166352.10,36594502,chr11-36749483-C-T,rs11033791,1,C,T,36749483,154981,36397894,36791110,351589
11,ENSG00000258659.1,5625001,chr11-5484534-C-T,rs11037733,1,C,T,5484534,140467,5428393,5821609,56141
11,ENSG00000187479.4,43942637,chr11-43973599-C-T,rs11037764,1,C,T,43973599,30962,43746029,44139245,227570
11,ENSG00000132256.14,5685074,chr11-5668773-C-T,rs11038642,-1,C,T,5668773,16301,5488466,5881682,180307
11,ENSG00000121653.6,45885651,chr11-45852713-A-G,rs11038689,1,A,G,45852713,32938,45689043,46082259,163670
11,ENSG00000165905.12,45922656,chr11-46072204-T-C,rs11038761,1,T,C,46072204,149548,45726048,46119264,346156
11,ENSG00000174080.6,66568606,chr11-66438698-C-T,rs11110,-1,C,T,66438698,129908,66371998,66765214,66700
11,ENSG00000121671.7,45847475,chr11-45841801-C-T,rs111954517,1,C,T,45841801,5674,45650867,46044083,190934
11,ENSG00000150782.7,112164094,chr11-112174177-G-T,rs11214110,-1,G,T,112174177,10083,111967486,112360702,206691
11,ENSG00000160593.12,118225011,chr11-118242196-G-A,rs11216829,-1,G,A,118242196,17185,118028403,118421619,213793
11,ENSG00000118096.3,118565931,chr11-118539753-A-G,rs11216883,-1,A,G,118539753,26178,118369323,118762539,170430
11,ENSG00000248712.3,119195841,chr11-119272103-C-G,rs11217226,-1,C,G,119272103,76262,118999233,119392449,272870
11,ENSG00000154114.8,121024102,chr11-120837083-C-T,rs11218020,1,C,T,120837083,187019,120827494,121220710,9589
11,ENSG00000172803.12,65833963,chr11-65856268-A-G,rs11227332,1,A,G,65856268,22305,65637355,66030571,218913
11,ENSG00000175115.7,66070272,chr11-66061524-T-C,rs11227394,1,T,C,66061524,8748,65873664,66266880,187860
11,ENSG00000197629.4,59212927,chr11-59186302-C-A,rs11229868,-1,C,A,59186302,26625,59016319,59409535,169983
11,ENSG00000006118.10,60924460,chr11-60845884-C-T,rs11230503,1,C,T,60845884,78576,60727852,61121068,118032
11,ENSG00000072518.14,63839110,chr11-63892464-T-C,rs11231631,1,T,C,63892464,53354,63642502,64035718,249962
11,ENSG00000171631.10,73272338,chr11-73268695-G-A,rs11235706,1,G,A,73268695,3643,73075730,73468946,192965
11,ENSG00000078124.6,76860918,chr11-76778424-G-C,rs11236933,1,G,C,76778424,82494,76664310,77057526,114114
11,ENSG00000151498.6,134253568,chr11-134253534-G-A,rs112372624,1,G,A,134253534,34,134056960,134450176,196574
11,ENSG00000151500.9,134253352,chr11-134253534-G-A,rs112372624,-1,G,A,134253534,182,134056744,134449960,196790
11,ENSG00000177030.10,695222,chr11-691029-T-C,rs11246265,-1,T,C,691029,4193,498614,891830,192415
11,ENSG00000189057.6,59107237,chr11-59228160-G-A,rs113715342,1,G,A,59228160,120923,58910629,59303845,317531
11,ENSG00000181333.11,94021354,chr11-94129327-A-C,rs1138800,1,A,C,94129327,107973,93824746,94217962,304581
11,ENSG00000151502.5,134224671,chr11-134299300-T-C,rs1146192,1,T,C,134299300,74629,134028063,134421279,271237
11,ENSG00000076043.5,114439467,chr11-114335657-G-T,rs11559525,1,G,T,114335657,103810,114242859,114636075,92798
11,ENSG00000162337.7,68312591,chr11-68357908-C-T,rs11574424,1,C,T,68357908,45317,68115983,68509199,241925
11,ENSG00000165457.8,72216794,chr11-72396144-G-A,rs1160142,1,G,A,72396144,179350,72020186,72413402,375958
11,ENSG00000110367.5,118791164,chr11-118917188-A-C,rs11602400,-1,A,C,118917188,126024,118594556,118987772,322632
11,ENSG00000110711.4,67483026,chr11-67463284-C-A,rs11603236,1,C,A,67463284,19742,67286418,67679634,176866
11,ENSG00000158555.10,75525941,chr11-75513855-T-G,rs11606662,-1,T,G,75513855,12086,75329333,75722549,184522
11,ENSG00000166900.10,59755376,chr11-59678027-A-G,rs11607283,1,A,G,59678027,77349,59558768,59951984,119259
11,ENSG00000184154.8,72080850,chr11-72191063-C-T,rs116588436,1,C,T,72191063,110213,71884242,72277458,306821
11,ENSG00000130413.11,8594228,chr11-8594339-C-T,rs117610728,-1,C,T,8594339,111,8397620,8790836,196719
11,ENSG00000048028.7,113875570,chr11-113956928-G-A,rs1176754,-1,G,A,113956928,81358,113678962,114072178,277966
11,ENSG00000150776.12,112074299,chr11-112118899-G-A,rs117711499,1,G,A,112118899,44600,111877691,112270907,241208
11,ENSG00000185101.8,442011,chr11-460303-T-C,rs11821341,-1,T,C,460303,18292,245403,638619,214900
11,ENSG00000244242.1,1750595,chr11-1751975-G-A,rs11822872,-1,G,A,1751975,1380,1553987,1947203,197988
11,ENSG00000174669.7,66371760,chr11-66330851-G-T,rs11823140,-1,G,T,66330851,40909,66175152,66568368,155699
11,ENSG00000110717.6,68030681,chr11-68029774-T-C,rs11825872,1,T,C,68029774,907,67834073,68227289,195701
11,ENSG00000110700.2,17077667,chr11-17169987-T-C,rs11826763,-1,T,C,17169987,92320,16881059,17274275,288928
11,ENSG00000182359.9,106077347,chr11-106066317-C-A,rs11826859,-1,C,A,106066317,11030,105880739,106273955,185578
11,ENSG00000180720.6,46391776,chr11-46366474-G-A,rs11827702,-1,G,A,46366474,25302,46195168,46588384,171306
11,ENSG00000149201.5,86374887,chr11-86216391-G-A,rs12223670,1,G,A,86216391,158496,86178279,86571495,38112
11,ENSG00000133789.10,9664077,chr11-9615307-A-G,rs12273601,1,A,G,9615307,48770,9467469,9860685,147838
11,ENSG00000132259.8,6239089,chr11-6234754-C-T,rs12274456,1,C,T,6234754,4335,6042481,6435697,192273
11,ENSG00000080854.9,133956968,chr11-133969230-C-T,rs12278054,-1,C,T,133969230,12262,133760360,134153576,208870
11,ENSG00000124942.7,62546806,chr11-62472644-A-G,rs12278769,-1,A,G,62472644,74162,62350198,62743414,122446
11,ENSG00000110013.8,124673739,chr11-124836453-A-G,rs12281572,-1,A,G,124836453,162714,124477131,124870347,359322
11,ENSG00000110693.11,16356546,chr11-16458790-A-T,rs12289034,-1,A,T,16458790,102244,16159938,16553154,298852
11,ENSG00000110693.11,16356546,chr11-16458790-A-G,rs12289034,-1,A,G,16458790,102244,16159938,16553154,298852
11,ENSG00000167799.5,67629937,chr11-67612104-G-A,rs12295232,-1,G,A,67612104,17833,67433329,67826545,178775
11,ENSG00000149196.10,86302240,chr11-86326654-T-A,rs12295985,1,T,A,86326654,24414,86105632,86498848,221022
11,ENSG00000186280.5,94973709,chr11-94995735-T-C,rs12363872,1,T,C,94995735,22026,94777101,95170317,218634
11,ENSG00000049449.3,32091074,chr11-32083127-G-A,rs12364816,1,G,A,32083127,7947,31894466,32287682,188661
11,ENSG00000181074.3,5754243,chr11-5710352-C-T,rs12417798,1,C,T,5710352,43891,5557635,5950851,152717
11,ENSG00000131620.12,70078317,chr11-70222486-A-G,rs12419801,1,A,G,70222486,144169,69881709,70274925,340777
11,ENSG00000149485.10,61817003,chr11-61864838-A-G,rs12577276,-1,A,G,61864838,47835,61620395,62013611,244443
11,ENSG00000178301.3,77589953,chr11-77594910-G-A,rs12577552,1,G,A,77594910,4957,77393345,77786561,201565
11,ENSG00000149577.9,117178743,chr11-117210993-A-G,rs1263499,1,A,G,117210993,32250,116982135,117375351,228858
11,ENSG00000166793.6,57649912,chr11-57646470-C-G,rs12793139,-1,C,G,57646470,3442,57453304,57846520,193166
11,ENSG00000183161.3,22625823,chr11-22597220-C-A,rs12796724,-1,C,A,22597220,28603,22429215,22822431,168005
11,ENSG00000151376.10,86672636,chr11-86865379-C-T,rs12796995,-1,C,T,86865379,192743,86476028,86869244,389351
11,ENSG00000099834.13,624955,chr11-621795-G-A,rs12801890,-1,G,A,621795,3160,428347,821563,193448
11,ENSG00000048649.9,77820722,chr11-77969353-G-T,rs12807406,-1,G,T,77969353,148631,77624114,78017330,345239
11,ENSG00000133318.9,63681500,chr11-63507296-T-G,rs1404504,1,T,G,63507296,174204,63484892,63878108,22404
11,ENSG00000149054.10,6926426,chr11-6926908-T-G,rs1491823,1,T,G,6926908,482,6729818,7123034,197090
11,ENSG00000170748.5,7088998,chr11-6926908-T-G,rs1491823,1,T,G,6926908,162090,6892390,7285606,34518
11,ENSG00000149548.9,124954202,chr11-125041240-G-A,rs15541,1,G,A,125041240,87038,124757594,125150810,283646
11,ENSG00000137642.7,121452314,chr11-121367746-C-T,rs1560407,1,C,T,121367746,84568,121255706,121648922,112040
11,ENSG00000174871.6,66278175,chr11-66313700-A-C,rs1621469,1,A,C,66313700,35525,66081567,66474783,232133
11,ENSG00000167985.2,61430124,chr11-61603381-A-G,rs1639892,1,A,G,61603381,173257,61233516,61626732,369865
11,ENSG00000110628.9,2902278,chr11-2921363-G-A,rs1661052,1,G,A,2921363,19085,2705670,3098886,215693
11,ENSG00000148925.5,13463222,chr11-13289254-C-A,rs16912563,-1,C,A,13289254,173968,13266614,13659830,22640
11,ENSG00000184937.8,32435539,chr11-32599401-C-T,rs16923443,-1,C,T,32599401,163862,32238931,32632147,360470
11,ENSG00000173432.6,18266264,chr11-18072696-C-T,rs16934918,1,C,T,18072696,193568,18069656,18462872,3040
11,ENSG00000154127.5,122655722,chr11-122708696-C-T,rs17126767,1,C,T,122708696,52974,122459114,122852330,249582
11,ENSG00000188997.3,78188626,chr11-78173068-A-G,rs17136321,-1,A,G,78173068,15558,77992018,78385234,181050
11,ENSG00000160588.5,118252365,chr11-118257730-C-G,rs1715450,-1,C,G,118257730,5365,118055757,118448973,201973
11,ENSG00000162191.8,62679073,chr11-62505064-A-G,rs17157365,-1,A,G,62505064,174009,62482465,62875681,22599
11,ENSG00000175224.10,46617553,chr11-46498752-T-C,rs17197116,1,T,C,46498752,118801,46420945,46814161,77807
11,ENSG00000179431.5,35618460,chr11-35610704-A-G,rs17296905,1,A,G,35610704,7756,35421852,35815068,188852
11,ENSG00000170322.9,129895578,chr11-129894862-A-G,rs1733455,-1,A,G,129894862,716,129698970,130092186,195892
11,ENSG00000110108.3,60914158,chr11-61062162-G-T,rs175121,1,G,T,61062162,148004,60717550,61110766,344612
11,ENSG00000168000.9,62707424,chr11-62536350-C-T,rs17664979,-1,C,T,62536350,171074,62510816,62904032,25534
11,ENSG00000172893.10,71448393,chr11-71423920-C-T,rs1792284,-1,C,T,71423920,24473,71251785,71645001,172135
11,ENSG00000074266.10,86244753,chr11-86228905-C-T,rs1874694,1,C,T,86228905,15848,86048145,86441361,180760
11,ENSG00000076053.6,114400666,chr11-114298591-T-C,rs1894030,1,T,C,114298591,102075,114204058,114597274,94533
11,ENSG00000148985.14,3808560,chr11-3754968-A-G,rs190680,1,A,G,3754968,53592,3611952,4005168,143016
11,ENSG00000175575.8,73876999,chr11-73900304-G-C,rs2067912,1,G,C,73900304,23305,73680391,74073607,219913
11,ENSG00000064201.10,2302013,chr11-2302298-T-C,rs2074021,1,T,C,2302298,285,2105405,2498621,196893
11,ENSG00000110665.7,2301918,chr11-2302298-T-C,rs2074021,-1,T,C,2302298,380,2105310,2498526,196988
11,ENSG00000110455.9,44066270,chr11-44066439-G-T,rs2074038,1,G,T,44066439,169,43869662,44262878,196777
11,ENSG00000110721.6,68121388,chr11-68049469-A-G,rs2075609,-1,A,G,68049469,71919,67924780,68317996,124689
11,ENSG00000110721.6,68121388,chr11-68049469-A-T,rs2075609,-1,A,T,68049469,71919,67924780,68317996,124689
11,ENSG00000019102.7,124752255,chr11-124748043-A-C,rs2075713,-1,A,C,124748043,4212,124555647,124948863,192396
11,ENSG00000177103.8,117797216,chr11-117816697-G-T,rs2077620,-1,G,T,117816697,19481,117600608,117993824,216089
11,ENSG00000183340.5,96390013,chr11-96266123-G-A,rs2082705,1,G,A,96266123,123890,96193405,96586621,72718
11,ENSG00000184232.3,120211032,chr11-120155892-G-A,rs2084897,1,G,A,120155892,55140,120014424,120407640,141468
11,ENSG00000166435.10,74949091,chr11-74948888-G-A,rs2119028,-1,G,A,74948888,203,74752483,75145699,196405
11,ENSG00000070081.9,17276739,chr11-17277267-A-G,rs214084,1,A,G,17277267,528,17080131,17473347,197136
11,ENSG00000188211.4,17351800,chr11-17277267-A-G,rs214084,1,A,G,17277267,74533,17155192,17548408,122075
11,ENSG00000149564.7,124762290,chr11-124730862-A-G,rs2155109,-1,A,G,124730862,31428,124565682,124958898,165180
11,ENSG00000154146.6,124739942,chr11-124730862-A-G,rs2155109,1,A,G,124730862,9080,124543334,124936550,187528
11,ENSG00000247595.2,18599789,chr11-18628846-T-C,rs2166519,1,T,C,18628846,29057,18403181,18796397,225665
11,ENSG00000166002.2,93543391,chr11-93526612-G-T,rs2198797,-1,G,T,93526612,16779,93346783,93739999,179829
11,ENSG00000166002.2,93543391,chr11-93526612-G-A,rs2198797,-1,G,A,93526612,16779,93346783,93739999,179829
11,ENSG00000149743.9,64226186,chr11-64258672-G-A,rs2244625,-1,G,A,64258672,32486,64029578,64422794,229094
11,ENSG00000149743.9,64226186,chr11-64258672-G-C,rs2244625,-1,G,C,64258672,32486,64029578,64422794,229094
11,ENSG00000110344.5,118359600,chr11-118359644-C-T,rs2276419,1,C,T,118359644,44,118162992,118556208,196652
11,ENSG00000075239.9,108121567,chr11-108217120-G-T,rs228606,1,G,T,108217120,95553,107924959,108318175,292161
11,ENSG00000179057.9,18726188,chr11-18707103-T-C,rs2289965,-1,T,C,18707103,19085,18529580,18922796,177523
11,ENSG00000134571.6,47352702,chr11-47415852-C-T,rs2293578,-1,C,T,47415852,63150,47156094,47549310,259758
11,ENSG00000187726.4,73951026,chr11-73968187-A-G,rs2306818,1,A,G,73968187,17161,73754418,74147634,213769
11,ENSG00000166959.3,60699612,chr11-60714856-T-C,rs2306836,1,T,C,60714856,15244,60503004,60896220,211852
11,ENSG00000110171.12,6473941,chr11-6464439-A-G,rs2344827,-1,A,G,6464439,9502,6277333,6670549,187106
11,ENSG00000149218.4,95089846,chr11-95096350-G-T,rs2509814,1,G,T,95096350,6504,94893238,95286454,203112
11,ENSG00000162174.8,62337448,chr11-62331263-T-C,rs2513747,1,T,C,62331263,6185,62140840,62534056,190423
11,ENSG00000167797.3,67508162,chr11-67648719-C-T,rs2514037,-1,C,T,67648719,140557,67311554,67704770,337165
11,ENSG00000166340.9,6619422,chr11-6489014-A-G,rs2555162,-1,A,G,6489014,130408,6422814,6816030,66200
11,ENSG00000134809.4,57530754,chr11-57585089-A-C,rs2649662,-1,A,C,57585089,54335,57334146,57727362,250943
11,ENSG00000134809.4,57530754,chr11-57585089-A-T,rs2649662,-1,A,T,57585089,54335,57334146,57727362,250943
11,ENSG00000132254.7,6481331,chr11-6612529-G-A,rs2659862,-1,G,A,6612529,131198,6284723,6677939,327806
11,ENSG00000178105.4,108665069,chr11-108767061-G-T,rs2726888,1,G,T,108767061,101992,108468461,108861677,298600
11,ENSG00000214872.4,57537595,chr11-57542460-C-T,rs2729382,1,C,T,57542460,4865,57340987,57734203,201473
11,ENSG00000135372.4,34105629,chr11-34206759-G-A,rs2746633,1,G,A,34206759,101130,33909021,34302237,297738
11,ENSG00000110435.6,34916618,chr11-35006528-C-G,rs2762965,1,C,G,35006528,89910,34720010,35113226,286518
11,ENSG00000110435.6,34916618,chr11-35006528-C-T,rs2762965,1,C,T,35006528,89910,34720010,35113226,286518
11,ENSG00000173113.2,64317559,chr11-64266276-T-C,rs28395880,-1,T,C,64266276,51283,64120951,64514167,145325
11,ENSG00000126432.9,64318121,chr11-64266276-T-C,rs28395880,1,T,C,64266276,51845,64121513,64514729,144763
11,ENSG00000173486.8,64241095,chr11-64186898-G-A,rs2845597,1,G,A,64186898,54197,64044487,64437703,142411
11,ENSG00000184524.5,790090,chr11-785219-C-T,rs28634261,-1,C,T,785219,4871,593482,986698,191737
11,ENSG00000177697.12,832952,chr11-834098-C-T,rs28681202,1,C,T,834098,1146,636344,1029560,197754
11,ENSG00000149089.7,34916379,chr11-34880974-A-C,rs2956086,-1,A,C,34880974,35405,34719771,35112987,161203
11,ENSG00000109861.8,88337736,chr11-88175178-C-G,rs302647,-1,C,G,88175178,162558,88141128,88534344,34050
11,ENSG00000185187.7,414999,chr11-406473-A-C,rs3087588,-1,A,C,406473,8526,218391,611607,188082
11,ENSG00000171067.6,68271973,chr11-68298566-G-A,rs312018,-1,G,A,68298566,26593,68075365,68468581,223201
11,ENSG00000137700.10,119030906,chr11-118895659-G-A,rs3136698,-1,G,A,118895659,135247,118834298,119227514,61361
11,ENSG00000166349.5,36568007,chr11-36464757-G-A,rs331435,1,G,A,36464757,103250,36371399,36764615,93358
11,ENSG00000214756.2,62665312,chr11-62602774-C-T,rs34709729,1,C,T,62602774,62538,62468704,62861920,134070
11,ENSG00000165434.4,74398433,chr11-74336698-T-A,rs36014178,-1,T,A,74336698,61735,74201825,74595041,134873
11,ENSG00000166452.7,8911189,chr11-8925403-G-T,rs3751068,1,G,T,8925403,14214,8714581,9107797,210822
11,ENSG00000198851.5,118304730,chr11-118266156-G-A,rs3759005,1,G,A,118266156,38574,118108122,118501338,158034
11,ENSG00000150455.8,126283093,chr11-126456673-T-C,rs3809005,1,T,C,126456673,173580,126086485,126479701,370188
11,ENSG00000168439.11,64186171,chr11-64266083-C-T,rs3815362,1,C,T,64266083,79912,63989563,64382779,276520
11,ENSG00000214517.4,74171289,chr11-74322021-G-A,rs3888908,1,G,A,74322021,150732,73974681,74367897,347340
11,ENSG00000185475.3,62787402,chr11-62852157-G-A,rs4034,1,G,A,62852157,64755,62590794,62984010,261363
11,ENSG00000166788.5,18106082,chr11-18119895-C-T,rs4052539,-1,C,T,18119895,13813,17909474,18302690,210421
11,ENSG00000185085.2,62653302,chr11-62487822-G-A,rs41427449,-1,G,A,62487822,165480,62456694,62849910,31128
11,ENSG00000205339.5,9384652,chr11-9307196-T-C,rs4282978,1,T,C,9307196,77456,9188044,9581260,119152
11,ENSG00000213619.4,47579074,chr11-47389400-T-C,rs4752993,1,T,C,47389400,189674,47382466,47775682,6934
11,ENSG00000166796.7,18412318,chr11-18418191-G-A,rs4757662,1,G,A,18418191,5873,18215710,18608926,202481
11,ENSG00000255561.2,111879165,chr11-112018930-C-T,rs476581,-1,C,T,112018930,139765,111682557,112075773,336373
11,ENSG00000175467.9,65961734,chr11-65775268-G-A,rs489574,1,G,A,65775268,186466,65765126,66158342,10142
11,ENSG00000162341.9,69048932,chr11-69049761-C-T,rs4930259,1,C,T,69049761,829,68852324,69245540,197437
11,ENSG00000110080.13,126355686,chr11-126358764-T-G,rs4937122,1,T,G,126358764,3078,126159078,126552294,199686
11,ENSG00000156738.13,60455847,chr11-60464852-A-G,rs4939364,1,A,G,60464852,9005,60259239,60652455,205613
11,ENSG00000175536.6,74493724,chr11-74387688-C-T,rs4944889,-1,C,T,74387688,106036,74297116,74690332,90572
11,ENSG00000173992.4,66593185,chr11-66595526-A-G,rs498045,1,A,G,66595526,2341,66396577,66789793,198949
11,ENSG00000148943.7,27506769,chr11-27440232-T-C,rs5020127,-1,T,C,27440232,66537,27310161,27703377,130071
11,ENSG00000110660.9,107858787,chr11-107823254-T-C,rs502398,-1,T,C,107823254,35533,107662179,108055395,161075
11,ENSG00000137486.12,75351661,chr11-75340189-A-G,rs504683,-1,A,G,75340189,11472,75155053,75548269,185136
11,ENSG00000014138.4,65261962,chr11-65325719-G-T,rs509303,1,G,T,65325719,63757,65065354,65458570,260365
11,ENSG00000168071.15,64340204,chr11-64470448-G-A,rs519106,1,G,A,64470448,130244,64143596,64536812,326852
11,ENSG00000174165.3,66546048,chr11-66641938-G-A,rs519380,-1,G,A,66641938,95890,66349440,66742656,292498
11,ENSG00000137731.8,117824744,chr11-117822540-T-C,rs529623,-1,T,C,117822540,2204,117628136,118021352,194404
11,ENSG00000160695.8,119067818,chr11-119076924-C-T,rs540261,1,C,T,119076924,9106,118871210,119264426,205714
11,ENSG00000204397.3,105045335,chr11-105024600-C-G,rs555301,-1,C,G,105024600,20735,104848727,105241943,175873
11,ENSG00000166471.6,9314593,chr11-9253372-G-A,rs55962227,-1,G,A,9253372,61221,9117985,9511201,135387
11,ENSG00000166257.4,123654624,chr11-123655588-G-A,rs56037734,-1,G,A,123655588,964,123458016,123851232,197572
11,ENSG00000099849.10,560970,chr11-480016-G-A,rs56060013,1,G,A,480016,80954,364362,757578,115654
11,ENSG00000151702.11,128694072,chr11-128791462-A-G,rs56388111,1,A,G,128791462,97390,128497464,128890680,293998
11,ENSG00000196655.5,119018766,chr11-119023577-A-G,rs569,1,A,G,119023577,4811,118822158,119215374,201419
11,ENSG00000068976.8,64759974,chr11-64747034-A-G,rs569602,-1,A,G,64747034,12940,64563366,64956582,183668
11,ENSG00000149177.7,47980559,chr11-48078400-C-T,rs57382627,1,C,T,48078400,97841,47783951,48177167,294449
11,ENSG00000110723.6,108593768,chr11-108569703-A-G,rs57968532,-1,A,G,108569703,24065,108397160,108790376,172543
11,ENSG00000188486.3,119095465,chr11-119029700-T-G,rs58412813,-1,T,G,119029700,65765,118898857,119292073,130843
11,ENSG00000149591.11,117199370,chr11-117198345-A-G,rs585849,1,A,G,117198345,1025,117002762,117395978,195583
11,ENSG00000175567.3,73982843,chr11-73985565-A-T,rs586773,-1,A,T,73985565,2722,73786235,74179451,199330
11,ENSG00000166439.5,74748849,chr11-74912966-C-A,rs590105,1,C,A,74912966,164117,74552241,74945457,360725
11,ENSG00000129158.5,18013047,chr11-18039853-T-C,rs591556,-1,T,C,18039853,26806,17816439,18209655,223414
11,ENSG00000110063.4,126304060,chr11-126287084-C-G,rs595022,1,C,G,126287084,16976,126107452,126500668,179632
11,ENSG00000110063.4,126304060,chr11-126287084-C-T,rs595022,1,C,T,126287084,16976,126107452,126500668,179632
11,ENSG00000121236.13,5596637,chr11-5599055-C-T,rs59650010,1,C,T,5599055,2418,5400029,5793245,199026
11,ENSG00000109929.5,121292771,chr11-121117415-A-G,rs597345,1,A,G,121117415,175356,121096163,121489379,21252
11,ENSG00000110651.6,2377310,chr11-2370014-C-T,rs60299329,1,C,T,2370014,7296,2180702,2573918,189312
11,ENSG00000175602.2,65890673,chr11-65882303-A-G,rs604630,1,A,G,65882303,8370,65694065,66087281,188238
11,ENSG00000149418.5,130159782,chr11-130182004-C-T,rs60745822,1,C,T,130182004,22222,129963174,130356390,218830
11,ENSG00000196371.2,94543921,chr11-94602964-T-C,rs608972,1,T,C,94602964,59043,94347313,94740529,255651
11,ENSG00000134627.7,94567368,chr11-94602964-T-C,rs608972,1,T,C,94602964,35596,94370760,94763976,232204
11,ENSG00000177098.4,118152823,chr11-118029101-T-G,rs617345,-1,T,G,118029101,123722,117956215,118349431,72886
11,ENSG00000214026.6,1947332,chr11-1872809-C-T,rs61868780,1,C,T,1872809,74523,1750724,2143940,122085
11,ENSG00000181649.5,2929420,chr11-2977392-G-A,rs61871243,-1,G,A,2977392,47972,2732812,3126028,244580
11,ENSG00000177685.10,827919,chr11-827713-A-T,rs61876746,1,A,T,827713,206,631311,1024527,196402
11,ENSG00000023191.11,507242,chr11-526356-G-A,rs61877777,-1,G,A,526356,19114,310634,703850,215722
11,ENSG00000182704.5,76783356,chr11-76628267-G-A,rs61893484,1,G,A,76628267,155089,76586748,76979964,41519
11,ENSG00000181924.6,73876846,chr11-73961529-C-A,rs622064,-1,C,A,73961529,84683,73680238,74073454,281291
11,ENSG00000110375.2,118956298,chr11-118958232-A-G,rs623500,1,A,G,118958232,1934,118759690,119152906,198542
11,ENSG00000197345.7,68903832,chr11-68899730-A-C,rs636049,-1,A,C,68899730,4102,68707224,69100440,192506
11,ENSG00000197345.7,68903832,chr11-68899730-A-T,rs636049,-1,A,T,68899730,4102,68707224,69100440,192506
11,ENSG00000142089.9,320860,chr11-305619-T-C,rs6421984,-1,T,C,305619,15241,124252,517468,181367
11,ENSG00000171204.8,85628593,chr11-85602021-T-C,rs645798,1,T,C,85602021,26572,85431985,85825201,170036
11,ENSG00000132740.4,68903891,chr11-68914185-A-G,rs646586,1,A,G,68914185,10294,68707283,69100499,206902
11,ENSG00000109881.11,27363215,chr11-27201945-A-G,rs6484271,-1,A,G,27201945,161270,27166607,27559823,35338
11,ENSG00000150768.10,112025408,chr11-112034744-A-G,rs6589259,1,A,G,112034744,9336,111828800,112222016,205944
11,ENSG00000149292.11,113314583,chr11-113322075-C-T,rs6589371,1,C,T,113322075,7492,113117975,113511191,204100
11,ENSG00000172543.3,65879837,chr11-65884359-A-G,rs658938,1,A,G,65884359,4522,65683229,66076445,201130
11,ENSG00000149403.5,120511748,chr11-120660264-C-T,rs6589829,1,C,T,120660264,148516,120315140,120708356,345124
11,ENSG00000033327.8,78417820,chr11-78560568-A-C,rs6592792,-1,A,C,78560568,142748,78221212,78614428,339356
11,ENSG00000177600.4,809967,chr11-803017-A-G,rs6597981,1,A,G,803017,6950,613359,1006575,189658
11,ENSG00000185522.4,560738,chr11-656523-C-T,rs6598007,-1,C,T,656523,95785,364130,757346,292393
11,ENSG00000185201.10,307816,chr11-330630-G-A,rs6598040,1,G,A,330630,22814,111208,504424,219422
11,ENSG00000174885.8,278407,chr11-254010-T-C,rs6598054,1,T,C,254010,24397,81799,475015,172211
11,ENSG00000142082.10,236342,chr11-252283-C-T,rs6598056,-1,C,T,252283,15941,39734,432950,212549
11,ENSG00000152558.10,102452765,chr11-102493788-C-T,rs668660,-1,C,T,102493788,41023,102256157,102649373,237631
11,ENSG00000109919.4,47642559,chr11-47500005-C-T,rs67132220,-1,C,T,47500005,142554,47445951,47839167,54054
11,ENSG00000148935.6,22666611,chr11-22668658-T-C,rs680436,1,T,C,22668658,2047,22470003,22863219,198655
11,ENSG00000133884.5,65333852,chr11-65383978-A-G,rs681309,1,A,G,65383978,50126,65137244,65530460,246734
11,ENSG00000151704.11,128867296,chr11-128802686-A-C,rs687326,-1,A,C,128802686,64610,128670688,129063904,131998
11,ENSG00000176485.6,63614433,chr11-63604248-C-G,rs7101608,-1,C,G,63604248,10185,63417825,63811041,186423
11,ENSG00000213445.4,65638101,chr11-65827349-T-A,rs7102454,1,T,A,65827349,189248,65441493,65834709,385856
11,ENSG00000213445.4,65638101,chr11-65827349-T-C,rs7102454,1,T,C,65827349,189248,65441493,65834709,385856
11,ENSG00000173457.6,64246943,chr11-64248812-G-T,rs7111278,-1,G,T,64248812,1869,64050335,64443551,198477
11,ENSG00000173457.6,64246943,chr11-64248812-G-A,rs7111278,-1,G,A,64248812,1869,64050335,64443551,198477
11,ENSG00000213593.5,57712593,chr11-57585182-T-G,rs7112126,1,T,G,57585182,127411,57515985,57909201,69197
11,ENSG00000109944.5,122882759,chr11-122878506-C-T,rs7114583,1,C,T,122878506,4253,122686151,123079367,192355
11,ENSG00000205126.2,44047981,chr11-44148709-G-A,rs7114988,1,G,A,44148709,100728,43851373,44244589,297336
11,ENSG00000043039.4,129375848,chr11-129552610-C-T,rs7115279,1,C,T,129552610,176762,129179240,129572456,373370
11,ENSG00000072952.12,10693755,chr11-10575534-G-A,rs7115310,-1,G,A,10575534,118221,10497147,10890363,78387
11,ENSG00000181830.5,45805149,chr11-45825537-C-T,rs7115967,1,C,T,45825537,20388,45608541,46001757,216996
11,ENSG00000110218.4,94128841,chr11-94114157-G-A,rs7116300,1,G,A,94114157,14684,93932233,94325449,181924
11,ENSG00000254997.2,71548420,chr11-71566552-A-C,rs7120471,1,A,C,71566552,18132,71351812,71745028,214740
11,ENSG00000175581.9,73787874,chr11-73672337-T-C,rs7126049,1,T,C,73672337,115537,73591266,73984482,81071
11,ENSG00000137726.10,117876658,chr11-118021855-T-C,rs7127135,-1,T,C,118021855,145197,117680050,118073266,341805
11,ENSG00000149115.9,57324952,chr11-57335876-A-G,rs71484443,-1,A,G,57335876,10924,57128344,57521560,207532
11,ENSG00000132275.6,6603616,chr11-6522831-A-G,rs72897893,-1,A,G,6522831,80785,6407008,6800224,115823
11,ENSG00000173511.5,64234584,chr11-64409140-A-G,rs72927945,1,A,G,64409140,174556,64037976,64431192,371164
11,ENSG00000109927.5,121101243,chr11-121020161-G-A,rs73011533,1,G,A,121020161,81082,120904635,121297851,115526
11,ENSG00000183134.4,60855950,chr11-60754411-C-A,rs73495012,-1,C,A,60754411,101539,60659342,61052558,95069
11,ENSG00000077514.3,74592582,chr11-74701829-G-C,rs74551717,1,G,C,74701829,109247,74395974,74789190,305855
11,ENSG00000182272.7,369499,chr11-324368-G-A,rs7480758,1,G,A,324368,45131,172891,566107,151477
11,ENSG00000150787.3,112226428,chr11-112217820-A-G,rs74874911,1,A,G,112217820,8608,112029820,112423036,188000
11,ENSG00000149043.11,1834990,chr11-1675639-G-A,rs75162634,1,G,A,1675639,159351,1638382,2031598,37257
11,ENSG00000166961.10,60756867,chr11-60831746-C-G,rs76197319,1,C,G,60831746,74879,60560259,60953475,271487
11,ENSG00000149573.3,118264297,chr11-118233261-C-T,rs76675432,-1,C,T,118233261,31036,118067689,118460905,165572
11,ENSG00000023171.9,123430269,chr11-123604606-G-A,rs77082103,1,G,A,123604606,174337,123233661,123626877,370945
11,ENSG00000177830.13,910810,chr11-804027-G-A,rs77173309,-1,G,A,804027,106783,714202,1107418,89825
11,ENSG00000158636.11,76445025,chr11-76604385-G-T,rs77251009,1,G,T,76604385,159360,76248417,76641633,355968
11,ENSG00000110492.9,46381669,chr11-46205504-G-C,rs77496299,1,G,C,46205504,176165,46185061,46578277,20443
11,ENSG00000118363.7,74949266,chr11-75008854-G-A,rs78205254,1,G,A,75008854,59588,74752658,75145874,256196
11,ENSG00000135362.9,36296288,chr11-36401151-C-T,rs78731804,1,C,T,36401151,104863,36099680,36492896,301471
11,ENSG00000084207.11,67583812,chr11-67579272-T-C,rs7927381,1,T,C,67579272,4540,67387204,67780420,192068
11,ENSG00000064199.2,124673904,chr11-124673907-T-G,rs7927406,1,T,G,124673907,3,124477296,124870512,196611
11,ENSG00000170209.4,113387779,chr11-113546386-T-C,rs79330444,1,T,C,113546386,158607,113191171,113584387,355215
11,ENSG00000158077.4,7020479,chr11-6976354-C-A,rs7933973,1,C,A,6976354,44125,6823871,7217087,152483
11,ENSG00000149050.5,7020346,chr11-6976354-C-A,rs7933973,-1,C,A,6976354,43992,6823738,7216954,152616
11,ENSG00000129757.8,2885775,chr11-2901861-T-G,rs7934793,-1,T,G,2901861,16086,2689167,3082383,212694
11,ENSG00000166004.9,93661682,chr11-93689286-G-A,rs7937523,1,G,A,93689286,27604,93465074,93858290,224212
11,ENSG00000175518.5,5516699,chr11-5620771-T-C,rs7939159,-1,T,C,5620771,104072,5320091,5713307,300680
11,ENSG00000172927.3,69294155,chr11-69260303-G-A,rs7940107,1,G,A,69260303,33852,69097547,69490763,162756
11,ENSG00000214063.6,842852,chr11-890405-T-C,rs7940112,1,T,C,890405,47553,646244,1039460,244161
11,ENSG00000183801.3,7485506,chr11-7505878-T-C,rs7943470,1,T,C,7505878,20372,7288898,7682114,216980
11,ENSG00000137509.5,82900430,chr11-82901653-C-T,rs7943593,-1,C,T,82901653,1223,82703822,83097038,197831
11,ENSG00000214290.3,111298546,chr11-111327051-C-T,rs7944798,1,C,T,111327051,28505,111101938,111495154,225113
11,ENSG00000152219.4,30323104,chr11-30309649-C-G,rs7947001,1,C,G,30309649,13455,30126496,30519712,183153
11,ENSG00000134955.7,125063305,chr11-124993240-C-A,rs7951202,1,C,A,124993240,70065,124866697,125259913,126543
11,ENSG00000109920.7,47767341,chr11-47610843-A-G,rs7952214,-1,A,G,47610843,156498,47570733,47963949,40110
11,ENSG00000137474.12,77128246,chr11-77155541-G-A,rs79579240,1,G,A,77155541,27295,76931638,77324854,223903
11,ENSG00000110429.8,33774520,chr11-33792629-G-A,rs79708249,-1,G,A,33792629,18109,33577912,33971128,214717
11,ENSG00000150764.9,111937343,chr11-112109680-A-T,rs79763567,1,A,T,112109680,172337,111740735,112133951,368945
11,ENSG00000176102.6,33161480,chr11-33310910-C-G,rs79950843,-1,C,G,33310910,149430,32964872,33358088,346038
11,ENSG00000166801.11,59142856,chr11-59302837-T-C,rs80143522,1,T,C,59302837,159981,58946248,59339464,356589
11,ENSG00000255823.1,10509186,chr11-10629255-T-C,rs80172281,-1,T,C,10629255,120069,10312578,10705794,316677
11,ENSG00000166391.9,75717838,chr11-75835646-A-G,rs80191572,1,A,G,75835646,117808,75521230,75914446,314416
11,ENSG00000137648.12,118077078,chr11-117908590-C-T,rs80264810,1,C,T,117908590,168488,117880470,118273686,28120
11,ENSG00000137648.12,118077078,chr11-117908590-C-A,rs80264810,1,C,A,117908590,168488,117880470,118273686,28120
11,ENSG00000165526.4,126211650,chr11-126290571-C-T,rs8177368,-1,C,T,126290571,78921,126015042,126408258,275529
11,ENSG00000132746.10,67674631,chr11-67583826-G-A,rs8191439,-1,G,A,67583826,90805,67478023,67871239,105803
11,ENSG00000110768.5,18322567,chr11-18272536-A-G,rs874957,1,A,G,18272536,50031,18125959,18519175,146577
11,ENSG00000223609.3,5234483,chr11-5430688-G-A,rs883689,-1,G,A,5430688,196205,5037875,5431091,392813
11,ENSG00000052841.9,43358920,chr11-43533426-C-T,rs900467,1,C,T,43533426,174506,43162312,43555528,371114
11,ENSG00000168092.9,117144287,chr11-117188631-C-T,rs90192,1,C,T,117188631,44344,116947679,117340895,240952
11,ENSG00000130592.9,1853084,chr11-1852842-G-A,rs907611,1,G,A,1852842,242,1656476,2049692,196366
11,ENSG00000172425.6,118527474,chr11-118494495-G-C,rs9332817,1,G,C,118494495,32979,118330866,118724082,163629
11,ENSG00000110237.3,73308276,chr11-73369360-A-G,rs947837,1,A,G,73369360,61084,73111668,73504884,257692
11,ENSG00000180988.2,5808924,chr11-5809058-G-A,rs9630186,1,G,A,5809058,134,5612316,6005532,196742
11,ENSG00000159063.7,78139626,chr11-78035139-G-C,rs9651741,-1,G,C,78035139,104487,77943018,78336234,92121
11,ENSG00000123892.6,88175443,chr11-88174574-C-T,rs9666730,-1,C,T,88174574,869,87978835,88372051,195739
11,ENSG00000166436.10,8682665,chr11-8673283-G-A,rs10128597,-1,G,A,8673283,9382,8486057,8879273,187226
11,ENSG00000166313.11,6419094,chr11-6438796-C-A,rs10500671,-1,C,A,6438796,19702,6222486,6615702,216310
11,ENSG00000142082.10,236342,chr11-235619-A-C,rs1056098,-1,A,C,235619,723,39734,432950,195885
11,ENSG00000149050.5,7020346,chr11-6916293-C-T,rs10732224,-1,C,T,6916293,104053,6823738,7216954,92555
11,ENSG00000118096.3,118565931,chr11-118588554-A-G,rs10736492,-1,A,G,118588554,22623,118369323,118762539,219231
11,ENSG00000149231.7,96389912,chr11-96394221-C-T,rs10765805,-1,C,T,96394221,4309,96193304,96586520,200917
11,ENSG00000160695.8,119067818,chr11-119102423-G-A,rs10790282,1,G,A,119102423,34605,118871210,119264426,231213
11,ENSG00000109929.5,121292771,chr11-121321073-C-G,rs10790434,1,C,G,121321073,28302,121096163,121489379,224910
11,ENSG00000166261.6,123741660,chr11-123675877-C-G,rs10790585,-1,C,G,123675877,65783,123545052,123938268,130825
11,ENSG00000129173.6,19240945,chr11-19187503-T-C,rs10833071,-1,T,C,19187503,53442,19044337,19437553,143166
11,ENSG00000149084.7,43680738,chr11-43833522-A-G,rs10838183,1,A,G,43833522,152784,43484130,43877346,349392
11,ENSG00000151364.11,78023276,chr11-78084525-A-G,rs10899436,-1,A,G,78084525,61249,77826668,78219884,257857
11,ENSG00000137513.5,78574864,chr11-78579305-G-A,rs10899559,-1,G,A,78579305,4441,78378256,78771472,201049
11,ENSG00000166689.9,17014414,chr11-16895672-T-C,rs11024074,-1,T,C,16895672,118742,16817806,17211022,77866
11,ENSG00000110619.12,3057423,chr11-2873222-G-T,rs11024404,-1,G,T,2873222,184201,2860815,3254031,12407
11,ENSG00000110628.9,2902278,chr11-2966056-A-G,rs11024772,1,A,G,2966056,63778,2705670,3098886,260386
11,ENSG00000148985.14,3808560,chr11-3835646-A-G,rs11029997,1,A,G,3835646,27086,3611952,4005168,223694
11,ENSG00000167323.5,3855664,chr11-3848866-C-T,rs11030046,1,C,T,3848866,6798,3659056,4052272,189810
11,ENSG00000152219.4,30323104,chr11-30426940-C-T,rs11031075,1,C,T,30426940,103836,30126496,30519712,300444
11,ENSG00000121691.4,34438934,chr11-34402227-A-T,rs11032654,1,A,T,34402227,36707,34242326,34635542,159901
11,ENSG00000149089.7,34916379,chr11-34865345-C-A,rs11032907,-1,C,A,34865345,51034,34719771,35112987,145574
11,ENSG00000132275.6,6603616,chr11-6600286-G-A,rs11040933,-1,G,A,6600286,3330,6407008,6800224,193278
11,ENSG00000130413.11,8594228,chr11-8604270-T-G,rs11042008,-1,T,G,8604270,10042,8397620,8790836,206650
11,ENSG00000166444.12,8810674,chr11-8869377-G-C,rs11042104,-1,G,C,8869377,58703,8614066,9007282,255311
11,ENSG00000133789.10,9664077,chr11-9648857-G-A,rs11042463,1,G,A,9648857,15220,9467469,9860685,181388
11,ENSG00000133789.10,9664077,chr11-9648857-G-C,rs11042463,1,G,C,9648857,15220,9467469,9860685,181388
11,ENSG00000118181.5,119018343,chr11-119029653-G-A,rs11217128,-1,G,A,119029653,11310,118821735,119214951,207918
11,ENSG00000110063.4,126304060,chr11-126226069-A-G,rs11220409,1,A,G,126226069,77991,126107452,126500668,118617
11,ENSG00000110080.13,126355686,chr11-126374057-G-A,rs11220462,1,G,A,126374057,18371,126159078,126552294,214979
11,ENSG00000110721.6,68121388,chr11-68186117-G-A,rs11228153,-1,G,A,68186117,64729,67924780,68317996,261337
11,ENSG00000132740.4,68903891,chr11-68835878-T-C,rs11228377,1,T,C,68835878,68013,68707283,69100499,128595
11,ENSG00000167985.2,61430124,chr11-61588016-G-A,rs11230745,1,G,A,61588016,157892,61233516,61626732,354500
11,ENSG00000162188.5,62707676,chr11-62626973-G-A,rs11231166,1,G,A,62626973,80703,62511068,62904284,115905
11,ENSG00000133328.3,63563379,chr11-63718099-A-G,rs11231570,-1,A,G,63718099,154720,63366771,63759987,351328
11,ENSG00000137501.11,85811141,chr11-85879998-C-T,rs11234457,-1,C,T,85879998,68857,85614533,86007749,265465
11,ENSG00000078124.6,76860918,chr11-76714401-G-A,rs11236894,1,G,A,76714401,146517,76664310,77057526,50091
11,ENSG00000166452.7,8911189,chr11-8981759-A-G,rs1123936,1,A,G,8981759,70570,8714581,9107797,267178
11,ENSG00000161328.10,537527,chr11-534916-A-G,rs11246176,1,A,G,534916,2611,340919,734135,193997
11,ENSG00000053918.10,2445008,chr11-2621854-A-G,rs11493163,1,A,G,2621854,176846,2248400,2641616,373454
11,ENSG00000110711.4,67483026,chr11-67459535-G-A,rs11601325,1,G,A,67459535,23491,67286418,67679634,173117
11,ENSG00000120451.6,130916479,chr11-130896330-T-C,rs11602545,-1,T,C,130896330,20149,130719871,131113087,176459
11,ENSG00000149016.11,62591523,chr11-62434114-G-T,rs116846164,-1,G,T,62434114,157409,62394915,62788131,39199
11,ENSG00000150672.11,85627344,chr11-85595899-C-T,rs117186122,-1,C,T,85595899,31445,85430736,85823952,165163
11,ENSG00000110400.5,119729200,chr11-119702945-C-T,rs117236359,-1,C,T,119702945,26255,119532592,119925808,170353
11,ENSG00000149294.11,112961420,chr11-112906617-G-A,rs117966185,1,G,A,112906617,54803,112764812,113158028,141805
11,ENSG00000149294.11,112961420,chr11-112906617-G-T,rs117966185,1,G,T,112906617,54803,112764812,113158028,141805
11,ENSG00000149548.9,124954202,chr11-125028629-T-C,rs11828896,1,T,C,125028629,74427,124757594,125150810,271035
11,ENSG00000152404.10,107457825,chr11-107269351-G-A,rs12224337,-1,G,A,107269351,188474,107261217,107654433,8134
11,ENSG00000007372.14,31811322,chr11-31841814-T-C,rs12286701,-1,T,C,31841814,30492,31614714,32007930,227100
11,ENSG00000137731.8,117824744,chr11-117804571-T-G,rs12364667,-1,T,G,117804571,20173,117628136,118021352,176435
11,ENSG00000169519.14,28108388,chr11-27991776-G-C,rs12417122,1,G,C,27991776,116612,27911780,28304996,79996
11,ENSG00000169519.14,28108388,chr11-27991776-G-A,rs12417122,1,G,A,27991776,116612,27911780,28304996,79996
11,ENSG00000137497.12,72080542,chr11-72236225-G-A,rs12417459,-1,G,A,72236225,155683,71883934,72277150,352291
11,ENSG00000186166.2,118998138,chr11-118898373-G-A,rs12417867,1,G,A,118898373,99765,118801530,119194746,96843
11,ENSG00000137656.7,116772987,chr11-116769225-A-G,rs1263149,-1,A,G,116769225,3762,116576379,116969595,192846
11,ENSG00000023191.11,507242,chr11-621795-G-A,rs12801890,-1,G,A,621795,114553,310634,703850,311161
11,ENSG00000167770.7,63986438,chr11-64091242-G-A,rs12805344,1,G,A,64091242,104804,63789830,64183046,301412
11,ENSG00000175575.8,73876999,chr11-73904682-G-A,rs1670551,1,G,A,73904682,27683,73680391,74073607,224291
11,ENSG00000135378.3,32829927,chr11-32670601-T-C,rs16923515,1,T,C,32670601,159326,32633319,33026535,37282
11,ENSG00000166391.9,75717838,chr11-75815145-C-T,rs17134356,1,C,T,75815145,97307,75521230,75914446,293915
11,ENSG00000085741.6,76206502,chr11-76393041-C-T,rs17134821,-1,C,T,76393041,186539,76009894,76403110,383147
11,ENSG00000137509.5,82900430,chr11-83077397-C-T,rs17144544,-1,C,T,83077397,176967,82703822,83097038,373575
11,ENSG00000165494.5,83156988,chr11-83184615-A-T,rs17144746,1,A,T,83184615,27627,82960380,83353596,224235
11,ENSG00000165494.5,83156988,chr11-83184615-A-G,rs17144746,1,A,G,83184615,27627,82960380,83353596,224235
11,ENSG00000168060.9,65058553,chr11-64895755-C-T,rs17146441,-1,C,T,64895755,162798,64861945,65255161,33810
11,ENSG00000156603.10,57712215,chr11-57529798-A-C,rs17453436,-1,A,C,57529798,182417,57515607,57908823,14191
11,ENSG00000134824.9,61828300,chr11-61824890-A-G,rs174566,1,A,G,61824890,3410,61631692,62024908,193198
11,ENSG00000075239.9,108121567,chr11-108053377-A-G,rs17617000,1,A,G,108053377,68190,107924959,108318175,128418
11,ENSG00000150782.7,112164094,chr11-112119302-T-G,rs1811349,-1,T,G,112119302,44792,111967486,112360702,151816
11,ENSG00000132109.8,4393702,chr11-4419462-T-C,rs1823633,-1,T,C,4419462,25760,4197094,4590310,222368
11,ENSG00000152558.10,102452765,chr11-102487376-C-T,rs1943783,-1,C,T,102487376,34611,102256157,102649373,231219
11,ENSG00000118369.8,78188919,chr11-77994490-C-A,rs2016147,1,C,A,77994490,194429,77992311,78385527,2179
11,ENSG00000118369.8,78188919,chr11-77994490-C-G,rs2016147,1,C,G,77994490,194429,77992311,78385527,2179
11,ENSG00000133805.10,10455264,chr11-10455151-C-T,rs2071019,1,C,T,10455151,113,10258656,10651872,196495
11,ENSG00000166002.2,93543391,chr11-93355990-G-T,rs2124559,-1,G,T,93355990,187401,93346783,93739999,9207
11,ENSG00000110696.4,16738647,chr11-16802189-G-T,rs216489,1,G,T,16802189,63542,16542039,16935255,260150
11,ENSG00000110696.4,16738647,chr11-16802189-G-A,rs216489,1,G,A,16802189,63542,16542039,16935255,260150
11,ENSG00000087884.10,77821144,chr11-77872220-G-A,rs2186564,1,G,A,77872220,51076,77624536,78017752,247684
11,ENSG00000126432.9,64318121,chr11-64258672-G-C,rs2244625,1,G,C,64258672,59449,64121513,64514729,137159
11,ENSG00000126432.9,64318121,chr11-64258672-G-A,rs2244625,1,G,A,64258672,59449,64121513,64514729,137159
11,ENSG00000074319.6,18526942,chr11-18484085-G-A,rs2279902,-1,G,A,18484085,42857,18330334,18723550,153751
11,ENSG00000110719.4,68039025,chr11-68026041-C-T,rs2286163,1,C,T,68026041,12984,67842417,68235633,183624
11,ENSG00000149380.7,74311640,chr11-74235886-T-C,rs2302509,-1,T,C,74235886,75754,74115032,74508248,120854
11,ENSG00000151498.6,134253568,chr11-134203124-A-T,rs2305379,1,A,T,134203124,50444,134056960,134450176,146164
11,ENSG00000167257.6,117232671,chr11-117282704-T-C,rs2305821,1,T,C,117282704,50033,117036063,117429279,246641
11,ENSG00000162174.8,62337448,chr11-62316436-C-T,rs2463833,1,C,T,62316436,21012,62140840,62534056,175596
11,ENSG00000162231.7,62805440,chr11-62899134-T-G,rs2507821,-1,T,G,62899134,93694,62608832,63002048,290302
11,ENSG00000110031.8,58575856,chr11-58593181-A-G,rs2510558,-1,A,G,58593181,17325,58379248,58772464,213933
11,ENSG00000149418.5,130159782,chr11-129965852-A-G,rs2512904,1,A,G,129965852,193930,129963174,130356390,2678
11,ENSG00000137747.9,117929402,chr11-117953877-C-T,rs2515800,-1,C,T,117953877,24475,117732794,118126010,221083
11,ENSG00000110723.6,108593768,chr11-108574809-A-C,rs2640749,-1,A,C,108574809,18959,108397160,108790376,177649
11,ENSG00000166340.9,6619422,chr11-6631387-C-T,rs2659871,-1,C,T,6631387,11965,6422814,6816030,208573
11,ENSG00000166796.7,18412318,chr11-18453553-G-A,rs2721123,1,G,A,18453553,41235,18215710,18608926,237843
11,ENSG00000132286.6,6481501,chr11-6528181-A-C,rs2880963,1,A,C,6528181,46680,6284893,6678109,243288
11,ENSG00000051009.5,6234636,chr11-6261846-C-G,rs2947025,-1,C,G,6261846,27210,6038028,6431244,223818
11,ENSG00000110455.9,44066270,chr11-44067802-G-A,rs33952257,1,G,A,44067802,1532,43869662,44262878,198140
11,ENSG00000110514.13,47270156,chr11-47285079-C-T,rs35233100,1,C,T,47285079,14923,47073548,47466764,211531
11,ENSG00000149182.9,47176879,chr11-47337495-G-A,rs3729952,-1,G,A,47337495,160616,46980271,47373487,357224
11,ENSG00000121236.13,5596637,chr11-5610249-A-C,rs3740999,1,A,C,5610249,13612,5400029,5793245,210220
11,ENSG00000025434.14,47257996,chr11-47421342-T-A,rs3781626,1,T,A,47421342,163346,47061388,47454604,359954
11,ENSG00000025434.14,47257996,chr11-47421342-T-G,rs3781626,1,T,G,47421342,163346,47061388,47454604,359954
11,ENSG00000149809.10,65111872,chr11-65124998-G-A,rs3782094,1,G,A,65124998,13126,64915264,65308480,209734
11,ENSG00000154134.10,124865432,chr11-124954085-C-T,rs3809055,1,C,T,124954085,88653,124668824,125062040,285261
11,ENSG00000142102.11,289126,chr11-290233-A-G,rs3809109,1,A,G,290233,1107,92518,485734,197715
11,ENSG00000110107.4,60906585,chr11-60868754-T-C,rs3888242,-1,T,C,60868754,37831,60709977,61103193,158777
11,ENSG00000166788.5,18106082,chr11-18146083-A-G,rs4256954,-1,A,G,18146083,40001,17909474,18302690,236609
11,ENSG00000134910.7,125592852,chr11-125513851-G-A,rs4344501,1,G,A,125513851,79001,125396244,125789460,117607
11,ENSG00000166257.4,123654624,chr11-123697613-G-T,rs4430519,-1,G,T,123697613,42989,123458016,123851232,239597
11,ENSG00000134954.9,128587558,chr11-128429124-C-A,rs4511289,-1,C,A,128429124,158434,128390950,128784166,38174
11,ENSG00000134954.9,128587558,chr11-128429124-C-T,rs4511289,-1,C,T,128429124,158434,128390950,128784166,38174
11,ENSG00000137491.9,75151107,chr11-75060433-T-C,rs4531492,1,T,C,75060433,90674,74954499,75347715,105934
11,ENSG00000166471.6,9314593,chr11-9314802-T-G,rs4627080,-1,T,G,9314802,209,9117985,9511201,196817
11,ENSG00000151500.9,134253352,chr11-134318648-T-C,rs481252,-1,T,C,134318648,65296,134056744,134449960,261904
11,ENSG00000137757.6,105023168,chr11-105079768-A-G,rs481926,-1,A,G,105079768,56600,104826560,105219776,253208
11,ENSG00000168061.8,65041210,chr11-65026488-A-G,rs500464,1,A,G,65026488,14722,64844602,65237818,181886
11,ENSG00000166439.5,74748849,chr11-74781797-T-G,rs558303,1,T,G,74781797,32948,74552241,74945457,229556
11,ENSG00000120457.6,128891356,chr11-128918422-G-A,rs56398738,1,G,A,128918422,27066,128694748,129087964,223674
11,ENSG00000110108.3,60914158,chr11-60836174-G-A,rs582246,1,G,A,60836174,77984,60717550,61110766,118624
11,ENSG00000150316.7,94973556,chr11-94948659-C-G,rs58659817,-1,C,G,94948659,24897,94776948,95170164,171711
11,ENSG00000159063.7,78139626,chr11-78062669-T-C,rs589472,-1,T,C,78062669,76957,77943018,78336234,119651
11,ENSG00000110660.9,107858787,chr11-107800447-C-T,rs614473,-1,C,T,107800447,58340,107662179,108055395,138268
11,ENSG00000099834.13,624955,chr11-526356-G-A,rs61877777,-1,G,A,526356,98599,428347,821563,98009
11,ENSG00000129158.5,18013047,chr11-17908181-T-C,rs61882448,-1,T,C,17908181,104866,17816439,18209655,91742
11,ENSG00000158636.11,76445025,chr11-76641140-G-A,rs61893490,1,G,A,76641140,196115,76248417,76641633,392723
11,ENSG00000132744.3,67650730,chr11-67652857-G-A,rs61894522,-1,G,A,67652857,2127,67454122,67847338,198735
11,ENSG00000170209.4,113387779,chr11-113566966-C-A,rs61902850,1,C,A,113566966,179187,113191171,113584387,375795
11,ENSG00000149218.4,95089846,chr11-95080336-T-G,rs622175,1,T,G,95080336,9510,94893238,95286454,187098
11,ENSG00000126391.9,65386637,chr11-65210173-C-T,rs625750,1,C,T,65210173,176464,65190029,65583245,20144
11,ENSG00000149798.3,65314866,chr11-65254141-C-A,rs626802,1,C,A,65254141,60725,65118258,65511474,135883
11,ENSG00000137486.12,75351661,chr11-75497306-T-C,rs628972,-1,T,C,75497306,145645,75155053,75548269,342253
11,ENSG00000158555.10,75525941,chr11-75541831-T-G,rs633473,-1,T,G,75541831,15890,75329333,75722549,212498
11,ENSG00000162139.5,74988933,chr11-75012511-A-G,rs639768,1,A,G,75012511,23578,74792325,75185541,220186
11,ENSG00000149489.4,62613257,chr11-62677326-T-A,rs644616,1,T,A,62677326,64069,62416649,62809865,260677
11,ENSG00000149489.4,62613257,chr11-62677326-T-G,rs644616,1,T,G,62677326,64069,62416649,62809865,260677
11,ENSG00000168040.4,70203296,chr11-70225821-C-A,rs644817,1,C,A,70225821,22525,70006688,70399904,219133
11,ENSG00000110375.2,118956298,chr11-118941803-C-T,rs647769,1,C,T,118941803,14495,118759690,119152906,182113
11,ENSG00000020922.7,94493844,chr11-94541163-C-A,rs658234,-1,C,A,94541163,47319,94297236,94690452,243927
11,ENSG00000109944.5,122882759,chr11-123030229-A-G,rs6589965,1,A,G,123030229,147470,122686151,123079367,344078
11,ENSG00000110077.10,60183083,chr11-60318291-G-T,rs6591564,-1,G,T,60318291,135208,59986475,60379691,331816
11,ENSG00000166004.9,93661682,chr11-93772324-A-C,rs675441,1,A,C,93772324,110642,93465074,93858290,307250
11,ENSG00000166004.9,93661682,chr11-93772324-A-T,rs675441,1,A,T,93772324,110642,93465074,93858290,307250
11,ENSG00000173465.3,65570477,chr11-65383978-A-G,rs681309,1,A,G,65383978,186499,65373869,65767085,10109
11,ENSG00000110324.4,117986394,chr11-118161513-T-C,rs688563,1,T,C,118161513,175119,117789786,118183002,371727
11,ENSG00000172543.3,65879837,chr11-65827349-T-A,rs7102454,1,T,A,65827349,52488,65683229,66076445,144120
11,ENSG00000172543.3,65879837,chr11-65827349-T-C,rs7102454,1,T,C,65827349,52488,65683229,66076445,144120
11,ENSG00000167799.5,67629937,chr11-67630204-G-A,rs7102670,-1,G,A,67630204,267,67433329,67826545,196875
11,ENSG00000149196.10,86302240,chr11-86348381-T-C,rs7106664,1,T,C,86348381,46141,86105632,86498848,242749
11,ENSG00000149262.10,77994668,chr11-77986205-G-A,rs7110670,-1,G,A,77986205,8463,77798060,78191276,188145
11,ENSG00000064199.2,124673904,chr11-124629970-G-A,rs7112299,1,G,A,124629970,43934,124477296,124870512,152674
11,ENSG00000137760.10,107565735,chr11-107507702-C-T,rs7112793,-1,C,T,107507702,58033,107369127,107762343,138575
11,ENSG00000137760.10,107565735,chr11-107507702-C-A,rs7112793,-1,C,A,107507702,58033,107369127,107762343,138575
11,ENSG00000167996.10,61967634,chr11-61991821-T-C,rs7115285,-1,T,C,61991821,24187,61771026,62164242,220795
11,ENSG00000110046.7,64917209,chr11-65089223-C-T,rs7120844,-1,C,T,65089223,172014,64720601,65113817,368622
11,ENSG00000036672.9,119381690,chr11-119351996-G-A,rs7122785,-1,G,A,119351996,29694,119185082,119578298,166914
11,ENSG00000133794.12,13277790,chr11-13117900-G-C,rs7123819,1,G,C,13117900,159890,13081182,13474398,36718
11,ENSG00000019485.8,45146639,chr11-45074818-C-T,rs7126280,1,C,T,45074818,71821,44950031,45343247,124787
11,ENSG00000158077.4,7020479,chr11-6903030-G-C,rs7129133,1,G,C,6903030,117449,6823871,7217087,79159
11,ENSG00000110315.2,10541187,chr11-10686720-A-G,rs716381,-1,A,G,10686720,145533,10344579,10737795,342141
11,ENSG00000149292.11,113314583,chr11-113363749-A-G,rs719803,1,A,G,113363749,49166,113117975,113511191,245774
11,ENSG00000255823.1,10509186,chr11-10496971-T-C,rs72857486,-1,T,C,10496971,12215,10312578,10705794,184393
11,ENSG00000134627.7,94567368,chr11-94598254-T-G,rs72965817,1,T,G,94598254,30886,94370760,94763976,227494
11,ENSG00000134780.5,61680391,chr11-61539766-T-C,rs73496255,1,T,C,61539766,140625,61483783,61876999,55983
11,ENSG00000148943.7,27506769,chr11-27592200-T-A,rs74425542,-1,T,A,27592200,85431,27310161,27703377,282039
11,ENSG00000160593.12,118225011,chr11-118300570-T-C,rs7479373,-1,T,C,118300570,75559,118028403,118421619,272167
11,ENSG00000110328.5,11622005,chr11-11659388-G-A,rs7480726,-1,G,A,11659388,37383,11425397,11818613,233991
11,ENSG00000142089.9,320860,chr11-336138-A-G,rs7481076,-1,A,G,336138,15278,124252,517468,211886
11,ENSG00000129757.8,2885775,chr11-3046128-G-A,rs74937625,-1,G,A,3046128,160353,2689167,3082383,356961
11,ENSG00000181649.5,2929420,chr11-3046128-G-A,rs74937625,-1,G,A,3046128,116708,2732812,3126028,313316
11,ENSG00000072952.12,10693755,chr11-10640584-C-T,rs76288654,-1,C,T,10640584,53171,10497147,10890363,143437
11,ENSG00000167987.5,61161426,chr11-61063095-T-C,rs7925904,-1,T,C,61063095,98331,60964818,61358034,98277
11,ENSG00000132259.8,6239089,chr11-6302831-C-T,rs7930238,1,C,T,6302831,63742,6042481,6435697,260350
11,ENSG00000070047.6,576470,chr11-577534-G-A,rs7936397,1,G,A,577534,1064,379862,773078,197672
11,ENSG00000026508.11,35139171,chr11-35292752-G-T,rs7937731,1,G,T,35292752,153581,34942563,35335779,350189
11,ENSG00000026508.11,35139171,chr11-35292752-G-C,rs7937731,1,G,C,35292752,153581,34942563,35335779,350189
11,ENSG00000019102.7,124752255,chr11-124778591-C-T,rs7937766,-1,C,T,124778591,26336,124555647,124948863,222944
11,ENSG00000166800.5,18455856,chr11-18458768-A-G,rs7938977,1,A,G,18458768,2912,18259248,18652464,199520
11,ENSG00000177697.12,832952,chr11-890405-T-C,rs7940112,1,T,C,890405,57453,636344,1029560,254061
11,ENSG00000149781.8,64206721,chr11-64093845-A-G,rs7941785,1,A,G,64093845,112876,64010113,64403329,83732
11,ENSG00000110665.7,2301918,chr11-2294174-G-A,rs7941928,-1,G,A,2294174,7744,2105310,2498526,188864
11,ENSG00000064201.10,2302013,chr11-2294174-G-A,rs7941928,1,G,A,2294174,7839,2105405,2498621,188769
11,ENSG00000166575.10,87037934,chr11-87180098-C-T,rs7946112,1,C,T,87180098,142164,86841326,87234542,338772
11,ENSG00000162105.9,71252577,chr11-71304004-C-T,rs79854874,-1,C,T,71304004,51427,71055969,71449185,248035
11,ENSG00000162341.9,69048932,chr11-69101566-A-G,rs921675,1,A,G,69101566,52634,68852324,69245540,249242
11,ENSG00000160588.5,118252365,chr11-118447464-G-T,rs9332755,-1,G,T,118447464,195099,118055757,118448973,391707
11,ENSG00000149582.10,118531192,chr11-118521851-G-A,rs9332865,1,G,A,118521851,9341,118334584,118727800,187267
11,ENSG00000110074.6,126269154,chr11-126423293-G-T,rs948054,1,G,T,126423293,154139,126072546,126465762,350747
11,ENSG00000110074.6,126269154,chr11-126423293-G-A,rs948054,1,G,A,126423293,154139,126072546,126465762,350747
11,ENSG00000181074.3,5754243,chr11-5738230-T-C,rs9665780,1,T,C,5738230,16013,5557635,5950851,180595
11,ENSG00000158077.4,7020479,chr11-6916293-C-T,rs10732224,1,C,T,6916293,104186,6823871,7217087,92422
11,ENSG00000184956.11,1036718,chr11-1006874-G-T,rs111317734,-1,G,T,1006874,29844,840110,1233326,166764
11,ENSG00000197345.7,68903832,chr11-68835878-T-C,rs11228377,-1,T,C,68835878,67954,68707224,69100440,128654
11,ENSG00000173511.5,64234584,chr11-64200298-C-T,rs11231722,1,C,T,64200298,34286,64037976,64431192,162322
11,ENSG00000173511.5,64234584,chr11-64200298-C-G,rs11231722,1,C,G,64200298,34286,64037976,64431192,162322
11,ENSG00000124942.7,62546806,chr11-62434114-G-T,rs116846164,-1,G,T,62434114,112692,62350198,62743414,83916
11,ENSG00000030066.8,47848467,chr11-47826943-G-T,rs116983862,-1,G,T,47826943,21524,47651859,48045075,175084
11,ENSG00000110492.9,46381669,chr11-46366474-G-A,rs11827702,1,G,A,46366474,15195,46185061,46578277,181413
11,ENSG00000242689.1,58622665,chr11-58674430-C-A,rs12794523,1,C,A,58674430,51765,58426057,58819273,248373
11,ENSG00000188124.2,6771976,chr11-6921464-C-G,rs12806437,-1,C,G,6921464,149488,6575368,6968584,346096
11,ENSG00000188124.2,6771976,chr11-6921464-C-T,rs12806437,-1,C,T,6921464,149488,6575368,6968584,346096
11,ENSG00000166796.7,18412318,chr11-18488446-C-T,rs16935476,1,C,T,18488446,76128,18215710,18608926,272736
11,ENSG00000166323.8,108467529,chr11-108340068-A-G,rs17092269,-1,A,G,108340068,127461,108270921,108664137,69147
11,ENSG00000151117.3,18698779,chr11-18707103-T-C,rs2289965,1,T,C,18707103,8324,18502171,18895387,204932
11,ENSG00000183020.7,925870,chr11-885064-G-A,rs28653756,1,G,A,885064,40806,729262,1122478,155802
11,ENSG00000172247.3,47594411,chr11-47652549-G-A,rs2869024,-1,G,A,47652549,58138,47397803,47791019,254746
11,ENSG00000137474.12,77128246,chr11-77105449-G-A,rs34950930,1,G,A,77105449,22797,76931638,77324854,173811
11,ENSG00000149554.7,125625163,chr11-125513851-G-A,rs4344501,1,G,A,125513851,111312,125428555,125821771,85296
11,ENSG00000174684.5,66347629,chr11-66309732-A-G,rs4390351,-1,A,G,66309732,37897,66151021,66544237,158711
11,ENSG00000167987.5,61161426,chr11-61111190-C-T,rs522073,-1,C,T,61111190,50236,60964818,61358034,146372
11,ENSG00000110104.5,60842113,chr11-60860110-C-T,rs533116,1,C,T,60860110,17997,60645505,61038721,214605
11,ENSG00000167985.2,61430124,chr11-61549995-T-C,rs57058363,1,T,C,61549995,119871,61233516,61626732,316479
11,ENSG00000085741.6,76206502,chr11-76045630-G-A,rs594826,-1,G,A,76045630,160872,76009894,76403110,35736
11,ENSG00000168061.8,65041210,chr11-65210173-C-T,rs625750,1,C,T,65210173,168963,64844602,65237818,365571
11,ENSG00000196371.2,94543921,chr11-94598254-T-G,rs72965817,1,T,G,94598254,54333,94347313,94740529,250941
10,ENSG00000165813.11,114174203,chr10-114284605-T-C,rs1003441,-1,T,C,114284605,110402,113977595,114370811,307010
10,ENSG00000122863.5,71964395,chr10-71985718-C-T,rs1006974,1,C,T,71985718,21323,71767787,72161003,217931
10,ENSG00000176244.6,15088776,chr10-15067545-G-A,rs10082455,-1,G,A,15067545,21231,14892168,15285384,175377
10,ENSG00000155265.5,97849843,chr10-97812539-T-C,rs1010006,1,T,C,97812539,37304,97653235,98046451,159304
10,ENSG00000107951.7,30349278,chr10-30302276-A-C,rs1011590,-1,A,C,30302276,47002,30152670,30545886,149606
10,ENSG00000107951.7,30349278,chr10-30302276-A-T,rs1011590,-1,A,T,30302276,47002,30152670,30545886,149606
10,ENSG00000171160.12,97633500,chr10-97683079-G-A,rs10444067,-1,G,A,97683079,49579,97436892,97830108,246187
10,ENSG00000107651.8,119892730,chr10-119711355-C-T,rs10466211,1,C,T,119711355,181375,119696122,120089338,15233
10,ENSG00000107672.8,121975217,chr10-121865675-T-C,rs10510102,-1,T,C,121865675,109542,121778609,122171825,87066
10,ENSG00000099282.4,69451465,chr10-69507254-G-A,rs1052179,1,G,A,69507254,55789,69254857,69648073,252397
10,ENSG00000138185.11,95756163,chr10-95825257-T-G,rs10736093,1,T,G,95825257,69094,95559555,95952771,265702
10,ENSG00000138326.12,78033863,chr10-78080247-G-A,rs10740469,1,G,A,78080247,46384,77837255,78230471,242992
10,ENSG00000148843.7,103396626,chr10-103500777-A-G,rs10748843,1,A,G,103500777,104151,103200018,103593234,300759
10,ENSG00000148835.9,103367976,chr10-103500777-A-G,rs10748843,1,A,G,103500777,132801,103171368,103564584,329409
10,ENSG00000152457.13,14954096,chr10-15055617-G-T,rs10752349,-1,G,T,15055617,101521,14757488,15150704,298129
10,ENSG00000152464.8,15097355,chr10-15292034-T-C,rs10752361,1,T,C,15292034,194679,14900747,15293963,391287
10,ENSG00000165383.6,48914232,chr10-48916732-T-A,rs10776654,-1,T,A,48916732,2500,48717624,49110840,199108
10,ENSG00000165383.6,48914232,chr10-48916732-T-G,rs10776654,-1,T,G,48916732,2500,48717624,49110840,199108
10,ENSG00000148468.11,15371289,chr10-15351310-G-A,rs10796285,-1,G,A,15351310,19979,15174681,15567897,176629
10,ENSG00000122912.9,68527523,chr10-68503822-C-T,rs10823215,-1,C,T,68503822,23701,68330915,68724131,172907
10,ENSG00000120594.9,19816432,chr10-19967314-A-C,rs10827912,1,A,C,19967314,150882,19619824,20013040,347490
10,ENSG00000174721.9,91909486,chr10-91900602-A-G,rs10881991,-1,A,G,91900602,8884,91712878,92106094,187724
10,ENSG00000176273.9,93893978,chr10-93905209-A-T,rs10882364,1,A,T,93905209,11231,93697370,94090586,207839
10,ENSG00000188690.7,125823258,chr10-125820725-G-C,rs10901450,-1,G,C,125820725,2533,125626650,126019866,194075
10,ENSG00000154473.11,123154402,chr10-123161441-T-C,rs10902883,1,T,C,123161441,7039,122957794,123351010,203647
10,ENSG00000165983.9,16437010,chr10-16443700-G-T,rs10904741,1,G,T,16443700,6690,16240402,16633618,203298
10,ENSG00000165983.9,16437010,chr10-16443700-G-A,rs10904741,1,G,A,16443700,6690,16240402,16633618,203298
10,ENSG00000165630.8,13586965,chr10-13591835-A-G,rs10906419,1,A,G,13591835,4870,13390357,13783573,201478
10,ENSG00000138311.11,62374369,chr10-62422860-C-T,rs10995153,1,C,T,62422860,48491,62177761,62570977,245099
10,ENSG00000180817.6,70233429,chr10-70197356-C-T,rs10999176,-1,C,T,70197356,36073,70036821,70430037,160535
10,ENSG00000120549.10,24209138,chr10-24378162-T-C,rs11014072,1,T,C,24378162,169024,24012530,24405746,365632
10,ENSG00000120549.10,24209138,chr10-24378162-T-G,rs11014072,1,T,G,24378162,169024,24012530,24405746,365632
10,ENSG00000148803.7,133358019,chr10-133376925-T-C,rs11101722,-1,T,C,133376925,18906,133161411,133554627,215514
10,ENSG00000099256.12,24952606,chr10-25106272-T-C,rs111238065,-1,T,C,25106272,153666,24755998,25149214,350274
10,ENSG00000185875.8,25016612,chr10-25106272-T-C,rs111238065,1,T,C,25106272,89660,24820004,25213220,286268
10,ENSG00000243660.3,43437111,chr10-43517605-C-T,rs1112958,1,C,T,43517605,80494,43240503,43633719,277102
10,ENSG00000052749.9,97401340,chr10-97375458-T-C,rs11189172,-1,T,C,97375458,25882,97204732,97597948,170726
10,ENSG00000173915.8,103396475,chr10-103296155-A-G,rs11191642,-1,A,G,103296155,100320,103199867,103593083,96288
10,ENSG00000120051.10,104353833,chr10-104351331-C-T,rs11192019,1,C,T,104351331,2502,104157225,104550441,194106
10,ENSG00000107551.13,44959802,chr10-44992854-A-G,rs11239303,1,A,G,44992854,33052,44763194,45156410,229660
10,ENSG00000107863.10,24723887,chr10-24857568-C-T,rs1124120,-1,C,T,24857568,133681,24527279,24920495,330289
10,ENSG00000107937.13,988434,chr10-1054260-A-G,rs11250243,1,A,G,1054260,65826,791826,1185042,262434
10,ENSG00000123243.10,7666966,chr10-7694941-C-T,rs11255291,-1,C,T,7694941,27975,7470358,7863574,224583
10,ENSG00000123243.10,7666966,chr10-7694941-C-A,rs11255291,-1,C,A,7694941,27975,7470358,7863574,224583
10,ENSG00000181192.7,12068954,chr10-11918603-A-G,rs11257426,1,A,G,11918603,150351,11872346,12265562,46257
10,ENSG00000148483.7,17752201,chr10-17699488-T-C,rs11593510,1,T,C,17699488,52713,17555593,17948809,143895
10,ENSG00000204149.4,49988406,chr10-49832344-A-G,rs11599257,1,A,G,49832344,156062,49791798,50185014,40546
10,ENSG00000107854.5,91798426,chr10-91667684-G-A,rs118083231,1,G,A,91667684,130742,91601818,91995034,65866
10,ENSG00000077150.12,102395705,chr10-102220804-A-C,rs11814771,1,A,C,102220804,174901,102199097,102592313,21707
10,ENSG00000185267.5,14838037,chr10-14817921-T-C,rs11817170,-1,T,C,14817921,20116,14641429,15034645,176492
10,ENSG00000204161.7,49188391,chr10-49207276-T-C,rs12253910,-1,T,C,49207276,18885,48991783,49384999,215493
10,ENSG00000196233.6,96832298,chr10-97014345-T-C,rs12254525,1,T,C,97014345,182047,96635690,97028906,378655
10,ENSG00000107902.9,124461823,chr10-124464426-C-T,rs12261656,1,C,T,124464426,2603,124265215,124658431,199211
10,ENSG00000148834.8,104254892,chr10-104272003-C-T,rs12261808,1,C,T,104272003,17111,104058284,104451500,213719
10,ENSG00000095585.10,96271569,chr10-96228697-C-T,rs12357751,-1,C,T,96228697,42872,96074961,96468177,153736
10,ENSG00000148841.10,104338465,chr10-104351421-A-G,rs12359649,-1,A,G,104351421,12956,104141857,104535073,209564
10,ENSG00000198246.7,71319259,chr10-71313495-A-C,rs12412201,1,A,C,71313495,5764,71122651,71515867,190844
10,ENSG00000148735.10,113751310,chr10-113724441-T-G,rs12769185,1,T,G,113724441,26869,113554702,113947918,169739
10,ENSG00000122359.11,80205537,chr10-80181108-T-C,rs12779955,-1,T,C,80181108,24429,80008929,80402145,172179
10,ENSG00000075073.10,69416918,chr10-69401141-C-T,rs13139,-1,C,T,69401141,15777,69220310,69613526,180831
10,ENSG00000181915.3,62804720,chr10-62792847-G-A,rs1509966,1,G,A,62792847,11873,62608112,63001328,184735
10,ENSG00000165650.7,117375440,chr10-117414434-T-C,rs1638665,-1,T,C,117414434,38994,117178832,117572048,235602
10,ENSG00000183621.9,31031937,chr10-31009396-G-A,rs1690624,-1,G,A,31009396,22541,30835329,31228545,174067
10,ENSG00000150867.7,22714578,chr10-22816067-A-C,rs16922732,-1,A,C,22816067,101489,22517970,22911186,298097
10,ENSG00000122859.4,69573422,chr10-69694167-G-A,rs16926612,-1,G,A,69694167,120745,69376814,69770030,317353
10,ENSG00000107738.12,71773520,chr10-71727370-A-G,rs16929266,-1,A,G,71727370,46150,71576912,71970128,150458
10,ENSG00000172538.6,49134021,chr10-49090146-G-T,rs17011799,-1,G,T,49090146,43875,48937413,49330629,152733
10,ENSG00000169826.6,43138445,chr10-43128364-C-T,rs17028,1,C,T,43128364,10081,42941837,43335053,186527
10,ENSG00000198873.8,119207571,chr10-119328387-T-C,rs17098718,1,T,C,119328387,120816,119010963,119404179,317424
10,ENSG00000155256.12,97737128,chr10-97574571-T-C,rs17108102,1,T,C,97574571,162557,97540520,97933736,34051
10,ENSG00000107521.13,98446935,chr10-98402394-T-C,rs17109653,-1,T,C,98402394,44541,98250327,98643543,152067
10,ENSG00000120008.10,120851362,chr10-120962691-T-C,rs17510528,1,T,C,120962691,111329,120654754,121047970,307937
10,ENSG00000120049.12,101843800,chr10-101961056-G-A,rs17699425,-1,G,A,101961056,117256,101647192,102040408,313864
10,ENSG00000165646.7,117241114,chr10-117343960-A-C,rs181440,1,A,C,117343960,102846,117044506,117437722,299454
10,ENSG00000185303.9,79560407,chr10-79629844-C-A,rs1863889,-1,C,A,79629844,69437,79363799,79757015,266045
10,ENSG00000122852.9,79610939,chr10-79629844-C-A,rs1863889,1,C,A,79629844,18905,79414331,79807547,215513
10,ENSG00000119917.8,89327997,chr10-89503830-T-C,rs188570,1,T,C,89503830,175833,89131389,89524605,372441
10,ENSG00000165512.4,45000923,chr10-45052514-G-A,rs1936394,1,G,A,45052514,51591,44804315,45197531,248199
10,ENSG00000138347.10,68109488,chr10-68162978-C-T,rs2087344,1,C,T,68162978,53490,67912880,68306096,250098
10,ENSG00000148798.5,103277138,chr10-103450224-T-C,rs2232658,1,T,C,103450224,173086,103080530,103473746,369694
10,ENSG00000198879.6,7411034,chr10-7465842-A-C,rs2251868,-1,A,C,7465842,54808,7214426,7607642,251416
10,ENSG00000165996.8,17617374,chr10-17697804-G-A,rs2253965,-1,G,A,17697804,80430,17420766,17813982,277038
10,ENSG00000138346.9,68471973,chr10-68341899-A-G,rs2273902,-1,A,G,68341899,130074,68275365,68668581,66534
10,ENSG00000148814.13,132332193,chr10-132337416-T-G,rs2295273,1,T,G,132337416,5223,132135585,132528801,201831
10,ENSG00000148908.10,119542719,chr10-119527180-A-G,rs2301181,-1,A,G,119527180,15539,119346111,119739327,181069
10,ENSG00000138134.7,88880245,chr10-88901941-A-G,rs2304803,1,A,G,88901941,21696,88683637,89076853,218304
10,ENSG00000166343.5,73433561,chr10-73627588-A-G,rs2395054,-1,A,G,73627588,194027,73236953,73630169,390635
10,ENSG00000136754.12,26860958,chr10-26933028-G-C,rs2477935,-1,G,C,26933028,72070,26664350,27057566,268678
10,ENSG00000198954.4,68988803,chr10-69005336-G-T,rs2487707,1,G,T,69005336,16533,68792195,69185411,213141
10,ENSG00000165732.7,68956170,chr10-69036167-C-T,rs2491032,1,C,T,69036167,79997,68759562,69152778,276605
10,ENSG00000165731.11,43077069,chr10-42952399-A-G,rs2506030,1,A,G,42952399,124670,42880461,43273677,71938
10,ENSG00000148484.12,16817424,chr10-16818064-A-G,rs2603794,-1,A,G,16818064,640,16620816,17014032,197248
10,ENSG00000128815.11,48684873,chr10-48801973-C-T,rs2663037,1,C,T,48801973,117100,48488265,48881481,313708
10,ENSG00000150347.10,61901699,chr10-61763508-T-C,rs2675612,1,T,C,61763508,138191,61705091,62098307,58417
10,ENSG00000165322.12,31928831,chr10-31762016-A-G,rs2797128,-1,A,G,31762016,166815,31732223,32125439,29793
10,ENSG00000107957.10,103855576,chr10-103952090-A-G,rs2864004,-1,A,G,103952090,96514,103658968,104052184,293122
10,ENSG00000203772.6,133424625,chr10-133345696-A-G,rs2864417,-1,A,G,133345696,78929,133228017,133621233,117679
10,ENSG00000156398.6,102714636,chr10-102727625-C-T,rs2902548,1,C,T,102727625,12989,102518028,102911244,209597
10,ENSG00000107798.11,89251775,chr10-89240182-T-C,rs2902563,-1,T,C,89240182,11593,89055167,89448383,185015
10,ENSG00000077420.9,26438341,chr10-26438525-G-A,rs2992333,1,G,A,26438525,184,26241733,26634949,196792
10,ENSG00000152778.7,89414568,chr10-89402920-C-G,rs303210,1,C,G,89402920,11648,89217960,89611176,184960
10,ENSG00000152778.7,89414568,chr10-89402920-C-T,rs303210,1,C,T,89402920,11648,89217960,89611176,184960
10,ENSG00000119977.13,95693927,chr10-95845184-T-C,rs3176883,-1,T,C,95845184,151257,95497319,95890535,347865
10,ENSG00000196072.6,100286680,chr10-100274701-A-G,rs3180413,-1,A,G,100274701,11979,100090072,100483288,184629
10,ENSG00000165672.5,119178812,chr10-119168032-T-G,rs3377,-1,T,G,119168032,10780,118982204,119375420,185828
10,ENSG00000156510.9,69220332,chr10-69177133-T-G,rs34052666,1,T,G,69177133,43199,69023724,69416940,153409
10,ENSG00000177613.7,51699595,chr10-51698287-A-G,rs3740228,-1,A,G,51698287,1308,51502987,51896203,195300
10,ENSG00000107796.7,88952773,chr10-88991583-A-G,rs3740286,-1,A,G,88991583,38810,88756165,89149381,235418
10,ENSG00000107816.11,100999476,chr10-100987606-G-T,rs3740484,1,G,T,100987606,11870,100802868,101196084,184738
10,ENSG00000055950.12,100987497,chr10-100994481-A-G,rs3740489,-1,A,G,100994481,6984,100790889,101184105,203592
10,ENSG00000165879.7,97319271,chr10-97318988-C-T,rs3740512,1,C,T,97318988,283,97122663,97515879,196325
10,ENSG00000138180.10,93496612,chr10-93498283-T-C,rs3758541,1,T,C,93498283,1671,93300004,93693220,198279
10,ENSG00000089876.7,125881292,chr10-125839698-T-C,rs3781058,-1,T,C,125839698,41594,125684684,126077900,155014
10,ENSG00000165806.12,113679912,chr10-113721259-C-T,rs3814231,1,C,T,113721259,41347,113483304,113876520,237955
10,ENSG00000067057.10,3067548,chr10-3113216-C-T,rs3816700,1,C,T,3113216,45668,2870940,3264156,242276
10,ENSG00000204020.4,88760020,chr10-88733777-C-T,rs406671,1,C,T,88733777,26243,88563412,88956628,170365
10,ENSG00000065154.7,124418923,chr10-124418937-A-C,rs4144117,-1,A,C,124418937,14,124222315,124615531,196622
10,ENSG00000165995.14,18140424,chr10-18328653-A-C,rs4146986,1,A,C,18328653,188229,17943816,18337032,384837
10,ENSG00000138175.7,102714397,chr10-102666420-G-A,rs4244354,-1,G,A,102666420,47977,102517789,102911005,148631
10,ENSG00000165633.6,49115522,chr10-49135640-G-C,rs4338455,-1,G,C,49135640,20118,48918914,49312130,216726
10,ENSG00000119922.7,89302046,chr10-89352023-C-T,rs4378299,1,C,T,89352023,49977,89105438,89498654,246585
10,ENSG00000148719.9,72354919,chr10-72309368-T-C,rs4409753,-1,T,C,72309368,45551,72158311,72551527,151057
10,ENSG00000148848.9,126388477,chr10-126308172-A-G,rs4420178,-1,A,G,126308172,80305,126191869,126585085,116303
10,ENSG00000151461.13,12042809,chr10-11925793-C-T,rs4466734,-1,C,T,11925793,117016,11846201,12239417,79592
10,ENSG00000148730.6,70404145,chr10-70422354-G-A,rs45450199,1,G,A,70422354,18209,70207537,70600753,214817
10,ENSG00000107537.9,13300064,chr10-13288402-T-C,rs473407,-1,T,C,13288402,11662,13103456,13496672,184946
10,ENSG00000134463.10,11742382,chr10-11747638-G-A,rs4750093,1,G,A,11747638,5256,11545774,11938990,201864
10,ENSG00000151923.12,119596964,chr10-119533523-T-G,rs4752325,-1,T,G,119533523,63441,119400356,119793572,133167
10,ENSG00000171206.7,102644479,chr10-102460819-C-T,rs4917968,1,C,T,102460819,183660,102447871,102841087,12948
10,ENSG00000171311.7,97446006,chr10-97445974-A-G,rs4919098,-1,A,G,97445974,32,97249398,97642614,196576
10,ENSG00000148690.9,93702592,chr10-93847792-T-G,rs4919587,-1,T,G,93847792,145200,93505984,93899200,341808
10,ENSG00000214435.3,102869470,chr10-102856743-T-C,rs4919690,1,T,C,102856743,12727,102672862,103066078,183881
10,ENSG00000119965.8,122954227,chr10-122933070-A-G,rs4980169,-1,A,G,122933070,21157,122757619,123150835,175451
10,ENSG00000214655.5,73785606,chr10-73950272-G-A,rs56215513,1,G,A,73950272,164666,73588998,73982214,361274
10,ENSG00000107614.16,17201672,chr10-17144448-C-T,rs56394211,-1,C,T,17144448,57224,17005064,17398280,139384
10,ENSG00000107614.16,17201672,chr10-17144448-C-A,rs56394211,-1,C,A,17144448,57224,17005064,17398280,139384
10,ENSG00000180644.5,70602741,chr10-70664556-C-T,rs608234,-1,C,T,70664556,61815,70406133,70799349,258423
10,ENSG00000075407.11,38094337,chr10-38057089-T-C,rs61858885,1,T,C,38057089,37248,37897729,38290945,159360
10,ENSG00000171314.6,97426191,chr10-97590676-C-A,rs61863261,1,C,A,97590676,164485,97229583,97622799,361093
10,ENSG00000165730.10,68827531,chr10-68785522-G-A,rs61869871,1,G,A,68785522,42009,68630923,69024139,154599
10,ENSG00000099204.12,114658275,chr10-114471861-T-G,rs6585284,-1,T,G,114471861,186414,114461667,114854883,10194
10,ENSG00000182022.12,124093598,chr10-124065861-T-A,rs6588750,-1,T,A,124065861,27737,123896990,124290206,168871
10,ENSG00000182022.12,124093598,chr10-124065861-T-C,rs6588750,-1,T,C,124065861,27737,123896990,124290206,168871
10,ENSG00000107959.9,3172782,chr10-3177602-A-G,rs6602036,-1,A,G,3177602,4820,2976174,3369390,201428
10,ENSG00000065665.15,12129677,chr10-12167753-T-C,rs6686,1,T,C,12167753,38076,11933069,12326285,234684
10,ENSG00000119906.6,100912963,chr10-101007360-C-A,rs701836,1,C,A,101007360,94397,100716355,101109571,291005
10,ENSG00000148377.5,1025859,chr10-978274-T-C,rs7069123,-1,T,C,978274,47585,829251,1222467,149023
10,ENSG00000166321.9,73110455,chr10-73152246-T-C,rs7069878,1,T,C,73152246,41791,72913847,73307063,238399
10,ENSG00000198298.8,43606438,chr10-43575139-A-G,rs7075288,1,A,G,43575139,31299,43409830,43803046,165309
10,ENSG00000014919.7,99732127,chr10-99604767-T-C,rs7075305,-1,T,C,99604767,127360,99535519,99928735,69248
10,ENSG00000078403.11,21534232,chr10-21491741-A-G,rs7076249,1,A,G,21491741,42491,21337624,21730840,154117
10,ENSG00000196968.4,73772276,chr10-73753039-C-T,rs7076525,1,C,T,73753039,19237,73575668,73968884,177371
10,ENSG00000197889.4,14959388,chr10-14966555-A-G,rs7079652,1,A,G,14966555,7167,14762780,15155996,203775
10,ENSG00000108091.10,59906556,chr10-59711206-A-T,rs7080992,-1,A,T,59711206,195350,59709948,60103164,1258
10,ENSG00000134461.9,5889893,chr10-5894148-G-A,rs7085189,-1,G,A,5894148,4255,5693285,6086501,200863
10,ENSG00000165752.11,132307950,chr10-132336922-A-C,rs7085610,-1,A,C,132336922,28972,132111342,132504558,225580
10,ENSG00000189129.8,80132730,chr10-80153805-C-T,rs7091565,1,C,T,80153805,21075,79936122,80329338,217683
10,ENSG00000107882.7,102503972,chr10-102457684-A-G,rs7094906,1,A,G,102457684,46288,102307364,102700580,150320
10,ENSG00000107815.3,100987543,chr10-100880492-T-A,rs7096225,1,T,A,100880492,107051,100790935,101184151,89557
10,ENSG00000171811.7,132942570,chr10-132940068-T-C,rs7096772,-1,T,C,132940068,2502,132745962,133139178,194106
10,ENSG00000166348.12,73591342,chr10-73602031-C-A,rs7097343,-1,C,A,73602031,10689,73394734,73787950,207297
10,ENSG00000148634.10,68075283,chr10-68150809-G-T,rs7097584,-1,G,T,68150809,75526,67878675,68271891,272134
10,ENSG00000227345.3,49942027,chr10-49995520-A-G,rs72797724,-1,A,G,49995520,53493,49745419,50138635,250101
10,ENSG00000122884.7,73096866,chr10-73002410-G-A,rs72812259,-1,G,A,73002410,94456,72900258,73293474,102152
10,ENSG00000213551.3,73247255,chr10-73060688-C-A,rs72812263,-1,C,A,73060688,186567,73050647,73443863,10041
10,ENSG00000043591.4,114043866,chr10-114026852-G-T,rs72823015,1,G,T,114026852,17014,113847258,114240474,179594
10,ENSG00000165476.6,63521401,chr10-63618935-C-T,rs72840204,1,C,T,63618935,97534,63324793,63718009,294142
10,ENSG00000225899.2,133626795,chr10-133456883-G-C,rs72868335,-1,G,C,133456883,169912,133430187,133823403,26696
10,ENSG00000165832.4,114938195,chr10-114990436-A-G,rs73372700,1,A,G,114990436,52241,114741587,115134803,248849
10,ENSG00000107562.12,44385097,chr10-44356510-G-A,rs736724,-1,G,A,44356510,28587,44188489,44581705,168021
10,ENSG00000152465.11,15168693,chr10-15157348-C-A,rs75941989,-1,C,A,15157348,11345,14972085,15365301,185263
10,ENSG00000107611.9,17129811,chr10-17003668-T-C,rs76098511,-1,T,C,17003668,126143,16933203,17326419,70465
10,ENSG00000138316.6,70672506,chr10-70578123-C-T,rs76143452,1,C,T,70578123,94383,70475898,70869114,102225
10,ENSG00000107438.4,95291003,chr10-95289181-G-A,rs76672094,-1,G,A,95289181,1822,95094395,95487611,194786
10,ENSG00000107438.4,95291003,chr10-95289181-G-C,rs76672094,-1,G,C,95289181,1822,95094395,95487611,194786
10,ENSG00000165449.7,59709850,chr10-59707825-G-C,rs76953358,-1,G,C,59707825,2025,59513242,59906458,194583
10,ENSG00000148688.6,90871974,chr10-90926725-A-G,rs77310729,1,A,G,90926725,54751,90675366,91068582,251359
10,ENSG00000107949.11,125823546,chr10-125787124-C-A,rs78084887,1,C,A,125787124,36422,125626938,126020154,160186
10,ENSG00000107949.11,125823546,chr10-125787124-C-T,rs78084887,1,C,T,125787124,36422,125626938,126020154,160186
10,ENSG00000177283.4,35642296,chr10-35682739-C-T,rs78852685,-1,C,T,35682739,40443,35445688,35838904,237051
10,ENSG00000127884.4,133373354,chr10-133370917-C-G,rs7894051,-1,C,G,133370917,2437,133176746,133569962,194171
10,ENSG00000185532.8,51074487,chr10-51014288-G-A,rs7895755,1,G,A,51014288,60199,50877879,51271095,136409
10,ENSG00000165406.9,45535371,chr10-45588052-G-T,rs7896175,-1,G,T,45588052,52681,45338763,45731979,249289
10,ENSG00000165678.13,84139509,chr10-84225575-C-T,rs7898778,1,C,T,84225575,86066,83942901,84336117,282674
10,ENSG00000012779.5,45374216,chr10-45336491-G-A,rs7906533,1,G,A,45336491,37725,45177608,45570824,158883
10,ENSG00000165985.7,16521879,chr10-16514711-T-C,rs7909832,-1,T,C,16514711,7168,16325271,16718487,189440
10,ENSG00000107771.11,84328589,chr10-84289284-G-A,rs7914940,1,G,A,84289284,39305,84131981,84525197,157303
10,ENSG00000107954.6,103493705,chr10-103590690-C-T,rs7918186,1,C,T,103590690,96985,103297097,103690313,293593
10,ENSG00000095539.10,100972540,chr10-101044326-T-C,rs7921250,1,T,C,101044326,71786,100775932,101169148,268394
10,ENSG00000108179.8,79347469,chr10-79367893-A-T,rs7922163,1,A,T,79367893,20424,79150861,79544077,217032
10,ENSG00000107554.10,100009947,chr10-99931871-G-T,rs7922447,-1,G,T,99931871,78076,99813339,100206555,118532
10,ENSG00000065809.8,14774897,chr10-14664762-A-G,rs7923154,-1,A,G,14664762,110135,14578289,14971505,86473
10,ENSG00000119927.9,112183765,chr10-112171675-G-A,rs79569343,-1,G,A,112171675,12090,111987157,112380373,184518
10,ENSG00000169129.8,114404502,chr10-114214494-C-T,rs79605080,-1,C,T,114214494,190008,114207894,114601110,6600
10,ENSG00000165507.7,44978809,chr10-44984028-G-T,rs79857424,-1,G,T,44984028,5219,44782201,45175417,201827
10,ENSG00000173848.13,5412557,chr10-5477714-G-T,rs80238017,1,G,T,5477714,65157,5215949,5609165,261765
10,ENSG00000170759.10,32056425,chr10-32072287-G-A,rs806818,-1,G,A,32072287,15862,31859817,32253033,212470
10,ENSG00000150054.12,28303064,chr10-28330558-T-C,rs811496,-1,T,C,28330558,27494,28106456,28499672,224102
10,ENSG00000086475.9,13348293,chr10-13271567-T-C,rs825631,-1,T,C,13271567,76726,13151685,13544901,119882
10,ENSG00000214413.2,110919180,chr10-110835961-G-C,rs942077,-1,G,C,110835961,83219,110722572,111115788,113389
10,ENSG00000214413.2,110919180,chr10-110835961-G-A,rs942077,-1,G,A,110835961,83219,110722572,111115788,113389
10,ENSG00000237489.2,130110830,chr10-130089055-G-A,rs942675,-1,G,A,130089055,21775,129914222,130307438,174833
10,ENSG00000166275.10,102854259,chr10-102863821-C-T,rs9527,1,C,T,102863821,9562,102657651,103050867,206170
10,ENSG00000150593.11,110871928,chr10-110843268-A-G,rs9633680,1,A,G,110843268,28660,110675320,111068536,167948
10,ENSG00000156521.9,70146700,chr10-70156705-G-A,rs9971029,-1,G,A,70156705,10005,69950092,70343308,206613
10,ENSG00000107874.5,102432574,chr10-102424324-G-A,rs1044476,-1,G,A,102424324,8250,102235966,102629182,188358
10,ENSG00000128805.9,48605073,chr10-48574372-T-C,rs10491040,-1,T,C,48574372,30701,48408465,48801681,165907
10,ENSG00000067064.6,1049119,chr10-1038420-T-C,rs10508204,-1,T,C,1038420,10699,852511,1245727,185909
10,ENSG00000077327.9,22345496,chr10-22473957-T-C,rs10508647,1,T,C,22473957,128461,22148888,22542104,325069
10,ENSG00000107796.7,88952773,chr10-88992155-T-A,rs10509561,-1,T,A,88992155,39382,88756165,89149381,235990
10,ENSG00000152778.7,89414568,chr10-89315502-A-G,rs10749605,1,A,G,89315502,99066,89217960,89611176,97542
10,ENSG00000187783.7,44911337,chr10-44902738-C-A,rs10751361,1,C,A,44902738,8599,44714729,45107945,188009
10,ENSG00000099284.7,70052846,chr10-70104154-C-T,rs10762338,1,C,T,70104154,51308,69856238,70249454,247916
10,ENSG00000237489.2,130110830,chr10-130191312-C-T,rs10764938,-1,C,T,130191312,80482,129914222,130307438,277090
10,ENSG00000108010.7,130136391,chr10-130192875-C-A,rs10764939,1,C,A,130192875,56484,129939783,130332999,253092
10,ENSG00000198682.7,87659878,chr10-87663488-A-G,rs10788561,1,A,G,87663488,3610,87463270,87856486,200218
10,ENSG00000047056.10,1056385,chr10-1110225-T-C,rs10794720,1,T,C,1110225,53840,859777,1252993,250448
10,ENSG00000122862.4,69088103,chr10-69085335-T-C,rs10823297,1,T,C,69085335,2768,68891495,69284711,193840
10,ENSG00000122862.4,69088103,chr10-69085335-T-G,rs10823297,1,T,G,69085335,2768,68891495,69284711,193840
10,ENSG00000177283.4,35642296,chr10-35787846-C-T,rs10827540,-1,C,T,35787846,145550,35445688,35838904,342158
10,ENSG00000165997.4,18659431,chr10-18549925-A-G,rs10828896,1,A,G,18549925,109506,18462823,18856039,87102
10,ENSG00000171314.6,97426191,chr10-97483569-C-T,rs10882942,1,C,T,97483569,57378,97229583,97622799,253986
10,ENSG00000095485.11,100267638,chr10-100081396-A-G,rs10883439,-1,A,G,100081396,186242,100071030,100464246,10366
10,ENSG00000203867.6,110644336,chr10-110828597-G-A,rs10885054,1,G,A,110828597,184261,110447728,110840944,380869
10,ENSG00000196793.8,43574616,chr10-43609596-G-A,rs10899836,-1,G,A,43609596,34980,43378008,43771224,231588
10,ENSG00000123243.10,7666966,chr10-7667946-T-C,rs10905208,-1,T,C,7667946,980,7470358,7863574,197588
10,ENSG00000108091.10,59906556,chr10-59772198-T-G,rs10994001,-1,T,G,59772198,134358,59709948,60103164,62250
10,ENSG00000072422.11,60944185,chr10-60866719-T-C,rs10994551,-1,T,C,60866719,77466,60747577,61140793,119142
10,ENSG00000182010.6,62268844,chr10-62206628-A-G,rs10995086,-1,A,G,62206628,62216,62072236,62465452,134392
10,ENSG00000151151.5,58267894,chr10-58228315-T-C,rs11006086,-1,T,C,58228315,39579,58071286,58464502,157029
10,ENSG00000148498.11,34815296,chr10-34727647-T-C,rs11009892,-1,T,C,34727647,87649,34618688,35011904,108959
10,ENSG00000077420.9,26438341,chr10-26461103-C-T,rs11015121,1,C,T,26461103,22762,26241733,26634949,219370
10,ENSG00000136754.12,26860958,chr10-26756603-A-C,rs11015266,-1,A,C,26756603,104355,26664350,27057566,92253
10,ENSG00000171811.7,132942570,chr10-132910734-G-A,rs11146587,-1,G,A,132910734,31836,132745962,133139178,164772
10,ENSG00000095464.8,93612537,chr10-93493473-G-T,rs11187464,1,G,T,93493473,119064,93415929,93809145,77544
10,ENSG00000148690.9,93702592,chr10-93707274-A-C,rs11187609,-1,A,C,93707274,4682,93505984,93899200,201290
10,ENSG00000138111.7,102461395,chr10-102461782-A-G,rs11191293,1,A,G,102461782,387,102264787,102658003,196995
10,ENSG00000148600.10,84194537,chr10-84179275-G-A,rs11200905,1,G,A,84179275,15262,83997929,84391145,181346
10,ENSG00000169813.11,43409186,chr10-43475993-A-G,rs11238553,-1,A,G,43475993,66807,43212578,43605794,263415
10,ENSG00000173848.13,5412557,chr10-5488422-T-C,rs11253202,1,T,C,5488422,75865,5215949,5609165,272473
10,ENSG00000183049.8,12349547,chr10-12398210-T-C,rs11592475,1,T,C,12398210,48663,12152939,12546155,245271
10,ENSG00000138119.11,93482334,chr10-93314655-A-G,rs11596560,-1,A,G,93314655,167679,93285726,93678942,28929
10,ENSG00000128815.11,48684873,chr10-48687602-T-G,rs116977127,1,T,G,48687602,2729,48488265,48881481,199337
10,ENSG00000165443.7,59176643,chr10-59313854-A-G,rs11812286,1,A,G,59313854,137211,58980035,59373251,333819
10,ENSG00000198105.7,37857610,chr10-37742055-G-A,rs11815066,-1,G,A,37742055,115555,37661002,38054218,81053
10,ENSG00000148719.9,72354919,chr10-72352428-A-G,rs12098649,-1,A,G,72352428,2491,72158311,72551527,194117
10,ENSG00000152463.10,15043943,chr10-14980404-C-T,rs12219384,1,C,T,14980404,63539,14847335,15240551,133069
10,ENSG00000148541.8,59362549,chr10-59343872-A-G,rs12240944,-1,A,G,59343872,18677,59165941,59559157,177931
10,ENSG00000165338.10,91410344,chr10-91481688-C-T,rs12242663,1,C,T,91481688,71344,91213736,91606952,267952
10,ENSG00000177613.7,51699595,chr10-51705477-T-C,rs12246619,-1,T,C,51705477,5882,51502987,51896203,202490
10,ENSG00000108061.7,110919604,chr10-111098247-C-T,rs12247360,1,C,T,111098247,178643,110722996,111116212,375251
10,ENSG00000184923.6,87225448,chr10-87404437-A-G,rs12251529,1,A,G,87404437,178989,87028840,87422056,375597
10,ENSG00000198246.7,71319259,chr10-71334440-G-A,rs12252139,1,G,A,71334440,15181,71122651,71515867,211789
10,ENSG00000107447.4,96304434,chr10-96306529-C-A,rs12260997,1,C,A,96306529,2095,96107826,96501042,198703
10,ENSG00000166321.9,73110455,chr10-73139982-C-T,rs12268142,1,C,T,73139982,29527,72913847,73307063,226135
10,ENSG00000151532.9,112447215,chr10-112481811-G-A,rs12269496,1,G,A,112481811,34596,112250607,112643823,231204
10,ENSG00000108021.13,5684838,chr10-5514708-T-A,rs12359191,1,T,A,5514708,170130,5488230,5881446,26478
10,ENSG00000214413.2,110919180,chr10-110817963-A-G,rs12413827,-1,A,G,110817963,101217,110722572,111115788,95391
10,ENSG00000165629.14,7788177,chr10-7812478-A-C,rs1244447,1,A,C,7812478,24301,7591569,7984785,220909
10,ENSG00000165879.7,97319271,chr10-97209311-G-A,rs1253407,1,G,A,97209311,109960,97122663,97515879,86648
10,ENSG00000134452.12,5890243,chr10-6035857-G-A,rs12722525,1,G,A,6035857,145614,5693635,6086851,342222
10,ENSG00000138182.9,89701590,chr10-89568475-C-T,rs1274046,1,C,T,89568475,133115,89504982,89898198,63493
10,ENSG00000165476.6,63521401,chr10-63605976-G-C,rs12779973,1,G,C,63605976,84575,63324793,63718009,281183
10,ENSG00000198018.6,99659509,chr10-99618763-A-C,rs1332104,1,A,C,99618763,40746,99462901,99856117,155862
10,ENSG00000107551.13,44959802,chr10-44872584-G-C,rs1408816,1,G,C,44872584,87218,44763194,45156410,109390
10,ENSG00000150054.12,28303064,chr10-28203719-C-T,rs1457177,-1,C,T,28203719,99345,28106456,28499672,97263
10,ENSG00000181915.3,62804720,chr10-62845974-G-A,rs1475084,1,G,A,62845974,41254,62608112,63001328,237862
10,ENSG00000256574.2,45315608,chr10-45433374-C-T,rs1487562,-1,C,T,45433374,117766,45119000,45512216,314374
10,ENSG00000122863.5,71964395,chr10-72063261-A-G,rs1668172,1,A,G,72063261,98866,71767787,72161003,295474
10,ENSG00000096717.7,67884656,chr10-67793736-T-C,rs16924881,1,T,C,67793736,90920,67688048,68081264,105688
10,ENSG00000107758.9,73496024,chr10-73407888-C-T,rs16930573,-1,C,T,73407888,88136,73299416,73692632,108472
10,ENSG00000107758.9,73496024,chr10-73407888-C-A,rs16930573,-1,C,A,73407888,88136,73299416,73692632,108472
10,ENSG00000107521.13,98446935,chr10-98382397-G-A,rs17109597,-1,G,A,98382397,64538,98250327,98643543,132070
10,ENSG00000014919.7,99732127,chr10-99754462-G-A,rs17112219,-1,G,A,99754462,22335,99535519,99928735,218943
10,ENSG00000107957.10,103855576,chr10-104032771-G-A,rs17116338,-1,G,A,104032771,177195,103658968,104052184,373803
10,ENSG00000165985.7,16521879,chr10-16607791-G-A,rs17138855,-1,G,A,16607791,85912,16325271,16718487,282520
10,ENSG00000185267.5,14838037,chr10-14849407-G-A,rs17155992,-1,G,A,14849407,11370,14641429,15034645,207978
10,ENSG00000165733.6,42782795,chr10-42785382-A-G,rs17158174,1,A,G,42785382,2587,42586187,42979403,199195
10,ENSG00000165983.9,16437010,chr10-16441792-A-G,rs17320049,1,A,G,16441792,4782,16240402,16633618,201390
10,ENSG00000095739.6,28677521,chr10-28813069-T-A,rs1761994,1,T,A,28813069,135548,28480913,28874129,332156
10,ENSG00000148484.12,16817424,chr10-16832566-T-C,rs1797081,-1,T,C,16832566,15142,16620816,17014032,211750
10,ENSG00000165731.11,43077069,chr10-43110412-T-A,rs1864402,1,T,A,43110412,33343,42880461,43273677,229951
10,ENSG00000165731.11,43077069,chr10-43110412-T-G,rs1864402,1,T,G,43110412,33343,42880461,43273677,229951
10,ENSG00000099282.4,69451465,chr10-69495991-T-C,rs1864589,1,T,C,69495991,44526,69254857,69648073,241134
10,ENSG00000119906.6,100912963,chr10-100887424-A-G,rs1886276,1,A,G,100887424,25539,100716355,101109571,171069
10,ENSG00000119950.14,110207605,chr10-110207086-C-T,rs1891374,1,C,T,110207086,519,110010997,110404213,196089
10,ENSG00000107719.7,70478767,chr10-70493140-A-G,rs1904593,1,A,G,70493140,14373,70282159,70675375,210981
10,ENSG00000198924.3,113854082,chr10-113664721-C-A,rs1936184,-1,C,A,113664721,189361,113657474,114050690,7247
10,ENSG00000204161.7,49188391,chr10-49184968-C-T,rs1962336,-1,C,T,49184968,3423,48991783,49384999,193185
10,ENSG00000148908.10,119542719,chr10-119647063-T-C,rs196289,-1,T,C,119647063,104344,119346111,119739327,300952
10,ENSG00000107954.6,103493705,chr10-103536631-A-G,rs2208322,1,A,G,103536631,42926,103297097,103690313,239534
10,ENSG00000214655.5,73785606,chr10-73909432-G-T,rs2227551,1,G,T,73909432,123826,73588998,73982214,320434
10,ENSG00000214655.5,73785606,chr10-73909432-G-C,rs2227551,1,G,C,73909432,123826,73588998,73982214,320434
10,ENSG00000107679.9,122374708,chr10-122464428-C-T,rs2248799,1,C,T,122464428,89720,122178100,122571316,286328
10,ENSG00000165507.7,44978809,chr10-44978892-G-C,rs2274888,-1,G,C,44978892,83,44782201,45175417,196691
10,ENSG00000165507.7,44978809,chr10-44978892-G-T,rs2274888,-1,G,T,44978892,83,44782201,45175417,196691
10,ENSG00000059573.4,95656711,chr10-95637470-T-C,rs2275273,-1,T,C,95637470,19241,95460103,95853319,177367
10,ENSG00000107611.9,17129811,chr10-17201797-A-G,rs2281647,-1,A,G,17201797,71986,16933203,17326419,268594
10,ENSG00000185532.8,51074487,chr10-51011383-T-C,rs2339684,1,T,C,51011383,63104,50877879,51271095,133504
10,ENSG00000188690.7,125823258,chr10-125860349-A-C,rs2366049,-1,A,C,125860349,37091,125626650,126019866,233699
10,ENSG00000075073.10,69416918,chr10-69286021-A-G,rs2394540,-1,A,G,69286021,130897,69220310,69613526,65711
10,ENSG00000107897.13,27240797,chr10-27237602-G-T,rs2483489,-1,G,T,27237602,3195,27044189,27437405,193413
10,ENSG00000189129.8,80132730,chr10-80215057-A-G,rs2493948,1,A,G,80215057,82327,79936122,80329338,278935
10,ENSG00000138347.10,68109488,chr10-68155278-A-G,rs2673797,1,A,G,68155278,45790,67912880,68306096,242398
10,ENSG00000196968.4,73772276,chr10-73903978-A-G,rs2688607,1,A,G,73903978,131702,73575668,73968884,328310
10,ENSG00000188385.7,132065946,chr10-132145902-G-A,rs2814175,1,G,A,132145902,79956,131869338,132262554,276564
10,ENSG00000151640.7,132186948,chr10-132222549-G-A,rs2814197,1,G,A,132222549,35601,131990340,132383556,232209
10,ENSG00000122359.11,80205537,chr10-80130414-A-G,rs2819889,-1,A,G,80130414,75123,80008929,80402145,121485
10,ENSG00000183621.9,31031937,chr10-30993493-A-G,rs2887738,-1,A,G,30993493,38444,30835329,31228545,158164
10,ENSG00000150867.7,22714578,chr10-22602036-C-T,rs2913109,-1,C,T,22602036,112542,22517970,22911186,84066
10,ENSG00000148835.9,103367976,chr10-103472823-G-A,rs2986034,1,G,A,103472823,104847,103171368,103564584,301455
10,ENSG00000107890.12,27100494,chr10-27222523-T-C,rs2995499,-1,T,C,27222523,122029,26903886,27297102,318637
10,ENSG00000183128.7,103479240,chr10-103486526-A-G,rs3014187,-1,A,G,103486526,7286,103282632,103675848,203894
10,ENSG00000148735.10,113751310,chr10-113645905-C-T,rs3121478,1,C,T,113645905,105405,113554702,113947918,91203
10,ENSG00000119977.13,95693927,chr10-95754860-G-A,rs3176893,-1,G,A,95754860,60933,95497319,95890535,257541
10,ENSG00000171813.10,132397200,chr10-132511506-A-G,rs34140003,1,A,G,132511506,114306,132200592,132593808,310914
10,ENSG00000148832.9,133379262,chr10-133318548-A-C,rs34466598,1,A,C,133318548,60714,133182654,133575870,135894
10,ENSG00000186862.11,101031129,chr10-100859326-C-A,rs35355083,-1,C,A,100859326,171803,100834521,101227737,24805
10,ENSG00000186862.11,101031129,chr10-100859326-C-T,rs35355083,-1,C,T,100859326,171803,100834521,101227737,24805
10,ENSG00000134470.12,5977543,chr10-5977007-A-G,rs36055263,-1,A,G,5977007,536,5780935,6174151,196072
10,ENSG00000165646.7,117241114,chr10-117270233-G-A,rs363272,1,G,A,117270233,29119,117044506,117437722,225727
10,ENSG00000165646.7,117241114,chr10-117270233-G-T,rs363272,1,G,T,117270233,29119,117044506,117437722,225727
10,ENSG00000119946.8,99329356,chr10-99357800-G-A,rs3750895,1,G,A,99357800,28444,99132748,99525964,225052
10,ENSG00000176244.6,15088776,chr10-15044307-C-A,rs3763787,-1,C,A,15044307,44469,14892168,15285384,152139
10,ENSG00000152464.8,15097355,chr10-15254708-A-C,rs3780930,1,A,C,15254708,157353,14900747,15293963,353961
10,ENSG00000122912.9,68527523,chr10-68345421-C-T,rs3781567,-1,C,T,68345421,182102,68330915,68724131,14506
10,ENSG00000156574.5,70441681,chr10-70255817-T-G,rs3812694,-1,T,G,70255817,185864,70245073,70638289,10744
10,ENSG00000107566.8,100186029,chr10-100289928-A-G,rs3894173,-1,A,G,100289928,103899,99989421,100382637,300507
10,ENSG00000138185.11,95756163,chr10-95606063-G-A,rs4037,1,G,A,95606063,150100,95559555,95952771,46508
10,ENSG00000204147.5,50739936,chr10-50813938-G-A,rs41274048,1,G,A,50813938,74002,50543328,50936544,270610
10,ENSG00000148824.12,133394157,chr10-133402574-C-G,rs41283343,1,C,G,133402574,8417,133197549,133590765,205025
10,ENSG00000197746.7,71851251,chr10-72013241-G-A,rs4148953,-1,G,A,72013241,161990,71654643,72047859,358598
10,ENSG00000172731.9,70382625,chr10-70368986-C-T,rs4314981,-1,C,T,70368986,13639,70186017,70579233,182969
10,ENSG00000172538.6,49134021,chr10-49135640-G-C,rs4338455,-1,G,C,49135640,1619,48937413,49330629,198227
10,ENSG00000065154.7,124418923,chr10-124484912-T-C,rs4427525,-1,T,C,124484912,65989,124222315,124615531,262597
10,ENSG00000198954.4,68988803,chr10-68892516-G-A,rs4472827,1,G,A,68892516,96287,68792195,69185411,100321
10,ENSG00000165630.8,13586965,chr10-13484000-T-C,rs4748040,1,T,C,13484000,102965,13390357,13783573,93643
10,ENSG00000168283.7,22321099,chr10-22133703-T-C,rs4748785,1,T,C,22133703,187396,22124491,22517707,9212
10,ENSG00000123240.10,13100163,chr10-13231577-G-A,rs4750326,1,G,A,13231577,131414,12903555,13296771,328022
10,ENSG00000213341.4,100229596,chr10-100113011-A-G,rs4919425,-1,A,G,100113011,116585,100032988,100426204,80023
10,ENSG00000165512.4,45000923,chr10-45061204-T-C,rs4948942,1,T,C,45061204,60281,44804315,45197531,256889
10,ENSG00000119965.8,122954227,chr10-122992612-C-T,rs4980172,-1,C,T,122992612,38385,122757619,123150835,234993
10,ENSG00000148444.9,22316388,chr10-22230027-A-G,rs56186224,1,A,G,22230027,86361,22119780,22512996,110247
10,ENSG00000151632.11,5003857,chr10-4812307-T-C,rs57563616,-1,T,C,4812307,191550,4807249,5200465,5058
10,ENSG00000173267.9,86958599,chr10-86851786-G-A,rs58256798,1,G,A,86851786,106813,86761991,87155207,89795
10,ENSG00000048740.10,11017872,chr10-11176152-C-T,rs596417,1,C,T,11176152,158280,10821264,11214480,354888
10,ENSG00000148426.6,11823356,chr10-11819951-T-C,rs61846275,1,T,C,11819951,3405,11626748,12019964,193203
10,ENSG00000122852.9,79610939,chr10-79459754-C-T,rs61862467,1,C,T,79459754,151185,79414331,79807547,45423
10,ENSG00000138190.12,92848520,chr10-92907226-T-G,rs6583847,1,T,G,92907226,58706,92651912,93045128,255314
10,ENSG00000138180.10,93496612,chr10-93650241-A-G,rs6583901,1,A,G,93650241,153629,93300004,93693220,350237
10,ENSG00000150593.11,110871928,chr10-111005922-G-A,rs6585028,1,G,A,111005922,133994,110675320,111068536,330602
10,ENSG00000107798.11,89251775,chr10-89234218-T-C,rs6586178,-1,T,C,89234218,17557,89055167,89448383,179051
10,ENSG00000148634.10,68075283,chr10-67969257-T-A,rs669794,-1,T,A,67969257,106026,67878675,68271891,90582
10,ENSG00000095564.8,91923770,chr10-92111309-G-A,rs701846,1,G,A,92111309,187539,91727162,92120378,384147
10,ENSG00000148429.7,11611650,chr10-11452667-C-A,rs7070337,-1,C,A,11452667,158983,11415042,11808258,37625
10,ENSG00000107882.7,102503972,chr10-102517366-A-T,rs7070591,1,A,T,102517366,13394,102307364,102700580,210002
10,ENSG00000107882.7,102503972,chr10-102517366-A-C,rs7070591,1,A,C,102517366,13394,102307364,102700580,210002
10,ENSG00000175029.11,125028071,chr10-124982872-T-C,rs7071558,-1,T,C,124982872,45199,124831463,125224679,151409
10,ENSG00000151474.13,14330924,chr10-14336353-C-G,rs7072333,-1,C,G,14336353,5429,14134316,14527532,202037
10,ENSG00000120549.10,24209138,chr10-24344856-T-C,rs7072844,1,T,C,24344856,135718,24012530,24405746,332326
10,ENSG00000227345.3,49942027,chr10-49914320-C-T,rs7075365,-1,C,T,49914320,27707,49745419,50138635,168901
10,ENSG00000065809.8,14774897,chr10-14681427-C-G,rs7079214,-1,C,G,14681427,93470,14578289,14971505,103138
10,ENSG00000165633.6,49115522,chr10-49100142-C-T,rs7079570,-1,C,T,49100142,15380,48918914,49312130,181228
10,ENSG00000165832.4,114938195,chr10-115016126-G-T,rs7090904,1,G,T,115016126,77931,114741587,115134803,274539
10,ENSG00000197444.5,49762323,chr10-49777199-G-T,rs7091448,-1,G,T,49777199,14876,49565715,49958931,211484
10,ENSG00000165996.8,17617374,chr10-17628033-A-C,rs7094334,-1,A,C,17628033,10659,17420766,17813982,207267
10,ENSG00000068383.12,132537787,chr10-132481636-A-G,rs7096228,1,A,G,132481636,56151,132341179,132734395,140457
10,ENSG00000099290.10,50067954,chr10-50058725-C-T,rs7097161,1,C,T,50058725,9229,49871346,50264562,187379
10,ENSG00000174721.9,91909486,chr10-91904887-T-C,rs7099658,-1,T,C,91904887,4599,91712878,92106094,192009
10,ENSG00000148450.8,23095579,chr10-23080492-C-T,rs722258,1,C,T,23080492,15087,22898971,23292187,181521
10,ENSG00000198879.6,7411034,chr10-7359472-C-T,rs72775555,-1,C,T,7359472,51562,7214426,7607642,145046
10,ENSG00000185875.8,25016612,chr10-25144865-T-C,rs72792064,1,T,C,25144865,128253,24820004,25213220,324861
10,ENSG00000043591.4,114043866,chr10-114035957-C-A,rs72823019,1,C,A,114035957,7909,113847258,114240474,188699
10,ENSG00000062650.11,86521792,chr10-86691113-C-T,rs72848117,-1,C,T,86691113,169321,86325184,86718400,365929
10,ENSG00000214562.5,87357744,chr10-87407171-C-G,rs74150460,1,C,G,87407171,49427,87161136,87554352,246035
10,ENSG00000214562.5,87357744,chr10-87407171-C-T,rs74150460,1,C,T,87407171,49427,87161136,87554352,246035
10,ENSG00000198825.7,119726050,chr10-119635426-A-G,rs74157688,1,A,G,119635426,90624,119529442,119922658,105984
10,ENSG00000138346.9,68471973,chr10-68472384-T-C,rs7478105,-1,T,C,68472384,411,68275365,68668581,197019
10,ENSG00000156398.6,102714636,chr10-102604466-A-G,rs74854733,1,A,G,102604466,110170,102518028,102911244,86438
10,ENSG00000180817.6,70233429,chr10-70131796-T-C,rs76251505,-1,T,C,70131796,101633,70036821,70430037,94975
10,ENSG00000122884.7,73096866,chr10-73182735-C-T,rs76660256,-1,C,T,73182735,85869,72900258,73293474,282477
10,ENSG00000203805.6,120457227,chr10-120292393-G-A,rs77437002,1,G,A,120292393,164834,120260619,120653835,31774
10,ENSG00000060339.8,68721239,chr10-68782821-T-C,rs78811806,1,T,C,68782821,61582,68524631,68917847,258190
10,ENSG00000214688.3,71719778,chr10-71728190-C-A,rs78865428,-1,C,A,71728190,8412,71523170,71916386,205020
10,ENSG00000214688.3,71719778,chr10-71728190-C-G,rs78865428,-1,C,G,71728190,8412,71523170,71916386,205020
10,ENSG00000120594.9,19816432,chr10-19947342-G-A,rs7898627,1,G,A,19947342,130910,19619824,20013040,327518
10,ENSG00000148459.10,26697701,chr10-26619546-T-G,rs7911815,1,T,G,26619546,78155,26501093,26894309,118453
10,ENSG00000107816.11,100999476,chr10-100845220-C-T,rs7911849,1,C,T,100845220,154256,100802868,101196084,42352
10,ENSG00000107816.11,100999476,chr10-100845220-C-A,rs7911849,1,C,A,100845220,154256,100802868,101196084,42352
10,ENSG00000156374.8,103351140,chr10-103241568-G-A,rs7913461,-1,G,A,103241568,109572,103154532,103547748,87036
10,ENSG00000107854.5,91798426,chr10-91691238-C-T,rs7917457,1,C,T,91691238,107188,91601818,91995034,89420
10,ENSG00000119922.7,89302046,chr10-89302352-C-T,rs7922613,1,C,T,89302352,306,89105438,89498654,196914
10,ENSG00000134463.10,11742382,chr10-11728172-G-T,rs7923065,1,G,T,11728172,14210,11545774,11938990,182398
10,ENSG00000138175.7,102714397,chr10-102658899-C-T,rs7923415,-1,C,T,102658899,55498,102517789,102911005,141110
10,ENSG00000138175.7,102714397,chr10-102658899-C-G,rs7923415,-1,C,G,102658899,55498,102517789,102911005,141110
10,ENSG00000107819.8,101031234,chr10-101032538-G-A,rs807014,1,G,A,101032538,1304,100834626,101227842,197912
10,ENSG00000107537.9,13300064,chr10-13271567-T-C,rs825631,-1,T,C,13271567,28497,13103456,13496672,168111
10,ENSG00000134460.9,6062367,chr10-6116449-A-G,rs8463,-1,A,G,6116449,54082,5865759,6258975,250690
10,ENSG00000023041.7,112446914,chr10-112428029-T-C,rs8624,-1,T,C,112428029,18885,112250306,112643522,177723
10,ENSG00000107902.9,124461823,chr10-124456396-G-T,rs908365,1,G,T,124456396,5427,124265215,124658431,191181
10,ENSG00000155254.7,97713730,chr10-97611972-A-C,rs933057,1,A,C,97611972,101758,97517122,97910338,94850
10,ENSG00000107738.12,71773520,chr10-71762937-T-C,rs9415039,-1,T,C,71762937,10583,71576912,71970128,186025
10,ENSG00000179988.8,122980401,chr10-122956576-G-A,rs9423292,1,G,A,122956576,23825,122783793,123177009,172783
10,ENSG00000108219.8,80454166,chr10-80505057-A-G,rs9633739,1,A,G,80505057,50891,80257558,80650774,247499
10,ENSG00000151224.7,80289658,chr10-80445650-A-G,rs9663342,-1,A,G,80445650,155992,80093050,80486266,352600
10,ENSG00000122378.9,80408551,chr10-80409842-C-G,rs9787439,1,C,G,80409842,1291,80211943,80605159,197899
10,ENSG00000089876.7,125881292,chr10-125722177-T-C,rs9804356,-1,T,C,125722177,159115,125684684,126077900,37493
10,ENSG00000175470.14,131901008,chr10-131935362-G-C,rs10430615,1,G,C,131935362,34354,131704400,132097616,230962
10,ENSG00000107719.7,70478767,chr10-70493338-T-C,rs10740351,1,T,C,70493338,14571,70282159,70675375,211179
10,ENSG00000196793.8,43574616,chr10-43592223-T-C,rs10793446,-1,T,C,43592223,17607,43378008,43771224,214215
10,ENSG00000067064.6,1049119,chr10-1169472-C-G,rs10794728,-1,C,G,1169472,120353,852511,1245727,316961
10,ENSG00000204147.5,50739936,chr10-50856463-C-T,rs10821887,1,C,T,50856463,116527,50543328,50936544,313135
10,ENSG00000165449.7,59709850,chr10-59673534-T-G,rs10826342,-1,T,G,59673534,36316,59513242,59906458,160292
10,ENSG00000214413.2,110919180,chr10-110738572-C-T,rs10885031,-1,C,T,110738572,180608,110722572,111115788,16000
10,ENSG00000198298.8,43606438,chr10-43616358-G-A,rs10899839,1,G,A,43616358,9920,43409830,43803046,206528
10,ENSG00000107949.11,125823546,chr10-125756081-C-T,rs10901423,1,C,T,125756081,67465,125626938,126020154,129143
10,ENSG00000138161.8,122845857,chr10-122721527-T-C,rs10902851,-1,T,C,122721527,124330,122649249,123042465,72278
10,ENSG00000148377.5,1025859,chr10-941673-G-T,rs10904587,-1,G,T,941673,84186,829251,1222467,112422
10,ENSG00000148484.12,16817424,chr10-16786241-C-T,rs10904808,-1,C,T,16786241,31183,16620816,17014032,165425
10,ENSG00000197889.4,14959388,chr10-14840341-A-T,rs10906772,1,A,T,14840341,119047,14762780,15155996,77561
10,ENSG00000185267.5,14838037,chr10-14920865-A-G,rs10906777,-1,A,G,14920865,82828,14641429,15034645,279436
10,ENSG00000099282.4,69451465,chr10-69388403-C-T,rs10998754,1,C,T,69388403,63062,69254857,69648073,133546
10,ENSG00000042286.9,70132825,chr10-70027397-A-G,rs10999089,-1,A,G,70027397,105428,69936217,70329433,91180
10,ENSG00000150275.12,54801231,chr10-54765335-A-C,rs11004557,-1,A,C,54765335,35896,54604623,54997839,160712
10,ENSG00000152464.8,15097355,chr10-14936975-A-G,rs111386791,1,A,G,14936975,160380,14900747,15293963,36228
10,ENSG00000180628.10,91220663,chr10-91236610-G-A,rs11186514,1,G,A,91236610,15947,91024055,91417271,212555
10,ENSG00000095637.13,95561371,chr10-95366117-C-A,rs11188295,-1,C,A,95366117,195254,95364763,95757979,1354
10,ENSG00000196233.6,96832298,chr10-96870959-C-T,rs11188957,1,C,T,96870959,38661,96635690,97028906,235269
10,ENSG00000185933.6,103458900,chr10-103628528-C-T,rs11191750,-1,C,T,103628528,169628,103262292,103655508,366236
10,ENSG00000012779.5,45374216,chr10-45224058-G-A,rs11239392,1,G,A,45224058,150158,45177608,45570824,46450
10,ENSG00000107902.9,124461823,chr10-124474595-C-T,rs11245086,1,C,T,124474595,12772,124265215,124658431,209380
10,ENSG00000108021.13,5684838,chr10-5528010-C-T,rs11253217,1,C,T,5528010,156828,5488230,5881446,39780
10,ENSG00000107485.10,8054688,chr10-8075089-C-G,rs11255509,1,C,G,8075089,20401,7858080,8251296,217009
10,ENSG00000107485.10,8054688,chr10-8075089-C-T,rs11255509,1,C,T,8075089,20401,7858080,8251296,217009
10,ENSG00000148429.7,11611650,chr10-11693560-C-T,rs11257255,-1,C,T,11693560,81910,11415042,11808258,278518
10,ENSG00000151461.13,12042809,chr10-12169971-T-G,rs11257576,-1,T,G,12169971,127162,11846201,12239417,323770
10,ENSG00000183049.8,12349547,chr10-12433838-T-G,rs1125791,1,T,G,12433838,84291,12152939,12546155,280899
10,ENSG00000148468.11,15371289,chr10-15340470-A-G,rs11259612,-1,A,G,15340470,30819,15174681,15567897,165789
10,ENSG00000130640.8,133308872,chr10-133431074-C-T,rs114627280,-1,C,T,133431074,122202,133112264,133505480,318810
10,ENSG00000156113.13,77637808,chr10-77633696-G-A,rs11598241,-1,G,A,77633696,4112,77441200,77834416,192496
10,ENSG00000089876.7,125881292,chr10-125957214-G-C,rs11599031,-1,G,C,125957214,75922,125684684,126077900,272530
10,ENSG00000096746.12,68332064,chr10-68345042-A-G,rs1177364,1,A,G,68345042,12978,68135456,68528672,209586
10,ENSG00000177283.4,35642296,chr10-35626672-G-A,rs11812944,-1,G,A,35626672,15624,35445688,35838904,180984
10,ENSG00000077420.9,26438341,chr10-26355157-G-A,rs11815009,1,G,A,26355157,83184,26241733,26634949,113424
10,ENSG00000107968.4,30434184,chr10-30512627-G-A,rs11816641,1,G,A,30512627,78443,30237576,30630792,275051
10,ENSG00000170525.12,6202932,chr10-6179333-C-T,rs12217915,1,C,T,6179333,23599,6006324,6399540,173009
10,ENSG00000095485.11,100267638,chr10-100140433-T-C,rs12218075,-1,T,C,100140433,127205,100071030,100464246,69403
10,ENSG00000107551.13,44959802,chr10-44916107-G-A,rs12246173,1,G,A,44916107,43695,44763194,45156410,152913
10,ENSG00000165476.6,63521401,chr10-63456484-C-A,rs12246496,1,C,A,63456484,64917,63324793,63718009,131691
10,ENSG00000204161.7,49188391,chr10-49210904-A-G,rs12249370,-1,A,G,49210904,22513,48991783,49384999,219121
10,ENSG00000148735.10,113751310,chr10-113731434-G-A,rs12249629,1,G,A,113731434,19876,113554702,113947918,176732
10,ENSG00000134460.9,6062367,chr10-6081532-C-T,rs12251307,-1,C,T,6081532,19165,5865759,6258975,215773
10,ENSG00000172538.6,49134021,chr10-49110439-G-A,rs12255055,-1,G,A,49110439,23582,48937413,49330629,173026
10,ENSG00000178217.8,80537902,chr10-80571475-T-C,rs12257493,1,T,C,80571475,33573,80341294,80734510,230181
10,ENSG00000067057.10,3067548,chr10-3117935-C-T,rs12257705,1,C,T,3117935,50387,2870940,3264156,246995
10,ENSG00000171811.7,132942570,chr10-133127635-G-A,rs12257731,-1,G,A,133127635,185065,132745962,133139178,381673
10,ENSG00000119950.14,110207605,chr10-110350072-A-G,rs1227985,1,A,G,110350072,142467,110010997,110404213,339075
10,ENSG00000204022.5,88586762,chr10-88678450-A-G,rs1228187,1,A,G,88678450,91688,88390154,88783370,288296
10,ENSG00000173267.9,86958599,chr10-86973435-C-T,rs1240375,1,C,T,86973435,14836,86761991,87155207,211444
10,ENSG00000181192.7,12068954,chr10-12123248-A-C,rs12570214,1,A,C,12123248,54294,11872346,12265562,250902
10,ENSG00000107537.9,13300064,chr10-13299185-C-T,rs12570229,-1,C,T,13299185,879,13103456,13496672,195729
10,ENSG00000180644.5,70602741,chr10-70473588-T-G,rs12572286,-1,T,G,70473588,129153,70406133,70799349,67455
10,ENSG00000138336.7,68560337,chr10-68620741-C-A,rs12764361,1,C,A,68620741,60404,68363729,68756945,257012
10,ENSG00000166275.10,102854259,chr10-102725544-G-A,rs12775883,1,G,A,102725544,128715,102657651,103050867,67893
10,ENSG00000151640.7,132186948,chr10-132142397-G-A,rs12778246,1,G,A,132142397,44551,131990340,132383556,152057
10,ENSG00000182010.6,62268844,chr10-62182200-A-G,rs12783236,-1,A,G,62182200,86644,62072236,62465452,109964
10,ENSG00000165983.9,16437010,chr10-16511719-G-T,rs1331255,1,G,T,16511719,74709,16240402,16633618,271317
10,ENSG00000185875.8,25016612,chr10-25034910-T-G,rs1546097,1,T,G,25034910,18298,24820004,25213220,214906
10,ENSG00000138303.11,72216276,chr10-72103623-C-T,rs1668166,-1,C,T,72103623,112653,72019668,72412884,83955
10,ENSG00000095739.6,28677521,chr10-28836990-G-A,rs1691907,1,G,A,28836990,159469,28480913,28874129,356077
10,ENSG00000197321.8,29634971,chr10-29592474-C-T,rs16930452,-1,C,T,29592474,42497,29438363,29831579,154111
10,ENSG00000197444.5,49762323,chr10-49830501-C-T,rs17010387,-1,C,T,49830501,68178,49565715,49958931,264786
10,ENSG00000165338.10,91410344,chr10-91514088-A-C,rs17093783,1,A,C,91514088,103744,91213736,91606952,300352
10,ENSG00000138134.7,88880245,chr10-88920467-G-C,rs17114161,1,G,C,88920467,40222,88683637,89076853,236830
10,ENSG00000203867.6,110644336,chr10-110733458-C-T,rs17127885,1,C,T,110733458,89122,110447728,110840944,285730
10,ENSG00000151532.9,112447215,chr10-112464880-C-T,rs17129806,1,C,T,112464880,17665,112250607,112643823,214273
10,ENSG00000165733.6,42782795,chr10-42800892-T-G,rs17158193,1,T,G,42800892,18097,42586187,42979403,214705
10,ENSG00000148516.15,31319216,chr10-31240211-C-T,rs17229928,1,C,T,31240211,79005,31122608,31515824,117603
10,ENSG00000095585.10,96271569,chr10-96090854-G-A,rs17384909,-1,G,A,96090854,180715,96074961,96468177,15893
10,ENSG00000165669.7,118342324,chr10-118458481-G-A,rs17575500,-1,G,A,118458481,116157,118145716,118538932,312765
10,ENSG00000165383.6,48914232,chr10-48806228-C-A,rs1871611,-1,C,A,48806228,108004,48717624,49110840,88604
10,ENSG00000107796.7,88952773,chr10-89028200-T-C,rs1926202,-1,T,C,89028200,75427,88756165,89149381,272035
10,ENSG00000119977.13,95693927,chr10-95872325-C-T,rs2051052,-1,C,T,95872325,178398,95497319,95890535,375006
10,ENSG00000170759.10,32056425,chr10-32047402-T-G,rs211289,-1,T,G,32047402,9023,31859817,32253033,187585
10,ENSG00000128805.9,48605073,chr10-48565250-C-T,rs2120905,-1,C,T,48565250,39823,48408465,48801681,156785
10,ENSG00000171314.6,97426191,chr10-97381448-A-G,rs2275089,1,A,G,97381448,44743,97229583,97622799,151865
10,ENSG00000148803.7,133358019,chr10-133328068-G-T,rs2298122,-1,G,T,133328068,29951,133161411,133554627,166657
10,ENSG00000166348.12,73591342,chr10-73627588-A-G,rs2395054,-1,A,G,73627588,36246,73394734,73787950,232854
10,ENSG00000198954.4,68988803,chr10-68999533-C-A,rs2487703,1,C,A,68999533,10730,68792195,69185411,207338
10,ENSG00000138347.10,68109488,chr10-68149756-C-T,rs2673801,1,C,T,68149756,40268,67912880,68306096,236876
10,ENSG00000155287.5,99620439,chr10-99798989-G-T,rs2756109,-1,G,T,99798989,178550,99423831,99817047,375158
10,ENSG00000165322.12,31928831,chr10-31764890-T-C,rs2778668,-1,T,C,31764890,163941,31732223,32125439,32667
10,ENSG00000122359.11,80205537,chr10-80126158-T-C,rs2784761,-1,T,C,80126158,79379,80008929,80402145,117229
10,ENSG00000148814.13,132332193,chr10-132258344-A-G,rs2814191,1,A,G,132258344,73849,132135585,132528801,122759
10,ENSG00000156510.9,69220332,chr10-69090203-G-A,rs2855022,1,G,A,69090203,130129,69023724,69416940,66479
10,ENSG00000107566.8,100186029,chr10-100038589-T-C,rs2862928,-1,T,C,100038589,147440,99989421,100382637,49168
10,ENSG00000138115.7,95069497,chr10-95238701-C-T,rs2901832,-1,C,T,95238701,169204,94872889,95266105,365812
10,ENSG00000148908.10,119542719,chr10-119545452-C-T,rs3009926,-1,C,T,119545452,2733,119346111,119739327,199341
10,ENSG00000026103.14,88990798,chr10-88809966-G-A,rs303526,1,G,A,88809966,180832,88794190,89187406,15776
10,ENSG00000134461.9,5889893,chr10-5966191-C-T,rs3181147,-1,C,T,5966191,76298,5693285,6086501,272906
10,ENSG00000166197.11,102152389,chr10-102082966-C-T,rs34848795,1,C,T,102082966,69423,101955781,102348997,127185
10,ENSG00000165650.7,117375440,chr10-117249657-A-C,rs363401,-1,A,C,117249657,125783,117178832,117572048,70825
10,ENSG00000166272.12,102743948,chr10-102776603-G-A,rs4147157,1,G,A,102776603,32655,102547340,102940556,229263
10,ENSG00000122863.5,71964395,chr10-71979503-C-T,rs4148927,1,C,T,71979503,15108,71767787,72161003,211716
10,ENSG00000138185.11,95756163,chr10-95862932-A-G,rs4244321,1,A,G,95862932,106769,95559555,95952771,303377
10,ENSG00000148842.10,102918294,chr10-102856906-T-C,rs4409766,1,T,C,102856906,61388,102721686,103114902,135220
10,ENSG00000241058.1,18651587,chr10-18500795-T-A,rs4485000,-1,T,A,18500795,150792,18454979,18848195,45816
10,ENSG00000241058.1,18651587,chr10-18500795-T-G,rs4485000,-1,T,G,18500795,150792,18454979,18848195,45816
10,ENSG00000035403.10,73998116,chr10-73972686-T-C,rs4746162,1,T,C,73972686,25430,73801508,74194724,171178
10,ENSG00000180817.6,70233429,chr10-70140433-G-T,rs4746969,-1,G,T,70140433,92996,70036821,70430037,103612
10,ENSG00000123240.10,13100163,chr10-12913138-G-A,rs4748012,1,G,A,12913138,187025,12903555,13296771,9583
10,ENSG00000165996.8,17617374,chr10-17496890-A-G,rs4748378,-1,A,G,17496890,120484,17420766,17813982,76124
10,ENSG00000052749.9,97401340,chr10-97344792-C-T,rs4919096,-1,C,T,97344792,56548,97204732,97597948,140060
10,ENSG00000078403.11,21534232,chr10-21493913-T-C,rs5011832,1,T,C,21493913,40319,21337624,21730840,156289
10,ENSG00000119906.6,100912963,chr10-100837035-C-A,rs56367693,1,C,A,100837035,75928,100716355,101109571,120680
10,ENSG00000107816.11,100999476,chr10-100837035-C-A,rs56367693,1,C,A,100837035,162441,100802868,101196084,34167
10,ENSG00000156384.10,104122171,chr10-104137527-G-A,rs56720966,1,G,A,104137527,15356,103925563,104318779,211964
10,ENSG00000196372.7,5666595,chr10-5596030-A-G,rs57954496,-1,A,G,5596030,70565,5469987,5863203,126043
10,ENSG00000148426.6,11823356,chr10-11825464-A-G,rs61846304,1,A,G,11825464,2108,11626748,12019964,198716
10,ENSG00000150593.11,110871928,chr10-110813098-A-G,rs61862917,1,A,G,110813098,58830,110675320,111068536,137778
10,ENSG00000150593.11,110871928,chr10-110813098-A-T,rs61862917,1,A,T,110813098,58830,110675320,111068536,137778
10,ENSG00000107938.12,125719709,chr10-125783708-A-G,rs61871474,1,A,G,125783708,63999,125523101,125916317,260607
10,ENSG00000108187.9,68332928,chr10-68175478-T-C,rs6480306,-1,T,C,68175478,157450,68136320,68529536,39158
10,ENSG00000067082.9,3785209,chr10-3875410-A-G,rs6601773,-1,A,G,3875410,90201,3588601,3981817,286809
10,ENSG00000169826.6,43138445,chr10-43250421-G-T,rs7067798,1,G,T,43250421,111976,42941837,43335053,308584
10,ENSG00000151151.5,58267894,chr10-58172841-T-C,rs7068355,-1,T,C,58172841,95053,58071286,58464502,101555
10,ENSG00000148835.9,103367976,chr10-103538013-C-G,rs7069733,1,C,G,103538013,170037,103171368,103564584,366645
10,ENSG00000165633.6,49115522,chr10-49111342-G-A,rs7072243,-1,G,A,49111342,4180,48918914,49312130,192428
10,ENSG00000181915.3,62804720,chr10-62667889-G-A,rs7075349,1,G,A,62667889,136831,62608112,63001328,59777
10,ENSG00000150054.12,28303064,chr10-28212416-T-C,rs7081651,-1,T,C,28212416,90648,28106456,28499672,105960
10,ENSG00000072422.11,60944185,chr10-60875947-C-A,rs7083122,-1,C,A,60875947,68238,60747577,61140793,128370
10,ENSG00000107864.8,92291078,chr10-92416331-T-C,rs7086285,-1,T,C,92416331,125253,92094470,92487686,321861
10,ENSG00000151893.9,118754970,chr10-118821681-G-A,rs7086399,-1,G,A,118821681,66711,118558362,118951578,263319
10,ENSG00000107731.8,71212570,chr10-71153967-A-T,rs7090571,1,A,T,71153967,58603,71015962,71409178,138005
10,ENSG00000148690.9,93702592,chr10-93724487-A-G,rs7094280,-1,A,G,93724487,21895,93505984,93899200,218503
10,ENSG00000107679.9,122374708,chr10-122345278-A-G,rs7095410,1,A,G,122345278,29430,122178100,122571316,167178
10,ENSG00000134463.10,11742382,chr10-11782851-C-A,rs7098491,1,C,A,11782851,40469,11545774,11938990,237077
10,ENSG00000134463.10,11742382,chr10-11782851-C-G,rs7098491,1,C,G,11782851,40469,11545774,11938990,237077
10,ENSG00000108219.8,80454166,chr10-80629770-G-A,rs7099231,1,G,A,80629770,175604,80257558,80650774,372212
10,ENSG00000108219.8,80454166,chr10-80629770-G-T,rs7099231,1,G,T,80629770,175604,80257558,80650774,372212
10,ENSG00000107954.6,103493705,chr10-103642807-C-T,rs7100298,1,C,T,103642807,149102,103297097,103690313,345710
10,ENSG00000120594.9,19816432,chr10-19978776-C-T,rs716829,1,C,T,19978776,162344,19619824,20013040,358952
10,ENSG00000078114.13,20897311,chr10-21025520-G-A,rs72790576,-1,G,A,21025520,128209,20700703,21093919,324817
10,ENSG00000166343.5,73433561,chr10-73483718-G-A,rs72814306,-1,G,A,73483718,50157,73236953,73630169,246765
10,ENSG00000127884.4,133373354,chr10-133283523-A-C,rs74164137,-1,A,C,133283523,89831,133176746,133569962,106777
10,ENSG00000165879.7,97319271,chr10-97190720-C-T,rs7474809,1,C,T,97190720,128551,97122663,97515879,68057
10,ENSG00000107854.5,91798426,chr10-91639373-C-T,rs7475251,1,C,T,91639373,159053,91601818,91995034,37555
10,ENSG00000148824.12,133394157,chr10-133512952-C-A,rs74753222,1,C,A,133512952,118795,133197549,133590765,315403
10,ENSG00000107560.6,118046941,chr10-117939764-C-T,rs75151512,-1,C,T,117939764,107177,117850333,118243549,89431
10,ENSG00000148840.6,102133040,chr10-102134852-G-T,rs75709864,1,G,T,102134852,1812,101936432,102329648,198420
10,ENSG00000156398.6,102714636,chr10-102655933-G-T,rs75950986,1,G,T,102655933,58703,102518028,102911244,137905
10,ENSG00000122952.11,56361259,chr10-56393630-G-C,rs76244763,-1,G,C,56393630,32371,56164651,56557867,228979
10,ENSG00000175395.10,37976647,chr10-37864155-C-G,rs77225320,-1,C,G,37864155,112492,37780039,38173255,84116
10,ENSG00000166321.9,73110455,chr10-73184164-T-G,rs77733274,1,T,G,73184164,73709,72913847,73307063,270317
10,ENSG00000198246.7,71319259,chr10-71372673-G-T,rs780698,1,G,T,71372673,53414,71122651,71515867,250022
10,ENSG00000095539.10,100972540,chr10-101055745-C-T,rs78643824,1,C,T,101055745,83205,100775932,101169148,279813
10,ENSG00000138180.10,93496612,chr10-93400164-C-A,rs78852093,1,C,A,93400164,96448,93300004,93693220,100160
10,ENSG00000155229.13,97498422,chr10-97588741-T-C,rs7897232,-1,T,C,97588741,90319,97301814,97695030,286927
10,ENSG00000107829.8,101695170,chr10-101551678-C-T,rs7897749,-1,C,T,101551678,143492,101498562,101891778,53116
10,ENSG00000151208.10,77926755,chr10-77777524-A-C,rs7903549,-1,A,C,77777524,149231,77730147,78123363,47377
10,ENSG00000014919.7,99732127,chr10-99575246-A-G,rs7906204,-1,A,G,99575246,156881,99535519,99928735,39727
10,ENSG00000204010.3,89378056,chr10-89218239-C-A,rs7908760,1,C,A,89218239,159817,89181448,89574664,36791
10,ENSG00000107438.4,95291003,chr10-95467182-T-C,rs7910365,-1,T,C,95467182,176179,95094395,95487611,372787
10,ENSG00000119927.9,112183765,chr10-112207892-A-G,rs7913485,-1,A,G,112207892,24127,111987157,112380373,220735
10,ENSG00000165507.7,44978809,chr10-45069842-T-C,rs7913550,-1,T,C,45069842,91033,44782201,45175417,287641
10,ENSG00000165985.7,16521879,chr10-16517382-C-T,rs7913889,-1,C,T,16517382,4497,16325271,16718487,192111
10,ENSG00000198546.9,133308914,chr10-133155163-T-C,rs7914516,1,T,C,133155163,153751,133112306,133505522,42857
10,ENSG00000043591.4,114043866,chr10-114025486-A-G,rs7915120,1,A,G,114025486,18380,113847258,114240474,178228
10,ENSG00000165730.10,68827531,chr10-68658106-C-T,rs7916778,1,C,T,68658106,169425,68630923,69024139,27183
10,ENSG00000119965.8,122954227,chr10-122821377-A-G,rs7917791,-1,A,G,122821377,132850,122757619,123150835,63758
10,ENSG00000107882.7,102503972,chr10-102658899-C-G,rs7923415,1,C,G,102658899,154927,102307364,102700580,351535
10,ENSG00000107882.7,102503972,chr10-102658899-C-T,rs7923415,1,C,T,102658899,154927,102307364,102700580,351535
10,ENSG00000165813.11,114174203,chr10-114214494-C-T,rs79605080,-1,C,T,114214494,40291,113977595,114370811,236899
10,ENSG00000148572.9,63133328,chr10-63263006-A-G,rs80151542,1,A,G,63263006,129678,62936720,63329936,326286
10,ENSG00000152804.6,92689955,chr10-92771843-C-T,rs9325463,1,C,T,92771843,81888,92493347,92886563,278496
10,ENSG00000107738.12,71773520,chr10-71764611-G-A,rs9415996,-1,G,A,71764611,8909,71576912,71970128,187699
10,ENSG00000119986.6,97687241,chr10-97516351-G-A,rs946987,-1,G,A,97516351,170890,97490633,97883849,25718
10,ENSG00000165731.11,43077069,chr10-42959891-G-T,rs947696,1,G,T,42959891,117178,42880461,43273677,79430
10,ENSG00000171862.5,87863625,chr10-87672529-T-C,rs9633742,1,T,C,87672529,191096,87667017,88060233,5512
10,ENSG00000015171.13,135455,chr10-318459-A-G,rs9804310,1,A,G,318459,183004,-61153,332063,379612
10,ENSG00000170430.9,129467241,chr10-129663059-G-A,rs9971190,1,G,A,129663059,195818,129270633,129663849,392426
9,ENSG00000106785.9,98119222,chr9-98117017-A-T,rs10119351,-1,A,T,98117017,2205,97922614,98315830,194403
9,ENSG00000070601.5,37650954,chr9-37841383-A-G,rs10125553,1,A,G,37841383,190429,37454346,37847562,387037
9,ENSG00000095303.10,122371024,chr9-122387794-G-A,rs10306165,1,G,A,122387794,16770,122174416,122567632,213378
9,ENSG00000130222.6,89605012,chr9-89702606-C-T,rs10436388,1,C,T,89702606,97594,89408404,89801620,294202
9,ENSG00000148396.12,136483040,chr9-136425617-T-A,rs10448340,-1,T,A,136425617,57423,136286432,136679648,139185
9,ENSG00000148396.12,136483040,chr9-136425617-T-G,rs10448340,-1,T,G,136425617,57423,136286432,136679648,139185
9,ENSG00000127084.12,92947523,chr9-92850567-A-G,rs10491803,1,A,G,92850567,96956,92750915,93144131,99652
9,ENSG00000136810.8,110256507,chr9-110256475-T-C,rs1049927,-1,T,C,110256475,32,110059899,110453115,196576
9,ENSG00000164970.10,34458570,chr9-34365359-C-T,rs10511918,-1,C,T,34365359,93211,34261962,34655178,103397
9,ENSG00000165304.3,36572895,chr9-36697738-A-G,rs10511931,1,A,G,36697738,124843,36376287,36769503,321451
9,ENSG00000185920.9,95509266,chr9-95534121-C-T,rs10512247,-1,C,T,95534121,24855,95312658,95705874,221463
9,ENSG00000136842.8,97501666,chr9-97513142-C-T,rs1052270,1,C,T,97513142,11476,97305058,97698274,208084
9,ENSG00000136925.9,97633368,chr9-97513142-C-T,rs1052270,-1,C,T,97513142,120226,97436760,97829976,76382
9,ENSG00000187239.10,130043189,chr9-129887578-C-T,rs1057888,-1,C,T,129887578,155611,129846581,130239797,40997
9,ENSG00000148335.8,129626163,chr9-129745631-T-C,rs10739757,1,T,C,129745631,119468,129429555,129822771,316076
9,ENSG00000176978.7,137114733,chr9-137114298-G-C,rs10747049,-1,G,C,137114298,435,136918125,137311341,196173
9,ENSG00000147872.5,19127492,chr9-19124598-T-A,rs10757027,-1,T,A,19124598,2894,18930884,19324100,193714
9,ENSG00000170122.4,118417,chr9-206255-G-T,rs10757084,-1,G,T,206255,87838,-78191,315025,284446
9,ENSG00000106976.12,128203379,chr9-128202956-G-A,rs10760548,1,G,A,128202956,423,128006771,128399987,196185
9,ENSG00000238227.3,136118875,chr9-136136282-G-A,rs10776884,-1,G,A,136136282,17407,135922267,136315483,214015
9,ENSG00000148175.8,121370250,chr9-121289122-A-G,rs1078305,-1,A,G,121289122,81128,121173642,121566858,115480
9,ENSG00000198642.5,21335404,chr9-21193433-T-A,rs10811497,-1,T,A,21193433,141971,21138796,21532012,54637
9,ENSG00000233816.2,21368962,chr9-21519296-T-A,rs10811557,-1,T,A,21519296,150334,21172354,21565570,346942
9,ENSG00000147852.9,2621787,chr9-2602831-C-T,rs10812325,1,C,T,2602831,18956,2425179,2818395,177652
9,ENSG00000096872.10,26956412,chr9-26960087-A-G,rs10812503,1,A,G,26960087,3675,26759804,27153020,200283
9,ENSG00000095383.14,98255649,chr9-98088685-A-G,rs10818472,-1,A,G,98088685,166964,98059041,98452257,29644
9,ENSG00000119383.15,129111415,chr9-129270358-T-C,rs10819484,1,T,C,129270358,158943,128914807,129308023,355551
9,ENSG00000188483.6,129178261,chr9-129270358-T-C,rs10819484,-1,T,C,129270358,92097,128981653,129374869,288705
9,ENSG00000130958.7,96383711,chr9-96495705-G-A,rs10820727,-1,G,A,96495705,111994,96187103,96580319,308602
9,ENSG00000106733.15,75088155,chr9-75092779-A-T,rs10869500,-1,A,T,75092779,4624,74891547,75284763,201232
9,ENSG00000106733.15,75088155,chr9-75092779-A-C,rs10869500,-1,A,C,75092779,4624,74891547,75284763,201232
9,ENSG00000196358.5,132162058,chr9-132235224-A-G,rs10901141,1,A,G,132235224,73166,131965450,132358666,269774
9,ENSG00000184434.7,27005672,chr9-27000342-C-T,rs10967652,-1,C,T,27000342,5330,26809064,27202280,191278
9,ENSG00000122692.7,33076674,chr9-33079025-A-G,rs10971388,-1,A,G,33079025,2351,32880066,33273282,198959
9,ENSG00000159884.7,35658292,chr9-35656878-C-T,rs10972552,1,C,T,35656878,1414,35461684,35854900,195194
9,ENSG00000122707.7,36036913,chr9-36032585-T-C,rs10972700,1,T,C,36032585,4328,35840305,36233521,192280
9,ENSG00000165275.5,37753805,chr9-37775180-C-T,rs10973538,1,C,T,37775180,21375,37557197,37950413,217983
9,ENSG00000178445.8,6645729,chr9-6617555-A-T,rs10975694,-1,A,T,6617555,28174,6449121,6842337,168434
9,ENSG00000137090.6,841697,chr9-676741-A-G,rs10975740,1,A,G,676741,164956,645089,1038305,31652
9,ENSG00000095209.7,105694541,chr9-105692062-A-G,rs10978204,1,A,G,105692062,2479,105497933,105891149,194129
9,ENSG00000188152.6,96928843,chr9-97002375-T-G,rs10980078,1,T,G,97002375,73532,96732235,97125451,270140
9,ENSG00000136868.8,113221544,chr9-113224129-T-G,rs10981694,1,T,G,113224129,2585,113024936,113418152,199193
9,ENSG00000176386.4,113275572,chr9-113287218-T-C,rs10981715,-1,T,C,113287218,11646,113078964,113472180,208254
9,ENSG00000119396.6,121201869,chr9-121086559-A-G,rs10985148,-1,A,G,121086559,115310,121005261,121398477,81298
9,ENSG00000182150.9,95875691,chr9-95840724-G-T,rs10985499,1,G,T,95840724,34967,95679083,96072299,161641
9,ENSG00000119408.11,124257949,chr9-124304852-G-A,rs10986309,1,G,A,124304852,46903,124061341,124454557,243511
9,ENSG00000136935.8,124941083,chr9-124958118-T-C,rs10986490,-1,T,C,124958118,17035,124744475,125137691,213643
9,ENSG00000044574.6,125241343,chr9-125386112-T-C,rs10986735,-1,T,C,125386112,144769,125044735,125437951,341377
9,ENSG00000167136.6,128818500,chr9-128833128-C-T,rs10988134,1,C,T,128833128,14628,128621892,129015108,211236
9,ENSG00000119523.8,99221942,chr9-99201731-A-G,rs10988749,-1,A,G,99201731,20211,99025334,99418550,176397
9,ENSG00000106803.5,99222282,chr9-99201731-A-G,rs10988749,1,A,G,99201731,20551,99025674,99418890,176057
9,ENSG00000048828.11,93451685,chr9-93451009-A-G,rs10992740,1,A,G,93451009,676,93255077,93648293,195932
9,ENSG00000080503.14,2015347,chr9-1958716-C-A,rs1105260,1,C,A,1958716,56631,1818739,2211955,139977
9,ENSG00000135069.8,78297125,chr9-78452332-A-C,rs11137682,1,A,C,78452332,155207,78100517,78493733,351815
9,ENSG00000134996.11,75088514,chr9-75081761-T-C,rs11144217,1,T,C,75081761,6753,74891906,75285122,189855
9,ENSG00000213213.6,136796338,chr9-136619223-G-C,rs11145804,1,G,C,136619223,177115,136599730,136992946,19493
9,ENSG00000160408.9,127899603,chr9-127908153-G-A,rs1127024,-1,G,A,127908153,8550,127702995,128096211,205158
9,ENSG00000136856.11,127397169,chr9-127447832-T-C,rs1139400,1,T,C,127447832,50663,127200561,127593777,247271
9,ENSG00000119326.10,109013499,chr9-108916228-C-T,rs1140064,-1,C,T,108916228,97271,108816891,109210107,99337
9,ENSG00000160325.9,133459978,chr9-133532073-C-T,rs11507716,1,C,T,133532073,72095,133263370,133656586,268703
9,ENSG00000175283.6,128947603,chr9-128770415-C-T,rs11560592,-1,C,T,128770415,177188,128750995,129144211,19420
9,ENSG00000198000.6,92325350,chr9-92391690-A-G,rs116388354,-1,A,G,92391690,66340,92128742,92521958,262948
9,ENSG00000165802.14,137459334,chr9-137349521-G-A,rs116575725,-1,G,A,137349521,109813,137262726,137655942,86795
9,ENSG00000177943.8,136852346,chr9-136865196-G-A,rs116924614,1,G,A,136865196,12850,136655738,137048954,209458
9,ENSG00000136897.6,101398618,chr9-101318928-T-C,rs117104094,-1,T,C,101318928,79690,101202010,101595226,116918
9,ENSG00000120235.3,21351378,chr9-21329434-C-A,rs11791015,-1,C,A,21329434,21944,21154770,21547986,174664
9,ENSG00000120235.3,21351378,chr9-21329434-C-G,rs11791015,-1,C,G,21329434,21944,21154770,21547986,174664
9,ENSG00000136866.9,113056724,chr9-113056970-C-T,rs11791740,-1,C,T,113056970,246,112860116,113253332,196854
9,ENSG00000106799.6,99105113,chr9-99170243-A-G,rs118112234,1,A,G,99170243,65130,98908505,99301721,261738
9,ENSG00000186638.9,34329268,chr9-34515330-T-C,rs12001113,-1,T,C,34515330,186062,34132660,34525876,382670
9,ENSG00000130635.10,134641803,chr9-134786174-T-C,rs12005720,1,T,C,134786174,144371,134445195,134838411,340979
9,ENSG00000197969.6,77177534,chr9-77142445-C-A,rs12005993,1,C,A,77142445,35089,76980926,77374142,161519
9,ENSG00000197919.3,21440439,chr9-21306242-G-A,rs12156640,1,G,A,21306242,134197,21243831,21637047,62411
9,ENSG00000135047.9,87726119,chr9-87888819-C-T,rs12238266,1,C,T,87888819,162700,87529511,87922727,359308
9,ENSG00000136802.7,128882133,chr9-128969201-G-A,rs12337718,1,G,A,128969201,87068,128685525,129078741,283676
9,ENSG00000137101.6,35618413,chr9-35733973-A-C,rs12340601,-1,A,C,35733973,115560,35421805,35815021,312168
9,ENSG00000147889.10,21974857,chr9-22128710-C-G,rs12347779,-1,C,G,22128710,153853,21778249,22171465,350461
9,ENSG00000172159.10,83538401,chr9-83441289-A-C,rs12378340,-1,A,C,83441289,97112,83341793,83735009,99496
9,ENSG00000136942.9,124861957,chr9-124758356-T-C,rs12683027,-1,T,C,124758356,103601,124665349,125058565,93007
9,ENSG00000165661.10,136245812,chr9-136218808-C-T,rs12684650,-1,C,T,136218808,27004,136049204,136442420,169604
9,ENSG00000165023.5,90642824,chr9-90535684-C-T,rs12685637,-1,C,T,90535684,107140,90446216,90839432,89468
9,ENSG00000160447.6,128702503,chr9-128703202-C-G,rs13283282,1,C,G,128703202,699,128505895,128899111,197307
9,ENSG00000136783.9,104747683,chr9-104746345-C-T,rs13288256,1,C,T,104746345,1338,104551075,104944291,195270
9,ENSG00000137124.5,38392702,chr9-38387868-A-G,rs13290293,1,A,G,38387868,4834,38196094,38589310,191774
9,ENSG00000198722.7,35162009,chr9-35166766-G-T,rs13293564,1,G,T,35166766,4757,34965401,35358617,201365
9,ENSG00000198435.2,137302271,chr9-137428362-A-G,rs13296446,-1,A,G,137428362,126091,137105663,137498879,322699
9,ENSG00000164967.5,34612097,chr9-34701355-A-G,rs13301121,-1,A,G,34701355,89258,34415489,34808705,285866
9,ENSG00000137038.7,7799778,chr9-7799606-C-A,rs14059,-1,C,A,7799606,172,7603170,7996386,196436
9,ENSG00000176884.10,137139154,chr9-137067808-G-A,rs144334202,1,G,A,137067808,71346,136942546,137335762,125262
9,ENSG00000106804.5,121050275,chr9-121047612-C-T,rs1468673,-1,C,T,121047612,2663,120853667,121246883,193945
9,ENSG00000196739.8,114155537,chr9-114154651-A-G,rs1469598,1,A,G,114154651,886,113958929,114352145,195722
9,ENSG00000164989.9,15553043,chr9-15656808-G-A,rs1553727,1,G,A,15656808,103765,15356435,15749651,300373
9,ENSG00000119446.8,122264840,chr9-122235946-A-G,rs1571585,-1,A,G,122235946,28894,122068232,122461448,167714
9,ENSG00000136869.13,117704403,chr9-117747674-C-A,rs16906116,1,C,A,117747674,43271,117507795,117901011,239879
9,ENSG00000165140.5,94639518,chr9-94636656-A-G,rs16910853,-1,A,G,94636656,2862,94442910,94836126,193746
9,ENSG00000204291.5,98943907,chr9-99053057-G-T,rs16918167,1,G,T,99053057,109150,98747299,99140515,305758
9,ENSG00000205808.3,4662294,chr9-4670573-C-T,rs16921782,1,C,T,4670573,8279,4465686,4858902,204887
9,ENSG00000175854.6,128276244,chr9-128237072-C-T,rs16930318,1,C,T,128237072,39172,128079636,128472852,157436
9,ENSG00000175854.6,128276244,chr9-128237072-C-G,rs16930318,1,C,G,128237072,39172,128079636,128472852,157436
9,ENSG00000164976.7,34376898,chr9-34242096-T-A,rs16935457,-1,T,A,34242096,134802,34180290,34573506,61806
9,ENSG00000106829.12,79571965,chr9-79531192-G-A,rs17082537,1,G,A,79531192,40773,79375357,79768573,155835
9,ENSG00000160326.9,133479099,chr9-133628864-C-T,rs17150766,-1,C,T,133628864,149765,133282491,133675707,346373
9,ENSG00000136872.10,101435774,chr9-101403078-C-T,rs17185855,-1,C,T,101403078,32696,101239166,101632382,163912
9,ENSG00000175287.14,128920982,chr9-128943484-G-A,rs17432839,1,G,A,128943484,22502,128724374,129117590,219110
9,ENSG00000120162.8,27529814,chr9-27447436-G-A,rs1822725,-1,G,A,27447436,82378,27333206,27726422,114230
9,ENSG00000137133.5,35815042,chr9-35696805-C-T,rs1885373,-1,C,T,35696805,118237,35618434,36011650,78371
9,ENSG00000154529.8,42129426,chr9-42186681-G-A,rs201906478,-1,G,A,42186681,57255,41932818,42326034,253863
9,ENSG00000147955.10,34637787,chr9-34649445-A-G,rs2070074,-1,A,G,34649445,11658,34441179,34834395,208266
9,ENSG00000160404.13,127735294,chr9-127870731-A-G,rs2094332,-1,A,G,127870731,135437,127538686,127931902,332045
9,ENSG00000213930.6,34646675,chr9-34691538-T-C,rs2233873,1,T,C,34691538,44863,34450067,34843283,241471
9,ENSG00000054148.13,136849409,chr9-136859658-G-A,rs2236544,1,G,A,136859658,10249,136652801,137046017,206857
9,ENSG00000130653.9,137550402,chr9-137588624-G-A,rs2259657,-1,G,A,137588624,38222,137353794,137747010,234830
9,ENSG00000107281.5,137046177,chr9-137052352-C-G,rs2271867,-1,C,G,137052352,6175,136849569,137242785,202783
9,ENSG00000107331.10,137028237,chr9-137052352-C-G,rs2271867,-1,C,G,137052352,24115,136831629,137224845,220723
9,ENSG00000054179.6,137054061,chr9-137052352-C-G,rs2271867,-1,C,G,137052352,1709,136857453,137250669,194899
9,ENSG00000127080.5,92670131,chr9-92642542-A-G,rs2277167,-1,A,G,92642542,27589,92473523,92866739,169019
9,ENSG00000130560.4,135961373,chr9-135948042-C-T,rs2297689,-1,C,T,135948042,13331,135764765,136157981,183277
9,ENSG00000095319.8,128947699,chr9-128999620-A-G,rs2302811,1,A,G,128999620,51921,128751091,129144307,248529
9,ENSG00000177076.4,19409009,chr9-19448475-A-G,rs2383096,1,A,G,19448475,39466,19212401,19605617,236074
9,ENSG00000147894.10,27573481,chr9-27586164-A-G,rs2453556,-1,A,G,27586164,12683,27376873,27770089,209291
9,ENSG00000165028.7,104764129,chr9-104774614-A-G,rs2515606,1,A,G,104774614,10485,104567521,104960737,207093
9,ENSG00000148229.8,113410675,chr9-113397580-G-A,rs2761025,-1,G,A,113397580,13095,113214067,113607283,183513
9,ENSG00000106948.11,114387982,chr9-114367105-C-G,rs2787352,-1,C,G,114367105,20877,114191374,114584590,175731
9,ENSG00000066697.10,100427143,chr9-100293656-G-A,rs2787375,1,G,A,100293656,133487,100230535,100623751,63121
9,ENSG00000177984.6,136764518,chr9-136773991-T-C,rs2811768,-1,T,C,136773991,9473,136567910,136961126,206081
9,ENSG00000176058.7,137200741,chr9-137233633-T-C,rs28407527,-1,T,C,137233633,32892,137004133,137397349,229500
9,ENSG00000176101.7,137188676,chr9-137181267-T-C,rs28451678,1,T,C,137181267,7409,136992068,137385284,189199
9,ENSG00000155158.13,15307360,chr9-15301430-C-A,rs2849049,-1,C,A,15301430,5930,15110752,15503968,190678
9,ENSG00000176248.6,137188560,chr9-137348112-G-A,rs28671254,-1,G,A,137348112,159552,136991952,137385168,356160
9,ENSG00000106789.8,98192637,chr9-98192147-G-A,rs28703824,-1,G,A,98192147,490,97996029,98389245,196118
9,ENSG00000123453.10,133738352,chr9-133735651-C-T,rs2905214,-1,C,T,133735651,2701,133541744,133934960,193907
9,ENSG00000165025.10,90801819,chr9-90799027-T-C,rs290992,1,T,C,90799027,2792,90605211,90998427,193816
9,ENSG00000148290.5,133356487,chr9-133425943-T-C,rs3118667,-1,T,C,133425943,69456,133159879,133553095,266064
9,ENSG00000137142.4,38424454,chr9-38293905-T-C,rs341474,-1,T,C,38293905,130549,38227846,38621062,66059
9,ENSG00000148225.10,113340275,chr9-113357049-A-G,rs35852964,-1,A,G,113357049,16774,113143667,113536883,213382
9,ENSG00000135002.7,76394426,chr9-76394431-G-A,rs3739730,-1,G,A,76394431,5,76197818,76591034,196613
9,ENSG00000119431.5,113376986,chr9-113375733-C-T,rs3747816,-1,C,T,113375733,1253,113180378,113573594,195355
9,ENSG00000148331.7,129642151,chr9-129629139-T-C,rs3780695,-1,T,C,129629139,13012,129445543,129838759,183596
9,ENSG00000167112.7,128322447,chr9-128150578-C-T,rs3780836,-1,C,T,128150578,171869,128125839,128519055,24739
9,ENSG00000167103.7,127930777,chr9-127951337-T-C,rs3802354,-1,T,C,127951337,20560,127734169,128127385,217168
9,ENSG00000165138.11,98796555,chr9-98728784-C-A,rs380857,-1,C,A,98728784,67771,98599947,98993163,128837
9,ENSG00000119514.5,98807670,chr9-98728784-C-A,rs380857,1,C,A,98728784,78886,98611062,99004278,117722
9,ENSG00000107263.12,131740076,chr9-131595766-C-T,rs3808803,-1,C,T,131595766,144310,131543468,131936684,52298
9,ENSG00000106853.11,111599647,chr9-111660113-A-G,rs3824469,-1,A,G,111660113,60466,111403039,111796255,257074
9,ENSG00000136908.13,127937854,chr9-127939274-G-C,rs3824528,-1,G,C,127939274,1420,127741246,128134462,198028
9,ENSG00000107140.9,35605262,chr9-35679254-A-G,rs3829078,1,A,G,35679254,73992,35408654,35801870,270600
9,ENSG00000154330.6,68356611,chr9-68385385-C-G,rs4111290,1,C,G,68385385,28774,68160003,68553219,225382
9,ENSG00000120215.5,5890889,chr9-5765648-G-A,rs41280733,1,G,A,5765648,125241,5694281,6087497,71367
9,ENSG00000184709.7,137170051,chr9-137161251-G-A,rs41290007,-1,G,A,137161251,8800,136973443,137366659,187808
9,ENSG00000157653.7,113410747,chr9-113583838-G-A,rs41305473,1,G,A,113583838,173091,113214139,113607355,369699
9,ENSG00000107036.7,5629107,chr9-5526124-C-T,rs4237162,1,C,T,5526124,102983,5432499,5825715,93625
9,ENSG00000196363.4,134136082,chr9-134127781-C-T,rs4358859,1,C,T,134127781,8301,133939474,134332690,188307
9,ENSG00000148339.8,128068232,chr9-128077733-C-T,rs4443757,1,C,T,128077733,9501,127871624,128264840,206109
9,ENSG00000137106.11,37422696,chr9-37421771-C-T,rs4472607,1,C,T,37421771,925,37226088,37619304,195683
9,ENSG00000130714.10,131502918,chr9-131528812-A-G,rs4740260,1,A,G,131528812,25894,131306310,131699526,222502
9,ENSG00000106688.7,4490468,chr9-4559775-C-T,rs4742007,1,C,T,4559775,69307,4293860,4687076,265915
9,ENSG00000136824.13,104094309,chr9-104094797-A-G,rs4742906,1,A,G,104094797,488,103897701,104290917,197096
9,ENSG00000160401.9,127706988,chr9-127734136-G-A,rs482712,1,G,A,127734136,27148,127510380,127903596,223756
9,ENSG00000148341.12,129028331,chr9-129023624-C-T,rs4837333,-1,C,T,129023624,4707,128831723,129224939,191901
9,ENSG00000136931.5,124507399,chr9-124460933-G-A,rs4838181,-1,G,A,124460933,46466,124310791,124704007,150142
9,ENSG00000148019.7,78236075,chr9-78242430-C-T,rs4877503,1,C,T,78242430,6355,78039467,78432683,202963
9,ENSG00000164978.12,34329569,chr9-34282390-C-A,rs4878560,1,C,A,34282390,47179,34132961,34526177,149429
9,ENSG00000198467.7,35689925,chr9-35700840-C-T,rs4879926,-1,C,T,35700840,10915,35493317,35886533,207523
9,ENSG00000187713.5,137205648,chr9-137136549-C-G,rs4880213,-1,C,G,137136549,69099,137009040,137402256,127509
9,ENSG00000187713.5,137205648,chr9-137136549-C-T,rs4880213,-1,C,T,137136549,69099,137009040,137402256,127509
9,ENSG00000119328.7,108934400,chr9-109000645-C-T,rs4978767,1,C,T,109000645,66245,108737792,109131008,262853
9,ENSG00000198121.7,111038470,chr9-111040153-C-G,rs4978978,-1,C,G,111040153,1683,110841862,111235078,198291
9,ENSG00000119471.10,112380108,chr9-112377996-G-A,rs4979109,1,G,A,112377996,2112,112183500,112576716,194496
9,ENSG00000157693.10,114611291,chr9-114613629-C-A,rs4979444,1,C,A,114613629,2338,114414683,114807899,198946
9,ENSG00000097007.11,130835254,chr9-131027336-T-C,rs56213822,1,T,C,131027336,192082,130638646,131031862,388690
9,ENSG00000164985.9,15510970,chr9-15523306-T-C,rs57142629,-1,T,C,15523306,12336,15314362,15707578,208944
9,ENSG00000159899.10,35791591,chr9-35742984-G-A,rs58869857,1,G,A,35742984,48607,35594983,35988199,148001
9,ENSG00000122729.11,32384643,chr9-32537143-T-G,rs597131,1,T,G,32537143,152500,32188035,32581251,349108
9,ENSG00000165280.11,35072625,chr9-35043294-G-T,rs615474,-1,G,T,35043294,29331,34876017,35269233,167277
9,ENSG00000148296.5,133336188,chr9-133346666-C-T,rs616836,-1,C,T,133346666,10478,133139580,133532796,207086
9,ENSG00000148291.5,133356550,chr9-133361131-C-T,rs61751475,1,C,T,133361131,4581,133159942,133553158,201189
9,ENSG00000165118.9,83956742,chr9-84013544-T-C,rs62565806,-1,T,C,84013544,56802,83760134,84153350,253410
9,ENSG00000187922.9,136742940,chr9-136725921-G-A,rs62582186,-1,G,A,136725921,17019,136546332,136939548,179589
9,ENSG00000136827.9,129824136,chr9-129975577-A-G,rs62583655,-1,A,G,129975577,151441,129627528,130020744,348049
9,ENSG00000167081.10,125747373,chr9-125650397-G-A,rs631287,1,G,A,125650397,96976,125550765,125943981,99632
9,ENSG00000107099.9,214865,chr9-289061-A-G,rs6476030,1,A,G,289061,74196,18257,411473,270804
9,ENSG00000196597.7,96854514,chr9-97029630-A-G,rs6477831,-1,A,G,97029630,175116,96657906,97051122,371724
9,ENSG00000136867.6,113151007,chr9-113103737-G-T,rs6477983,1,G,T,113103737,47270,112954399,113347615,149338
9,ENSG00000136891.8,100352942,chr9-100329523-A-G,rs6479013,-1,A,G,100329523,23419,100156334,100549550,173189
9,ENSG00000157303.5,93058701,chr9-93130161-A-T,rs6479454,1,A,T,93130161,71460,92862093,93255309,268068
9,ENSG00000180549.7,137032088,chr9-137039568-G-A,rs6605,-1,G,A,137039568,7480,136835480,137228696,204088
9,ENSG00000198113.2,137277726,chr9-137268088-A-G,rs67211234,1,A,G,137268088,9638,137081118,137474334,186970
9,ENSG00000136878.7,129835458,chr9-129993991-T-C,rs7019010,1,T,C,129993991,158533,129638850,130032066,355141
9,ENSG00000135063.12,69325215,chr9-69284053-C-T,rs7019607,1,C,T,69284053,41162,69128607,69521823,155446
9,ENSG00000136930.8,124415442,chr9-124248595-C-T,rs7020077,-1,C,T,124248595,166847,124218834,124612050,29761
9,ENSG00000165233.13,93096217,chr9-93100259-G-A,rs7020130,1,G,A,93100259,4042,92899609,93292825,200650
9,ENSG00000119125.12,72149440,chr9-72148510-A-G,rs7021424,1,A,G,72148510,930,71952832,72346048,195678
9,ENSG00000188959.9,110208159,chr9-110157886-C-T,rs7023301,-1,C,T,110157886,50273,110011551,110404767,146335
9,ENSG00000136940.9,122828588,chr9-122821959-C-T,rs7023344,-1,C,T,122821959,6629,122631980,123025196,189979
9,ENSG00000119139.11,69174277,chr9-69179357-C-T,rs7023961,1,C,T,69179357,5080,68977669,69370885,201688
9,ENSG00000099219.9,5833117,chr9-5925878-C-T,rs7024130,-1,C,T,5925878,92761,5636509,6029725,289369
9,ENSG00000107262.11,33264708,chr9-33354238-T-G,rs7027207,-1,T,G,33354238,89530,33068100,33461316,286138
9,ENSG00000164946.13,14910428,chr9-14931836-A-G,rs7028365,-1,A,G,14931836,21408,14713820,15107036,218016
9,ENSG00000136928.4,98708935,chr9-98571785-A-C,rs7029361,-1,A,C,98571785,137150,98512327,98905543,59458
9,ENSG00000165119.11,83980215,chr9-84055778-C-A,rs7029362,-1,C,A,84055778,75563,83783607,84176823,272171
9,ENSG00000180071.12,38620596,chr9-38661419-A-G,rs7031991,-1,A,G,38661419,40823,38423988,38817204,237431
9,ENSG00000131669.5,93134251,chr9-93120619-T-C,rs7032525,-1,T,C,93120619,13632,92937643,93330859,182976
9,ENSG00000107242.11,68705240,chr9-68671055-A-G,rs7032654,1,A,G,68671055,34185,68508632,68901848,162423
9,ENSG00000148057.10,83623143,chr9-83675190-C-T,rs7033585,1,C,T,83675190,52047,83426535,83819751,248655
9,ENSG00000119402.10,120793416,chr9-120838263-T-C,rs7035159,-1,T,C,120838263,44847,120596808,120990024,241455
9,ENSG00000106952.3,114930591,chr9-114754138-C-A,rs7038398,-1,C,A,114754138,176453,114733983,115127199,20155
9,ENSG00000135040.11,85941146,chr9-85948696-T-C,rs7040368,1,T,C,85948696,7550,85744538,86137754,204158
9,ENSG00000119522.11,123930126,chr9-123875165-C-T,rs7042633,-1,C,T,123875165,54961,123733518,124126734,141647
9,ENSG00000090054.8,92115413,chr9-92148533-G-T,rs7049168,-1,G,T,92148533,33120,91918805,92312021,229728
9,ENSG00000221829.4,35079942,chr9-35163510-C-G,rs72722992,-1,C,G,35163510,83568,34883334,35276550,280176
9,ENSG00000196781.8,81689547,chr9-81703136-A-G,rs72749025,-1,A,G,81703136,13589,81492939,81886155,210197
9,ENSG00000119401.9,116687305,chr9-116525236-C-T,rs72759981,1,C,T,116525236,162069,116490697,116883913,34539
9,ENSG00000187609.10,137423162,chr9-137411175-G-C,rs72765153,-1,G,C,137411175,11987,137226554,137619770,184621
9,ENSG00000187609.10,137423162,chr9-137411175-G-A,rs72765153,-1,G,A,137411175,11987,137226554,137619770,184621
9,ENSG00000148411.3,136095289,chr9-136078854-G-T,rs72773715,-1,G,T,136078854,16435,135898681,136291897,180173
9,ENSG00000147862.9,14314141,chr9-14314797-T-C,rs74646167,-1,T,C,14314797,656,14117533,14510749,197264
9,ENSG00000197355.6,137077517,chr9-137085965-T-C,rs7466635,1,T,C,137085965,8448,136880909,137274125,205056
9,ENSG00000165684.3,136400170,chr9-136398310-T-C,rs75200747,-1,T,C,136398310,1860,136203562,136596778,194748
9,ENSG00000137135.12,35665195,chr9-35753660-G-A,rs75446899,-1,G,A,35753660,88465,35468587,35861803,285073
9,ENSG00000137070.12,34652185,chr9-34602786-G-T,rs77020248,1,G,T,34602786,49399,34455577,34848793,147209
9,ENSG00000070159.7,109498307,chr9-109655621-C-T,rs77242551,-1,C,T,109655621,157314,109301699,109694915,353922
9,ENSG00000107104.12,504695,chr9-523504-C-A,rs77420486,1,C,A,523504,18809,308087,701303,215417
9,ENSG00000070061.10,108934124,chr9-109020251-T-A,rs7776,-1,T,A,109020251,86127,108737516,109130732,282735
9,ENSG00000070061.10,108934124,chr9-109020251-T-G,rs7776,-1,T,G,109020251,86127,108737516,109130732,282735
9,ENSG00000125485.12,132669983,chr9-132695048-C-T,rs7848496,-1,C,T,132695048,25065,132473375,132866591,221673
9,ENSG00000106927.5,114078300,chr9-114094885-T-C,rs7853169,-1,T,C,114094885,16585,113881692,114274908,213193
9,ENSG00000136811.9,128456152,chr9-128481915-C-T,rs7853988,1,C,T,128481915,25763,128259544,128652760,222371
9,ENSG00000119392.10,128504719,chr9-128481915-C-T,rs7853988,1,C,T,128481915,22804,128308111,128701327,173804
9,ENSG00000197816.8,97307659,chr9-97238449-A-G,rs7856254,1,A,G,97238449,69210,97111051,97504267,127398
9,ENSG00000158122.6,96655317,chr9-96511956-A-G,rs7856709,-1,A,G,96511956,143361,96458709,96851925,53247
9,ENSG00000107014.7,5304716,chr9-5326367-C-T,rs7863534,-1,C,T,5326367,21651,5108108,5501324,218259
9,ENSG00000147912.8,37576380,chr9-37518764-G-A,rs7865834,-1,G,A,37518764,57616,37379772,37772988,138992
9,ENSG00000106992.13,127877675,chr9-127988522-G-A,rs7868260,-1,G,A,127988522,110847,127681067,128074283,307455
9,ENSG00000148334.9,128127729,chr9-128041408-C-T,rs7869490,-1,C,T,128041408,86321,127931121,128324337,110287
9,ENSG00000119411.10,113349541,chr9-113351116-C-T,rs7873862,1,C,T,113351116,1575,113152933,113546149,198183
9,ENSG00000119314.11,112333619,chr9-112210999-A-G,rs7874261,-1,A,G,112210999,122620,112137011,112530227,73988
9,ENSG00000120217.9,5450542,chr9-5547288-C-T,rs7874637,1,C,T,5547288,96746,5253934,5647150,293354
9,ENSG00000106689.6,124011768,chr9-124002375-T-C,rs79165010,1,T,C,124002375,9393,123815160,124208376,187215
9,ENSG00000197646.6,5510531,chr9-5510742-A-G,rs80027732,1,A,G,5510742,211,5313923,5707139,196819
9,ENSG00000148357.11,130265760,chr9-130393974-G-A,rs80073481,1,G,A,130393974,128214,130069152,130462368,324822
9,ENSG00000148218.11,113401284,chr9-113403698-G-A,rs818692,-1,G,A,113403698,2414,113204676,113597892,199022
9,ENSG00000187210.8,76459182,chr9-76619870-A-G,rs890152,1,A,G,76619870,160688,76262574,76655790,357296
9,ENSG00000160445.6,128771927,chr9-128638786-T-C,rs945836,-1,T,C,128638786,133141,128575319,128968535,63467
9,ENSG00000186193.7,137070557,chr9-137087175-A-G,rs968733,-1,A,G,137087175,16618,136873949,137267165,213226
9,ENSG00000186051.4,105662457,chr9-105671508-A-T,rs9694985,1,A,T,105671508,9051,105465849,105859065,205659
9,ENSG00000182154.7,137551879,chr9-137692704-A-G,rs975978,1,A,G,137692704,140825,137355271,137748487,337433
9,ENSG00000188986.4,137255327,chr9-137250197-G-A,rs9802576,1,G,A,137250197,5130,137058719,137451935,191478
9,ENSG00000119321.4,113221277,chr9-113209149-T-C,rs10081701,-1,T,C,113209149,12128,113024669,113417885,184480
9,ENSG00000107242.11,68705240,chr9-68750547-T-A,rs10115871,1,T,A,68750547,45307,68508632,68901848,241915
9,ENSG00000165661.10,136245812,chr9-136218015-T-G,rs10122824,-1,T,G,136218015,27797,136049204,136442420,168811
9,ENSG00000056558.6,120926796,chr9-121045260-T-C,rs1017119,-1,T,C,121045260,118464,120730188,121123404,315072
9,ENSG00000188352.7,20684259,chr9-20793947-C-T,rs10511685,1,C,T,20793947,109688,20487651,20880867,306296
9,ENSG00000188352.7,20684259,chr9-20793947-C-G,rs10511685,1,C,G,20793947,109688,20487651,20880867,306296
9,ENSG00000147889.10,21974857,chr9-22124478-A-G,rs10757278,-1,A,G,22124478,149621,21778249,22171465,346229
9,ENSG00000086062.7,33167336,chr9-33107710-T-C,rs10758187,-1,T,C,33107710,59626,32970728,33363944,136982
9,ENSG00000095209.7,105694541,chr9-105697216-G-A,rs10759128,1,G,A,105697216,2675,105497933,105891149,199283
9,ENSG00000178966.11,83980805,chr9-84046739-C-T,rs10780645,1,C,T,84046739,65934,83784197,84177413,262542
9,ENSG00000147872.5,19127492,chr9-19151256-T-C,rs10811127,-1,T,C,19151256,23764,18930884,19324100,220372
9,ENSG00000086102.13,33290516,chr9-33104526-A-G,rs10813946,1,A,G,33104526,185990,33093908,33487124,10618
9,ENSG00000086065.8,33265049,chr9-33420450-A-G,rs10813974,1,A,G,33420450,155401,33068441,33461657,352009
9,ENSG00000148334.9,128127729,chr9-127935049-G-A,rs10819321,-1,G,A,127935049,192680,127931121,128324337,3928
9,ENSG00000170681.6,100578079,chr9-100675702-G-A,rs10819806,1,G,A,100675702,97623,100381471,100774687,294231
9,ENSG00000135052.11,86099558,chr9-86092777-C-T,rs10868372,-1,C,T,86092777,6781,85902950,86296166,189827
9,ENSG00000119125.12,72149440,chr9-72164488-T-G,rs10869137,1,T,G,72164488,15048,71952832,72346048,211656
9,ENSG00000122729.11,32384643,chr9-32563916-G-A,rs10971025,1,G,A,32563916,179273,32188035,32581251,375881
9,ENSG00000122694.10,36136733,chr9-36186267-T-C,rs10972784,1,T,C,36186267,49534,35940125,36333341,246142
9,ENSG00000205808.3,4662294,chr9-4677454-G-T,rs10974724,1,G,T,4677454,15160,4465686,4858902,211768
9,ENSG00000157693.10,114611291,chr9-114518738-T-C,rs10982271,1,T,C,114518738,92553,114414683,114807899,104055
9,ENSG00000136937.7,97633821,chr9-97532863-G-T,rs10982558,1,G,T,97532863,100958,97437213,97830429,95650
9,ENSG00000041982.9,115118157,chr9-115228517-C-T,rs10982619,-1,C,T,115228517,110360,114921549,115314765,306968
9,ENSG00000214654.5,120793467,chr9-120736223-G-A,rs10985016,1,G,A,120736223,57244,120596859,120990075,139364
9,ENSG00000119402.10,120793416,chr9-120941616-C-T,rs10985097,-1,C,T,120941616,148200,120596808,120990024,344808
9,ENSG00000136856.11,127397169,chr9-127410206-G-A,rs10987639,1,G,A,127410206,13037,127200561,127593777,209645
9,ENSG00000160404.13,127735294,chr9-127628439-G-A,rs10987706,-1,G,A,127628439,106855,127538686,127931902,89753
9,ENSG00000106991.8,127854658,chr9-127856098-T-C,rs10987759,-1,T,C,127856098,1440,127658050,128051266,198048
9,ENSG00000167103.7,127930777,chr9-127970556-A-G,rs10987790,-1,A,G,127970556,39779,127734169,128127385,236387
9,ENSG00000119383.15,129111415,chr9-129181161-C-T,rs10988239,1,C,T,129181161,69746,128914807,129308023,266354
9,ENSG00000148358.12,130053906,chr9-130178768-C-T,rs10988632,1,C,T,130178768,124862,129857298,130250514,321470
9,ENSG00000158079.10,94084464,chr9-94099516-T-C,rs10993052,1,T,C,94099516,15052,93887856,94281072,211660
9,ENSG00000130635.10,134641803,chr9-134478917-T-C,rs11103770,1,T,C,134478917,162886,134445195,134838411,33722
9,ENSG00000172159.10,83538401,chr9-83450273-G-A,rs11140095,-1,G,A,83450273,88128,83341793,83735009,108480
9,ENSG00000054179.6,137054061,chr9-137041401-C-G,rs11145975,-1,C,G,137041401,12660,136857453,137250669,183948
9,ENSG00000054179.6,137054061,chr9-137041401-C-T,rs11145975,-1,C,T,137041401,12660,136857453,137250669,183948
9,ENSG00000107164.13,130579577,chr9-130532738-G-A,rs11243665,1,G,A,130532738,46839,130382969,130776185,149769
9,ENSG00000187764.7,89498113,chr9-89534156-T-G,rs11265797,-1,T,G,89534156,36043,89301505,89694721,232651
9,ENSG00000165689.12,136410614,chr9-136441147-A-G,rs1127152,-1,A,G,136441147,30533,136214006,136607222,227141
9,ENSG00000176248.6,137188560,chr9-137320206-G-A,rs113950356,-1,G,A,137320206,131646,136991952,137385168,328254
9,ENSG00000176101.7,137188676,chr9-137218245-A-G,rs11525177,1,A,G,137218245,29569,136992068,137385284,226177
9,ENSG00000054148.13,136849409,chr9-136672437-G-A,rs11558192,1,G,A,136672437,176972,136652801,137046017,19636
9,ENSG00000081377.12,96619843,chr9-96632324-A-G,rs116950909,-1,A,G,96632324,12481,96423235,96816451,209089
9,ENSG00000130957.4,94593824,chr9-94570392-C-T,rs117355087,-1,C,T,94570392,23432,94397216,94790432,173176
9,ENSG00000136807.6,127786034,chr9-127845239-T-G,rs11789185,1,T,G,127845239,59205,127589426,127982642,255813
9,ENSG00000070159.7,109498307,chr9-109671425-T-C,rs117914628,-1,T,C,109671425,173118,109301699,109694915,369726
9,ENSG00000070159.7,109498307,chr9-109671425-T-G,rs117914628,-1,T,G,109671425,173118,109301699,109694915,369726
9,ENSG00000136819.8,129835275,chr9-129874322-T-C,rs11792703,-1,T,C,129874322,39047,129638667,130031883,235655
9,ENSG00000238227.3,136118875,chr9-136153982-C-T,rs12002547,-1,C,T,136153982,35107,135922267,136315483,231715
9,ENSG00000119314.11,112333619,chr9-112383825-C-T,rs12335731,-1,C,T,112383825,50206,112137011,112530227,246814
9,ENSG00000196305.11,92293697,chr9-92165527-A-G,rs12337081,-1,A,G,92165527,128170,92097089,92490305,68438
9,ENSG00000136897.6,101398618,chr9-101307254-G-A,rs12337610,-1,G,A,101307254,91364,101202010,101595226,105244
9,ENSG00000095321.10,129110793,chr9-129078577-T-C,rs12346996,-1,T,C,129078577,32216,128914185,129307401,164392
9,ENSG00000147853.10,4741202,chr9-4740251-A-C,rs12348423,-1,A,C,4740251,951,4544594,4937810,195657
9,ENSG00000106789.8,98192637,chr9-98222664-T-C,rs12351801,-1,T,C,98222664,30027,97996029,98389245,226635
9,ENSG00000154330.6,68356611,chr9-68480931-C-T,rs12379560,1,C,T,68480931,124320,68160003,68553219,320928
9,ENSG00000137038.7,7799778,chr9-7798435-C-T,rs1254,-1,C,T,7798435,1343,7603170,7996386,195265
9,ENSG00000159884.7,35658292,chr9-35674104-T-C,rs12553173,1,T,C,35674104,15812,35461684,35854900,212420
9,ENSG00000131669.5,93134251,chr9-93249353-G-A,rs12554664,-1,G,A,93249353,115102,92937643,93330859,311710
9,ENSG00000178445.8,6645729,chr9-6632061-G-A,rs1260463,-1,G,A,6632061,13668,6449121,6842337,182940
9,ENSG00000198887.7,70258978,chr9-70068369-G-A,rs12685632,1,G,A,70068369,190609,70062370,70455586,5999
9,ENSG00000099219.9,5833117,chr9-5656436-A-G,rs12685784,-1,A,G,5656436,176681,5636509,6029725,19927
9,ENSG00000164985.9,15510970,chr9-15464288-C-T,rs13248,-1,C,T,15464288,46682,15314362,15707578,149926
9,ENSG00000135018.9,83707958,chr9-83549513-A-G,rs13289150,-1,A,G,83549513,158445,83511350,83904566,38163
9,ENSG00000188921.11,21031640,chr9-20849928-G-C,rs1332313,-1,G,C,20849928,181712,20835032,21228248,14896
9,ENSG00000070061.10,108934124,chr9-109025948-T-C,rs1537431,-1,T,C,109025948,91824,108737516,109130732,288432
9,ENSG00000106823.8,92535990,chr9-92611602-A-G,rs1552908,-1,A,G,92611602,75612,92339382,92732598,272220
9,ENSG00000165118.9,83956742,chr9-83956883-T-G,rs1572031,-1,T,G,83956883,141,83760134,84153350,196749
9,ENSG00000120217.9,5450542,chr9-5553765-T-A,rs16923216,1,T,A,5553765,103223,5253934,5647150,299831
9,ENSG00000119408.11,124257949,chr9-124223055-A-C,rs16927294,1,A,C,124223055,34894,124061341,124454557,161714
9,ENSG00000165280.11,35072625,chr9-34970200-T-C,rs16932097,-1,T,C,34970200,102425,34876017,35269233,94183
9,ENSG00000175893.6,14693432,chr9-14701853-G-A,rs16932197,-1,G,A,14701853,8421,14496824,14890040,205029
9,ENSG00000175893.6,14693432,chr9-14701853-G-C,rs16932197,-1,G,C,14701853,8421,14496824,14890040,205029
9,ENSG00000159921.8,36258448,chr9-36215584-C-T,rs16933086,-1,C,T,36215584,42864,36061840,36455056,153744
9,ENSG00000136950.9,124862130,chr9-124925937-T-C,rs17250311,1,T,C,124925937,63807,124665522,125058738,260415
9,ENSG00000159069.9,136944738,chr9-136918005-C-G,rs17250539,-1,C,G,136918005,26733,136748130,137141346,169875
9,ENSG00000159069.9,136944738,chr9-136918005-C-T,rs17250539,-1,C,T,136918005,26733,136748130,137141346,169875
9,ENSG00000106803.5,99222282,chr9-99258944-A-G,rs1746154,1,A,G,99258944,36662,99025674,99418890,233270
9,ENSG00000096872.10,26956412,chr9-27066072-T-C,rs17694631,1,T,C,27066072,109660,26759804,27153020,306268
9,ENSG00000119411.10,113349541,chr9-113316188-C-A,rs17764563,1,C,A,113316188,33353,113152933,113546149,163255
9,ENSG00000120162.8,27529814,chr9-27488094-T-A,rs17779457,-1,T,A,27488094,41720,27333206,27726422,154888
9,ENSG00000120162.8,27529814,chr9-27488094-T-G,rs17779457,-1,T,G,27488094,41720,27333206,27726422,154888
9,ENSG00000188986.4,137255327,chr9-137392607-T-C,rs17855944,1,T,C,137392607,137280,137058719,137451935,333888
9,ENSG00000215183.4,35754276,chr9-35696805-C-T,rs1885373,-1,C,T,35696805,57471,35557668,35950884,139137
9,ENSG00000164978.12,34329569,chr9-34329841-G-C,rs2039345,1,G,C,34329841,272,34132961,34526177,196880
9,ENSG00000106927.5,114078300,chr9-114077924-A-G,rs2251680,-1,A,G,114077924,376,113881692,114274908,196232
9,ENSG00000070601.5,37650954,chr9-37731010-C-T,rs2274324,1,C,T,37731010,80056,37454346,37847562,276664
9,ENSG00000107175.6,35732666,chr9-35712006-G-A,rs2295795,1,G,A,35712006,20660,35536058,35929274,175948
9,ENSG00000137135.12,35665195,chr9-35650461-G-A,rs2297880,-1,G,A,35650461,14734,35468587,35861803,181874
9,ENSG00000148341.12,129028331,chr9-128999620-A-G,rs2302811,-1,A,G,128999620,28711,128831723,129224939,167897
9,ENSG00000107223.8,136866308,chr9-137000282-A-G,rs2386133,-1,A,G,137000282,133974,136669700,137062916,330582
9,ENSG00000119421.5,122159779,chr9-122124730-T-C,rs2416855,-1,T,C,122124730,35049,121963171,122356387,161559
9,ENSG00000095303.10,122371024,chr9-122491734-A-G,rs2416864,1,A,G,122491734,120710,122174416,122567632,317318
9,ENSG00000123453.10,133738352,chr9-133716297-C-A,rs2427981,-1,C,A,133716297,22055,133541744,133934960,174553
9,ENSG00000147894.10,27573481,chr9-27599748-T-C,rs2477518,-1,T,C,27599748,26267,27376873,27770089,222875
9,ENSG00000188152.6,96928843,chr9-96902072-C-T,rs2479209,1,C,T,96902072,26771,96732235,97125451,169837
9,ENSG00000160293.11,133992324,chr9-133945735-C-T,rs2519799,-1,C,T,133945735,46589,133795716,134188932,150019
9,ENSG00000164989.9,15553043,chr9-15509621-A-G,rs2665503,1,A,G,15509621,43422,15356435,15749651,153186
9,ENSG00000164975.10,15422876,chr9-15461855-G-C,rs2665504,1,G,C,15461855,38979,15226268,15619484,235587
9,ENSG00000137106.11,37422696,chr9-37399387-C-T,rs2768653,1,C,T,37399387,23309,37226088,37619304,173299
9,ENSG00000136872.10,101435774,chr9-101401880-A-C,rs2777336,-1,A,C,101401880,33894,101239166,101632382,162714
9,ENSG00000187210.8,76459182,chr9-76350575-C-A,rs2803407,1,C,A,76350575,108607,76262574,76655790,88001
9,ENSG00000187713.5,137205648,chr9-137233633-T-C,rs28407527,-1,T,C,137233633,27985,137009040,137402256,224593
9,ENSG00000180071.12,38620596,chr9-38652717-G-A,rs2993174,-1,G,A,38652717,32121,38423988,38817204,228729
9,ENSG00000048828.11,93451685,chr9-93323088-C-T,rs3001450,1,C,T,93323088,128597,93255077,93648293,68011
9,ENSG00000160323.13,133422367,chr9-133439376-G-A,rs3124768,1,G,A,133439376,17009,133225759,133618975,213617
9,ENSG00000160447.6,128702503,chr9-128628923-C-T,rs35782171,1,C,T,128628923,73580,128505895,128899111,123028
9,ENSG00000119471.10,112380108,chr9-112398025-G-C,rs35938444,1,G,C,112398025,17917,112183500,112576716,214525
9,ENSG00000107020.5,5437925,chr9-5340129-T-C,rs3758240,-1,T,C,5340129,97796,5241317,5634533,98812
9,ENSG00000165271.10,33473924,chr9-33449954-C-T,rs3758280,-1,C,T,33449954,23970,33277316,33670532,172638
9,ENSG00000135046.9,73151865,chr9-73149649-A-C,rs3758354,1,A,C,73149649,2216,72955257,73348473,194392
9,ENSG00000204291.5,98943907,chr9-99037011-A-G,rs3780621,1,A,G,99037011,93104,98747299,99140515,289712
9,ENSG00000095370.14,127778666,chr9-127762096-A-G,rs3780652,-1,A,G,127762096,16570,127582058,127975274,180038
9,ENSG00000136868.8,113221544,chr9-113169412-A-G,rs3810909,1,A,G,113169412,52132,113024936,113418152,144476
9,ENSG00000213221.4,136363744,chr9-136367539-A-G,rs3812556,-1,A,G,136367539,3795,136167136,136560352,200403
9,ENSG00000213221.4,136363744,chr9-136367539-A-C,rs3812556,-1,A,C,136367539,3795,136167136,136560352,200403
9,ENSG00000171159.4,128160265,chr9-128148408-A-G,rs3814526,1,A,G,128148408,11857,127963657,128356873,184751
9,ENSG00000136891.8,100352942,chr9-100303602-C-T,rs3923501,-1,C,T,100303602,49340,100156334,100549550,147268
9,ENSG00000185963.9,92764833,chr9-92616379-A-G,rs41266679,-1,A,G,92616379,148454,92568225,92961441,48154
9,ENSG00000182752.7,116153791,chr9-116076195-T-G,rs4145479,1,T,G,116076195,77596,115957183,116350399,119012
9,ENSG00000136783.9,104747683,chr9-104792547-T-G,rs4149328,1,T,G,104792547,44864,104551075,104944291,241472
9,ENSG00000155876.4,19049427,chr9-19201740-T-C,rs457062,1,T,C,19201740,152313,18852819,19246035,348921
9,ENSG00000120158.6,4792944,chr9-4855514-C-A,rs457417,1,C,A,4855514,62570,4596336,4989552,259178
9,ENSG00000130714.10,131502918,chr9-131522237-C-T,rs4740165,1,C,T,131522237,19319,131306310,131699526,215927
9,ENSG00000165138.11,98796555,chr9-98749858-G-A,rs4742738,-1,G,A,98749858,46697,98599947,98993163,149911
9,ENSG00000136881.7,101385006,chr9-101338601-A-G,rs4742811,-1,A,G,101338601,46405,101188398,101581614,150203
9,ENSG00000106701.7,105448034,chr9-105614816-G-A,rs4742955,1,G,A,105614816,166782,105251426,105644642,363390
9,ENSG00000172785.11,179147,chr9-205964-A-G,rs478882,-1,A,G,205964,26817,-17461,375755,223425
9,ENSG00000106976.12,128203379,chr9-128162643-T-C,rs4837250,1,T,C,128162643,40736,128006771,128399987,155872
9,ENSG00000148180.9,121268162,chr9-121084342-A-G,rs4837808,1,A,G,121084342,183820,121071554,121464770,12788
9,ENSG00000148175.8,121370250,chr9-121232885-C-G,rs4837817,-1,C,G,121232885,137365,121173642,121566858,59243
9,ENSG00000148187.12,122264882,chr9-122222310-C-T,rs4837950,1,C,T,122222310,42572,122068274,122461490,154036
9,ENSG00000119446.8,122264840,chr9-122420327-C-G,rs4837964,-1,C,G,122420327,155487,122068232,122461448,352095
9,ENSG00000107281.5,137046177,chr9-137108302-C-T,rs4880090,-1,C,T,137108302,62125,136849569,137242785,258733
9,ENSG00000107331.10,137028237,chr9-137101743-G-C,rs4880203,-1,G,C,137101743,73506,136831629,137224845,270114
9,ENSG00000176058.7,137200741,chr9-137136549-C-G,rs4880213,-1,C,G,137136549,64192,137004133,137397349,132416
9,ENSG00000176058.7,137200741,chr9-137136549-C-T,rs4880213,-1,C,T,137136549,64192,137004133,137397349,132416
9,ENSG00000155158.13,15307360,chr9-15308156-G-A,rs491322,-1,G,A,15308156,796,15110752,15503968,197404
9,ENSG00000160271.9,133121240,chr9-133183495-T-C,rs4962101,-1,T,C,133183495,62255,132924632,133317848,258863
9,ENSG00000196358.5,132162058,chr9-132245816-T-C,rs4962175,1,T,C,132245816,83758,131965450,132358666,280366
9,ENSG00000130653.9,137550402,chr9-137461922-C-A,rs4962240,-1,C,A,137461922,88480,137353794,137747010,108128
9,ENSG00000188959.9,110208159,chr9-110140281-G-A,rs4978873,-1,G,A,110140281,67878,110011551,110404767,128730
9,ENSG00000148296.5,133336188,chr9-133325787-G-T,rs597411,-1,G,T,133325787,10401,133139580,133532796,186207
9,ENSG00000204136.6,121499844,chr9-121581314-T-C,rs603757,-1,T,C,121581314,81470,121303236,121696452,278078
9,ENSG00000160325.9,133459978,chr9-133346666-C-T,rs616836,1,C,T,133346666,113312,133263370,133656586,83296
9,ENSG00000164970.10,34458570,chr9-34409979-C-T,rs62559871,-1,C,T,34409979,48591,34261962,34655178,148017
9,ENSG00000232434.1,136842478,chr9-136725921-G-A,rs62582186,1,G,A,136725921,116557,136645870,137039086,80051
9,ENSG00000137054.10,37485948,chr9-37498337-C-T,rs6476635,1,C,T,37498337,12389,37289340,37682556,208997
9,ENSG00000136925.9,97633368,chr9-97534694-T-C,rs6478247,-1,T,C,97534694,98674,97436760,97829976,97934
9,ENSG00000119514.5,98807670,chr9-98639189-G-A,rs6478792,1,G,A,98639189,168481,98611062,99004278,28127
9,ENSG00000148110.10,94374569,chr9-94495450-T-C,rs6479549,1,T,C,94495450,120881,94177961,94571177,317489
9,ENSG00000136933.12,125200542,chr9-125087039-A-C,rs650599,1,A,C,125087039,113503,125003934,125397150,83105
9,ENSG00000122728.6,32635669,chr9-32817122-C-G,rs654184,-1,C,G,32817122,181453,32439061,32832277,378061
9,ENSG00000196363.4,134136082,chr9-133963739-T-C,rs695067,1,T,C,133963739,172343,133939474,134332690,24265
9,ENSG00000137074.12,33001628,chr9-33195621-G-A,rs697529,-1,G,A,33195621,193993,32805020,33198236,390601
9,ENSG00000106853.11,111599647,chr9-111432994-T-C,rs7018469,-1,T,C,111432994,166653,111403039,111796255,29955
9,ENSG00000122692.7,33076674,chr9-33113324-C-T,rs7019909,-1,C,T,33113324,36650,32880066,33273282,233258
9,ENSG00000136810.8,110256507,chr9-110199481-A-G,rs7020970,-1,A,G,110199481,57026,110059899,110453115,139582
9,ENSG00000167118.6,128371374,chr9-128197270-C-T,rs7023128,1,C,T,128197270,174104,128174766,128567982,22504
9,ENSG00000135048.9,71768513,chr9-71868717-C-T,rs7023190,-1,C,T,71868717,100204,71571905,71965121,296812
9,ENSG00000136827.9,129824136,chr9-129794931-T-C,rs7025992,-1,T,C,129794931,29205,129627528,130020744,167403
9,ENSG00000119326.10,109013499,chr9-109037987-G-A,rs7029890,-1,G,A,109037987,24488,108816891,109210107,221096
9,ENSG00000106688.7,4490468,chr9-4490134-T-G,rs7031998,1,T,G,4490134,334,4293860,4687076,196274
9,ENSG00000175854.6,128276244,chr9-128140181-C-T,rs7036450,1,C,T,128140181,136063,128079636,128472852,60545
9,ENSG00000159899.10,35791591,chr9-35842483-A-G,rs7037450,1,A,G,35842483,50892,35594983,35988199,247500
9,ENSG00000130956.9,96450169,chr9-96584288-C-T,rs7042473,1,C,T,96584288,134119,96253561,96646777,330727
9,ENSG00000119139.11,69174277,chr9-69198655-T-C,rs7043149,1,T,C,69198655,24378,68977669,69370885,220986
9,ENSG00000187866.5,68780065,chr9-68737577-T-C,rs7044422,1,T,C,68737577,42488,68583457,68976673,154120
9,ENSG00000158122.6,96655317,chr9-96672811-G-T,rs7045407,-1,G,T,96672811,17494,96458709,96851925,214102
9,ENSG00000175764.10,122093308,chr9-122055770-T-C,rs7045782,-1,T,C,122055770,37538,121896700,122289916,159070
9,ENSG00000083223.12,86354410,chr9-86210852-T-C,rs7046228,-1,T,C,86210852,143558,86157802,86551018,53050
9,ENSG00000106799.6,99105113,chr9-99089625-A-G,rs7046702,1,A,G,99089625,15488,98908505,99301721,181120
9,ENSG00000148154.5,111896814,chr9-111867962-A-G,rs716440,1,A,G,111867962,28852,111700206,112093422,167756
9,ENSG00000198963.5,74497335,chr9-74693674-G-A,rs72730919,1,G,A,74693674,196339,74300727,74693943,392947
9,ENSG00000167113.5,128322839,chr9-128295504-C-T,rs73672492,1,C,T,128295504,27335,128126231,128519447,169273
9,ENSG00000130559.14,135907546,chr9-136074817-G-A,rs74443985,-1,G,A,136074817,167271,135710938,136104154,363879
9,ENSG00000180549.7,137032088,chr9-137069483-A-G,rs7467117,-1,A,G,137069483,37395,136835480,137228696,234003
9,ENSG00000168795.4,37465450,chr9-37391112-C-T,rs751030,-1,C,T,37391112,74338,37268842,37662058,122270
9,ENSG00000197919.3,21440439,chr9-21531949-G-T,rs75145502,1,G,T,21531949,91510,21243831,21637047,288118
9,ENSG00000165119.11,83980215,chr9-84118607-C-T,rs75556442,-1,C,T,84118607,138392,83783607,84176823,335000
9,ENSG00000171843.10,20622499,chr9-20603759-G-A,rs756728,-1,G,A,20603759,18740,20425891,20819107,177868
9,ENSG00000165233.13,93096217,chr9-93030933-T-C,rs75776206,1,T,C,93030933,65284,92899609,93292825,131324
9,ENSG00000184709.7,137170051,chr9-137155084-G-A,rs75845722,-1,G,A,137155084,14967,136973443,137366659,181641
9,ENSG00000135063.12,69325215,chr9-69319821-T-C,rs75984529,1,T,C,69319821,5394,69128607,69521823,191214
9,ENSG00000119523.8,99221942,chr9-99248056-A-G,rs76235977,-1,A,G,99248056,26114,99025334,99418550,222722
9,ENSG00000165264.6,32573159,chr9-32698402-G-T,rs76843843,-1,G,T,32698402,125243,32376551,32769767,321851
9,ENSG00000172889.10,136662916,chr9-136612604-G-A,rs77277738,1,G,A,136612604,50312,136466308,136859524,146296
9,ENSG00000136928.4,98708935,chr9-98780550-C-T,rs78235211,-1,C,T,98780550,71615,98512327,98905543,268223
9,ENSG00000136928.4,98708935,chr9-98780550-C-G,rs78235211,-1,C,G,98780550,71615,98512327,98905543,268223
9,ENSG00000189357.4,81928428,chr9-81774816-A-C,rs7847362,1,A,C,81774816,153612,81731820,82125036,42996
9,ENSG00000186788.8,81943500,chr9-81774816-A-C,rs7847362,1,A,C,81774816,168684,81746892,82140108,27924
9,ENSG00000148400.9,136546048,chr9-136616795-C-A,rs7852910,-1,C,A,136616795,70747,136349440,136742656,267355
9,ENSG00000183354.7,6008482,chr9-6090276-T-C,rs7865727,-1,T,C,6090276,81794,5811874,6205090,278402
9,ENSG00000160345.8,135499869,chr9-135364062-A-G,rs7869343,-1,A,G,135364062,135807,135303261,135696477,60801
9,ENSG00000148218.11,113401284,chr9-113403116-T-G,rs818691,-1,T,G,113403116,1832,113204676,113597892,198440
9,ENSG00000106771.7,109119947,chr9-108930852-T-C,rs838818,-1,T,C,108930852,189095,108923339,109316555,7513
9,ENSG00000187922.9,136742940,chr9-136644302-T-C,rs914746,-1,T,C,136644302,98638,136546332,136939548,97970
9,ENSG00000165724.5,137590512,chr9-137592656-T-A,rs928046,-1,T,A,137592656,2144,137393904,137787120,198752
9,ENSG00000165724.5,137590512,chr9-137592656-T-C,rs928046,-1,T,C,137592656,2144,137393904,137787120,198752
9,ENSG00000148408.8,137877782,chr9-137856943-G-T,rs9410147,1,G,T,137856943,20839,137681174,138074390,175769
9,ENSG00000177943.8,136852346,chr9-136697233-G-A,rs9411217,1,G,A,136697233,155113,136655738,137048954,41495
9,ENSG00000167123.11,128420857,chr9-128600082-T-C,rs945831,1,T,C,128600082,179225,128224249,128617465,375833
9,ENSG00000198113.2,137277726,chr9-137268581-G-A,rs9696384,1,G,A,137268581,9145,137081118,137474334,187463
9,ENSG00000197859.5,133534704,chr9-133533953-A-G,rs9696672,1,A,G,133533953,751,133338096,133731312,195857
9,ENSG00000136824.13,104094309,chr9-104126236-T-C,rs980249,1,T,C,104126236,31927,103897701,104290917,228535
9,ENSG00000177125.5,126860665,chr9-126696478-G-C,rs10115373,1,G,C,126696478,164187,126664057,127057273,32421
9,ENSG00000177125.5,126860665,chr9-126696478-G-A,rs10115373,1,G,A,126696478,164187,126664057,127057273,32421
9,ENSG00000095209.7,105694541,chr9-105678261-T-C,rs10120372,1,T,C,105678261,16280,105497933,105891149,180328
9,ENSG00000119431.5,113376986,chr9-113373918-C-T,rs1043836,-1,C,T,113373918,3068,113180378,113573594,193540
9,ENSG00000165698.11,132878898,chr9-132892556-C-T,rs1050700,1,C,T,132892556,13658,132682290,133075506,210266
9,ENSG00000070601.5,37650954,chr9-37709240-C-T,rs10511943,1,C,T,37709240,58286,37454346,37847562,254894
9,ENSG00000164985.9,15510970,chr9-15451868-A-G,rs10738397,-1,A,G,15451868,59102,15314362,15707578,137506
9,ENSG00000130950.8,94328644,chr9-94215368-T-A,rs10739973,-1,T,A,94215368,113276,94132036,94525252,83332
9,ENSG00000137054.10,37485948,chr9-37591239-T-G,rs10758442,1,T,G,37591239,105291,37289340,37682556,301899
9,ENSG00000188959.9,110208159,chr9-110156251-A-G,rs10759392,-1,A,G,110156251,51908,110011551,110404767,144700
9,ENSG00000136925.9,97633368,chr9-97510720-G-A,rs10759742,-1,G,A,97510720,122648,97436760,97829976,73960
9,ENSG00000136842.8,97501666,chr9-97510720-G-A,rs10759742,1,G,A,97510720,9054,97305058,97698274,205662
9,ENSG00000106772.11,76906114,chr9-76724799-T-C,rs10781372,-1,T,C,76724799,181315,76709506,77102722,15293
9,ENSG00000137106.11,37422696,chr9-37302158-C-T,rs10814518,1,C,T,37302158,120538,37226088,37619304,76070
9,ENSG00000182150.9,95875691,chr9-95772180-T-G,rs10817721,1,T,G,95772180,103511,95679083,96072299,93097
9,ENSG00000135052.11,86099558,chr9-86007692-C-T,rs10868361,-1,C,T,86007692,91866,85902950,86296166,104742
9,ENSG00000147905.12,37120574,chr9-37183939-T-A,rs10973244,1,T,A,37183939,63365,36923966,37317182,259973
9,ENSG00000119326.10,109013499,chr9-109191835-T-C,rs10979739,-1,T,C,109191835,178336,108816891,109210107,374944
9,ENSG00000165185.10,112486827,chr9-112604875-G-A,rs10981455,1,G,A,112604875,118048,112290219,112683435,314656
9,ENSG00000106780.7,120714470,chr9-120735629-T-A,rs10985013,-1,T,A,120735629,21159,120517862,120911078,217767
9,ENSG00000106689.6,124011768,chr9-124118198-C-A,rs10986226,1,C,A,124118198,106430,123815160,124208376,303038
9,ENSG00000106991.8,127854658,chr9-127817814-T-C,rs10987746,-1,T,C,127817814,36844,127658050,128051266,159764
9,ENSG00000185963.9,92764833,chr9-92826614-A-G,rs10992485,-1,A,G,92826614,61781,92568225,92961441,258389
9,ENSG00000148019.7,78236075,chr9-78285761-C-T,rs11137585,1,C,T,78285761,49686,78039467,78432683,246294
9,ENSG00000148019.7,78236075,chr9-78285761-C-G,rs11137585,1,C,G,78285761,49686,78039467,78432683,246294
9,ENSG00000135040.11,85941146,chr9-85916164-G-A,rs11141148,1,G,A,85916164,24982,85744538,86137754,171626
9,ENSG00000135040.11,85941146,chr9-85916164-G-T,rs11141148,1,G,T,85916164,24982,85744538,86137754,171626
9,ENSG00000156017.8,75028293,chr9-74867063-T-C,rs11144123,-1,T,C,74867063,161230,74831685,75224901,35378
9,ENSG00000148362.6,136992422,chr9-137136838-A-G,rs11146019,1,A,G,137136838,144416,136795814,137189030,341024
9,ENSG00000107164.13,130579577,chr9-130482812-G-T,rs11243474,1,G,T,130482812,96765,130382969,130776185,99843
9,ENSG00000187609.10,137423162,chr9-137253313-C-T,rs1134511,-1,C,T,137253313,169849,137226554,137619770,26759
9,ENSG00000188747.4,137423393,chr9-137431510-G-A,rs11534415,1,G,A,137431510,8117,137226785,137620001,204725
9,ENSG00000177943.8,136852346,chr9-136672437-G-A,rs11558192,1,G,A,136672437,179909,136655738,137048954,16699
9,ENSG00000130956.9,96450169,chr9-96632324-A-G,rs116950909,1,A,G,96632324,182155,96253561,96646777,378763
9,ENSG00000119392.10,128504719,chr9-128358102-G-A,rs117199693,1,G,A,128358102,146617,128308111,128701327,49991
9,ENSG00000148296.5,133336188,chr9-133374038-A-G,rs117509822,-1,A,G,133374038,37850,133139580,133532796,234458
9,ENSG00000107020.5,5437925,chr9-5450790-C-A,rs117829760,-1,C,A,5450790,12865,5241317,5634533,209473
9,ENSG00000176978.7,137114733,chr9-137130394-G-T,rs11794273,-1,G,T,137130394,15661,136918125,137311341,212269
9,ENSG00000136888.6,114587769,chr9-114588322-A-G,rs118009168,1,A,G,114588322,553,114391161,114784377,197161
9,ENSG00000107159.7,35673928,chr9-35857852-G-A,rs118137738,1,G,A,35857852,183924,35477320,35870536,380532
9,ENSG00000119523.8,99221942,chr9-99226683-G-A,rs118142760,-1,G,A,99226683,4741,99025334,99418550,201349
9,ENSG00000187796.9,136373669,chr9-136476890-G-A,rs11999525,-1,G,A,136476890,103221,136177061,136570277,299829
9,ENSG00000119318.7,107283279,chr9-107127969-A-G,rs12002945,1,A,G,107127969,155310,107086671,107479887,41298
9,ENSG00000157693.10,114611291,chr9-114586186-G-A,rs12238437,1,G,A,114586186,25105,114414683,114807899,171503
9,ENSG00000177076.4,19409009,chr9-19380240-C-T,rs12342100,1,C,T,19380240,28769,19212401,19605617,167839
9,ENSG00000106853.11,111599647,chr9-111609344-A-C,rs12342716,-1,A,C,111609344,9697,111403039,111796255,206305
9,ENSG00000126882.8,131276510,chr9-131235078-C-T,rs12346002,-1,C,T,131235078,41432,131079902,131473118,155176
9,ENSG00000107290.9,132354986,chr9-132354004-C-T,rs12348044,-1,C,T,132354004,982,132158378,132551594,195626
9,ENSG00000107290.9,132354986,chr9-132354004-C-G,rs12348044,-1,C,G,132354004,982,132158378,132551594,195626
9,ENSG00000147853.10,4741202,chr9-4733379-G-A,rs12350463,-1,G,A,4733379,7823,4544594,4937810,188785
9,ENSG00000147853.10,4741202,chr9-4733379-G-C,rs12350463,-1,G,C,4733379,7823,4544594,4937810,188785
9,ENSG00000178031.9,18474153,chr9-18642146-A-G,rs12552620,1,A,G,18642146,167993,18277545,18670761,364601
9,ENSG00000090054.8,92115413,chr9-91972280-A-G,rs1316268,-1,A,G,91972280,143133,91918805,92312021,53475
9,ENSG00000066697.10,100427143,chr9-100387705-T-C,rs13284428,1,T,C,100387705,39438,100230535,100623751,157170
9,ENSG00000086062.7,33167336,chr9-33186790-G-A,rs13285633,-1,G,A,33186790,19454,32970728,33363944,216062
9,ENSG00000155158.13,15307360,chr9-15298770-T-C,rs13286025,-1,T,C,15298770,8590,15110752,15503968,188018
9,ENSG00000183354.7,6008482,chr9-5966898-T-C,rs13289592,-1,T,C,5966898,41584,5811874,6205090,155024
9,ENSG00000106733.15,75088155,chr9-75148384-A-G,rs13290703,-1,A,G,75148384,60229,74891547,75284763,256837
9,ENSG00000165283.10,35103131,chr9-34983193-C-T,rs13293550,-1,C,T,34983193,119938,34906523,35299739,76670
9,ENSG00000119328.7,108934400,chr9-108770540-A-G,rs1339882,1,A,G,108770540,163860,108737792,109131008,32748
9,ENSG00000136881.7,101385006,chr9-101511619-G-A,rs1407869,-1,G,A,101511619,126613,101188398,101581614,323221
9,ENSG00000167081.10,125747373,chr9-125902131-C-T,rs1411351,1,C,T,125902131,154758,125550765,125943981,351366
9,ENSG00000106686.12,4666480,chr9-4664749-C-T,rs1485202,-1,C,T,4664749,1731,4469872,4863088,194877
9,ENSG00000136827.9,129824136,chr9-129861014-C-T,rs1503375,-1,C,T,129861014,36878,129627528,130020744,233486
9,ENSG00000178445.8,6645729,chr9-6679844-C-G,rs1658940,-1,C,G,6679844,34115,6449121,6842337,230723
9,ENSG00000157657.10,113876309,chr9-113739088-G-A,rs16908653,1,G,A,113739088,137221,113679701,114072917,59387
9,ENSG00000119402.10,120793416,chr9-120705402-T-C,rs16910080,-1,T,C,120705402,88014,120596808,120990024,108594
9,ENSG00000106927.5,114078300,chr9-113993925-T-C,rs16911462,-1,T,C,113993925,84375,113881692,114274908,112233
9,ENSG00000086061.10,33025273,chr9-33112625-A-C,rs16918999,1,A,C,33112625,87352,32828665,33221881,283960
9,ENSG00000041982.9,115118157,chr9-115202921-C-T,rs16932368,-1,C,T,115202921,84764,114921549,115314765,281372
9,ENSG00000122694.10,36136733,chr9-36237244-T-G,rs16933112,1,T,G,36237244,100511,35940125,36333341,297119
9,ENSG00000176386.4,113275572,chr9-113462172-G-A,rs16933949,-1,G,A,113462172,186600,113078964,113472180,383208
9,ENSG00000136933.12,125200542,chr9-125196575-C-T,rs17337635,1,C,T,125196575,3967,125003934,125397150,192641
9,ENSG00000188483.6,129178261,chr9-129290732-G-C,rs17456987,-1,G,C,129290732,112471,128981653,129374869,309079
9,ENSG00000172785.11,179147,chr9-270321-A-G,rs17720310,-1,A,G,270321,91174,-17461,375755,287782
9,ENSG00000148120.9,94726699,chr9-94865485-A-G,rs1867102,1,A,G,94865485,138786,94530091,94923307,335394
9,ENSG00000120162.8,27529814,chr9-27353462-A-G,rs1888380,-1,A,G,27353462,176352,27333206,27726422,20256
9,ENSG00000198853.6,35490111,chr9-35343530-C-T,rs1927955,1,C,T,35343530,146581,35293503,35686719,50027
9,ENSG00000136868.8,113221544,chr9-113344807-G-A,rs2093691,1,G,A,113344807,123263,113024936,113418152,319871
9,ENSG00000196358.5,132162058,chr9-132226867-C-T,rs2149171,1,C,T,132226867,64809,131965450,132358666,261417
9,ENSG00000198887.7,70258978,chr9-70345875-T-C,rs2150000,1,T,C,70345875,86897,70062370,70455586,283505
9,ENSG00000136783.9,104747683,chr9-104665764-A-C,rs2185657,1,A,C,104665764,81919,104551075,104944291,114689
9,ENSG00000171159.4,128160265,chr9-128218658-G-A,rs2229917,1,G,A,128218658,58393,127963657,128356873,255001
9,ENSG00000106976.12,128203379,chr9-128218658-G-A,rs2229917,1,G,A,128218658,15279,128006771,128399987,211887
9,ENSG00000167123.11,128420857,chr9-128429124-A-G,rs2270202,1,A,G,128429124,8267,128224249,128617465,204875
9,ENSG00000167106.6,127980989,chr9-127944802-A-G,rs2274426,-1,A,G,127944802,36187,127784381,128177597,160421
9,ENSG00000107130.6,130172404,chr9-130110483-A-G,rs2277197,1,A,G,130110483,61921,129975796,130369012,134687
9,ENSG00000198467.7,35689925,chr9-35676610-G-A,rs2301372,-1,G,A,35676610,13315,35493317,35886533,183293
9,ENSG00000159884.7,35658292,chr9-35676610-G-A,rs2301372,1,G,A,35676610,18318,35461684,35854900,214926
9,ENSG00000136935.8,124941083,chr9-124881667-A-G,rs2304957,-1,A,G,124881667,59416,124744475,125137691,137192
9,ENSG00000136897.6,101398618,chr9-101346368-G-A,rs2417250,-1,G,A,101346368,52250,101202010,101595226,144358
9,ENSG00000160293.11,133992324,chr9-133826023-C-A,rs2428095,-1,C,A,133826023,166301,133795716,134188932,30307
9,ENSG00000165029.11,104928155,chr9-104924124-C-T,rs2487052,-1,C,T,104924124,4031,104731547,105124763,192577
9,ENSG00000136826.9,107489769,chr9-107560747-T-C,rs2488050,-1,T,C,107560747,70978,107293161,107686377,267586
9,ENSG00000123454.5,133636363,chr9-133630196-G-A,rs2519147,1,G,A,133630196,6167,133439755,133832971,190441
9,ENSG00000148331.7,129642151,chr9-129604557-A-G,rs2542242,-1,A,G,129604557,37594,129445543,129838759,159014
9,ENSG00000097007.11,130835254,chr9-130767865-G-A,rs2791744,1,G,A,130767865,67389,130638646,131031862,129219
9,ENSG00000107104.12,504695,chr9-603264-C-T,rs2804297,1,C,T,603264,98569,308087,701303,295177
9,ENSG00000176101.7,137188676,chr9-137310817-C-T,rs28374197,1,C,T,137310817,122141,136992068,137385284,318749
9,ENSG00000165275.5,37753805,chr9-37820829-C-T,rs2841947,1,C,T,37820829,67024,37557197,37950413,263632
9,ENSG00000185920.9,95509266,chr9-95518506-A-C,rs28469297,-1,A,C,95518506,9240,95312658,95705874,205848
9,ENSG00000148335.8,129626163,chr9-129631991-G-A,rs2900277,1,G,A,129631991,5828,129429555,129822771,202436
9,ENSG00000148335.8,129626163,chr9-129631991-G-T,rs2900277,1,G,T,129631991,5828,129429555,129822771,202436
9,ENSG00000130222.6,89605012,chr9-89604886-C-T,rs3138496,1,C,T,89604886,126,89408404,89801620,196482
9,ENSG00000130222.6,89605012,chr9-89604886-C-G,rs3138496,1,C,G,89604886,126,89408404,89801620,196482
9,ENSG00000137038.7,7799778,chr9-7805650-C-T,rs327759,-1,C,T,7805650,5872,7603170,7996386,202480
9,ENSG00000106804.5,121050275,chr9-121116037-A-G,rs34680486,-1,A,G,121116037,65762,120853667,121246883,262370
9,ENSG00000107021.11,128787253,chr9-128628923-C-T,rs35782171,1,C,T,128628923,158330,128590645,128983861,38278
9,ENSG00000135018.9,83707958,chr9-83553006-T-C,rs35913863,-1,T,C,83553006,154952,83511350,83904566,41656
9,ENSG00000119411.10,113349541,chr9-113369995-G-A,rs3750529,1,G,A,113369995,20454,113152933,113546149,217062
9,ENSG00000136830.5,127569073,chr9-127525193-G-T,rs3765601,-1,G,T,127525193,43880,127372465,127765681,152728
9,ENSG00000136908.13,127937854,chr9-127911140-C-T,rs3780668,-1,C,T,127911140,26714,127741246,128134462,169894
9,ENSG00000167103.7,127930777,chr9-127908253-C-T,rs3818509,-1,C,T,127908253,22524,127734169,128127385,174084
9,ENSG00000136856.11,127397169,chr9-127383345-G-A,rs3824415,1,G,A,127383345,13824,127200561,127593777,182784
9,ENSG00000171843.10,20622499,chr9-20464364-C-A,rs3904577,-1,C,A,20464364,158135,20425891,20819107,38473
9,ENSG00000070061.10,108934124,chr9-108856322-A-G,rs3908996,-1,A,G,108856322,77802,108737516,109130732,118806
9,ENSG00000136810.8,110256507,chr9-110208354-T-C,rs4111656,-1,T,C,110208354,48153,110059899,110453115,148455
9,ENSG00000106789.8,98192637,chr9-98233736-T-C,rs41283620,-1,T,C,98233736,41099,97996029,98389245,237707
9,ENSG00000205808.3,4662294,chr9-4670315-G-A,rs445684,1,G,A,4670315,8021,4465686,4858902,204629
9,ENSG00000165684.3,136400170,chr9-136395799-C-T,rs4498662,-1,C,T,136395799,4371,136203562,136596778,192237
9,ENSG00000165684.3,136400170,chr9-136395799-C-G,rs4498662,-1,C,G,136395799,4371,136203562,136596778,192237
9,ENSG00000164975.10,15422876,chr9-15424940-G-A,rs4741498,1,G,A,15424940,2064,15226268,15619484,198672
9,ENSG00000136819.8,129835275,chr9-129777146-T-C,rs4837413,-1,T,C,129777146,58129,129638667,130031883,138479
9,ENSG00000130560.4,135961373,chr9-136032177-A-T,rs4842080,-1,A,T,136032177,70804,135764765,136157981,267412
9,ENSG00000054179.6,137054061,chr9-137108302-C-T,rs4880090,-1,C,T,137108302,54241,136857453,137250669,250849
9,ENSG00000212864.2,137222240,chr9-137123686-C-T,rs4880094,-1,C,T,137123686,98554,137025632,137418848,98054
9,ENSG00000165802.14,137459334,chr9-137461922-C-A,rs4962240,-1,C,A,137461922,2588,137262726,137655942,199196
9,ENSG00000157653.7,113410747,chr9-113552638-G-C,rs4979253,1,G,C,113552638,141891,113214139,113607355,338499
9,ENSG00000136824.13,104094309,chr9-104013164-C-G,rs536314,1,C,G,104013164,81145,103897701,104290917,115463
9,ENSG00000196422.5,135479782,chr9-135524568-G-A,rs59238865,1,G,A,135524568,44786,135283174,135676390,241394
9,ENSG00000123453.10,133738352,chr9-133733337-C-T,rs593824,-1,C,T,133733337,5015,133541744,133934960,191593
9,ENSG00000184434.7,27005672,chr9-27099246-G-A,rs596427,-1,G,A,27099246,93574,26809064,27202280,290182
9,ENSG00000188986.4,137255327,chr9-137272145-G-A,rs61751916,1,G,A,137272145,16818,137058719,137451935,213426
9,ENSG00000188986.4,137255327,chr9-137272145-G-C,rs61751916,1,G,C,137272145,16818,137058719,137451935,213426
9,ENSG00000180071.12,38620596,chr9-38668706-G-A,rs62537836,-1,G,A,38668706,48110,38423988,38817204,244718
9,ENSG00000180071.12,38620596,chr9-38668706-G-T,rs62537836,-1,G,T,38668706,48110,38423988,38817204,244718
9,ENSG00000180549.7,137032088,chr9-137116032-C-T,rs6560659,-1,C,T,137116032,83944,136835480,137228696,280552
9,ENSG00000137094.9,34989745,chr9-35113250-G-A,rs7020853,1,G,A,35113250,123505,34793137,35186353,320113
9,ENSG00000122729.11,32384643,chr9-32469907-T-C,rs7022323,1,T,C,32469907,85264,32188035,32581251,281872
9,ENSG00000165272.8,33447593,chr9-33487025-G-A,rs7022355,-1,G,A,33487025,39432,33250985,33644201,236040
9,ENSG00000164967.5,34612097,chr9-34582885-T-C,rs7032335,-1,T,C,34582885,29212,34415489,34808705,167396
9,ENSG00000107018.5,5339876,chr9-5186332-C-T,rs7038681,-1,C,T,5186332,153544,5143268,5536484,43064
9,ENSG00000095321.10,129110793,chr9-129285361-G-A,rs7039559,-1,G,A,129285361,174568,128914185,129307401,371176
9,ENSG00000158122.6,96655317,chr9-96584288-C-T,rs7042473,-1,C,T,96584288,71029,96458709,96851925,125579
9,ENSG00000178966.11,83980805,chr9-84177042-A-T,rs7042671,1,A,T,84177042,196237,83784197,84177413,392845
9,ENSG00000136932.8,97922500,chr9-97772541-A-T,rs7045465,-1,A,T,97772541,149959,97725892,98119108,46649
9,ENSG00000167136.6,128818500,chr9-128925059-T-C,rs7048932,1,T,C,128925059,106559,128621892,129015108,303167
9,ENSG00000198963.5,74497335,chr9-74436711-G-T,rs72729216,1,G,T,74436711,60624,74300727,74693943,135984
9,ENSG00000165118.9,83956742,chr9-84031340-A-G,rs72749149,-1,A,G,84031340,74598,83760134,84153350,271206
9,ENSG00000244187.2,136791344,chr9-136609484-C-T,rs72777518,1,C,T,136609484,181860,136594736,136987952,14748
9,ENSG00000148204.7,123356197,chr9-123328806-T-G,rs7341862,1,T,G,123328806,27391,123159589,123552805,169217
9,ENSG00000148290.5,133356487,chr9-133303925-A-G,rs7357661,-1,A,G,133303925,52562,133159879,133553095,144046
9,ENSG00000213221.4,136363744,chr9-136398310-T-C,rs75200747,-1,T,C,136398310,34566,136167136,136560352,231174
9,ENSG00000148408.8,137877782,chr9-137829308-C-T,rs75268321,1,C,T,137829308,48474,137681174,138074390,148134
9,ENSG00000187713.5,137205648,chr9-137309493-C-T,rs75592854,-1,C,T,137309493,103845,137009040,137402256,300453
9,ENSG00000198870.6,133376366,chr9-133533736-C-A,rs756770,1,C,A,133533736,157370,133179758,133572974,353978
9,ENSG00000198876.7,34126698,chr9-34255825-C-G,rs76716576,-1,C,G,34255825,129127,33930090,34323306,325735
9,ENSG00000106692.8,105558131,chr9-105395987-G-A,rs76786444,1,G,A,105395987,162144,105361523,105754739,34464
9,ENSG00000176058.7,137200741,chr9-137255836-C-T,rs78469234,-1,C,T,137255836,55095,137004133,137397349,251703
9,ENSG00000147872.5,19127492,chr9-19119036-C-A,rs7847408,-1,C,A,19119036,8456,18930884,19324100,188152
9,ENSG00000147872.5,19127492,chr9-19119036-C-G,rs7847408,-1,C,G,19119036,8456,18930884,19324100,188152
9,ENSG00000080503.14,2015347,chr9-1980918-T-G,rs7847882,1,T,G,1980918,34429,1818739,2211955,162179
9,ENSG00000148411.3,136095289,chr9-136197871-T-G,rs7850466,-1,T,G,136197871,102582,135898681,136291897,299190
9,ENSG00000155621.8,71911639,chr9-72001261-T-G,rs7855195,1,T,G,72001261,89622,71715031,72108247,286230
9,ENSG00000107281.5,137046177,chr9-137053021-G-T,rs7861020,-1,G,T,137053021,6844,136849569,137242785,203452
9,ENSG00000107263.12,131740076,chr9-131582354-C-T,rs7861733,-1,C,T,131582354,157722,131543468,131936684,38886
9,ENSG00000119514.5,98807670,chr9-98643756-A-G,rs7864144,1,A,G,98643756,163914,98611062,99004278,32694
9,ENSG00000137040.8,6015624,chr9-6090276-T-C,rs7865727,-1,T,C,6090276,74652,5819016,6212232,271260
9,ENSG00000107036.7,5629107,chr9-5734759-C-A,rs7869920,1,C,A,5734759,105652,5432499,5825715,302260
9,ENSG00000148343.14,129036626,chr9-129217138-T-G,rs7870878,1,T,G,129217138,180512,128840018,129233234,377120
9,ENSG00000160326.9,133479099,chr9-133649417-T-G,rs7876027,-1,T,G,133649417,170318,133282491,133675707,366926
9,ENSG00000095397.9,114505473,chr9-114551020-T-C,rs79203776,-1,T,C,114551020,45547,114308865,114702081,242155
9,ENSG00000137076.12,35732195,chr9-35917953-C-T,rs79857739,-1,C,T,35917953,185758,35535587,35928803,382366
9,ENSG00000120217.9,5450542,chr9-5510742-A-G,rs80027732,1,A,G,5510742,60200,5253934,5647150,256808
9,ENSG00000147852.9,2621787,chr9-2599564-C-T,rs882259,1,C,T,2599564,22223,2425179,2818395,174385
9,ENSG00000095303.10,122371024,chr9-122199025-G-A,rs913935,1,G,A,122199025,171999,122174416,122567632,24609
9,ENSG00000173258.8,111525179,chr9-111524995-C-T,rs9299199,1,C,T,111524995,184,111328571,111721787,196424
9,ENSG00000148399.7,137578925,chr9-137426165-C-T,rs9414734,-1,C,T,137426165,152760,137382317,137775533,43848
9,ENSG00000106785.9,98119222,chr9-98127058-G-T,rs942165,-1,G,T,98127058,7836,97922614,98315830,204444
9,ENSG00000106992.13,127877675,chr9-128012090-A-C,rs947626,-1,A,C,128012090,134415,127681067,128074283,331023
9,ENSG00000238227.3,136118875,chr9-136106764-A-C,rs959016,-1,A,C,136106764,12111,135922267,136315483,184497
9,ENSG00000238227.3,136118875,chr9-136106764-A-G,rs959016,-1,A,G,136106764,12111,135922267,136315483,184497
8,ENSG00000133739.10,85107238,chr8-85140008-A-G,rs10088120,1,A,G,85140008,32770,84910630,85303846,229378
8,ENSG00000185015.3,85245458,chr8-85227767-T-C,rs10090196,1,T,C,85227767,17691,85048850,85442066,178917
8,ENSG00000132294.8,131904093,chr8-131870447-A-C,rs10090261,1,A,C,131870447,33646,131707485,132100701,162962
8,ENSG00000198846.4,59119147,chr8-58960675-A-C,rs10092016,-1,A,C,58960675,158472,58922539,59315755,38136
8,ENSG00000104312.6,89757816,chr8-89837077-C-A,rs10094579,1,C,A,89837077,79261,89561208,89954424,275869
8,ENSG00000205189.6,80486226,chr8-80447660-G-T,rs10095089,1,G,T,80447660,38566,80289618,80682834,158042
8,ENSG00000172728.10,33473146,chr8-33473052-G-A,rs10097936,-1,G,A,33473052,94,33276538,33669754,196514
8,ENSG00000105339.6,141128589,chr8-141181649-T-G,rs10104549,1,T,G,141181649,53060,140931981,141325197,249668
8,ENSG00000186918.9,28386460,chr8-28232826-G-A,rs10216536,-1,G,A,28232826,153634,28189852,28583068,42974
8,ENSG00000137571.5,69834978,chr8-69676506-T-C,rs10448033,-1,T,C,69676506,158472,69638370,70031586,38136
8,ENSG00000175806.10,10054292,chr8-10120550-G-T,rs10503402,1,G,T,10120550,66258,9857684,10250900,262866
8,ENSG00000171320.10,27774554,chr8-27779621-G-A,rs10503820,1,G,A,27779621,5067,27577946,27971162,201675
8,ENSG00000076641.3,81112068,chr8-81105137-G-A,rs10504730,-1,G,A,81105137,6931,80915460,81308676,189677
8,ENSG00000136982.5,119855894,chr8-119834883-C-T,rs1055131,-1,C,T,119834883,21011,119659286,120052502,175597
8,ENSG00000133731.5,81686325,chr8-81658396-C-T,rs1058401,-1,C,T,81658396,27929,81489717,81882933,168679
8,ENSG00000104529.12,143597415,chr8-143568377-G-A,rs11136302,-1,G,A,143568377,29038,143400807,143794023,167570
8,ENSG00000179832.12,144148016,chr8-143984818-A-G,rs11136343,1,A,G,143984818,163198,143951408,144344624,33410
8,ENSG00000168487.13,22165372,chr8-22164004-G-A,rs1124,1,G,A,22164004,1368,21968764,22361980,195240
8,ENSG00000164941.9,94823287,chr8-94876079-C-T,rs1129152,1,C,T,94876079,52792,94626679,95019895,249400
8,ENSG00000154589.2,73991392,chr8-74010200-A-G,rs11466002,1,A,G,74010200,18808,73794784,74188000,215416
8,ENSG00000169398.14,141001233,chr8-140807352-C-T,rs116910216,-1,C,T,140807352,193881,140804625,141197841,2727
8,ENSG00000164687.6,81280536,chr8-81280973-C-T,rs116967130,1,C,T,81280973,437,81083928,81477144,197045
8,ENSG00000183309.5,143636019,chr8-143779453-C-T,rs117340801,1,C,T,143779453,143434,143439411,143832627,340042
8,ENSG00000042832.6,132866958,chr8-132972045-C-T,rs117512053,1,C,T,132972045,105087,132670350,133063566,301695
8,ENSG00000154328.9,11769710,chr8-11798848-A-C,rs11774161,1,A,C,11798848,29138,11573102,11966318,225746
8,ENSG00000183779.4,37695782,chr8-37550066-C-T,rs117767565,1,C,T,37550066,145716,37499174,37892390,50892
8,ENSG00000178209.10,143939597,chr8-143998371-T-C,rs11779776,-1,T,C,143998371,58774,143742989,144136205,255382
8,ENSG00000197217.8,23457647,chr8-23425438-A-G,rs11779953,-1,A,G,23425438,32209,23261039,23654255,164399
8,ENSG00000164808.10,47260938,chr8-47409440-T-C,rs11781727,1,T,C,47409440,148502,47064330,47457546,345110
8,ENSG00000179526.12,144103773,chr8-144280341-C-T,rs11993916,-1,C,T,144280341,176568,143907165,144300381,373176
8,ENSG00000167700.3,144509070,chr8-144523760-C-T,rs11996936,1,C,T,144523760,14690,144312462,144705678,211298
8,ENSG00000253250.2,90985238,chr8-90837380-G-T,rs11997330,-1,G,T,90837380,147858,90788630,91181846,48750
8,ENSG00000123119.7,90791775,chr8-90845553-G-T,rs12114104,1,G,T,90845553,53778,90595167,90988383,250386
8,ENSG00000177669.3,30144665,chr8-30142830-T-G,rs12334730,-1,T,G,30142830,1835,29948057,30341273,194773
8,ENSG00000104518.6,143558346,chr8-143565758-T-C,rs12541647,1,T,C,143565758,7412,143361738,143754954,204020
8,ENSG00000070718.7,42153063,chr8-42162095-G-A,rs12547064,1,G,A,42162095,9032,41956455,42349671,205640
8,ENSG00000036448.5,2045046,chr8-2130827-A-G,rs12681998,1,A,G,2130827,85781,1848438,2241654,282389
8,ENSG00000165066.10,41650817,chr8-41609270-T-C,rs12708212,-1,T,C,41609270,41547,41454209,41847425,155061
8,ENSG00000164733.14,11868087,chr8-11861019-T-C,rs1293288,-1,T,C,11861019,7068,11671479,12064695,189540
8,ENSG00000164751.10,77000078,chr8-77004279-C-T,rs13248273,-1,C,T,77004279,4201,76803470,77196686,200809
8,ENSG00000182759.3,143430732,chr8-143362039-T-G,rs13250507,-1,T,G,143362039,68693,143234124,143627340,127915
8,ENSG00000156469.4,96261610,chr8-96226541-A-G,rs13261747,-1,A,G,96226541,35069,96065002,96458218,161539
8,ENSG00000147684.3,124539123,chr8-124488277-A-G,rs13264071,1,A,G,124488277,50846,124342515,124735731,145762
8,ENSG00000164949.3,94262319,chr8-94234188-G-T,rs13264275,-1,G,T,94234188,28131,94065711,94458927,168477
8,ENSG00000179698.9,144107739,chr8-144120626-T-C,rs13264654,1,T,C,144120626,12887,143911131,144304347,209495
8,ENSG00000154319.10,11466753,chr8-11491677-G-A,rs13277113,-1,G,A,11491677,24924,11270145,11663361,221532
8,ENSG00000104689.5,23225102,chr8-23225458-G-T,rs13278062,-1,G,T,23225458,356,23028494,23421710,196964
8,ENSG00000104689.5,23225102,chr8-23225458-G-A,rs13278062,-1,G,A,23225458,356,23028494,23421710,196964
8,ENSG00000133874.1,33567128,chr8-33554518-C-T,rs13439478,-1,C,T,33554518,12610,33370520,33763736,183998
8,ENSG00000173281.4,9150658,chr8-9336872-G-A,rs13439811,-1,G,A,9336872,186214,8954050,9347266,382822
8,ENSG00000155087.3,102551589,chr8-102536282-A-G,rs1347320,1,A,G,102536282,15307,102354981,102748197,181301
8,ENSG00000104427.6,78666089,chr8-78659987-C-A,rs1384804,1,C,A,78659987,6102,78469481,78862697,190506
8,ENSG00000164930.6,103298898,chr8-103333550-A-G,rs1403294,1,A,G,103333550,34652,103102290,103495506,231260
8,ENSG00000165392.5,31033810,chr8-31101349-G-A,rs1477535,1,G,A,31101349,67539,30837202,31230418,264147
8,ENSG00000147434.4,42768786,chr8-42693096-C-T,rs1530847,-1,C,T,42693096,75690,42572178,42965394,120918
8,ENSG00000155792.5,119873722,chr8-119700439-A-G,rs16893021,1,A,G,119700439,173283,119677114,120070330,23325
8,ENSG00000104324.11,96645242,chr8-96537335-G-A,rs16894706,1,G,A,96537335,107907,96448634,96841850,88701
8,ENSG00000156802.8,123396447,chr8-123202104-C-T,rs16898132,-1,C,T,123202104,194343,123199839,123593055,2265
8,ENSG00000147687.11,124539085,chr8-124562359-T-C,rs16899698,-1,T,C,124562359,23274,124342477,124735693,219882
8,ENSG00000164879.5,85438859,chr8-85270060-A-G,rs16913721,1,A,G,85270060,168799,85242251,85635467,27809
8,ENSG00000205133.7,92966144,chr8-92965781-G-A,rs16915402,-1,G,A,92965781,363,92769536,93162752,196245
8,ENSG00000137547.4,54135241,chr8-54150978-G-A,rs16919784,1,G,A,54150978,15737,53938633,54331849,212345
8,ENSG00000091656.10,76681247,chr8-76529630-C-T,rs16939292,1,C,T,76529630,151617,76484639,76877855,44991
8,ENSG00000104765.9,26383054,chr8-26409846-A-C,rs17055196,1,A,C,26409846,26792,26186446,26579662,223400
8,ENSG00000120885.13,27614700,chr8-27644146-G-A,rs17057475,-1,G,A,27644146,29446,27418092,27811308,226054
8,ENSG00000147316.8,6406627,chr8-6407475-C-T,rs17076757,1,C,T,6407475,848,6210019,6603235,197456
8,ENSG00000061337.10,20303963,chr8-20454222-A-C,rs17092453,-1,A,C,20454222,150259,20107355,20500571,346867
8,ENSG00000129422.9,17801094,chr8-17804524-T-C,rs17125481,-1,T,C,17804524,3430,17604486,17997702,200038
8,ENSG00000171056.6,10730511,chr8-10765730-T-C,rs17711777,-1,T,C,10765730,35219,10533903,10927119,231827
8,ENSG00000132541.5,98117171,chr8-98097220-A-G,rs17832106,-1,A,G,98097220,19951,97920563,98313779,176657
8,ENSG00000147813.11,143578330,chr8-143580905-G-A,rs1809148,-1,G,A,143580905,2575,143381722,143774938,199183
8,ENSG00000104497.9,81842185,chr8-81839587-T-G,rs1814534,-1,T,G,81839587,2598,81645577,82038793,194010
8,ENSG00000214814.2,123851987,chr8-123843073-A-G,rs1821116,1,A,G,123843073,8914,123655379,124048595,187694
8,ENSG00000253598.1,81695058,chr8-81652967-A-G,rs2142316,-1,A,G,81652967,42091,81498450,81891666,154517
8,ENSG00000071894.9,144409335,chr8-144441971-C-A,rs2242265,-1,C,A,144441971,32636,144212727,144605943,229244
8,ENSG00000160949.11,144444440,chr8-144439290-G-A,rs2242268,-1,G,A,144439290,5150,144247832,144641048,191458
8,ENSG00000104611.7,19313693,chr8-19313865-G-T,rs2272000,1,G,T,19313865,172,19117085,19510301,196780
8,ENSG00000104517.7,102412700,chr8-102564430-G-A,rs2436889,-1,G,A,102564430,151730,102216092,102609308,348338
8,ENSG00000155090.10,102655725,chr8-102564430-G-A,rs2436889,-1,G,A,102564430,91295,102459117,102852333,105313
8,ENSG00000156509.9,100145817,chr8-100206126-G-A,rs2439455,-1,G,A,100206126,60309,99949209,100342425,256917
8,ENSG00000104341.10,97775788,chr8-97780458-A-C,rs2449504,1,A,C,97780458,4670,97579180,97972396,201278
8,ENSG00000034677.7,100309953,chr8-100125669-T-C,rs2453626,-1,T,C,100125669,184284,100113345,100506561,12324
8,ENSG00000177570.9,118621963,chr8-118617215-G-A,rs2460970,-1,G,A,118617215,4748,118425355,118818571,191860
8,ENSG00000182197.6,118111826,chr8-118195608-C-T,rs2514981,-1,C,T,118195608,83782,117915218,118308434,280390
8,ENSG00000104671.3,30156369,chr8-30002889-T-C,rs2595042,1,T,C,30002889,153480,29959761,30352977,43128
8,ENSG00000177710.5,11331012,chr8-11527047-C-T,rs2618443,1,C,T,11527047,196035,11134404,11527620,392643
8,ENSG00000196378.5,144787317,chr8-144825428-C-T,rs2722475,-1,C,T,144825428,38111,144590709,144983925,234719
8,ENSG00000170631.10,144950880,chr8-144825428-C-T,rs2722475,-1,C,T,144825428,125452,144754272,145147488,71156
8,ENSG00000158806.9,22024134,chr8-21891286-T-C,rs28398141,1,T,C,21891286,132848,21827526,22220742,63760
8,ENSG00000158815.6,22042820,chr8-21891286-T-C,rs28398141,1,T,C,21891286,151534,21846212,22239428,45074
8,ENSG00000179886.4,143597831,chr8-143514552-G-A,rs28569868,1,G,A,143514552,83279,143401223,143794439,113329
8,ENSG00000147601.7,73008864,chr8-72953611-G-A,rs28616742,1,G,A,72953611,55253,72812256,73205472,141355
8,ENSG00000147601.7,73008864,chr8-72953611-G-C,rs28616742,1,G,C,72953611,55253,72812256,73205472,141355
8,ENSG00000136574.12,11704202,chr8-11747150-C-T,rs28709984,1,C,T,11747150,42948,11507594,11900810,239556
8,ENSG00000136574.12,11704202,chr8-11747150-C-G,rs28709984,1,C,G,11747150,42948,11507594,11900810,239556
8,ENSG00000104219.8,17156482,chr8-17162904-G-A,rs2904662,1,G,A,17162904,6422,16959874,17353090,203030
8,ENSG00000164920.5,98944442,chr8-98913400-C-T,rs2922068,1,C,T,98913400,31042,98747834,99141050,165566
8,ENSG00000104375.11,98825688,chr8-98913400-C-T,rs2922068,-1,C,T,98913400,87712,98629080,99022296,284320
8,ENSG00000104687.8,30727846,chr8-30766480-T-C,rs2956016,-1,T,C,30766480,38634,30531238,30924454,235242
8,ENSG00000147408.10,19602495,chr8-19638773-C-T,rs2957618,-1,C,T,19638773,36278,19405887,19799103,232886
8,ENSG00000160948.8,144428548,chr8-144392053-A-G,rs2977837,-1,A,G,144392053,36495,144231940,144625156,160113
8,ENSG00000253457.1,30638580,chr8-30598071-G-A,rs2979524,1,G,A,30598071,40509,30441972,30835188,156099
8,ENSG00000164749.7,75539869,chr8-75413404-C-G,rs2980252,1,C,G,75413404,126465,75343261,75736477,70143
8,ENSG00000164933.5,103415107,chr8-103395913-G-T,rs3098256,-1,G,T,103395913,19194,103218499,103611715,177414
8,ENSG00000104660.13,30095408,chr8-30016087-A-G,rs309853,1,A,G,30016087,79321,29898800,30292016,117287
8,ENSG00000164934.8,103415386,chr8-103407872-T-C,rs3134254,1,T,C,103407872,7514,103218778,103611994,189094
8,ENSG00000104613.6,19817416,chr8-19841680-G-T,rs34564004,1,G,T,19841680,24264,19620808,20014024,220872
8,ENSG00000104613.6,19817416,chr8-19841680-G-A,rs34564004,1,G,A,19841680,24264,19620808,20014024,220872
8,ENSG00000160886.9,142700111,chr8-142740610-C-T,rs34956412,1,C,T,142740610,40499,142503503,142896719,237107
8,ENSG00000104728.11,1823926,chr8-1906418-T-C,rs35174153,1,T,C,1906418,82492,1627318,2020534,279100
8,ENSG00000164695.4,81732448,chr8-81732207-G-A,rs3735701,1,G,A,81732207,241,81535840,81929056,196367
8,ENSG00000156482.6,98045545,chr8-98046165-A-C,rs3758031,-1,A,C,98046165,620,97848937,98242153,197228
8,ENSG00000204839.4,143572772,chr8-143582424-C-T,rs3793368,-1,C,T,143582424,9652,143376164,143769380,206260
8,ENSG00000104522.11,143617549,chr8-143582129-G-A,rs3793371,-1,G,A,143582129,35420,143420941,143814157,161188
8,ENSG00000175606.6,73976195,chr8-73982852-T-C,rs3816751,1,T,C,73982852,6657,73779587,74172803,203265
8,ENSG00000178685.8,143986460,chr8-143987456-C-T,rs3936211,-1,C,T,143987456,996,143789852,144183068,197604
8,ENSG00000104408.5,108248717,chr8-108091046-A-G,rs422847,-1,A,G,108091046,157671,108052109,108445325,38937
8,ENSG00000092964.10,26514031,chr8-26570093-G-A,rs424422,1,G,A,26570093,56062,26317423,26710639,252670
8,ENSG00000104472.5,140511322,chr8-140502973-C-G,rs4246129,1,C,G,140502973,8349,140314714,140707930,188259
8,ENSG00000104356.6,98117293,chr8-98155095-T-C,rs4305870,1,T,C,98155095,37802,97920685,98313901,234410
8,ENSG00000078674.11,17922988,chr8-18058112-A-C,rs431719,1,A,C,18058112,135124,17726380,18119596,331732
8,ENSG00000198363.9,61714592,chr8-61748634-A-C,rs4322003,-1,A,C,61748634,34042,61517984,61911200,230650
8,ENSG00000198363.9,61714592,chr8-61748634-A-G,rs4322003,-1,A,G,61748634,34042,61517984,61911200,230650
8,ENSG00000234616.3,142669967,chr8-142857551-G-A,rs4383949,-1,G,A,142857551,187584,142473359,142866575,384192
8,ENSG00000147459.12,25184689,chr8-25029429-C-T,rs4392898,1,C,T,25029429,155260,24988081,25381297,41348
8,ENSG00000187954.8,144462871,chr8-144375707-C-T,rs4407919,-1,C,T,144375707,87164,144266263,144659479,109444
8,ENSG00000254093.3,10839875,chr8-10988971-A-T,rs4484650,-1,A,T,10988971,149096,10643267,11036483,345704
8,ENSG00000153317.9,130443674,chr8-130479982-A-G,rs4601326,-1,A,G,130479982,36308,130247066,130640282,232916
8,ENSG00000164983.6,124372701,chr8-124392522-G-A,rs4612323,-1,G,A,124392522,19821,124176093,124569309,216429
8,ENSG00000169122.7,57994523,chr8-58141141-T-C,rs4738647,1,T,C,58141141,146618,57797915,58191131,343226
8,ENSG00000171033.8,78516340,chr8-78643913-T-C,rs4739134,1,T,C,78643913,127573,78319732,78712948,324181
8,ENSG00000079459.7,11802741,chr8-11844424-T-C,rs4839,1,T,C,11844424,41683,11606133,11999349,238291
8,ENSG00000164961.10,125091792,chr8-125105917-T-G,rs4871570,-1,T,G,125105917,14125,124895184,125288400,210733
8,ENSG00000168490.8,22232099,chr8-22263935-C-T,rs4872461,-1,C,T,22263935,31836,22035491,22428707,228444
8,ENSG00000160972.5,144477982,chr8-144460930-C-T,rs4925809,1,C,T,144460930,17052,144281374,144674590,179556
8,ENSG00000176623.7,86508686,chr8-86473939-T-C,rs4961193,-1,T,C,86473939,34747,86312078,86705294,161861
8,ENSG00000185000.4,144326852,chr8-144284925-C-A,rs4977199,-1,C,A,144284925,41927,144130244,144523460,154681
8,ENSG00000185000.4,144326852,chr8-144284925-C-G,rs4977199,-1,C,G,144284925,41927,144130244,144523460,154681
8,ENSG00000185900.5,43093515,chr8-43103864-C-A,rs5024011,1,C,A,43103864,10349,42896907,43290123,206957
8,ENSG00000186583.7,144012280,chr8-143992685-C-T,rs56261297,1,C,T,143992685,19595,143815672,144208888,177013
8,ENSG00000177459.6,98064568,chr8-98115756-C-G,rs57392722,1,C,G,98115756,51188,97867960,98261176,247796
8,ENSG00000181790.6,142449649,chr8-142513030-T-C,rs58371504,1,T,C,142513030,63381,142253041,142646257,259989
8,ENSG00000120875.4,29350684,chr8-29391930-G-T,rs586621,-1,G,T,29391930,41246,29154076,29547292,237854
8,ENSG00000066855.10,65644734,chr8-65799846-G-A,rs59198392,1,G,A,65799846,155112,65448126,65841342,351720
8,ENSG00000180921.6,143733779,chr8-143717088-G-T,rs61201083,-1,G,T,143717088,16691,143537171,143930387,179917
8,ENSG00000185189.11,143840973,chr8-143894828-A-G,rs6420192,-1,A,G,143894828,53855,143644365,144037581,250463
8,ENSG00000175895.3,95133785,chr8-95100475-C-A,rs6471520,1,C,A,95100475,33310,94937177,95330393,163298
8,ENSG00000197892.8,29263070,chr8-29239336-G-A,rs6558102,-1,G,A,29239336,23734,29066462,29459678,172874
8,ENSG00000197892.8,29263070,chr8-29239336-G-T,rs6558102,-1,G,T,29239336,23734,29066462,29459678,172874
8,ENSG00000181135.11,143684479,chr8-143690674-C-T,rs6558383,1,C,T,143690674,6195,143487871,143881087,202803
8,ENSG00000185730.3,143291417,chr8-143294322-G-A,rs6651419,1,G,A,143294322,2905,143094809,143488025,199513
8,ENSG00000161016.10,144792390,chr8-144770380-G-A,rs66716313,-1,G,A,144770380,22010,144595782,144988998,174598
8,ENSG00000104228.7,27311272,chr8-27316536-T-C,rs6981016,-1,T,C,27316536,5264,27114664,27507880,201872
8,ENSG00000147799.7,144685846,chr8-144588073-A-G,rs6989368,-1,A,G,144588073,97773,144489238,144882454,98835
8,ENSG00000171428.9,18210109,chr8-18350632-G-T,rs6993686,1,G,T,18350632,140523,18013501,18406717,337131
8,ENSG00000164841.4,108787594,chr8-108900907-G-A,rs6994782,-1,G,A,108900907,113313,108590986,108984202,309921
8,ENSG00000104442.5,65634177,chr8-65592869-T-C,rs6995242,-1,T,C,65592869,41308,65437569,65830785,155300
8,ENSG00000147647.7,104467055,chr8-104393693-G-A,rs6999483,-1,G,A,104393693,73362,104270447,104663663,123246
8,ENSG00000212993.3,127409026,chr8-127428683-A-G,rs6999921,1,A,G,127428683,19657,127212418,127605634,216265
8,ENSG00000158856.11,22056814,chr8-22111282-T-G,rs7000569,1,T,G,22111282,54468,21860206,22253422,251076
8,ENSG00000158106.8,143368876,chr8-143365185-A-G,rs7003432,1,A,G,143365185,3691,143172268,143565484,192917
8,ENSG00000215114.3,58411361,chr8-58405889-C-T,rs7007296,1,C,T,58405889,5472,58214753,58607969,191136
8,ENSG00000137574.6,55773446,chr8-55690279-A-G,rs7011147,1,A,G,55690279,83167,55576838,55970054,113441
8,ENSG00000147642.12,109644822,chr8-109800541-G-A,rs7011741,-1,G,A,109800541,155719,109448214,109841430,352327
8,ENSG00000147677.6,116755823,chr8-116905180-A-G,rs7014154,-1,A,G,116905180,149357,116559215,116952431,345965
8,ENSG00000198169.3,144755531,chr8-144839646-C-T,rs71520599,-1,C,T,144839646,84115,144558923,144952139,280723
8,ENSG00000147475.9,37736634,chr8-37731674-G-A,rs72641941,1,G,A,37731674,4960,37540026,37933242,191648
8,ENSG00000156172.5,95269201,chr8-95286404-A-G,rs73268354,-1,A,G,95286404,17203,95072593,95465809,213811
8,ENSG00000186523.9,12194082,chr8-12024892-C-T,rs73542355,-1,C,T,12024892,169190,11997474,12390690,27418
8,ENSG00000104419.9,133297252,chr8-133374094-A-C,rs737438,-1,A,C,133374094,76842,133100644,133493860,273450
8,ENSG00000008513.10,133571887,chr8-133452433-A-G,rs741901,-1,A,G,133452433,119454,133375279,133768495,77154
8,ENSG00000104361.5,98294235,chr8-98293135-G-A,rs7461545,-1,G,A,98293135,1100,98097627,98490843,195508
8,ENSG00000147457.9,23243637,chr8-23245692-A-G,rs7464232,1,A,G,23245692,2055,23047029,23440245,198663
8,ENSG00000120896.9,22551927,chr8-22587645-T-G,rs75622036,1,T,G,22587645,35718,22355319,22748535,232326
8,ENSG00000123908.7,140635633,chr8-140462990-G-T,rs75670848,-1,G,T,140462990,172643,140439025,140832241,23965
8,ENSG00000147804.5,144416844,chr8-144414270-T-C,rs75920625,-1,T,C,144414270,2574,144220236,144613452,194034
8,ENSG00000168575.5,42501231,chr8-42466429-C-T,rs76509575,-1,C,T,42466429,34802,42304623,42697839,161806
8,ENSG00000182307.8,145052467,chr8-145053635-G-A,rs77005838,1,G,A,145053635,1168,144855859,145249075,197776
8,ENSG00000179388.7,22693480,chr8-22630437-G-A,rs77509180,-1,G,A,22630437,63043,22496872,22890088,133565
8,ENSG00000164951.11,93916923,chr8-93919644-G-A,rs7814312,1,G,A,93919644,2721,93720315,94113531,199329
8,ENSG00000157110.11,30384541,chr8-30202788-C-T,rs7830778,1,C,T,30202788,181753,30187933,30581149,14855
8,ENSG00000136997.9,127736231,chr8-127802519-T-G,rs7844288,1,T,G,127802519,66288,127539623,127932839,262896
8,ENSG00000147548.10,38382271,chr8-38277894-T-C,rs7845911,-1,T,C,38277894,104377,38185663,38578879,92231
8,ENSG00000104524.9,143609575,chr8-143591786-C-A,rs79185314,-1,C,A,143591786,17789,143412967,143806183,178819
8,ENSG00000197275.7,94475115,chr8-94425145-G-A,rs882521,-1,G,A,94425145,49970,94278507,94671723,146638
8,ENSG00000066827.10,134713031,chr8-134600502-A-G,rs894344,-1,A,G,134600502,112529,134516423,134909639,84079
8,ENSG00000014164.5,143541447,chr8-143502610-A-G,rs896945,-1,A,G,143502610,38837,143344839,143738055,157771
8,ENSG00000136573.6,11494387,chr8-11494403-C-T,rs922483,1,C,T,11494403,16,11297779,11690995,196624
8,ENSG00000130193.7,142727223,chr8-142670817-T-C,rs9297976,1,T,C,142670817,56406,142530615,142923831,140202
8,ENSG00000180900.11,143815773,chr8-143648286-G-A,rs10098662,-1,G,A,143648286,167487,143619165,144012381,29121
8,ENSG00000120915.8,27491143,chr8-27544615-T-C,rs1042064,1,T,C,27544615,53472,27294535,27687751,250080
8,ENSG00000180694.9,90646083,chr8-90532649-C-T,rs10504895,-1,C,T,90532649,113434,90449475,90842691,83174
8,ENSG00000042832.6,132866958,chr8-132844972-C-A,rs10505602,1,C,A,132844972,21986,132670350,133063566,174622
8,ENSG00000253457.1,30638580,chr8-30618409-A-G,rs10955031,1,A,G,30618409,20171,30441972,30835188,176437
8,ENSG00000104325.2,90001477,chr8-90174490-C-T,rs10956500,1,C,T,90174490,173013,89804869,90198085,369621
8,ENSG00000185000.4,144326852,chr8-144210989-C-T,rs111281369,-1,C,T,144210989,115863,144130244,144523460,80745
8,ENSG00000158106.8,143368876,chr8-143220058-G-A,rs11136273,1,G,A,143220058,148818,143172268,143565484,47790
8,ENSG00000172748.7,232456,chr8-287333-T-G,rs11136516,1,T,G,287333,54877,35848,429064,251485
8,ENSG00000147437.5,25424261,chr8-25378082-C-G,rs111902374,-1,C,G,25378082,46179,25227653,25620869,150429
8,ENSG00000147548.10,38382271,chr8-38523585-G-A,rs112070057,-1,G,A,38523585,141314,38185663,38578879,337922
8,ENSG00000155087.3,102551589,chr8-102432898-G-A,rs113072599,1,G,A,102432898,118691,102354981,102748197,77917
8,ENSG00000167702.6,144466337,chr8-144524616-G-A,rs114251607,1,G,A,144524616,58279,144269729,144662945,254887
8,ENSG00000147649.5,97644184,chr8-97716023-G-A,rs116888747,1,G,A,97716023,71839,97447576,97840792,268447
8,ENSG00000186523.9,12194082,chr8-12024556-G-A,rs117391281,-1,G,A,12024556,169526,11997474,12390690,27082
8,ENSG00000120992.11,54101947,chr8-54071539-C-T,rs117617235,-1,C,T,54071539,30408,53905339,54298555,166200
8,ENSG00000036448.5,2045046,chr8-2147087-G-A,rs11774937,1,G,A,2147087,102041,1848438,2241654,298649
8,ENSG00000136960.7,119638839,chr8-119636347-G-A,rs11775064,-1,G,A,119636347,2492,119442231,119835447,194116
8,ENSG00000104228.7,27311272,chr8-27210635-C-T,rs11781760,-1,C,T,27210635,100637,27114664,27507880,95971
8,ENSG00000164695.4,81732448,chr8-81741409-A-G,rs11782652,1,A,G,81741409,8961,81535840,81929056,205569
8,ENSG00000254402.1,144527033,chr8-144614992-C-T,rs117889339,-1,C,T,144614992,87959,144330425,144723641,284567
8,ENSG00000104497.9,81842185,chr8-81858255-G-A,rs11987669,-1,G,A,81858255,16070,81645577,82038793,212678
8,ENSG00000132554.14,100106049,chr8-100258216-C-T,rs11988199,-1,C,T,100258216,152167,99909441,100302657,348775
8,ENSG00000132294.8,131904093,chr8-132036518-C-T,rs11991293,1,C,T,132036518,132425,131707485,132100701,329033
8,ENSG00000029534.14,41797622,chr8-41716164-T-C,rs11994013,-1,T,C,41716164,81458,41601014,41994230,115150
8,ENSG00000029534.14,41797622,chr8-41716164-T-G,rs11994013,-1,T,G,41716164,81458,41601014,41994230,115150
8,ENSG00000147684.3,124539123,chr8-124591057-G-A,rs11994203,1,G,A,124591057,51934,124342515,124735731,248542
8,ENSG00000104635.8,22367278,chr8-22189316-T-G,rs11994254,1,T,G,22189316,177962,22170670,22563886,18646
8,ENSG00000136982.5,119855894,chr8-119791414-C-T,rs11996390,-1,C,T,119791414,64480,119659286,120052502,132128
8,ENSG00000179698.9,144107739,chr8-144224185-C-T,rs12542298,1,C,T,144224185,116446,143911131,144304347,313054
8,ENSG00000171045.10,142403182,chr8-142437539-G-A,rs12544597,-1,G,A,142437539,34357,142206574,142599790,230965
8,ENSG00000185728.11,63168621,chr8-63300612-G-A,rs12544880,1,G,A,63300612,131991,62972013,63365229,328599
8,ENSG00000185122.5,144291604,chr8-144344210-C-T,rs12546042,1,C,T,144344210,52606,144094996,144488212,249214
8,ENSG00000185730.3,143291417,chr8-143474771-A-G,rs12547588,1,A,G,143474771,183354,143094809,143488025,379962
8,ENSG00000156787.11,123072707,chr8-123012583-A-G,rs12549382,1,A,G,123012583,60124,122876099,123269315,136484
8,ENSG00000183665.4,124450820,chr8-124542846-A-C,rs12550827,1,A,C,124542846,92026,124254212,124647428,288634
8,ENSG00000104756.11,25458433,chr8-25463078-T-C,rs12675625,-1,T,C,25463078,4645,25261825,25655041,201253
8,ENSG00000066855.10,65644734,chr8-65781884-C-A,rs1316700,1,C,A,65781884,137150,65448126,65841342,333758
8,ENSG00000176595.3,1973677,chr8-1967930-C-A,rs13250845,1,C,A,1967930,5747,1777069,2170285,190861
8,ENSG00000156170.7,95024989,chr8-95150736-A-G,rs13263827,1,A,G,95150736,125747,94828381,95221597,322355
8,ENSG00000171033.8,78516340,chr8-78521197-G-A,rs13275966,1,G,A,78521197,4857,78319732,78712948,201465
8,ENSG00000133731.5,81686325,chr8-81745458-C-T,rs13276421,-1,C,T,81745458,59133,81489717,81882933,255741
8,ENSG00000104728.11,1823926,chr8-1904259-A-G,rs13280012,1,A,G,1904259,80333,1627318,2020534,276941
8,ENSG00000179886.4,143597831,chr8-143722308-C-T,rs146972476,1,C,T,143722308,124477,143401223,143794439,321085
8,ENSG00000178860.8,71844412,chr8-72004486-G-C,rs1481849,-1,G,C,72004486,160074,71647804,72041020,356682
8,ENSG00000129691.10,38105529,chr8-38255288-C-T,rs16887289,1,C,T,38255288,149759,37908921,38302137,346367
8,ENSG00000104324.11,96645242,chr8-96568951-G-A,rs16894748,1,G,A,96568951,76291,96448634,96841850,120317
8,ENSG00000164749.7,75539869,chr8-75708759-G-A,rs16919400,1,G,A,75708759,168890,75343261,75736477,365498
8,ENSG00000008988.5,56074506,chr8-55941613-C-T,rs16922459,-1,C,T,55941613,132893,55877898,56271114,63715
8,ENSG00000171316.6,60678740,chr8-60849057-C-T,rs16926499,1,C,T,60849057,170317,60482132,60875348,366925
8,ENSG00000104381.8,74350403,chr8-74275130-A-G,rs16938845,1,A,G,74275130,75273,74153795,74547011,121335
8,ENSG00000253958.1,8701937,chr8-8719851-T-C,rs1703974,1,T,C,8719851,17914,8505329,8898545,214522
8,ENSG00000147459.12,25184689,chr8-25066127-A-G,rs17053062,1,A,G,25066127,118562,24988081,25381297,78046
8,ENSG00000092964.10,26514031,chr8-26409846-A-C,rs17055196,1,A,C,26409846,104185,26317423,26710639,92423
8,ENSG00000197217.8,23457647,chr8-23534805-A-G,rs17089331,-1,A,G,23534805,77158,23261039,23654255,273766
8,ENSG00000156011.11,19013703,chr8-19067626-G-A,rs17127771,-1,G,A,19067626,53923,18817095,19210311,250531
8,ENSG00000164983.6,124372701,chr8-124287543-C-A,rs17296758,-1,C,A,124287543,85158,124176093,124569309,111450
8,ENSG00000104361.5,98294235,chr8-98314531-G-A,rs17367639,-1,G,A,98314531,20296,98097627,98490843,216904
8,ENSG00000147576.11,66432504,chr8-66418110-G-A,rs17383243,1,G,A,66418110,14394,66235896,66629112,182214
8,ENSG00000156509.9,100145817,chr8-100291704-A-C,rs17422240,-1,A,C,100291704,145887,99949209,100342425,342495
8,ENSG00000104427.6,78666089,chr8-78777400-C-T,rs17505589,1,C,T,78777400,111311,78469481,78862697,307919
8,ENSG00000156103.11,88327483,chr8-88420771-A-G,rs17669974,-1,A,G,88420771,93288,88130875,88524091,289896
8,ENSG00000133739.10,85107238,chr8-84980203-C-T,rs17811680,1,C,T,84980203,127035,84910630,85303846,69573
8,ENSG00000104518.6,143558346,chr8-143580905-G-A,rs1809148,1,G,A,143580905,22559,143361738,143754954,219167
8,ENSG00000197275.7,94475115,chr8-94519191-T-C,rs1866844,-1,T,C,94519191,44076,94278507,94671723,240684
8,ENSG00000204839.4,143572772,chr8-143611669-C-T,rs2045084,-1,C,T,143611669,38897,143376164,143769380,235505
8,ENSG00000147364.11,406958,chr8-243585-G-A,rs2240379,1,G,A,243585,163373,210350,603566,33235
8,ENSG00000167701.9,144504140,chr8-144452086-A-G,rs2245052,1,A,G,144452086,52054,144307532,144700748,144554
8,ENSG00000147669.6,100150636,chr8-100150730-G-A,rs2254883,1,G,A,100150730,94,99954028,100347244,196702
8,ENSG00000160949.11,144444440,chr8-144414342-T-C,rs2272662,-1,T,C,144414342,30098,144247832,144641048,166510
8,ENSG00000155090.10,102655725,chr8-102604467-T-G,rs2436930,-1,T,G,102604467,51258,102459117,102852333,145350
8,ENSG00000156482.6,98045545,chr8-98009781-C-A,rs2444896,-1,C,A,98009781,35764,97848937,98242153,160844
8,ENSG00000164949.3,94262319,chr8-94241168-T-G,rs2448911,-1,T,G,94241168,21151,94065711,94458927,175457
8,ENSG00000104341.10,97775788,chr8-97773295-A-G,rs2449529,1,A,G,97773295,2493,97579180,97972396,194115
8,ENSG00000155097.7,103021083,chr8-102966471-C-T,rs2458286,1,C,T,102966471,54612,102824475,103217691,141996
8,ENSG00000184428.7,143334880,chr8-143355002-A-G,rs2467947,-1,A,G,143355002,20122,143138272,143531488,216730
8,ENSG00000169427.2,139703123,chr8-139551000-T-C,rs2542465,-1,T,C,139551000,152123,139506515,139899731,44485
8,ENSG00000104687.8,30727846,chr8-30708367-A-G,rs2551707,-1,A,G,30708367,19479,30531238,30924454,177129
8,ENSG00000187954.8,144462871,chr8-144533083-T-C,rs2620641,-1,T,C,144533083,70212,144266263,144659479,266820
8,ENSG00000079112.5,94208555,chr8-94225198-G-A,rs2623151,-1,G,A,94225198,16643,94011947,94405163,213251
8,ENSG00000104388.9,60516987,chr8-60643747-C-T,rs2680297,1,C,T,60643747,126760,60320379,60713595,323368
8,ENSG00000067167.3,70608416,chr8-70648189-C-T,rs268629,-1,C,T,70648189,39773,70411808,70805024,236381
8,ENSG00000137547.4,54135241,chr8-54296305-C-A,rs2719384,1,C,A,54296305,161064,53938633,54331849,357672
8,ENSG00000165392.5,31033810,chr8-31123685-A-G,rs2725353,1,A,G,31123685,89875,30837202,31230418,286483
8,ENSG00000035681.3,58659853,chr8-58770383-C-A,rs2726551,-1,C,A,58770383,110530,58463245,58856461,307138
8,ENSG00000035681.3,58659853,chr8-58770383-C-T,rs2726551,-1,C,T,58770383,110530,58463245,58856461,307138
8,ENSG00000172728.10,33473146,chr8-33438181-A-G,rs2732256,-1,A,G,33438181,34965,33276538,33669754,161643
8,ENSG00000155096.8,102864163,chr8-102767595-A-G,rs28608974,-1,A,G,102767595,96568,102667555,103060771,100040
8,ENSG00000165066.10,41650817,chr8-41632742-C-A,rs2920123,-1,C,A,41632742,18075,41454209,41847425,178533
8,ENSG00000165066.10,41650817,chr8-41632742-C-T,rs2920123,-1,C,T,41632742,18075,41454209,41847425,178533
8,ENSG00000104371.3,42377229,chr8-42549034-G-A,rs2923446,-1,G,A,42549034,171805,42180621,42573837,368413
8,ENSG00000008513.10,133571887,chr8-133529299-C-T,rs2945779,-1,C,T,133529299,42588,133375279,133768495,154020
8,ENSG00000132541.5,98117171,chr8-98076023-A-G,rs2959644,-1,A,G,98076023,41148,97920563,98313779,155460
8,ENSG00000176209.6,42541585,chr8-42600703-C-T,rs2974312,1,C,T,42600703,59118,42344977,42738193,255726
8,ENSG00000071894.9,144409335,chr8-144397883-C-G,rs2977834,-1,C,G,144397883,11452,144212727,144605943,185156
8,ENSG00000071894.9,144409335,chr8-144397883-C-T,rs2977834,-1,C,T,144397883,11452,144212727,144605943,185156
8,ENSG00000164761.4,118951885,chr8-118934568-G-A,rs3102724,-1,G,A,118934568,17317,118755277,119148493,179291
8,ENSG00000147650.6,104589258,chr8-104462707-T-C,rs3133278,-1,T,C,104462707,126551,104392650,104785866,70057
8,ENSG00000168490.8,22232099,chr8-22047380-G-A,rs3176300,-1,G,A,22047380,184719,22035491,22428707,11889
8,ENSG00000154359.8,12755526,chr8-12770785-C-T,rs35735067,-1,C,T,12770785,15259,12558918,12952134,211867
8,ENSG00000205002.3,116938207,chr8-116837735-G-A,rs35811513,1,G,A,116837735,100472,116741599,117134815,96136
8,ENSG00000130193.7,142727223,chr8-142743190-C-T,rs3758083,1,C,T,142743190,15967,142530615,142923831,212575
8,ENSG00000198846.4,59119147,chr8-59000178-T-C,rs380013,-1,T,C,59000178,118969,58922539,59315755,77639
8,ENSG00000167700.3,144509070,chr8-144359179-T-C,rs3817681,1,T,C,144359179,149891,144312462,144705678,46717
8,ENSG00000164924.12,100952020,chr8-100975998-G-A,rs4002957,-1,G,A,100975998,23978,100755412,101148628,220586
8,ENSG00000180938.5,124973295,chr8-124789618-C-T,rs4075472,1,C,T,124789618,183677,124776687,125169903,12931
8,ENSG00000160959.3,144517992,chr8-144516318-C-G,rs4244612,1,C,G,144516318,1674,144321384,144714600,194934
8,ENSG00000104312.6,89757816,chr8-89766285-G-A,rs42490,1,G,A,89766285,8469,89561208,89954424,205077
8,ENSG00000120910.10,22441078,chr8-22311574-A-G,rs4266653,1,A,G,22311574,129504,22244470,22637686,67104
8,ENSG00000215114.3,58411361,chr8-58386587-T-C,rs4379435,1,T,C,58386587,24774,58214753,58607969,171834
8,ENSG00000175305.11,94895201,chr8-94702955-T-C,rs4443628,-1,T,C,94702955,192246,94698593,95091809,4362
8,ENSG00000136986.4,123042302,chr8-122872543-A-G,rs4593547,-1,A,G,122872543,169759,122845694,123238910,26849
8,ENSG00000175895.3,95133785,chr8-95073089-C-T,rs4641029,1,C,T,95073089,60696,94937177,95330393,135912
8,ENSG00000120963.7,101205673,chr8-101334181-G-A,rs477351,-1,G,A,101334181,128508,101009065,101402281,325116
8,ENSG00000014164.5,143541447,chr8-143488567-T-C,rs4874139,-1,T,C,143488567,52880,143344839,143738055,143728
8,ENSG00000022567.5,141308288,chr8-141327343-T-C,rs4961265,-1,T,C,141327343,19055,141111680,141504896,215663
8,ENSG00000147324.6,8893630,chr8-8772759-A-C,rs506960,-1,A,C,8772759,120871,8697022,9090238,75737
8,ENSG00000085719.7,86514435,chr8-86657515-G-A,rs59109039,1,G,A,86657515,143080,86317827,86711043,339688
8,ENSG00000160932.6,143018529,chr8-142912850-A-G,rs61757294,1,A,G,142912850,105679,142821921,143215137,90929
8,ENSG00000167034.8,23682938,chr8-23523230-C-A,rs62503281,-1,C,A,23523230,159708,23486330,23879546,36900
8,ENSG00000205189.6,80486226,chr8-80580348-T-G,rs62515087,1,T,G,80580348,94122,80289618,80682834,290730
8,ENSG00000157110.11,30384541,chr8-30255416-T-G,rs6468234,1,T,G,30255416,129125,30187933,30581149,67483
8,ENSG00000173273.10,9555912,chr8-9371253-G-T,rs6601300,1,G,T,9371253,184659,9359304,9752520,11949
8,ENSG00000133874.1,33567128,chr8-33403199-G-A,rs6998432,-1,G,A,33403199,163929,33370520,33763736,32679
8,ENSG00000104490.12,101790969,chr8-101938908-T-C,rs7003289,-1,T,C,101938908,147939,101594361,101987577,344547
8,ENSG00000164823.5,89902570,chr8-89863690-T-C,rs7015630,1,T,C,89863690,38880,89705962,90099178,157728
8,ENSG00000104356.6,98117293,chr8-98188342-T-C,rs7016814,1,T,C,98188342,71049,97920685,98313901,267657
8,ENSG00000168078.5,27837817,chr8-27946864-T-C,rs71519661,-1,T,C,27946864,109047,27641209,28034425,305655
8,ENSG00000042980.8,24294069,chr8-24351834-C-T,rs73217065,1,C,T,24351834,57765,24097461,24490677,254373
8,ENSG00000173530.5,23164027,chr8-23162697-G-A,rs73222565,-1,G,A,23162697,1330,22967419,23360635,195278
8,ENSG00000156795.2,123416774,chr8-123451804-C-T,rs7341643,1,C,T,123451804,35030,123220166,123613382,231638
8,ENSG00000070756.8,100722088,chr8-100600051-C-T,rs73699411,-1,C,T,100600051,122037,100525480,100918696,74571
8,ENSG00000175806.10,10054292,chr8-10137779-C-T,rs74357253,1,C,T,10137779,83487,9857684,10250900,280095
8,ENSG00000175806.10,10054292,chr8-10137779-C-A,rs74357253,1,C,A,10137779,83487,9857684,10250900,280095
8,ENSG00000159167.6,23854806,chr8-23798595-A-G,rs75009409,-1,A,G,23798595,56211,23658198,24051414,140397
8,ENSG00000168453.10,22131010,chr8-22181500-G-T,rs75755104,-1,G,T,22181500,50490,21934402,22327618,247098
8,ENSG00000158941.12,22604757,chr8-22460519-C-T,rs76564756,1,C,T,22460519,144238,22408149,22801365,52370
8,ENSG00000180543.3,97277928,chr8-97262093-T-C,rs76602935,-1,T,C,97262093,15835,97081320,97474536,180773
8,ENSG00000104313.12,71362069,chr8-71358716-T-C,rs76981761,-1,T,C,71358716,3353,71165461,71558677,193255
8,ENSG00000183117.10,4994914,chr8-5032626-G-A,rs77220086,-1,G,A,5032626,37712,4798306,5191522,234320
8,ENSG00000212993.3,127409026,chr8-127556093-G-A,rs77288742,1,G,A,127556093,147067,127212418,127605634,343675
8,ENSG00000147434.4,42768786,chr8-42907811-C-T,rs773072,-1,C,T,42907811,139025,42572178,42965394,335633
8,ENSG00000104517.7,102412700,chr8-102312052-A-G,rs77523118,-1,A,G,102312052,100648,102216092,102609308,95960
8,ENSG00000104517.7,102412700,chr8-102312052-A-T,rs77523118,-1,A,T,102312052,100648,102216092,102609308,95960
8,ENSG00000104321.5,72075584,chr8-71953326-G-A,rs77887183,-1,G,A,71953326,122258,71878976,72272192,74350
8,ENSG00000177669.3,30144665,chr8-30138740-T-C,rs7813902,-1,T,C,30138740,5925,29948057,30341273,190683
8,ENSG00000104472.5,140511322,chr8-140505151-A-C,rs7814184,1,A,C,140505151,6171,140314714,140707930,190437
8,ENSG00000164934.8,103415386,chr8-103354539-G-C,rs7814419,1,G,C,103354539,60847,103218778,103611994,135761
8,ENSG00000253598.1,81695058,chr8-81545273-C-T,rs78153152,-1,C,T,81545273,149785,81498450,81891666,46823
8,ENSG00000104219.8,17156482,chr8-17172466-C-T,rs7827043,1,C,T,17172466,15984,16959874,17353090,212592
8,ENSG00000121022.9,67062133,chr8-66996827-T-C,rs7831045,-1,T,C,66996827,65306,66865525,67258741,131302
8,ENSG00000161016.10,144792390,chr8-144785726-T-A,rs7833780,-1,T,A,144785726,6664,144595782,144988998,189944
8,ENSG00000161016.10,144792390,chr8-144785726-T-G,rs7833780,-1,T,G,144785726,6664,144595782,144988998,189944
8,ENSG00000147604.9,73293633,chr8-73349099-A-G,rs7835634,-1,A,G,73349099,55466,73097025,73490241,252074
8,ENSG00000197858.6,144082634,chr8-144113921-T-C,rs7836836,1,T,C,144113921,31287,143886026,144279242,227895
8,ENSG00000179526.12,144103773,chr8-144123972-G-A,rs7837375,-1,G,A,144123972,20199,143907165,144300381,216807
8,ENSG00000172167.3,120445419,chr8-120566847-T-C,rs7845125,1,T,C,120566847,121428,120248811,120642027,318036
8,ENSG00000196150.7,144901453,chr8-145000270-C-T,rs79615697,-1,C,T,145000270,98817,144704845,145098061,295425
8,ENSG00000178814.11,144060692,chr8-144042819-T-C,rs79832570,-1,T,C,144042819,17873,143864084,144257300,178735
8,ENSG00000154328.9,11769710,chr8-11769124-C-T,rs8191513,1,C,T,11769124,586,11573102,11966318,196022
8,ENSG00000079459.7,11802741,chr8-11758829-A-C,rs867858,1,A,C,11758829,43912,11606133,11999349,152696
8,ENSG00000153310.12,129939832,chr8-130015092-A-G,rs874617,-1,A,G,130015092,75260,129743224,130136440,271868
8,ENSG00000160886.9,142700111,chr8-142670817-T-C,rs9297976,1,T,C,142670817,29294,142503503,142896719,167314
8,ENSG00000120903.5,27479261,chr8-27616685-A-G,rs9314349,-1,A,G,27616685,137424,27282653,27675869,334032
8,ENSG00000156471.8,96261902,chr8-96425359-T-C,rs958402,1,T,C,96425359,163457,96065294,96458510,360065
8,ENSG00000147654.10,109540173,chr8-109458129-T-C,rs9643050,1,T,C,109458129,82044,109343565,109736781,114564
8,ENSG00000121039.5,73294602,chr8-73411653-G-A,rs9643663,1,G,A,73411653,117051,73097994,73491210,313659
8,ENSG00000154319.10,11466753,chr8-11465516-G-A,rs9644687,-1,G,A,11465516,1237,11270145,11663361,195371
8,ENSG00000203499.6,143734139,chr8-143538845-C-T,rs10081449,1,C,T,143538845,195294,143537531,143930747,1314
8,ENSG00000168300.9,51899036,chr8-52011220-G-A,rs10088713,-1,G,A,52011220,112184,51702428,52095644,308792
8,ENSG00000104689.5,23225102,chr8-23281923-C-T,rs10091786,-1,C,T,23281923,56821,23028494,23421710,253429
8,ENSG00000134014.11,28093139,chr8-28228291-T-C,rs10094977,1,T,C,28228291,135152,27896531,28289747,331760
8,ENSG00000159167.6,23854806,chr8-23859057-G-A,rs10108951,-1,G,A,23859057,4251,23658198,24051414,200859
8,ENSG00000159167.6,23854806,chr8-23859057-G-C,rs10108951,-1,G,C,23859057,4251,23658198,24051414,200859
8,ENSG00000198846.4,59119147,chr8-59305648-C-T,rs10481228,-1,C,T,59305648,186501,58922539,59315755,383109
8,ENSG00000104611.7,19313693,chr8-19357392-A-T,rs10503655,1,A,T,19357392,43699,19117085,19510301,240307
8,ENSG00000014164.5,143541447,chr8-143531747-G-A,rs1077272,-1,G,A,143531747,9700,143344839,143738055,186908
8,ENSG00000104518.6,143558346,chr8-143568377-G-A,rs11136302,1,G,A,143568377,10031,143361738,143754954,206639
8,ENSG00000186106.7,100559759,chr8-100704967-G-C,rs113574896,-1,G,C,100704967,145208,100363151,100756367,341816
8,ENSG00000104332.6,41309473,chr8-41144576-G-A,rs117984023,-1,G,A,41144576,164897,41112865,41506081,31711
8,ENSG00000012232.4,28701501,chr8-28824247-A-G,rs11985067,1,A,G,28824247,122746,28504893,28898109,319354
8,ENSG00000179698.9,144107739,chr8-144077730-T-C,rs11990558,1,T,C,144077730,30009,143911131,144304347,166599
8,ENSG00000155189.7,6708642,chr8-6728721-C-G,rs11991276,1,C,G,6728721,20079,6512034,6905250,216687
8,ENSG00000213563.2,144529111,chr8-144613673-C-T,rs11991859,-1,C,T,144613673,84562,144332503,144725719,281170
8,ENSG00000183665.4,124450820,chr8-124591057-G-A,rs11994203,1,G,A,124591057,140237,124254212,124647428,336845
8,ENSG00000177669.3,30144665,chr8-30100300-G-A,rs12386822,-1,G,A,30100300,44365,29948057,30341273,152243
8,ENSG00000136982.5,119855894,chr8-119776846-A-G,rs12541733,-1,A,G,119776846,79048,119659286,120052502,117560
8,ENSG00000178685.8,143986460,chr8-143871023-T-C,rs12543389,-1,T,C,143871023,115437,143789852,144183068,81171
8,ENSG00000173535.8,23102921,chr8-23231650-C-T,rs12543863,1,C,T,23231650,128729,22906313,23299529,325337
8,ENSG00000173535.8,23102921,chr8-23231650-C-A,rs12543863,1,C,A,23231650,128729,22906313,23299529,325337
8,ENSG00000147724.7,138497261,chr8-138604522-C-T,rs12543875,-1,C,T,138604522,107261,138300653,138693869,303869
8,ENSG00000022567.5,141308288,chr8-141237291-A-C,rs12550677,-1,A,C,141237291,70997,141111680,141504896,125611
8,ENSG00000179886.4,143597831,chr8-143538172-T-C,rs1318196,1,T,C,143538172,59659,143401223,143794439,136949
8,ENSG00000015592.12,27258404,chr8-27120202-G-A,rs13270044,-1,G,A,27120202,138202,27061796,27455012,58406
8,ENSG00000160957.7,144517833,chr8-144350803-C-T,rs13280387,-1,C,T,144350803,167030,144321225,144714441,29578
8,ENSG00000064313.7,119832841,chr8-119854708-C-T,rs1509347,-1,C,T,119854708,21867,119636233,120029449,218475
8,ENSG00000147677.6,116755823,chr8-116612244-G-T,rs1529943,-1,G,T,116612244,143579,116559215,116952431,53029
8,ENSG00000168081.4,28317268,chr8-28305781-A-T,rs1531382,1,A,T,28305781,11487,28120660,28513876,185121
8,ENSG00000155097.7,103021083,chr8-103078050-A-T,rs1566159,1,A,T,103078050,56967,102824475,103217691,253575
8,ENSG00000164929.12,103140725,chr8-103112886-C-G,rs16870122,1,C,G,103112886,27839,102944117,103337333,168769
8,ENSG00000253457.1,30638580,chr8-30487075-G-A,rs16877081,1,G,A,30487075,151505,30441972,30835188,45103
8,ENSG00000205038.7,109362461,chr8-109491989-A-G,rs16879659,1,A,G,109491989,129528,109165853,109559069,326136
8,ENSG00000104371.3,42377229,chr8-42428608-A-C,rs16891316,-1,A,C,42428608,51379,42180621,42573837,247987
8,ENSG00000136960.7,119638839,chr8-119632193-T-C,rs16892900,-1,T,C,119632193,6646,119442231,119835447,189962
8,ENSG00000164684.9,80874781,chr8-81002555-T-C,rs16908311,-1,T,C,81002555,127774,80678173,81071389,324382
8,ENSG00000076641.3,81112068,chr8-81106908-T-C,rs16908611,-1,T,C,81106908,5160,80915460,81308676,191448
8,ENSG00000008988.5,56074506,chr8-55979671-T-C,rs16922508,-1,T,C,55979671,94835,55877898,56271114,101773
8,ENSG00000140396.7,70403808,chr8-70287874-C-T,rs16936880,-1,C,T,70287874,115934,70207200,70600416,80674
8,ENSG00000189233.7,28083936,chr8-27900272-G-A,rs17058183,-1,G,A,27900272,183664,27887328,28280544,12944
8,ENSG00000129422.9,17801094,chr8-17893869-A-C,rs17125822,-1,A,C,17893869,92775,17604486,17997702,289383
8,ENSG00000164933.5,103415107,chr8-103231186-C-T,rs17205590,-1,C,T,103231186,183921,103218499,103611715,12687
8,ENSG00000164749.7,75539869,chr8-75433826-A-G,rs17303366,1,A,G,75433826,106043,75343261,75736477,90565
8,ENSG00000161016.10,144792390,chr8-144843209-T-C,rs1735408,-1,T,C,144843209,50819,144595782,144988998,247427
8,ENSG00000137547.4,54135241,chr8-54262259-C-T,rs17394176,1,C,T,54262259,127018,53938633,54331849,323626
8,ENSG00000156172.5,95269201,chr8-95295916-C-T,rs17669929,-1,C,T,95295916,26715,95072593,95465809,223323
8,ENSG00000154359.8,12755526,chr8-12842662-C-T,rs17769628,-1,C,T,12842662,87136,12558918,12952134,283744
8,ENSG00000165392.5,31033810,chr8-31081188-G-A,rs1800391,1,G,A,31081188,47378,30837202,31230418,243986
8,ENSG00000077782.14,38468635,chr8-38482283-A-G,rs184491,-1,A,G,38482283,13648,38272027,38665243,210256
8,ENSG00000156482.6,98045545,chr8-97979053-C-T,rs1869607,-1,C,T,97979053,66492,97848937,98242153,130116
8,ENSG00000206579.5,55102028,chr8-55036970-T-C,rs1904861,1,T,C,55036970,65058,54905420,55298636,131550
8,ENSG00000177570.9,118621963,chr8-118593364-T-C,rs1915541,-1,T,C,118593364,28599,118425355,118818571,168009
8,ENSG00000168619.10,39584568,chr8-39766052-C-T,rs202012,1,C,T,39766052,181484,39387960,39781176,378092
8,ENSG00000155090.10,102655725,chr8-102534207-A-C,rs2033561,-1,A,C,102534207,121518,102459117,102852333,75090
8,ENSG00000183779.4,37695782,chr8-37628233-C-A,rs2051166,1,C,A,37628233,67549,37499174,37892390,129059
8,ENSG00000183779.4,37695782,chr8-37628233-C-G,rs2051166,1,C,G,37628233,67549,37499174,37892390,129059
8,ENSG00000123119.7,90791775,chr8-90874797-C-T,rs2129260,1,C,T,90874797,83022,90595167,90988383,279630
8,ENSG00000132541.5,98117171,chr8-98033750-A-C,rs2255464,-1,A,C,98033750,83421,97920563,98313779,113187
8,ENSG00000104529.12,143597415,chr8-143610015-A-G,rs2278897,-1,A,G,143610015,12600,143400807,143794023,209208
8,ENSG00000156162.12,94719900,chr8-94873321-C-T,rs2305466,1,C,T,94873321,153421,94523292,94916508,350029
8,ENSG00000175324.5,38176493,chr8-38238144-C-T,rs2306899,-1,C,T,38238144,61651,37979885,38373101,258259
8,ENSG00000104419.9,133297252,chr8-133438238-G-T,rs2403981,-1,G,T,133438238,140986,133100644,133493860,337594
8,ENSG00000104517.7,102412700,chr8-102600480-T-C,rs2436929,-1,T,C,102600480,187780,102216092,102609308,384388
8,ENSG00000104517.7,102412700,chr8-102600480-T-G,rs2436929,-1,T,G,102600480,187780,102216092,102609308,384388
8,ENSG00000120963.7,101205673,chr8-101191462-C-T,rs2441706,-1,C,T,101191462,14211,101009065,101402281,182397
8,ENSG00000177459.6,98064568,chr8-98076685-T-C,rs2513829,1,T,C,98076685,12117,97867960,98261176,208725
8,ENSG00000104341.10,97775788,chr8-97773257-C-G,rs2513985,1,C,G,97773257,2531,97579180,97972396,194077
8,ENSG00000164949.3,94262319,chr8-94169018-G-A,rs2514809,-1,G,A,94169018,93301,94065711,94458927,103307
8,ENSG00000169427.2,139703123,chr8-139543601-A-G,rs2542474,-1,A,G,139543601,159522,139506515,139899731,37086
8,ENSG00000104231.6,81721300,chr8-81591764-C-T,rs2581529,-1,C,T,81591764,129536,81524692,81917908,67072
8,ENSG00000071894.9,144409335,chr8-144465013-A-C,rs2620645,-1,A,C,144465013,55678,144212727,144605943,252286
8,ENSG00000164823.5,89902570,chr8-89937652-A-C,rs2697679,1,A,C,89937652,35082,89705962,90099178,231690
8,ENSG00000147475.9,37736634,chr8-37629558-A-G,rs2843749,1,A,G,37629558,107076,37540026,37933242,89532
8,ENSG00000104432.7,78805463,chr8-78880811-G-A,rs28529281,-1,G,A,78880811,75348,78608855,79002071,271956
8,ENSG00000147647.7,104467055,chr8-104401528-T-C,rs2853158,-1,T,C,104401528,65527,104270447,104663663,131081
8,ENSG00000187840.4,38030534,chr8-38025920-T-C,rs28813686,1,T,C,38025920,4614,37833926,38227142,191994
8,ENSG00000164695.4,81732448,chr8-81701224-C-T,rs2932223,1,C,T,81701224,31224,81535840,81929056,165384
8,ENSG00000253598.1,81695058,chr8-81706019-A-C,rs2955005,-1,A,C,81706019,10961,81498450,81891666,207569
8,ENSG00000104219.8,17156482,chr8-17169343-T-C,rs2959634,1,T,C,17169343,12861,16959874,17353090,209469
8,ENSG00000183117.10,4994914,chr8-4983334-T-G,rs2977729,-1,T,G,4983334,11580,4798306,5191522,185028
8,ENSG00000120526.6,109334087,chr8-109336020-A-T,rs2980571,-1,A,T,109336020,1933,109137479,109530695,198541
8,ENSG00000034677.7,100309953,chr8-100150218-C-T,rs3133677,-1,C,T,100150218,159735,100113345,100506561,36873
8,ENSG00000181135.11,143684479,chr8-143869993-C-T,rs35221054,1,C,T,143869993,185514,143487871,143881087,382122
8,ENSG00000104290.6,28494212,chr8-28587741-C-T,rs352418,1,C,T,28587741,93529,28297604,28690820,290137
8,ENSG00000171045.10,142403182,chr8-142393591-C-A,rs35755256,-1,C,A,142393591,9591,142206574,142599790,187017
8,ENSG00000156795.2,123416774,chr8-123395606-C-T,rs3779983,1,C,T,123395606,21168,123220166,123613382,175440
8,ENSG00000170631.10,144950880,chr8-144948250-T-C,rs3808375,-1,T,C,144948250,2630,144754272,145147488,193978
8,ENSG00000104679.6,23288108,chr8-23304420-C-T,rs3808526,1,C,T,23304420,16312,23091500,23484716,212920
8,ENSG00000104679.6,23288108,chr8-23304420-C-G,rs3808526,1,C,G,23304420,16312,23091500,23484716,212920
8,ENSG00000160932.6,143018529,chr8-142837677-G-T,rs388963,1,G,T,142837677,180852,142821921,143215137,15756
8,ENSG00000184489.7,141392021,chr8-141401930-C-T,rs4073027,1,C,T,141401930,9909,141195413,141588629,206517
8,ENSG00000104267.4,85464007,chr8-85535479-C-T,rs414922,1,C,T,85535479,71472,85267399,85660615,268080
8,ENSG00000253250.2,90985238,chr8-91051873-T-C,rs4467904,-1,T,C,91051873,66635,90788630,91181846,263243
8,ENSG00000164951.11,93916923,chr8-93980594-A-C,rs4631428,1,A,C,93980594,63671,93720315,94113531,260279
8,ENSG00000147650.6,104589258,chr8-104688355-T-C,rs4734805,-1,T,C,104688355,99097,104392650,104785866,295705
8,ENSG00000175895.3,95133785,chr8-94955610-A-G,rs481887,1,A,G,94955610,178175,94937177,95330393,18433
8,ENSG00000186523.9,12194082,chr8-12002231-A-C,rs4841663,-1,A,C,12002231,191851,11997474,12390690,4757
8,ENSG00000185730.3,143291417,chr8-143451060-T-G,rs4874129,1,T,G,143451060,159643,143094809,143488025,356251
8,ENSG00000253958.1,8701937,chr8-8772759-A-C,rs506960,1,A,C,8772759,70822,8505329,8898545,267430
8,ENSG00000120885.13,27614700,chr8-27612623-G-T,rs545243,-1,G,T,27612623,2077,27418092,27811308,194531
8,ENSG00000176209.6,42541585,chr8-42482116-G-A,rs55840085,1,G,A,42482116,59469,42344977,42738193,137139
8,ENSG00000176853.10,123768439,chr8-123886749-C-A,rs62518670,1,C,A,123886749,118310,123571831,123965047,314918
8,ENSG00000164924.12,100952020,chr8-101054030-C-T,rs6468755,-1,C,T,101054030,102010,100755412,101148628,298618
8,ENSG00000164924.12,100952020,chr8-101054030-C-A,rs6468755,-1,C,A,101054030,102010,100755412,101148628,298618
8,ENSG00000158815.6,22042820,chr8-22131002-A-C,rs6557841,1,A,C,22131002,88182,21846212,22239428,284790
8,ENSG00000104213.7,17577216,chr8-17670847-C-T,rs6586622,1,C,T,17670847,93631,17380608,17773824,290239
8,ENSG00000196150.7,144901453,chr8-144993123-C-T,rs6599549,-1,C,T,144993123,91670,144704845,145098061,288278
8,ENSG00000171316.6,60678740,chr8-60791524-G-A,rs6982898,1,G,A,60791524,112784,60482132,60875348,309392
8,ENSG00000104497.9,81842185,chr8-81937935-C-T,rs6989360,-1,C,T,81937935,95750,81645577,82038793,292358
8,ENSG00000197892.8,29263070,chr8-29159570-A-G,rs6994211,-1,A,G,29159570,103500,29066462,29459678,93108
8,ENSG00000173281.4,9150658,chr8-9087592-A-C,rs7009435,-1,A,C,9087592,63066,8954050,9347266,133542
8,ENSG00000120915.8,27491143,chr8-27524479-C-G,rs721619,1,C,G,27524479,33336,27294535,27687751,229944
8,ENSG00000185728.11,63168621,chr8-63322084-A-G,rs72661748,1,A,G,63322084,153463,62972013,63365229,350071
8,ENSG00000185000.4,144326852,chr8-144286837-G-A,rs73374024,-1,G,A,144286837,40015,144130244,144523460,156593
8,ENSG00000168172.3,42896978,chr8-42766752-A-G,rs73633798,1,A,G,42766752,130226,42700370,43093586,66382
8,ENSG00000147789.10,144827560,chr8-145008844-G-A,rs74622951,1,G,A,145008844,181284,144630952,145024168,377892
8,ENSG00000172728.10,33473146,chr8-33498805-G-A,rs76212197,-1,G,A,33498805,25659,33276538,33669754,222267
8,ENSG00000184428.7,143334880,chr8-143408005-C-T,rs76317216,-1,C,T,143408005,73125,143138272,143531488,269733
8,ENSG00000168575.5,42501231,chr8-42571503-T-C,rs76831292,-1,T,C,42571503,70272,42304623,42697839,266880
8,ENSG00000104356.6,98117293,chr8-98193386-T-G,rs76909221,1,T,G,98193386,76093,97920685,98313901,272701
8,ENSG00000164761.4,118951885,chr8-118897855-G-A,rs76936579,-1,G,A,118897855,54030,118755277,119148493,142578
8,ENSG00000164930.6,103298898,chr8-103354539-G-C,rs7814419,1,G,C,103354539,55641,103102290,103495506,252249
8,ENSG00000137574.6,55773446,chr8-55757421-T-C,rs7828202,1,T,C,55757421,16025,55576838,55970054,180583
8,ENSG00000130227.11,21919662,chr8-22109838-G-A,rs7831322,1,G,A,22109838,190176,21723054,22116270,386784
8,ENSG00000158106.8,143368876,chr8-143215394-C-T,rs78367243,1,C,T,143215394,153482,143172268,143565484,43126
8,ENSG00000165066.10,41650817,chr8-41742607-T-G,rs7836809,-1,T,G,41742607,91790,41454209,41847425,288398
8,ENSG00000104660.13,30095408,chr8-30058458-C-T,rs7846290,1,C,T,30058458,36950,29898800,30292016,159658
8,ENSG00000133878.4,33600023,chr8-33657457-C-G,rs79243249,-1,C,G,33657457,57434,33403415,33796631,254042
8,ENSG00000129292.15,132775388,chr8-132905374-C-T,rs79609056,1,C,T,132905374,129986,132578780,132971996,326594
8,ENSG00000169398.14,141001233,chr8-141172781-C-T,rs80336336,-1,C,T,141172781,171548,140804625,141197841,368156
8,ENSG00000204839.4,143572772,chr8-143558336-G-C,rs80346174,-1,G,C,143558336,14436,143376164,143769380,182172
8,ENSG00000079459.7,11802741,chr8-11769124-C-T,rs8191513,1,C,T,11769124,33617,11606133,11999349,162991
8,ENSG00000167904.9,55773378,chr8-55789424-G-A,rs896126,-1,G,A,55789424,16046,55576770,55969986,212654
8,ENSG00000205189.6,80486226,chr8-80441419-G-A,rs9298338,1,G,A,80441419,44807,80289618,80682834,151801
8,ENSG00000179041.2,66429014,chr8-66270480-T-G,rs9792363,1,T,G,66270480,158534,66232406,66625622,38074
7,ENSG00000240583.5,30911853,chr7-30797387-A-G,rs1017012,1,A,G,30797387,114466,30715245,31108461,82142
7,ENSG00000106125.14,30771417,chr7-30797387-A-G,rs1017012,1,A,G,30797387,25970,30574809,30968025,222578
7,ENSG00000215018.4,7535873,chr7-7572218-G-C,rs10236767,-1,G,C,7572218,36345,7339265,7732481,232953
7,ENSG00000128607.8,130070534,chr7-130160005-G-A,rs10241132,1,G,A,130160005,89471,129873926,130267142,286079
7,ENSG00000146574.10,6826275,chr7-6831004-G-A,rs10242703,-1,G,A,6831004,4729,6629667,7022883,201337
7,ENSG00000122643.13,33062776,chr7-33055370-C-T,rs10251079,-1,C,T,33055370,7406,32866168,33259384,189202
7,ENSG00000214960.5,16421538,chr7-16373856-C-T,rs10257504,-1,C,T,16373856,47682,16224930,16618146,148926
7,ENSG00000106404.9,101237802,chr7-101250677-G-A,rs10260813,-1,G,A,101250677,12875,101041194,101434410,209483
7,ENSG00000257093.2,141702166,chr7-141698907-A-G,rs10261515,-1,A,G,141698907,3259,141505558,141898774,193349
7,ENSG00000146828.11,100852713,chr7-100702383-C-T,rs10266044,1,C,T,100702383,150330,100656105,101049321,46278
7,ENSG00000153790.7,25180354,chr7-25092564-A-G,rs10268780,-1,A,G,25092564,87790,24983746,25376962,108818
7,ENSG00000087077.7,100867387,chr7-100918383-A-C,rs10278546,1,A,C,100918383,50996,100670779,101063995,247604
7,ENSG00000205413.3,93117979,chr7-93238211-G-A,rs10280473,-1,G,A,93238211,120232,92921371,93314587,316840
7,ENSG00000164715.5,98106862,chr7-98102388-G-A,rs10282336,1,G,A,98102388,4474,97910254,98303470,192134
7,ENSG00000106538.5,150341629,chr7-150348213-G-A,rs10282458,-1,G,A,150348213,6584,150145021,150538237,203192
7,ENSG00000196683.6,22822849,chr7-22810714-C-T,rs1029741,-1,C,T,22810714,12135,22626241,23019457,184473
7,ENSG00000170852.5,32891760,chr7-32869092-T-C,rs1045477,-1,T,C,32869092,22668,32695152,33088368,173940
7,ENSG00000164654.11,7566884,chr7-7506060-G-C,rs10486176,1,G,C,7506060,60824,7370276,7763492,135784
7,ENSG00000122644.8,12687633,chr7-12780976-G-A,rs10488233,1,G,A,12780976,93343,12491025,12884241,289951
7,ENSG00000196456.4,150379330,chr7-150250995-A-C,rs10488347,1,A,C,150250995,128335,150182722,150575938,68273
7,ENSG00000172331.7,134646853,chr7-134640553-T-C,rs10488433,1,T,C,134640553,6300,134450245,134843461,190308
7,ENSG00000122786.13,134779634,chr7-134720850-T-C,rs10488453,1,T,C,134720850,58784,134583026,134976242,137824
7,ENSG00000122786.13,134779634,chr7-134720850-T-A,rs10488453,1,T,A,134720850,58784,134583026,134976242,137824
7,ENSG00000186645.6,77032361,chr7-77204749-A-G,rs10488499,-1,A,G,77204749,172388,76835753,77228969,368996
7,ENSG00000225968.4,1670277,chr7-1748644-G-C,rs10950352,1,G,C,1748644,78367,1473669,1866885,274975
7,ENSG00000198517.5,1530702,chr7-1554022-G-A,rs10952167,1,G,A,1554022,23320,1334094,1727310,219928
7,ENSG00000157240.2,91264433,chr7-91276770-T-C,rs10953044,1,T,C,91276770,12337,91067825,91461041,208945
7,ENSG00000186088.10,77416349,chr7-77416905-C-T,rs10953236,-1,C,T,77416905,556,77219741,77612957,197164
7,ENSG00000059377.10,139829264,chr7-139674341-C-T,rs10954654,1,C,T,139674341,154923,139632656,140025872,41685
7,ENSG00000170265.6,149195546,chr7-149219390-C-T,rs112833271,1,C,T,149219390,23844,148998938,149392154,220452
7,ENSG00000155026.10,5967204,chr7-5885227-C-T,rs113132829,-1,C,T,5885227,81977,5770596,6163812,114631
7,ENSG00000157680.8,137846974,chr7-137697299-T-C,rs113442902,-1,T,C,137697299,149675,137650366,138043582,46933
7,ENSG00000106608.12,43906596,chr7-43761631-T-C,rs113581902,-1,T,C,43761631,144965,43709988,44103204,51643
7,ENSG00000164708.5,44065567,chr7-44075830-C-T,rs1139270,-1,C,T,44075830,10263,43868959,44262175,206871
7,ENSG00000133574.4,150567390,chr7-150628290-T-C,rs114540180,1,T,C,150628290,60900,150370782,150763998,257508
7,ENSG00000127952.11,76048000,chr7-76047898-C-T,rs11553096,-1,C,T,76047898,102,75851392,76244608,196506
7,ENSG00000241258.2,66114847,chr7-66110906-G-A,rs1167390,1,G,A,66110906,3941,65918239,66311455,192667
7,ENSG00000106348.12,128409982,chr7-128349825-G-A,rs117271927,-1,G,A,128349825,60157,128213374,128606590,136451
7,ENSG00000221970.1,144312419,chr7-144126740-T-C,rs11763619,1,T,C,144126740,185679,144115811,144509027,10929
7,ENSG00000132436.7,50450350,chr7-50429143-C-T,rs11764792,-1,C,T,50429143,21207,50253742,50646958,175401
7,ENSG00000015676.12,44490658,chr7-44376567-C-T,rs11766300,-1,C,T,44376567,114091,44294050,44687266,82517
7,ENSG00000188707.4,150322639,chr7-150329664-T-C,rs11769348,1,T,C,150329664,7025,150126031,150519247,203633
7,ENSG00000171115.3,150450630,chr7-150442551-G-A,rs11772955,1,G,A,150442551,8079,150254022,150647238,188529
7,ENSG00000106009.11,2555524,chr7-2564844-C-T,rs11773176,-1,C,T,2564844,9320,2358916,2752132,205928
7,ENSG00000106603.12,43729523,chr7-43765096-C-T,rs1181574,-1,C,T,43765096,35573,43532915,43926131,232181
7,ENSG00000106560.6,150685706,chr7-150662968-A-G,rs11972223,1,A,G,150662968,22738,150489098,150882314,173870
7,ENSG00000136193.10,29989801,chr7-30089509-G-A,rs11975522,-1,G,A,30089509,99708,29793193,30186409,296316
7,ENSG00000146856.10,134986508,chr7-135073537-T-C,rs11979458,1,T,C,135073537,87029,134789900,135183116,283637
7,ENSG00000136261.10,16646181,chr7-16783128-C-T,rs12112188,1,C,T,16783128,136947,16449573,16842789,333555
7,ENSG00000011426.6,36389862,chr7-36280180-C-T,rs12154765,1,C,T,36280180,109682,36193254,36586470,86926
7,ENSG00000205238.5,102551232,chr7-102471533-C-T,rs12534337,1,C,T,102471533,79699,102354624,102747840,116909
7,ENSG00000173678.10,102650319,chr7-102471533-C-T,rs12534337,1,C,T,102471533,178786,102453711,102846927,17822
7,ENSG00000181220.10,149497809,chr7-149666766-G-A,rs12536519,-1,G,A,149666766,168957,149301201,149694417,365565
7,ENSG00000227471.3,134549110,chr7-134603308-G-A,rs12666996,1,G,A,134603308,54198,134352502,134745718,250806
7,ENSG00000176125.3,100889715,chr7-100878489-T-C,rs12669120,-1,T,C,100878489,11226,100693107,101086323,185382
7,ENSG00000128595.10,128739359,chr7-128569804-C-T,rs12670823,1,C,T,128569804,169555,128542751,128935967,27053
7,ENSG00000106327.8,100641552,chr7-100621544-A-G,rs12673102,-1,A,G,100621544,20008,100444944,100838160,176600
7,ENSG00000166997.3,100119634,chr7-100072705-A-T,rs12673441,1,A,T,100072705,46929,99923026,100316242,149679
7,ENSG00000075213.5,84194789,chr7-84198684-G-A,rs12673519,-1,G,A,84198684,3895,83998181,84391397,200503
7,ENSG00000169193.7,23597382,chr7-23609095-G-T,rs12700451,1,G,T,23609095,11713,23400774,23793990,208321
7,ENSG00000127946.12,75738941,chr7-75639467-A-G,rs13226566,-1,A,G,75639467,99474,75542333,75935549,97134
7,ENSG00000196511.9,144836053,chr7-144977426-C-T,rs13234206,-1,C,T,144977426,141373,144639445,145032661,337981
7,ENSG00000214102.3,141708353,chr7-141850980-G-C,rs13236432,1,G,C,141850980,142627,141511745,141904961,339235
7,ENSG00000077063.6,117873441,chr7-117982476-C-T,rs13236493,-1,C,T,117982476,109035,117676833,118070049,305643
7,ENSG00000165171.6,73842516,chr7-73840482-T-C,rs13241921,-1,T,C,73840482,2034,73645908,74039124,194574
7,ENSG00000165171.6,73842516,chr7-73840482-T-G,rs13241921,-1,T,G,73840482,2034,73645908,74039124,194574
7,ENSG00000127362.2,141764097,chr7-141602173-T-G,rs13244441,1,T,G,141602173,161924,141567489,141960705,34684
7,ENSG00000164610.4,33109404,chr7-33157620-C-A,rs1362368,-1,C,A,33157620,48216,32912796,33306012,244824
7,ENSG00000153814.7,28180795,chr7-28299637-G-C,rs1398725,-1,G,C,28299637,118842,27984187,28377403,315450
7,ENSG00000085662.8,134459100,chr7-134618526-T-C,rs1424441,-1,T,C,134618526,159426,134262492,134655708,356034
7,ENSG00000135253.8,128910709,chr7-128863489-T-C,rs1472147,-1,T,C,128863489,47220,128714101,129107317,149388
7,ENSG00000126524.4,66995586,chr7-67052638-G-A,rs151323838,-1,G,A,67052638,57052,66798978,67192194,253660
7,ENSG00000166529.9,100049774,chr7-100094117-G-A,rs1527423,1,G,A,100094117,44343,99853166,100246382,240951
7,ENSG00000152926.8,64982119,chr7-64983023-A-G,rs1608716,-1,A,G,64983023,904,64785511,65178727,197512
7,ENSG00000146535.8,2844308,chr7-2824952-G-T,rs1636264,-1,G,T,2824952,19356,2647700,3040916,177252
7,ENSG00000106086.12,30028412,chr7-29847240-A-G,rs16875169,1,A,G,29847240,181172,29831804,30225020,15436
7,ENSG00000105989.4,117323058,chr7-117239008-A-G,rs17139491,-1,A,G,117239008,84050,117126450,117519666,112558
7,ENSG00000106013.8,118224704,chr7-118245460-A-G,rs17141135,1,A,G,118245460,20756,118028096,118421312,217364
7,ENSG00000005483.13,105014205,chr7-105207306-C-A,rs17145071,1,C,A,105207306,193101,104817597,105210813,389709
7,ENSG00000050344.6,26152198,chr7-26062668-T-C,rs17153154,1,T,C,26062668,89530,25955590,26348806,107078
7,ENSG00000127993.9,92528795,chr7-92591781-C-T,rs17164627,1,C,T,92591781,62986,92332187,92725403,259594
7,ENSG00000105825.7,93890753,chr7-93922294-G-A,rs17165909,-1,G,A,93922294,31541,93694145,94087361,228149
7,ENSG00000127920.4,93921735,chr7-93922294-G-A,rs17165909,1,G,A,93922294,559,93725127,94118343,197167
7,ENSG00000196636.7,97117698,chr7-97106224-T-C,rs17168179,1,T,C,97106224,11474,96921090,97314306,185134
7,ENSG00000105875.9,135211526,chr7-135016632-G-A,rs17168200,-1,G,A,135016632,194894,135014918,135408134,1714
7,ENSG00000006451.3,39623572,chr7-39684865-A-G,rs17171612,1,A,G,39684865,61293,39426964,39820180,257901
7,ENSG00000243896.3,144264792,chr7-144434729-G-A,rs17195674,-1,G,A,144434729,169937,144068184,144461400,366545
7,ENSG00000146576.8,6590021,chr7-6476806-T-G,rs17198191,1,T,G,6476806,113215,6393413,6786629,83393
7,ENSG00000212807.1,144239605,chr7-144173329-G-A,rs1731353,-1,G,A,144173329,66276,144042997,144436213,130332
7,ENSG00000106392.5,7182544,chr7-7250307-C-G,rs17318297,1,C,G,7250307,67763,6985936,7379152,264371
7,ENSG00000160862.8,99976031,chr7-99861633-C-T,rs17342647,-1,C,T,99861633,114398,99779423,100172639,82210
7,ENSG00000253293.2,27174320,chr7-27140195-G-A,rs17437369,-1,G,A,27140195,34125,26977712,27370928,162483
7,ENSG00000213203.2,150716613,chr7-150566821-A-G,rs17553490,1,A,G,150566821,149792,150520005,150913221,46816
7,ENSG00000008282.3,106112312,chr7-106115348-C-A,rs176507,-1,C,A,106115348,3036,105915704,106308920,199644
7,ENSG00000146707.9,76627279,chr7-76580142-A-G,rs17718122,-1,A,G,76580142,47137,76430671,76823887,149471
7,ENSG00000188372.9,76424950,chr7-76580142-A-G,rs17718122,1,A,G,76580142,155192,76228342,76621558,351800
7,ENSG00000106636.3,44200978,chr7-44137813-C-T,rs17769733,1,C,T,44137813,63165,44004370,44397586,133443
7,ENSG00000136231.8,23470491,chr7-23391576-G-A,rs17797853,-1,G,A,23391576,78915,23273883,23667099,117693
7,ENSG00000009335.13,157138926,chr7-157270582-T-G,rs17837744,1,T,G,157270582,131656,156942318,157335534,328264
7,ENSG00000154678.12,32070407,chr7-31883289-A-G,rs1860788,-1,A,G,31883289,187118,31873799,32267015,9490
7,ENSG00000106565.12,150800364,chr7-150692505-T-C,rs1860871,-1,T,C,150692505,107859,150603756,150996972,88749
7,ENSG00000002726.14,150852517,chr7-150692505-T-C,rs1860871,1,T,C,150692505,160012,150655909,151049125,36596
7,ENSG00000002933.3,150800769,chr7-150692505-T-C,rs1860871,1,T,C,150692505,108264,150604161,150997377,88344
7,ENSG00000106415.8,7968796,chr7-7821036-A-G,rs1863139,1,A,G,7821036,147760,7772188,8165404,48848
7,ENSG00000164647.4,90154469,chr7-90223835-G-A,rs194518,1,G,A,90223835,69366,89957861,90351077,265974
7,ENSG00000157214.8,90211740,chr7-90223835-G-A,rs194518,1,G,A,90223835,12095,90015132,90408348,208703
7,ENSG00000055130.9,148698903,chr7-148544847-C-T,rs1971691,1,C,T,148544847,154056,148502295,148895511,42552
7,ENSG00000197037.6,99616946,chr7-99748750-C-T,rs2005548,1,C,T,99748750,131804,99420338,99813554,328412
7,ENSG00000135211.5,77798434,chr7-77792277-C-A,rs2057932,-1,C,A,77792277,6157,77601826,77995042,190451
7,ENSG00000128536.11,105963264,chr7-105884203-T-C,rs2067537,1,T,C,105884203,79061,105766656,106159872,117547
7,ENSG00000205482.7,77062558,chr7-77122604-A-G,rs2080164,-1,A,G,77122604,60046,76865950,77259166,256654
7,ENSG00000105974.7,116525036,chr7-116577603-G-A,rs2109517,1,G,A,116577603,52567,116328428,116721644,249175
7,ENSG00000158623.10,130668748,chr7-130595870-C-T,rs2129904,-1,C,T,130595870,72878,130472140,130865356,123730
7,ENSG00000178381.7,1160196,chr7-1174367-T-C,rs2140578,-1,T,C,1174367,14171,963588,1356804,210779
7,ENSG00000127399.10,150323355,chr7-150320125-A-G,rs2159236,1,A,G,150320125,3230,150126747,150519963,193378
7,ENSG00000106591.3,42932376,chr7-42922743-A-G,rs2162602,1,A,G,42922743,9633,42735768,43128984,186975
7,ENSG00000105808.11,102616756,chr7-102473640-C-T,rs2229796,-1,C,T,102473640,143116,102420148,102813364,53492
7,ENSG00000127366.4,141790217,chr7-141778774-G-C,rs2234001,1,G,C,141778774,11443,141593609,141986825,185165
7,ENSG00000106052.8,27740162,chr7-27756623-G-C,rs2237342,1,G,C,27756623,16461,27543554,27936770,213069
7,ENSG00000106070.12,50782896,chr7-50661814-C-T,rs2237460,-1,C,T,50661814,121082,50586288,50979504,75526
7,ENSG00000164543.5,43583108,chr7-43647697-C-T,rs2240516,1,C,T,43647697,64589,43386500,43779716,261197
7,ENSG00000160991.10,102433575,chr7-102308137-G-A,rs2242584,1,G,A,102308137,125438,102236967,102630183,71170
7,ENSG00000106100.6,30478784,chr7-30475375-T-C,rs2256023,-1,T,C,30475375,3409,30282176,30675392,193199
7,ENSG00000136235.10,23246775,chr7-23273552-T-C,rs2268748,1,T,C,23273552,26777,23050167,23443383,223385
7,ENSG00000166925.4,100479214,chr7-100600248-A-G,rs2272575,-1,A,G,100600248,121034,100282606,100675822,317642
7,ENSG00000105877.12,21543039,chr7-21543345-G-T,rs2285943,1,G,T,21543345,306,21346431,21739647,196914
7,ENSG00000106344.3,128343908,chr7-128317549-A-C,rs2290225,-1,A,C,128317549,26359,128147300,128540516,170249
7,ENSG00000106344.3,128343908,chr7-128317549-A-T,rs2290225,-1,A,T,128317549,26359,128147300,128540516,170249
7,ENSG00000198898.6,116862587,chr7-116898580-T-C,rs2301649,1,T,C,116898580,35993,116665979,117059195,232601
7,ENSG00000158604.9,44582231,chr7-44570153-C-T,rs2304373,-1,C,T,44570153,12078,44385623,44778839,184530
7,ENSG00000164815.6,104208013,chr7-104228743-A-G,rs2385142,-1,A,G,104228743,20730,104011405,104404621,217338
7,ENSG00000006576.11,77798792,chr7-77932977-G-A,rs2428939,1,G,A,77932977,134185,77602184,77995400,330793
7,ENSG00000033100.9,151232483,chr7-151237076-G-T,rs2446065,1,G,T,151237076,4593,151035875,151429091,201201
7,ENSG00000033100.9,151232483,chr7-151237076-G-C,rs2446065,1,G,C,151237076,4593,151035875,151429091,201201
7,ENSG00000013374.10,151341812,chr7-151336542-T-C,rs2487161,1,T,C,151336542,5270,151145204,151538420,191338
7,ENSG00000187260.9,151410038,chr7-151336542-T-C,rs2487161,-1,T,C,151336542,73496,151213430,151606646,123112
7,ENSG00000048052.15,18495749,chr7-18509096-G-A,rs2520460,1,G,A,18509096,13347,18299141,18692357,209955
7,ENSG00000146833.10,99919530,chr7-99923825-C-T,rs2527907,-1,C,T,99923825,4295,99722922,100116138,200903
7,ENSG00000106624.4,44104345,chr7-44107886-C-A,rs2537188,1,C,A,44107886,3541,43907737,44300953,200149
7,ENSG00000205060.6,134316930,chr7-134235691-G-A,rs2544165,-1,G,A,134235691,81239,134120322,134513538,115369
7,ENSG00000106105.9,30594878,chr7-30724436-A-G,rs255155,1,A,G,30724436,129558,30398270,30791486,326166
7,ENSG00000126870.11,158856558,chr7-158858396-G-A,rs2657381,1,G,A,158858396,1838,158659950,159053166,198446
7,ENSG00000091127.8,105522271,chr7-105507453-A-C,rs2668882,-1,A,C,105507453,14818,105325663,105718879,181790
7,ENSG00000164746.9,48035543,chr7-47929330-C-A,rs2686817,1,C,A,47929330,106213,47838935,48232151,90395
7,ENSG00000002745.7,121329000,chr7-121324351-T-G,rs2707483,1,T,G,121324351,4649,121132392,121525608,191959
7,ENSG00000071243.11,120950777,chr7-120896344-G-T,rs2721348,1,G,T,120896344,54433,120754169,121147385,142175
7,ENSG00000160908.14,99500281,chr7-99663111-C-T,rs28365086,-1,C,T,99663111,162830,99303673,99696889,359438
7,ENSG00000146963.10,139359894,chr7-139351312-A-G,rs28477480,1,A,G,139351312,8582,139163286,139556502,188026
7,ENSG00000146963.10,139359894,chr7-139351312-A-T,rs28477480,1,A,T,139351312,8582,139163286,139556502,188026
7,ENSG00000006459.6,140176983,chr7-140349492-A-G,rs28670038,-1,A,G,140349492,172509,139980375,140373591,369117
7,ENSG00000197461.8,519409,chr7-590649-A-C,rs28722080,-1,A,C,590649,71240,322801,716017,267848
7,ENSG00000133597.5,140672945,chr7-140688385-G-A,rs2907951,1,G,A,140688385,15440,140476337,140869553,212048
7,ENSG00000090266.7,140696708,chr7-140715861-C-T,rs2930325,1,C,T,140715861,19153,140500100,140893316,215761
7,ENSG00000136205.11,47582111,chr7-47482578-C-T,rs2941541,-1,C,T,47482578,99533,47385503,47778719,97075
7,ENSG00000243317.3,135662514,chr7-135672728-A-C,rs3110823,1,A,C,135672728,10214,135465906,135859122,206822
7,ENSG00000164707.9,135728186,chr7-135692145-C-T,rs3112335,-1,C,T,135692145,36041,135531578,135924794,160567
7,ENSG00000164707.9,135728186,chr7-135692145-C-A,rs3112335,-1,C,A,135692145,36041,135531578,135924794,160567
7,ENSG00000188191.8,727281,chr7-579301-A-G,rs3211362,-1,A,G,579301,147980,530673,923889,48628
7,ENSG00000197448.9,143263441,chr7-143302065-G-T,rs3212148,1,G,T,143302065,38624,143066833,143460049,235232
7,ENSG00000196584.2,152676141,chr7-152669999-T-C,rs3218410,-1,T,C,152669999,6142,152479533,152872749,190466
7,ENSG00000006704.6,74453906,chr7-74387615-G-A,rs34083004,1,G,A,74387615,66291,74257298,74650514,130317
7,ENSG00000146540.9,1138247,chr7-962176-A-G,rs34201071,-1,A,G,962176,176071,941639,1334855,20537
7,ENSG00000105963.7,954680,chr7-921005-G-A,rs34217249,-1,G,A,921005,33675,758072,1151288,162933
7,ENSG00000106665.10,74289407,chr7-74425972-T-C,rs34827785,1,T,C,74425972,136565,74092799,74486015,333173
7,ENSG00000178397.7,6348967,chr7-6330674-C-A,rs3750039,-1,C,A,6330674,18293,6152359,6545575,178315
7,ENSG00000178397.7,6348967,chr7-6330674-C-G,rs3750039,-1,C,G,6330674,18293,6152359,6545575,178315
7,ENSG00000136280.10,45000201,chr7-45108420-C-T,rs3757574,1,C,T,45108420,108219,44803593,45196809,304827
7,ENSG00000164692.12,94394895,chr7-94392163-T-C,rs3763469,1,T,C,94392163,2732,94198287,94591503,193876
7,ENSG00000005075.11,102478922,chr7-102472646-T-C,rs3800988,-1,T,C,102472646,6276,102282314,102675530,190332
7,ENSG00000128604.13,128937927,chr7-128939148-T-C,rs3807307,1,T,C,128939148,1221,128741319,129134535,197829
7,ENSG00000128510.5,130293161,chr7-130294379-T-C,rs3807344,1,T,C,130294379,1218,130096553,130489769,197826
7,ENSG00000086289.7,37920640,chr7-37918169-A-G,rs3807612,1,A,G,37918169,2471,37724032,38117248,194137
7,ENSG00000106460.13,12211294,chr7-12210752-G-A,rs3807866,1,G,A,12210752,542,12014686,12407902,196066
7,ENSG00000117868.9,158829509,chr7-158788727-G-A,rs3850489,-1,G,A,158788727,40782,158632901,159026117,155826
7,ENSG00000184903.5,111562492,chr7-111438856-T-G,rs38752,-1,T,G,111438856,123636,111365884,111759100,72972
7,ENSG00000091073.13,76461709,chr7-76587931-C-A,rs3906145,1,C,A,76587931,126222,76265101,76658317,322830
7,ENSG00000197150.7,151028450,chr7-151010256-G-T,rs3918201,1,G,T,151010256,18194,150831842,151225058,178414
7,ENSG00000177683.8,108569706,chr7-108562348-C-T,rs40939,-1,C,T,108562348,7358,108373098,108766314,189250
7,ENSG00000198822.6,86643909,chr7-86753004-T-C,rs41381245,1,T,C,86753004,109095,86447301,86840517,305703
7,ENSG00000186472.13,83162884,chr7-83088852-C-T,rs41521249,-1,C,T,83088852,74032,82966276,83359492,122576
7,ENSG00000164638.5,5282943,chr7-5301939-A-G,rs4299914,1,A,G,5301939,18996,5086335,5479551,215604
7,ENSG00000136247.10,6577454,chr7-6608107-T-C,rs4416743,1,T,C,6608107,30653,6380846,6774062,227261
7,ENSG00000136247.10,6577454,chr7-6608107-T-A,rs4416743,1,T,A,6608107,30653,6380846,6774062,227261
7,ENSG00000129103.13,56064286,chr7-56049716-G-A,rs4424212,1,G,A,56049716,14570,55867678,56260894,182038
7,ENSG00000198874.7,66996833,chr7-67172014-G-T,rs4433018,1,G,T,67172014,175181,66800225,67193441,371789
7,ENSG00000234444.3,64313961,chr7-64356018-G-A,rs4718067,1,G,A,64356018,42057,64117353,64510569,238665
7,ENSG00000146904.4,143408856,chr7-143386318-G-A,rs4725616,-1,G,A,143386318,22538,143212248,143605464,174070
7,ENSG00000127364.2,141776674,chr7-141905284-G-A,rs4726479,1,G,A,141905284,128610,141580066,141973282,325218
7,ENSG00000187416.7,104328603,chr7-104250637-A-G,rs4727591,1,A,G,104250637,77966,104131995,104525211,118642
7,ENSG00000170027.4,76358991,chr7-76383349-T-C,rs4728710,-1,T,C,76383349,24358,76162383,76555599,220966
7,ENSG00000221838.5,100101643,chr7-100041822-T-C,rs4729568,1,T,C,100041822,59821,99905035,100298251,136787
7,ENSG00000106366.5,101127104,chr7-101058170-T-C,rs4729655,1,T,C,101058170,68934,100930496,101323712,127674
7,ENSG00000161036.5,102464984,chr7-102461063-A-G,rs4989124,1,A,G,102461063,3921,102268376,102661592,192687
7,ENSG00000146830.7,100694250,chr7-100715797-A-G,rs506597,-1,A,G,100715797,21547,100497642,100890858,218155
7,ENSG00000155530.2,134127299,chr7-134086377-C-T,rs55974805,1,C,T,134086377,40922,133930691,134323907,155686
7,ENSG00000086232.7,6059175,chr7-6058670-C-T,rs581706,-1,C,T,6058670,505,5862567,6255783,196103
7,ENSG00000146842.11,130205406,chr7-130156105-A-C,rs60394478,-1,A,C,130156105,49301,130008798,130402014,147307
7,ENSG00000085514.10,100373487,chr7-100236228-C-T,rs62482174,1,C,T,100236228,137259,100176879,100570095,59349
7,ENSG00000188732.6,23680199,chr7-23690555-A-G,rs6461725,1,A,G,23690555,10356,23483591,23876807,206964
7,ENSG00000106153.12,56106476,chr7-56104067-A-C,rs6593298,-1,A,C,56104067,2409,55909868,56303084,194199
7,ENSG00000106153.12,56106476,chr7-56104067-A-T,rs6593298,-1,A,T,56104067,2409,55909868,56303084,194199
7,ENSG00000186480.8,155297878,chr7-155190050-G-A,rs6597475,1,G,A,155190050,107828,155101270,155494486,88780
7,ENSG00000136240.5,6484152,chr7-6462736-T-C,rs6796,-1,T,C,6462736,21416,6287544,6680760,175192
7,ENSG00000105854.7,95435028,chr7-95437094-A-G,rs6946850,-1,A,G,95437094,2066,95238420,95631636,198674
7,ENSG00000127948.9,75915155,chr7-76054230-G-A,rs6950085,1,G,A,76054230,139075,75718547,76111763,335683
7,ENSG00000003147.13,8262167,chr7-8351589-A-T,rs6952743,-1,A,T,8351589,89422,8065559,8458775,286030
7,ENSG00000197362.8,149090718,chr7-149087403-A-G,rs6959224,-1,A,G,149087403,3315,148894110,149287326,193293
7,ENSG00000075790.6,107580246,chr7-107609944-G-A,rs6960817,1,G,A,107609944,29698,107383638,107776854,226306
7,ENSG00000001629.5,92245974,chr7-92083384-A-G,rs6960867,1,A,G,92083384,162590,92049366,92442582,34018
7,ENSG00000196652.6,99504662,chr7-99544047-C-T,rs6962461,1,C,T,99544047,39385,99308054,99701270,235993
7,ENSG00000105879.4,107744142,chr7-107811181-A-G,rs6962701,1,A,G,107811181,67039,107547534,107940750,263647
7,ENSG00000106355.5,32490380,chr7-32453365-C-T,rs6962754,-1,C,T,32453365,37015,32293772,32686988,159593
7,ENSG00000136270.9,45111697,chr7-45099564-T-C,rs6967748,-1,T,C,45099564,12133,44915089,45308305,184475
7,ENSG00000164850.9,1088113,chr7-1115301-G-A,rs6970907,1,G,A,1115301,27188,891505,1284721,223796
7,ENSG00000122778.5,138981389,chr7-138983042-A-G,rs6977460,-1,A,G,138983042,1653,138784781,139177997,198261
7,ENSG00000169871.8,101085481,chr7-100944816-C-T,rs6980219,1,C,T,100944816,140665,100888873,101282089,55943
7,ENSG00000106526.6,150323545,chr7-150274924-G-A,rs71537924,-1,G,A,150274924,48621,150126937,150520153,147987
7,ENSG00000106633.11,44189439,chr7-44232814-G-A,rs730951,-1,G,A,44232814,43375,43992831,44386047,239983
7,ENSG00000164776.5,56092952,chr7-56040301-A-G,rs73140801,-1,A,G,56040301,52651,55896344,56289560,143957
7,ENSG00000164776.5,56092952,chr7-56040301-A-C,rs73140801,-1,A,C,56040301,52651,55896344,56289560,143957
7,ENSG00000122783.11,135170707,chr7-135168333-A-C,rs73153794,-1,A,C,135168333,2374,134974099,135367315,194234
7,ENSG00000214300.5,100307702,chr7-100490299-T-C,rs73161780,1,T,C,100490299,182597,100111094,100504310,379205
7,ENSG00000240204.1,129502531,chr7-129385468-G-T,rs73234741,1,G,T,129385468,117063,129305923,129699139,79545
7,ENSG00000218305.2,48924547,chr7-49095803-G-A,rs73695655,1,G,A,49095803,171256,48727939,49121155,367864
7,ENSG00000106554.7,133082090,chr7-133235342-G-A,rs75411528,-1,G,A,133235342,153252,132885482,133278698,349860
7,ENSG00000010270.9,38178245,chr7-38223122-C-T,rs756392,1,C,T,38223122,44877,37981637,38374853,241485
7,ENSG00000164542.8,36367240,chr7-36474489-G-T,rs76827509,-1,G,T,36474489,107249,36170632,36563848,303857
7,ENSG00000196262.8,44796681,chr7-44766892-C-T,rs77367934,1,C,T,44766892,29789,44600073,44993289,166819
7,ENSG00000159840.11,143381345,chr7-143414712-C-T,rs77531530,1,C,T,143414712,33367,143184737,143577953,229975
7,ENSG00000198420.5,143902176,chr7-143734790-A-G,rs7776595,-1,A,G,143734790,167386,143705568,144098784,29222
7,ENSG00000106290.10,100119358,chr7-100067194-A-G,rs7778571,-1,A,G,100067194,52164,99922750,100315966,144444
7,ENSG00000106290.10,100119358,chr7-100067194-A-C,rs7778571,-1,A,C,100067194,52164,99922750,100315966,144444
7,ENSG00000165055.10,128476748,chr7-128501584-G-A,rs7785264,1,G,A,128501584,24836,128280140,128673356,221444
7,ENSG00000136238.13,6374527,chr7-6343893-G-A,rs7791772,1,G,A,6343893,30634,6177919,6571135,165974
7,ENSG00000189077.6,75994595,chr7-75991323-G-A,rs7794040,-1,G,A,75991323,3272,75797987,76191203,193336
7,ENSG00000087085.8,100895888,chr7-100848613-G-A,rs7794532,-1,G,A,100848613,47275,100699280,101092496,149333
7,ENSG00000171130.11,149873969,chr7-149874377-A-G,rs7795944,1,A,G,149874377,408,149677361,150070577,197016
7,ENSG00000146918.13,158704804,chr7-158712545-G-A,rs7796786,-1,G,A,158712545,7741,158508196,158901412,204349
7,ENSG00000136237.12,22357154,chr7-22351471-C-T,rs7798524,-1,C,T,22351471,5683,22160546,22553762,190925
7,ENSG00000128596.11,128791968,chr7-128810478-G-A,rs7799186,1,G,A,128810478,18510,128595360,128988576,215118
7,ENSG00000205085.4,128672292,chr7-128613342-T-C,rs7800335,1,T,C,128613342,58950,128475684,128868900,137658
7,ENSG00000136213.7,2403611,chr7-2354312-T-G,rs7801817,1,T,G,2354312,49299,2207003,2600219,147309
7,ENSG00000105855.4,20330900,chr7-20239019-G-T,rs7806550,1,G,T,20239019,91881,20134292,20527508,104727
7,ENSG00000213462.4,65006687,chr7-64989251-A-G,rs7807855,-1,A,G,64989251,17436,64810079,65203295,179172
7,ENSG00000214253.4,101245081,chr7-101238809-G-A,rs7808669,-1,G,A,101238809,6272,101048473,101441689,190336
7,ENSG00000213199.3,151048531,chr7-151012483-G-T,rs7830,1,G,T,151012483,36048,150851923,151245139,160560
7,ENSG00000146757.9,65373855,chr7-65269753-C-A,rs78369014,1,C,A,65269753,104102,65177247,65570463,92506
7,ENSG00000128573.17,114414815,chr7-114555255-A-G,rs78447914,1,A,G,114555255,140440,114218207,114611423,337048
7,ENSG00000105810.5,92836573,chr7-92857303-A-G,rs78581841,-1,A,G,92857303,20730,92639965,93033181,217338
7,ENSG00000164916.7,4682295,chr7-4822540-G-A,rs79575100,1,G,A,4822540,140245,4485687,4878903,336853
7,ENSG00000261115.1,141074064,chr7-141102530-A-G,rs79587754,1,A,G,141102530,28466,140877456,141270672,225074
7,ENSG00000106144.14,143288351,chr7-143322273-G-T,rs79790719,1,G,T,143322273,33922,143091743,143484959,230530
7,ENSG00000106617.8,151877115,chr7-151793953-G-C,rs79918575,-1,G,C,151793953,83162,151680507,152073723,113446
7,ENSG00000090263.10,141014952,chr7-141068150-A-G,rs801155,-1,A,G,141068150,53198,140818344,141211560,249806
7,ENSG00000122512.9,6009049,chr7-6055526-C-A,rs852151,-1,C,A,6055526,46477,5812441,6205657,243085
7,ENSG00000009954.6,73522293,chr7-73712768-G-A,rs875342,-1,G,A,73712768,190475,73325685,73718901,387083
7,ENSG00000136295.10,2631986,chr7-2775100-A-G,rs9332401,1,A,G,2775100,143114,2435378,2828594,339722
7,ENSG00000106245.5,99408969,chr7-99434835-C-T,rs940336,1,C,T,99434835,25866,99212361,99605577,222474
7,ENSG00000188186.6,100148918,chr7-100080868-A-G,rs941289,1,A,G,100080868,68050,99952310,100345526,128558
7,ENSG00000071462.7,73683597,chr7-73672716-A-G,rs941297,1,A,G,73672716,10881,73486989,73880205,185727
7,ENSG00000164849.6,1044546,chr7-1110906-T-A,rs9655467,1,T,A,1110906,66360,847938,1241154,262968
7,ENSG00000158525.11,130344816,chr7-130382200-C-T,rs968404,1,C,T,130382200,37384,130148208,130541424,233992
7,ENSG00000106605.6,43758680,chr7-43580584-G-C,rs9690115,1,G,C,43580584,178096,43562072,43955288,18512
7,ENSG00000106049.3,27662883,chr7-27543164-G-A,rs978447,-1,G,A,27543164,119719,27466275,27859491,76889
7,ENSG00000205277.5,100969565,chr7-101072593-G-A,rs9792109,1,G,A,101072593,103028,100772957,101166173,299636
7,ENSG00000189077.6,75994595,chr7-76104888-A-C,rs10085567,-1,A,C,76104888,110293,75797987,76191203,306901
7,ENSG00000243317.3,135662514,chr7-135629089-C-T,rs10224307,1,C,T,135629089,33425,135465906,135859122,163183
7,ENSG00000164746.9,48035543,chr7-48024141-G-A,rs10225968,1,G,A,48024141,11402,47838935,48232151,185206
7,ENSG00000243896.3,144264792,chr7-144109595-C-A,rs10230228,-1,C,A,144109595,155197,144068184,144461400,41411
7,ENSG00000146963.10,139359894,chr7-139361760-C-T,rs10233769,1,C,T,139361760,1866,139163286,139556502,198474
7,ENSG00000164692.12,94394895,chr7-94381720-A-T,rs10241133,1,A,T,94381720,13175,94198287,94591503,183433
7,ENSG00000157240.2,91264433,chr7-91248486-A-T,rs10243298,1,A,T,91248486,15947,91067825,91461041,180661
7,ENSG00000105989.4,117323058,chr7-117312729-T-G,rs10245232,-1,T,G,117312729,10329,117126450,117519666,186279
7,ENSG00000128564.4,101165569,chr7-101049399-T-G,rs10246021,-1,T,G,101049399,116170,100968961,101362177,80438
7,ENSG00000128564.4,101165569,chr7-101049399-T-A,rs10246021,-1,T,A,101049399,116170,100968961,101362177,80438
7,ENSG00000106459.10,129611720,chr7-129800815-C-A,rs10246160,1,C,A,129800815,189095,129415112,129808328,385703
7,ENSG00000106459.10,129611720,chr7-129800815-C-G,rs10246160,1,C,G,129800815,189095,129415112,129808328,385703
7,ENSG00000173678.10,102650319,chr7-102737562-G-A,rs10254446,1,G,A,102737562,87243,102453711,102846927,283851
7,ENSG00000146701.6,76048106,chr7-76117091-T-C,rs10255591,1,T,C,76117091,68985,75851498,76244714,265593
7,ENSG00000009335.13,157138926,chr7-156988404-G-A,rs10260592,1,G,A,156988404,150522,156942318,157335534,46086
7,ENSG00000214253.4,101245081,chr7-101221803-G-A,rs10265206,-1,G,A,101221803,23278,101048473,101441689,173330
7,ENSG00000164828.12,832476,chr7-903397-C-G,rs10269327,1,C,G,903397,70921,635868,1029084,267529
7,ENSG00000136193.10,29989801,chr7-29876969-G-A,rs10276961,-1,G,A,29876969,112832,29793193,30186409,83776
7,ENSG00000127955.11,80134831,chr7-80128551-C-T,rs10277713,1,C,T,80128551,6280,79938223,80331439,190328
7,ENSG00000106538.5,150341629,chr7-150375413-T-C,rs10480297,-1,T,C,150375413,33784,150145021,150538237,230392
7,ENSG00000127399.10,150323355,chr7-150410649-A-G,rs1048407,1,A,G,150410649,87294,150126747,150519963,283902
7,ENSG00000105855.4,20330900,chr7-20252255-G-A,rs10486388,1,G,A,20252255,78645,20134292,20527508,117963
7,ENSG00000105810.5,92836573,chr7-93021429-T-G,rs10488528,-1,T,G,93021429,184856,92639965,93033181,381464
7,ENSG00000106263.12,2354827,chr7-2294751-G-A,rs10950641,1,G,A,2294751,60076,2158219,2551435,136532
7,ENSG00000106628.6,44123548,chr7-44130986-G-A,rs10951757,-1,G,A,44130986,7438,43926940,44320156,204046
7,ENSG00000177409.6,93148385,chr7-93052506-A-G,rs10953084,-1,A,G,93052506,95879,92951777,93344993,100729
7,ENSG00000164880.11,1504389,chr7-1541764-C-A,rs111764525,-1,C,A,1541764,37375,1307781,1700997,233983
7,ENSG00000164880.11,1504389,chr7-1541764-C-T,rs111764525,-1,C,T,1541764,37375,1307781,1700997,233983
7,ENSG00000106367.9,101154476,chr7-101173024-T-C,rs112978090,1,T,C,101173024,18548,100957868,101351084,215156
7,ENSG00000157778.4,1570032,chr7-1592740-G-A,rs113210207,-1,G,A,1592740,22708,1373424,1766640,219316
7,ENSG00000133619.13,149714951,chr7-149784268-C-T,rs113658613,1,C,T,149784268,69317,149518343,149911559,265925
7,ENSG00000135253.8,128910709,chr7-128866416-C-T,rs113752302,-1,C,T,128866416,44293,128714101,129107317,152315
7,ENSG00000196329.5,150737418,chr7-150628290-T-C,rs114540180,1,T,C,150628290,109128,150540810,150934026,87480
7,ENSG00000128606.8,102913000,chr7-103030486-C-T,rs11543780,1,C,T,103030486,117486,102716392,103109608,314094
7,ENSG00000071462.7,73683597,chr7-73698011-C-T,rs11544049,1,C,T,73698011,14414,73486989,73880205,211022
7,ENSG00000213413.2,100219236,chr7-100056977-A-G,rs11558475,1,A,G,100056977,162259,100022628,100415844,34349
7,ENSG00000105793.10,90346716,chr7-90521720-A-G,rs11563419,1,A,G,90521720,175004,90150108,90543324,371612
7,ENSG00000197576.8,27130757,chr7-27307978-T-C,rs11564006,-1,T,C,27307978,177221,26934149,27327365,373829
7,ENSG00000106617.8,151877115,chr7-151901974-A-G,rs116022132,-1,A,G,151901974,24859,151680507,152073723,221467
7,ENSG00000178809.7,75395629,chr7-75546611-C-T,rs1167797,1,C,T,75546611,150982,75199021,75592237,347590
7,ENSG00000127366.4,141790217,chr7-141600470-C-T,rs117203961,1,C,T,141600470,189747,141593609,141986825,6861
7,ENSG00000106246.9,99438798,chr7-99334497-C-G,rs117316159,-1,C,G,99334497,104301,99242190,99635406,92307
7,ENSG00000136250.6,36724494,chr7-36881725-G-A,rs117386933,-1,G,A,36881725,157231,36527886,36921102,353839
7,ENSG00000186480.8,155297878,chr7-155220772-G-A,rs11765868,1,G,A,155220772,77106,155101270,155494486,119502
7,ENSG00000197008.5,64794428,chr7-64655565-C-T,rs117663768,1,C,T,64655565,138863,64597820,64991036,57745
7,ENSG00000204946.5,149262196,chr7-149427759-A-G,rs117675411,1,A,G,149427759,165563,149065588,149458804,362171
7,ENSG00000205482.7,77062558,chr7-76980256-C-T,rs11768176,-1,C,T,76980256,82302,76865950,77259166,114306
7,ENSG00000106624.4,44104345,chr7-44095976-A-G,rs11768607,1,A,G,44095976,8369,43907737,44300953,188239
7,ENSG00000173041.7,64563071,chr7-64505788-C-T,rs11768782,-1,C,T,64505788,57283,64366463,64759679,139325
7,ENSG00000122550.11,23105785,chr7-23168424-G-A,rs11770879,1,G,A,23168424,62639,22909177,23302393,259247
7,ENSG00000185055.6,105581493,chr7-105462925-C-G,rs11771875,-1,C,G,105462925,118568,105384885,105778101,78040
7,ENSG00000135249.3,105532201,chr7-105463394-C-G,rs11772023,1,C,G,105463394,68807,105335593,105728809,127801
7,ENSG00000164654.11,7566884,chr7-7492188-G-A,rs11772657,1,G,A,7492188,74696,7370276,7763492,121912
7,ENSG00000128563.9,102396363,chr7-102470197-C-T,rs117742273,1,C,T,102470197,73834,102199755,102592971,270442
7,ENSG00000106003.8,2519774,chr7-2480654-C-A,rs117777395,1,C,A,2480654,39120,2323166,2716382,157488
7,ENSG00000146802.6,112790393,chr7-112671211-A-G,rs118000904,-1,A,G,112671211,119182,112593785,112987001,77426
7,ENSG00000010270.9,38178245,chr7-38257544-T-C,rs11971259,1,T,C,38257544,79299,37981637,38374853,275907
7,ENSG00000157214.8,90211740,chr7-90025764-A-G,rs11977462,1,A,G,90025764,185976,90015132,90408348,10632
7,ENSG00000218305.2,48924547,chr7-49020541-T-G,rs11978940,1,T,G,49020541,95994,48727939,49121155,292602
7,ENSG00000153790.7,25180354,chr7-25179272-C-T,rs11980216,-1,C,T,25179272,1082,24983746,25376962,195526
7,ENSG00000122591.7,23014130,chr7-23080136-G-T,rs12112291,-1,G,T,23080136,66006,22817522,23210738,262614
7,ENSG00000106484.8,130492085,chr7-130480095-C-G,rs12112550,1,C,G,130480095,11990,130295477,130688693,184618
7,ENSG00000169193.7,23597382,chr7-23639768-G-A,rs12154330,1,G,A,23639768,42386,23400774,23793990,238994
7,ENSG00000164849.6,1044546,chr7-923196-T-C,rs12381369,1,T,C,923196,121350,847938,1241154,75258
7,ENSG00000105835.7,106284983,chr7-106201902-T-C,rs12534175,-1,T,C,106201902,83081,106088375,106481591,113527
7,ENSG00000128604.13,128937927,chr7-129077852-G-A,rs12537284,1,G,A,129077852,139925,128741319,129134535,336533
7,ENSG00000106477.12,130441016,chr7-130448808-A-G,rs12538244,-1,A,G,130448808,7792,130244408,130637624,204400
7,ENSG00000242802.2,4775623,chr7-4720493-A-G,rs12667710,1,A,G,4720493,55130,4579015,4972231,141478
7,ENSG00000171115.3,150450630,chr7-150443826-T-C,rs12668210,1,T,C,150443826,6804,150254022,150647238,189804
7,ENSG00000105825.7,93890753,chr7-93774213-T-G,rs12670534,-1,T,G,93774213,116540,93694145,94087361,80068
7,ENSG00000166529.9,100049774,chr7-100072705-A-T,rs12673441,1,A,T,100072705,22931,99853166,100246382,219539
7,ENSG00000001630.10,92134477,chr7-92245372-C-T,rs12704637,-1,C,T,92245372,110895,91937869,92331085,307503
7,ENSG00000257093.2,141702166,chr7-141881525-G-T,rs1285961,-1,G,T,141881525,179359,141505558,141898774,375967
7,ENSG00000105974.7,116525036,chr7-116497431-A-T,rs13226307,1,A,T,116497431,27605,116328428,116721644,169003
7,ENSG00000188732.6,23680199,chr7-23612942-T-C,rs13227748,1,T,C,23612942,67257,23483591,23876807,129351
7,ENSG00000127946.12,75738941,chr7-75733069-A-G,rs13238507,-1,A,G,75733069,5872,75542333,75935549,190736
7,ENSG00000177679.14,76201896,chr7-76115715-T-C,rs13239185,1,T,C,76115715,86181,76005288,76398504,110427
7,ENSG00000177683.8,108569706,chr7-108625745-A-G,rs13242766,-1,A,G,108625745,56039,108373098,108766314,252647
7,ENSG00000105808.11,102616756,chr7-102692001-C-G,rs141003853,-1,C,G,102692001,75245,102420148,102813364,271853
7,ENSG00000234444.3,64313961,chr7-64233851-C-T,rs1525168,1,C,T,64233851,80110,64117353,64510569,116498
7,ENSG00000196511.9,144836053,chr7-144778502-G-A,rs1635352,-1,G,A,144778502,57551,144639445,145032661,139057
7,ENSG00000157680.8,137846974,chr7-137899942-C-T,rs1646540,-1,C,T,137899942,52968,137650366,138043582,249576
7,ENSG00000122687.13,2242205,chr7-2057867-A-G,rs17132109,-1,A,G,2057867,184338,2045597,2438813,12270
7,ENSG00000136235.10,23246775,chr7-23263674-C-T,rs17147998,1,C,T,23263674,16899,23050167,23443383,213507
7,ENSG00000136235.10,23246775,chr7-23263674-C-A,rs17147998,1,C,A,23263674,16899,23050167,23443383,213507
7,ENSG00000186088.10,77416349,chr7-77439648-C-A,rs17153477,-1,C,A,77439648,23299,77219741,77612957,219907
7,ENSG00000135164.13,87152453,chr7-87073355-A-G,rs17161290,1,A,G,87073355,79098,86955845,87349061,117510
7,ENSG00000128510.5,130293161,chr7-130360838-G-C,rs17164838,1,G,C,130360838,67677,130096553,130489769,264285
7,ENSG00000146859.4,135148072,chr7-134974312-G-A,rs17168150,1,G,A,134974312,173760,134951464,135344680,22848
7,ENSG00000214960.5,16421538,chr7-16552789-C-A,rs17169537,-1,C,A,16552789,131251,16224930,16618146,327859
7,ENSG00000001626.8,117480025,chr7-117536959-G-A,rs17449134,1,G,A,117536959,56934,117283417,117676633,253542
7,ENSG00000106070.12,50782896,chr7-50646978-G-A,rs17545762,-1,G,A,50646978,135918,50586288,50979504,60690
7,ENSG00000158623.10,130668748,chr7-130645454-C-T,rs17647828,-1,C,T,130645454,23294,130472140,130865356,173314
7,ENSG00000105953.10,44606627,chr7-44541392-T-C,rs17655652,1,T,C,44541392,65235,44410019,44803235,131373
7,ENSG00000127952.11,76048000,chr7-75986787-G-A,rs17685,-1,G,A,75986787,61213,75851392,76244608,135395
7,ENSG00000106086.12,30028412,chr7-30143370-T-C,rs181542598,1,T,C,30143370,114958,29831804,30225020,311566
7,ENSG00000240583.5,30911853,chr7-30760082-G-T,rs1860510,1,G,T,30760082,151771,30715245,31108461,44837
7,ENSG00000188372.9,76424950,chr7-76405477-A-G,rs1968108,1,A,G,76405477,19473,76228342,76621558,177135
7,ENSG00000155530.2,134127299,chr7-134058640-A-G,rs1986692,1,A,G,134058640,68659,133930691,134323907,127949
7,ENSG00000160862.8,99976031,chr7-100099174-T-C,rs2070215,-1,T,C,100099174,123143,99779423,100172639,319751
7,ENSG00000213214.3,144195833,chr7-144026377-C-T,rs2189874,-1,C,T,144026377,169456,143999225,144392441,27152
7,ENSG00000170667.9,102517777,chr7-102473640-C-T,rs2229796,-1,C,T,102473640,44137,102321169,102714385,152471
7,ENSG00000105928.9,24757464,chr7-24722231-G-T,rs2237315,-1,G,T,24722231,35233,24560856,24954072,161375
7,ENSG00000160999.8,102286868,chr7-102308137-G-A,rs2242584,1,G,A,102308137,21269,102090260,102483476,217877
7,ENSG00000136247.10,6577454,chr7-6618924-A-G,rs2248342,1,A,G,6618924,41470,6380846,6774062,238078
7,ENSG00000146856.10,134986508,chr7-134993772-C-T,rs2252826,1,C,T,134993772,7264,134789900,135183116,203872
7,ENSG00000161036.5,102464984,chr7-102400104-A-G,rs2410988,1,A,G,102400104,64880,102268376,102661592,131728
7,ENSG00000127920.4,93921735,chr7-93778086-C-A,rs2519609,1,C,A,93778086,143649,93725127,94118343,52959
7,ENSG00000146833.10,99919530,chr7-99947686-G-A,rs2525539,-1,G,A,99947686,28156,99722922,100116138,224764
7,ENSG00000168090.5,100088969,chr7-99947686-G-A,rs2525539,1,G,A,99947686,141283,99892361,100285577,55325
7,ENSG00000146535.8,2844308,chr7-2795235-C-T,rs2533886,-1,C,T,2795235,49073,2647700,3040916,147535
7,ENSG00000106125.14,30771417,chr7-30741045-T-C,rs255173,1,T,C,30741045,30372,30574809,30968025,166236
7,ENSG00000188763.3,73433778,chr7-73569890-T-C,rs2573,1,T,C,73569890,136112,73237170,73630386,332720
7,ENSG00000128617.2,128775794,chr7-128839313-T-C,rs2643765,-1,T,C,128839313,63519,128579186,128972402,260127
7,ENSG00000136237.12,22357154,chr7-22412565-A-T,rs2686514,-1,A,T,22412565,55411,22160546,22553762,252019
7,ENSG00000106244.8,99408597,chr7-99419107-A-G,rs28378107,-1,A,G,99419107,10510,99211989,99605205,207118
7,ENSG00000122674.8,5898733,chr7-5903429-C-T,rs2906501,1,C,T,5903429,4696,5702125,6095341,201304
7,ENSG00000136205.11,47582111,chr7-47485200-A-G,rs2941542,-1,A,G,47485200,96911,47385503,47778719,99697
7,ENSG00000090266.7,140696708,chr7-140682356-T-C,rs2968553,1,T,C,140682356,14352,140500100,140893316,182256
7,ENSG00000127951.5,77199819,chr7-77199958-A-G,rs3093273,-1,A,G,77199958,139,77003211,77396427,196747
7,ENSG00000196411.5,100827523,chr7-100773850-C-T,rs314299,-1,C,T,100773850,53673,100630915,101024131,142935
7,ENSG00000071189.15,17940494,chr7-17968959-G-A,rs34058374,-1,G,A,17968959,28465,17743886,18137102,225073
7,ENSG00000106266.4,2314441,chr7-2297647-G-A,rs34320540,-1,G,A,2297647,16794,2117833,2511049,179814
7,ENSG00000001629.5,92245974,chr7-92072960-G-A,rs34581834,1,G,A,92072960,173014,92049366,92442582,23594
7,ENSG00000106404.9,101237802,chr7-101219111-A-G,rs35094522,-1,A,G,101219111,18691,101041194,101434410,177917
7,ENSG00000187260.9,151410038,chr7-151379598-A-C,rs35217858,-1,A,C,151379598,30440,151213430,151606646,166168
7,ENSG00000221838.5,100101643,chr7-100017147-T-C,rs35414630,1,T,C,100017147,84496,99905035,100298251,112112
7,ENSG00000215045.4,6551461,chr7-6391578-C-T,rs35981225,-1,C,T,6391578,159883,6354853,6748069,36725
7,ENSG00000091127.8,105522271,chr7-105500561-G-A,rs3735368,-1,G,A,105500561,21710,105325663,105718879,174898
7,ENSG00000006530.10,141551410,chr7-141548675-G-A,rs3757470,1,G,A,141548675,2735,141354802,141748018,193873
7,ENSG00000106415.8,7968796,chr7-7964091-C-G,rs37963,1,C,G,7964091,4705,7772188,8165404,191903
7,ENSG00000122786.13,134779634,chr7-134848783-G-A,rs3800733,1,G,A,134848783,69149,134583026,134976242,265757
7,ENSG00000065883.10,39950256,chr7-40061736-G-A,rs3800802,1,G,A,40061736,111480,39753648,40146864,308088
7,ENSG00000086300.11,26291862,chr7-26350152-C-G,rs3801886,1,C,G,26350152,58290,26095254,26488470,254898
7,ENSG00000106100.6,30478784,chr7-30460345-T-C,rs3823773,-1,T,C,30460345,18439,30282176,30675392,178169
7,ENSG00000171130.11,149873969,chr7-149884188-C-A,rs4077894,1,C,A,149884188,10219,149677361,150070577,206827
7,ENSG00000105976.9,116672196,chr7-116851160-C-A,rs41788,1,C,A,116851160,178964,116475588,116868804,375572
7,ENSG00000214309.3,100126967,chr7-100008238-T-C,rs4216,1,T,C,100008238,118729,99930359,100323575,77879
7,ENSG00000205277.5,100969565,chr7-100950289-C-T,rs4236547,1,C,T,100950289,19276,100772957,101166173,177332
7,ENSG00000164815.6,104208013,chr7-104229706-T-A,rs4265124,-1,T,A,104229706,21693,104011405,104404621,218301
7,ENSG00000164815.6,104208013,chr7-104229706-T-G,rs4265124,-1,T,G,104229706,21693,104011405,104404621,218301
7,ENSG00000122778.5,138981389,chr7-139124531-A-G,rs4321936,-1,A,G,139124531,143142,138784781,139177997,339750
7,ENSG00000164715.5,98106862,chr7-98262148-A-G,rs4604367,1,A,G,98262148,155286,97910254,98303470,351894
7,ENSG00000188191.8,727281,chr7-808560-T-C,rs4719437,-1,T,C,808560,81279,530673,923889,277887
7,ENSG00000106004.4,27143681,chr7-27192143-C-T,rs4722672,-1,C,T,27192143,48462,26947073,27340289,245070
7,ENSG00000075624.8,5530601,chr7-5560738-C-T,rs4724708,-1,C,T,5560738,30137,5333993,5727209,226745
7,ENSG00000197448.9,143263441,chr7-143363198-T-C,rs4726612,1,T,C,143363198,99757,143066833,143460049,296365
7,ENSG00000066923.11,100177918,chr7-99995723-C-A,rs4727443,1,C,A,99995723,182195,99981310,100374526,14413
7,ENSG00000106366.5,101127104,chr7-101109417-G-C,rs4727478,1,G,C,101109417,17687,100930496,101323712,178921
7,ENSG00000105948.9,139133778,chr7-139325914-C-T,rs4732365,1,C,T,139325914,192136,138937170,139330386,388744
7,ENSG00000132436.7,50450350,chr7-50426883-T-C,rs4947410,-1,T,C,50426883,23467,50253742,50646958,173141
7,ENSG00000146530.6,12403865,chr7-12531967-C-T,rs55845368,-1,C,T,12531967,128102,12207257,12600473,324710
7,ENSG00000228049.3,102671629,chr7-102699053-G-C,rs55867734,-1,G,C,102699053,27424,102475021,102868237,224032
7,ENSG00000228049.3,102671629,chr7-102699053-G-A,rs55867734,-1,G,A,102699053,27424,102475021,102868237,224032
7,ENSG00000188186.6,100148918,chr7-100222221-G-A,rs56089143,1,G,A,100222221,73303,99952310,100345526,269911
7,ENSG00000005075.11,102478922,chr7-102462847-G-A,rs56208004,-1,G,A,102462847,16075,102282314,102675530,180533
7,ENSG00000157212.13,155003124,chr7-154924722-C-T,rs57164738,-1,C,T,154924722,78402,154806516,155199732,118206
7,ENSG00000006625.11,30504829,chr7-30497598-C-T,rs57379358,-1,C,T,30497598,7231,30308221,30701437,189377
7,ENSG00000019991.10,81770047,chr7-81751879-G-A,rs5745647,-1,G,A,81751879,18168,81573439,81966655,178440
7,ENSG00000090263.10,141014952,chr7-141077230-C-T,rs579518,-1,C,T,141077230,62278,140818344,141211560,258886
7,ENSG00000087085.8,100895888,chr7-100787910-A-C,rs60783739,-1,A,C,100787910,107978,100699280,101092496,88630
7,ENSG00000165171.6,73842516,chr7-73865031-C-T,rs61742124,-1,C,T,73865031,22515,73645908,74039124,219123
7,ENSG00000008311.10,122144249,chr7-122311395-T-C,rs62476009,-1,T,C,122311395,167146,121947641,122340857,363754
7,ENSG00000189043.5,10940153,chr7-10838130-A-G,rs6460761,-1,A,G,10838130,102023,10743545,11136761,94585
7,ENSG00000196335.8,23710219,chr7-23625053-G-A,rs6461718,1,G,A,23625053,85166,23513611,23906827,111442
7,ENSG00000003147.13,8262167,chr7-8259105-T-A,rs6463788,-1,T,A,8259105,3062,8065559,8458775,193546
7,ENSG00000221970.1,144312419,chr7-144144679-C-T,rs6464580,1,C,T,144144679,167740,144115811,144509027,28868
7,ENSG00000008282.3,106112312,chr7-106053509-T-C,rs6466081,-1,T,C,106053509,58803,105915704,106308920,137805
7,ENSG00000146729.5,55964585,chr7-56054365-A-C,rs6593297,1,A,C,56054365,89780,55767977,56161193,286388
7,ENSG00000146729.5,55964585,chr7-56054365-A-T,rs6593297,1,A,T,56054365,89780,55767977,56161193,286388
7,ENSG00000160917.9,99438943,chr7-99558897-C-T,rs6947826,1,C,T,99558897,119954,99242335,99635551,316562
7,ENSG00000158683.3,47948466,chr7-47775331-T-C,rs6949512,-1,T,C,47775331,173135,47751858,48145074,23473
7,ENSG00000197362.8,149090718,chr7-149119427-C-G,rs6950172,-1,C,G,149119427,28709,148894110,149287326,225317
7,ENSG00000059377.10,139829264,chr7-139807769-A-C,rs6951759,1,A,C,139807769,21495,139632656,140025872,175113
7,ENSG00000122512.9,6009049,chr7-6161674-G-A,rs6959740,-1,G,A,6161674,152625,5812441,6205657,349233
7,ENSG00000153814.7,28180795,chr7-28121760-C-A,rs6962289,-1,C,A,28121760,59035,27984187,28377403,137573
7,ENSG00000136240.5,6484152,chr7-6481045-T-C,rs6964421,-1,T,C,6481045,3107,6287544,6680760,193501
7,ENSG00000164877.14,1459470,chr7-1512802-A-G,rs6965558,-1,A,G,1512802,53332,1262862,1656078,249940
7,ENSG00000059378.7,140062951,chr7-140045991-G-A,rs6969159,-1,G,A,140045991,16960,139866343,140259559,179648
7,ENSG00000213199.3,151048531,chr7-151128000-G-A,rs6970983,1,G,A,151128000,79469,150851923,151245139,276077
7,ENSG00000196262.8,44796681,chr7-44851384-G-A,rs6975896,1,G,A,44851384,54703,44600073,44993289,251311
7,ENSG00000106344.3,128343908,chr7-128276155-G-A,rs6979784,-1,G,A,128276155,67753,128147300,128540516,128855
7,ENSG00000239857.1,876554,chr7-1063632-C-G,rs6980433,1,C,G,1063632,187078,679946,1073162,383686
7,ENSG00000164896.13,151080809,chr7-151125105-C-T,rs729712,-1,C,T,151125105,44296,150884201,151277417,240904
7,ENSG00000006704.6,74453906,chr7-74573075-G-A,rs73137109,1,G,A,74573075,119169,74257298,74650514,315777
7,ENSG00000009954.6,73522293,chr7-73666787-C-T,rs73138822,-1,C,T,73666787,144494,73325685,73718901,341102
7,ENSG00000198742.5,99144108,chr7-99218631-A-G,rs73157581,-1,A,G,99218631,74523,98947500,99340716,271131
7,ENSG00000164916.7,4682295,chr7-4755969-T-C,rs73674092,1,T,C,4755969,73674,4485687,4878903,270282
7,ENSG00000106460.13,12211294,chr7-12261960-A-G,rs7457114,1,A,G,12261960,50666,12014686,12407902,247274
7,ENSG00000006652.8,112450460,chr7-112476143-G-A,rs7467,1,G,A,112476143,25683,112253852,112647068,222291
7,ENSG00000129103.13,56064286,chr7-56257428-C-T,rs74834148,1,C,T,56257428,193142,55867678,56260894,389750
7,ENSG00000106399.7,7718607,chr7-7532443-G-A,rs74983009,-1,G,A,7532443,186164,7521999,7915215,10444
7,ENSG00000128596.11,128791968,chr7-128932249-G-A,rs754280,1,G,A,128932249,140281,128595360,128988576,336889
7,ENSG00000106603.12,43729523,chr7-43846250-T-C,rs757859,-1,T,C,43846250,116727,43532915,43926131,313335
7,ENSG00000170027.4,76358991,chr7-76323980-C-A,rs758944,-1,C,A,76323980,35011,76162383,76555599,161597
7,ENSG00000122644.8,12687633,chr7-12750510-G-A,rs75912994,1,G,A,12750510,62877,12491025,12884241,259485
7,ENSG00000106571.8,42237209,chr7-42197922-G-T,rs76257295,-1,G,T,42197922,39287,42040601,42433817,157321
7,ENSG00000106009.11,2555524,chr7-2542447-G-A,rs77542618,-1,G,A,2542447,13077,2358916,2752132,183531
7,ENSG00000185811.12,50304716,chr7-50371022-G-T,rs7780012,1,G,T,50371022,66306,50108108,50501324,262914
7,ENSG00000106392.5,7182544,chr7-7210818-A-C,rs7780273,1,A,C,7210818,28274,6985936,7379152,224882
7,ENSG00000105887.10,135977359,chr7-135976801-A-G,rs7781426,-1,A,G,135976801,558,135780751,136173967,196050
7,ENSG00000002745.7,121329000,chr7-121325598-C-T,rs7782648,1,C,T,121325598,3402,121132392,121525608,193206
7,ENSG00000106123.7,142855076,chr7-142854611-C-A,rs7789029,1,C,A,142854611,465,142658468,143051684,196143
7,ENSG00000128591.11,128830406,chr7-128708351-G-A,rs7790478,1,G,A,128708351,122055,128633798,129027014,74553
7,ENSG00000196937.5,121396308,chr7-121393137-A-G,rs7793554,-1,A,G,121393137,3171,121199700,121592916,193437
7,ENSG00000204947.4,149126324,chr7-149102480-C-A,rs7796282,-1,C,A,149102480,23844,148929716,149322932,172764
7,ENSG00000136280.10,45000201,chr7-45128232-C-T,rs7799075,1,C,T,45128232,128031,44803593,45196809,324639
7,ENSG00000106560.6,150685706,chr7-150520001-G-A,rs7800829,1,G,A,150520001,165705,150489098,150882314,30903
7,ENSG00000146648.10,55019017,chr7-55106378-C-G,rs7803660,1,C,G,55106378,87361,54822409,55215625,283969
7,ENSG00000004766.11,93232366,chr7-93388079-A-G,rs7804125,1,A,G,93388079,155713,93035758,93428974,352321
7,ENSG00000214300.5,100307702,chr7-100467096-A-G,rs7806537,1,A,G,100467096,159394,100111094,100504310,356002
7,ENSG00000180354.11,30134986,chr7-30154701-C-A,rs7811155,1,C,A,30154701,19715,29938378,30331594,216323
7,ENSG00000227471.3,134549110,chr7-134546863-A-G,rs7811759,1,A,G,134546863,2247,134352502,134745718,194361
7,ENSG00000126870.11,158856558,chr7-158871562-G-A,rs78313003,1,G,A,158871562,15004,158659950,159053166,211612
7,ENSG00000105854.7,95435028,chr7-95495017-G-A,rs78641443,-1,G,A,95495017,59989,95238420,95631636,256597
7,ENSG00000197157.5,127652194,chr7-127766898-A-G,rs79465896,1,A,G,127766898,114704,127455586,127848802,311312
7,ENSG00000157800.12,140398530,chr7-140422539-A-G,rs80274100,-1,A,G,140422539,24009,140201922,140595138,220617
7,ENSG00000086232.7,6059175,chr7-6070185-C-T,rs852144,-1,C,T,6070185,11010,5862567,6255783,207618
7,ENSG00000075618.11,5592816,chr7-5569301-G-C,rs852499,1,G,C,5569301,23515,5396208,5789424,173093
7,ENSG00000106635.3,73557690,chr7-73712768-G-A,rs875342,-1,G,A,73712768,155078,73361082,73754298,351686
7,ENSG00000136213.7,2403611,chr7-2458417-A-C,rs886626,1,A,C,2458417,54806,2207003,2600219,251414
7,ENSG00000181220.10,149497809,chr7-149546528-C-T,rs886710,-1,C,T,149546528,48719,149301201,149694417,245327
7,ENSG00000136274.8,45088969,chr7-45228046-G-A,rs917088,-1,G,A,45228046,139077,44892361,45285577,335685
7,ENSG00000146674.8,45921272,chr7-45917370-T-G,rs9282734,-1,T,G,45917370,3902,45724664,46117880,192706
7,ENSG00000178381.7,1160196,chr7-1005302-T-C,rs9639696,-1,T,C,1005302,154894,963588,1356804,41714
7,ENSG00000205060.6,134316930,chr7-134155208-A-T,rs997316,-1,A,T,134155208,161722,134120322,134513538,34886
7,ENSG00000136243.12,23182048,chr7-23258796-C-A,rs10085838,1,C,A,23258796,76748,22985440,23378656,273356
7,ENSG00000157212.13,155003124,chr7-155068597-A-C,rs1017488,-1,A,C,155068597,65473,154806516,155199732,262081
7,ENSG00000188372.9,76424950,chr7-76402974-G-C,rs10228441,1,G,C,76402974,21976,76228342,76621558,174632
7,ENSG00000075790.6,107580246,chr7-107459123-G-A,rs10229063,1,G,A,107459123,121123,107383638,107776854,75485
7,ENSG00000253293.2,27174320,chr7-27203487-G-A,rs10233387,-1,G,A,27203487,29167,26977712,27370928,225775
7,ENSG00000106526.6,150323545,chr7-150289088-G-A,rs10248343,-1,G,A,150289088,34457,150126937,150520153,162151
7,ENSG00000164850.9,1088113,chr7-1232183-G-A,rs10249139,1,G,A,1232183,144070,891505,1284721,340678
7,ENSG00000204947.4,149126324,chr7-149236845-A-C,rs10250080,-1,A,C,149236845,110521,148929716,149322932,307129
7,ENSG00000136237.12,22357154,chr7-22435302-A-G,rs10250942,-1,A,G,22435302,78148,22160546,22553762,274756
7,ENSG00000172331.7,134646853,chr7-134659466-T-A,rs1025097,1,T,A,134659466,12613,134450245,134843461,209221
7,ENSG00000172331.7,134646853,chr7-134659466-T-C,rs1025097,1,T,C,134659466,12613,134450245,134843461,209221
7,ENSG00000106399.7,7718607,chr7-7873680-T-C,rs10255556,-1,T,C,7873680,155073,7521999,7915215,351681
7,ENSG00000106052.8,27740162,chr7-27892688-A-C,rs10258132,1,A,C,27892688,152526,27543554,27936770,349134
7,ENSG00000003147.13,8262167,chr7-8179168-G-A,rs10264092,-1,G,A,8179168,82999,8065559,8458775,113609
7,ENSG00000106400.7,101218165,chr7-101221803-G-A,rs10265206,1,G,A,101221803,3638,101021557,101414773,200246
7,ENSG00000178381.7,1160196,chr7-1132882-C-A,rs10265758,-1,C,A,1132882,27314,963588,1356804,169294
7,ENSG00000178381.7,1160196,chr7-1132882-C-T,rs10265758,-1,C,T,1132882,27314,963588,1356804,169294
7,ENSG00000122786.13,134779634,chr7-134770615-A-G,rs10266371,1,A,G,134770615,9019,134583026,134976242,187589
7,ENSG00000135250.12,105388921,chr7-105396243-G-T,rs10267633,-1,G,T,105396243,7322,105192313,105585529,203930
7,ENSG00000077063.6,117873441,chr7-117897603-A-G,rs10487379,-1,A,G,117897603,24162,117676833,118070049,220770
7,ENSG00000132436.7,50450350,chr7-50550906-T-C,rs10499695,-1,T,C,50550906,100556,50253742,50646958,297164
7,ENSG00000234444.3,64313961,chr7-64379957-C-T,rs10499774,1,C,T,64379957,65996,64117353,64510569,262604
7,ENSG00000212807.1,144239605,chr7-144414614-C-A,rs1074358,-1,C,A,144414614,175009,144042997,144436213,371617
7,ENSG00000090266.7,140696708,chr7-140634330-A-G,rs111752385,1,A,G,140634330,62378,140500100,140893316,134230
7,ENSG00000146859.4,135148072,chr7-134969179-T-C,rs11204,1,T,C,134969179,178893,134951464,135344680,17715
7,ENSG00000146833.10,99919530,chr7-100035359-T-C,rs1133790,-1,T,C,100035359,115829,99722922,100116138,312437
7,ENSG00000146576.8,6590021,chr7-6514495-C-T,rs115745154,1,C,T,6514495,75526,6393413,6786629,121082
7,ENSG00000146576.8,6590021,chr7-6514495-C-A,rs115745154,1,C,A,6514495,75526,6393413,6786629,121082
7,ENSG00000105854.7,95435028,chr7-95505406-G-A,rs116922441,-1,G,A,95505406,70378,95238420,95631636,266986
7,ENSG00000154978.8,55572502,chr7-55473993-G-A,rs117337937,-1,G,A,55473993,98509,55375894,55769110,98099
7,ENSG00000126522.10,66075819,chr7-65998667-G-A,rs117429228,1,G,A,65998667,77152,65879211,66272427,119456
7,ENSG00000106565.12,150800364,chr7-150986933-G-A,rs117564322,-1,G,A,150986933,186569,150603756,150996972,383177
7,ENSG00000002933.3,150800769,chr7-150986933-G-A,rs117564322,1,G,A,150986933,186164,150604161,150997377,382772
7,ENSG00000197576.8,27130757,chr7-27150779-A-C,rs11762730,-1,A,C,27150779,20022,26934149,27327365,216630
7,ENSG00000106636.3,44200978,chr7-44332588-G-A,rs11762769,1,G,A,44332588,131610,44004370,44397586,328218
7,ENSG00000164659.10,87059654,chr7-87236899-A-G,rs11771665,-1,A,G,87236899,177245,86863046,87256262,373853
7,ENSG00000186480.8,155297878,chr7-155302883-G-T,rs11772189,1,G,T,155302883,5005,155101270,155494486,201613
7,ENSG00000186480.8,155297878,chr7-155302883-G-A,rs11772189,1,G,A,155302883,5005,155101270,155494486,201613
7,ENSG00000090263.10,141014952,chr7-140990752-T-G,rs118102967,-1,T,G,140990752,24200,140818344,141211560,172408
7,ENSG00000106366.5,101127104,chr7-101277394-T-C,rs118191741,1,T,C,101277394,150290,100930496,101323712,346898
7,ENSG00000146535.8,2844308,chr7-2873445-T-C,rs1182142,-1,T,C,2873445,29137,2647700,3040916,225745
7,ENSG00000106392.5,7182544,chr7-7229225-G-T,rs11972106,1,G,T,7229225,46681,6985936,7379152,243289
7,ENSG00000002746.8,43112647,chr7-43287021-G-A,rs11978433,1,G,A,43287021,174374,42916039,43309255,370982
7,ENSG00000002726.14,150852517,chr7-150813915-C-T,rs11981656,1,C,T,150813915,38602,150655909,151049125,158006
7,ENSG00000135249.3,105532201,chr7-105640741-G-A,rs11983798,1,G,A,105640741,108540,105335593,105728809,305148
7,ENSG00000158623.10,130668748,chr7-130480095-C-G,rs12112550,-1,C,G,130480095,188653,130472140,130865356,7955
7,ENSG00000213462.4,65006687,chr7-64937553-C-T,rs12534485,-1,C,T,64937553,69134,64810079,65203295,127474
7,ENSG00000091127.8,105522271,chr7-105605307-A-G,rs12535264,-1,A,G,105605307,83036,105325663,105718879,279644
7,ENSG00000128585.11,131327876,chr7-131191046-C-T,rs12535530,1,C,T,131191046,136830,131131268,131524484,59778
7,ENSG00000136238.13,6374527,chr7-6396270-G-A,rs12536544,1,G,A,6396270,21743,6177919,6571135,218351
7,ENSG00000155849.10,37448864,chr7-37318051-T-C,rs12666889,-1,T,C,37318051,130813,37252256,37645472,65795
7,ENSG00000196329.5,150737418,chr7-150573252-A-G,rs12669961,1,A,G,150573252,164166,150540810,150934026,32442
7,ENSG00000196636.7,97117698,chr7-97157313-C-A,rs12670377,1,C,A,97157313,39615,96921090,97314306,236223
7,ENSG00000106153.12,56106476,chr7-56090888-T-C,rs12673255,-1,T,C,56090888,15588,55909868,56303084,181020
7,ENSG00000128609.9,123557818,chr7-123665390-A-C,rs12706544,-1,A,C,123665390,107572,123361210,123754426,304180
7,ENSG00000164690.3,155812463,chr7-155975112-C-T,rs13224793,-1,C,T,155975112,162649,155615855,156009071,359257
7,ENSG00000129103.13,56064286,chr7-56072925-T-G,rs13238899,1,T,G,56072925,8639,55867678,56260894,205247
7,ENSG00000136270.9,45111697,chr7-45098718-T-A,rs13246602,-1,T,A,45098718,12979,44915089,45308305,183629
7,ENSG00000136247.10,6577454,chr7-6589813-G-T,rs13312180,1,G,T,6589813,12359,6380846,6774062,208967
7,ENSG00000001629.5,92245974,chr7-92439301-G-T,rs13438466,1,G,T,92439301,193327,92049366,92442582,389935
7,ENSG00000001629.5,92245974,chr7-92439301-G-C,rs13438466,1,G,C,92439301,193327,92049366,92442582,389935
7,ENSG00000214253.4,101245081,chr7-101209892-T-C,rs1468358,-1,T,C,101209892,35189,101048473,101441689,161419
7,ENSG00000214253.4,101245081,chr7-101209892-T-A,rs1468358,-1,T,A,101209892,35189,101048473,101441689,161419
7,ENSG00000128524.4,128862856,chr7-128863489-T-C,rs1472147,1,T,C,128863489,633,128666248,129059464,197241
7,ENSG00000127995.12,94509809,chr7-94336724-T-C,rs1557658,1,T,C,94336724,173085,94313201,94706417,23523
7,ENSG00000070882.8,24980178,chr7-24987040-C-T,rs16873726,-1,C,T,24987040,6862,24783570,25176786,203470
7,ENSG00000105928.9,24757464,chr7-24717611-G-A,rs17149980,-1,G,A,24717611,39853,24560856,24954072,156755
7,ENSG00000127951.5,77199819,chr7-77190972-G-C,rs17155678,-1,G,C,77190972,8847,77003211,77396427,187761
7,ENSG00000064393.11,139777998,chr7-139942907-C-T,rs17161280,-1,C,T,139942907,164909,139581390,139974606,361517
7,ENSG00000127993.9,92528795,chr7-92422230-A-G,rs17164547,1,A,G,92422230,106565,92332187,92725403,90043
7,ENSG00000106484.8,130492085,chr7-130360838-G-C,rs17164838,1,G,C,130360838,131247,130295477,130688693,65361
7,ENSG00000158467.12,129225030,chr7-129069117-C-T,rs17167079,1,C,T,129069117,155913,129028422,129421638,40695
7,ENSG00000122557.4,35695135,chr7-35559810-T-C,rs17171522,-1,T,C,35559810,135325,35498527,35891743,61283
7,ENSG00000221866.5,132576470,chr7-132502137-G-A,rs17224513,-1,G,A,132502137,74333,132379862,132773078,122275
7,ENSG00000105825.7,93890753,chr7-94077908-T-G,rs17247328,-1,T,G,94077908,187155,93694145,94087361,383763
7,ENSG00000160999.8,102286868,chr7-102270864-C-T,rs1725604,1,C,T,102270864,16004,102090260,102483476,180604
7,ENSG00000136193.10,29989801,chr7-29885070-A-C,rs174966,-1,A,C,29885070,104731,29793193,30186409,91877
7,ENSG00000164708.5,44065567,chr7-44060774-C-T,rs17546439,-1,C,T,44060774,4793,43868959,44262175,191815
7,ENSG00000008282.3,106112312,chr7-106085811-C-T,rs176479,-1,C,T,106085811,26501,105915704,106308920,170107
7,ENSG00000106125.14,30771417,chr7-30801825-C-T,rs17781398,1,C,T,30801825,30408,30574809,30968025,227016
7,ENSG00000106009.11,2555524,chr7-2405685-A-G,rs17793630,-1,A,G,2405685,149839,2358916,2752132,46769
7,ENSG00000184903.5,111562492,chr7-111645484-T-C,rs1859744,-1,T,C,111645484,82992,111365884,111759100,279600
7,ENSG00000146776.10,105876599,chr7-105863089-C-T,rs1859814,-1,C,T,105863089,13510,105679991,106073207,183098
7,ENSG00000133574.4,150567390,chr7-150584274-G-A,rs1960024,1,G,A,150584274,16884,150370782,150763998,213492
7,ENSG00000011426.6,36389862,chr7-36243158-G-A,rs196538,1,G,A,36243158,146704,36193254,36586470,49904
7,ENSG00000122547.6,36153254,chr7-36253867-G-T,rs196551,1,G,T,36253867,100613,35956646,36349862,297221
7,ENSG00000196335.8,23710219,chr7-23670840-A-G,rs1978252,1,A,G,23670840,39379,23513611,23906827,157229
7,ENSG00000105875.9,135211526,chr7-135107666-T-C,rs1986359,-1,T,C,135107666,103860,135014918,135408134,92748
7,ENSG00000153790.7,25180354,chr7-25016121-A-G,rs2040672,-1,A,G,25016121,164233,24983746,25376962,32375
7,ENSG00000135253.8,128910709,chr7-128740695-G-A,rs2060717,-1,G,A,128740695,170014,128714101,129107317,26594
7,ENSG00000091136.9,108003161,chr7-108104584-A-G,rs2074748,-1,A,G,108104584,101423,107806553,108199769,298031
7,ENSG00000106302.5,123845169,chr7-123954152-G-A,rs2285996,1,G,A,123954152,108983,123648561,124041777,305591
7,ENSG00000133612.13,151086475,chr7-151191701-A-G,rs2288649,1,A,G,151191701,105226,150889867,151283083,301834
7,ENSG00000164896.13,151080809,chr7-151128405-A-G,rs2288651,-1,A,G,151128405,47596,150884201,151277417,244204
7,ENSG00000188707.4,150322639,chr7-150407322-C-T,rs2293282,1,C,T,150407322,84683,150126031,150519247,281291
7,ENSG00000136261.10,16646181,chr7-16527020-C-G,rs2301968,1,C,G,16527020,119161,16449573,16842789,77447
7,ENSG00000106105.9,30594878,chr7-30755672-A-G,rs2302339,1,A,G,30755672,160794,30398270,30791486,357402
7,ENSG00000127955.11,80134831,chr7-80136306-C-A,rs2428469,1,C,A,80136306,1475,79938223,80331439,198083
7,ENSG00000013374.10,151341812,chr7-151340035-C-T,rs2487149,1,C,T,151340035,1777,151145204,151538420,194831
7,ENSG00000106624.4,44104345,chr7-44105422-A-G,rs2595705,1,A,G,44105422,1077,43907737,44300953,197685
7,ENSG00000170265.6,149195546,chr7-149234431-G-A,rs2693319,1,G,A,149234431,38885,148998938,149392154,235493
7,ENSG00000243317.3,135662514,chr7-135482251-T-C,rs2696887,1,T,C,135482251,180263,135465906,135859122,16345
7,ENSG00000172115.4,25125260,chr7-25168355-T-C,rs2717858,-1,T,C,25168355,43095,24928652,25321868,239703
7,ENSG00000106617.8,151877115,chr7-151707367-A-G,rs2727562,-1,A,G,151707367,169748,151680507,152073723,26860
7,ENSG00000126870.11,158856558,chr7-158943757-T-C,rs2730247,1,T,C,158943757,87199,158659950,159053166,283807
7,ENSG00000197037.6,99616946,chr7-99663111-C-T,rs28365086,1,C,T,99663111,46165,99420338,99813554,242773
7,ENSG00000188191.8,727281,chr7-586631-A-G,rs28415285,-1,A,G,586631,140650,530673,923889,55958
7,ENSG00000186088.10,77416349,chr7-77230970-C-T,rs3108450,-1,C,T,77230970,185379,77219741,77612957,11229
7,ENSG00000105855.4,20330900,chr7-20307947-A-G,rs3114431,1,A,G,20307947,22953,20134292,20527508,173655
7,ENSG00000196411.5,100827523,chr7-100803648-T-A,rs314348,-1,T,A,100803648,23875,100630915,101024131,172733
7,ENSG00000196411.5,100827523,chr7-100803648-T-G,rs314348,-1,T,G,100803648,23875,100630915,101024131,172733
7,ENSG00000196411.5,100827523,chr7-100803648-T-C,rs314348,-1,T,C,100803648,23875,100630915,101024131,172733
7,ENSG00000106367.9,101154476,chr7-101174620-A-G,rs34985488,1,A,G,101174620,20144,100957868,101351084,216752
7,ENSG00000171130.11,149873969,chr7-149868074-A-G,rs3735333,1,A,G,149868074,5895,149677361,150070577,190713
7,ENSG00000157680.8,137846974,chr7-137791825-C-T,rs3800665,-1,C,T,137791825,55149,137650366,138043582,141459
7,ENSG00000106268.11,2242226,chr7-2077626-C-T,rs3800875,1,C,T,2077626,164600,2045618,2438834,32008
7,ENSG00000164548.6,23531981,chr7-23344879-C-G,rs3807462,-1,C,G,23344879,187102,23335373,23728589,9506
7,ENSG00000164916.7,4682295,chr7-4800251-T-C,rs3816854,1,T,C,4800251,117956,4485687,4878903,314564
7,ENSG00000164849.6,1044546,chr7-984945-T-C,rs3824081,1,T,C,984945,59601,847938,1241154,137007
7,ENSG00000128567.11,131556628,chr7-131687162-A-G,rs4073301,-1,A,G,131687162,130534,131360020,131753236,327142
7,ENSG00000127920.4,93921735,chr7-94057064-C-T,rs41526,1,C,T,94057064,135329,93725127,94118343,331937
7,ENSG00000127920.4,93921735,chr7-94057064-C-G,rs41526,1,C,G,94057064,135329,93725127,94118343,331937
7,ENSG00000196367.7,98878532,chr7-98973260-A-C,rs41645,1,A,C,98973260,94728,98681924,99075140,291336
7,ENSG00000071243.11,120950777,chr7-121004503-G-A,rs41704,1,G,A,121004503,53726,120754169,121147385,250334
7,ENSG00000106049.3,27662883,chr7-27678097-G-C,rs42102,-1,G,C,27678097,15214,27466275,27859491,211822
7,ENSG00000164649.15,21945899,chr7-21906222-C-T,rs4445125,-1,C,T,21906222,39677,21749291,22142507,156931
7,ENSG00000128591.11,128830406,chr7-128770687-T-G,rs4566976,1,T,G,128770687,59719,128633798,129027014,136889
7,ENSG00000006625.11,30504829,chr7-30662298-G-A,rs4723000,-1,G,A,30662298,157469,30308221,30701437,354077
7,ENSG00000240583.5,30911853,chr7-30740601-C-T,rs4723008,1,C,T,30740601,171252,30715245,31108461,25356
7,ENSG00000164742.9,45574368,chr7-45543259-A-G,rs4724414,1,A,G,45543259,31109,45377760,45770976,165499
7,ENSG00000215045.4,6551461,chr7-6562061-A-C,rs4724823,-1,A,C,6562061,10600,6354853,6748069,207208
7,ENSG00000197362.8,149090718,chr7-149250607-A-G,rs4725801,-1,A,G,149250607,159889,148894110,149287326,356497
7,ENSG00000127399.10,150323355,chr7-150395596-C-T,rs4725889,1,C,T,150395596,72241,150126747,150519963,268849
7,ENSG00000105939.7,139109720,chr7-139096676-T-C,rs4728461,-1,T,C,139096676,13044,138913112,139306328,183564
7,ENSG00000227471.3,134549110,chr7-134541036-C-T,rs4732036,1,C,T,134541036,8074,134352502,134745718,188534
7,ENSG00000105865.6,107563971,chr7-107701083-T-A,rs55701254,1,T,A,107701083,137112,107367363,107760579,333720
7,ENSG00000105963.7,954680,chr7-934672-G-T,rs62433082,-1,G,T,934672,20008,758072,1151288,176600
7,ENSG00000105926.9,24573452,chr7-24590782-C-G,rs62449807,1,C,G,24590782,17330,24376844,24770060,213938
7,ENSG00000006451.3,39623572,chr7-39584670-C-T,rs62453608,1,C,T,39584670,38902,39426964,39820180,157706
7,ENSG00000008256.11,6272624,chr7-6129276-C-A,rs62454270,-1,C,A,6129276,143348,6076016,6469232,53260
7,ENSG00000106004.4,27143681,chr7-27142710-T-G,rs62454414,-1,T,G,27142710,971,26947073,27340289,195637
7,ENSG00000168090.5,100088969,chr7-100041564-G-A,rs62484984,1,G,A,100041564,47405,99892361,100285577,149203
7,ENSG00000006704.6,74453906,chr7-74395124-T-C,rs6460078,1,T,C,74395124,58782,74257298,74650514,137826
7,ENSG00000188732.6,23680199,chr7-23625053-G-A,rs6461718,1,G,A,23625053,55146,23483591,23876807,141462
7,ENSG00000122778.5,138981389,chr7-138961571-C-T,rs675396,-1,C,T,138961571,19818,138784781,139177997,176790
7,ENSG00000161057.6,103347643,chr7-103372286-C-G,rs6942876,1,C,G,103372286,24643,103151035,103544251,221251
7,ENSG00000105784.11,87628398,chr7-87508870-A-G,rs6946379,1,A,G,87508870,119528,87431790,87825006,77080
7,ENSG00000008311.10,122144249,chr7-122270959-A-C,rs6946696,-1,A,C,122270959,126710,121947641,122340857,323318
7,ENSG00000002745.7,121329000,chr7-121309188-A-C,rs6953489,1,A,C,121309188,19812,121132392,121525608,176796
7,ENSG00000002745.7,121329000,chr7-121309188-A-G,rs6953489,1,A,G,121309188,19812,121132392,121525608,176796
7,ENSG00000005249.6,107044705,chr7-107010095-T-C,rs6954575,1,T,C,107010095,34610,106848097,107241313,161998
7,ENSG00000106128.13,30963953,chr7-30769481-C-T,rs6958083,1,C,T,30769481,194472,30767345,31160561,2136
7,ENSG00000136240.5,6484152,chr7-6495429-C-G,rs6959768,-1,C,G,6495429,11277,6287544,6680760,207885
7,ENSG00000146856.10,134986508,chr7-135111234-T-C,rs6962111,1,T,C,135111234,124726,134789900,135183116,321334
7,ENSG00000221838.5,100101643,chr7-100020983-G-A,rs6963345,1,G,A,100020983,80660,99905035,100298251,115948
7,ENSG00000132434.5,55365337,chr7-55492167-A-G,rs6964031,1,A,G,55492167,126830,55168729,55561945,323438
7,ENSG00000196584.2,152676141,chr7-152564807-A-T,rs6965541,-1,A,T,152564807,111334,152479533,152872749,85274
7,ENSG00000196584.2,152676141,chr7-152564807-A-C,rs6965541,-1,A,C,152564807,111334,152479533,152872749,85274
7,ENSG00000135211.5,77798434,chr7-77796930-T-G,rs6970158,-1,T,G,77796930,1504,77601826,77995042,195104
7,ENSG00000157259.6,92447482,chr7-92562432-C-A,rs6970992,1,C,A,92562432,114950,92250874,92644090,311558
7,ENSG00000205277.5,100969565,chr7-101019688-G-A,rs6973913,1,G,A,101019688,50123,100772957,101166173,246731
7,ENSG00000214309.3,100126967,chr7-100141739-A-G,rs6975031,1,A,G,100141739,14772,99930359,100323575,211380
7,ENSG00000229937.4,18027846,chr7-18039468-A-G,rs6977061,-1,A,G,18039468,11622,17831238,18224454,208230
7,ENSG00000033100.9,151232483,chr7-151134721-C-G,rs6979622,1,C,G,151134721,97762,151035875,151429091,98846
7,ENSG00000033100.9,151232483,chr7-151134721-C-T,rs6979622,1,C,T,151134721,97762,151035875,151429091,98846
7,ENSG00000127946.12,75738941,chr7-75886346-G-A,rs71560493,-1,G,A,75886346,147405,75542333,75935549,344013
7,ENSG00000106571.8,42237209,chr7-42137348-C-T,rs720791,-1,C,T,42137348,99861,42040601,42433817,96747
7,ENSG00000086300.11,26291862,chr7-26350495-C-T,rs73068463,1,C,T,26350495,58633,26095254,26488470,255241
7,ENSG00000106341.6,31687215,chr7-31824188-G-A,rs73092410,1,G,A,31824188,136973,31490607,31883823,333581
7,ENSG00000146731.5,56051765,chr7-56040301-A-C,rs73140801,1,A,C,56040301,11464,55855157,56248373,185144
7,ENSG00000146731.5,56051765,chr7-56040301-A-G,rs73140801,1,A,G,56040301,11464,55855157,56248373,185144
7,ENSG00000105993.9,157337004,chr7-157459135-A-G,rs73178459,1,A,G,157459135,122131,157140396,157533612,318739
7,ENSG00000106344.3,128343908,chr7-128344490-A-C,rs73230661,-1,A,C,128344490,582,128147300,128540516,197190
7,ENSG00000185811.12,50304716,chr7-50405384-C-A,rs7349964,1,C,A,50405384,100668,50108108,50501324,297276
7,ENSG00000185811.12,50304716,chr7-50405384-C-T,rs7349964,1,C,T,50405384,100668,50108108,50501324,297276
7,ENSG00000106070.12,50782896,chr7-50768456-T-G,rs74813781,-1,T,G,50768456,14440,50586288,50979504,182168
7,ENSG00000106638.9,73578579,chr7-73578528-C-G,rs76029572,-1,C,G,73578528,51,73381971,73775187,196557
7,ENSG00000169902.8,66205334,chr7-66249954-C-T,rs76475117,1,C,T,66249954,44620,66008726,66401942,241228
7,ENSG00000198286.5,3043867,chr7-3083820-C-A,rs7776783,-1,C,A,3083820,39953,2847259,3240475,236561
7,ENSG00000198286.5,3043867,chr7-3083820-C-T,rs7776783,-1,C,T,3083820,39953,2847259,3240475,236561
7,ENSG00000050327.8,144355402,chr7-144525836-A-G,rs7779534,1,A,G,144525836,170434,144158794,144552010,367042
7,ENSG00000106013.8,118224704,chr7-118412224-A-G,rs7780891,1,A,G,118412224,187520,118028096,118421312,384128
7,ENSG00000257923.3,101817626,chr7-101705509-C-T,rs7784756,1,C,T,101705509,112117,101621018,102014234,84491
7,ENSG00000122779.10,138460259,chr7-138455833-C-A,rs7786347,1,C,A,138455833,4426,138263651,138656867,192182
7,ENSG00000059378.7,140062951,chr7-139939656-A-G,rs77899375,-1,A,G,139939656,123295,139866343,140259559,73313
7,ENSG00000165171.6,73842516,chr7-73794320-T-C,rs77900184,-1,T,C,73794320,48196,73645908,74039124,148412
7,ENSG00000213214.3,144195833,chr7-144178446-T-C,rs7791258,-1,T,C,144178446,17387,143999225,144392441,179221
7,ENSG00000241258.2,66114847,chr7-66222434-G-A,rs7791750,1,G,A,66222434,107587,65918239,66311455,304195
7,ENSG00000059377.10,139829264,chr7-139818820-T-C,rs77943929,1,T,C,139818820,10444,139632656,140025872,186164
7,ENSG00000059377.10,139829264,chr7-139818820-T-G,rs77943929,1,T,G,139818820,10444,139632656,140025872,186164
7,ENSG00000161036.5,102464984,chr7-102412967-C-A,rs7797435,1,C,A,102412967,52017,102268376,102661592,144591
7,ENSG00000164647.4,90154469,chr7-90007090-C-A,rs7799411,1,C,A,90007090,147379,89957861,90351077,49229
7,ENSG00000181444.8,149773588,chr7-149744229-A-C,rs7802599,-1,A,C,149744229,29359,149576980,149970196,167249
7,ENSG00000187416.7,104328603,chr7-104473864-G-A,rs7803448,1,G,A,104473864,145261,104131995,104525211,341869
7,ENSG00000121716.11,100358117,chr7-100467096-A-G,rs7806537,1,A,G,100467096,108979,100161509,100554725,305587
7,ENSG00000187260.9,151410038,chr7-151334421-A-G,rs7807594,-1,A,G,151334421,75617,151213430,151606646,120991
7,ENSG00000157240.2,91264433,chr7-91231036-C-T,rs7809443,1,C,T,91231036,33397,91067825,91461041,163211
7,ENSG00000146733.9,56051444,chr7-55903760-T-C,rs78485977,-1,T,C,55903760,147684,55854836,56248052,48924
7,ENSG00000169402.10,6757590,chr7-6594702-T-C,rs79000164,1,T,C,6594702,162888,6560982,6954198,33720
7,ENSG00000166529.9,100049774,chr7-100058940-C-G,rs79017592,1,C,G,100058940,9166,99853166,100246382,205774
7,ENSG00000236609.3,6615610,chr7-6548001-G-T,rs79715413,1,G,T,6548001,67609,6419002,6812218,128999
7,ENSG00000105968.14,44848087,chr7-44745098-C-T,rs799449,-1,C,T,44745098,102989,44651479,45044695,93619
7,ENSG00000128512.13,112206399,chr7-112111102-G-T,rs849015,-1,G,T,112111102,95297,112009791,112403007,101311
7,ENSG00000122512.9,6009049,chr7-6070185-C-T,rs852144,-1,C,T,6070185,61136,5812441,6205657,257744
7,ENSG00000196453.6,149461062,chr7-149479026-C-A,rs870970,-1,C,A,149479026,17964,149264454,149657670,214572
7,ENSG00000009954.6,73522293,chr7-73672716-A-G,rs941297,-1,A,G,73672716,150423,73325685,73718901,347031
7,ENSG00000171115.3,150450630,chr7-150446717-A-T,rs952825,1,A,T,150446717,3913,150254022,150647238,192695
7,ENSG00000155026.10,5967204,chr7-6134748-G-A,rs9648587,-1,G,A,6134748,167544,5770596,6163812,364152
7,ENSG00000155530.2,134127299,chr7-134155208-A-T,rs997316,1,A,T,134155208,27909,133930691,134323907,224517
6,ENSG00000112282.12,131628242,chr6-131595075-A-G,rs10081029,-1,A,G,131595075,33167,131431634,131824850,163441
6,ENSG00000231389.2,33080710,chr6-33069222-T-C,rs1042190,-1,T,C,33069222,11488,32884102,33277318,185120
6,ENSG00000156711.10,36130513,chr6-36147711-C-T,rs10447375,1,C,T,36147711,17198,35933905,36327121,213806
6,ENSG00000047579.13,15663028,chr6-15537094-T-C,rs10456773,-1,T,C,15537094,125934,15466420,15859636,70674
6,ENSG00000111843.8,10723070,chr6-10723216-A-C,rs1045911,1,A,C,10723216,146,10526462,10919678,196754
6,ENSG00000111843.8,10723070,chr6-10723216-A-G,rs1045911,1,A,G,10723216,146,10526462,10919678,196754
6,ENSG00000184357.3,27867588,chr6-27778811-A-T,rs10484401,-1,A,T,27778811,88777,27670980,28064196,107831
6,ENSG00000112031.11,153002709,chr6-152954190-T-C,rs10484864,-1,T,C,152954190,48519,152806101,153199317,148089
6,ENSG00000111962.7,148747030,chr6-148790981-A-G,rs10499260,1,A,G,148790981,43951,148550422,148943638,240559
6,ENSG00000196735.6,32637406,chr6-32659937-T-G,rs1063355,1,T,G,32659937,22531,32440798,32834014,219139
6,ENSG00000124613.4,27388759,chr6-27368934-T-C,rs10755644,1,T,C,27368934,19825,27192151,27585367,176783
6,ENSG00000124508.12,26383108,chr6-26405036-G-C,rs10807008,1,G,C,26405036,21928,26186500,26579716,218536
6,ENSG00000112304.5,24667077,chr6-24703312-G-C,rs10946720,1,G,C,24703312,36235,24470469,24863685,232843
6,ENSG00000078401.6,12290361,chr6-12343729-T-G,rs10947954,1,T,G,12343729,53368,12093753,12486969,249976
6,ENSG00000188820.8,116461375,chr6-116460830-C-T,rs11153612,1,C,T,116460830,545,116264767,116657983,196063
6,ENSG00000111897.5,122471807,chr6-122362886-G-A,rs11154070,-1,G,A,122362886,108921,122275199,122668415,87687
6,ENSG00000146373.11,124962437,chr6-124902451-T-G,rs11154277,1,T,G,124902451,59986,124765829,125159045,136622
6,ENSG00000214113.5,5260950,chr6-5260461-C-T,rs111557465,-1,C,T,5260461,489,5064342,5457558,196119
6,ENSG00000187566.3,18122677,chr6-18204714-A-C,rs112298915,-1,A,C,18204714,82037,17926069,18319285,278645
6,ENSG00000137267.4,3157544,chr6-3205200-T-C,rs11242827,-1,T,C,3205200,47656,2960936,3354152,244264
6,ENSG00000118407.9,75493800,chr6-75476322-T-C,rs113307287,-1,T,C,75476322,17478,75297192,75690408,179130
6,ENSG00000204580.6,30884519,chr6-30751704-C-A,rs113617295,1,C,A,30751704,132815,30687911,31081127,63793
6,ENSG00000168116.9,57046693,chr6-57189149-T-C,rs11398,1,T,C,57189149,142456,56850085,57243301,339064
6,ENSG00000137312.10,30742687,chr6-30869513-C-T,rs114059502,-1,C,T,30869513,126826,30546079,30939295,323434
6,ENSG00000196230.7,30720352,chr6-30643899-C-A,rs1140809,1,C,A,30643899,76453,30523744,30916960,120155
6,ENSG00000137409.12,36986196,chr6-36968707-C-T,rs11548580,-1,C,T,36968707,17489,36789588,37182804,179119
6,ENSG00000146476.6,151452466,chr6-151445687-C-A,rs11550103,1,C,A,151445687,6779,151255858,151649074,189829
6,ENSG00000137171.10,43059631,chr6-43061550-G-A,rs11558979,1,G,A,43061550,1919,42863023,43256239,198527
6,ENSG00000204482.5,31586277,chr6-31590014-G-A,rs11575839,1,G,A,31590014,3737,31389669,31782885,200345
6,ENSG00000118491.7,143864474,chr6-143833841-G-A,rs116910255,1,G,A,143833841,30633,143667866,144061082,165975
6,ENSG00000082269.12,70413508,chr6-70345915-T-C,rs117062375,1,T,C,70345915,67593,70216900,70610116,129015
6,ENSG00000124635.6,27132795,chr6-27130248-G-A,rs11753580,-1,G,A,27130248,2547,26936187,27329403,194061
6,ENSG00000122335.8,158168262,chr6-158151943-G-T,rs11756587,-1,G,T,158151943,16319,157971654,158364870,180289
6,ENSG00000124664.6,34556329,chr6-34546430-C-T,rs11757517,-1,C,T,34546430,9899,34359721,34752937,186709
6,ENSG00000124507.4,34466076,chr6-34467254-A-G,rs11759825,1,A,G,34467254,1178,34269468,34662684,197786
6,ENSG00000204574.6,30571442,chr6-30679595-C-T,rs118140680,1,C,T,30679595,108153,30374834,30768050,304761
6,ENSG00000203734.6,138796087,chr6-138906438-G-A,rs1188866,1,G,A,138906438,110351,138599479,138992695,306959
6,ENSG00000153046.12,4776404,chr6-4946122-A-G,rs11964806,1,A,G,4946122,169718,4579796,4973012,366326
6,ENSG00000137404.10,30690984,chr6-30584008-G-A,rs11968929,-1,G,A,30584008,106976,30494376,30887592,89632
6,ENSG00000050393.6,13814557,chr6-13817127-T-C,rs1204148,-1,T,C,13817127,2570,13617949,14011165,199178
6,ENSG00000137414.4,17600302,chr6-17699091-G-T,rs12199222,1,G,T,17699091,98789,17403694,17796910,295397
6,ENSG00000146409.5,132798637,chr6-132814890-T-C,rs12202407,-1,T,C,132814890,16253,132602029,132995245,212861
6,ENSG00000164484.7,130366017,chr6-130291855-G-A,rs12211846,1,G,A,130291855,74162,130169409,130562625,122446
6,ENSG00000027697.7,137219385,chr6-137293081-T-A,rs12213281,-1,T,A,137293081,73696,137022777,137415993,270304
6,ENSG00000197279.3,28080568,chr6-28191176-A-G,rs1237873,1,A,G,28191176,110608,27883960,28277176,307216
6,ENSG00000204392.5,31806966,chr6-31901358-G-A,rs12525922,-1,G,A,31901358,94392,31610358,32003574,291000
6,ENSG00000204592.5,30489509,chr6-30490287-G-A,rs1264457,1,G,A,30490287,778,30292901,30686117,197386
6,ENSG00000137310.7,31158589,chr6-31151812-G-T,rs1265109,1,G,T,31151812,6777,30961981,31355197,189831
6,ENSG00000204531.9,31170682,chr6-31149298-C-A,rs1265115,-1,C,A,31149298,21384,30974074,31367290,175224
6,ENSG00000234745.3,31357179,chr6-31172270-G-A,rs1265159,-1,G,A,31172270,184909,31160571,31553787,11699
6,ENSG00000173214.5,111259339,chr6-111253534-A-G,rs12662324,1,A,G,111253534,5805,111062731,111455947,190803
6,ENSG00000112659.8,43182196,chr6-43242957-A-G,rs12663537,1,A,G,43242957,60761,42985588,43378804,257369
6,ENSG00000171217.5,155264013,chr6-155235534-G-A,rs12663896,1,G,A,155235534,28479,155067405,155460621,168129
6,ENSG00000124496.8,42452045,chr6-42503841-G-A,rs12665070,-1,G,A,42503841,51796,42255437,42648653,248404
6,ENSG00000261272.1,31010474,chr6-31144960-C-A,rs130079,1,C,A,31144960,134486,30813866,31207082,331094
6,ENSG00000118514.9,134950101,chr6-134965367-T-C,rs13199205,-1,T,C,134965367,15266,134753493,135146709,211874
6,ENSG00000124575.5,26234987,chr6-26122729-G-A,rs13200797,-1,G,A,26122729,112258,26038379,26431595,84350
6,ENSG00000155085.9,109691202,chr6-109634847-C-T,rs13201430,-1,C,T,109634847,56355,109494594,109887810,140253
6,ENSG00000074706.9,154356803,chr6-154257211-C-T,rs13202830,-1,C,T,154257211,99592,154160195,154553411,97016
6,ENSG00000180992.5,44127452,chr6-44109619-A-G,rs1321097,-1,A,G,44109619,17833,43930844,44324060,178775
6,ENSG00000137200.6,37433221,chr6-37442727-T-C,rs13212461,1,T,C,37442727,9506,37236613,37629829,206114
6,ENSG00000079931.10,132401475,chr6-132405216-G-A,rs1338937,-1,G,A,132405216,3741,132204867,132598083,200349
6,ENSG00000135547.4,125749632,chr6-125914170-G-A,rs1407592,1,G,A,125914170,164538,125553024,125946240,361146
6,ENSG00000118503.9,137867259,chr6-137931946-G-A,rs1436271,1,G,A,137931946,64687,137670651,138063867,261295
6,ENSG00000213760.5,31546608,chr6-31679209-G-A,rs145921744,-1,G,A,31679209,132601,31350000,31743216,329209
6,ENSG00000186340.9,169253846,chr6-169190703-C-T,rs1467584,-1,C,T,169190703,63143,169057238,169450454,133465
6,ENSG00000146376.5,129710177,chr6-129695948-T-G,rs1476042,-1,T,G,129695948,14229,129513569,129906785,182379
6,ENSG00000112167.5,39115186,chr6-39156672-T-G,rs1544935,-1,T,G,39156672,41486,38918578,39311794,238094
6,ENSG00000151917.11,56955107,chr6-56992867-A-C,rs1562908,1,A,C,56992867,37760,56758499,57151715,234368
6,ENSG00000064995.12,34888042,chr6-34883049-G-C,rs15922,-1,G,C,34883049,4993,34691434,35084650,191615
6,ENSG00000204681.5,29633183,chr6-29712244-C-T,rs1611371,-1,C,T,29712244,79061,29436575,29829791,275669
6,ENSG00000204632.7,29827825,chr6-29861474-A-C,rs1611713,1,A,C,29861474,33649,29631217,30024433,230257
6,ENSG00000203778.2,112087591,chr6-112076242-C-T,rs1624814,1,C,T,112076242,11349,111890983,112284199,185259
6,ENSG00000204618.3,30075769,chr6-30018907-T-C,rs165256,-1,T,C,30018907,56862,29879161,30272377,139746
6,ENSG00000135315.7,84227643,chr6-84213170-G-T,rs16874339,-1,G,T,84213170,14473,84031035,84424251,182135
6,ENSG00000135315.7,84227643,chr6-84213170-G-A,rs16874339,-1,G,A,84213170,14473,84031035,84424251,182135
6,ENSG00000135336.8,87590135,chr6-87689106-G-C,rs16879704,1,G,C,87689106,98971,87393527,87786743,295579
6,ENSG00000010030.9,36387669,chr6-36379051-C-T,rs16888237,-1,C,T,36379051,8618,36191061,36584277,187990
6,ENSG00000112210.6,57222307,chr6-57211754-G-A,rs16888392,-1,G,A,57211754,10553,57025699,57418915,186055
6,ENSG00000124772.7,36839444,chr6-36869665-A-G,rs16889215,-1,A,G,36869665,30221,36642836,37036052,226829
6,ENSG00000112293.8,24489578,chr6-24462856-C-T,rs16889327,-1,C,T,24462856,26722,24292970,24686186,169886
6,ENSG00000188107.8,65707226,chr6-65806299-C-T,rs16897203,-1,C,T,65806299,99073,65510618,65903834,295681
6,ENSG00000197442.7,136792477,chr6-136937336-C-T,rs17053708,-1,C,T,136937336,144859,136595869,136989085,341467
6,ENSG00000112319.13,133241357,chr6-133436565-C-T,rs17062555,1,C,T,133436565,195208,133044749,133437965,391816
6,ENSG00000169976.5,144095573,chr6-144087998-G-A,rs17073338,-1,G,A,144087998,7575,143898965,144292181,189033
6,ENSG00000196911.5,116681211,chr6-116560906-G-A,rs17078060,1,G,A,116560906,120305,116484603,116877819,76303
6,ENSG00000096696.8,7541671,chr6-7537775-G-T,rs17142963,1,G,T,7537775,3896,7345063,7738279,192712
6,ENSG00000096696.8,7541671,chr6-7537775-G-A,rs17142963,1,G,A,7537775,3896,7345063,7738279,192712
6,ENSG00000204348.5,31972138,chr6-32079491-T-C,rs17201560,-1,T,C,32079491,107353,31775530,32168746,303961
6,ENSG00000203872.5,87344813,chr6-87330150-G-C,rs1746444,1,G,C,87330150,14663,87148205,87541421,181945
6,ENSG00000120254.10,150865702,chr6-150909701-G-A,rs1771845,1,G,A,150909701,43999,150669094,151062310,240607
6,ENSG00000111981.3,149963943,chr6-149943490-C-T,rs17748581,1,C,T,149943490,20453,149767335,150160551,176155
6,ENSG00000112715.16,43770211,chr6-43902342-G-A,rs1776723,1,G,A,43902342,132131,43573603,43966819,328739
6,ENSG00000112294.8,24494969,chr6-24491247-A-C,rs1883415,1,A,C,24491247,3722,24298361,24691577,192886
6,ENSG00000023892.8,35297818,chr6-35215372-T-G,rs1888822,1,T,G,35215372,82446,35101210,35494426,114162
6,ENSG00000146243.8,78867551,chr6-79011692-C-A,rs1933238,1,C,A,79011692,144141,78670943,79064159,340749
6,ENSG00000196126.6,32589848,chr6-32481634-T-C,rs1964995,-1,T,C,32481634,108214,32393240,32786456,88394
6,ENSG00000010704.13,26087429,chr6-25981420-A-G,rs199757,1,A,G,25981420,106009,25890821,26284037,90599
6,ENSG00000198721.8,4135575,chr6-4109747-G-A,rs2002835,-1,G,A,4109747,25828,3938967,4332183,170780
6,ENSG00000146278.9,89080751,chr6-89039386-G-A,rs205217,1,G,A,89039386,41365,88884143,89277359,155243
6,ENSG00000130348.7,106629578,chr6-106629627-G-A,rs2054365,1,G,A,106629627,49,106432970,106826186,196657
6,ENSG00000180573.7,26124172,chr6-26091108-T-C,rs2071303,1,T,C,26091108,33064,25927564,26320780,163544
6,ENSG00000204264.4,32844047,chr6-32843868-A-G,rs2071542,-1,A,G,32843868,179,32647439,33040655,196429
6,ENSG00000204305.8,32184253,chr6-32371734-C-T,rs2076535,-1,C,T,32371734,187481,31987645,32380861,384089
6,ENSG00000030110.7,33580276,chr6-33572432-A-G,rs210134,-1,A,G,33572432,7844,33383668,33776884,188764
6,ENSG00000137218.6,41779900,chr6-41655295-G-T,rs2143678,-1,G,T,41655295,124605,41583292,41976508,72003
6,ENSG00000146282.12,87589987,chr6-87456561-G-A,rs2179845,-1,G,A,87456561,133426,87393379,87786595,63182
6,ENSG00000172197.9,20212469,chr6-20197471-G-A,rs2182786,-1,G,A,20197471,14998,20015861,20409077,181610
6,ENSG00000164414.11,87472974,chr6-87470923-A-G,rs2207146,1,A,G,87470923,2051,87276366,87669582,194557
6,ENSG00000157593.11,44257528,chr6-44362819-C-T,rs2221224,-1,C,T,44362819,105291,44060920,44454136,301899
6,ENSG00000204410.9,31740005,chr6-31572779-T-C,rs2229094,1,T,C,31572779,167226,31543397,31936613,29382
6,ENSG00000187189.9,116254075,chr6-116254113-T-G,rs2232466,-1,T,G,116254113,38,116057467,116450683,196646
6,ENSG00000204516.5,31498145,chr6-31513369-C-A,rs2246871,1,C,A,31513369,15224,31301537,31694753,211832
6,ENSG00000204472.7,31615234,chr6-31616050-T-G,rs2259571,1,T,G,31616050,816,31418626,31811842,197424
6,ENSG00000135521.8,143843338,chr6-143951103-A-G,rs2268443,1,A,G,143951103,107765,143646730,144039946,304373
6,ENSG00000074935.7,112087482,chr6-112054441-G-A,rs2280153,-1,G,A,112054441,33041,111890874,112284090,163567
6,ENSG00000112357.7,136822592,chr6-136845512-A-G,rs2295592,1,A,G,136845512,22920,136625984,137019200,219528
6,ENSG00000158406.2,26285534,chr6-26285455-T-C,rs2393593,-1,T,C,26285455,79,26088926,26482142,196529
6,ENSG00000137338.4,28281572,chr6-28414975-C-T,rs2394098,1,C,T,28414975,133403,28084964,28478180,330011
6,ENSG00000124713.5,42960754,chr6-42972935-A-G,rs2395943,1,A,G,42972935,12181,42764146,43157362,208789
6,ENSG00000096092.5,52671113,chr6-52667174-C-T,rs2397098,1,C,T,52667174,3939,52474505,52867721,192669
6,ENSG00000112697.10,75284792,chr6-75231023-G-C,rs240410,-1,G,C,75231023,53769,75088184,75481400,142839
6,ENSG00000031691.5,49463370,chr6-49492265-A-G,rs2501968,1,A,G,49492265,28895,49266762,49659978,225503
6,ENSG00000244694.3,48111197,chr6-48258797-T-C,rs2503672,-1,T,C,48258797,147600,47914589,48307805,344208
6,ENSG00000198563.8,31542003,chr6-31450245-A-G,rs2596457,-1,A,G,31450245,91758,31345395,31738611,104850
6,ENSG00000172738.7,37258122,chr6-37236764-A-C,rs262925,-1,A,C,37236764,21358,37061514,37454730,175250
6,ENSG00000154079.5,70566930,chr6-70600428-A-G,rs2691505,1,A,G,70600428,33498,70370322,70763538,230106
6,ENSG00000204427.7,31703324,chr6-31777507-C-T,rs2736426,-1,C,T,31777507,74183,31506716,31899932,270791
6,ENSG00000124562.5,34757505,chr6-34687223-C-T,rs2744961,1,C,T,34687223,70282,34560897,34954113,126326
6,ENSG00000008083.8,15246069,chr6-15092434-G-T,rs2747507,1,G,T,15092434,153635,15049461,15442677,42973
6,ENSG00000175048.11,157381190,chr6-157388857-T-C,rs2749668,1,T,C,157388857,7667,157184582,157577798,204275
6,ENSG00000204248.5,33192467,chr6-33171178-G-A,rs2855437,-1,G,A,33171178,21289,32995859,33389075,175319
6,ENSG00000204228.3,33204655,chr6-33168798-C-T,rs2855448,1,C,T,33168798,35857,33008047,33401263,160751
6,ENSG00000223865.4,33075990,chr6-33078305-C-T,rs2856819,1,C,T,33078305,2315,32879382,33272598,198923
6,ENSG00000112062.6,36027808,chr6-36153598-C-T,rs2859129,1,C,T,36153598,125790,35831200,36224416,322398
6,ENSG00000026950.12,26402275,chr6-26430753-A-G,rs2893848,1,A,G,26430753,28478,26205667,26598883,225086
6,ENSG00000213588.3,33454576,chr6-33358473-A-G,rs3106192,1,A,G,33358473,96103,33257968,33651184,100505
6,ENSG00000204257.8,32953097,chr6-33129837-C-A,rs3129269,-1,C,A,33129837,176740,32756489,33149705,373348
6,ENSG00000236104.2,33317744,chr6-33346316-T-C,rs3130104,-1,T,C,33346316,28572,33121136,33514352,225180
6,ENSG00000137411.10,30914238,chr6-30937536-A-G,rs3132571,1,A,G,30937536,23298,30717630,31110846,219906
6,ENSG00000170542.5,2903309,chr6-2898362-A-G,rs318491,-1,A,G,2898362,4947,2706701,3099917,191661
6,ENSG00000001561.5,46129989,chr6-46079721-C-T,rs3734207,1,C,T,46079721,50268,45933381,46326597,146340
6,ENSG00000112796.4,46170980,chr6-46079721-C-T,rs3734207,-1,C,T,46079721,91259,45974372,46367588,105349
6,ENSG00000131013.3,149546043,chr6-149593917-C-T,rs3734295,-1,C,T,149593917,47874,149349435,149742651,244482
6,ENSG00000010017.8,13711835,chr6-13787346-G-A,rs3734672,-1,G,A,13787346,75511,13515227,13908443,272119
6,ENSG00000171462.9,43455548,chr6-43456041-A-G,rs3734688,-1,A,G,43456041,493,43258940,43652156,197101
6,ENSG00000112297.9,106360717,chr6-106519903-T-C,rs3747787,1,T,C,106519903,159186,106164109,106557325,355794
6,ENSG00000112599.7,42194956,chr6-42194650-A-G,rs3749921,-1,A,G,42194650,306,41998348,42391564,196302
6,ENSG00000111802.8,24666899,chr6-24665112-A-C,rs3756819,-1,A,C,24665112,1787,24470291,24863507,194821
6,ENSG00000196284.9,45377934,chr6-45379907-G-A,rs3763190,-1,G,A,45379907,1973,45181326,45574542,198581
6,ENSG00000198833.5,89352722,chr6-89282481-C-T,rs3777522,-1,C,T,89282481,70241,89156114,89549330,126367
6,ENSG00000146426.12,154995315,chr6-155150320-C-T,rs3792958,1,C,T,155150320,155005,154798707,155191923,351613
6,ENSG00000112655.10,43076314,chr6-43098175-A-G,rs3793017,1,A,G,43098175,21861,42879706,43272922,218469
6,ENSG00000112763.10,26457955,chr6-26466954-T-C,rs3799380,1,T,C,26466954,8999,26261347,26654563,205607
6,ENSG00000183826.12,38639929,chr6-38678854-A-G,rs3799703,-1,A,G,38678854,38925,38443321,38836537,235533
6,ENSG00000124615.12,39934462,chr6-39934461-C-T,rs3800349,-1,C,T,39934461,1,39737854,40131070,196607
6,ENSG00000184465.11,169702029,chr6-169658278-C-T,rs3800544,-1,C,T,169658278,43751,169505421,169898637,152857
6,ENSG00000146085.6,49463253,chr6-49463856-A-G,rs3806988,-1,A,G,49463856,603,49266645,49659861,197211
6,ENSG00000185127.5,169702190,chr6-169790104-G-A,rs3807067,1,G,A,169790104,87914,169505582,169898798,284522
6,ENSG00000237541.3,32741391,chr6-32668032-T-C,rs3828790,1,T,C,32668032,73359,32544783,32937999,123249
6,ENSG00000179344.11,32666657,chr6-32668032-T-C,rs3828790,-1,T,C,32668032,1375,32470049,32863265,197983
6,ENSG00000047932.9,117602511,chr6-117546888-T-C,rs389663,-1,T,C,117546888,55623,117405903,117799119,140985
6,ENSG00000204351.5,31959175,chr6-31979309-G-A,rs391165,1,G,A,31979309,20134,31762567,32155783,216742
6,ENSG00000111817.11,116370947,chr6-116316610-C-A,rs3935474,1,C,A,116316610,54337,116174339,116567555,142271
6,ENSG00000111817.11,116370947,chr6-116316610-C-G,rs3935474,1,C,G,116316610,54337,116174339,116567555,142271
6,ENSG00000112280.11,70303084,chr6-70280967-G-A,rs41303785,-1,G,A,70280967,22117,70106476,70499692,174491
6,ENSG00000158373.7,26158122,chr6-26197818-T-A,rs4145878,1,T,A,26197818,39696,25961514,26354730,236304
6,ENSG00000122194.12,160702244,chr6-160741374-T-C,rs4252170,1,T,C,160741374,39130,160505636,160898852,235738
6,ENSG00000096433.5,33621322,chr6-33589448-A-G,rs430655,1,A,G,33589448,31874,33424714,33817930,164734
6,ENSG00000124491.9,6320662,chr6-6381296-C-T,rs4395776,-1,C,T,6381296,60634,6124054,6517270,257242
6,ENSG00000198478.6,79631329,chr6-79598469-C-A,rs4413576,1,C,A,79598469,32860,79434721,79827937,163748
6,ENSG00000135318.6,85450083,chr6-85448787-T-C,rs4458647,1,T,C,85448787,1296,85253475,85646691,195312
6,ENSG00000112308.7,24719154,chr6-24677760-C-T,rs4544900,-1,C,T,24677760,41394,24522546,24915762,155214
6,ENSG00000092820.13,158819368,chr6-158858262-T-C,rs4569991,-1,T,C,158858262,38894,158622760,159015976,235502
6,ENSG00000118432.11,88166347,chr6-88179497-C-G,rs4707437,-1,C,G,88179497,13150,87969739,88362955,209758
6,ENSG00000112039.3,35452338,chr6-35448262-C-A,rs4713864,1,C,A,35448262,4076,35255730,35648946,192532
6,ENSG00000124721.13,38715311,chr6-38755650-A-G,rs4714178,1,A,G,38755650,40339,38518703,38911919,236947
6,ENSG00000112576.8,41941808,chr6-42023323-A-G,rs4714552,-1,A,G,42023323,81515,41745200,42138416,278123
6,ENSG00000112640.9,42984570,chr6-43154631-G-C,rs4714669,1,G,C,43154631,170061,42787962,43181178,366669
6,ENSG00000170915.8,52362151,chr6-52348860-T-G,rs4715296,1,T,G,52348860,13291,52165543,52558759,183317
6,ENSG00000024862.11,138773769,chr6-138710785-G-C,rs4895537,1,G,C,138710785,62984,138577161,138970377,133624
6,ENSG00000146416.10,143060889,chr6-143062971-C-T,rs4896620,1,C,T,143062971,2082,142864281,143257497,198690
6,ENSG00000135604.9,144150517,chr6-144174296-T-G,rs4896702,1,T,G,144174296,23779,143953909,144347125,220387
6,ENSG00000085382.7,104859919,chr6-104904160-G-A,rs4945713,-1,G,A,104904160,44241,104663311,105056527,240849
6,ENSG00000180822.7,3258947,chr6-3251901-C-A,rs4959782,1,C,A,3251901,7046,3062339,3455555,189562
6,ENSG00000112685.8,693139,chr6-670871-C-T,rs4960175,-1,C,T,670871,22268,496531,889747,174340
6,ENSG00000170950.3,49787285,chr6-49798813-A-G,rs500032,-1,A,G,49798813,11528,49590677,49983893,208136
6,ENSG00000135297.10,73461737,chr6-73620580-G-A,rs506262,1,G,A,73620580,158843,73265129,73658345,355451
6,ENSG00000124657.1,27957241,chr6-27892756-C-T,rs58106751,1,C,T,27892756,64485,27760633,28153849,132123
6,ENSG00000164458.5,166167851,chr6-166287023-G-A,rs58377461,-1,G,A,166287023,119172,165971243,166364459,315780
6,ENSG00000145982.5,5261513,chr6-5386284-G-A,rs59355030,1,G,A,5386284,124771,5064905,5458121,321379
6,ENSG00000137269.9,53795005,chr6-53646426-T-C,rs60969333,1,T,C,53646426,148579,53598397,53991613,48029
6,ENSG00000176381.4,166308392,chr6-166287287-C-A,rs61137892,-1,C,A,166287287,21105,166111784,166505000,175503
6,ENSG00000204227.4,33208500,chr6-33194763-C-G,rs61669264,1,C,G,33194763,13737,33011892,33405108,182871
6,ENSG00000044090.4,43053851,chr6-43046284-G-A,rs61732148,-1,G,A,43046284,7567,42857243,43250459,189041
6,ENSG00000137204.10,43298260,chr6-43186049-G-A,rs61743561,1,G,A,43186049,112211,43101652,43494868,84397
6,ENSG00000137265.9,391752,chr6-421281-G-A,rs62389423,1,G,A,421281,29529,195144,588360,226137
6,ENSG00000111845.4,10694972,chr6-10661131-C-T,rs62397698,1,C,T,10661131,33841,10498364,10891580,162767
6,ENSG00000124733.3,43013946,chr6-43164190-C-A,rs62417512,-1,C,A,43164190,150244,42817338,43210554,346852
6,ENSG00000164440.10,139291998,chr6-139270754-T-C,rs62441202,-1,T,C,139270754,21244,139095390,139488606,175364
6,ENSG00000111846.11,10521351,chr6-10528201-A-G,rs631299,1,A,G,10528201,6850,10324743,10717959,203458
6,ENSG00000137203.6,10415074,chr6-10345338-G-A,rs6456402,-1,G,A,10345338,69736,10218466,10611682,126872
6,ENSG00000153162.7,7726099,chr6-7684391-T-C,rs6597279,1,T,C,7684391,41708,7529491,7922707,154900
6,ENSG00000137207.6,43516926,chr6-43483455-G-A,rs66726175,-1,G,A,43483455,33471,43320318,43713534,163137
6,ENSG00000137207.6,43516926,chr6-43483455-G-C,rs66726175,-1,G,C,43483455,33471,43320318,43713534,163137
6,ENSG00000155906.11,151452126,chr6-151433138-T-C,rs6904364,-1,T,C,151433138,18988,151255518,151648734,177620
6,ENSG00000080546.9,109094846,chr6-108990357-T-G,rs6904998,-1,T,G,108990357,104489,108898238,109291454,92119
6,ENSG00000112110.5,159790467,chr6-159796974-G-A,rs6908294,1,G,A,159796974,6507,159593859,159987075,203115
6,ENSG00000137251.9,54308441,chr6-54317505-T-C,rs6909083,1,T,C,54317505,9064,54111833,54505049,205672
6,ENSG00000153157.8,10887052,chr6-10902206-A-G,rs6910232,1,A,G,10902206,15154,10690444,11083660,211762
6,ENSG00000135334.7,87702233,chr6-87800691-C-T,rs6914106,-1,C,T,87800691,98458,87505625,87898841,295066
6,ENSG00000137198.5,16238587,chr6-16280956-C-T,rs6914805,1,C,T,16280956,42369,16041979,16435195,238977
6,ENSG00000112146.10,53065404,chr6-53206551-G-A,rs6917666,1,G,A,53206551,141147,52868796,53262012,337755
6,ENSG00000146411.5,134052624,chr6-133979503-C-T,rs6919121,-1,C,T,133979503,73121,133856016,134249232,123487
6,ENSG00000178199.9,149485014,chr6-149351239-C-G,rs6922130,-1,C,G,149351239,133775,149288406,149681622,62833
6,ENSG00000178199.9,149485014,chr6-149351239-C-A,rs6922130,-1,C,A,149351239,133775,149288406,149681622,62833
6,ENSG00000240065.2,32854192,chr6-32858673-T-C,rs6930981,1,T,C,32858673,4481,32657584,33050800,201089
6,ENSG00000137274.8,3118711,chr6-3143531-T-G,rs6933330,1,T,G,3143531,24820,2922103,3315319,221428
6,ENSG00000164627.12,39725408,chr6-39715158-T-C,rs6933563,-1,T,C,39715158,10250,39528800,39922016,186358
6,ENSG00000112139.9,37697883,chr6-37704146-T-G,rs6937280,-1,T,G,37704146,6263,37501275,37894491,202871
6,ENSG00000065029.9,35259735,chr6-35229693-G-A,rs6938138,1,G,A,35229693,30042,35063127,35456343,166566
6,ENSG00000007944.10,16129086,chr6-16037321-C-T,rs6941340,1,C,T,16037321,91765,15932478,16325694,104843
6,ENSG00000130347.8,106629498,chr6-106761984-A-G,rs71574210,-1,A,G,106761984,132486,106432890,106826106,329094
6,ENSG00000214338.6,127519191,chr6-127460675-T-C,rs723642,-1,T,C,127460675,58516,127322583,127715799,138092
6,ENSG00000145949.8,2750922,chr6-2937256-A-G,rs72838699,-1,A,G,2937256,186334,2554314,2947530,382942
6,ENSG00000021355.7,2841863,chr6-2937256-A-G,rs72838699,-1,A,G,2937256,95393,2645255,3038471,292001
6,ENSG00000124570.11,2971567,chr6-2937256-A-G,rs72838699,-1,A,G,2937256,34311,2774959,3168175,162297
6,ENSG00000124535.10,2765393,chr6-2937256-A-G,rs72838699,1,A,G,2937256,171863,2568785,2962001,368471
6,ENSG00000146192.9,37005655,chr6-37010687-A-G,rs72848057,1,A,G,37010687,5032,36809047,37202263,201640
6,ENSG00000118495.12,144008259,chr6-144090201-G-A,rs73008259,-1,G,A,144090201,81942,143811651,144204867,278550
6,ENSG00000137434.7,10694616,chr6-10694492-A-G,rs73439094,-1,A,G,10694492,124,10498008,10891224,196484
6,ENSG00000010810.11,111873452,chr6-111923127-G-A,rs73535644,-1,G,A,111923127,49675,111676844,112070060,246283
6,ENSG00000189134.3,28259297,chr6-28406826-G-C,rs73740607,1,G,C,28406826,147529,28062689,28455905,344137
6,ENSG00000112249.9,100881329,chr6-100999267-C-T,rs75039186,-1,C,T,100999267,117938,100684721,101077937,314546
6,ENSG00000112667.8,43229481,chr6-43220435-A-G,rs75187159,-1,A,G,43220435,9046,43032873,43426089,187562
6,ENSG00000112312.5,24774937,chr6-24916871-G-A,rs76656398,1,G,A,24916871,141934,24578329,24971545,338542
6,ENSG00000131018.16,152637362,chr6-152816167-C-A,rs76718311,-1,C,A,152816167,178805,152440754,152833970,375413
6,ENSG00000124795.10,18264530,chr6-18135289-T-C,rs77339739,-1,T,C,18135289,129241,18067922,18461138,67367
6,ENSG00000234127.3,30213406,chr6-30379488-G-A,rs7739438,-1,G,A,30379488,166082,30016798,30410014,362690
6,ENSG00000124608.4,44313347,chr6-44307060-T-C,rs7740535,-1,T,C,44307060,6287,44116739,44509955,190321
6,ENSG00000124608.4,44313347,chr6-44307060-T-A,rs7740535,-1,T,A,44307060,6287,44116739,44509955,190321
6,ENSG00000152818.12,144285335,chr6-144293730-T-C,rs7740792,1,T,C,144293730,8395,144088727,144481943,205003
6,ENSG00000112195.8,41201149,chr6-41284483-G-A,rs7742256,-1,G,A,41284483,83334,41004541,41397757,279942
6,ENSG00000001036.8,143511720,chr6-143513413-A-T,rs7743944,-1,A,T,143513413,1693,143315112,143708328,198301
6,ENSG00000189007.9,143450695,chr6-143442708-A-G,rs7744361,-1,A,G,143442708,7987,143254087,143647303,188621
6,ENSG00000189367.9,127459389,chr6-127519665-A-G,rs7749831,-1,A,G,127519665,60276,127262781,127655997,256884
6,ENSG00000146112.6,30686645,chr6-30499918-A-G,rs7754598,-1,A,G,30499918,186727,30490037,30883253,9881
6,ENSG00000065060.12,34792083,chr6-34754882-G-A,rs7756405,1,G,A,34754882,37201,34595475,34988691,159407
6,ENSG00000130024.10,169724500,chr6-169660291-G-A,rs7760433,-1,G,A,169660291,64209,169527892,169921108,132399
6,ENSG00000111886.8,89315299,chr6-89342885-G-A,rs7760851,-1,G,A,89342885,27586,89118691,89511907,224194
6,ENSG00000137225.8,44158820,chr6-44172132-C-T,rs7763358,1,C,T,44172132,13312,43962212,44355428,209920
6,ENSG00000146072.5,47309905,chr6-47414428-T-C,rs7763430,-1,T,C,47414428,104523,47113297,47506513,301131
6,ENSG00000005700.10,82247744,chr6-82259395-C-T,rs7763533,-1,C,T,82259395,11651,82051136,82444352,208259
6,ENSG00000111885.5,119349761,chr6-119357291-A-G,rs7765368,-1,A,G,119357291,7530,119153153,119546369,204138
6,ENSG00000051620.5,138404223,chr6-138389387-A-G,rs7765991,1,A,G,138389387,14836,138207615,138600831,181772
6,ENSG00000112759.11,44223595,chr6-44195793-A-G,rs7768389,1,A,G,44195793,27802,44026987,44420203,168806
6,ENSG00000146221.8,44297698,chr6-44333169-C-T,rs7769324,-1,C,T,44333169,35471,44101090,44494306,232079
6,ENSG00000118507.11,131135467,chr6-131112536-T-C,rs7769831,1,T,C,131112536,22931,130938859,131332075,173677
6,ENSG00000154548.8,89118071,chr6-89169449-A-C,rs7775554,-1,A,C,89169449,51378,88921463,89314679,247986
6,ENSG00000112096.11,159693241,chr6-159728147-T-C,rs78550031,-1,T,C,159728147,34906,159496633,159889849,231514
6,ENSG00000171467.10,43369647,chr6-43182821-C-T,rs78780266,-1,C,T,43182821,186826,43173039,43566255,9782
6,ENSG00000204428.7,31680377,chr6-31695180-C-T,rs805277,-1,C,T,31695180,14803,31483769,31876985,211411
6,ENSG00000197409.6,26197286,chr6-26141147-C-T,rs806970,-1,C,T,26141147,56139,26000678,26393894,140469
6,ENSG00000124784.4,7389808,chr6-7496877-A-G,rs823695,1,A,G,7496877,107069,7193200,7586416,303677
6,ENSG00000204252.7,33009591,chr6-33008982-G-T,rs86567,-1,G,T,33008982,609,32812983,33206199,195999
6,ENSG00000111816.5,116060891,chr6-116016340-G-A,rs868943,-1,G,A,116016340,44551,115864283,116257499,152057
6,ENSG00000204536.8,31157802,chr6-31178143-C-T,rs887464,-1,C,T,31178143,20341,30961194,31354410,216949
6,ENSG00000198502.5,32530287,chr6-32634619-C-T,rs9272226,-1,C,T,32634619,104332,32333679,32726895,300940
6,ENSG00000124523.9,13574601,chr6-13563825-C-G,rs9296714,1,C,G,13563825,10776,13377993,13771209,185832
6,ENSG00000111863.7,11778803,chr6-11734629-A-G,rs932345,-1,A,G,11734629,44174,11582195,11975411,152434
6,ENSG00000119900.6,71288811,chr6-71282113-T-G,rs9346455,1,T,G,71282113,6698,71092203,71485419,189910
6,ENSG00000213886.3,29559732,chr6-29488244-G-A,rs9348832,-1,G,A,29488244,71488,29363124,29756340,125120
6,ENSG00000111850.5,87322588,chr6-87264649-G-A,rs9353470,1,G,A,87264649,57939,87125980,87519196,138669
6,ENSG00000198818.5,166342545,chr6-166337928-C-T,rs9356478,-1,C,T,166337928,4617,166145937,166539153,191991
6,ENSG00000026297.10,166956550,chr6-166960220-C-T,rs9366076,-1,C,T,166960220,3670,166759942,167153158,200278
6,ENSG00000172594.8,122789258,chr6-122765043-G-A,rs9372715,1,G,A,122765043,24215,122592650,122985866,172393
6,ENSG00000009844.9,142147263,chr6-142305562-T-C,rs9376683,1,T,C,142305562,158299,141950655,142343871,354907
6,ENSG00000188428.12,8064389,chr6-8258002-G-C,rs9379178,-1,G,C,8258002,193613,7867781,8260997,390221
6,ENSG00000198315.5,28141883,chr6-28008422-G-C,rs9380032,1,G,C,28008422,133461,27945275,28338491,63147
6,ENSG00000198315.5,28141883,chr6-28008422-G-T,rs9380032,1,G,T,28008422,133461,27945275,28338491,63147
6,ENSG00000198315.5,28141883,chr6-28008422-G-A,rs9380032,1,G,A,28008422,133461,27945275,28338491,63147
6,ENSG00000137288.4,33711700,chr6-33709779-C-A,rs9380374,-1,C,A,33709779,1921,33515092,33908308,194687
6,ENSG00000137168.7,36874803,chr6-36885767-A-G,rs9380618,-1,A,G,36885767,10964,36678195,37071411,207572
6,ENSG00000112218.5,96837477,chr6-96795719-C-T,rs9386830,-1,C,T,96795719,41758,96640869,97034085,154850
6,ENSG00000151914.12,56954830,chr6-56981317-C-T,rs9396246,-1,C,T,56981317,26487,56758222,57151438,223095
6,ENSG00000091844.2,153131282,chr6-153095777-G-A,rs9397587,-1,G,A,153095777,35505,152934674,153327890,161103
6,ENSG00000203797.4,110415575,chr6-110421991-T-C,rs9398236,-1,T,C,110421991,6416,110218967,110612183,203024
6,ENSG00000079819.10,131063245,chr6-131057787-C-G,rs9398971,-1,C,G,131057787,5458,130866637,131259853,191150
6,ENSG00000135596.12,109455772,chr6-109526789-G-A,rs9400289,-1,G,A,109526789,71017,109259164,109652380,267625
6,ENSG00000093144.13,127343609,chr6-127397917-T-C,rs9401955,-1,T,C,127397917,54308,127147001,127540217,250916
6,ENSG00000079950.8,132513116,chr6-132340514-A-G,rs9402397,-1,A,G,132340514,172602,132316508,132709724,24006
6,ENSG00000132423.6,99394195,chr6-99379438-T-C,rs9402716,-1,T,C,99379438,14757,99197587,99590803,181851
6,ENSG00000065308.4,52577060,chr6-52524077-G-A,rs941969,-1,G,A,52524077,52983,52380452,52773668,143625
6,ENSG00000112406.4,139135080,chr6-139257872-G-T,rs943651,1,G,T,139257872,122792,138938472,139331688,319400
6,ENSG00000156535.8,73696203,chr6-73722913-C-T,rs9442951,1,C,T,73722913,26710,73499595,73892811,223318
6,ENSG00000164691.11,159044991,chr6-159127244-T-C,rs9457558,-1,T,C,159127244,82253,158848383,159241599,278861
6,ENSG00000079691.13,25279374,chr6-25400095-G-A,rs9461157,1,G,A,25400095,120721,25082766,25475982,317329
6,ENSG00000224389.3,32014795,chr6-31863944-G-T,rs9461727,1,G,T,31863944,150851,31818187,32211403,45757
6,ENSG00000244731.3,31982057,chr6-31863944-G-T,rs9461727,1,G,T,31863944,118113,31785449,32178665,78495
6,ENSG00000124587.9,42979181,chr6-42979205-G-A,rs9462859,-1,G,A,42979205,24,42782573,43175789,196632
6,ENSG00000096654.10,27473105,chr6-27324563-T-C,rs9468060,-1,T,C,27324563,148542,27276497,27669713,48066
6,ENSG00000197977.3,11044305,chr6-11083743-C-T,rs9468395,-1,C,T,11083743,39438,10847697,11240913,236046
6,ENSG00000112208.8,57172326,chr6-57225144-A-G,rs9475792,1,A,G,57225144,52818,56975718,57368934,249426
6,ENSG00000111834.7,116616479,chr6-116482833-A-G,rs9481643,1,A,G,116482833,133646,116419871,116813087,62962
6,ENSG00000112335.10,108261040,chr6-108264117-G-A,rs9486841,-1,G,A,108264117,3077,108064432,108457648,199685
6,ENSG00000135587.4,109440724,chr6-109429207-C-T,rs9487100,1,C,T,109429207,11517,109244116,109637332,185091
6,ENSG00000112290.8,110179670,chr6-110227037-C-T,rs9487318,-1,C,T,110227037,47367,109983062,110376278,243975
6,ENSG00000111875.6,118894152,chr6-118759216-G-A,rs9489520,1,G,A,118759216,134936,118697544,119090760,61672
6,ENSG00000111906.12,125301967,chr6-125310413-T-C,rs9491384,-1,T,C,125310413,8446,125105359,125498575,205054
6,ENSG00000112303.9,132757904,chr6-132752994-G-A,rs9493423,-1,G,A,132752994,4910,132561296,132954512,191698
6,ENSG00000093134.8,132734765,chr6-132752994-G-A,rs9493423,-1,G,A,132752994,18229,132538157,132931373,214837
6,ENSG00000112306.7,132814569,chr6-132814668-C-T,rs9493450,1,C,T,132814668,99,132617961,133011177,196707
6,ENSG00000124782.14,7107961,chr6-7251630-C-T,rs9502567,1,C,T,7251630,143669,6911353,7304569,340277
6,ENSG00000197062.6,28267143,chr6-28242910-C-T,rs967005,1,C,T,28242910,24233,28070535,28463751,172375
6,ENSG00000118420.12,83065841,chr6-82872539-T-C,rs9688767,-1,T,C,82872539,193302,82869233,83262449,3306
6,ENSG00000055211.7,149566375,chr6-149588241-T-G,rs9767713,1,T,G,149588241,21866,149369767,149762983,218474
6,ENSG00000112799.3,6588720,chr6-6588648-A-C,rs977785,1,A,C,6588648,72,6392112,6785328,196536
6,ENSG00000027697.7,137219385,chr6-137410807-A-G,rs10484596,-1,A,G,137410807,191422,137022777,137415993,388030
6,ENSG00000189007.9,143450695,chr6-143432408-G-A,rs10484800,-1,G,A,143432408,18287,143254087,143647303,178321
6,ENSG00000112699.6,2245605,chr6-2436259-C-T,rs10900924,-1,C,T,2436259,190654,2048997,2442213,387262
6,ENSG00000112357.7,136822592,chr6-136856465-A-G,rs114561955,1,A,G,136856465,33873,136625984,137019200,230481
6,ENSG00000213760.5,31546608,chr6-31350916-G-A,rs115164306,-1,G,A,31350916,195692,31350000,31743216,916
6,ENSG00000204475.4,31593006,chr6-31592893-C-T,rs11575837,-1,C,T,31592893,113,31396398,31789614,196495
6,ENSG00000118518.10,127266864,chr6-127070521-G-C,rs117010590,1,G,C,127070521,196343,127070256,127463472,265
6,ENSG00000118491.7,143864474,chr6-144055015-C-G,rs117059750,1,C,G,144055015,190541,143667866,144061082,387149
6,ENSG00000155085.9,109691202,chr6-109762875-C-T,rs11751112,-1,C,T,109762875,71673,109494594,109887810,268281
6,ENSG00000085377.8,105403082,chr6-105359946-A-G,rs11752450,-1,A,G,105359946,43136,105206474,105599690,153472
6,ENSG00000111845.4,10694972,chr6-10861318-G-A,rs11754011,1,G,A,10861318,166346,10498364,10891580,362954
6,ENSG00000146281.5,89146055,chr6-89201968-G-A,rs11754862,1,G,A,89201968,55913,88949447,89342663,252521
6,ENSG00000231852.2,32038415,chr6-31876918-G-A,rs118007953,1,G,A,31876918,161497,31841807,32235023,35111
6,ENSG00000203734.6,138796087,chr6-138900713-G-T,rs1188873,1,G,T,138900713,104626,138599479,138992695,301234
6,ENSG00000164414.11,87472974,chr6-87408443-C-T,rs11964237,1,C,T,87408443,64531,87276366,87669582,132077
6,ENSG00000112367.6,109691296,chr6-109737797-G-A,rs11964533,1,G,A,109737797,46501,109494688,109887904,243109
6,ENSG00000051620.5,138404223,chr6-138341259-G-A,rs11964805,1,G,A,138341259,62964,138207615,138600831,133644
6,ENSG00000137413.11,42050524,chr6-42051145-G-T,rs11967378,1,G,T,42051145,621,41853916,42247132,197229
6,ENSG00000112218.5,96837477,chr6-96814478-G-A,rs11967774,-1,G,A,96814478,22999,96640869,97034085,173609
6,ENSG00000007866.13,35497064,chr6-35567893-C-T,rs11967862,-1,C,T,35567893,70829,35300456,35693672,267437
6,ENSG00000050393.6,13814557,chr6-13833981-G-A,rs1204161,-1,G,A,13833981,19424,13617949,14011165,216032
6,ENSG00000013392.5,83193357,chr6-83198513-C-T,rs12190337,1,C,T,83198513,5156,82996749,83389965,201764
6,ENSG00000186340.9,169253846,chr6-169280647-G-A,rs12196140,-1,G,A,169280647,26801,169057238,169450454,223409
6,ENSG00000178425.7,116100853,chr6-116168387-A-G,rs12196141,1,A,G,116168387,67534,115904245,116297461,264142
6,ENSG00000196569.6,128883138,chr6-128804740-G-T,rs12212552,1,G,T,128804740,78398,128686530,129079746,118210
6,ENSG00000137185.7,28225275,chr6-28205441-G-A,rs1233708,1,G,A,28205441,19834,28028667,28421883,176774
6,ENSG00000171611.4,42916053,chr6-42868845-G-A,rs12526596,1,G,A,42868845,47208,42719445,43112661,149400
6,ENSG00000146457.10,159727506,chr6-159665056-G-A,rs12529327,1,G,A,159665056,62450,159530898,159924114,134158
6,ENSG00000137310.7,31158589,chr6-31144298-G-A,rs1265080,1,G,A,31144298,14291,30961981,31355197,182317
6,ENSG00000204531.9,31170682,chr6-31144298-G-A,rs1265080,-1,G,A,31144298,26384,30974074,31367290,170224
6,ENSG00000026950.12,26402275,chr6-26462128-C-T,rs12660069,1,C,T,26462128,59853,26205667,26598883,256461
6,ENSG00000137251.9,54308441,chr6-54300502-T-C,rs1316575,1,T,C,54300502,7939,54111833,54505049,188669
6,ENSG00000026652.9,161274061,chr6-161231671-T-G,rs13194692,-1,T,G,161231671,42390,161077453,161470669,154218
6,ENSG00000154079.5,70566930,chr6-70586074-G-A,rs13197182,1,G,A,70586074,19144,70370322,70763538,215752
6,ENSG00000112685.8,693139,chr6-693473-C-G,rs13205146,-1,C,G,693473,334,496531,889747,196942
6,ENSG00000182952.3,26538366,chr6-26376604-T-C,rs13218591,1,T,C,26376604,161762,26341758,26734974,34846
6,ENSG00000010810.11,111873452,chr6-111874408-T-C,rs1409837,-1,T,C,111874408,956,111676844,112070060,197564
6,ENSG00000112297.9,106360717,chr6-106534613-T-C,rs1462147,1,T,C,106534613,173896,106164109,106557325,370504
6,ENSG00000146410.7,136250311,chr6-136150662-T-C,rs1471546,-1,T,C,136150662,99649,136053703,136446919,96959
6,ENSG00000026297.10,166956550,chr6-167039757-T-C,rs151604,-1,T,C,167039757,83207,166759942,167153158,279815
6,ENSG00000168116.9,57046693,chr6-56992867-A-C,rs1562908,1,A,C,56992867,53826,56850085,57243301,142782
6,ENSG00000198833.5,89352722,chr6-89299480-A-T,rs1570931,-1,A,T,89299480,53242,89156114,89549330,143366
6,ENSG00000112761.12,112054104,chr6-112076242-C-T,rs1624814,1,C,T,112076242,22138,111857496,112250712,218746
6,ENSG00000225921.2,13615335,chr6-13787608-G-C,rs16874329,1,G,C,13787608,172273,13418727,13811943,368881
6,ENSG00000135299.11,89433152,chr6-89555946-G-C,rs16881936,1,G,C,89555946,122794,89236544,89629760,319402
6,ENSG00000135299.11,89433152,chr6-89555946-G-A,rs16881936,1,G,A,89555946,122794,89236544,89629760,319402
6,ENSG00000185760.10,72622064,chr6-72712644-G-A,rs16882726,1,G,A,72712644,90580,72425456,72818672,287188
6,ENSG00000111802.8,24666899,chr6-24595625-T-C,rs16889506,-1,T,C,24595625,71274,24470291,24863507,125334
6,ENSG00000180596.6,26123926,chr6-26311013-C-G,rs16891523,-1,C,G,26311013,187087,25927318,26320534,383695
6,ENSG00000197903.6,27146855,chr6-27203626-T-A,rs16894783,-1,T,A,27203626,56771,26950247,27343463,253379
6,ENSG00000048544.5,42217861,chr6-42196532-T-C,rs16895284,-1,T,C,42196532,21329,42021253,42414469,175279
6,ENSG00000071242.7,166627251,chr6-166634458-T-C,rs16899273,-1,T,C,166634458,7207,166430643,166823859,203815
6,ENSG00000008018.7,170553307,chr6-170565671-A-G,rs16901474,-1,A,G,170565671,12364,170356699,170749915,208972
6,ENSG00000111897.5,122471807,chr6-122659414-C-T,rs17052989,-1,C,T,122659414,187607,122275199,122668415,384215
6,ENSG00000029363.11,136289846,chr6-136384115-G-A,rs17065472,-1,G,A,136384115,94269,136093238,136486454,290877
6,ENSG00000112276.9,105137157,chr6-105276766-T-G,rs17065726,-1,T,G,105276766,139609,104940549,105333765,336217
6,ENSG00000132429.5,105180014,chr6-105276766-T-G,rs17065726,-1,T,G,105276766,96752,104983406,105376622,293360
6,ENSG00000130347.8,106629498,chr6-106610621-G-A,rs17067435,-1,G,A,106610621,18877,106432890,106826106,177731
6,ENSG00000239264.2,7910788,chr6-7936208-G-A,rs17339636,-1,G,A,7936208,25420,7714180,8107396,222028
6,ENSG00000056972.13,111605878,chr6-111593045-T-C,rs174382,-1,T,C,111593045,12833,111409270,111802486,183775
6,ENSG00000096654.10,27473105,chr6-27382602-A-T,rs1883404,-1,A,T,27382602,90503,27276497,27669713,106105
6,ENSG00000137269.9,53795005,chr6-53618857-T-G,rs188664917,1,T,G,53618857,176148,53598397,53991613,20460
6,ENSG00000112343.7,25962802,chr6-25944983-A-G,rs2051541,1,A,G,25944983,17819,25766194,26159410,178789
6,ENSG00000146376.5,129710177,chr6-129708694-G-A,rs2068685,-1,G,A,129708694,1483,129513569,129906785,195125
6,ENSG00000203797.4,110415575,chr6-110408770-G-T,rs2073210,-1,G,T,110408770,6805,110218967,110612183,189803
6,ENSG00000198818.5,166342545,chr6-166339882-C-T,rs2103565,-1,C,T,166339882,2663,166145937,166539153,193945
6,ENSG00000112335.10,108261040,chr6-108350760-T-C,rs2152582,-1,T,C,108350760,89720,108064432,108457648,286328
6,ENSG00000112200.11,57090188,chr6-57228858-C-T,rs223296,1,C,T,57228858,138670,56893580,57286796,335278
6,ENSG00000111886.8,89315299,chr6-89315393-G-T,rs2236204,-1,G,T,89315393,94,89118691,89511907,196702
6,ENSG00000118418.10,79234689,chr6-79202472-A-G,rs2236543,-1,A,G,79202472,32217,79038081,79431297,164391
6,ENSG00000204209.6,33322959,chr6-33131211-C-G,rs2294477,-1,C,G,33131211,191748,33126351,33519567,4860
6,ENSG00000124641.10,41921139,chr6-41927412-G-A,rs2296916,-1,G,A,41927412,6273,41724531,42117747,202881
6,ENSG00000118508.4,146543833,chr6-146364188-T-C,rs2300619,1,T,C,146364188,179645,146347225,146740441,16963
6,ENSG00000172197.9,20212469,chr6-20186529-C-A,rs2328395,-1,C,A,20186529,25940,20015861,20409077,170668
6,ENSG00000137168.7,36874803,chr6-36824059-T-C,rs236375,-1,T,C,36824059,50744,36678195,37071411,145864
6,ENSG00000146112.6,30686645,chr6-30682541-T-G,rs2394392,-1,T,G,30682541,4104,30490037,30883253,192504
6,ENSG00000226979.3,31572289,chr6-31464097-G-T,rs2395030,1,G,T,31464097,108192,31375681,31768897,88416
6,ENSG00000173214.5,111259339,chr6-111352511-T-C,rs240993,1,T,C,111352511,93172,111062731,111455947,289780
6,ENSG00000164627.12,39725408,chr6-39620342-A-G,rs2446649,-1,A,G,39620342,105066,39528800,39922016,91542
6,ENSG00000146109.3,26596953,chr6-26614723-G-A,rs2494691,1,G,A,26614723,17770,26400345,26793561,214378
6,ENSG00000232040.2,28587298,chr6-28468283-C-T,rs2531815,-1,C,T,28468283,119015,28390690,28783906,77593
6,ENSG00000188820.8,116461375,chr6-116466215-T-C,rs2637678,1,T,C,116466215,4840,116264767,116657983,201448
6,ENSG00000204632.7,29827825,chr6-29947524-C-A,rs2735097,1,C,A,29947524,119699,29631217,30024433,316307
6,ENSG00000204386.5,31862821,chr6-31777507-C-T,rs2736426,-1,C,T,31777507,85314,31666213,32059429,111294
6,ENSG00000215712.4,157323519,chr6-157388857-T-C,rs2749668,-1,T,C,157388857,65338,157126911,157520127,261946
6,ENSG00000135334.7,87702233,chr6-87793591-G-T,rs2787885,-1,G,T,87793591,91358,87505625,87898841,287966
6,ENSG00000196376.6,117907264,chr6-117907364-A-C,rs2788996,1,A,C,117907364,100,117710656,118103872,196708
6,ENSG00000001561.5,46129989,chr6-46222640-A-C,rs2799354,1,A,C,46222640,92651,45933381,46326597,289259
6,ENSG00000112796.4,46170980,chr6-46222640-A-C,rs2799354,-1,A,C,46222640,51660,45974372,46367588,248268
6,ENSG00000204536.8,31157802,chr6-31229630-C-T,rs28397289,-1,C,T,31229630,71828,30961194,31354410,268436
6,ENSG00000135297.10,73461737,chr6-73445392-C-T,rs3013726,1,C,T,73445392,16345,73265129,73658345,180263
6,ENSG00000175003.8,160121815,chr6-160163821-C-T,rs3101826,1,C,T,160163821,42006,159925207,160318423,238614
6,ENSG00000204252.7,33009591,chr6-33052196-A-T,rs3128952,-1,A,T,33052196,42605,32812983,33206199,239213
6,ENSG00000231389.2,33080710,chr6-33157685-C-T,rs3129206,-1,C,T,33157685,76975,32884102,33277318,273583
6,ENSG00000232629.4,32763532,chr6-32680942-G-A,rs3129782,-1,G,A,32680942,82590,32566924,32960140,114018
6,ENSG00000235863.1,33277123,chr6-33346316-T-C,rs3130104,1,T,C,33346316,69193,33080515,33473731,265801
6,ENSG00000204228.3,33204655,chr6-33151135-A-G,rs3130157,1,A,G,33151135,53520,33008047,33401263,143088
6,ENSG00000137343.12,30626874,chr6-30772383-G-A,rs3130666,1,G,A,30772383,145509,30430266,30823482,342117
6,ENSG00000021355.7,2841863,chr6-2892774-A-G,rs318489,-1,A,G,2892774,50911,2645255,3038471,247519
6,ENSG00000124535.10,2765393,chr6-2892774-A-G,rs318489,1,A,G,2892774,127381,2568785,2962001,323989
6,ENSG00000145949.8,2750922,chr6-2898362-A-G,rs318491,-1,A,G,2898362,147440,2554314,2947530,344048
6,ENSG00000137218.6,41779900,chr6-41942598-T-C,rs3218084,-1,T,C,41942598,162698,41583292,41976508,359306
6,ENSG00000204248.5,33192467,chr6-33033994-T-C,rs34493748,-1,T,C,33033994,158473,32995859,33389075,38135
6,ENSG00000204390.7,31815283,chr6-31809864-C-T,rs34814308,-1,C,T,31809864,5419,31618675,32011891,191189
6,ENSG00000204616.4,30113090,chr6-30168525-C-G,rs34823152,-1,C,G,30168525,55435,29916482,30309698,252043
6,ENSG00000057663.8,106325760,chr6-106165888-G-C,rs35342892,-1,G,C,106165888,159872,106129152,106522368,36736
6,ENSG00000204525.8,31272092,chr6-31306672-C-A,rs35647108,-1,C,A,31306672,34580,31075484,31468700,231188
6,ENSG00000204525.8,31272092,chr6-31306672-C-T,rs35647108,-1,C,T,31306672,34580,31075484,31468700,231188
6,ENSG00000172738.7,37258122,chr6-37218737-A-G,rs35867476,-1,A,G,37218737,39385,37061514,37454730,157223
6,ENSG00000112599.7,42194956,chr6-42239135-C-T,rs35884864,-1,C,T,42239135,44179,41998348,42391564,240787
6,ENSG00000198502.5,32530287,chr6-32408694-A-C,rs3763313,-1,A,C,32408694,121593,32333679,32726895,75015
6,ENSG00000124562.5,34757505,chr6-34855097-T-C,rs3777750,1,T,C,34855097,97592,34560897,34954113,294200
6,ENSG00000188112.4,42142620,chr6-42174319-T-C,rs3793083,-1,T,C,42174319,31699,41946012,42339228,228307
6,ENSG00000111850.5,87322588,chr6-87333842-T-C,rs379455,1,T,C,87333842,11254,87125980,87519196,207862
6,ENSG00000198755.6,35468401,chr6-35594863-A-G,rs3798346,1,A,G,35594863,126462,35271793,35665009,323070
6,ENSG00000137285.8,3227653,chr6-3150281-C-T,rs3799216,-1,C,T,3150281,77372,3031045,3424261,119236
6,ENSG00000137267.4,3157544,chr6-3150281-C-T,rs3799216,-1,C,T,3150281,7263,2960936,3354152,189345
6,ENSG00000137203.6,10415074,chr6-10388420-T-G,rs3818408,-1,T,G,10388420,26654,10218466,10611682,169954
6,ENSG00000153989.7,117675469,chr6-117546888-T-C,rs389663,1,T,C,117546888,128581,117478861,117872077,68027
6,ENSG00000112290.8,110179670,chr6-110078860-T-C,rs41381746,-1,T,C,110078860,100810,109983062,110376278,95798
6,ENSG00000168394.9,32853704,chr6-32849181-G-A,rs4148882,-1,G,A,32849181,4523,32657096,33050312,192085
6,ENSG00000175048.11,157381190,chr6-157435296-G-A,rs41505947,1,G,A,157435296,54106,157184582,157577798,250714
6,ENSG00000079691.13,25279374,chr6-25409618-C-T,rs4440453,1,C,T,25409618,130244,25082766,25475982,326852
6,ENSG00000124721.13,38715311,chr6-38907976-A-G,rs4452640,1,A,G,38907976,192665,38518703,38911919,389273
6,ENSG00000083123.8,80106671,chr6-79971524-G-T,rs4541708,1,G,T,79971524,135147,79910063,80303279,61461
6,ENSG00000145979.11,13328537,chr6-13295304-C-T,rs454563,-1,C,T,13295304,33233,13131929,13525145,163375
6,ENSG00000156535.8,73696203,chr6-73723489-T-G,rs4706552,1,T,G,73723489,27286,73499595,73892811,223894
6,ENSG00000137404.10,30690984,chr6-30663286-G-A,rs4713346,-1,G,A,30663286,27698,30494376,30887592,168910
6,ENSG00000137225.8,44158820,chr6-44173995-G-C,rs4714764,1,G,C,44173995,15175,43962212,44355428,211783
6,ENSG00000112149.5,14117772,chr6-13958423-G-A,rs4715723,1,G,A,13958423,159349,13921164,14314380,37259
6,ENSG00000118515.7,134318112,chr6-134288153-A-C,rs4896038,-1,A,C,134288153,29959,134121504,134514720,166649
6,ENSG00000057657.9,106086336,chr6-105926140-C-A,rs4946713,1,C,A,105926140,160196,105889728,106282944,36412
6,ENSG00000214113.5,5260950,chr6-5156067-T-C,rs4960070,-1,T,C,5156067,104883,5064342,5457558,91725
6,ENSG00000124508.12,26383108,chr6-26405588-T-C,rs55676749,1,T,C,26405588,22480,26186500,26579716,219088
6,ENSG00000030110.7,33580276,chr6-33578721-C-T,rs5745582,-1,C,T,33578721,1555,33383668,33776884,195053
6,ENSG00000204438.5,31664997,chr6-31851599-G-A,rs574914,-1,G,A,31851599,186602,31468389,31861605,383210
6,ENSG00000135549.8,122610405,chr6-122735415-T-C,rs58551574,1,T,C,122735415,125010,122413797,122807013,321618
6,ENSG00000112667.8,43229481,chr6-43046284-G-A,rs61732148,-1,G,A,43046284,183197,43032873,43426089,13411
6,ENSG00000146122.12,39792376,chr6-39932764-A-G,rs62403569,1,A,G,39932764,140388,39595768,39988984,336996
6,ENSG00000065308.4,52577060,chr6-52561961-G-A,rs62405876,-1,G,A,52561961,15099,52380452,52773668,181509
6,ENSG00000112280.11,70303084,chr6-70387472-C-A,rs62420316,-1,C,A,70387472,84388,70106476,70499692,280996
6,ENSG00000122335.8,158168262,chr6-158168623-C-G,rs62437115,-1,C,G,158168623,361,157971654,158364870,196969
6,ENSG00000184465.11,169702029,chr6-169660073-T-C,rs6459651,-1,T,C,169660073,41956,169505421,169898637,154652
6,ENSG00000093134.8,132734765,chr6-132716722-G-T,rs6569827,-1,G,T,132716722,18043,132538157,132931373,178565
6,ENSG00000118514.9,134950101,chr6-134903615-C-A,rs6569976,-1,C,A,134903615,46486,134753493,135146709,150122
6,ENSG00000112419.9,143677965,chr6-143618411-T-C,rs6570568,1,T,C,143618411,59554,143481357,143874573,137054
6,ENSG00000198721.8,4135575,chr6-4118817-C-T,rs659025,-1,C,T,4118817,16758,3938967,4332183,179850
6,ENSG00000112739.11,4021300,chr6-3996744-G-T,rs6597023,1,G,T,3996744,24556,3824692,4217908,172052
6,ENSG00000112312.5,24774937,chr6-24950601-A-G,rs680009,1,A,G,24950601,175664,24578329,24971545,372272
6,ENSG00000112659.8,43182196,chr6-43292922-T-C,rs6901866,1,T,C,43292922,110726,42985588,43378804,307334
6,ENSG00000120438.7,159789602,chr6-159826217-G-T,rs6902339,-1,G,T,159826217,36615,159592994,159986210,233223
6,ENSG00000152818.12,144285335,chr6-144364595-T-C,rs6904291,1,T,C,144364595,79260,144088727,144481943,275868
6,ENSG00000078269.9,157981863,chr6-158000242-T-C,rs6904665,1,T,C,158000242,18379,157785255,158178471,214987
6,ENSG00000111843.8,10723070,chr6-10808390-A-T,rs6906052,1,A,T,10808390,85320,10526462,10919678,281928
6,ENSG00000197409.6,26197286,chr6-26186897-C-T,rs6906367,-1,C,T,26186897,10389,26000678,26393894,186219
6,ENSG00000079819.10,131063245,chr6-131023993-A-G,rs6906478,-1,A,G,131023993,39252,130866637,131259853,157356
6,ENSG00000204052.3,43510686,chr6-43691888-C-T,rs6908311,-1,C,T,43691888,181202,43314078,43707294,377810
6,ENSG00000112763.10,26457955,chr6-26464414-A-G,rs6911765,1,A,G,26464414,6459,26261347,26654563,203067
6,ENSG00000112139.9,37697883,chr6-37692341-A-G,rs6916856,-1,A,G,37692341,5542,37501275,37894491,191066
6,ENSG00000132424.10,99425308,chr6-99345399-T-C,rs6917584,-1,T,C,99345399,79909,99228700,99621916,116699
6,ENSG00000146232.9,44265551,chr6-44374243-T-C,rs6918742,-1,T,C,44374243,108692,44068943,44462159,305300
6,ENSG00000074935.7,112087482,chr6-112162713-G-A,rs6919131,-1,G,A,112162713,75231,111890874,112284090,271839
6,ENSG00000112799.3,6588720,chr6-6626030-G-A,rs6922002,1,G,A,6626030,37310,6392112,6785328,233918
6,ENSG00000151917.11,56955107,chr6-57039819-G-T,rs6923296,1,G,T,57039819,84712,56758499,57151715,281320
6,ENSG00000112658.6,43171269,chr6-43222184-C-T,rs6923954,1,C,T,43222184,50915,42974661,43367877,247523
6,ENSG00000124614.9,34426069,chr6-34414160-A-G,rs6925243,-1,A,G,34414160,11909,34229461,34622677,184699
6,ENSG00000146243.8,78867551,chr6-78793454-A-G,rs6926463,1,A,G,78793454,74097,78670943,79064159,122511
6,ENSG00000130338.8,158312465,chr6-158340692-A-G,rs6928292,1,A,G,158340692,28227,158115857,158509073,224835
6,ENSG00000111877.12,118935159,chr6-119025747-G-A,rs6929403,-1,G,A,119025747,90588,118738551,119131767,287196
6,ENSG00000137204.10,43298260,chr6-43281673-C-T,rs6929983,1,C,T,43281673,16587,43101652,43494868,180021
6,ENSG00000204227.4,33208500,chr6-33028086-C-G,rs6933319,1,C,G,33028086,180414,33011892,33405108,16194
6,ENSG00000204227.4,33208500,chr6-33028086-C-T,rs6933319,1,C,T,33028086,180414,33011892,33405108,16194
6,ENSG00000112624.6,42782052,chr6-42785747-C-T,rs6933426,1,C,T,42785747,3695,42585444,42978660,200303
6,ENSG00000146409.5,132798637,chr6-132802938-A-G,rs6934161,-1,A,G,132802938,4301,132602029,132995245,200909
6,ENSG00000131016.12,151239967,chr6-151247807-T-C,rs6934340,1,T,C,151247807,7840,151043359,151436575,204448
6,ENSG00000124615.12,39934462,chr6-40129274-T-C,rs6936016,-1,T,C,40129274,194812,39737854,40131070,391420
6,ENSG00000124588.13,2999894,chr6-2963672-C-T,rs6939693,1,C,T,2963672,36222,2803286,3196502,160386
6,ENSG00000112033.9,35342558,chr6-35534706-T-G,rs6940863,1,T,G,35534706,192148,35145950,35539166,388756
6,ENSG00000137193.8,37170152,chr6-36995364-G-A,rs708008,1,G,A,36995364,174788,36973544,37366760,21820
6,ENSG00000156508.12,73521032,chr6-73705309-C-T,rs72953378,-1,C,T,73705309,184277,73324424,73717640,380885
6,ENSG00000176381.4,166308392,chr6-166281220-T-C,rs729887,-1,T,C,166281220,27172,166111784,166505000,169436
6,ENSG00000153162.7,7726099,chr6-7897914-A-G,rs73719371,1,A,G,7897914,171815,7529491,7922707,368423
6,ENSG00000112576.8,41941808,chr6-42077626-G-A,rs73735020,-1,G,A,42077626,135818,41745200,42138416,332426
6,ENSG00000118495.12,144008259,chr6-143922148-G-A,rs74353552,-1,G,A,143922148,86111,143811651,144204867,110497
6,ENSG00000010030.9,36387669,chr6-36368310-A-G,rs744848,-1,A,G,36368310,19359,36191061,36584277,177249
6,ENSG00000096063.10,35921098,chr6-35766829-A-G,rs74827100,-1,A,G,35766829,154269,35724490,36117706,42339
6,ENSG00000124784.4,7389808,chr6-7442624-C-T,rs76117671,1,C,T,7442624,52816,7193200,7586416,249424
6,ENSG00000185127.5,169702190,chr6-169811787-T-C,rs761443,1,T,C,169811787,109597,169505582,169898798,306205
6,ENSG00000180822.7,3258947,chr6-3219387-C-A,rs76320308,1,C,A,3219387,39560,3062339,3455555,157048
6,ENSG00000124786.8,8435545,chr6-8262962-C-T,rs76333269,-1,C,T,8262962,172583,8238937,8632153,24025
6,ENSG00000124787.9,5004037,chr6-4931884-T-C,rs77281944,-1,T,C,4931884,72153,4807429,5200645,124455
6,ENSG00000055211.7,149566375,chr6-149474206-C-T,rs7747354,1,C,T,149474206,92169,149369767,149762983,104439
6,ENSG00000096060.8,35688915,chr6-35727497-G-A,rs7751693,-1,G,A,35727497,38582,35492307,35885523,235190
6,ENSG00000060762.13,166382940,chr6-166407411-G-A,rs7753745,-1,G,A,166407411,24471,166186332,166579548,221079
6,ENSG00000170915.8,52362151,chr6-52352577-T-C,rs7754194,1,T,C,52352577,9574,52165543,52558759,187034
6,ENSG00000203872.5,87344813,chr6-87350973-T-C,rs7756440,1,T,C,87350973,6160,87148205,87541421,202768
6,ENSG00000074706.9,154356803,chr6-154521195-A-T,rs7759594,-1,A,T,154521195,164392,154160195,154553411,361000
6,ENSG00000085382.7,104859919,chr6-104896961-T-G,rs7762076,-1,T,G,104896961,37042,104663311,105056527,233650
6,ENSG00000112679.9,292487,chr6-348195-G-A,rs7768224,1,G,A,348195,55708,95879,489095,252316
6,ENSG00000135541.15,135497740,chr6-135605412-C-T,rs7769840,-1,C,T,135605412,107672,135301132,135694348,304280
6,ENSG00000186577.7,34249006,chr6-34278937-C-A,rs7770443,-1,C,A,34278937,29931,34052398,34445614,226539
6,ENSG00000023892.8,35297818,chr6-35382265-C-T,rs7770619,1,C,T,35382265,84447,35101210,35494426,281055
6,ENSG00000091844.2,153131282,chr6-153200070-C-T,rs7772159,-1,C,T,153200070,68788,152934674,153327890,265396
6,ENSG00000096696.8,7541671,chr6-7555016-G-C,rs7774328,1,G,C,7555016,13345,7345063,7738279,209953
6,ENSG00000029639.6,155314484,chr6-155300688-G-A,rs7775163,-1,G,A,155300688,13796,155117876,155511092,182812
6,ENSG00000204351.5,31959175,chr6-31824731-A-G,rs78292716,1,A,G,31824731,134444,31762567,32155783,62164
6,ENSG00000120437.7,159762045,chr6-159679270-A-G,rs7855,1,A,G,159679270,82775,159565437,159958653,113833
6,ENSG00000096093.9,52420342,chr6-52360735-C-T,rs78900420,1,C,T,52360735,59607,52223734,52616950,137001
6,ENSG00000164440.10,139291998,chr6-139433650-C-G,rs79324176,-1,C,G,139433650,141652,139095390,139488606,338260
6,ENSG00000168298.4,26156329,chr6-26141147-C-T,rs806970,1,C,T,26141147,15182,25959721,26352937,181426
6,ENSG00000146038.6,24358059,chr6-24546799-A-G,rs811100,-1,A,G,24546799,188740,24161451,24554667,385348
6,ENSG00000196787.2,27133043,chr6-27205737-G-A,rs858983,1,G,A,27205737,72694,26936435,27329651,269302
6,ENSG00000180992.5,44127452,chr6-44108162-A-G,rs877112,-1,A,G,44108162,19290,43930844,44324060,177318
6,ENSG00000080546.9,109094846,chr6-108941984-C-T,rs911475,-1,C,T,108941984,152862,108898238,109291454,43746
6,ENSG00000204287.8,32439887,chr6-32628097-C-T,rs9271894,1,C,T,32628097,188210,32243279,32636495,384818
6,ENSG00000179344.11,32666657,chr6-32660921-C-T,rs9273529,-1,C,T,32660921,5736,32470049,32863265,190872
6,ENSG00000146166.11,63319983,chr6-63248692-G-A,rs9294140,-1,G,A,63248692,71291,63123375,63516591,125317
6,ENSG00000135315.7,84227643,chr6-84065363-G-A,rs9294289,-1,G,A,84065363,162280,84031035,84424251,34328
6,ENSG00000025039.9,89412273,chr6-89277418-C-T,rs9294430,-1,C,T,89277418,134855,89215665,89608881,61753
6,ENSG00000124678.12,35141339,chr6-35147515-T-C,rs9296143,-1,T,C,35147515,6176,34944731,35337947,202784
6,ENSG00000112039.3,35452338,chr6-35321247-G-A,rs9296146,1,G,A,35321247,131091,35255730,35648946,65517
6,ENSG00000124491.9,6320662,chr6-6399916-G-A,rs9328360,-1,G,A,6399916,79254,6124054,6517270,275862
6,ENSG00000186470.7,26365198,chr6-26340802-C-T,rs9358928,1,C,T,26340802,24396,26168590,26561806,172212
6,ENSG00000146433.7,158560091,chr6-158554684-C-T,rs9364973,1,C,T,158554684,5407,158363483,158756699,191201
6,ENSG00000153157.8,10887052,chr6-10887018-T-C,rs9366663,1,T,C,10887018,34,10690444,11083660,196574
6,ENSG00000096264.9,41335608,chr6-41333159-T-C,rs9367104,1,T,C,41333159,2449,41139000,41532216,194159
6,ENSG00000124496.8,42452045,chr6-42497689-T-G,rs9367148,-1,T,G,42497689,45644,42255437,42648653,242252
6,ENSG00000172469.9,95577535,chr6-95566045-C-G,rs9372382,1,C,G,95566045,11490,95380927,95774143,185118
6,ENSG00000131013.3,149546043,chr6-149560687-G-A,rs9373596,-1,G,A,149560687,14644,149349435,149742651,211252
6,ENSG00000112306.7,132814569,chr6-132866046-T-G,rs9375927,1,T,G,132866046,51477,132617961,133011177,248085
6,ENSG00000204366.3,31902086,chr6-31901161-C-T,rs9394078,-1,C,T,31901161,925,31705478,32098694,195683
6,ENSG00000111863.7,11778803,chr6-11721068-C-A,rs9394270,-1,C,A,11721068,57735,11582195,11975411,138873
6,ENSG00000178199.9,149485014,chr6-149509525-C-T,rs9399689,-1,C,T,149509525,24511,149288406,149681622,221119
6,ENSG00000112378.9,138107419,chr6-138005556-G-T,rs9402935,-1,G,T,138005556,101863,137910811,138304027,94745
6,ENSG00000146386.7,139028745,chr6-139020013-A-G,rs9403027,1,A,G,139020013,8732,138832137,139225353,187876
6,ENSG00000135604.9,144150517,chr6-144013430-T-A,rs9403544,1,T,A,144013430,137087,143953909,144347125,59521
6,ENSG00000135604.9,144150517,chr6-144013430-T-C,rs9403544,1,T,C,144013430,137087,143953909,144347125,59521
6,ENSG00000135318.6,85450083,chr6-85485580-A-G,rs9450282,1,A,G,85485580,35497,85253475,85646691,232105
6,ENSG00000164691.11,159044991,chr6-159057276-C-T,rs9457545,-1,C,T,159057276,12285,158848383,159241599,208893
6,ENSG00000112592.6,170554369,chr6-170384238-G-A,rs9459997,1,G,A,170384238,170131,170357761,170750977,26477
6,ENSG00000112062.6,36027808,chr6-35982433-T-C,rs9470187,1,T,C,35982433,45375,35831200,36224416,151233
6,ENSG00000044090.4,43053851,chr6-43101606-A-G,rs9472007,-1,A,G,43101606,47755,42857243,43250459,244363
6,ENSG00000124541.5,43021623,chr6-43101606-A-G,rs9472007,1,A,G,43101606,79983,42825015,43218231,276591
6,ENSG00000031691.5,49463370,chr6-49523592-C-T,rs9473583,1,C,T,49523592,60222,49266762,49659978,256830
6,ENSG00000153721.11,154510685,chr6-154441846-A-C,rs9479857,-1,A,C,154441846,68839,154314077,154707293,127769
6,ENSG00000198945.3,130018581,chr6-129847556-A-G,rs9483068,1,A,G,129847556,171025,129821973,130215189,25583
6,ENSG00000184530.8,127577174,chr6-127591551-T-G,rs9491833,1,T,G,127591551,14377,127380566,127773782,210985
6,ENSG00000124523.9,13574601,chr6-13456584-C-T,rs966255,1,C,T,13456584,118017,13377993,13771209,78591
6,ENSG00000124713.5,42960754,chr6-42975041-A-G,rs9986447,1,A,G,42975041,14287,42764146,43157362,210895
6,ENSG00000112592.6,170554369,chr6-170374153-G-C,rs1022615,1,G,C,170374153,180216,170357761,170750977,16392
6,ENSG00000096070.14,36196744,chr6-36320968-G-A,rs10456439,1,G,A,36320968,124224,36000136,36393352,320832
6,ENSG00000151917.11,56955107,chr6-57131890-T-C,rs10484410,1,T,C,57131890,176783,56758499,57151715,373391
6,ENSG00000112619.6,42722597,chr6-42646106-T-C,rs10484912,-1,T,C,42646106,76491,42525989,42919205,120117
6,ENSG00000146457.10,159727506,chr6-159564680-G-A,rs10484951,1,G,A,159564680,162826,159530898,159924114,33782
6,ENSG00000146457.10,159727506,chr6-159564680-G-C,rs10484951,1,G,C,159564680,162826,159530898,159924114,33782
6,ENSG00000204619.3,30067198,chr6-29970147-T-C,rs1061535,1,T,C,29970147,97051,29870590,30263806,99557
6,ENSG00000146409.5,132798637,chr6-132922771-G-A,rs11154704,-1,G,A,132922771,124134,132602029,132995245,320742
6,ENSG00000132423.6,99394195,chr6-99389078-G-A,rs11154812,-1,G,A,99389078,5117,99197587,99590803,191491
6,ENSG00000223865.4,33075990,chr6-33080690-G-T,rs1126513,1,G,T,33080690,4700,32879382,33272598,201308
6,ENSG00000204536.8,31157802,chr6-31182658-A-G,rs1128175,-1,A,G,31182658,24856,30961194,31354410,221464
6,ENSG00000204264.4,32844047,chr6-32714813-G-A,rs113721192,-1,G,A,32714813,129234,32647439,33040655,67374
6,ENSG00000204348.5,31972138,chr6-32070773-C-T,rs1150755,-1,C,T,32070773,98635,31775530,32168746,295243
6,ENSG00000204248.5,33192467,chr6-33191522-A-C,rs115831888,-1,A,C,33191522,945,32995859,33389075,195663
6,ENSG00000111863.7,11778803,chr6-11636299-G-A,rs115988391,-1,G,A,11636299,142504,11582195,11975411,54104
6,ENSG00000164691.11,159044991,chr6-159186071-A-G,rs116942979,-1,A,G,159186071,141080,158848383,159241599,337688
6,ENSG00000135525.12,136550422,chr6-136640789-G-A,rs117005134,-1,G,A,136640789,90367,136353814,136747030,286975
6,ENSG00000131019.4,150069121,chr6-150212579-C-T,rs11753049,-1,C,T,150212579,143458,149872513,150265729,340066
6,ENSG00000154548.8,89118071,chr6-89201968-G-A,rs11754862,-1,G,A,89201968,83897,88921463,89314679,280505
6,ENSG00000123505.9,110874785,chr6-110995416-C-G,rs11754928,1,C,G,110995416,120631,110678177,111071393,317239
6,ENSG00000118418.10,79234689,chr6-79244968-G-A,rs11755402,-1,G,A,79244968,10279,79038081,79431297,206887
6,ENSG00000093144.13,127343609,chr6-127186258-T-C,rs11759578,-1,T,C,127186258,157351,127147001,127540217,39257
6,ENSG00000137171.10,43059631,chr6-42955738-C-T,rs11969309,1,C,T,42955738,103893,42863023,43256239,92715
6,ENSG00000168631.6,30940973,chr6-30952101-G-C,rs11970154,1,G,C,30952101,11128,30744365,31137581,207736
6,ENSG00000171453.11,43517089,chr6-43450953-G-A,rs1214748,1,G,A,43450953,66136,43320481,43713697,130472
6,ENSG00000156639.7,37819727,chr6-37665564-G-A,rs12191101,1,G,A,37665564,154163,37623119,38016335,42445
6,ENSG00000137269.9,53795005,chr6-53819240-A-G,rs12195491,1,A,G,53819240,24235,53598397,53991613,220843
6,ENSG00000013375.9,83193265,chr6-83200674-A-G,rs12197473,-1,A,G,83200674,7409,82996657,83389873,204017
6,ENSG00000146285.9,107824313,chr6-107832815-C-T,rs12202454,-1,C,T,107832815,8502,107627705,108020921,205110
6,ENSG00000135596.12,109455772,chr6-109625358-G-A,rs12529505,-1,G,A,109625358,169586,109259164,109652380,366194
6,ENSG00000111981.3,149963943,chr6-149971745-C-T,rs12529569,1,C,T,149971745,7802,149767335,150160551,204410
6,ENSG00000118513.13,135181308,chr6-135264221-T-C,rs12529613,1,T,C,135264221,82913,134984700,135377916,279521
6,ENSG00000124508.12,26383108,chr6-26462128-C-T,rs12660069,1,C,T,26462128,79020,26186500,26579716,275628
6,ENSG00000124795.10,18264530,chr6-18181114-C-T,rs12664214,-1,C,T,18181114,83416,18067922,18461138,113192
6,ENSG00000157343.4,35737032,chr6-35925166-C-T,rs13219605,1,C,T,35925166,188134,35540424,35933640,384742
6,ENSG00000172738.7,37258122,chr6-37311157-T-C,rs149709,-1,T,C,37311157,53035,37061514,37454730,249643
6,ENSG00000196747.3,27808173,chr6-27997045-A-C,rs149940,1,A,C,27997045,188872,27611565,28004781,385480
6,ENSG00000026297.10,166956550,chr6-167042141-G-A,rs162298,-1,G,A,167042141,85591,166759942,167153158,282199
6,ENSG00000204287.8,32439887,chr6-32443935-G-A,rs16822632,1,G,A,32443935,4048,32243279,32636495,200656
6,ENSG00000178233.10,44270450,chr6-44277233-C-G,rs16871694,1,C,G,44277233,6783,44073842,44467058,203391
6,ENSG00000111886.8,89315299,chr6-89342196-A-G,rs16881711,-1,A,G,89342196,26897,89118691,89511907,223505
6,ENSG00000135314.8,73310215,chr6-73309653-T-C,rs16883573,-1,T,C,73309653,562,73113607,73506823,196046
6,ENSG00000111802.8,24666899,chr6-24641377-C-T,rs16889556,-1,C,T,24641377,25522,24470291,24863507,171086
6,ENSG00000112304.5,24667077,chr6-24650398-C-T,rs16889567,1,C,T,24650398,16679,24470469,24863685,179929
6,ENSG00000112658.6,43171269,chr6-43359379-T-C,rs16896453,1,T,C,43359379,188110,42974661,43367877,384718
6,ENSG00000010810.11,111873452,chr6-111961196-G-A,rs17073100,-1,G,A,111961196,87744,111676844,112070060,284352
6,ENSG00000025156.7,122399652,chr6-122422593-C-T,rs17084528,1,C,T,122422593,22941,122203044,122596260,219549
6,ENSG00000198721.8,4135575,chr6-4009632-T-C,rs17137470,-1,T,C,4009632,125943,3938967,4332183,70665
6,ENSG00000146112.6,30686645,chr6-30704549-T-C,rs17292678,-1,T,C,30704549,17904,30490037,30883253,214512
6,ENSG00000204642.7,29723434,chr6-29736623-T-C,rs1736913,1,T,C,29736623,13189,29526826,29920042,209797
6,ENSG00000146166.11,63319983,chr6-63348660-T-C,rs1741797,-1,T,C,63348660,28677,63123375,63516591,225285
6,ENSG00000137409.12,36986196,chr6-37002079-C-T,rs1753285,-1,C,T,37002079,15883,36789588,37182804,212491
6,ENSG00000111912.13,125790960,chr6-125783674-A-G,rs1777206,1,A,G,125783674,7286,125594352,125987568,189322
6,ENSG00000204227.4,33208500,chr6-33170900-G-A,rs1799911,1,G,A,33170900,37600,33011892,33405108,159008
6,ENSG00000008083.8,15246069,chr6-15133634-G-A,rs1884121,1,G,A,15133634,112435,15049461,15442677,84173
6,ENSG00000111906.12,125301967,chr6-125344949-G-A,rs1934991,-1,G,A,125344949,42982,125105359,125498575,239590
6,ENSG00000158406.2,26285534,chr6-26122705-G-T,rs198823,-1,G,T,26122705,162829,26088926,26482142,33779
6,ENSG00000153046.12,4776404,chr6-4608019-C-T,rs2007513,1,C,T,4608019,168385,4579796,4973012,28223
6,ENSG00000118514.9,134950101,chr6-135118125-A-G,rs2026937,-1,A,G,135118125,168024,134753493,135146709,364632
6,ENSG00000156711.10,36130513,chr6-36139395-G-A,rs2071863,1,G,A,36139395,8882,35933905,36327121,205490
6,ENSG00000137310.7,31158589,chr6-31272119-T-C,rs2074491,1,T,C,31272119,113530,30961981,31355197,310138
6,ENSG00000197283.7,33420065,chr6-33543452-G-A,rs210203,1,G,A,33543452,123387,33223457,33616673,319995
6,ENSG00000153989.7,117675469,chr6-117522909-A-G,rs210648,1,A,G,117522909,152560,117478861,117872077,44048
6,ENSG00000184530.8,127577174,chr6-127588832-C-A,rs2121881,1,C,A,127588832,11658,127380566,127773782,208266
6,ENSG00000096092.5,52671113,chr6-52587787-A-G,rs2239620,1,A,G,52587787,83326,52474505,52867721,113282
6,ENSG00000093134.8,132734765,chr6-132672889-C-T,rs2251553,-1,C,T,132672889,61876,132538157,132931373,134732
6,ENSG00000146282.12,87589987,chr6-87476059-T-C,rs2268996,-1,T,C,87476059,113928,87393379,87786595,82680
6,ENSG00000065308.4,52577060,chr6-52490408-T-C,rs2273120,-1,T,C,52490408,86652,52380452,52773668,109956
6,ENSG00000111843.8,10723070,chr6-10881942-C-T,rs2275387,1,C,T,10881942,158872,10526462,10919678,355480
6,ENSG00000034693.8,143450805,chr6-143484202-A-G,rs2294506,1,A,G,143484202,33397,143254197,143647413,230005
6,ENSG00000112299.7,132714055,chr6-132724673-G-A,rs2294758,-1,G,A,132724673,10618,132517447,132910663,207226
6,ENSG00000204371.6,31897684,chr6-31750825-G-A,rs2299851,-1,G,A,31750825,146859,31701076,32094292,49749
6,ENSG00000079950.8,132513116,chr6-132709353-T-C,rs2300077,-1,T,C,132709353,196237,132316508,132709724,392845
6,ENSG00000137265.9,391752,chr6-460732-G-T,rs2316795,1,G,T,460732,68980,195144,588360,265588
6,ENSG00000146433.7,158560091,chr6-158552443-A-G,rs2362575,1,A,G,158552443,7648,158363483,158756699,188960
6,ENSG00000112079.8,36547479,chr6-36717816-G-A,rs236488,-1,G,A,36717816,170337,36350871,36744087,366945
6,ENSG00000122194.12,160702244,chr6-160894184-A-C,rs2489955,1,A,C,160894184,191940,160505636,160898852,388548
6,ENSG00000204482.5,31586277,chr6-31596390-A-G,rs2515919,1,A,G,31596390,10113,31389669,31782885,206721
6,ENSG00000227507.2,31582424,chr6-31526961-C-A,rs2734573,-1,C,A,31526961,55463,31385816,31779032,141145
6,ENSG00000112096.11,159693241,chr6-159683812-G-T,rs2758330,-1,G,T,159683812,9429,159496633,159889849,187179
6,ENSG00000214113.5,5260950,chr6-5240666-C-T,rs2773296,-1,C,T,5240666,20284,5064342,5457558,176324
6,ENSG00000124787.9,5004037,chr6-5044535-A-C,rs2793259,-1,A,C,5044535,40498,4807429,5200645,237106
6,ENSG00000112149.5,14117772,chr6-13954401-G-A,rs280171,1,G,A,13954401,163371,13921164,14314380,33237
6,ENSG00000111913.11,24935960,chr6-24760730-G-A,rs2817739,-1,G,A,24760730,175230,24739352,25132568,21378
6,ENSG00000196126.6,32589848,chr6-32591976-T-C,rs28366266,-1,T,C,32591976,2128,32393240,32786456,198736
6,ENSG00000124570.11,2971567,chr6-3005952-G-A,rs28383612,-1,G,A,3005952,34385,2774959,3168175,230993
6,ENSG00000184465.11,169702029,chr6-169830086-A-G,rs2864054,-1,A,G,169830086,128057,169505421,169898637,324665
6,ENSG00000145996.7,20534457,chr6-20428550-G-A,rs2876564,1,G,A,20428550,105907,20337849,20731065,90701
6,ENSG00000198719.7,170291078,chr6-170133013-G-C,rs2935066,-1,G,C,170133013,158065,170094470,170487686,38543
6,ENSG00000112701.12,75601880,chr6-75426552-G-A,rs2951928,1,G,A,75426552,175328,75405272,75798488,21280
6,ENSG00000236104.2,33317744,chr6-33344531-A-G,rs3130014,-1,A,G,33344531,26787,33121136,33514352,223395
6,ENSG00000231925.6,33314078,chr6-33147247-T-C,rs3130151,-1,T,C,33147247,166831,33117470,33510686,29777
6,ENSG00000112031.11,153002709,chr6-153187190-G-A,rs316289,-1,G,A,153187190,184481,152806101,153199317,381089
6,ENSG00000137275.7,3068494,chr6-2892774-A-G,rs318489,1,A,G,2892774,175720,2871886,3265102,20888
6,ENSG00000170542.5,2903309,chr6-2910764-A-G,rs318496,-1,A,G,2910764,7455,2706701,3099917,204063
6,ENSG00000145949.8,2750922,chr6-2912043-G-A,rs318497,-1,G,A,2912043,161121,2554314,2947530,357729
6,ENSG00000021355.7,2841863,chr6-2912043-G-A,rs318497,-1,G,A,2912043,70180,2645255,3038471,266788
6,ENSG00000048544.5,42217861,chr6-42200375-G-A,rs34173278,-1,G,A,42200375,17486,42021253,42414469,179122
6,ENSG00000175048.11,157381190,chr6-157553507-A-G,rs35380765,1,A,G,157553507,172317,157184582,157577798,368925
6,ENSG00000112339.10,135054822,chr6-135006317-G-A,rs35485255,-1,G,A,135006317,48505,134858214,135251430,148103
6,ENSG00000112697.10,75284792,chr6-75204610-G-A,rs3756791,-1,G,A,75204610,80182,75088184,75481400,116426
6,ENSG00000124535.10,2765393,chr6-2766493-A-G,rs3757094,1,A,G,2766493,1100,2568785,2962001,197708
6,ENSG00000204580.6,30884519,chr6-30954105-T-C,rs3757340,1,T,C,30954105,69586,30687911,31081127,266194
6,ENSG00000146416.10,143060889,chr6-143108339-A-G,rs3789783,1,A,G,143108339,47450,142864281,143257497,244058
6,ENSG00000186470.7,26365198,chr6-26466954-T-C,rs3799380,1,T,C,26466954,101756,26168590,26561806,298364
6,ENSG00000111801.10,26440504,chr6-26466954-T-C,rs3799380,1,T,C,26466954,26450,26243896,26637112,223058
6,ENSG00000112357.7,136822592,chr6-136913025-T-G,rs3799480,1,T,G,136913025,90433,136625984,137019200,287041
6,ENSG00000157593.11,44257528,chr6-44260715-A-G,rs3799962,-1,A,G,44260715,3187,44060920,44454136,199795
6,ENSG00000196821.5,34696767,chr6-34648545-G-C,rs3800461,-1,G,C,34648545,48222,34500159,34893375,148386
6,ENSG00000083123.8,80106671,chr6-80275822-A-G,rs3805896,1,A,G,80275822,169151,79910063,80303279,365759
6,ENSG00000001561.5,46129989,chr6-46168247-G-T,rs3806995,1,G,T,46168247,38258,45933381,46326597,234866
6,ENSG00000124731.7,41286682,chr6-41248596-A-G,rs3857580,-1,A,G,41248596,38086,41090074,41483290,158522
6,ENSG00000204516.5,31498145,chr6-31507043-C-T,rs41293883,1,C,T,31507043,8898,31301537,31694753,205506
6,ENSG00000112739.11,4021300,chr6-3884918-C-T,rs4145940,1,C,T,3884918,136382,3824692,4217908,60226
6,ENSG00000204267.8,32838739,chr6-32829016-G-A,rs4148876,-1,G,A,32829016,9723,32642131,33035347,186885
6,ENSG00000137285.8,3227653,chr6-3189475-C-G,rs4327733,-1,C,G,3189475,38178,3031045,3424261,158430
6,ENSG00000112218.5,96837477,chr6-96658805-G-A,rs4341010,-1,G,A,96658805,178672,96640869,97034085,17936
6,ENSG00000213066.5,166999397,chr6-166984126-G-A,rs435359,1,G,A,166984126,15271,166802789,167196005,181337
6,ENSG00000204444.6,31655894,chr6-31713512-C-T,rs442391,1,C,T,31713512,57618,31459286,31852502,254226
6,ENSG00000085377.8,105403082,chr6-105348032-C-T,rs4585599,-1,C,T,105348032,55050,105206474,105599690,141558
6,ENSG00000197081.7,159969082,chr6-159786538-A-G,rs4709369,1,A,G,159786538,182544,159772474,160165690,14064
6,ENSG00000056972.13,111605878,chr6-111609703-G-A,rs4947129,-1,G,A,111609703,3825,111409270,111802486,200433
6,ENSG00000130396.15,167826911,chr6-167819149-A-G,rs503364,1,A,G,167819149,7762,167630303,168023519,188846
6,ENSG00000111816.5,116060891,chr6-115943191-C-A,rs550480,-1,C,A,115943191,117700,115864283,116257499,78908
6,ENSG00000145979.11,13328537,chr6-13318377-G-A,rs555100,-1,G,A,13318377,10160,13131929,13525145,186448
6,ENSG00000179344.11,32666657,chr6-32553039-G-C,rs58495148,-1,G,C,32553039,113618,32470049,32863265,82990
6,ENSG00000130338.8,158312465,chr6-158476762-C-T,rs599329,1,C,T,158476762,164297,158115857,158509073,360905
6,ENSG00000155906.11,151452126,chr6-151412926-C-T,rs60701331,-1,C,T,151412926,39200,151255518,151648734,157408
6,ENSG00000060762.13,166382940,chr6-166287287-C-A,rs61137892,-1,C,A,166287287,95653,166186332,166579548,100955
6,ENSG00000146232.9,44265551,chr6-44205197-T-C,rs62401143,-1,T,C,44205197,60354,44068943,44462159,136254
6,ENSG00000146192.9,37005655,chr6-37117383-G-A,rs62408363,1,G,A,37117383,111728,36809047,37202263,308336
6,ENSG00000146247.11,79078254,chr6-79172917-T-A,rs62411266,-1,T,A,79172917,94663,78881646,79274862,291271
6,ENSG00000078401.6,12290361,chr6-12261688-T-G,rs6458155,1,T,G,12261688,28673,12093753,12486969,167935
6,ENSG00000078401.6,12290361,chr6-12261688-T-C,rs6458155,1,T,C,12261688,28673,12093753,12486969,167935
6,ENSG00000096433.5,33621322,chr6-33716536-A-T,rs649775,1,A,T,33716536,95214,33424714,33817930,291822
6,ENSG00000096433.5,33621322,chr6-33716536-A-G,rs649775,1,A,G,33716536,95214,33424714,33817930,291822
6,ENSG00000029639.6,155314484,chr6-155223123-A-G,rs6557410,-1,A,G,155223123,91361,155117876,155511092,105247
6,ENSG00000137251.9,54308441,chr6-54422922-A-G,rs681834,1,A,G,54422922,114481,54111833,54505049,311089
6,ENSG00000111911.5,125956770,chr6-125901927-G-A,rs6900852,1,G,A,125901927,54843,125760162,126153378,141765
6,ENSG00000124532.9,24402936,chr6-24475072-A-T,rs6901703,1,A,T,24475072,72136,24206328,24599544,268744
6,ENSG00000214338.6,127519191,chr6-127543148-C-A,rs6902947,-1,C,A,127543148,23957,127322583,127715799,220565
6,ENSG00000146109.3,26596953,chr6-26464414-A-G,rs6911765,1,A,G,26464414,132539,26400345,26793561,64069
6,ENSG00000124762.7,36678714,chr6-36661740-T-C,rs6912480,1,T,C,36661740,16974,36482106,36875322,179634
6,ENSG00000112234.3,98947946,chr6-99078045-G-T,rs6912645,-1,G,T,99078045,130099,98751338,99144554,326707
6,ENSG00000112576.8,41941808,chr6-41947405-T-C,rs6913232,-1,T,C,41947405,5597,41745200,42138416,202205
6,ENSG00000112667.8,43229481,chr6-43178649-A-G,rs6914964,-1,A,G,43178649,50832,43032873,43426089,145776
6,ENSG00000137413.11,42050524,chr6-42224844-G-A,rs6915565,1,G,A,42224844,174320,41853916,42247132,370928
6,ENSG00000112379.7,138161939,chr6-138207174-T-C,rs6916055,1,T,C,138207174,45235,137965331,138358547,241843
6,ENSG00000012660.9,53348950,chr6-53206551-G-A,rs6917666,-1,G,A,53206551,142399,53152342,53545558,54209
6,ENSG00000170915.8,52362151,chr6-52356137-C-T,rs6917990,1,C,T,52356137,6014,52165543,52558759,190594
6,ENSG00000180573.7,26124172,chr6-26277891-G-A,rs6924986,1,G,A,26277891,153719,25927564,26320780,350327
6,ENSG00000171611.4,42916053,chr6-42944851-A-G,rs6927188,1,A,G,42944851,28798,42719445,43112661,225406
6,ENSG00000111962.7,148747030,chr6-148619464-A-G,rs6928140,1,A,G,148619464,127566,148550422,148943638,69042
6,ENSG00000001036.8,143511720,chr6-143540556-C-T,rs6935132,-1,C,T,143540556,28836,143315112,143708328,225444
6,ENSG00000146281.5,89146055,chr6-89153006-T-C,rs6937095,1,T,C,89153006,6951,88949447,89342663,203559
6,ENSG00000112759.11,44223595,chr6-44224183-A-C,rs693955,1,A,C,44224183,588,44026987,44420203,197196
6,ENSG00000079691.13,25279374,chr6-25392705-T-C,rs716798,1,T,C,25392705,113331,25082766,25475982,309939
6,ENSG00000146453.7,159800276,chr6-159862858-C-T,rs722498,1,C,T,159862858,62582,159603668,159996884,259190
6,ENSG00000189325.6,36336888,chr6-36297915-G-A,rs72848557,-1,G,A,36297915,38973,36140280,36533496,157635
6,ENSG00000124713.5,42960754,chr6-43101709-T-C,rs72867536,1,T,C,43101709,140955,42764146,43157362,337563
6,ENSG00000178409.9,107115515,chr6-107057933-C-T,rs72935728,-1,C,T,107057933,57582,106918907,107312123,139026
6,ENSG00000112306.7,132814569,chr6-132891440-C-G,rs73002029,1,C,G,132891440,76871,132617961,133011177,273479
6,ENSG00000186340.9,169253846,chr6-169200949-C-T,rs73041845,-1,C,T,169200949,52897,169057238,169450454,143711
6,ENSG00000137225.8,44158820,chr6-44225969-C-G,rs731780,1,C,G,44225969,67149,43962212,44355428,263757
6,ENSG00000188994.8,87155565,chr6-86961711-G-A,rs74559531,1,G,A,86961711,193854,86958957,87352173,2754
6,ENSG00000124766.4,21593751,chr6-21677947-A-G,rs75157802,1,A,G,21677947,84196,21397143,21790359,280804
6,ENSG00000169976.5,144095573,chr6-144071249-G-T,rs763773,-1,G,T,144071249,24324,143898965,144292181,172284
6,ENSG00000118508.4,146543833,chr6-146631279-T-C,rs76877742,1,T,C,146631279,87446,146347225,146740441,284054
6,ENSG00000112309.6,70957060,chr6-70843694-A-C,rs77190822,-1,A,C,70843694,113366,70760452,71153668,83242
6,ENSG00000177688.5,149400262,chr6-149306077-G-A,rs77208944,1,G,A,149306077,94185,149203654,149596870,102423
6,ENSG00000112406.4,139135080,chr6-138999151-G-A,rs7741529,1,G,A,138999151,135929,138938472,139331688,60679
6,ENSG00000164484.7,130366017,chr6-130459937-T-A,rs7741911,1,T,A,130459937,93920,130169409,130562625,290528
6,ENSG00000095951.11,12012312,chr6-11878046-C-T,rs7741970,1,C,T,11878046,134266,11815704,12208920,62342
6,ENSG00000111875.6,118894152,chr6-118781108-A-G,rs7743045,1,A,G,118781108,113044,118697544,119090760,83564
6,ENSG00000204632.7,29827825,chr6-29947692-T-C,rs7745413,1,T,C,29947692,119867,29631217,30024433,316475
6,ENSG00000111961.11,148342838,chr6-148449369-T-C,rs7746800,1,T,C,148449369,106531,148146230,148539446,303139
6,ENSG00000014123.9,96521806,chr6-96689105-T-G,rs7746875,1,T,G,96689105,167299,96325198,96718414,363907
6,ENSG00000112210.6,57222307,chr6-57034103-A-G,rs7748120,-1,A,G,57034103,188204,57025699,57418915,8404
6,ENSG00000112599.7,42194956,chr6-42202924-T-C,rs7749339,-1,T,C,42202924,7968,41998348,42391564,204576
6,ENSG00000164442.7,139374648,chr6-139419770-C-T,rs7751870,-1,C,T,139419770,45122,139178040,139571256,241730
6,ENSG00000137200.6,37433221,chr6-37344732-C-T,rs7758096,1,C,T,37344732,88489,37236613,37629829,108119
6,ENSG00000176381.4,166308392,chr6-166291144-G-A,rs7759603,-1,G,A,166291144,17248,166111784,166505000,179360
6,ENSG00000196911.5,116681211,chr6-116554264-G-A,rs7762318,1,G,A,116554264,126947,116484603,116877819,69661
6,ENSG00000112308.7,24719154,chr6-24748419-T-C,rs7772399,-1,T,C,24748419,29265,24522546,24915762,225873
6,ENSG00000196569.6,128883138,chr6-128977716-A-C,rs77880750,1,A,C,128977716,94578,128686530,129079746,291186
6,ENSG00000055211.7,149566375,chr6-149608132-T-C,rs78055549,1,T,C,149608132,41757,149369767,149762983,238365
6,ENSG00000146072.5,47309905,chr6-47380443-C-T,rs78189219,-1,C,T,47380443,70538,47113297,47506513,267146
6,ENSG00000112761.12,112054104,chr6-112238036-G-T,rs79128042,1,G,T,112238036,183932,111857496,112250712,380540
6,ENSG00000156535.8,73696203,chr6-73695400-C-T,rs79317699,1,C,T,73695400,803,73499595,73892811,195805
6,ENSG00000135318.6,85450083,chr6-85594044-A-G,rs79514927,1,A,G,85594044,143961,85253475,85646691,340569
6,ENSG00000124575.5,26234987,chr6-26141147-C-T,rs806970,-1,C,T,26141147,93840,26038379,26431595,102768
6,ENSG00000137261.9,24646191,chr6-24548744-C-T,rs807531,-1,C,T,24548744,97447,24449583,24842799,99161
6,ENSG00000180992.5,44127452,chr6-44066954-C-A,rs833810,-1,C,A,44066954,60498,43930844,44324060,136110
6,ENSG00000124635.6,27132795,chr6-27205737-G-A,rs858983,-1,G,A,27205737,72942,26936187,27329403,269550
6,ENSG00000204525.8,31272092,chr6-31175734-G-A,rs887466,-1,G,A,31175734,96358,31075484,31468700,100250
6,ENSG00000164674.10,158650054,chr6-158798572-C-T,rs901367,1,C,T,158798572,148518,158453446,158846662,345126
6,ENSG00000096093.9,52420342,chr6-52546324-A-T,rs910244,1,A,T,52546324,125982,52223734,52616950,322590
6,ENSG00000096093.9,52420342,chr6-52546324-A-C,rs910244,1,A,C,52546324,125982,52223734,52616950,322590
6,ENSG00000234745.3,31357179,chr6-31384336-T-C,rs9266772,-1,T,C,31384336,27157,31160571,31553787,223765
6,ENSG00000204315.3,32130288,chr6-32212846-C-A,rs9267835,-1,C,A,32212846,82558,31933680,32326896,279166
6,ENSG00000198502.5,32530287,chr6-32463581-T-G,rs9268880,-1,T,G,32463581,66706,32333679,32726895,129902
6,ENSG00000196735.6,32637406,chr6-32607592-G-T,rs9271055,1,G,T,32607592,29814,32440798,32834014,166794
6,ENSG00000237541.3,32741391,chr6-32634619-C-T,rs9272226,1,C,T,32634619,106772,32544783,32937999,89836
6,ENSG00000124491.9,6320662,chr6-6331640-T-C,rs927332,-1,T,C,6331640,10978,6124054,6517270,207586
6,ENSG00000047579.13,15663028,chr6-15686468-G-A,rs9296989,-1,G,A,15686468,23440,15466420,15859636,220048
6,ENSG00000091831.15,151807682,chr6-151879295-C-T,rs9322336,1,C,T,151879295,71613,151611074,152004290,268221
6,ENSG00000085382.7,104859919,chr6-104784358-A-C,rs9322817,-1,A,C,104784358,75561,104663311,105056527,121047
6,ENSG00000198833.5,89352722,chr6-89327264-T-G,rs9344925,-1,T,G,89327264,25458,89156114,89549330,171150
6,ENSG00000172197.9,20212469,chr6-20209561-A-G,rs9350223,-1,A,G,20209561,2908,20015861,20409077,193700
6,ENSG00000118432.11,88166347,chr6-88170982-T-C,rs9353528,-1,T,C,88170982,4635,87969739,88362955,201243
6,ENSG00000180596.6,26123926,chr6-26303091-T-C,rs9357004,-1,T,C,26303091,179165,25927318,26320534,375773
6,ENSG00000112763.10,26457955,chr6-26479663-G-T,rs9357008,1,G,T,26479663,21708,26261347,26654563,218316
6,ENSG00000137207.6,43516926,chr6-43448604-G-C,rs9357412,-1,G,C,43448604,68322,43320318,43713534,128286
6,ENSG00000153157.8,10887052,chr6-10893446-G-T,rs9368452,1,G,T,10893446,6394,10690444,11083660,203002
6,ENSG00000153157.8,10887052,chr6-10893446-G-C,rs9368452,1,G,C,10893446,6394,10690444,11083660,203002
6,ENSG00000118689.9,108560917,chr6-108538390-G-A,rs9374035,1,G,A,108538390,22527,108364309,108757525,174081
6,ENSG00000153975.5,116668766,chr6-116750220-C-G,rs9374622,-1,C,G,116750220,81454,116472158,116865374,278062
6,ENSG00000132424.10,99425308,chr6-99393043-C-T,rs9376127,-1,C,T,99393043,32265,99228700,99621916,164343
6,ENSG00000124783.8,7313199,chr6-7504124-C-T,rs9379111,-1,C,T,7504124,190925,7116591,7509807,387533
6,ENSG00000146085.6,49463253,chr6-49516488-G-A,rs9381793,-1,G,A,49516488,53235,49266645,49659861,249843
6,ENSG00000173214.5,111259339,chr6-111073366-T-C,rs9400464,1,T,C,111073366,185973,111062731,111455947,10635
6,ENSG00000146376.5,129710177,chr6-129715324-C-A,rs9402164,-1,C,A,129715324,5147,129513569,129906785,201755
6,ENSG00000135521.8,143843338,chr6-144013430-T-C,rs9403544,1,T,C,144013430,170092,143646730,144039946,366700
6,ENSG00000135521.8,143843338,chr6-144013430-T-A,rs9403544,1,T,A,144013430,170092,143646730,144039946,366700
6,ENSG00000196230.7,30720352,chr6-30702515-C-T,rs9405048,1,C,T,30702515,17837,30523744,30916960,178771
6,ENSG00000168994.8,3751713,chr6-3928821-G-A,rs9405208,-1,G,A,3928821,177108,3555105,3948321,373716
6,ENSG00000112706.7,76072662,chr6-75947981-C-T,rs943085,-1,C,T,75947981,124681,75876054,76269270,71927
6,ENSG00000118402.5,79947553,chr6-79905099-G-A,rs9448846,-1,G,A,79905099,42454,79750945,80144161,154154
6,ENSG00000130340.9,157823246,chr6-157801208-G-T,rs9458540,1,G,T,157801208,22038,157626638,158019854,174570
6,ENSG00000204531.9,31170682,chr6-31275570-C-T,rs9461680,-1,C,T,31275570,104888,30974074,31367290,301496
6,ENSG00000124587.9,42979181,chr6-42922864-A-G,rs9462851,-1,A,G,42922864,56317,42782573,43175789,140291
6,ENSG00000124493.8,34146087,chr6-34026014-C-T,rs9469687,-1,C,T,34026014,120073,33949479,34342695,76535
6,ENSG00000124493.8,34146087,chr6-34026014-C-A,rs9469687,-1,C,A,34026014,120073,33949479,34342695,76535
6,ENSG00000146476.6,151452466,chr6-151349591-G-A,rs9478197,1,G,A,151349591,102875,151255858,151649074,93733
6,ENSG00000112303.9,132757904,chr6-132748326-G-A,rs9483497,-1,G,A,132748326,9578,132561296,132954512,187030
6,ENSG00000080546.9,109094846,chr6-109265741-A-G,rs9487019,-1,A,G,109265741,170895,108898238,109291454,367503
6,ENSG00000051620.5,138404223,chr6-138278105-A-G,rs9494990,1,A,G,138278105,126118,138207615,138600831,70490
6,ENSG00000164440.10,139291998,chr6-139278990-G-A,rs9495409,-1,G,A,139278990,13008,139095390,139488606,183600
6,ENSG00000145945.5,3849373,chr6-3708966-A-T,rs9503715,1,A,T,3708966,140407,3652765,4045981,56201
6,ENSG00000080007.6,73394828,chr6-73243041-G-A,rs951021,1,G,A,73243041,151787,73198220,73591436,44821
6,ENSG00000124615.12,39934462,chr6-39924281-G-A,rs9689513,-1,G,A,39924281,10181,39737854,40131070,186427
6,ENSG00000151914.12,56954830,chr6-56953908-T-C,rs986245,-1,T,C,56953908,922,56758222,57151438,195686
6,ENSG00000204228.3,33204655,chr6-33168185-C-G,rs986522,1,C,G,33168185,36470,33008047,33401263,160138
6,ENSG00000112139.9,37697883,chr6-37681935-C-T,rs989713,-1,C,T,37681935,15948,37501275,37894491,180660
5,ENSG00000152684.10,52787916,chr5-52857922-T-C,rs10038615,1,T,C,52857922,70006,52591308,52984524,266614
5,ENSG00000164576.6,154445997,chr5-154399157-G-A,rs10040997,1,G,A,154399157,46840,154249389,154642605,149768
5,ENSG00000172239.9,43557077,chr5-43561657-C-T,rs10042992,-1,C,T,43561657,4580,43360469,43753685,201188
5,ENSG00000112874.5,103562789,chr5-103549137-T-C,rs10057864,-1,T,C,103549137,13652,103366181,103759397,182956
5,ENSG00000113296.10,80035348,chr5-79978772-T-A,rs10060444,1,T,A,79978772,56576,79838740,80231956,140032
5,ENSG00000151883.10,50666637,chr5-50539205-T-C,rs10067795,1,T,C,50539205,127432,50470029,50863245,69176
5,ENSG00000164209.11,110739007,chr5-110846397-A-T,rs10068260,1,A,T,110846397,107390,110542399,110935615,303998
5,ENSG00000152620.8,36241925,chr5-36242252-A-G,rs10075150,-1,A,G,36242252,327,36045317,36438533,196935
5,ENSG00000176049.10,147782728,chr5-147759166-G-A,rs1016104,-1,G,A,147759166,23562,147586120,147979336,173046
5,ENSG00000161010.10,179858817,chr5-179837731-T-C,rs10277,-1,T,C,179837731,21086,179662209,180055425,175522
5,ENSG00000171522.5,40679915,chr5-40490688-G-A,rs10440635,1,G,A,40490688,189227,40483307,40876523,7381
5,ENSG00000183323.8,69332801,chr5-69320252-G-A,rs10471773,-1,G,A,69320252,12549,69136193,69529409,184059
5,ENSG00000142319.14,1445440,chr5-1425120-A-G,rs10475006,-1,A,G,1425120,20320,1248832,1642048,176288
5,ENSG00000198677.6,95554977,chr5-95463438-T-C,rs10515227,-1,T,C,95463438,91539,95358369,95751585,105069
5,ENSG00000145725.11,103120301,chr5-102965664-T-C,rs10515337,1,T,C,102965664,154637,102923693,103316909,41971
5,ENSG00000113368.6,126777136,chr5-126836307-T-C,rs1051643,1,T,C,126836307,59171,126580528,126973744,255779
5,ENSG00000011083.4,150190062,chr5-150362673-G-A,rs1104959,1,G,A,150362673,172611,149993454,150386670,369219
5,ENSG00000011083.4,150190062,chr5-150362673-G-T,rs1104959,1,G,T,150362673,172611,149993454,150386670,369219
5,ENSG00000169258.5,176610156,chr5-176622621-T-C,rs11134986,-1,T,C,176622621,12465,176413548,176806764,209073
5,ENSG00000228672.2,139395104,chr5-139426616-T-G,rs11242465,-1,T,G,139426616,31512,139198496,139591712,228120
5,ENSG00000169131.6,178730659,chr5-178713089-C-T,rs1132336,-1,C,T,178713089,17570,178534051,178927267,179038
5,ENSG00000164509.9,55851357,chr5-55927935-T-G,rs113678094,1,T,G,55927935,76578,55654749,56047965,273186
5,ENSG00000175471.13,95285094,chr5-95255970-T-C,rs114068480,-1,T,C,95255970,29124,95088486,95481702,167484
5,ENSG00000164190.11,36876769,chr5-36723279-G-T,rs115594123,1,G,T,36723279,153490,36680161,37073377,43118
5,ENSG00000125347.8,132490773,chr5-132335767-G-A,rs11568506,-1,G,A,132335767,155006,132294165,132687381,41602
5,ENSG00000164176.8,84384880,chr5-84233545-T-C,rs1159734,-1,T,C,84233545,151335,84188272,84581488,45273
5,ENSG00000145911.5,178113532,chr5-177992290-G-A,rs116225539,1,G,A,177992290,121242,177916924,178310140,75366
5,ENSG00000197860.5,65722109,chr5-65581787-A-G,rs11740053,-1,A,G,65581787,140322,65525501,65918717,56286
5,ENSG00000044115.14,138753425,chr5-138632045-G-A,rs11743323,1,G,A,138632045,121380,138556817,138950033,75228
5,ENSG00000180104.9,443176,chr5-386657-C-G,rs11749473,1,C,G,386657,56519,246568,639784,140089
5,ENSG00000197043.7,151157779,chr5-151155701-C-T,rs11750621,-1,C,T,151155701,2078,150961171,151354387,194530
5,ENSG00000145907.9,151771954,chr5-151592287-C-T,rs11948904,1,C,T,151592287,179667,151575346,151968562,16941
5,ENSG00000072803.13,172006638,chr5-172086352-G-A,rs11958723,-1,G,A,172086352,79714,171810030,172203246,276322
5,ENSG00000205302.2,122775080,chr5-122810924-G-C,rs12109789,1,G,C,122810924,35844,122578472,122971688,232452
5,ENSG00000164221.8,115296654,chr5-115471230-G-A,rs12153505,-1,G,A,115471230,174576,115100046,115493262,371184
5,ENSG00000131711.10,72107475,chr5-72093924-G-A,rs1217817,1,G,A,72093924,13551,71910867,72304083,183057
5,ENSG00000132837.9,79069674,chr5-79221320-C-T,rs12189248,-1,C,T,79221320,151646,78873066,79266282,348254
5,ENSG00000168944.10,123423403,chr5-123345585-T-G,rs12520233,-1,T,G,123345585,77818,123226795,123620011,118790
5,ENSG00000204767.3,169980495,chr5-169922991-G-A,rs12522080,-1,G,A,169922991,57504,169783887,170177103,139104
5,ENSG00000253767.1,141392633,chr5-141584847-A-G,rs12523361,1,A,G,141584847,192214,141196025,141589241,388822
5,ENSG00000169252.4,148826611,chr5-148826178-G-A,rs12654778,1,G,A,148826178,433,148630003,149023219,196175
5,ENSG00000132915.6,149944793,chr5-150116043-G-A,rs12655077,-1,G,A,150116043,171250,149748185,150141401,367858
5,ENSG00000174705.7,172454525,chr5-172562670-T-A,rs12658472,-1,T,A,172562670,108145,172257917,172651133,304753
5,ENSG00000177453.3,43192225,chr5-43013852-A-C,rs13169690,1,A,C,43013852,178373,42995617,43388833,18235
5,ENSG00000153044.5,69189583,chr5-69169644-C-T,rs13175606,1,C,T,69169644,19939,68992975,69386191,176669
5,ENSG00000164236.6,10564070,chr5-10704985-G-A,rs13176602,1,G,A,10704985,140915,10367462,10760678,337523
5,ENSG00000164587.7,150449739,chr5-150465963-T-A,rs13182116,-1,T,A,150465963,16224,150253131,150646347,212832
5,ENSG00000198624.7,151224092,chr5-151212630-C-T,rs13183776,-1,C,T,151212630,11462,151027484,151420700,185146
5,ENSG00000181104.6,76716126,chr5-76862029-T-C,rs1320305,1,T,C,76862029,145903,76519518,76912734,342511
5,ENSG00000170571.6,50441288,chr5-50575899-C-T,rs13355434,-1,C,T,50575899,134611,50244680,50637896,331219
5,ENSG00000186314.7,145835342,chr5-145839882-T-C,rs13359571,-1,T,C,145839882,4540,145638734,146031950,201148
5,ENSG00000164332.6,159263290,chr5-159084326-G-A,rs13362288,1,G,A,159084326,178964,159066682,159459898,17644
5,ENSG00000131459.8,180353336,chr5-180293555-T-C,rs1363516,-1,T,C,180293555,59781,180156728,180549944,136827
5,ENSG00000134061.4,67196799,chr5-67002834-T-C,rs1363932,-1,T,C,67002834,193965,67000191,67393407,2643
5,ENSG00000164308.12,96876500,chr5-96958112-A-G,rs1363974,1,A,G,96958112,81612,96679892,97073108,278220
5,ENSG00000120314.14,140664904,chr5-140558652-C-T,rs145698446,1,C,T,140558652,106252,140468296,140861512,90356
5,ENSG00000145777.10,111071713,chr5-111223184-A-G,rs1457114,1,A,G,111223184,151471,110875105,111268321,348079
5,ENSG00000079215.8,36606606,chr5-36689261-A-G,rs1529461,1,A,G,36689261,82655,36409998,36803214,279263
5,ENSG00000145687.10,81751097,chr5-81757626-C-A,rs1550802,-1,C,A,81757626,6529,81554489,81947705,203137
5,ENSG00000082074.10,39219563,chr5-39261865-T-C,rs155450,-1,T,C,39261865,42302,39022955,39416171,238910
5,ENSG00000172568.4,157345677,chr5-157454845-G-A,rs1559144,-1,G,A,157454845,109168,157149069,157542285,305776
5,ENSG00000158458.14,140043299,chr5-140043791-C-T,rs155944,-1,C,T,140043791,492,139846691,140239907,197100
5,ENSG00000145545.7,6633440,chr5-6638007-G-A,rs1651074,1,G,A,6638007,4567,6436832,6830048,201175
5,ENSG00000164284.10,149345499,chr5-149339481-G-T,rs1659087,1,G,T,149339481,6018,149148891,149542107,190590
5,ENSG00000164338.5,73565743,chr5-73565634-G-A,rs168222,1,G,A,73565634,109,73369135,73762351,196499
5,ENSG00000164338.5,73565743,chr5-73565634-G-C,rs168222,1,G,C,73565634,109,73369135,73762351,196499
5,ENSG00000132356.7,40798374,chr5-40830961-T-C,rs16870378,-1,T,C,40830961,32587,40601766,40994982,229195
5,ENSG00000164347.11,74767117,chr5-74853653-T-C,rs16872345,-1,T,C,74853653,86536,74570509,74963725,283144
5,ENSG00000113494.12,35230487,chr5-35315097-C-T,rs16873579,-1,C,T,35315097,84610,35033879,35427095,281218
5,ENSG00000145536.10,5140330,chr5-5045634-C-T,rs16874621,1,C,T,5045634,94696,4943722,5336938,101912
5,ENSG00000112902.7,9546075,chr5-9391525-C-A,rs16882610,-1,C,A,9391525,154550,9349467,9742683,42058
5,ENSG00000086200.10,62412763,chr5-62599297-A-G,rs16890857,1,A,G,62599297,186534,62216155,62609371,383142
5,ENSG00000151388.6,33891990,chr5-33890905-G-A,rs16891883,-1,G,A,33890905,1085,33695382,34088598,195523
5,ENSG00000123219.7,65563168,chr5-65613660-A-G,rs16894099,-1,A,G,65613660,50492,65366560,65759776,247100
5,ENSG00000168671.5,36066882,chr5-36067473-A-G,rs16902708,-1,A,G,36067473,591,35870274,36263490,197199
5,ENSG00000081189.9,88883184,chr5-88932561-T-G,rs16903411,-1,T,G,88932561,49377,88686576,89079792,245985
5,ENSG00000164609.5,160419081,chr5-160419067-A-G,rs17057781,-1,A,G,160419067,14,160222473,160615689,196594
5,ENSG00000113719.11,172834251,chr5-172695123-C-G,rs17075121,1,C,G,172695123,139128,172637643,173030859,57480
5,ENSG00000113719.11,172834251,chr5-172695123-C-A,rs17075121,1,C,A,172695123,139128,172637643,173030859,57480
5,ENSG00000164904.9,126595219,chr5-126572511-C-T,rs17154671,-1,C,T,126572511,22708,126398611,126791827,173900
5,ENSG00000174132.7,100535374,chr5-100676844-T-C,rs17158426,1,T,C,100676844,141470,100338766,100731982,338078
5,ENSG00000120708.9,136028988,chr5-136178653-G-A,rs17169934,1,G,A,136178653,149665,135832380,136225596,346273
5,ENSG00000145819.10,142770377,chr5-142593659-A-G,rs17217618,1,A,G,142593659,176718,142573769,142966985,19890
5,ENSG00000152939.9,69415116,chr5-69409321-A-G,rs17236590,1,A,G,69409321,5795,69218508,69611724,190813
5,ENSG00000168724.10,34929559,chr5-34961567-C-T,rs17304654,1,C,T,34961567,32008,34732951,35126167,228616
5,ENSG00000164574.11,154190733,chr5-154271899-A-G,rs17552639,1,A,G,154271899,81166,153994125,154387341,277774
5,ENSG00000164199.10,90558797,chr5-90745693-A-G,rs17624033,1,A,G,90745693,186896,90362189,90755405,383504
5,ENSG00000145757.11,95682991,chr5-95647825-C-T,rs17790731,-1,C,T,95647825,35166,95486383,95879599,161442
5,ENSG00000124275.10,7869148,chr5-7870860-A-G,rs1801394,1,A,G,7870860,1712,7672540,8065756,198320
5,ENSG00000062194.10,57174059,chr5-57231640-C-T,rs1862174,1,C,T,57231640,57581,56977451,57370667,254189
5,ENSG00000164171.5,52989352,chr5-53011540-C-T,rs1862639,1,C,T,53011540,22188,52792744,53185960,218796
5,ENSG00000145555.10,16936288,chr5-17061633-G-A,rs2086606,-1,G,A,17061633,125345,16739680,17132896,321953
5,ENSG00000027847.8,177600132,chr5-177668516-C-T,rs2133716,1,C,T,177668516,68384,177403524,177796740,264992
5,ENSG00000113716.8,150000739,chr5-150051660-G-A,rs216131,1,G,A,150051660,50921,149804131,150197347,247529
5,ENSG00000164197.7,64165843,chr5-64328599-G-A,rs2162804,1,G,A,64328599,162756,63969235,64362451,359364
5,ENSG00000178015.4,95620087,chr5-95619898-C-A,rs2194051,1,C,A,95619898,189,95423479,95816695,196419
5,ENSG00000113597.12,65625027,chr5-65793340-G-A,rs2248213,1,G,A,65793340,168313,65428419,65821635,364921
5,ENSG00000186468.8,82278354,chr5-82275850-C-T,rs226202,-1,C,T,82275850,2504,82081746,82474962,194104
5,ENSG00000146013.6,138274621,chr5-138165314-T-C,rs2269954,-1,T,C,138165314,109307,138078013,138471229,87301
5,ENSG00000066230.6,524449,chr5-469972-G-A,rs2278251,-1,G,A,469972,54477,327841,721057,142131
5,ENSG00000037749.7,154038967,chr5-153992616-T-C,rs2289265,1,T,C,153992616,46351,153842359,154235575,150257
5,ENSG00000153113.17,96662376,chr5-96660029-G-T,rs2351245,1,G,T,96660029,2347,96465768,96858984,194261
5,ENSG00000152348.9,81972023,chr5-81980268-T-C,rs2406909,1,T,C,81980268,8245,81775415,82168631,204853
5,ENSG00000152495.6,111224384,chr5-111248012-G-A,rs2434723,1,G,A,111248012,23628,111027776,111420992,220236
5,ENSG00000155850.7,149960758,chr5-149961475-T-A,rs245056,1,T,A,149961475,717,149764150,150157366,197325
5,ENSG00000013561.13,141969105,chr5-141964288-A-C,rs252143,1,A,C,141964288,4817,141772497,142165713,191791
5,ENSG00000164331.5,73565639,chr5-73600399-T-C,rs2544652,-1,T,C,73600399,34760,73369031,73762247,231368
5,ENSG00000177721.3,43040319,chr5-42922714-A-G,rs2548370,-1,A,G,42922714,117605,42843711,43236927,79003
5,ENSG00000040275.11,169583773,chr5-169587297-C-T,rs255824,1,C,T,169587297,3524,169387165,169780381,200132
5,ENSG00000123213.16,65722205,chr5-65726386-G-A,rs2561205,1,G,A,65726386,4181,65525597,65918813,200789
5,ENSG00000213523.4,140557473,chr5-140631730-C-A,rs2563298,-1,C,A,140631730,74257,140360865,140754081,270865
5,ENSG00000131495.4,140647630,chr5-140628834-G-A,rs2569188,-1,G,A,140628834,18796,140451022,140844238,177812
5,ENSG00000095015.5,56815549,chr5-56942770-A-G,rs2591961,1,A,G,56942770,127221,56618941,57012157,323829
5,ENSG00000154153.9,16616997,chr5-16558293-G-T,rs2617421,-1,G,T,16558293,58704,16420389,16813605,137904
5,ENSG00000164307.7,96807945,chr5-96790207-C-T,rs26510,-1,C,T,96790207,17738,96611337,97004553,178870
5,ENSG00000177879.10,115841935,chr5-115842698-C-T,rs26538,1,C,T,115842698,763,115645327,116038543,197371
5,ENSG00000073578.10,218320,chr5-356266-C-T,rs2672737,1,C,T,356266,137946,21712,414928,334554
5,ENSG00000164466.7,175478560,chr5-175490421-T-C,rs267377,1,T,C,175490421,11861,175281952,175675168,208469
5,ENSG00000164219.5,115262877,chr5-115334179-T-C,rs269492,-1,T,C,115334179,71302,115066269,115459485,267910
5,ENSG00000197822.6,69492790,chr5-69489471-G-A,rs28616120,1,G,A,69489471,3319,69296182,69689398,193289
5,ENSG00000175449.7,95646777,chr5-95549679-T-G,rs2881773,1,T,G,95549679,97098,95450169,95843385,99510
5,ENSG00000151304.5,121961975,chr5-121970332-A-G,rs2914605,1,A,G,121970332,8357,121765367,122158583,204965
5,ENSG00000170231.11,160229506,chr5-160391118-C-T,rs2961932,1,C,T,160391118,161612,160032898,160426114,358220
5,ENSG00000113194.7,176448385,chr5-176510546-T-C,rs2963297,1,T,C,176510546,62161,176251777,176644993,258769
5,ENSG00000074276.6,176549342,chr5-176510546-T-C,rs2963297,1,T,C,176510546,38796,176352734,176745950,157812
5,ENSG00000081059.14,134114681,chr5-134106318-A-G,rs30498,1,A,G,134106318,8363,133918073,134311289,188245
5,ENSG00000043462.7,170297777,chr5-170297763-G-C,rs315731,-1,G,C,170297763,14,170101169,170494385,196594
5,ENSG00000153922.5,98929007,chr5-98944573-A-G,rs327805,-1,A,G,98944573,15566,98732399,99125615,212174
5,ENSG00000156453.9,141878410,chr5-141754378-C-T,rs32935,-1,C,T,141754378,124032,141681802,142075018,72576
5,ENSG00000113758.9,177473634,chr5-177440275-T-C,rs335434,-1,T,C,177440275,33359,177277026,177670242,163249
5,ENSG00000231989.2,156850295,chr5-156683428-T-C,rs34853524,1,T,C,156683428,166867,156653687,157046903,29741
5,ENSG00000081791.4,141923871,chr5-141930259-G-A,rs351260,1,G,A,141930259,6388,141727263,142120479,202996
5,ENSG00000113504.13,1112063,chr5-1104823-C-T,rs35188965,-1,C,T,1104823,7240,915455,1308671,189368
5,ENSG00000153395.5,1523960,chr5-1498744-A-G,rs36989,-1,A,G,1498744,25216,1327352,1720568,171392
5,ENSG00000164615.3,134738548,chr5-134887903-A-G,rs3733897,1,A,G,134887903,149355,134541940,134935156,345963
5,ENSG00000164220.5,76623403,chr5-76592643-T-G,rs3736395,-1,T,G,76592643,30760,76426795,76820011,165848
5,ENSG00000171421.7,1799837,chr5-1814255-C-T,rs3752844,-1,C,T,1814255,14418,1603229,1996445,211026
5,ENSG00000112972.9,43313412,chr5-43383400-T-G,rs3756416,-1,T,G,43383400,69988,43116804,43510020,266596
5,ENSG00000112893.5,109689927,chr5-109690962-G-C,rs3756599,1,G,C,109690962,1035,109493319,109886535,197643
5,ENSG00000146083.7,176537402,chr5-176576453-C-T,rs3762966,-1,C,T,176576453,39051,176340794,176734010,235659
5,ENSG00000118985.10,95961851,chr5-95933064-G-A,rs3777179,-1,G,A,95933064,28787,95765243,96158459,167821
5,ENSG00000182578.8,150086554,chr5-150053300-T-C,rs3828609,-1,T,C,150053300,33254,149889946,150283162,163354
5,ENSG00000113721.7,150155845,chr5-150156062-A-C,rs3828610,-1,A,C,150156062,217,149959237,150352453,196825
5,ENSG00000169570.4,118988547,chr5-118809442-T-A,rs383585,-1,T,A,118809442,179105,118791939,119185155,17503
5,ENSG00000113558.12,134176950,chr5-134117702-T-C,rs3867425,-1,T,C,134117702,59248,133980342,134373558,137360
5,ENSG00000131435.8,132257696,chr5-132257177-T-C,rs3900945,1,T,C,132257177,519,132061088,132454304,196089
5,ENSG00000170464.5,139439525,chr5-139439612-C-T,rs3923060,-1,C,T,139439612,87,139242917,139636133,196695
5,ENSG00000170469.6,139404089,chr5-139418036-C-G,rs3924257,-1,C,G,139418036,13947,139207481,139600697,210555
5,ENSG00000170469.6,139404089,chr5-139418036-C-A,rs3924257,-1,C,A,139418036,13947,139207481,139600697,210555
5,ENSG00000198944.4,132813302,chr5-132770869-A-G,rs392916,1,A,G,132770869,42433,132616694,133009910,154175
5,ENSG00000198944.4,132813302,chr5-132770869-A-T,rs392916,1,A,T,132770869,42433,132616694,133009910,154175
5,ENSG00000134056.6,69217760,chr5-69276841-C-T,rs4077460,1,C,T,69276841,59081,69021152,69414368,255689
5,ENSG00000066583.6,129094749,chr5-129232142-T-C,rs41492044,1,T,C,129232142,137393,128898141,129291357,334001
5,ENSG00000064652.6,122845613,chr5-123026208-C-T,rs41527147,1,C,T,123026208,180595,122649005,123042221,377203
5,ENSG00000168246.5,172283764,chr5-172225859-A-G,rs41537348,-1,A,G,172225859,57905,172087156,172480372,138703
5,ENSG00000113593.7,65563296,chr5-65659068-T-C,rs42961,1,T,C,65659068,95772,65366688,65759904,292380
5,ENSG00000155545.14,56952123,chr5-56990382-T-C,rs4309923,-1,T,C,56990382,38259,56755515,57148731,234867
5,ENSG00000173221.9,95822726,chr5-95816609-A-G,rs4561,-1,A,G,95816609,6117,95626118,96019334,190491
5,ENSG00000164620.4,141636997,chr5-141704257-G-A,rs456238,1,G,A,141704257,67260,141440389,141833605,263868
5,ENSG00000145604.10,36152111,chr5-36157499-A-G,rs464812,1,A,G,36157499,5388,35955503,36348719,201996
5,ENSG00000165810.11,181040266,chr5-180914845-G-A,rs4700772,1,G,A,180914845,125421,180843658,181236874,71187
5,ENSG00000176783.9,179550554,chr5-179607259-G-A,rs4701140,1,G,A,179607259,56705,179353946,179747162,253313
5,ENSG00000155846.12,149730310,chr5-149801803-C-T,rs4705382,1,C,T,149801803,71493,149533702,149926918,268101
5,ENSG00000197208.5,132294394,chr5-132419312-A-G,rs4705943,1,A,G,132419312,124918,132097786,132491002,321526
5,ENSG00000197375.7,132369710,chr5-132419312-A-G,rs4705943,1,A,G,132419312,49602,132173102,132566318,246210
5,ENSG00000120729.5,137867860,chr5-137963201-T-C,rs4835662,1,T,C,137963201,95341,137671252,138064468,291949
5,ENSG00000164172.13,53109757,chr5-53017734-G-A,rs4865756,-1,G,A,53017734,92023,52913149,53306365,104585
5,ENSG00000113328.13,163437595,chr5-163372989-T-A,rs4869059,1,T,A,163372989,64606,163240987,163634203,132002
5,ENSG00000113328.13,163437595,chr5-163372989-T-C,rs4869059,1,T,C,163372989,64606,163240987,163634203,132002
5,ENSG00000158497.2,143812161,chr5-143771558-G-A,rs4912659,1,G,A,143771558,40603,143615553,144008769,156005
5,ENSG00000177556.7,151758631,chr5-151684113-A-G,rs4958487,-1,A,G,151684113,74518,151562023,151955239,122090
5,ENSG00000155511.10,153490670,chr5-153436579-G-A,rs4958650,1,G,A,153436579,54091,153294062,153687278,142517
5,ENSG00000129625.8,112922227,chr5-112849794-A-G,rs497844,-1,A,G,112849794,72433,112725619,113118835,124175
5,ENSG00000161011.14,179820905,chr5-179821774-A-C,rs502729,1,A,C,179821774,869,179624297,180017513,197477
5,ENSG00000234511.3,170232985,chr5-170414210-A-G,rs56231214,1,A,G,170414210,181225,170036377,170429593,377833
5,ENSG00000113739.6,173328414,chr5-173161190-T-C,rs5745164,-1,T,C,173161190,167224,173131806,173525022,29384
5,ENSG00000112977.11,10761234,chr5-10680885-G-A,rs5745297,-1,G,A,10680885,80349,10564626,10957842,116259
5,ENSG00000146063.13,181223281,chr5-181242275-C-T,rs59085681,1,C,T,181242275,18994,181026673,181419889,215602
5,ENSG00000068796.11,62306206,chr5-62285604-G-A,rs61354333,1,G,A,62285604,20602,62109598,62502814,176006
5,ENSG00000145740.13,69094014,chr5-68945089-T-C,rs62354485,1,T,C,68945089,148925,68897406,69290622,47683
5,ENSG00000113273.11,78985310,chr5-79074555-T-C,rs62377949,-1,T,C,79074555,89245,78788702,79181918,285853
5,ENSG00000178996.8,54517759,chr5-54483701-C-T,rs6450209,1,C,T,54483701,34058,54321151,54714367,162550
5,ENSG00000171530.8,77776339,chr5-77672009-C-T,rs6453341,-1,C,T,77672009,104330,77579731,77972947,92278
5,ENSG00000134058.6,69234886,chr5-69155128-A-G,rs651076,1,A,G,69155128,79758,69038278,69431494,116850
5,ENSG00000015479.12,139293740,chr5-139369899-A-G,rs6596471,1,A,G,139369899,76159,139097132,139490348,272767
5,ENSG00000170074.14,177753206,chr5-177711297-A-C,rs6601075,-1,A,C,177711297,41909,177556598,177949814,154699
5,ENSG00000170074.14,177753206,chr5-177711297-A-G,rs6601075,-1,A,G,177711297,41909,177556598,177949814,154699
5,ENSG00000145817.10,144170659,chr5-144170653-G-T,rs6864309,-1,G,T,144170653,6,143974051,144367267,196602
5,ENSG00000135074.11,157575775,chr5-157535136-G-C,rs6866363,-1,G,C,157535136,40639,157379167,157772383,155969
5,ENSG00000050748.12,180292083,chr5-180260772-C-T,rs6868333,-1,C,T,180260772,31311,180095475,180488691,165297
5,ENSG00000113070.6,140346603,chr5-140280343-C-T,rs6869801,-1,C,T,140280343,66260,140149995,140543211,130348
5,ENSG00000204764.6,170862018,chr5-170771681-T-C,rs6870687,1,T,C,170771681,90337,170665410,171058626,106271
5,ENSG00000145850.4,156963226,chr5-156958697-C-T,rs6873413,-1,C,T,156958697,4529,156766618,157159834,192079
5,ENSG00000171617.8,74640728,chr5-74491055-T-C,rs6874566,-1,T,C,74491055,149673,74444120,74837336,46935
5,ENSG00000198865.5,42756818,chr5-42698979-G-A,rs6875431,1,G,A,42698979,57839,42560210,42953426,138769
5,ENSG00000134057.10,69167150,chr5-69034530-G-A,rs6876353,1,G,A,69034530,132620,68970542,69363758,63988
5,ENSG00000171368.10,693352,chr5-545544-G-A,rs6878374,-1,G,A,545544,147808,496744,889960,48800
5,ENSG00000145779.6,119356019,chr5-119347094-C-T,rs6878879,1,C,T,119347094,8925,119159411,119552627,187683
5,ENSG00000131507.7,142108779,chr5-142058392-A-G,rs6884380,1,A,G,142058392,50387,141912171,142305387,146221
5,ENSG00000169230.5,177303799,chr5-177313995-C-A,rs6885410,1,C,A,177313995,10196,177107191,177500407,206804
5,ENSG00000145882.6,149358046,chr5-149346583-A-G,rs6887230,1,A,G,149346583,11463,149161438,149554654,185145
5,ENSG00000234284.2,179023804,chr5-179022073-T-C,rs6888567,1,T,C,179022073,1731,178827196,179220412,194877
5,ENSG00000112992.10,43603180,chr5-43680565-A-G,rs6893250,1,A,G,43680565,77385,43406572,43799788,273993
5,ENSG00000145824.8,135578991,chr5-135631045-C-A,rs6895292,-1,C,A,135631045,52054,135382383,135775599,248662
5,ENSG00000135077.4,157109044,chr5-157114365-C-T,rs6896579,-1,C,T,157114365,5321,156912436,157305652,201929
5,ENSG00000131503.15,140401833,chr5-140332965-A-C,rs7268,1,A,C,140332965,68868,140205225,140598441,127740
5,ENSG00000254996.1,140401908,chr5-140332965-A-C,rs7268,1,A,C,140332965,68943,140205300,140598516,127665
5,ENSG00000083720.7,41870425,chr5-42036404-G-T,rs72748647,-1,G,T,42036404,165979,41673817,42067033,362587
5,ENSG00000083720.7,41870425,chr5-42036404-G-A,rs72748647,-1,G,A,42036404,165979,41673817,42067033,362587
5,ENSG00000164258.7,53560639,chr5-53657454-C-T,rs72753668,1,C,T,53657454,96815,53364031,53757247,293423
5,ENSG00000171540.6,77638713,chr5-77568688-C-T,rs72770940,-1,C,T,77568688,70025,77442105,77835321,126583
5,ENSG00000113083.7,122078259,chr5-122152274-G-A,rs72786994,-1,G,A,122152274,74015,121881651,122274867,270623
5,ENSG00000113083.7,122078259,chr5-122152274-G-C,rs72786994,-1,G,C,122152274,74015,121881651,122274867,270623
5,ENSG00000196743.4,151253185,chr5-151239432-C-T,rs72794132,1,C,T,151239432,13753,151056577,151449793,182855
5,ENSG00000170606.8,133052013,chr5-133108436-G-A,rs72801474,1,G,A,133108436,56423,132855405,133248621,253031
5,ENSG00000113734.13,173144531,chr5-173089762-C-T,rs72816117,1,C,T,173089762,54769,172947923,173341139,141839
5,ENSG00000129596.4,115816659,chr5-115638165-T-C,rs72817147,-1,T,C,115638165,178494,115620051,116013267,18114
5,ENSG00000145794.12,127290796,chr5-127399340-G-A,rs74569405,1,G,A,127399340,108544,127094188,127487404,305152
5,ENSG00000155324.4,126423409,chr5-126448667-C-G,rs75108770,1,C,G,126448667,25258,126226801,126620017,221866
5,ENSG00000173210.14,149141493,chr5-149318287-C-T,rs75184973,1,C,T,149318287,176794,148944885,149338101,373402
5,ENSG00000146054.13,181205196,chr5-181199242-G-A,rs76492548,-1,G,A,181199242,5954,181008588,181401804,190654
5,ENSG00000072682.12,132227853,chr5-132250265-A-G,rs7701414,-1,A,G,132250265,22412,132031245,132424461,219020
5,ENSG00000164237.4,10307902,chr5-10306532-G-A,rs7702977,-1,G,A,10306532,1370,10111294,10504510,195238
5,ENSG00000120306.5,140175188,chr5-140238561-C-G,rs7705090,1,C,G,140238561,63373,139978580,140371796,259981
5,ENSG00000177733.4,137754363,chr5-137874962-C-T,rs7713839,-1,C,T,137874962,120599,137557755,137950971,317207
5,ENSG00000155858.5,157743712,chr5-157757772-A-G,rs7714390,1,A,G,157757772,14060,157547104,157940320,210668
5,ENSG00000244234.1,178187371,chr5-178212941-G-C,rs7719034,-1,G,C,178212941,25570,177990763,178383979,222178
5,ENSG00000067113.12,55534964,chr5-55388522-T-A,rs7719928,-1,T,A,55388522,146442,55338356,55731572,50166
5,ENSG00000113356.6,90474864,chr5-90455633-G-A,rs7729481,1,G,A,90455633,19231,90278256,90671472,177377
5,ENSG00000039560.9,34656328,chr5-34567205-G-A,rs7736168,1,G,A,34567205,89123,34459720,34852936,107485
5,ENSG00000092421.12,116574823,chr5-116687054-C-T,rs77843619,-1,C,T,116687054,112231,116378215,116771431,308839
5,ENSG00000134352.14,55994963,chr5-56123279-G-A,rs79330186,-1,G,A,56123279,128316,55798355,56191571,324924
5,ENSG00000049860.9,74685233,chr5-74682876-G-A,rs820866,1,G,A,74682876,2357,74488625,74881841,194251
5,ENSG00000154122.8,14871778,chr5-14877365-A-G,rs835153,-1,A,G,14877365,5587,14675170,15068386,202195
5,ENSG00000249915.2,271646,chr5-168810-G-A,rs876950,1,G,A,168810,102836,75038,468254,93772
5,ENSG00000051596.5,175968315,chr5-175786847-C-T,rs968024,-1,C,T,175786847,181468,175771707,176164923,15140
5,ENSG00000164307.7,96807945,chr5-96749072-C-A,rs10037212,-1,C,A,96749072,58873,96611337,97004553,137735
5,ENSG00000255833.1,135452351,chr5-135456379-C-T,rs10039805,-1,C,T,135456379,4028,135255743,135648959,200636
5,ENSG00000164284.10,149345499,chr5-149396107-A-G,rs10050356,1,A,G,149396107,50608,149148891,149542107,247216
5,ENSG00000170074.14,177753206,chr5-177693696-T-C,rs10060053,-1,T,C,177693696,59510,177556598,177949814,137098
5,ENSG00000172568.4,157345677,chr5-157490332-A-C,rs10067096,-1,A,C,157490332,144655,157149069,157542285,341263
5,ENSG00000170231.11,160229506,chr5-160269547-A-G,rs10071116,1,A,G,160269547,40041,160032898,160426114,236649
5,ENSG00000112893.5,109689927,chr5-109886143-C-T,rs10073312,1,C,T,109886143,196216,109493319,109886535,392824
5,ENSG00000064652.6,122845613,chr5-123015798-G-T,rs10080107,1,G,T,123015798,170185,122649005,123042221,366793
5,ENSG00000113494.12,35230487,chr5-35238263-T-C,rs10472952,-1,T,C,35238263,7776,35033879,35427095,204384
5,ENSG00000113296.10,80035348,chr5-80057163-G-A,rs10474606,1,G,A,80057163,21815,79838740,80231956,218423
5,ENSG00000145907.9,151771954,chr5-151796187-T-C,rs10477000,1,T,C,151796187,24233,151575346,151968562,220841
5,ENSG00000155324.4,126423409,chr5-126370184-G-T,rs10478726,1,G,T,126370184,53225,126226801,126620017,143383
5,ENSG00000079215.8,36606606,chr5-36686784-A-C,rs1049522,1,A,C,36686784,80178,36409998,36803214,276786
5,ENSG00000124275.10,7869148,chr5-7936174-T-C,rs10512934,1,T,C,7936174,67026,7672540,8065756,263634
5,ENSG00000186468.8,82278354,chr5-82352598-C-T,rs10514238,-1,C,T,82352598,74244,82081746,82474962,270852
5,ENSG00000037749.7,154038967,chr5-153992529-A-T,rs10515704,1,A,T,153992529,46438,153842359,154235575,150170
5,ENSG00000168621.10,37840041,chr5-37806428-C-T,rs10941369,-1,C,T,37806428,33613,37643433,38036649,162995
5,ENSG00000152413.10,79514134,chr5-79536172-G-A,rs10942894,-1,G,A,79536172,22038,79317526,79710742,218646
5,ENSG00000131507.7,142108779,chr5-142099500-A-C,rs11167764,1,A,C,142099500,9279,141912171,142305387,187329
5,ENSG00000169131.6,178730659,chr5-178722949-G-A,rs112370781,-1,G,A,178722949,7710,178534051,178927267,188898
5,ENSG00000164300.10,80256048,chr5-80165287-A-G,rs1132801,-1,A,G,80165287,90761,80059440,80452656,105847
5,ENSG00000145604.10,36152111,chr5-36084324-T-C,rs114136102,1,T,C,36084324,67787,35955503,36348719,128821
5,ENSG00000172901.13,115962475,chr5-116001469-G-A,rs114773365,1,G,A,116001469,38994,115765867,116159083,235602
5,ENSG00000196670.8,180861276,chr5-180835407-C-T,rs11541202,-1,C,T,180835407,25869,180664668,181057884,170739
5,ENSG00000244234.1,178187371,chr5-178050630-C-T,rs115471217,-1,C,T,178050630,136741,177990763,178383979,59867
5,ENSG00000171617.8,74640728,chr5-74468164-T-G,rs115775918,-1,T,G,74468164,172564,74444120,74837336,24044
5,ENSG00000131459.8,180353336,chr5-180414314-G-A,rs116391970,-1,G,A,180414314,60978,180156728,180549944,257586
5,ENSG00000160883.6,176899346,chr5-176858046-G-A,rs116686459,-1,G,A,176858046,41300,176702738,177095954,155308
5,ENSG00000177721.3,43040319,chr5-43095616-C-T,rs11746055,-1,C,T,43095616,55297,42843711,43236927,251905
5,ENSG00000180104.9,443176,chr5-489084-T-C,rs11748410,1,T,C,489084,45908,246568,639784,242516
5,ENSG00000204764.6,170862018,chr5-170775561-C-A,rs11951617,1,C,A,170775561,86457,170665410,171058626,110151
5,ENSG00000164615.3,134738548,chr5-134570837-C-T,rs11953143,1,C,T,134570837,167711,134541940,134935156,28897
5,ENSG00000039319.12,80408064,chr5-80452563-G-A,rs11958178,1,G,A,80452563,44499,80211456,80604672,241107
5,ENSG00000145824.8,135578991,chr5-135650385-G-A,rs11960418,-1,G,A,135650385,71394,135382383,135775599,268002
5,ENSG00000131711.10,72107475,chr5-72095585-A-G,rs1217820,1,A,G,72095585,11890,71910867,72304083,184718
5,ENSG00000154124.4,14664718,chr5-14847493-C-T,rs12188319,1,C,T,14847493,182775,14468110,14861326,379383
5,ENSG00000051596.5,175968315,chr5-175885609-G-A,rs12521617,-1,G,A,175885609,82706,175771707,176164923,113902
5,ENSG00000086570.8,151591331,chr5-151455788-A-G,rs12655145,-1,A,G,151455788,135543,151394723,151787939,61065
5,ENSG00000186314.7,145835342,chr5-145821569-C-T,rs12658465,-1,C,T,145821569,13773,145638734,146031950,182835
5,ENSG00000113460.8,34915711,chr5-34800246-T-C,rs12659689,1,T,C,34800246,115465,34719103,35112319,81143
5,ENSG00000153113.17,96662376,chr5-96661008-C-T,rs12659730,1,C,T,96661008,1368,96465768,96858984,195240
5,ENSG00000070614.9,150508131,chr5-150540177-G-C,rs1290147,1,G,C,150540177,32046,150311523,150704739,228654
5,ENSG00000254996.1,140401908,chr5-140298717-A-G,rs13153401,1,A,G,140298717,103191,140205300,140598516,93417
5,ENSG00000168944.10,123423403,chr5-123408484-T-C,rs13154356,-1,T,C,123408484,14919,123226795,123620011,181689
5,ENSG00000172548.10,157460213,chr5-157489581-A-G,rs13155908,1,A,G,157489581,29368,157263605,157656821,225976
5,ENSG00000145882.6,149358046,chr5-149385351-A-G,rs13160429,1,A,G,149385351,27305,149161438,149554654,223913
5,ENSG00000164181.9,60844269,chr5-60773612-C-T,rs13162920,-1,C,T,60773612,70657,60647661,61040877,125951
5,ENSG00000150756.8,10249888,chr5-10289391-C-T,rs13168213,-1,C,T,10289391,39503,10053280,10446496,236111
5,ENSG00000123219.7,65563168,chr5-65542051-G-A,rs13178551,-1,G,A,65542051,21117,65366560,65759776,175491
5,ENSG00000145725.11,103120301,chr5-103043263-T-G,rs13187628,1,T,G,103043263,77038,102923693,103316909,119570
5,ENSG00000169230.5,177303799,chr5-177310719-A-G,rs13190036,1,A,G,177310719,6920,177107191,177500407,203528
5,ENSG00000185028.3,191495,chr5-57401-T-G,rs138150931,1,T,G,57401,134094,-5113,388103,62514
5,ENSG00000146094.9,177509826,chr5-177502129-C-T,rs1422268,-1,C,T,177502129,7697,177313218,177706434,188911
5,ENSG00000134987.7,111092348,chr5-111231900-C-T,rs1457115,1,C,T,111231900,139552,110895740,111288956,336160
5,ENSG00000129625.8,112922227,chr5-112921117-A-G,rs149190,-1,A,G,112921117,1110,112725619,113118835,195498
5,ENSG00000196743.4,151253185,chr5-151255868-A-G,rs152266,1,A,G,151255868,2683,151056577,151449793,199291
5,ENSG00000118985.10,95961851,chr5-95862649-C-T,rs154448,-1,C,T,95862649,99202,95765243,96158459,97406
5,ENSG00000145779.6,119356019,chr5-119261792-G-A,rs1553544,1,G,A,119261792,94227,119159411,119552627,102381
5,ENSG00000145779.6,119356019,chr5-119261792-G-T,rs1553544,1,G,T,119261792,94227,119159411,119552627,102381
5,ENSG00000072682.12,132227853,chr5-132191628-C-T,rs156033,-1,C,T,132191628,36225,132031245,132424461,160383
5,ENSG00000152422.10,83077547,chr5-83117014-A-G,rs1564211,1,A,G,83117014,39467,82880939,83274155,236075
5,ENSG00000113719.11,172834251,chr5-172829021-T-C,rs1564259,1,T,C,172829021,5230,172637643,173030859,191378
5,ENSG00000154153.9,16616997,chr5-16522016-C-T,rs163282,-1,C,T,16522016,94981,16420389,16813605,101627
5,ENSG00000134057.10,69167150,chr5-69113787-A-G,rs164392,1,A,G,69113787,53363,68970542,69363758,143245
5,ENSG00000083720.7,41870425,chr5-41849153-G-C,rs16871972,-1,G,C,41849153,21272,41673817,42067033,175336
5,ENSG00000083720.7,41870425,chr5-41849153-G-A,rs16871972,-1,G,A,41849153,21272,41673817,42067033,175336
5,ENSG00000164346.5,74767249,chr5-74673233-A-C,rs16872173,1,A,C,74673233,94016,74570641,74963857,102592
5,ENSG00000164347.11,74767117,chr5-74673233-A-C,rs16872173,-1,A,C,74673233,93884,74570509,74963725,102724
5,ENSG00000198780.7,74866387,chr5-74830539-A-C,rs16872305,-1,A,C,74830539,35848,74669779,75062995,160760
5,ENSG00000145703.10,76403285,chr5-76544214-T-C,rs16873476,1,T,C,76544214,140929,76206677,76599893,337537
5,ENSG00000133398.3,6378547,chr5-6415731-G-C,rs16877282,-1,G,C,6415731,37184,6181939,6575155,233792
5,ENSG00000133398.3,6378547,chr5-6415731-G-A,rs16877282,-1,G,A,6415731,37184,6181939,6575155,233792
5,ENSG00000164258.7,53560639,chr5-53426968-A-T,rs16881394,1,A,T,53426968,133671,53364031,53757247,62937
5,ENSG00000145632.9,58460086,chr5-58624221-C-T,rs16888306,-1,C,T,58624221,164135,58263478,58656694,360743
5,ENSG00000174695.5,83077394,chr5-83077176-G-C,rs16900155,-1,G,C,83077176,218,82880786,83274002,196390
5,ENSG00000074276.6,176549342,chr5-176579569-G-A,rs17078336,1,G,A,176579569,30227,176352734,176745950,226835
5,ENSG00000173221.9,95822726,chr5-95802242-T-G,rs17085096,-1,T,G,95802242,20484,95626118,96019334,176124
5,ENSG00000183775.4,144170873,chr5-144152083-A-T,rs17101592,1,A,T,144152083,18790,143974265,144367481,177818
5,ENSG00000172795.11,112976798,chr5-112845176-T-C,rs17135042,1,T,C,112845176,131622,112780190,113173406,64986
5,ENSG00000131446.10,180802806,chr5-180855933-T-C,rs17141222,-1,T,C,180855933,53127,180606198,180999414,249735
5,ENSG00000170606.8,133052013,chr5-132868305-A-G,rs17166297,1,A,G,132868305,183708,132855405,133248621,12900
5,ENSG00000120708.9,136028988,chr5-135914735-A-G,rs17169384,1,A,G,135914735,114253,135832380,136225596,82355
5,ENSG00000134058.6,69234886,chr5-69219666-A-G,rs17331590,1,A,G,69219666,15220,69038278,69431494,181388
5,ENSG00000168671.5,36066882,chr5-36064878-G-A,rs17342682,-1,G,A,36064878,2004,35870274,36263490,194604
5,ENSG00000151292.13,123512099,chr5-123344495-G-A,rs17472832,1,G,A,123344495,167604,123315491,123708707,29004
5,ENSG00000204956.4,141330514,chr5-141148432-C-T,rs17629011,1,C,T,141148432,182082,141133906,141527122,14526
5,ENSG00000113721.7,150155845,chr5-150150436-C-A,rs17708682,-1,C,A,150150436,5409,149959237,150352453,191199
5,ENSG00000113721.7,150155845,chr5-150150436-C-T,rs17708682,-1,C,T,150150436,5409,149959237,150352453,191199
5,ENSG00000131730.11,81233322,chr5-81075502-A-G,rs190409,1,A,G,81075502,157820,81036714,81429930,38788
5,ENSG00000164209.11,110739007,chr5-110608456-A-T,rs190924397,1,A,T,110608456,130551,110542399,110935615,66057
5,ENSG00000081189.9,88883184,chr5-88927603-G-A,rs190982,-1,G,A,88927603,44419,88686576,89079792,241027
5,ENSG00000164574.11,154190733,chr5-154243208-T-G,rs2122895,1,T,G,154243208,52475,153994125,154387341,249083
5,ENSG00000164172.13,53109757,chr5-52951403-G-A,rs2193968,-1,G,A,52951403,158354,52913149,53306365,38254
5,ENSG00000145757.11,95682991,chr5-95619898-C-A,rs2194051,-1,C,A,95619898,63093,95486383,95879599,133515
5,ENSG00000113108.13,140564598,chr5-140677950-G-A,rs2230361,-1,G,A,140677950,113352,140367990,140761206,309960
5,ENSG00000113645.8,168291645,chr5-168300174-C-T,rs2253028,1,C,T,168300174,8529,168095037,168488253,205137
5,ENSG00000081791.4,141923871,chr5-141936116-G-C,rs2270113,1,G,C,141936116,12245,141727263,142120479,208853
5,ENSG00000197603.7,37249376,chr5-37318272-T-C,rs2272601,-1,T,C,37318272,68896,37052768,37445984,265504
5,ENSG00000133706.12,146182650,chr5-146204060-A-G,rs2279895,-1,A,G,146204060,21410,145986042,146379258,218018
5,ENSG00000234511.3,170232985,chr5-170236423-C-T,rs2287738,1,C,T,170236423,3438,170036377,170429593,200046
5,ENSG00000113048.11,72320240,chr5-72436766-T-G,rs2338020,-1,T,G,72436766,116526,72123632,72516848,313134
5,ENSG00000234284.2,179023804,chr5-179150391-C-T,rs2411906,1,C,T,179150391,126587,178827196,179220412,323195
5,ENSG00000155868.7,157142865,chr5-157158243-T-C,rs246871,-1,T,C,157158243,15378,156946257,157339473,211986
5,ENSG00000133835.9,119452497,chr5-119564080-T-A,rs246968,1,T,A,119564080,111583,119255889,119649105,308191
5,ENSG00000168724.10,34929559,chr5-34957339-T-C,rs251636,1,T,C,34957339,27780,34732951,35126167,224388
5,ENSG00000113273.11,78985310,chr5-78839378-C-T,rs25413,-1,C,T,78839378,145932,78788702,79181918,50676
5,ENSG00000153015.9,64768930,chr5-64676347-T-C,rs2548251,1,T,C,64676347,92583,64572322,64965538,104025
5,ENSG00000185261.8,94618604,chr5-94794800-A-G,rs255345,-1,A,G,94794800,176196,94421996,94815212,372804
5,ENSG00000170458.9,140633175,chr5-140757420-C-T,rs2563265,-1,C,T,140757420,124245,140436567,140829783,320853
5,ENSG00000243056.1,140547662,chr5-140631730-C-A,rs2563298,1,C,A,140631730,84068,140351054,140744270,280676
5,ENSG00000150753.6,10250280,chr5-10242050-T-C,rs2578628,1,T,C,10242050,8230,10053672,10446888,188378
5,ENSG00000112977.11,10761234,chr5-10713283-G-A,rs267985,-1,G,A,10713283,47951,10564626,10957842,148657
5,ENSG00000112902.7,9546075,chr5-9500970-G-A,rs268502,-1,G,A,9500970,45105,9349467,9742683,151503
5,ENSG00000113441.11,96936080,chr5-96762440-G-A,rs27035,1,G,A,96762440,173640,96739472,97132688,22968
5,ENSG00000113441.11,96936080,chr5-96762440-G-T,rs27035,1,G,T,96762440,173640,96739472,97132688,22968
5,ENSG00000153395.5,1523960,chr5-1479563-G-C,rs27059,-1,G,C,1479563,44397,1327352,1720568,152211
5,ENSG00000127022.9,179698967,chr5-179801623-G-A,rs272440,1,G,A,179801623,102656,179502359,179895575,299264
5,ENSG00000131844.11,71587340,chr5-71677464-G-C,rs281131,1,G,C,71677464,90124,71390732,71783948,286732
5,ENSG00000146066.2,176388751,chr5-176413242-G-T,rs28429418,1,G,T,176413242,24491,176192143,176585359,221099
5,ENSG00000164609.5,160419081,chr5-160423365-C-T,rs2910201,-1,C,T,160423365,4284,160222473,160615689,200892
5,ENSG00000151388.6,33891990,chr5-33848640-A-G,rs2910633,-1,A,G,33848640,43350,33695382,34088598,153258
5,ENSG00000249915.2,271646,chr5-190524-C-T,rs29681,1,C,T,190524,81122,75038,468254,115486
5,ENSG00000169570.4,118988547,chr5-119060533-C-T,rs299216,-1,C,T,119060533,71986,118791939,119185155,268594
5,ENSG00000164171.5,52989352,chr5-53072126-G-T,rs3212581,1,G,T,53072126,82774,52792744,53185960,279382
5,ENSG00000228716.2,80654983,chr5-80764197-G-A,rs33013,-1,G,A,80764197,109214,80458375,80851591,305822
5,ENSG00000170584.5,163460102,chr5-163409433-C-T,rs34791046,-1,C,T,163409433,50669,163263494,163656710,145939
5,ENSG00000113532.7,100903282,chr5-100852912-G-T,rs3776165,-1,G,T,100852912,50370,100706674,101099890,146238
5,ENSG00000177556.7,151758631,chr5-151775182-T-C,rs3812003,-1,T,C,151775182,16551,151562023,151955239,213159
5,ENSG00000171368.10,693352,chr5-601532-G-A,rs3828570,-1,G,A,601532,91820,496744,889960,104788
5,ENSG00000038382.12,14143342,chr5-14068322-G-A,rs3849079,1,G,A,14068322,75020,13946734,14339950,121588
5,ENSG00000198624.7,151224092,chr5-151241736-C-G,rs3857424,-1,C,G,151241736,17644,151027484,151420700,214252
5,ENSG00000181751.5,103258763,chr5-103319560-G-A,rs402232,1,G,A,103319560,60797,103062155,103455371,257405
5,ENSG00000164151.7,5422677,chr5-5316947-C-T,rs4074589,1,C,T,5316947,105730,5226069,5619285,90878
5,ENSG00000055163.14,157266123,chr5-157279443-G-C,rs41345045,1,G,C,157279443,13320,157069515,157462731,209928
5,ENSG00000153044.5,69189583,chr5-69231530-A-C,rs41392244,1,A,C,69231530,41947,68992975,69386191,238555
5,ENSG00000197043.7,151157779,chr5-151169369-T-C,rs420460,-1,T,C,151169369,11590,150961171,151354387,208198
5,ENSG00000170482.11,139383297,chr5-139378470-G-A,rs4257763,-1,G,A,139378470,4827,139186689,139579905,191781
5,ENSG00000183323.8,69332801,chr5-69305204-C-T,rs4288083,-1,C,T,69305204,27597,69136193,69529409,169011
5,ENSG00000113595.10,65624333,chr5-65659068-T-C,rs42961,-1,T,C,65659068,34735,65427725,65820941,231343
5,ENSG00000152620.8,36241925,chr5-36420813-T-A,rs4460161,-1,T,A,36420813,178888,36045317,36438533,375496
5,ENSG00000069020.12,66596393,chr5-66567907-G-A,rs4527553,1,G,A,66567907,28486,66399785,66793001,168122
5,ENSG00000113504.13,1112063,chr5-1113867-T-C,rs4576192,-1,T,C,1113867,1804,915455,1308671,198412
5,ENSG00000198055.6,177426676,chr5-177450109-C-T,rs461264,1,C,T,177450109,23433,177230068,177623284,220041
5,ENSG00000174136.7,98773663,chr5-98651703-G-A,rs469731,1,G,A,98651703,121960,98577055,98970271,74648
5,ENSG00000082074.10,39219563,chr5-39342206-C-T,rs476569,-1,C,T,39342206,122643,39022955,39416171,319251
5,ENSG00000064651.9,128083766,chr5-128001394-A-G,rs4835937,1,A,G,128001394,82372,127887158,128280374,114236
5,ENSG00000170091.6,174045706,chr5-174197532-C-A,rs4867742,1,C,A,174197532,151826,173849098,174242314,348434
5,ENSG00000082213.12,31532301,chr5-31452892-C-T,rs491989,1,C,T,31452892,79409,31335693,31728909,117199
5,ENSG00000092421.12,116574823,chr5-116770530-A-G,rs4920935,-1,A,G,116770530,195707,116378215,116771431,392315
5,ENSG00000129595.7,112419277,chr5-112367782-G-A,rs4958045,-1,G,A,112367782,51495,112222669,112615885,145113
5,ENSG00000142319.14,1445440,chr5-1433286-G-A,rs4975646,-1,G,A,1433286,12154,1248832,1642048,184454
5,ENSG00000169252.4,148826611,chr5-148834583-A-G,rs57804121,1,A,G,148834583,7972,148630003,149023219,204580
5,ENSG00000177453.3,43192225,chr5-43275293-A-G,rs58426758,1,A,G,43275293,83068,42995617,43388833,279676
5,ENSG00000145777.10,111071713,chr5-111052064-T-G,rs58743367,1,T,G,111052064,19649,110875105,111268321,176959
5,ENSG00000113318.8,80654652,chr5-80655213-A-G,rs6151599,1,A,G,80655213,561,80458044,80851260,197169
5,ENSG00000242419.1,141485030,chr5-141654303-T-G,rs61749636,1,T,G,141654303,169273,141288422,141681638,365881
5,ENSG00000062194.10,57174059,chr5-57061264-C-T,rs62356644,1,C,T,57061264,112795,56977451,57370667,83813
5,ENSG00000178015.4,95620087,chr5-95616432-T-C,rs6556877,1,T,C,95616432,3655,95423479,95816695,192953
5,ENSG00000146005.3,139795808,chr5-139665418-T-C,rs6580190,1,T,C,139665418,130390,139599200,139992416,66218
5,ENSG00000161055.3,180591499,chr5-180556602-T-C,rs6859296,-1,T,C,180556602,34897,180394891,180788107,161711
5,ENSG00000171522.5,40679915,chr5-40597516-G-A,rs6869535,1,G,A,40597516,82399,40483307,40876523,114209
5,ENSG00000250722.1,42811892,chr5-42698979-G-A,rs6875431,-1,G,A,42698979,112913,42615284,43008500,83695
5,ENSG00000176783.9,179550554,chr5-179625184-C-G,rs6886107,1,C,G,179625184,74630,179353946,179747162,271238
5,ENSG00000113734.13,173144531,chr5-172983655-G-A,rs6895696,1,G,A,172983655,160876,172947923,173341139,35732
5,ENSG00000145569.4,14581792,chr5-14764333-C-T,rs706292,1,C,T,14764333,182541,14385184,14778400,379149
5,ENSG00000164404.4,132866469,chr5-132816106-G-A,rs72799442,-1,G,A,132816106,50363,132669861,133063077,146245
5,ENSG00000158402.13,138331804,chr5-138428660-C-T,rs72803894,-1,C,T,138428660,96856,138135196,138528412,293464
5,ENSG00000158497.2,143812161,chr5-143692407-C-A,rs72808740,1,C,A,143692407,119754,143615553,144008769,76854
5,ENSG00000158497.2,143812161,chr5-143692407-C-T,rs72808740,1,C,T,143692407,119754,143615553,144008769,76854
5,ENSG00000087206.11,177006779,chr5-177079956-G-T,rs72813142,-1,G,T,177079956,73177,176810171,177203387,269785
5,ENSG00000087206.11,177006779,chr5-177079956-G-C,rs72813142,-1,G,C,177079956,73177,176810171,177203387,269785
5,ENSG00000028310.12,892801,chr5-1065284-C-T,rs737154,-1,C,T,1065284,172483,696193,1089409,369091
5,ENSG00000151422.8,108747897,chr5-108617520-A-G,rs7449365,1,A,G,108617520,130377,108551289,108944505,66231
5,ENSG00000156427.7,171419647,chr5-171461107-T-A,rs74588350,1,T,A,171461107,41460,171223039,171616255,238068
5,ENSG00000156427.7,171419647,chr5-171461107-T-C,rs74588350,1,T,C,171461107,41460,171223039,171616255,238068
5,ENSG00000164237.4,10307902,chr5-10308110-A-C,rs74655025,-1,A,C,10308110,208,10111294,10504510,196816
5,ENSG00000197208.5,132294394,chr5-132179971-C-A,rs754129,1,C,A,132179971,114423,132097786,132491002,82185
5,ENSG00000037280.10,180649600,chr5-180824882-G-A,rs75858778,-1,G,A,180824882,175282,180452992,180846208,371890
5,ENSG00000113758.9,177473634,chr5-177422097-T-C,rs7711038,-1,T,C,177422097,51537,177277026,177670242,145071
5,ENSG00000157107.8,72956041,chr5-72956648-A-G,rs7713398,1,A,G,72956648,607,72759433,73152649,197215
5,ENSG00000113580.9,143403686,chr5-143218355-G-T,rs7720812,-1,G,T,143218355,185331,143207078,143600294,11277
5,ENSG00000165810.11,181040266,chr5-181034906-C-T,rs7725222,1,C,T,181034906,5360,180843658,181236874,191248
5,ENSG00000113638.8,40755961,chr5-40827205-T-C,rs7725810,-1,T,C,40827205,71244,40559353,40952569,267852
5,ENSG00000120129.4,172771195,chr5-172601218-G-T,rs7730543,-1,G,T,172601218,169977,172574587,172967803,26631
5,ENSG00000120129.4,172771195,chr5-172601218-G-A,rs7730543,-1,G,A,172601218,169977,172574587,172967803,26631
5,ENSG00000164220.5,76623403,chr5-76572052-T-C,rs77373975,-1,T,C,76572052,51351,76426795,76820011,145257
5,ENSG00000131437.9,132737546,chr5-132897875-T-C,rs77554816,-1,T,C,132897875,160329,132540938,132934154,356937
5,ENSG00000134061.4,67196799,chr5-67204294-C-T,rs77760534,-1,C,T,67204294,7495,67000191,67393407,204103
5,ENSG00000019582.10,150412910,chr5-150414087-G-A,rs79078220,-1,G,A,150414087,1177,150216302,150609518,197785
5,ENSG00000145864.8,161546725,chr5-161431824-G-A,rs79091883,-1,G,A,161431824,114901,161350117,161743333,81707
5,ENSG00000153404.9,92168,chr5-185303-C-T,rs79713827,1,C,T,185303,93135,-104440,288776,289743
5,ENSG00000078795.12,137889457,chr5-137844235-C-T,rs847821,1,C,T,137844235,45222,137692849,138086065,151386
5,ENSG00000039600.6,157652438,chr5-157612994-T-G,rs868176,-1,T,G,157612994,39444,157455830,157849046,157164
5,ENSG00000145817.10,144170659,chr5-144208427-G-A,rs879717,-1,G,A,144208427,37768,143974051,144367267,234376
5,ENSG00000066230.6,524449,chr5-476854-C-T,rs890978,-1,C,T,476854,47595,327841,721057,149013
5,ENSG00000068796.11,62306206,chr5-62137498-G-T,rs9291749,1,G,T,62137498,168708,62109598,62502814,27900
5,ENSG00000151881.10,43483865,chr5-43296784-T-G,rs9292870,-1,T,G,43296784,187081,43287257,43680473,9527
5,ENSG00000175309.10,178232802,chr5-178339242-A-T,rs9329143,-1,A,T,178339242,106440,178036194,178429410,303048
5,ENSG00000155542.6,56909596,chr5-56745122-C-A,rs961848,1,C,A,56745122,164474,56712988,57106204,32134
5,ENSG00000164244.14,127517640,chr5-127486255-A-G,rs984024,1,A,G,127486255,31385,127321032,127714248,165223
5,ENSG00000164587.7,150449739,chr5-150631825-T-C,rs10039597,-1,T,C,150631825,182086,150253131,150646347,378694
5,ENSG00000145888.6,151924851,chr5-151976684-G-A,rs10042480,-1,G,A,151976684,51833,151728243,152121459,248441
5,ENSG00000153395.5,1523960,chr5-1490894-A-G,rs10058172,-1,A,G,1490894,33066,1327352,1720568,163542
5,ENSG00000171720.4,141636849,chr5-141768731-G-A,rs10062181,-1,G,A,141768731,131882,141440241,141833457,328490
5,ENSG00000164220.5,76623403,chr5-76505811-T-G,rs10064273,-1,T,G,76505811,117592,76426795,76820011,79016
5,ENSG00000092421.12,116574823,chr5-116378555-G-A,rs10066891,-1,G,A,116378555,196268,116378215,116771431,340
5,ENSG00000213949.3,52787916,chr5-52907314-A-C,rs10076207,1,A,C,52907314,119398,52591308,52984524,316006
5,ENSG00000113645.8,168291645,chr5-168367771-T-C,rs1030182,1,T,C,168367771,76126,168095037,168488253,272734
5,ENSG00000132842.8,78294698,chr5-78177595-T-C,rs10428660,-1,T,C,78177595,117103,78098090,78491306,79505
5,ENSG00000113456.13,34915504,chr5-34826684-G-A,rs10461948,-1,G,A,34826684,88820,34718896,35112112,107788
5,ENSG00000234284.2,179023804,chr5-179044033-A-G,rs10464078,1,A,G,179044033,20229,178827196,179220412,216837
5,ENSG00000123219.7,65563168,chr5-65450800-A-G,rs10471661,-1,A,G,65450800,112368,65366560,65759776,84240
5,ENSG00000182230.7,176084963,chr5-175919787-G-A,rs10476176,1,G,A,175919787,165176,175888355,176281571,31432
5,ENSG00000170571.6,50441288,chr5-50566165-A-G,rs10940390,-1,A,G,50566165,124877,50244680,50637896,321485
5,ENSG00000164347.11,74767117,chr5-74888319-T-G,rs10942722,-1,T,G,74888319,121202,74570509,74963725,317810
5,ENSG00000251201.4,115626161,chr5-115702399-A-G,rs112010721,-1,A,G,115702399,76238,115429553,115822769,272846
5,ENSG00000066583.6,129094749,chr5-128951488-T-C,rs11241981,1,T,C,128951488,143261,128898141,129291357,53347
5,ENSG00000228672.2,139395104,chr5-139431876-A-C,rs11242467,-1,A,C,139431876,36772,139198496,139591712,233380
5,ENSG00000176783.9,179550554,chr5-179677940-A-G,rs11249654,1,A,G,179677940,127386,179353946,179747162,323994
5,ENSG00000039560.9,34656328,chr5-34708148-A-G,rs114417817,1,A,G,34708148,51820,34459720,34852936,248428
5,ENSG00000171604.7,139648349,chr5-139632529-C-T,rs114613137,1,C,T,139632529,15820,139451741,139844957,180788
5,ENSG00000135074.11,157575775,chr5-157494947-A-G,rs11466782,-1,A,G,157494947,80828,157379167,157772383,115780
5,ENSG00000145685.8,78648772,chr5-78646884-T-C,rs115534748,-1,T,C,78646884,1888,78452164,78845380,194720
5,ENSG00000156453.9,141878410,chr5-141959001-C-G,rs11744911,-1,C,G,141959001,80591,141681802,142075018,277199
5,ENSG00000214944.5,73626196,chr5-73800393-A-C,rs11745557,1,A,C,73800393,174197,73429588,73822804,370805
5,ENSG00000151883.10,50666637,chr5-50794038-A-G,rs11747930,1,A,G,50794038,127401,50470029,50863245,324009
5,ENSG00000253537.1,141382742,chr5-141550595-C-T,rs11748064,1,C,T,141550595,167853,141186134,141579350,364461
5,ENSG00000164576.6,154445997,chr5-154597869-G-C,rs11749576,1,G,C,154597869,151872,154249389,154642605,348480
5,ENSG00000155542.6,56909596,chr5-56926293-G-A,rs11957276,1,G,A,56926293,16697,56712988,57106204,213305
5,ENSG00000171992.8,150640660,chr5-150558177-G-A,rs11994,1,G,A,150558177,82483,150444052,150837268,114125
5,ENSG00000169567.7,131165256,chr5-131082441-G-A,rs12153520,-1,G,A,131082441,82815,130968648,131361864,113793
5,ENSG00000082213.12,31532301,chr5-31484788-C-T,rs12173038,1,C,T,31484788,47513,31335693,31728909,149095
5,ENSG00000131711.10,72107475,chr5-71949983-T-C,rs1217744,1,T,C,71949983,157492,71910867,72304083,39116
5,ENSG00000188573.6,168529305,chr5-168434841-G-A,rs12516671,1,G,A,168434841,94464,168332697,168725913,102144
5,ENSG00000113649.7,146447333,chr5-146407696-T-C,rs12517249,1,T,C,146407696,39637,146250725,146643941,156971
5,ENSG00000164284.10,149345499,chr5-149448016-T-C,rs12655723,1,T,C,149448016,102517,149148891,149542107,299125
5,ENSG00000169230.5,177303799,chr5-177273884-G-A,rs12660023,1,G,A,177273884,29915,177107191,177500407,166693
5,ENSG00000082515.12,154941073,chr5-155126705-C-T,rs13158580,1,C,T,155126705,185632,154744465,155137681,382240
5,ENSG00000113615.8,134648785,chr5-134570139-C-T,rs13178130,1,C,T,134570139,78646,134452177,134845393,117962
5,ENSG00000164171.5,52989352,chr5-52879893-T-C,rs1351140,1,T,C,52879893,109459,52792744,53185960,87149
5,ENSG00000146083.7,176537402,chr5-176633845-G-A,rs1352303,-1,G,A,176633845,96443,176340794,176734010,293051
5,ENSG00000152495.6,111224384,chr5-111131801-C-T,rs1438673,1,C,T,111131801,92583,111027776,111420992,104025
5,ENSG00000134058.6,69234886,chr5-69049821-G-A,rs149292,1,G,A,69049821,185065,69038278,69431494,11543
5,ENSG00000145757.11,95682991,chr5-95701399-C-A,rs153917,-1,C,A,95701399,18408,95486383,95879599,215016
5,ENSG00000049192.9,65481920,chr5-65670073-T-C,rs1549192,-1,T,C,65670073,188153,65285312,65678528,384761
5,ENSG00000242110.3,34008050,chr5-33988430-C-T,rs15612,-1,C,T,33988430,19620,33811442,34204658,176988
5,ENSG00000154162.8,22853344,chr5-22794548-A-G,rs1561836,-1,A,G,22794548,58796,22656736,23049952,137812
5,ENSG00000131435.8,132257696,chr5-132225629-G-C,rs157578,1,G,C,132225629,32067,132061088,132454304,164541
5,ENSG00000152932.6,58583075,chr5-58609647-G-T,rs167132,1,G,T,58609647,26572,58386467,58779683,223180
5,ENSG00000152422.10,83077547,chr5-83144380-T-C,rs16876476,1,T,C,83144380,66833,82880939,83274155,263441
5,ENSG00000069020.12,66596393,chr5-66613760-G-T,rs16895311,1,G,T,66613760,17367,66399785,66793001,213975
5,ENSG00000069020.12,66596393,chr5-66613760-G-C,rs16895311,1,G,C,66613760,17367,66399785,66793001,213975
5,ENSG00000164187.5,36151887,chr5-36308995-A-G,rs16902947,-1,A,G,36308995,157108,35955279,36348495,353716
5,ENSG00000164330.11,159099916,chr5-159083802-T-C,rs17056549,-1,T,C,159083802,16114,158903308,159296524,180494
5,ENSG00000113302.4,159330487,chr5-159397971-T-C,rs17056737,-1,T,C,159397971,67484,159133879,159527095,264092
5,ENSG00000262576.1,141355021,chr5-141390940-A-G,rs17097254,1,A,G,141390940,35919,141158413,141551629,232527
5,ENSG00000064692.12,122312237,chr5-122167247-C-T,rs17148904,1,C,T,122167247,144990,122115629,122508845,51618
5,ENSG00000237190.3,134411881,chr5-134302343-C-A,rs17165388,-1,C,A,134302343,109538,134215273,134608489,87070
5,ENSG00000168938.5,123036725,chr5-123196696-A-G,rs17470253,-1,A,G,123196696,159971,122840117,123233333,356579
5,ENSG00000155324.4,126423409,chr5-126282239-C-T,rs17527123,1,C,T,126282239,141170,126226801,126620017,55438
5,ENSG00000164574.11,154190733,chr5-154146491-G-A,rs17536714,1,G,A,154146491,44242,153994125,154387341,152366
5,ENSG00000134987.7,111092348,chr5-111120565-C-G,rs17624563,1,C,G,111120565,28217,110895740,111288956,224825
5,ENSG00000177839.4,141187161,chr5-141148432-C-T,rs17629011,1,C,T,141148432,38729,140990553,141383769,157879
5,ENSG00000145703.10,76403285,chr5-76390160-T-C,rs17651979,1,T,C,76390160,13125,76206677,76599893,183483
5,ENSG00000164292.7,95731336,chr5-95647825-C-T,rs17790731,1,C,T,95647825,83511,95534728,95927944,113097
5,ENSG00000124275.10,7869148,chr5-7924801-T-C,rs179171,1,T,C,7924801,55653,7672540,8065756,252261
5,ENSG00000131507.7,142108779,chr5-142233903-A-G,rs1860991,1,A,G,142233903,125124,141912171,142305387,321732
5,ENSG00000124279.7,7869031,chr5-7826192-T-G,rs191261,-1,T,G,7826192,42839,7672423,8065639,153769
5,ENSG00000164252.8,77030404,chr5-76938657-C-A,rs2055628,1,C,A,76938657,91747,76833796,77227012,104861
5,ENSG00000069011.10,135034228,chr5-135219930-A-C,rs2059779,-1,A,C,135219930,185702,134837620,135230836,382310
5,ENSG00000069011.10,135034228,chr5-135219930-A-G,rs2059779,-1,A,G,135219930,185702,134837620,135230836,382310
5,ENSG00000172795.11,112976798,chr5-113022796-G-A,rs2112452,1,G,A,113022796,45998,112780190,113173406,242606
5,ENSG00000120137.6,168579368,chr5-168581738-C-T,rs2112562,-1,C,T,168581738,2370,168382760,168775976,198978
5,ENSG00000113716.8,150000739,chr5-150063735-C-T,rs216140,1,C,T,150063735,62996,149804131,150197347,259604
5,ENSG00000181104.6,76716126,chr5-76734869-A-C,rs2227801,1,A,C,76734869,18743,76519518,76912734,215351
5,ENSG00000178913.5,141320784,chr5-141319490-G-C,rs2230133,-1,G,C,141319490,1294,141124176,141517392,195314
5,ENSG00000197860.5,65722109,chr5-65787321-T-C,rs2248915,-1,T,C,65787321,65212,65525501,65918717,261820
5,ENSG00000186468.8,82278354,chr5-82357662-C-T,rs224912,-1,C,T,82357662,79308,82081746,82474962,275916
5,ENSG00000081059.14,134114681,chr5-134227627-A-G,rs2292283,1,A,G,134227627,112946,133918073,134311289,309554
5,ENSG00000176049.10,147782728,chr5-147775996-C-G,rs2436408,-1,C,G,147775996,6732,147586120,147979336,189876
5,ENSG00000133835.9,119452497,chr5-119424720-T-G,rs2451818,1,T,G,119424720,27777,119255889,119649105,168831
5,ENSG00000131730.11,81233322,chr5-81148372-C-T,rs248992,1,C,T,81148372,84950,81036714,81429930,111658
5,ENSG00000113318.8,80654652,chr5-80830334-A-G,rs249633,1,A,G,80830334,175682,80458044,80851260,372290
5,ENSG00000255833.1,135452351,chr5-135473290-A-T,rs251556,-1,A,T,135473290,20939,135255743,135648959,217547
5,ENSG00000087206.11,177006779,chr5-177065556-G-A,rs251848,-1,G,A,177065556,58777,176810171,177203387,255385
5,ENSG00000027847.8,177600132,chr5-177542793-G-A,rs2545802,1,G,A,177542793,57339,177403524,177796740,139269
5,ENSG00000135083.10,160312564,chr5-160170281-A-T,rs2546363,-1,A,T,160170281,142283,160115956,160509172,54325
5,ENSG00000151388.6,33891990,chr5-33842163-A-G,rs2548020,-1,A,G,33842163,49827,33695382,34088598,146781
5,ENSG00000083312.11,72816661,chr5-72961353-G-T,rs2548331,1,G,T,72961353,144692,72620053,73013269,341300
5,ENSG00000174705.7,172454525,chr5-172360891-G-C,rs2569227,-1,G,C,172360891,93634,172257917,172651133,102974
5,ENSG00000172901.13,115962475,chr5-115842698-C-T,rs26538,1,C,T,115842698,119777,115765867,116159083,76831
5,ENSG00000072682.12,132227853,chr5-132313493-A-G,rs270607,-1,A,G,132313493,85640,132031245,132424461,282248
5,ENSG00000146054.13,181205196,chr5-181206646-A-C,rs2770950,-1,A,C,181206646,1450,181008588,181401804,198058
5,ENSG00000083720.7,41870425,chr5-41902609-G-A,rs277411,-1,G,A,41902609,32184,41673817,42067033,228792
5,ENSG00000164307.7,96807945,chr5-96757286-A-G,rs28081,-1,A,G,96757286,50659,96611337,97004553,145949
5,ENSG00000048162.14,176388598,chr5-176413242-G-T,rs28429418,-1,G,T,176413242,24644,176191990,176585206,221252
5,ENSG00000164308.12,96876500,chr5-96867651-T-G,rs2911134,1,T,G,96867651,8849,96679892,97073108,187759
5,ENSG00000164188.4,36301902,chr5-36487185-G-A,rs2937543,-1,G,A,36487185,185283,36105294,36498510,381891
5,ENSG00000164188.4,36301902,chr5-36487185-G-C,rs2937543,-1,G,C,36487185,185283,36105294,36498510,381891
5,ENSG00000175414.6,176365487,chr5-176548393-A-G,rs2963688,1,A,G,176548393,182906,176168879,176562095,379514
5,ENSG00000112977.11,10761234,chr5-10732758-G-A,rs2964792,-1,G,A,10732758,28476,10564626,10957842,168132
5,ENSG00000250722.1,42811892,chr5-42820023-A-G,rs2972756,-1,A,G,42820023,8131,42615284,43008500,204739
5,ENSG00000164615.3,134738548,chr5-134541987-G-A,rs329302,1,G,A,134541987,196561,134541940,134935156,47
5,ENSG00000038382.12,14143342,chr5-13979288-A-G,rs339428,1,A,G,13979288,164054,13946734,14339950,32554
5,ENSG00000244234.1,178187371,chr5-178381202-T-C,rs34176122,-1,T,C,178381202,193831,177990763,178383979,390439
5,ENSG00000189045.7,75611453,chr5-75638388-T-G,rs34342,1,T,G,75638388,26935,75414845,75808061,223543
5,ENSG00000168246.5,172283764,chr5-172208492-G-A,rs34884555,-1,G,A,172208492,75272,172087156,172480372,121336
5,ENSG00000123213.16,65722205,chr5-65777036-C-T,rs34977,1,C,T,65777036,54831,65525597,65918813,251439
5,ENSG00000112992.10,43603180,chr5-43612944-A-G,rs35201656,1,A,G,43612944,9764,43406572,43799788,206372
5,ENSG00000079215.8,36606606,chr5-36681419-T-C,rs3733812,1,T,C,36681419,74813,36409998,36803214,271421
5,ENSG00000168724.10,34929559,chr5-34948427-T-C,rs37440,1,T,C,34948427,18868,34732951,35126167,215476
5,ENSG00000164211.8,111512535,chr5-111367789-A-G,rs3756612,-1,A,G,111367789,144746,111315927,111709143,51862
5,ENSG00000164362.14,1295068,chr5-1393229-C-G,rs3797200,-1,C,G,1393229,98161,1098460,1491676,294769
5,ENSG00000164362.14,1295068,chr5-1393229-C-T,rs3797200,-1,C,T,1393229,98161,1098460,1491676,294769
5,ENSG00000174136.7,98773663,chr5-98741946-C-G,rs3849790,1,C,G,98741946,31717,98577055,98970271,164891
5,ENSG00000153140.4,90409756,chr5-90356539-A-G,rs3952709,-1,A,G,90356539,53217,90213148,90606364,143391
5,ENSG00000145715.9,87267883,chr5-87165270-A-G,rs40466,1,A,G,87165270,102613,87071275,87464491,93995
5,ENSG00000173221.9,95822726,chr5-95780255-C-T,rs41276257,-1,C,T,95780255,42471,95626118,96019334,154137
5,ENSG00000113013.7,138575401,chr5-138575524-G-C,rs41294550,-1,G,C,138575524,123,138378793,138772009,196731
5,ENSG00000113575.5,134226073,chr5-134201367-A-C,rs41423646,-1,A,C,134201367,24706,134029465,134422681,171902
5,ENSG00000145911.5,178113532,chr5-178066866-A-G,rs4246823,1,A,G,178066866,46666,177916924,178310140,149942
5,ENSG00000119048.3,134371569,chr5-134450946-C-G,rs4326194,1,C,G,134450946,79377,134174961,134568177,275985
5,ENSG00000064652.6,122845613,chr5-123022018-G-A,rs448442,1,G,A,123022018,176405,122649005,123042221,373013
5,ENSG00000113494.12,35230487,chr5-35391745-C-T,rs452335,-1,C,T,35391745,161258,35033879,35427095,357866
5,ENSG00000085231.9,69369520,chr5-69479238-C-T,rs4602576,-1,C,T,69479238,109718,69172912,69566128,306326
5,ENSG00000080709.9,114362070,chr5-114255620-C-T,rs4610451,1,C,T,114255620,106450,114165462,114558678,90158
5,ENSG00000164236.6,10564070,chr5-10670928-A-G,rs4702718,1,A,G,10670928,106858,10367462,10760678,303466
5,ENSG00000164253.8,77492316,chr5-77433889-G-A,rs4704421,-1,G,A,77433889,58427,77295708,77688924,138181
5,ENSG00000172548.10,157460213,chr5-157463889-C-G,rs4704864,1,C,G,157463889,3676,157263605,157656821,200284
5,ENSG00000158985.9,131264053,chr5-131200351-C-A,rs4706009,1,C,A,131200351,63702,131067445,131460661,132906
5,ENSG00000158985.9,131264053,chr5-131200351-C-T,rs4706009,1,C,T,131200351,63702,131067445,131460661,132906
5,ENSG00000152942.14,69369818,chr5-69356714-T-C,rs4976162,1,T,C,69356714,13104,69173210,69566426,183504
5,ENSG00000028310.12,892801,chr5-1083419-T-C,rs4999131,-1,T,C,1083419,190618,696193,1089409,387226
5,ENSG00000113240.7,178627050,chr5-178595625-A-G,rs530542,-1,A,G,178595625,31425,178430442,178823658,165183
5,ENSG00000152409.7,79236131,chr5-79144349-T-C,rs55754450,1,T,C,79144349,91782,79039523,79432739,104826
5,ENSG00000171540.6,77638713,chr5-77515433-G-A,rs55921077,-1,G,A,77515433,123280,77442105,77835321,73328
5,ENSG00000113504.13,1112063,chr5-1097937-C-T,rs59081716,-1,C,T,1097937,14126,915455,1308671,182482
5,ENSG00000113504.13,1112063,chr5-1097937-C-G,rs59081716,-1,C,G,1097937,14126,915455,1308671,182482
5,ENSG00000145882.6,149358046,chr5-149381487-C-T,rs61433829,1,C,T,149381487,23441,149161438,149554654,220049
5,ENSG00000170606.8,133052013,chr5-133073275-G-A,rs61755724,1,G,A,133073275,21262,132855405,133248621,217870
5,ENSG00000145592.9,40835222,chr5-40858140-G-A,rs62357607,-1,G,A,40858140,22918,40638614,41031830,219526
5,ENSG00000253305.1,141408021,chr5-141372129-C-A,rs62620756,1,C,A,141372129,35892,141211413,141604629,160716
5,ENSG00000145782.8,115841565,chr5-115955096-T-C,rs6594913,-1,T,C,115955096,113531,115644957,116038173,310139
5,ENSG00000196670.8,180861276,chr5-180866505-C-A,rs6601146,-1,C,A,180866505,5229,180664668,181057884,201837
5,ENSG00000186314.7,145835342,chr5-145832582-C-T,rs681591,-1,C,T,145832582,2760,145638734,146031950,193848
5,ENSG00000072571.13,163460632,chr5-163563850-T-C,rs6861528,1,T,C,163563850,103218,163264024,163657240,299826
5,ENSG00000153113.17,96662376,chr5-96646810-A-G,rs6862521,1,A,G,96646810,15566,96465768,96858984,181042
5,ENSG00000062194.10,57174059,chr5-57216216-A-G,rs6864611,1,A,G,57216216,42157,56977451,57370667,238765
5,ENSG00000113460.8,34915711,chr5-34751918-A-G,rs6866210,1,A,G,34751918,163793,34719103,35112319,32815
5,ENSG00000066230.6,524449,chr5-495262-C-T,rs6868535,-1,C,T,495262,29187,327841,721057,167421
5,ENSG00000175471.13,95285094,chr5-95134024-C-T,rs6868622,-1,C,T,95134024,151070,95088486,95481702,45538
5,ENSG00000164509.9,55851357,chr5-55733768-G-A,rs6873811,1,G,A,55733768,117589,55654749,56047965,79019
5,ENSG00000073578.10,218320,chr5-139425-T-C,rs6880135,1,T,C,139425,78895,21712,414928,117713
5,ENSG00000113368.6,126777136,chr5-126601498-G-A,rs6882015,1,G,A,126601498,175638,126580528,126973744,20970
5,ENSG00000132570.10,134905131,chr5-134820449-G-A,rs6883535,1,G,A,134820449,84682,134708523,135101739,111926
5,ENSG00000171617.8,74640728,chr5-74557427-T-C,rs6890969,-1,T,C,74557427,83301,74444120,74837336,113307
5,ENSG00000067248.5,55307694,chr5-55319079-C-T,rs6898074,-1,C,T,55319079,11385,55111086,55504302,207993
5,ENSG00000145545.7,6633440,chr5-6627299-T-C,rs72724261,1,T,C,6627299,6141,6436832,6830048,190467
5,ENSG00000185305.5,54310573,chr5-54135327-T-C,rs72752124,-1,T,C,54135327,175246,54113965,54507181,21362
5,ENSG00000112874.5,103562789,chr5-103562198-T-C,rs72782538,-1,T,C,103562198,591,103366181,103759397,196017
5,ENSG00000112874.5,103562789,chr5-103562198-T-G,rs72782538,-1,T,G,103562198,591,103366181,103759397,196017
5,ENSG00000198624.7,151224092,chr5-151239432-C-T,rs72794132,-1,C,T,151239432,15340,151027484,151420700,211948
5,ENSG00000205302.2,122775080,chr5-122860560-A-G,rs72796845,1,A,G,122860560,85480,122578472,122971688,282088
5,ENSG00000086570.8,151591331,chr5-151559740-C-T,rs72798369,-1,C,T,151559740,31591,151394723,151787939,165017
5,ENSG00000184840.7,177592203,chr5-177639664-C-T,rs72815181,1,C,T,177639664,47461,177395595,177788811,244069
5,ENSG00000184840.7,177592203,chr5-177639664-C-A,rs72815181,1,C,A,177639664,47461,177395595,177788811,244069
5,ENSG00000113583.5,133968625,chr5-133795211-G-A,rs731430,-1,G,A,133795211,173414,133772017,134165233,23194
5,ENSG00000019582.10,150412910,chr5-150274112-C-T,rs73268749,-1,C,T,150274112,138798,150216302,150609518,57810
5,ENSG00000171530.8,77776339,chr5-77707259-A-C,rs73768428,-1,A,C,77707259,69080,77579731,77972947,127528
5,ENSG00000183718.3,181261143,chr5-181128272-C-A,rs7378761,-1,C,A,181128272,132871,181064535,181457751,63737
5,ENSG00000171421.7,1799837,chr5-1842172-T-C,rs746703,-1,T,C,1842172,42335,1603229,1996445,238943
5,ENSG00000138829.6,128538245,chr5-128427063-C-G,rs75138601,-1,C,G,128427063,111182,128341637,128734853,85426
5,ENSG00000082074.10,39219563,chr5-39392625-G-A,rs75459462,-1,G,A,39392625,173062,39022955,39416171,369670
5,ENSG00000113231.9,77210680,chr5-77345592-A-G,rs75973464,1,A,G,77345592,134912,77014072,77407288,331520
5,ENSG00000213523.4,140557473,chr5-140474338-C-T,rs76376634,-1,C,T,140474338,83135,140360865,140754081,113473
5,ENSG00000150712.6,32312939,chr5-32239457-T-C,rs76846923,-1,T,C,32239457,73482,32116331,32509547,123126
5,ENSG00000164338.5,73565743,chr5-73727242-A-G,rs7703182,1,A,G,73727242,161499,73369135,73762351,358107
5,ENSG00000070614.9,150508131,chr5-150588381-C-T,rs7704610,1,C,T,150588381,80250,150311523,150704739,276858
5,ENSG00000113296.10,80035348,chr5-79941664-A-G,rs7712567,1,A,G,79941664,93684,79838740,80231956,102924
5,ENSG00000145936.3,170389367,chr5-170480034-A-G,rs7712568,-1,A,G,170480034,90667,170192759,170585975,287275
5,ENSG00000221886.3,160400054,chr5-160399667-T-C,rs7717016,-1,T,C,160399667,387,160203446,160596662,196221
5,ENSG00000123643.6,151447603,chr5-151587978-A-G,rs7723204,1,A,G,151587978,140375,151250995,151644211,336983
5,ENSG00000198961.5,109409974,chr5-109318512-C-T,rs7729692,-1,C,T,109318512,91462,109213366,109606582,105146
5,ENSG00000145919.6,173616650,chr5-173479880-C-T,rs7733015,-1,C,T,173479880,136770,173420042,173813258,59838
5,ENSG00000113638.8,40755961,chr5-40690556-G-A,rs7737225,-1,G,A,40690556,65405,40559353,40952569,131203
5,ENSG00000164346.5,74767249,chr5-74696204-A-C,rs77412261,1,A,C,74696204,71045,74570641,74963857,125563
5,ENSG00000164221.8,115296654,chr5-115251452-G-A,rs78151087,-1,G,A,115251452,45202,115100046,115493262,151406
5,ENSG00000177721.3,43040319,chr5-42949533-A-G,rs78310016,-1,A,G,42949533,90786,42843711,43236927,105822
5,ENSG00000188725.3,61162468,chr5-61053176-A-G,rs78709717,-1,A,G,61053176,109292,60965860,61359076,87316
5,ENSG00000112964.8,42423439,chr5-42295155-G-A,rs78903561,1,G,A,42295155,128284,42226831,42620047,68324
5,ENSG00000037474.10,6633044,chr5-6641444-G-A,rs79085552,-1,G,A,6641444,8400,6436436,6829652,205008
5,ENSG00000050748.12,180292083,chr5-180197702-A-G,rs79917833,-1,A,G,180197702,94381,180095475,180488691,102227
5,ENSG00000112941.8,6713432,chr5-6844968-T-C,rs870346,1,T,C,6844968,131536,6516824,6910040,328144
5,ENSG00000044115.14,138753425,chr5-138657020-G-A,rs882740,1,G,A,138657020,96405,138556817,138950033,100203
5,ENSG00000150756.8,10249888,chr5-10062138-G-A,rs9312714,-1,G,A,10062138,187750,10053280,10446496,8858
4,ENSG00000109667.7,10021497,chr4-9982851-C-T,rs10003001,-1,C,T,9982851,38646,9824889,10218105,157962
4,ENSG00000145335.11,89837161,chr4-89822180-C-T,rs10005233,-1,C,T,89822180,14981,89640553,90033769,181627
4,ENSG00000163132.6,4859665,chr4-4932131-T-C,rs10007275,1,T,C,4932131,72466,4663057,5056273,269074
4,ENSG00000138796.10,107989889,chr4-107987355-C-G,rs10008581,1,C,G,107987355,2534,107793281,108186497,194074
4,ENSG00000151552.7,17512090,chr4-17525059-A-C,rs10020773,-1,A,C,17525059,12969,17315482,17708698,209577
4,ENSG00000154553.8,185535507,chr4-185586033-G-A,rs1046236,-1,G,A,185586033,50526,185338899,185732115,247134
4,ENSG00000138798.7,109912883,chr4-109956260-A-T,rs10488881,1,A,T,109956260,43377,109716275,110109491,239985
4,ENSG00000163956.6,3532422,chr4-3512812-G-A,rs1049574,-1,G,A,3512812,19610,3335814,3729030,176998
4,ENSG00000004468.6,15778328,chr4-15848487-G-A,rs10516293,1,G,A,15848487,70159,15581720,15974936,266767
4,ENSG00000138640.10,89057185,chr4-88876487-G-A,rs10516823,-1,G,A,88876487,180698,88860577,89253793,15910
4,ENSG00000163110.10,94451942,chr4-94409029-C-A,rs10516949,1,C,A,94409029,42913,94255334,94648550,153695
4,ENSG00000168228.9,25312774,chr4-25415749-G-A,rs10517073,1,G,A,25415749,102975,25116166,25509382,299583
4,ENSG00000138764.9,77157207,chr4-77209068-A-C,rs10518167,1,A,C,77209068,51861,76960599,77353815,248469
4,ENSG00000151718.11,183099257,chr4-183288044-A-G,rs10520554,1,A,G,183288044,188787,182902649,183295865,385395
4,ENSG00000164037.11,103019705,chr4-103029268-C-T,rs1080081,-1,C,T,103029268,9563,102823097,103216313,206171
4,ENSG00000170801.5,8269754,chr4-8247216-C-T,rs10938700,1,C,T,8247216,22538,8073146,8466362,174070
4,ENSG00000052795.8,158769026,chr4-158764591-C-T,rs11100197,1,C,T,158764591,4435,158572418,158965634,192173
4,ENSG00000169026.8,689151,chr4-620883-C-T,rs11248029,-1,C,T,620883,68268,492543,885759,128340
4,ENSG00000182903.11,499156,chr4-443432-G-A,rs114734668,-1,G,A,443432,55724,302548,695764,140884
4,ENSG00000159788.13,3293021,chr4-3156114-C-G,rs115270146,1,C,G,3156114,136907,3096413,3489629,59701
4,ENSG00000056050.6,169757944,chr4-169757842-T-C,rs11540095,-1,T,C,169757842,102,169561336,169954552,196506
4,ENSG00000169288.12,77862830,chr4-77693272-T-C,rs115487233,1,T,C,77693272,169558,77666222,78059438,27050
4,ENSG00000170088.7,165112860,chr4-165049952-G-C,rs116576664,-1,G,C,165049952,62908,164916252,165309468,133700
4,ENSG00000151790.4,155903696,chr4-155946088-G-A,rs117170243,1,G,A,155946088,42392,155707088,156100304,239000
4,ENSG00000151611.8,145619385,chr4-145651075-G-A,rs11721553,1,G,A,145651075,31690,145422777,145815993,228298
4,ENSG00000127415.8,987044,chr4-971991-G-A,rs11724804,1,G,A,971991,15053,790436,1183652,181555
4,ENSG00000151806.9,44678420,chr4-44601352-T-G,rs11725120,1,T,G,44601352,77068,44481812,44875028,119540
4,ENSG00000138663.4,83035183,chr4-83156618-G-T,rs11727330,1,G,T,83156618,121435,82838575,83231791,318043
4,ENSG00000168491.5,185471733,chr4-185352976-T-G,rs11727342,-1,T,G,185352976,118757,185275125,185668341,77851
4,ENSG00000138639.13,85475150,chr4-85577784-A-G,rs11930449,1,A,G,85577784,102634,85278542,85671758,299242
4,ENSG00000163683.6,39638865,chr4-39777293-C-T,rs11933569,-1,C,T,39777293,138428,39442257,39835473,335036
4,ENSG00000155275.14,8440777,chr4-8392736-C-T,rs11934642,1,C,T,8392736,48041,8244169,8637385,148567
4,ENSG00000197386.6,3074681,chr4-3033904-A-T,rs11947255,1,A,T,3033904,40777,2878073,3271289,155831
4,ENSG00000197057.4,36281616,chr4-36333701-A-G,rs12331547,1,A,G,36333701,52085,36085008,36478224,248693
4,ENSG00000071127.11,10116799,chr4-10118985-T-C,rs12374320,-1,T,C,10118985,2186,9920191,10313407,198794
4,ENSG00000164162.8,145098196,chr4-145159187-T-C,rs12498677,-1,T,C,145159187,60991,144901588,145294804,257599
4,ENSG00000109452.7,142846301,chr4-142776994-T-A,rs12500163,-1,T,A,142776994,69307,142649693,143042909,127301
4,ENSG00000124406.12,42657105,chr4-42654769-C-A,rs12502496,-1,C,A,42654769,2336,42460497,42853713,194272
4,ENSG00000109756.4,159103079,chr4-159047453-A-G,rs12505998,1,A,G,159047453,55626,158906471,159299687,140982
4,ENSG00000250317.3,25914220,chr4-25893636-C-T,rs12512962,1,C,T,25893636,20584,25717612,26110828,176024
4,ENSG00000163694.10,40629864,chr4-40451335-G-A,rs12647748,-1,G,A,40451335,178529,40433256,40826472,18079
4,ENSG00000152784.9,80197503,chr4-80166861-A-G,rs12648190,1,A,G,80166861,30642,80000895,80394111,165966
4,ENSG00000152583.7,87529376,chr4-87556416-A-G,rs12649411,-1,A,G,87556416,27040,87332768,87725984,223648
4,ENSG00000125089.10,8199290,chr4-8228729-T-G,rs1281152,1,T,G,8228729,29439,8002682,8395898,226047
4,ENSG00000157426.8,56387491,chr4-56358353-A-G,rs13102012,-1,A,G,56358353,29138,56190883,56584099,167470
4,ENSG00000168826.11,4290251,chr4-4344646-C-T,rs13103109,1,C,T,4344646,54395,4093643,4486859,251003
4,ENSG00000002549.7,17577198,chr4-17565732-A-C,rs13103430,1,A,C,17565732,11466,17380590,17773806,185142
4,ENSG00000091490.6,25862988,chr4-25876874-G-A,rs13104150,-1,G,A,25876874,13886,25666380,26059596,210494
4,ENSG00000038002.4,177442437,chr4-177440968-C-G,rs13106192,-1,C,G,177440968,1469,177245829,177639045,195139
4,ENSG00000154277.8,41256928,chr4-41290944-A-G,rs13107512,1,A,G,41290944,34016,41060320,41453536,230624
4,ENSG00000151012.9,138242349,chr4-138171565-A-G,rs13120371,-1,A,G,138171565,70784,138045741,138438957,125824
4,ENSG00000145414.4,163166890,chr4-163082706-T-C,rs13132042,-1,T,C,163082706,84184,162970282,163363498,112424
4,ENSG00000072832.9,5893086,chr4-5728686-T-C,rs13132305,-1,T,C,5728686,164400,5696478,6089694,32208
4,ENSG00000145476.10,186191567,chr4-186199057-C-A,rs13146272,1,C,A,186199057,7490,185994959,186388175,204098
4,ENSG00000118564.10,15655357,chr4-15739122-G-A,rs13148924,-1,G,A,15739122,83765,15458749,15851965,280373
4,ENSG00000118564.10,15655357,chr4-15739122-G-C,rs13148924,-1,G,C,15739122,83765,15458749,15851965,280373
4,ENSG00000145214.9,973569,chr4-967585-G-A,rs1377586,-1,G,A,967585,5984,776961,1170177,190624
4,ENSG00000078140.9,39698136,chr4-39504524-C-T,rs1379819,1,C,T,39504524,193612,39501528,39894744,2996
4,ENSG00000123737.8,121801323,chr4-121828386-C-T,rs1507994,1,C,T,121828386,27063,121604715,121997931,223671
4,ENSG00000151466.7,129093539,chr4-129243051-C-T,rs1514569,-1,C,T,129243051,149512,128896931,129290147,346120
4,ENSG00000138801.4,107720234,chr4-107721797-G-A,rs16780,-1,G,A,107721797,1563,107523626,107916842,198171
4,ENSG00000186222.3,6716174,chr4-6628468-T-C,rs16839049,1,T,C,6628468,87706,6519566,6912782,108902
4,ENSG00000169019.9,47463702,chr4-47340845-C-T,rs16860118,-1,C,T,47340845,122857,47267094,47660310,73751
4,ENSG00000250254.1,37960398,chr4-37924357-T-C,rs16994074,1,T,C,37924357,36041,37763790,38157006,160567
4,ENSG00000169116.7,74933116,chr4-75004440-G-T,rs17000076,1,G,T,75004440,71324,74736508,75129724,267932
4,ENSG00000255072.1,88523776,chr4-88546861-C-T,rs17014192,-1,C,T,88546861,23085,88327168,88720384,219693
4,ENSG00000164168.3,147617397,chr4-147634709-G-A,rs17023581,1,G,A,147634709,17312,147420789,147814005,213920
4,ENSG00000168785.3,98658611,chr4-98614277-T-C,rs17027858,-1,T,C,98614277,44334,98462003,98855219,152274
4,ENSG00000078177.8,40056850,chr4-40055669-C-T,rs1704157,1,C,T,40055669,1181,39860242,40253458,195427
4,ENSG00000145439.7,169010255,chr4-168861193-T-C,rs17054543,-1,T,C,168861193,149062,168813647,169206863,47546
4,ENSG00000128040.6,56821701,chr4-56922067-C-T,rs17087265,-1,C,T,56922067,100366,56625093,57018309,296974
4,ENSG00000163319.6,83456058,chr4-83467762-C-T,rs17355027,1,C,T,83467762,11704,83259450,83652666,208312
4,ENSG00000137462.6,153684280,chr4-153668572-T-C,rs17370673,1,T,C,153668572,15708,153487672,153880888,180900
4,ENSG00000050730.11,121164321,chr4-121200339-A-G,rs17435444,-1,A,G,121200339,36018,120967713,121360929,232626
4,ENSG00000163697.11,41214542,chr4-41205322-C-T,rs17443381,-1,C,T,41205322,9220,41017934,41411150,187388
4,ENSG00000174123.6,38782990,chr4-38865806-A-G,rs17582830,-1,A,G,38865806,82816,38586382,38979598,279424
4,ENSG00000150625.12,175812264,chr4-175893145-A-C,rs17667772,-1,A,C,175893145,80881,175615656,176008872,277489
4,ENSG00000109265.7,56049098,chr4-55931355-A-G,rs17797565,1,A,G,55931355,117743,55852490,56245706,78865
4,ENSG00000145349.12,113761738,chr4-113740525-T-G,rs1859229,-1,T,G,113740525,21213,113565130,113958346,175395
4,ENSG00000118579.6,17614641,chr4-17655737-G-A,rs1860598,1,G,A,17655737,41096,17418033,17811249,237704
4,ENSG00000138823.7,99574824,chr4-99544415-G-A,rs1873516,1,G,A,99544415,30409,99378216,99771432,166199
4,ENSG00000134851.7,55395957,chr4-55341544-C-T,rs1985606,1,C,T,55341544,54413,55199349,55592565,142195
4,ENSG00000163069.8,52038299,chr4-52006072-T-C,rs2030333,-1,T,C,52006072,32227,51841691,52234907,164381
4,ENSG00000138777.15,105474062,chr4-105473223-C-A,rs2074396,-1,C,A,105473223,839,105277454,105670670,195769
4,ENSG00000164342.6,186069156,chr4-186220703-C-T,rs2102576,1,C,T,186220703,151547,185872548,186265764,348155
4,ENSG00000073331.12,112297369,chr4-112212471-T-C,rs2102993,1,T,C,112212471,84898,112100761,112493977,111710
4,ENSG00000164163.6,145098311,chr4-145039315-C-T,rs2162090,1,C,T,145039315,58996,144901703,145294919,137612
4,ENSG00000145354.5,102868992,chr4-102798584-C-T,rs223438,1,C,T,102798584,70408,102672384,103065600,126200
4,ENSG00000154556.13,185656969,chr4-185776340-T-C,rs2310357,-1,T,C,185776340,119371,185460361,185853577,315979
4,ENSG00000074966.6,48134250,chr4-48124069-T-C,rs2704439,-1,T,C,48124069,10181,47937642,48330858,186427
4,ENSG00000121895.7,39032409,chr4-39033166-G-C,rs2711976,-1,G,C,39033166,757,38835801,39229017,197365
4,ENSG00000168936.6,1721323,chr4-1719621-G-A,rs2854916,-1,G,A,1719621,1702,1524715,1917931,194906
4,ENSG00000173085.9,83284798,chr4-83224058-C-G,rs28629807,-1,C,G,83224058,60740,83088190,83481406,135868
4,ENSG00000173083.9,83334848,chr4-83224058-C-G,rs28629807,-1,C,G,83224058,110790,83138240,83531456,85818
4,ENSG00000145287.6,83114729,chr4-83224058-C-G,rs28629807,-1,C,G,83224058,109329,82918121,83311337,305937
4,ENSG00000185477.3,89307800,chr4-89249086-G-T,rs28647517,-1,G,T,89249086,58714,89111192,89504408,137894
4,ENSG00000185477.3,89307800,chr4-89249086-G-A,rs28647517,-1,G,A,89249086,58714,89111192,89504408,137894
4,ENSG00000163633.6,86892422,chr4-86887872-T-C,rs28664715,-1,T,C,86887872,4550,86695814,87089030,192058
4,ENSG00000138685.7,122826831,chr4-122827461-C-G,rs2922979,1,C,G,122827461,630,122630223,123023439,197238
4,ENSG00000145337.4,88523776,chr4-88669680-T-G,rs2924354,-1,T,G,88669680,145904,88327168,88720384,342512
4,ENSG00000132406.7,4248223,chr4-4255528-C-T,rs2980092,-1,C,T,4255528,7305,4051615,4444831,203913
4,ENSG00000177432.5,88697829,chr4-88728340-A-G,rs3017895,-1,A,G,88728340,30511,88501221,88894437,227119
4,ENSG00000164323.8,185204000,chr4-185202643-C-G,rs3108297,-1,C,G,185202643,1357,185007392,185400608,195251
4,ENSG00000145365.8,112285904,chr4-112275750-T-C,rs3202899,-1,T,C,112275750,10154,112089296,112482512,186454
4,ENSG00000109674.3,177309874,chr4-177341630-A-G,rs34193982,1,A,G,177341630,31756,177113266,177506482,228364
4,ENSG00000185619.13,705765,chr4-733364-C-T,rs34434107,1,C,T,733364,27599,509157,902373,224207
4,ENSG00000164117.7,174283667,chr4-174387450-A-T,rs34989812,-1,A,T,174387450,103783,174087059,174480275,300391
4,ENSG00000109684.9,10684768,chr4-10689294-C-G,rs35755918,-1,C,G,10689294,4526,10488160,10881376,201134
4,ENSG00000087008.10,8440723,chr4-8376605-G-C,rs3756187,-1,G,C,8376605,64118,8244115,8637331,132490
4,ENSG00000109519.7,7068064,chr4-7068077-C-G,rs3822270,-1,C,G,7068077,13,6871456,7264672,196621
4,ENSG00000109519.7,7068064,chr4-7068077-C-A,rs3822270,-1,C,A,7068077,13,6871456,7264672,196621
4,ENSG00000133256.8,625573,chr4-652620-G-T,rs3864130,1,G,T,652620,27047,428965,822181,223655
4,ENSG00000171234.9,69096474,chr4-69154736-A-G,rs3891754,1,A,G,69154736,58262,68899866,69293082,254870
4,ENSG00000145390.6,119212713,chr4-119234651-C-A,rs4145952,1,C,A,119234651,21938,119016105,119409321,218546
4,ENSG00000171476.16,56681296,chr4-56649581-T-C,rs4276340,-1,T,C,56649581,31715,56484688,56877904,164893
4,ENSG00000109689.10,26860841,chr4-26848304-A-G,rs4532223,1,A,G,26848304,12537,26664233,27057449,184071
4,ENSG00000172007.5,139454121,chr4-139441777-G-A,rs4535284,1,G,A,139441777,12344,139257513,139650729,184264
4,ENSG00000164144.10,152779954,chr4-152779978-C-T,rs4619875,1,C,T,152779978,24,152583346,152976562,196632
4,ENSG00000138670.10,81471907,chr4-81417577-T-C,rs4692955,-1,T,C,81417577,54330,81275299,81668515,142278
4,ENSG00000138668.13,82373991,chr4-82228325-G-A,rs4693026,-1,G,A,82228325,145666,82177383,82570599,50942
4,ENSG00000159733.9,2418645,chr4-2412941-A-G,rs4974710,-1,A,G,2412941,5704,2222037,2615253,190904
4,ENSG00000138772.8,78551770,chr4-78552886-C-A,rs4975144,1,C,A,78552886,1116,78355162,78748378,197724
4,ENSG00000163138.13,20700458,chr4-20683755-C-A,rs55863541,1,C,A,20683755,16703,20503850,20897066,179905
4,ENSG00000168824.10,4387102,chr4-4347178-C-A,rs56151717,1,C,A,4347178,39924,4190494,4583710,156684
4,ENSG00000174130.7,38856817,chr4-38804475-T-C,rs5743562,-1,T,C,38804475,52342,38660209,39053425,144266
4,ENSG00000197888.2,68576322,chr4-68500812-G-A,rs62299466,-1,G,A,68500812,75510,68379714,68772930,121098
4,ENSG00000196620.4,68670652,chr4-68500812-G-A,rs62299466,-1,G,A,68500812,169840,68474044,68867260,26768
4,ENSG00000196526.6,7939861,chr4-7810947-G-A,rs6446622,-1,G,A,7810947,128914,7743253,8136469,67694
4,ENSG00000014824.7,41990530,chr4-41844067-T-C,rs6447117,1,T,C,41844067,146463,41793922,42187138,50145
4,ENSG00000163322.9,83485100,chr4-83443655-T-C,rs6535473,-1,T,C,83443655,41445,83288492,83681708,155163
4,ENSG00000198189.6,87391188,chr4-87325048-A-C,rs66837437,-1,A,C,87325048,66140,87194580,87587796,130468
4,ENSG00000256043.2,155953866,chr4-155946328-C-T,rs6816024,-1,C,T,155946328,7538,155757258,156150474,189070
4,ENSG00000145362.11,113049653,chr4-113000992-A-G,rs6818733,1,A,G,113000992,48661,112853045,113246261,147947
4,ENSG00000138744.8,75941013,chr4-75949076-C-T,rs6826085,-1,C,T,75949076,8063,75744405,76137621,204671
4,ENSG00000145331.9,99564039,chr4-99518879-T-C,rs6828637,-1,T,C,99518879,45160,99367431,99760647,151448
4,ENSG00000070190.8,99816827,chr4-99784115-C-T,rs6831238,1,C,T,99784115,32712,99620219,100013435,163896
4,ENSG00000151612.10,145938823,chr4-145792230-C-T,rs6836085,-1,C,T,145792230,146593,145742215,146135431,50015
4,ENSG00000163104.12,94207865,chr4-94065351-G-A,rs6837513,1,G,A,94065351,142514,94011257,94404473,54094
4,ENSG00000174780.10,56467617,chr4-56463770-T-C,rs6849183,1,T,C,56463770,3847,56271009,56664225,192761
4,ENSG00000138792.5,110476155,chr4-110669805-C-T,rs6850879,1,C,T,110669805,193650,110279547,110672763,390258
4,ENSG00000164111.9,121696980,chr4-121685764-T-C,rs6854854,-1,T,C,121685764,11216,121500372,121893588,185392
4,ENSG00000145358.2,100190468,chr4-100182037-A-C,rs6856947,-1,A,C,100182037,8431,99993860,100387076,188177
4,ENSG00000138785.10,105708689,chr4-105725192-A-G,rs72671852,-1,A,G,105725192,16503,105512081,105905297,213111
4,ENSG00000007062.7,16084023,chr4-15999584-C-T,rs73230290,-1,C,T,15999584,84439,15887415,16280631,112169
4,ENSG00000174125.3,38804791,chr4-38788054-G-A,rs73236616,-1,G,A,38788054,16737,38608183,39001399,179871
4,ENSG00000090989.13,55853648,chr4-55871323-G-A,rs73238378,1,G,A,55871323,17675,55657040,56050256,214283
4,ENSG00000152969.11,6200549,chr4-6198343-A-G,rs7377975,-1,A,G,6198343,2206,6003941,6397157,194402
4,ENSG00000183439.5,164977657,chr4-164977530-C-T,rs74651789,-1,C,T,164977530,127,164781049,165174265,196481
4,ENSG00000127418.9,1011626,chr4-1017327-T-C,rs748651,1,T,C,1017327,5701,815018,1208234,202309
4,ENSG00000077684.10,128809700,chr4-128676244-A-G,rs74980942,1,A,G,128676244,133456,128613092,129006308,63152
4,ENSG00000184178.11,53366061,chr4-53265171-T-C,rs751265,-1,T,C,53265171,100890,53169453,53562669,95718
4,ENSG00000109794.9,186104704,chr4-185972808-G-A,rs75163896,1,G,A,185972808,131896,185908096,186301312,64712
4,ENSG00000118762.3,88007635,chr4-87929063-C-T,rs76409708,1,C,T,87929063,78572,87811027,88204243,118036
4,ENSG00000163738.13,74158118,chr4-74349944-A-G,rs7656052,1,A,G,74349944,191826,73961510,74354726,388434
4,ENSG00000013288.4,6575189,chr4-6606103-T-C,rs7659958,1,T,C,6606103,30914,6378581,6771797,227522
4,ENSG00000164109.8,120066848,chr4-120098131-G-A,rs7660900,-1,G,A,120098131,31283,119870240,120263456,227891
4,ENSG00000197465.8,143905559,chr4-143958036-C-T,rs7662736,-1,C,T,143958036,52477,143708951,144102167,249085
4,ENSG00000087274.11,2843844,chr4-3027896-A-G,rs7677445,1,A,G,3027896,184052,2647236,3040452,380660
4,ENSG00000183423.6,109848107,chr4-109865134-C-T,rs7679048,1,C,T,109865134,17027,109651499,110044715,213635
4,ENSG00000109133.8,41935429,chr4-41943042-A-G,rs7681854,1,A,G,41943042,7613,41738821,42132037,204221
4,ENSG00000173011.10,7043372,chr4-7187493-T-C,rs7684317,1,T,C,7187493,144121,6846764,7239980,340729
4,ENSG00000164116.12,155666848,chr4-155677233-A-G,rs7685675,1,A,G,155677233,10385,155470240,155863456,206993
4,ENSG00000047315.10,56978896,chr4-56958766-A-G,rs7687767,1,A,G,56958766,20130,56782288,57175504,176478
4,ENSG00000129128.8,176319966,chr4-176401459-C-T,rs7694651,1,C,T,176401459,81493,176123358,176516574,278101
4,ENSG00000159674.7,1172583,chr4-1242553-C-T,rs77001529,-1,C,T,1242553,69970,975975,1369191,266578
4,ENSG00000215375.2,677922,chr4-739842-G-A,rs77052907,1,G,A,739842,61920,481314,874530,258528
4,ENSG00000174473.10,171813404,chr4-172009284-C-T,rs77472055,1,C,T,172009284,195880,171616796,172010012,392488
4,ENSG00000188993.3,52020363,chr4-51885693-T-A,rs77856227,-1,T,A,51885693,134670,51823755,52216971,61938
4,ENSG00000145241.6,67545503,chr4-67485326-T-C,rs78088859,-1,T,C,67485326,60177,67348895,67742111,136431
4,ENSG00000186212.2,76898144,chr4-76985088-C-T,rs79092945,-1,C,T,76985088,86944,76701536,77094752,283552
4,ENSG00000174137.8,1684313,chr4-1705720-T-C,rs798756,-1,T,C,1705720,21407,1487705,1880921,218015
4,ENSG00000085871.4,139665819,chr4-139675545-A-G,rs8192047,1,A,G,139675545,9726,139469211,139862427,206334
4,ENSG00000138686.5,121870474,chr4-121912159-C-T,rs906496,-1,C,T,121912159,41685,121673866,122067082,238293
4,ENSG00000189157.8,76251721,chr4-76333651-C-T,rs907446,1,C,T,76333651,81930,76055113,76448329,278538
4,ENSG00000170509.7,87322882,chr4-87461323-G-A,rs9307036,-1,G,A,87461323,138441,87126274,87519490,335049
4,ENSG00000150961.10,118836126,chr4-118994418-T-C,rs9307466,-1,T,C,118994418,158292,118639518,119032734,354900
4,ENSG00000250312.2,124501,chr4-102685-T-C,rs9884834,1,T,C,102685,21816,-72107,321109,174792
4,ENSG00000121892.10,39977911,chr4-39804876-C-T,rs9992906,-1,C,T,39804876,173035,39781303,40174519,23573
4,ENSG00000178988.10,6709865,chr4-6710074-C-G,rs9992941,-1,C,G,6710074,209,6513257,6906473,196817
4,ENSG00000138641.10,88592480,chr4-88645052-C-T,rs10016030,1,C,T,88645052,52572,88395872,88789088,249180
4,ENSG00000178343.4,42397488,chr4-42588957-G-C,rs10022097,1,G,C,42588957,191469,42200880,42594096,388077
4,ENSG00000071205.7,147732088,chr4-147733645-G-A,rs10023419,1,G,A,147733645,1557,147535480,147928696,198165
4,ENSG00000071205.7,147732088,chr4-147733645-G-T,rs10023419,1,G,T,147733645,1557,147535480,147928696,198165
4,ENSG00000164093.10,110623077,chr4-110743296-A-G,rs10027473,-1,A,G,110743296,120219,110426469,110819685,316827
4,ENSG00000109771.11,185395924,chr4-185350000-G-A,rs10030392,-1,G,A,185350000,45924,185199316,185592532,150684
4,ENSG00000189308.6,83010823,chr4-83152147-C-T,rs10033406,-1,C,T,83152147,141324,82814215,83207431,337932
4,ENSG00000138658.11,112636909,chr4-112504453-C-T,rs1038560,-1,C,T,112504453,132456,112440301,112833517,64152
4,ENSG00000174125.3,38804791,chr4-38766912-A-G,rs10470854,-1,A,G,38766912,37879,38608183,39001399,158729
4,ENSG00000109572.8,169620578,chr4-169742084-C-T,rs1047642,1,C,T,169742084,121506,169423970,169817186,318114
4,ENSG00000174749.4,112145454,chr4-112129120-C-T,rs10516587,1,C,T,112129120,16334,111948846,112342062,180274
4,ENSG00000124406.12,42657105,chr4-42546243-C-A,rs10938196,-1,C,A,42546243,110862,42460497,42853713,85746
4,ENSG00000109684.9,10684768,chr4-10733564-G-A,rs10938947,-1,G,A,10733564,48796,10488160,10881376,245404
4,ENSG00000118777.6,88158639,chr4-88076931-G-A,rs10965,-1,G,A,88076931,81708,87962031,88355247,114900
4,ENSG00000170502.8,87422573,chr4-87344854-C-T,rs11097131,1,C,T,87344854,77719,87225965,87619181,118889
4,ENSG00000109265.7,56049098,chr4-55997866-A-G,rs11133419,1,A,G,55997866,51232,55852490,56245706,145376
4,ENSG00000175920.11,3463306,chr4-3598027-C-T,rs112850639,1,C,T,3598027,134721,3266698,3659914,331329
4,ENSG00000128039.6,55346242,chr4-55391465-G-C,rs113058073,1,G,C,55391465,45223,55149634,55542850,241831
4,ENSG00000047365.6,36244514,chr4-36100907-A-G,rs114690689,-1,A,G,36100907,143607,36047906,36441122,53001
4,ENSG00000002549.7,17577198,chr4-17593913-A-G,rs115189991,1,A,G,17593913,16715,17380590,17773806,213323
4,ENSG00000163950.7,1712319,chr4-1816898-T-C,rs115233072,-1,T,C,1816898,104579,1515711,1908927,301187
4,ENSG00000163956.6,3532422,chr4-3503369-G-A,rs116262719,-1,G,A,3503369,29053,3335814,3729030,167555
4,ENSG00000118785.8,87975714,chr4-87975269-T-C,rs11730582,1,T,C,87975269,445,87779106,88172322,196163
4,ENSG00000056050.6,169757944,chr4-169730023-C-T,rs11732885,-1,C,T,169730023,27921,169561336,169954552,168687
4,ENSG00000181826.5,37686376,chr4-37652573-T-A,rs11929982,-1,T,A,37652573,33803,37489768,37882984,162805
4,ENSG00000164038.10,103076761,chr4-103177142-G-C,rs11932885,-1,G,C,103177142,100381,102880153,103273369,296989
4,ENSG00000109475.12,108620576,chr4-108447979-C-T,rs11936528,1,C,T,108447979,172597,108423968,108817184,24011
4,ENSG00000171476.16,56681296,chr4-56640619-T-C,rs11947513,-1,T,C,56640619,40677,56484688,56877904,155931
4,ENSG00000074966.6,48134250,chr4-48179155-C-A,rs12499541,-1,C,A,48179155,44905,47937642,48330858,241513
4,ENSG00000151611.8,145619385,chr4-145796440-C-T,rs12501107,1,C,T,145796440,177055,145422777,145815993,373663
4,ENSG00000059691.7,151761007,chr4-151627960-T-C,rs12504273,-1,T,C,151627960,133047,151564399,151957615,63561
4,ENSG00000163312.6,83455823,chr4-83363045-T-C,rs12507011,-1,T,C,83363045,92778,83259215,83652431,103830
4,ENSG00000118564.10,15655357,chr4-15546792-C-T,rs12508186,-1,C,T,15546792,108565,15458749,15851965,88043
4,ENSG00000145425.5,151099628,chr4-151243634-G-A,rs12509302,1,G,A,151243634,144006,150903020,151296236,340614
4,ENSG00000151470.7,129096152,chr4-129191393-C-T,rs12511477,1,C,T,129191393,95241,128899544,129292760,291849
4,ENSG00000145331.9,99564039,chr4-99530784-A-G,rs12640855,-1,A,G,99530784,33255,99367431,99760647,163353
4,ENSG00000164134.6,139301505,chr4-139108890-G-A,rs12643839,1,G,A,139108890,192615,139104897,139498113,3993
4,ENSG00000138668.13,82373991,chr4-82379425-G-T,rs12711238,-1,G,T,82379425,5434,82177383,82570599,202042
4,ENSG00000163110.10,94451942,chr4-94615818-C-A,rs13110958,1,C,A,94615818,163876,94255334,94648550,360484
4,ENSG00000109390.7,139302477,chr4-139368131-A-G,rs13117654,-1,A,G,139368131,65654,139105869,139499085,262262
4,ENSG00000169245.4,76023497,chr4-75939317-C-T,rs13118503,-1,C,T,75939317,84180,75826889,76220105,112428
4,ENSG00000163071.6,52051304,chr4-52102311-G-A,rs13122418,1,G,A,52102311,51007,51854696,52247912,247615
4,ENSG00000109814.7,39527439,chr4-39525021-G-A,rs13129975,-1,G,A,39525021,2418,39330831,39724047,194190
4,ENSG00000138686.5,121870474,chr4-121709462-G-A,rs13132345,-1,G,A,121709462,161012,121673866,122067082,35596
4,ENSG00000171234.9,69096474,chr4-69153615-T-C,rs13134261,1,T,C,69153615,57141,68899866,69293082,253749
4,ENSG00000109452.7,142846301,chr4-143039634-A-G,rs13136216,-1,A,G,143039634,193333,142649693,143042909,389941
4,ENSG00000125388.14,2963571,chr4-3052290-T-C,rs1313768,1,T,C,3052290,88719,2766963,3160179,285327
4,ENSG00000138685.7,122826831,chr4-122789142-C-T,rs13138349,1,C,T,122789142,37689,122630223,123023439,158919
4,ENSG00000145246.8,47485275,chr4-47423916-T-C,rs13138813,1,T,C,47423916,61359,47288667,47681883,135249
4,ENSG00000129187.10,182917386,chr4-182732946-A-G,rs13435237,-1,A,G,182732946,184440,182720778,183113994,12168
4,ENSG00000138722.5,89894854,chr4-89898635-C-G,rs1372508,1,C,G,89898635,3781,89698246,90091462,200389
4,ENSG00000138722.5,89894854,chr4-89898635-C-T,rs1372508,1,C,T,89898635,3781,89698246,90091462,200389
4,ENSG00000197888.2,68576322,chr4-68475861-C-T,rs1454247,-1,C,T,68475861,100461,68379714,68772930,96147
4,ENSG00000196620.4,68670652,chr4-68475861-C-T,rs1454247,-1,C,T,68475861,194791,68474044,68867260,1817
4,ENSG00000145390.6,119212713,chr4-119135660-G-A,rs1459055,1,G,A,119135660,77053,119016105,119409321,119555
4,ENSG00000151718.11,183099257,chr4-183270884-C-T,rs1473070,1,C,T,183270884,171627,182902649,183295865,368235
4,ENSG00000138678.6,83536108,chr4-83594622-G-A,rs1474250,1,G,A,83594622,58514,83339500,83732716,255122
4,ENSG00000109189.7,52659301,chr4-52799688-T-C,rs1483686,-1,T,C,52799688,140387,52462693,52855909,336995
4,ENSG00000109163.6,67754388,chr4-67765346-C-T,rs1484185,-1,C,T,67765346,10958,67557780,67950996,207566
4,ENSG00000152953.8,5051480,chr4-5217892-G-A,rs16836902,1,G,A,5217892,166412,4854872,5248088,363020
4,ENSG00000168214.16,26321014,chr4-26424229-C-G,rs16878322,1,C,G,26424229,103215,26124406,26517622,299823
4,ENSG00000138814.12,101347526,chr4-101220061-T-A,rs16996716,-1,T,A,101220061,127465,101150918,101544134,69143
4,ENSG00000145337.4,88523776,chr4-88398144-T-G,rs17014118,-1,T,G,88398144,125632,88327168,88720384,70976
4,ENSG00000145337.4,88523776,chr4-88398144-T-C,rs17014118,-1,T,C,88398144,125632,88327168,88720384,70976
4,ENSG00000171497.4,158723396,chr4-158849904-T-C,rs17037716,-1,T,C,158849904,126508,158526788,158920004,323116
4,ENSG00000174473.10,171813404,chr4-171858757-G-A,rs17057501,1,G,A,171858757,45353,171616796,172010012,241961
4,ENSG00000109674.3,177309874,chr4-177307859-C-T,rs17064585,1,C,T,177307859,2015,177113266,177506482,194593
4,ENSG00000163322.9,83485100,chr4-83467762-C-T,rs17355027,-1,C,T,83467762,17338,83288492,83681708,179270
4,ENSG00000109133.8,41935429,chr4-41962320-A-G,rs17445354,1,A,G,41962320,26891,41738821,42132037,223499
4,ENSG00000109805.5,17810979,chr4-17882060-G-T,rs17526868,1,G,T,17882060,71081,17614371,18007587,267689
4,ENSG00000109805.5,17810979,chr4-17882060-G-C,rs17526868,1,G,C,17882060,71081,17614371,18007587,267689
4,ENSG00000174130.7,38856817,chr4-38811255-T-C,rs17616434,-1,T,C,38811255,45562,38660209,39053425,151046
4,ENSG00000188993.3,52020363,chr4-51854505-A-G,rs17657391,-1,A,G,51854505,165858,51823755,52216971,30750
4,ENSG00000169429.6,73740569,chr4-73781924-A-T,rs17809003,1,A,T,73781924,41355,73543961,73937177,237963
4,ENSG00000050730.11,121164321,chr4-121227632-A-G,rs2044970,-1,A,G,121227632,63311,120967713,121360929,259919
4,ENSG00000138639.13,85475150,chr4-85548961-C-T,rs2128100,1,C,T,85548961,73811,85278542,85671758,270419
4,ENSG00000151806.9,44678420,chr4-44725971-C-A,rs2172143,1,C,A,44725971,47551,44481812,44875028,244159
4,ENSG00000038002.4,177442437,chr4-177438525-T-C,rs2271100,-1,T,C,177438525,3912,177245829,177639045,192696
4,ENSG00000151552.7,17512090,chr4-17500784-A-G,rs2518616,-1,A,G,17500784,11306,17315482,17708698,185302
4,ENSG00000072201.8,53591486,chr4-53693571-C-T,rs2590783,-1,C,T,53693571,102085,53394878,53788094,298693
4,ENSG00000153130.12,140373646,chr4-140370451-G-A,rs2668585,1,G,A,140370451,3195,140177038,140570254,193413
4,ENSG00000189184.7,137532494,chr4-137559814-G-A,rs28505426,-1,G,A,137559814,27320,137335886,137729102,223928
4,ENSG00000138772.8,78551770,chr4-78493996-T-C,rs2867446,1,T,C,78493996,57774,78355162,78748378,138834
4,ENSG00000163644.9,88284561,chr4-88218680-C-T,rs2904185,-1,C,T,88218680,65881,88087953,88481169,130727
4,ENSG00000075539.9,48780279,chr4-48896637-G-A,rs2925213,-1,G,A,48896637,116358,48583671,48976887,312966
4,ENSG00000155275.14,8440777,chr4-8556138-C-T,rs3115378,1,C,T,8556138,115361,8244169,8637385,311969
4,ENSG00000035720.3,67558727,chr4-67606886-T-C,rs354885,1,T,C,67606886,48159,67362119,67755335,244767
4,ENSG00000145335.11,89837161,chr4-89770386-T-C,rs356188,-1,T,C,89770386,66775,89640553,90033769,129833
4,ENSG00000152990.9,22516066,chr4-22628328-T-C,rs35819520,-1,T,C,22628328,112262,22319458,22712674,308870
4,ENSG00000137463.4,139280225,chr4-139301685-G-A,rs3749516,-1,G,A,139301685,21460,139083617,139476833,218068
4,ENSG00000163297.12,80073229,chr4-80184608-T-C,rs3755913,-1,T,C,80184608,111379,79876621,80269837,307987
4,ENSG00000159733.9,2418645,chr4-2467872-C-G,rs3762830,-1,C,G,2467872,49227,2222037,2615253,245835
4,ENSG00000164114.13,155376965,chr4-155378888-C-T,rs3775255,-1,C,T,155378888,1923,155180357,155573573,198531
4,ENSG00000121895.7,39032409,chr4-39018574-T-G,rs3860068,-1,T,G,39018574,13835,38835801,39229017,182773
4,ENSG00000168824.10,4387102,chr4-4344700-G-A,rs3981,1,G,A,4344700,42402,4190494,4583710,154206
4,ENSG00000137449.10,15002481,chr4-14886482-G-A,rs41375747,1,G,A,14886482,115999,14805873,15199089,80609
4,ENSG00000173085.9,83284798,chr4-83322396-A-G,rs4328905,-1,A,G,83322396,37598,83088190,83481406,234206
4,ENSG00000197410.6,154491799,chr4-154500558-A-G,rs4345160,-1,A,G,154500558,8759,154295191,154688407,205367
4,ENSG00000145349.12,113761738,chr4-113838318-G-A,rs4426777,-1,G,A,113838318,76580,113565130,113958346,273188
4,ENSG00000127418.9,1011626,chr4-990021-C-T,rs4690221,1,C,T,990021,21605,815018,1208234,175003
4,ENSG00000145416.9,164384019,chr4-164553467-A-G,rs4691994,-1,A,G,164553467,169448,164187411,164580627,366056
4,ENSG00000154447.10,169270956,chr4-169315601-T-C,rs4692568,-1,T,C,169315601,44645,169074348,169467564,241253
4,ENSG00000138646.4,88457119,chr4-88524755-G-T,rs4693959,1,G,T,88524755,67636,88260511,88653727,264244
4,ENSG00000138642.9,88378852,chr4-88524755-G-T,rs4693959,1,G,T,88524755,145903,88182244,88575460,342511
4,ENSG00000163281.6,44726556,chr4-44631399-G-A,rs4694776,-1,G,A,44631399,95157,44529948,44923164,101451
4,ENSG00000169019.9,47463702,chr4-47283017-C-G,rs4695209,-1,C,G,47283017,180685,47267094,47660310,15923
4,ENSG00000071127.11,10116799,chr4-10143672-C-T,rs4697931,-1,C,T,10143672,26873,9920191,10313407,223481
4,ENSG00000123737.8,121801323,chr4-121767589-G-A,rs4833233,1,G,A,121767589,33734,121604715,121997931,162874
4,ENSG00000178403.3,112516180,chr4-112404754-G-A,rs4834273,-1,G,A,112404754,111426,112319572,112712788,85182
4,ENSG00000138744.8,75941013,chr4-75936235-C-T,rs4859572,-1,C,T,75936235,4778,75744405,76137621,191830
4,ENSG00000145386.5,121823883,chr4-121811061-T-G,rs5004355,-1,T,G,121811061,12822,121627275,122020491,183786
4,ENSG00000185477.3,89307800,chr4-89205955-G-A,rs55730628,-1,G,A,89205955,101845,89111192,89504408,94763
4,ENSG00000109794.9,186104704,chr4-186082605-T-G,rs5743317,1,T,G,186082605,22099,185908096,186301312,174509
4,ENSG00000138756.12,78776350,chr4-78601491-T-C,rs5943,1,T,C,78601491,174859,78579742,78972958,21749
4,ENSG00000013288.4,6575189,chr4-6614329-C-G,rs61729241,1,C,G,6614329,39140,6378581,6771797,235748
4,ENSG00000013288.4,6575189,chr4-6614329-C-T,rs61729241,1,C,T,6614329,39140,6378581,6771797,235748
4,ENSG00000173320.5,183905307,chr4-183888365-C-T,rs62340434,1,C,T,183888365,16942,183708699,184101915,179666
4,ENSG00000184305.9,90127394,chr4-89989779-G-A,rs6532210,1,G,A,89989779,137615,89930786,90324002,58993
4,ENSG00000163319.6,83456058,chr4-83443655-T-C,rs6535473,1,T,C,83443655,12403,83259450,83652666,184205
4,ENSG00000072840.8,5711201,chr4-5749526-C-T,rs6813121,1,C,T,5749526,38325,5514593,5907809,234933
4,ENSG00000072840.8,5711201,chr4-5749526-C-A,rs6813121,1,C,A,5749526,38325,5514593,5907809,234933
4,ENSG00000109436.7,140756385,chr4-140640199-G-T,rs6813507,-1,G,T,140640199,116186,140559777,140952993,80422
4,ENSG00000138670.10,81471907,chr4-81506692-A-C,rs6819303,-1,A,C,81506692,34785,81275299,81668515,231393
4,ENSG00000145362.11,113049653,chr4-112994491-G-A,rs6820742,1,G,A,112994491,55162,112853045,113246261,141446
4,ENSG00000152583.7,87529376,chr4-87409835-A-G,rs6827817,-1,A,G,87409835,119541,87332768,87725984,77067
4,ENSG00000218336.3,182243402,chr4-182102270-T-C,rs6830046,1,T,C,182102270,141132,182046794,182440010,55476
4,ENSG00000109689.10,26860841,chr4-26870838-G-A,rs6833053,1,G,A,26870838,9997,26664233,27057449,206605
4,ENSG00000168772.9,104494894,chr4-104625796-C-T,rs6835657,-1,C,T,104625796,130902,104298286,104691502,327510
4,ENSG00000109321.6,74445136,chr4-74283205-A-G,rs6835734,1,A,G,74283205,161931,74248528,74641744,34677
4,ENSG00000134851.7,55395957,chr4-55267462-C-T,rs6837397,1,C,T,55267462,128495,55199349,55592565,68113
4,ENSG00000163257.6,17810757,chr4-17852432-T-G,rs6842303,-1,T,G,17852432,41675,17614149,18007365,238283
4,ENSG00000128040.6,56821701,chr4-56882914-T-C,rs6848165,-1,T,C,56882914,61213,56625093,57018309,257821
4,ENSG00000138796.10,107989889,chr4-108038126-A-G,rs6851442,1,A,G,108038126,48237,107793281,108186497,244845
4,ENSG00000138796.10,107989889,chr4-108038126-A-C,rs6851442,1,A,C,108038126,48237,107793281,108186497,244845
4,ENSG00000197712.6,38867806,chr4-38876573-T-C,rs721653,1,T,C,38876573,8767,38671198,39064414,205375
4,ENSG00000186212.2,76898144,chr4-76935873-C-A,rs72665106,-1,C,A,76935873,37729,76701536,77094752,234337
4,ENSG00000186212.2,76898144,chr4-76935873-C-G,rs72665106,-1,C,G,76935873,37729,76701536,77094752,234337
4,ENSG00000168556.5,183505058,chr4-183521757-A-G,rs72689393,1,A,G,183521757,16699,183308450,183701666,213307
4,ENSG00000150627.9,176065841,chr4-176083775-C-G,rs72706340,1,C,G,176083775,17934,175869233,176262449,214542
4,ENSG00000178950.11,932316,chr4-954279-G-A,rs73209899,-1,G,A,954279,21963,735708,1128924,218571
4,ENSG00000174792.6,75556066,chr4-75392493-G-A,rs74475117,1,G,A,75392493,163573,75359458,75752674,33035
4,ENSG00000133256.8,625573,chr4-559461-G-A,rs74702339,1,G,A,559461,66112,428965,822181,130496
4,ENSG00000138640.10,89057185,chr4-89077890-A-G,rs756175,-1,A,G,89077890,20705,88860577,89253793,217313
4,ENSG00000250317.3,25914220,chr4-25934607-G-C,rs7656432,1,G,C,25934607,20387,25717612,26110828,216995
4,ENSG00000164144.10,152779954,chr4-152908101-A-G,rs7657803,1,A,G,152908101,128147,152583346,152976562,324755
4,ENSG00000078177.8,40056850,chr4-40041046-T-C,rs7660948,1,T,C,40041046,15804,39860242,40253458,180804
4,ENSG00000078177.8,40056850,chr4-40041046-T-G,rs7660948,1,T,G,40041046,15804,39860242,40253458,180804
4,ENSG00000163138.13,20700458,chr4-20659721-T-C,rs7662488,1,T,C,20659721,40737,20503850,20897066,155871
4,ENSG00000169116.7,74933116,chr4-75061212-T-G,rs7662998,1,T,G,75061212,128096,74736508,75129724,324704
4,ENSG00000061918.8,155759021,chr4-155610180-A-C,rs7667749,1,A,C,155610180,148841,155562413,155955629,47767
4,ENSG00000198189.6,87391188,chr4-87427870-G-T,rs7673763,-1,G,T,87427870,36682,87194580,87587796,233290
4,ENSG00000170801.5,8269754,chr4-8080144-G-A,rs7676911,1,G,A,8080144,189610,8073146,8466362,6998
4,ENSG00000197386.6,3074681,chr4-3027896-A-G,rs7677445,1,A,G,3027896,46785,2878073,3271289,149823
4,ENSG00000169299.8,37826686,chr4-37783078-T-G,rs7679058,1,T,G,37783078,43608,37630078,38023294,153000
4,ENSG00000164111.9,121696980,chr4-121702910-T-C,rs7680787,-1,T,C,121702910,5930,121500372,121893588,202538
4,ENSG00000168228.9,25312774,chr4-25309802-C-T,rs7689775,1,C,T,25309802,2972,25116166,25509382,193636
4,ENSG00000250312.2,124501,chr4-204819-A-C,rs7690900,1,A,C,204819,80318,-72107,321109,276926
4,ENSG00000170365.5,145481853,chr4-145514998-A-C,rs7694086,1,A,C,145514998,33145,145285245,145678461,229753
4,ENSG00000123933.9,2262109,chr4-2288264-T-C,rs7695321,-1,T,C,2288264,26155,2065501,2458717,222763
4,ENSG00000189157.8,76251721,chr4-76356337-T-C,rs77855175,1,T,C,76356337,104616,76055113,76448329,301224
4,ENSG00000164118.8,174283911,chr4-174102391-A-G,rs78227195,1,A,G,174102391,181520,174087303,174480519,15088
4,ENSG00000164303.6,184217873,chr4-184363983-G-A,rs78715035,-1,G,A,184363983,146110,184021265,184414481,342718
4,ENSG00000145348.11,106316209,chr4-106126587-T-G,rs79150233,-1,T,G,106126587,189622,106119601,106512817,6986
4,ENSG00000182552.10,183659185,chr4-183551637-A-G,rs79219333,-1,A,G,183551637,107548,183462577,183855793,89060
4,ENSG00000085871.4,139665819,chr4-139678977-C-A,rs795588,1,C,A,139678977,13158,139469211,139862427,209766
4,ENSG00000198856.8,108650599,chr4-108525913-T-G,rs79765393,1,T,G,108525913,124686,108453991,108847207,71922
4,ENSG00000174137.8,1684313,chr4-1728572-A-G,rs798759,-1,A,G,1728572,44259,1487705,1880921,240867
4,ENSG00000090316.10,1289891,chr4-1218000-G-A,rs80061036,1,G,A,1218000,71891,1093283,1486499,124717
4,ENSG00000163743.9,75514403,chr4-75355634-C-T,rs80276888,-1,C,T,75355634,158769,75317795,75711011,37839
4,ENSG00000087008.10,8440723,chr4-8367142-C-T,rs827000,-1,C,T,8367142,73581,8244115,8637331,123027
4,ENSG00000087008.10,8440723,chr4-8367142-C-A,rs827000,-1,C,A,8367142,73581,8244115,8637331,123027
4,ENSG00000091490.6,25862988,chr4-25911533-C-T,rs878552,-1,C,T,25911533,48545,25666380,26059596,245153
4,ENSG00000137441.7,15963175,chr4-16071598-A-C,rs908645,-1,A,C,16071598,108423,15766567,16159783,305031
4,ENSG00000157426.8,56387491,chr4-56329989-C-T,rs939293,-1,C,T,56329989,57502,56190883,56584099,139106
4,ENSG00000109519.7,7068064,chr4-7048650-C-A,rs9985704,-1,C,A,7048650,19414,6871456,7264672,177194
4,ENSG00000121211.3,153344688,chr4-153214305-A-G,rs9997214,1,A,G,153214305,130383,153148080,153541296,66225
4,ENSG00000018189.7,70721964,chr4-70870948-G-A,rs10004288,1,G,A,70870948,148984,70525356,70918572,345592
4,ENSG00000137462.6,153684280,chr4-153652099-A-T,rs10007443,1,A,T,153652099,32181,153487672,153880888,164427
4,ENSG00000109519.7,7068064,chr4-7022671-A-T,rs10012590,-1,A,T,7022671,45393,6871456,7264672,151215
4,ENSG00000109519.7,7068064,chr4-7022671-A-G,rs10012590,-1,A,G,7022671,45393,6871456,7264672,151215
4,ENSG00000138771.9,76435229,chr4-76622579-C-T,rs10014906,1,C,T,76622579,187350,76238621,76631837,383958
4,ENSG00000121897.9,39459056,chr4-39521375-A-G,rs10025178,1,A,G,39521375,62319,39262448,39655664,258927
4,ENSG00000173011.10,7043372,chr4-6925744-T-G,rs10025565,1,T,G,6925744,117628,6846764,7239980,78980
4,ENSG00000174130.7,38856817,chr4-38766912-A-G,rs10470854,-1,A,G,38766912,89905,38660209,39053425,106703
4,ENSG00000145358.2,100190468,chr4-100186119-C-A,rs1063821,-1,C,A,100186119,4349,99993860,100387076,192259
4,ENSG00000168826.11,4290251,chr4-4300922-C-G,rs10937863,1,C,G,4300922,10671,4093643,4486859,207279
4,ENSG00000163132.6,4859665,chr4-4790522-C-T,rs10937891,1,C,T,4790522,69143,4663057,5056273,127465
4,ENSG00000138640.10,89057185,chr4-88958061-C-T,rs1104633,-1,C,T,88958061,99124,88860577,89253793,97484
4,ENSG00000145365.8,112285904,chr4-112300458-A-G,rs11098149,-1,A,G,112300458,14554,112089296,112482512,211162
4,ENSG00000205097.2,190027256,chr4-189872692-G-A,rs11132767,-1,G,A,189872692,154564,189830648,190223864,42044
4,ENSG00000174792.6,75556066,chr4-75635772-C-T,rs113133062,1,C,T,75635772,79706,75359458,75752674,276314
4,ENSG00000174792.6,75556066,chr4-75635772-C-A,rs113133062,1,C,A,75635772,79706,75359458,75752674,276314
4,ENSG00000174125.3,38804791,chr4-38774173-A-G,rs11466657,-1,A,G,38774173,30618,38608183,39001399,165990
4,ENSG00000138641.10,88592480,chr4-88466413-T-C,rs114876930,1,T,C,88466413,126067,88395872,88789088,70541
4,ENSG00000145247.7,48906774,chr4-48718716-A-G,rs115097924,-1,A,G,48718716,188058,48710166,49103382,8550
4,ENSG00000109686.11,151325605,chr4-151314214-G-A,rs11723291,-1,G,A,151314214,11391,151128997,151522213,185217
4,ENSG00000109466.9,165207561,chr4-165301869-G-A,rs11723812,1,G,A,165301869,94308,165010953,165404169,290916
4,ENSG00000090989.13,55853648,chr4-55759302-A-G,rs11725155,1,A,G,55759302,94346,55657040,56050256,102262
4,ENSG00000250312.2,124501,chr4-231159-T-C,rs11726829,1,T,C,231159,106658,-72107,321109,303266
4,ENSG00000138801.4,107720234,chr4-107750567-C-T,rs11732603,-1,C,T,107750567,30333,107523626,107916842,226941
4,ENSG00000255072.1,88523776,chr4-88374011-T-C,rs11733230,-1,T,C,88374011,149765,88327168,88720384,46843
4,ENSG00000164104.7,173334358,chr4-173209341-G-A,rs11932721,-1,G,A,173209341,125017,173137750,173530966,71591
4,ENSG00000109814.7,39527439,chr4-39413373-A-G,rs11940694,-1,A,G,39413373,114066,39330831,39724047,82542
4,ENSG00000163104.12,94207865,chr4-94336804-A-G,rs11947921,1,A,G,94336804,128939,94011257,94404473,325547
4,ENSG00000163104.12,94207865,chr4-94336804-A-C,rs11947921,1,A,C,94336804,128939,94011257,94404473,325547
4,ENSG00000185774.9,21948772,chr4-21976085-G-A,rs12505172,-1,G,A,21976085,27313,21752164,22145380,223921
4,ENSG00000145390.6,119212713,chr4-119053385-C-T,rs12506805,1,C,T,119053385,159328,119016105,119409321,37280
4,ENSG00000164306.6,184649738,chr4-184650622-C-T,rs12507711,1,C,T,184650622,884,184453130,184846346,197492
4,ENSG00000256043.2,155953866,chr4-155923244-C-T,rs12509679,-1,C,T,155923244,30622,155757258,156150474,165986
4,ENSG00000175920.11,3463306,chr4-3489151-C-T,rs12510300,1,C,T,3489151,25845,3266698,3659914,222453
4,ENSG00000174473.10,171813404,chr4-171879872-C-T,rs13101636,1,C,T,171879872,66468,171616796,172010012,263076
4,ENSG00000169245.4,76023497,chr4-75841938-C-G,rs13435679,-1,C,G,75841938,181559,75826889,76220105,15049
4,ENSG00000137441.7,15963175,chr4-16107473-T-C,rs1443367,-1,T,C,16107473,144298,15766567,16159783,340906
4,ENSG00000145439.7,169010255,chr4-169014730-G-A,rs1458292,-1,G,A,169014730,4475,168813647,169206863,201083
4,ENSG00000151729.5,185143266,chr4-185124584-G-A,rs1486668,1,G,A,185124584,18682,184946658,185339874,177926
4,ENSG00000163281.6,44726556,chr4-44783372-G-T,rs1491313,-1,G,T,44783372,56816,44529948,44923164,253424
4,ENSG00000157426.8,56387491,chr4-56434391-C-T,rs1520026,-1,C,T,56434391,46900,56190883,56584099,243508
4,ENSG00000138821.8,102345482,chr4-102216820-A-G,rs1540052,-1,A,G,102216820,128662,102148874,102542090,67946
4,ENSG00000170801.5,8269754,chr4-8253057-C-T,rs1678336,1,C,T,8253057,16697,8073146,8466362,179911
4,ENSG00000145246.8,47485275,chr4-47572450-A-C,rs16860387,1,A,C,47572450,87175,47288667,47681883,283783
4,ENSG00000078177.8,40056850,chr4-40211942-G-A,rs16995625,1,G,A,40211942,155092,39860242,40253458,351700
4,ENSG00000164040.10,128287813,chr4-128392498-A-G,rs17013258,-1,A,G,128392498,104685,128091205,128484421,301293
4,ENSG00000168772.9,104494894,chr4-104657130-A-G,rs17034785,-1,A,G,104657130,162236,104298286,104691502,358844
4,ENSG00000134852.10,55546909,chr4-55592309-A-G,rs17085929,-1,A,G,55592309,45400,55350301,55743517,242008
4,ENSG00000109265.7,56049098,chr4-55913916-A-G,rs17086165,1,A,G,55913916,135182,55852490,56245706,61426
4,ENSG00000109685.13,1871393,chr4-1941444-G-A,rs17132088,1,G,A,1941444,70051,1674785,2068001,266659
4,ENSG00000168924.9,1856156,chr4-1982757-T-C,rs17132112,-1,T,C,1982757,126601,1659548,2052764,323209
4,ENSG00000133256.8,625573,chr4-819605-C-T,rs17165046,1,C,T,819605,194032,428965,822181,390640
4,ENSG00000052795.8,158769026,chr4-158833208-T-C,rs17285772,1,T,C,158833208,64182,158572418,158965634,260790
4,ENSG00000172403.6,118888854,chr4-119040950-A-G,rs17330202,1,A,G,119040950,152096,118692246,119085462,348704
4,ENSG00000145241.6,67545503,chr4-67401719-C-T,rs17428139,-1,C,T,67401719,143784,67348895,67742111,52824
4,ENSG00000169299.8,37826686,chr4-37766693-G-T,rs17578289,1,G,T,37766693,59993,37630078,38023294,136615
4,ENSG00000163071.6,52051304,chr4-52129893-A-C,rs17612170,1,A,C,52129893,78589,51854696,52247912,275197
4,ENSG00000197712.6,38867806,chr4-38811255-T-C,rs17616434,1,T,C,38811255,56551,38671198,39064414,140057
4,ENSG00000178343.4,42397488,chr4-42447664-A-G,rs17630450,1,A,G,42447664,50176,42200880,42594096,246784
4,ENSG00000168818.5,4542048,chr4-4636851-G-T,rs17706055,-1,G,T,4636851,94803,4345440,4738656,291411
4,ENSG00000154447.10,169270956,chr4-169131495-T-C,rs1976543,-1,T,C,169131495,139461,169074348,169467564,57147
4,ENSG00000002549.7,17577198,chr4-17727174-C-T,rs2024160,1,C,T,17727174,149976,17380590,17773806,346584
4,ENSG00000150627.9,176065841,chr4-176195758-G-C,rs2170577,1,G,C,176195758,129917,175869233,176262449,326525
4,ENSG00000150627.9,176065841,chr4-176195758-G-T,rs2170577,1,G,T,176195758,129917,175869233,176262449,326525
4,ENSG00000174137.8,1684313,chr4-1702815-T-G,rs2236995,-1,T,G,1702815,18502,1487705,1880921,215110
4,ENSG00000174137.8,1684313,chr4-1702815-T-C,rs2236995,-1,T,C,1702815,18502,1487705,1880921,215110
4,ENSG00000145214.9,973569,chr4-882099-G-A,rs2279186,-1,G,A,882099,91470,776961,1170177,105138
4,ENSG00000109805.5,17810979,chr4-17817262-T-C,rs2302212,1,T,C,17817262,6283,17614371,18007587,202891
4,ENSG00000164111.9,121696980,chr4-121696533-T-C,rs2306416,-1,T,C,121696533,447,121500372,121893588,196161
4,ENSG00000198498.5,163494690,chr4-163486448-T-C,rs2320618,1,T,C,163486448,8242,163298082,163691298,188366
4,ENSG00000087008.10,8440723,chr4-8330330-C-T,rs2386219,-1,C,T,8330330,110393,8244115,8637331,86215
4,ENSG00000151552.7,17512090,chr4-17471111-G-T,rs2597749,-1,G,T,17471111,40979,17315482,17708698,155629
4,ENSG00000138722.5,89894854,chr4-89812518-A-G,rs2619369,1,A,G,89812518,82336,89698246,90091462,114272
4,ENSG00000155275.14,8440777,chr4-8459790-T-C,rs2631749,1,T,C,8459790,19013,8244169,8637385,215621
4,ENSG00000118816.5,77075989,chr4-76921367-G-A,rs2703108,-1,G,A,76921367,154622,76879381,77272597,41986
4,ENSG00000196620.4,68670652,chr4-68482946-A-G,rs2708695,-1,A,G,68482946,187706,68474044,68867260,8902
4,ENSG00000197888.2,68576322,chr4-68482946-A-G,rs2708695,-1,A,G,68482946,93376,68379714,68772930,103232
4,ENSG00000121895.7,39032409,chr4-39134753-G-T,rs28396323,-1,G,T,39134753,102344,38835801,39229017,298952
4,ENSG00000138685.7,122826831,chr4-122854222-A-G,rs28544074,1,A,G,122854222,27391,122630223,123023439,223999
4,ENSG00000186212.2,76898144,chr4-77024017-C-T,rs28572498,-1,C,T,77024017,125873,76701536,77094752,322481
4,ENSG00000132406.7,4248223,chr4-4194719-A-G,rs2920172,-1,A,G,4194719,53504,4051615,4444831,143104
4,ENSG00000157404.10,54657957,chr4-54773381-A-G,rs3109915,1,A,G,54773381,115424,54461349,54854565,312032
4,ENSG00000145476.10,186191567,chr4-186191156-G-A,rs35641294,1,G,A,186191156,411,185994959,186388175,196197
4,ENSG00000123737.8,121801323,chr4-121900007-T-C,rs3749475,1,T,C,121900007,98684,121604715,121997931,295292
4,ENSG00000152784.9,80197503,chr4-80182408-G-A,rs3755912,1,G,A,80182408,15095,80000895,80394111,181513
4,ENSG00000118564.10,15655357,chr4-15833863-G-T,rs3796864,-1,G,T,15833863,178506,15458749,15851965,375114
4,ENSG00000248144.1,99352746,chr4-99279352-C-T,rs3819197,-1,C,T,99279352,73394,99156138,99549354,123214
4,ENSG00000163110.10,94451942,chr4-94484688-G-A,rs41328444,1,G,A,94484688,32746,94255334,94648550,229354
4,ENSG00000197410.6,154491799,chr4-154517187-A-G,rs4235247,-1,A,G,154517187,25388,154295191,154688407,221996
4,ENSG00000178163.3,10457426,chr4-10437905-C-T,rs4235362,-1,C,T,10437905,19521,10260818,10654034,177087
4,ENSG00000168491.5,185471733,chr4-185480477-T-C,rs4241802,-1,T,C,185480477,8744,185275125,185668341,205352
4,ENSG00000145349.12,113761738,chr4-113943935-T-C,rs4364328,-1,T,C,113943935,182197,113565130,113958346,378805
4,ENSG00000171476.16,56681296,chr4-56663420-A-G,rs4365784,-1,A,G,56663420,17876,56484688,56877904,178732
4,ENSG00000109501.8,6269850,chr4-6149527-C-T,rs4560489,1,C,T,6149527,120323,6073242,6466458,76285
4,ENSG00000109684.9,10684768,chr4-10673406-C-T,rs4697777,-1,C,T,10673406,11362,10488160,10881376,185246
4,ENSG00000189157.8,76251721,chr4-76286954-G-A,rs4859442,1,G,A,76286954,35233,76055113,76448329,231841
4,ENSG00000163738.13,74158118,chr4-74090399-T-C,rs549967,1,T,C,74090399,67719,73961510,74354726,128889
4,ENSG00000236699.3,105552620,chr4-105666159-T-C,rs56277608,1,T,C,105666159,113539,105356012,105749228,310147
4,ENSG00000138755.5,76007509,chr4-75924115-T-C,rs58239288,-1,T,C,75924115,83394,75810901,76204117,113214
4,ENSG00000178222.8,1113564,chr4-1024420-G-A,rs58679007,-1,G,A,1024420,89144,916956,1310172,107464
4,ENSG00000163138.13,20700458,chr4-20592051-G-C,rs61790708,1,G,C,20592051,108407,20503850,20897066,88201
4,ENSG00000138777.15,105474062,chr4-105436578-G-A,rs62317260,-1,G,A,105436578,37484,105277454,105670670,159124
4,ENSG00000013288.4,6575189,chr4-6607129-T-C,rs6446514,1,T,C,6607129,31940,6378581,6771797,228548
4,ENSG00000183423.6,109848107,chr4-109879276-G-C,rs6533472,1,G,C,109879276,31169,109651499,110044715,227777
4,ENSG00000073331.12,112297369,chr4-112423991-A-G,rs6533616,1,A,G,112423991,126622,112100761,112493977,323230
4,ENSG00000168214.16,26321014,chr4-26190822-G-A,rs6817712,1,G,A,26190822,130192,26124406,26517622,66416
4,ENSG00000138744.8,75941013,chr4-75917955-C-T,rs6819442,-1,C,T,75917955,23058,75744405,76137621,173550
4,ENSG00000171234.9,69096474,chr4-69062924-T-C,rs6820734,1,T,C,69062924,33550,68899866,69293082,163058
4,ENSG00000109163.6,67754388,chr4-67712136-A-G,rs6824220,-1,A,G,67712136,42252,67557780,67950996,154356
4,ENSG00000198189.6,87391188,chr4-87409835-A-G,rs6827817,-1,A,G,87409835,18647,87194580,87587796,215255
4,ENSG00000091490.6,25862988,chr4-25861753-G-T,rs6831024,-1,G,T,25861753,1235,25666380,26059596,195373
4,ENSG00000127418.9,1011626,chr4-1002377-G-A,rs6831280,1,G,A,1002377,9249,815018,1208234,187359
4,ENSG00000174607.6,114598807,chr4-114623558-A-G,rs6851610,1,A,G,114623558,24751,114402199,114795415,221359
4,ENSG00000151726.8,184825968,chr4-184851771-G-A,rs6852527,-1,G,A,184851771,25803,184629360,185022576,222411
4,ENSG00000056050.6,169757944,chr4-169733497-A-G,rs6854083,-1,A,G,169733497,24447,169561336,169954552,172161
4,ENSG00000163956.6,3532422,chr4-3600382-G-A,rs6856283,-1,G,A,3600382,67960,3335814,3729030,264568
4,ENSG00000168564.5,183444636,chr4-183520494-A-G,rs72689391,1,A,G,183520494,75858,183248028,183641244,272466
4,ENSG00000150625.12,175812264,chr4-175937989-T-G,rs72704546,-1,T,G,175937989,125725,175615656,176008872,322333
4,ENSG00000150625.12,175812264,chr4-175937989-T-C,rs72704546,-1,T,C,175937989,125725,175615656,176008872,322333
4,ENSG00000181826.5,37686376,chr4-37656878-A-G,rs73147230,-1,A,G,37656878,29498,37489768,37882984,167110
4,ENSG00000168421.7,40197031,chr4-40202430-T-C,rs73808637,1,T,C,40202430,5399,40000423,40393639,202007
4,ENSG00000109436.7,140756385,chr4-140812625-G-A,rs73859322,-1,G,A,140812625,56240,140559777,140952993,252848
4,ENSG00000164303.6,184217873,chr4-184217993-A-G,rs73872825,-1,A,G,184217993,120,184021265,184414481,196728
4,ENSG00000128050.4,56436260,chr4-56434764-T-C,rs7435941,1,T,C,56434764,1496,56239652,56632868,195112
4,ENSG00000154553.8,185535507,chr4-185603334-G-A,rs74702790,-1,G,A,185603334,67827,185338899,185732115,264435
4,ENSG00000189184.7,137532494,chr4-137478117-G-A,rs75682440,-1,G,A,137478117,54377,137335886,137729102,142231
4,ENSG00000063978.10,2469106,chr4-2314753-G-A,rs762837,1,G,A,2314753,154353,2272498,2665714,42255
4,ENSG00000109790.11,39062232,chr4-39140797-G-A,rs76510496,1,G,A,39140797,78565,38865624,39258840,275173
4,ENSG00000163633.6,86892422,chr4-86930956-G-T,rs7657530,-1,G,T,86930956,38534,86695814,87089030,235142
4,ENSG00000197465.8,143905559,chr4-143711068-A-G,rs76600473,-1,A,G,143711068,194491,143708951,144102167,2117
4,ENSG00000196782.7,140154184,chr4-140196045-A-C,rs7665091,-1,A,C,140196045,41861,139957576,140350792,238469
4,ENSG00000125388.14,2963571,chr4-2952990-G-A,rs7667661,1,G,A,2952990,10581,2766963,3160179,186027
4,ENSG00000074966.6,48134250,chr4-48253039-T-C,rs7669018,-1,T,C,48253039,118789,47937642,48330858,315397
4,ENSG00000185477.3,89307800,chr4-89297070-G-A,rs7671122,-1,G,A,89297070,10730,89111192,89504408,185878
4,ENSG00000250317.3,25914220,chr4-25880255-C-T,rs7681279,1,C,T,25880255,33965,25717612,26110828,162643
4,ENSG00000038002.4,177442437,chr4-177443649-T-C,rs7682705,-1,T,C,177443649,1212,177245829,177639045,197820
4,ENSG00000109220.6,54064605,chr4-53891428-A-G,rs7683360,-1,A,G,53891428,173177,53867997,54261213,23431
4,ENSG00000109133.8,41935429,chr4-42108378-A-T,rs7692068,1,A,T,42108378,172949,41738821,42132037,369557
4,ENSG00000169019.9,47463702,chr4-47655071-C-G,rs77315097,-1,C,G,47655071,191369,47267094,47660310,387977
4,ENSG00000145348.11,106316209,chr4-106152764-G-A,rs78104935,-1,G,A,106152764,163445,106119601,106512817,33163
4,ENSG00000109189.7,52659301,chr4-52810167-A-G,rs78157039,-1,A,G,52810167,150866,52462693,52855909,347474
4,ENSG00000151611.8,145619385,chr4-145452738-A-G,rs78243498,1,A,G,145452738,166647,145422777,145815993,29961
4,ENSG00000164117.7,174283667,chr4-174157271-G-A,rs79596331,-1,G,A,174157271,126396,174087059,174480275,70212
4,ENSG00000138823.7,99574824,chr4-99503048-C-T,rs79623823,1,C,T,99503048,71776,99378216,99771432,124832
4,ENSG00000085871.4,139665819,chr4-139664596-A-C,rs8192002,1,A,C,139664596,1223,139469211,139862427,195385
4,ENSG00000159733.9,2418645,chr4-2463577-G-A,rs846252,-1,G,A,2463577,44932,2222037,2615253,241540
4,ENSG00000154556.13,185656969,chr4-185809294-T-C,rs878357,-1,T,C,185809294,152325,185460361,185853577,348933
4,ENSG00000151725.6,184734096,chr4-184734017-C-T,rs902174,-1,C,T,184734017,79,184537488,184930704,196529
4,ENSG00000170509.7,87322882,chr4-87459928-T-C,rs9968511,-1,T,C,87459928,137046,87126274,87519490,333654
4,ENSG00000138795.5,108168932,chr4-108274141-G-T,rs9996699,-1,G,T,108274141,105209,107972324,108365540,301817
4,ENSG00000138795.5,108168932,chr4-108274141-G-A,rs9996699,-1,G,A,108274141,105209,107972324,108365540,301817
4,ENSG00000118777.6,88158639,chr4-88152045-A-C,rs9999111,-1,A,C,88152045,6594,87962031,88355247,190014
3,ENSG00000206535.3,100401539,chr3-100403237-C-T,rs1036769,1,C,T,100403237,1698,100204931,100598147,198306
3,ENSG00000010322.10,52455604,chr3-52307110-G-A,rs10461027,1,G,A,52307110,148494,52258996,52652212,48114
3,ENSG00000154767.9,14178601,chr3-14143219-T-C,rs10468,-1,T,C,14143219,35382,13981993,14375209,161226
3,ENSG00000077092.13,25428263,chr3-25561241-G-C,rs10510568,1,G,C,25561241,132978,25231655,25624871,329586
3,ENSG00000163931.10,53256022,chr3-53363454-C-T,rs10510763,-1,C,T,53363454,107432,53059414,53452630,304040
3,ENSG00000154165.3,98531978,chr3-98573022-G-T,rs10511168,1,G,T,98573022,41044,98335370,98728586,237652
3,ENSG00000180353.6,121660903,chr3-121849748-C-T,rs10511407,-1,C,T,121849748,188845,121464295,121857511,385453
3,ENSG00000175040.4,143119771,chr3-143169562-G-T,rs10513192,1,G,T,143169562,49791,142923163,143316379,246399
3,ENSG00000058056.4,179653040,chr3-179529397-G-A,rs10513760,1,G,A,179529397,123643,179456432,179849648,72965
3,ENSG00000114446.4,108222424,chr3-108302447-G-A,rs10933936,-1,G,A,108302447,80023,108025816,108419032,276631
3,ENSG00000178750.2,94028597,chr3-94093949-G-T,rs10934674,-1,G,T,94093949,65352,93831989,94225205,261960
3,ENSG00000091513.10,133746393,chr3-133564240-G-A,rs10935069,1,G,A,133564240,182153,133549785,133943001,14455
3,ENSG00000175193.8,183884880,chr3-183845137-G-A,rs10937153,-1,G,A,183845137,39743,183688272,184081488,156865
3,ENSG00000182580.2,184561785,chr3-184576552-T-C,rs111611525,1,T,C,184576552,14767,184365177,184758393,211375
3,ENSG00000132170.15,12289070,chr3-12333892-T-C,rs1122648,1,T,C,12333892,44822,12092462,12485678,241430
3,ENSG00000144827.4,111979026,chr3-111992747-A-G,rs1127853,1,A,G,111992747,13721,111782418,112175634,210329
3,ENSG00000163576.13,19934217,chr3-19946047-G-T,rs1133328,-1,G,T,19946047,11830,19737609,20130825,208438
3,ENSG00000173226.12,121835060,chr3-121788384-A-T,rs1141528,-1,A,T,121788384,46676,121638452,122031668,149932
3,ENSG00000134070.4,10164919,chr3-10192381-G-A,rs1144911,1,G,A,10192381,27462,9968311,10361527,224070
3,ENSG00000131375.5,15206246,chr3-15349904-C-A,rs114570696,1,C,A,15349904,143658,15009638,15402854,340266
3,ENSG00000131375.5,15206246,chr3-15349904-C-T,rs114570696,1,C,T,15349904,143658,15009638,15402854,340266
3,ENSG00000163428.3,120349354,chr3-120367443-G-A,rs1147688,-1,G,A,120367443,18089,120152746,120545962,214697
3,ENSG00000154783.6,14818962,chr3-14999695-G-A,rs114914052,1,G,A,14999695,180733,14622354,15015570,377341
3,ENSG00000114019.10,134374447,chr3-134299939-G-A,rs114991340,-1,G,A,134299939,74508,134177839,134571055,122100
3,ENSG00000114019.10,134374447,chr3-134299939-G-C,rs114991340,-1,G,C,134299939,74508,134177839,134571055,122100
3,ENSG00000080200.5,97822011,chr3-97941240-C-T,rs11544446,1,C,T,97941240,119229,97625403,98018619,315837
3,ENSG00000196220.9,9249646,chr3-9365020-G-A,rs11547584,-1,G,A,9365020,115374,9053038,9446254,311982
3,ENSG00000134072.6,9769947,chr3-9690321-T-C,rs115679775,-1,T,C,9690321,79626,9573339,9966555,116982
3,ENSG00000114126.13,142149544,chr3-142012868-G-A,rs11569181,-1,G,A,142012868,136676,141952936,142346152,59932
3,ENSG00000131389.12,14402606,chr3-14495227-G-A,rs116285841,1,G,A,14495227,92621,14205998,14599214,289229
3,ENSG00000131389.12,14402606,chr3-14495227-G-T,rs116285841,1,G,T,14495227,92621,14205998,14599214,289229
3,ENSG00000144711.8,13073429,chr3-13224683-G-A,rs11707839,-1,G,A,13224683,151254,12876821,13270037,347862
3,ENSG00000169087.6,122793831,chr3-122687418-C-A,rs11711456,-1,C,A,122687418,106413,122597223,122990439,90195
3,ENSG00000168334.8,39192595,chr3-39186552-T-G,rs11711871,-1,T,G,39186552,6043,38995987,39389203,190565
3,ENSG00000164045.7,48188417,chr3-47998793-C-T,rs11711953,-1,C,T,47998793,189624,47991809,48385025,6984
3,ENSG00000126062.3,50359521,chr3-50407420-C-T,rs11712474,-1,C,T,50407420,47899,50162913,50556129,244507
3,ENSG00000145194.13,184276022,chr3-184443627-C-A,rs11718215,1,C,A,184443627,167605,184079414,184472630,364213
3,ENSG00000144635.4,32570858,chr3-32541243-C-T,rs11919477,-1,C,T,32541243,29615,32374250,32767466,166993
3,ENSG00000154813.5,16264943,chr3-16363200-T-G,rs11919705,-1,T,G,16363200,98257,16068335,16461551,294865
3,ENSG00000082781.6,124887365,chr3-125050952-C-T,rs11921016,-1,C,T,125050952,163587,124690757,125083973,360195
3,ENSG00000198843.8,150603321,chr3-150537598-A-G,rs11921309,1,A,G,150537598,65723,150406713,150799929,130885
3,ENSG00000174500.8,112133248,chr3-112294699-C-T,rs12491414,-1,C,T,112294699,161451,111936640,112329856,358059
3,ENSG00000154174.6,100401089,chr3-100364013-C-G,rs12591,-1,C,G,100364013,37076,100204481,100597697,159532
3,ENSG00000163320.6,88059005,chr3-88122078-A-C,rs12629581,-1,A,C,88122078,63073,87862397,88255613,259681
3,ENSG00000011376.5,45388576,chr3-45518621-A-G,rs12630693,1,A,G,45518621,130045,45191968,45585184,326653
3,ENSG00000196542.4,161371517,chr3-161189375-T-C,rs12634256,-1,T,C,161189375,182142,161174909,161568125,14466
3,ENSG00000119227.3,196968833,chr3-196948008-A-G,rs12636891,-1,A,G,196948008,20825,196772225,197165441,175783
3,ENSG00000161217.6,196287726,chr3-196278573-G-A,rs12637288,-1,G,A,196278573,9153,196091118,196484334,187455
3,ENSG00000198919.7,108589722,chr3-108689767-C-T,rs13059124,1,C,T,108689767,100045,108393114,108786330,296653
3,ENSG00000177646.12,128879620,chr3-128791751-A-G,rs13065032,1,A,G,128791751,87869,128683012,129076228,108739
3,ENSG00000164054.10,48504174,chr3-48436629-T-C,rs13069724,-1,T,C,48436629,67545,48307566,48700782,129063
3,ENSG00000114450.5,179451470,chr3-179274163-C-T,rs13076233,-1,C,T,179274163,177307,179254862,179648078,19301
3,ENSG00000168356.7,39051944,chr3-39034229-C-T,rs13087954,-1,C,T,39034229,17715,38855336,39248552,178893
3,ENSG00000244607.1,42773253,chr3-42771455-C-T,rs13090185,-1,C,T,42771455,1798,42576645,42969861,194810
3,ENSG00000163755.4,149129638,chr3-149197375-A-G,rs13095262,1,A,G,149197375,67737,148933030,149326246,264345
3,ENSG00000047457.9,149221829,chr3-149227783-G-A,rs13096289,-1,G,A,149227783,5954,149025221,149418437,202562
3,ENSG00000182568.11,18425339,chr3-18441066-T-C,rs1328542,-1,T,C,18441066,15727,18228731,18621947,212335
3,ENSG00000230301.3,98264244,chr3-98239791-A-C,rs13321188,1,A,C,98239791,24453,98067636,98460852,172155
3,ENSG00000174013.7,196568660,chr3-196559784-T-C,rs1355533,1,T,C,196559784,8876,196372052,196765268,187732
3,ENSG00000136521.8,179604794,chr3-179480486-T-C,rs1362644,1,T,C,179480486,124308,179408186,179801402,72300
3,ENSG00000164078.7,49903873,chr3-49722606-T-C,rs1466685,-1,T,C,49722606,181267,49707265,50100481,15341
3,ENSG00000075975.11,12557087,chr3-12538445-G-T,rs1466835,1,G,T,12538445,18642,12360479,12753695,177966
3,ENSG00000144843.7,119579492,chr3-119581808-G-A,rs1485331,1,G,A,119581808,2316,119382884,119776100,198924
3,ENSG00000163607.8,112990984,chr3-112992524-G-A,rs1488189,1,G,A,112992524,1540,112794376,113187592,198148
3,ENSG00000145020.10,49422473,chr3-49602370-G-T,rs1491983,-1,G,T,49602370,179897,49225865,49619081,376505
3,ENSG00000152952.7,146161184,chr3-146194512-C-A,rs1512902,-1,C,A,146194512,33328,145964576,146357792,229936
3,ENSG00000152952.7,146161184,chr3-146194512-C-T,rs1512902,-1,C,T,146194512,33328,145964576,146357792,229936
3,ENSG00000093217.5,38346785,chr3-38340857-C-A,rs151629,1,C,A,38340857,5928,38150177,38543393,190680
3,ENSG00000073711.6,135965728,chr3-136023525-A-G,rs1523594,1,A,G,136023525,57797,135769120,136162336,254405
3,ENSG00000197584.6,178536436,chr3-178644895-C-A,rs1542526,1,C,A,178644895,108459,178339828,178733044,305067
3,ENSG00000168827.9,158644527,chr3-158556233-C-A,rs1656372,1,C,A,158556233,88294,158447919,158841135,108314
3,ENSG00000168827.9,158644527,chr3-158556233-C-T,rs1656372,1,C,T,158556233,88294,158447919,158841135,108314
3,ENSG00000177565.10,177197482,chr3-177074378-G-A,rs1681655,-1,G,A,177074378,123104,177000874,177394090,73504
3,ENSG00000213186.3,160449786,chr3-160605934-G-A,rs16831286,-1,G,A,160605934,156148,160253178,160646394,352756
3,ENSG00000114423.14,105869012,chr3-105687301-C-T,rs16851443,-1,C,T,105687301,181711,105672404,106065620,14897
3,ENSG00000018408.10,149658025,chr3-149604261-G-A,rs16862021,-1,G,A,149604261,53764,149461417,149854633,142844
3,ENSG00000144893.8,151085664,chr3-151185335-G-A,rs16863238,1,G,A,151185335,99671,150889056,151282272,296279
3,ENSG00000144677.10,37861880,chr3-37776619-A-G,rs17036944,1,A,G,37776619,85261,37665272,38058488,111347
3,ENSG00000157036.8,38496340,chr3-38517724-A-G,rs17037804,1,A,G,38517724,21384,38299732,38692948,217992
3,ENSG00000163634.7,63863805,chr3-64022828-C-T,rs17069700,-1,C,T,64022828,159023,63667197,64060413,355631
3,ENSG00000160746.8,43622011,chr3-43533870-T-C,rs17075780,-1,T,C,43533870,88141,43425403,43818619,108467
3,ENSG00000144791.5,45594751,chr3-45462835-G-A,rs17077856,1,G,A,45462835,131916,45398143,45791359,64692
3,ENSG00000163389.6,119468963,chr3-119486370-T-G,rs17203139,1,T,G,119486370,17407,119272355,119665571,214015
3,ENSG00000138495.2,119677406,chr3-119636564-C-T,rs17203235,-1,C,T,119636564,40842,119480798,119874014,155766
3,ENSG00000173175.10,123449090,chr3-123503521-A-G,rs17296876,-1,A,G,123503521,54431,123252482,123645698,251039
3,ENSG00000163608.9,113019671,chr3-113139105-G-A,rs17318371,-1,G,A,113139105,119434,112823063,113216279,316042
3,ENSG00000114416.12,180912670,chr3-180934134-A-G,rs17537540,1,A,G,180934134,21464,180716062,181109278,218072
3,ENSG00000178053.13,158571194,chr3-158693892-C-T,rs17642107,1,C,T,158693892,122698,158374586,158767802,319306
3,ENSG00000118849.5,158732457,chr3-158709270-T-C,rs17642880,-1,T,C,158709270,23187,158535849,158929065,173421
3,ENSG00000182179.6,49813953,chr3-49812290-G-A,rs1799843,-1,G,A,49812290,1663,49617345,50010561,194945
3,ENSG00000114904.8,52770940,chr3-52792531-C-A,rs2017352,-1,C,A,52792531,21591,52574332,52967548,218199
3,ENSG00000172215.5,45943464,chr3-45948725-A-G,rs2054866,1,A,G,45948725,5261,45746856,46140072,201869
3,ENSG00000138463.8,122795069,chr3-122938357-C-T,rs2060090,1,C,T,122938357,143288,122598461,122991677,339896
3,ENSG00000114455.9,108296490,chr3-108279773-T-G,rs2100581,1,T,G,108279773,16717,108099882,108493098,179891
3,ENSG00000144566.5,19947097,chr3-19941001-G-A,rs2170341,1,G,A,19941001,6096,19750489,20143705,190512
3,ENSG00000172340.9,67654612,chr3-67653678-G-A,rs2198015,-1,G,A,67653678,934,67458004,67851220,195674
3,ENSG00000172936.7,38138661,chr3-38132242-C-T,rs2239621,1,C,T,38132242,6419,37942053,38335269,190189
3,ENSG00000061938.12,195908551,chr3-195872214-T-C,rs2241413,-1,T,C,195872214,36337,195711943,196105159,160271
3,ENSG00000163933.5,53130435,chr3-53021826-G-A,rs2244461,-1,G,A,53021826,108609,52933827,53327043,87999
3,ENSG00000144837.4,119597885,chr3-119607060-G-A,rs2251566,1,G,A,119607060,9175,119401277,119794493,205783
3,ENSG00000170017.8,105366909,chr3-105527928-G-A,rs2252459,1,G,A,105527928,161019,105170301,105563517,357627
3,ENSG00000114491.9,124730452,chr3-124637087-C-T,rs2276741,1,C,T,124637087,93365,124533844,124927060,103243
3,ENSG00000114353.11,50236204,chr3-50254353-G-A,rs2282751,1,G,A,50254353,18149,50039596,50432812,214757
3,ENSG00000163687.8,58210972,chr3-58306531-C-T,rs2292679,-1,C,T,58306531,95559,58014364,58407580,292167
3,ENSG00000232382.1,98463201,chr3-98511645-T-C,rs2316131,1,T,C,98511645,48444,98266593,98659809,245052
3,ENSG00000225526.2,12545499,chr3-12608077-A-G,rs2442812,-1,A,G,12608077,62578,12348891,12742107,259186
3,ENSG00000206561.6,15521706,chr3-15708837-A-C,rs2470514,-1,A,C,15708837,187131,15325098,15718314,383739
3,ENSG00000083937.4,87227309,chr3-87047711-A-G,rs2575787,1,A,G,87047711,179598,87030701,87423917,17010
3,ENSG00000214706.6,50292429,chr3-50136764-G-T,rs2624847,-1,G,T,50136764,155665,50095821,50489037,40943
3,ENSG00000144455.8,4467269,chr3-4362153-A-G,rs2633852,-1,A,G,4362153,105116,4270661,4663877,91492
3,ENSG00000134077.10,9363054,chr3-9379503-G-A,rs2648550,1,G,A,9379503,16449,9166446,9559662,213057
3,ENSG00000170860.3,14178817,chr3-14125372-C-T,rs2733580,1,C,T,14125372,53445,13982209,14375425,143163
3,ENSG00000170819.4,133400056,chr3-133466990-T-C,rs2737717,1,T,C,133466990,66934,133203448,133596664,263542
3,ENSG00000114670.8,131026877,chr3-130858892-G-A,rs2760258,1,G,A,130858892,167985,130830269,131223485,28623
3,ENSG00000177463.11,14947583,chr3-15116326-G-A,rs28615988,1,G,A,15116326,168743,14750975,15144191,365351
3,ENSG00000196428.6,150408298,chr3-150365224-C-T,rs2868425,1,C,T,150365224,43074,150211690,150604906,153534
3,ENSG00000180611.6,192917856,chr3-192898911-T-G,rs2886870,-1,T,G,192898911,18945,192721248,193114464,177663
3,ENSG00000180611.6,192917856,chr3-192898911-T-A,rs2886870,-1,T,A,192898911,18945,192721248,193114464,177663
3,ENSG00000162244.5,51995895,chr3-51987300-A-G,rs323895,-1,A,G,51987300,8595,51799287,52192503,188013
3,ENSG00000114529.8,112086389,chr3-112115906-G-A,rs340163,1,G,A,112115906,29517,111889781,112282997,226125
3,ENSG00000197980.6,156826353,chr3-156828886-T-G,rs344072,1,T,G,156828886,2533,156629745,157022961,199141
3,ENSG00000173890.12,170037995,chr3-170036207-C-G,rs35204505,1,C,G,170036207,1788,169841387,170234603,194820
3,ENSG00000173890.12,170037995,chr3-170036207-C-A,rs35204505,1,C,A,170036207,1788,169841387,170234603,194820
3,ENSG00000010318.13,52410660,chr3-52224356-T-C,rs352139,1,T,C,52224356,186304,52214052,52607268,10304
3,ENSG00000163701.13,9902848,chr3-9893069-A-G,rs35365817,1,A,G,9893069,9779,9706240,10099456,186829
3,ENSG00000144820.3,100609601,chr3-100789345-A-G,rs35476532,1,A,G,100789345,179744,100412993,100806209,376352
3,ENSG00000157017.11,10292947,chr3-10286566-A-C,rs35683,-1,A,C,10286566,6381,10096339,10489555,190227
3,ENSG00000174928.9,155806278,chr3-155747702-T-C,rs358742,-1,T,C,155747702,58576,155609670,156002886,138032
3,ENSG00000114107.4,138594260,chr3-138628322-T-C,rs361073,-1,T,C,138628322,34062,138397652,138790868,230670
3,ENSG00000158234.8,138608771,chr3-138628322-T-C,rs361073,1,T,C,138628322,19551,138412163,138805379,216159
3,ENSG00000154928.12,134795260,chr3-134957234-G-A,rs36132,1,G,A,134957234,161974,134598652,134991868,358582
3,ENSG00000072756.12,3126940,chr3-3146332-A-G,rs3762760,1,A,G,3146332,19392,2930332,3323548,216000
3,ENSG00000114480.7,81761645,chr3-81759451-C-A,rs3772882,-1,C,A,81759451,2194,81565037,81958253,194414
3,ENSG00000056736.5,53846568,chr3-53796740-G-A,rs3774605,1,G,A,53796740,49828,53649960,54043176,146780
3,ENSG00000088543.10,50567747,chr3-50626330-C-T,rs3792327,-1,C,T,50626330,58583,50371139,50764355,255191
3,ENSG00000154743.12,12484480,chr3-12484507-G-A,rs3806662,1,G,A,12484507,27,12287872,12681088,196635
3,ENSG00000041802.6,194672191,chr3-194648851-C-A,rs3821403,-1,C,A,194648851,23340,194475583,194868799,173268
3,ENSG00000163378.9,69013684,chr3-69077344-T-C,rs3853156,-1,T,C,69077344,63660,68817076,69210292,260268
3,ENSG00000144559.6,11846885,chr3-11844891-T-C,rs392621,-1,T,C,11844891,1994,11650277,12043493,194614
3,ENSG00000168038.6,41962103,chr3-41935722-C-T,rs3934103,-1,C,T,41935722,26381,41765495,42158711,170227
3,ENSG00000175110.7,139344020,chr3-139469580-C-T,rs41356949,1,C,T,139469580,125560,139147412,139540628,322168
3,ENSG00000163840.5,122564338,chr3-122577094-A-C,rs4147495,1,A,C,122577094,12756,122367730,122760946,209364
3,ENSG00000138496.10,122564300,chr3-122577094-A-C,rs4147495,-1,A,C,122577094,12794,122367692,122760908,209402
3,ENSG00000173200.7,122577650,chr3-122577094-A-C,rs4147495,1,A,C,122577094,556,122381042,122774258,196052
3,ENSG00000073849.10,186930526,chr3-187040795-C-A,rs4234598,1,C,A,187040795,110269,186733918,187127134,306877
3,ENSG00000114812.8,42502643,chr3-42478068-A-G,rs427048,1,A,G,42478068,24575,42306035,42699251,172033
3,ENSG00000184307.9,113948013,chr3-113833610-C-T,rs4339084,1,C,T,113833610,114403,113751405,114144621,82205
3,ENSG00000041880.10,51942363,chr3-51907769-C-T,rs4416372,1,C,T,51907769,34594,51745755,52138971,162014
3,ENSG00000163960.7,196432427,chr3-196414790-A-G,rs4459932,-1,A,G,196414790,17637,196235819,196629035,178971
3,ENSG00000197885.6,23916990,chr3-23934090-C-T,rs4490300,-1,C,T,23934090,17100,23720382,24113598,213708
3,ENSG00000255423.1,73061659,chr3-73040434-T-C,rs4676898,1,T,C,73040434,21225,72865051,73258267,175383
3,ENSG00000158163.9,138115608,chr3-138003033-A-G,rs4678398,-1,A,G,138003033,112575,137919000,138312216,84033
3,ENSG00000114554.7,126983115,chr3-126908938-C-T,rs4679302,1,C,T,126908938,74177,126786507,127179723,122431
3,ENSG00000114805.12,155745071,chr3-155615579-T-C,rs4680201,-1,T,C,155615579,129492,155548463,155941679,67116
3,ENSG00000114573.4,113747035,chr3-113907798-C-G,rs4682146,1,C,G,113907798,160763,113550427,113943643,357371
3,ENSG00000182923.11,134486057,chr3-134316165-G-A,rs4682662,1,G,A,134316165,169892,134289449,134682665,26716
3,ENSG00000163808.11,44761794,chr3-44777944-T-C,rs4682996,1,T,C,44777944,16150,44565186,44958402,212758
3,ENSG00000183833.11,119703022,chr3-119705975-C-A,rs4688028,1,C,A,119705975,2953,119506414,119899630,199561
3,ENSG00000178149.12,49018580,chr3-48961890-G-A,rs4974082,-1,G,A,48961890,56690,48821972,49215188,139918
3,ENSG00000114626.12,127672952,chr3-127714699-C-T,rs534018,1,C,T,127714699,41747,127476344,127869560,238355
3,ENSG00000151967.14,159839861,chr3-160014244-C-T,rs545232,1,C,T,160014244,174383,159643253,160036469,370991
3,ENSG00000186446.6,44729635,chr3-44721338-A-G,rs56084453,1,A,G,44721338,8297,44533027,44926243,188311
3,ENSG00000196653.6,44712660,chr3-44721338-A-G,rs56084453,1,A,G,44721338,8678,44516052,44909268,205286
3,ENSG00000163686.8,58237792,chr3-58237565-T-C,rs58433687,1,T,C,58237565,227,58041184,58434400,196381
3,ENSG00000179934.5,39329709,chr3-39327476-G-A,rs59744905,1,G,A,39327476,2233,39133101,39526317,194375
3,ENSG00000114631.9,127629185,chr3-127594753-G-A,rs60317558,1,G,A,127594753,34432,127432577,127825793,162176
3,ENSG00000163959.5,196216534,chr3-196234383-C-T,rs60631199,1,C,T,196234383,17849,196019926,196413142,214457
3,ENSG00000240303.3,132659809,chr3-132562429-C-T,rs61023005,-1,C,T,132562429,97380,132463201,132856417,99228
3,ENSG00000129048.5,132597270,chr3-132499231-C-T,rs61748102,1,C,T,132499231,98039,132400662,132793878,98569
3,ENSG00000163584.13,170870195,chr3-170826994-G-A,rs61790515,-1,G,A,170826994,43201,170673587,171066803,153407
3,ENSG00000180914.6,8769613,chr3-8768776-C-T,rs62243375,-1,C,T,8768776,837,8573005,8966221,195771
3,ENSG00000163870.10,127590733,chr3-127681974-A-G,rs62264157,-1,A,G,127681974,91241,127394125,127787341,287849
3,ENSG00000144852.12,119782101,chr3-119808059-C-T,rs62264686,1,C,T,119808059,25958,119585493,119978709,222566
3,ENSG00000138246.10,132417502,chr3-132593322-C-T,rs62291489,1,C,T,132593322,175820,132220894,132614110,372428
3,ENSG00000145014.13,194633419,chr3-194633785-A-G,rs6437394,-1,A,G,194633785,366,194436811,194830027,196974
3,ENSG00000206530.4,113441493,chr3-113419233-A-G,rs6438148,-1,A,G,113419233,22260,113244885,113638101,174348
3,ENSG00000145088.4,121835209,chr3-121766392-G-A,rs6438656,1,G,A,121766392,68817,121638601,122031817,127791
3,ENSG00000091527.11,133573686,chr3-133500935-G-T,rs6439416,1,G,T,133500935,72751,133377078,133770294,123857
3,ENSG00000184220.6,99817862,chr3-100003552-A-C,rs6440967,1,A,C,100003552,185690,99621254,100014470,382298
3,ENSG00000186448.9,44625036,chr3-44768615-C-T,rs6441867,1,C,T,44768615,143579,44428428,44821644,340187
3,ENSG00000121879.3,179148357,chr3-179273093-C-T,rs6443634,1,C,T,179273093,124736,178951749,179344965,321344
3,ENSG00000121858.6,172523430,chr3-172489190-A-G,rs6445064,-1,A,G,172489190,34240,172326822,172720038,162368
3,ENSG00000189283.5,61251452,chr3-61329676-A-G,rs6445204,-1,A,G,61329676,78224,61054844,61448060,274832
3,ENSG00000157388.8,53494611,chr3-53599298-A-G,rs6445589,1,A,G,53599298,104687,53298003,53691219,301295
3,ENSG00000144959.5,172711067,chr3-172695097-G-A,rs651165,-1,G,A,172695097,15970,172514459,172907675,180638
3,ENSG00000114541.10,69386088,chr3-69372697-T-C,rs6549211,-1,T,C,69372697,13391,69189480,69582696,183217
3,ENSG00000114541.10,69386088,chr3-69372697-T-A,rs6549211,-1,T,A,69372697,13391,69189480,69582696,183217
3,ENSG00000074416.8,127822515,chr3-127755187-G-A,rs664910,-1,G,A,127755187,67328,127625907,128019123,129280
3,ENSG00000184897.4,129316286,chr3-129325862-A-G,rs6763292,-1,A,G,129325862,9576,129119678,129512894,206184
3,ENSG00000163823.3,46208313,chr3-46062803-C-T,rs6764189,-1,C,T,46062803,145510,46011705,46404921,51098
3,ENSG00000170266.10,33097146,chr3-33045401-T-C,rs6766207,-1,T,C,33045401,51745,32900538,33293754,144863
3,ENSG00000168036.12,41199505,chr3-41246975-G-A,rs6769117,1,G,A,41246975,47470,41002897,41396113,244078
3,ENSG00000144712.7,12796680,chr3-12756064-C-T,rs6770851,1,C,T,12756064,40616,12600072,12993288,155992
3,ENSG00000131379.5,14675141,chr3-14728091-C-G,rs6771179,1,C,G,14728091,52950,14478533,14871749,249558
3,ENSG00000197938.4,98282505,chr3-98213209-C-T,rs6771271,1,C,T,98213209,69296,98085897,98479113,127312
3,ENSG00000163923.5,187139496,chr3-186964536-T-G,rs6771438,-1,T,G,186964536,174960,186942888,187336104,21648
3,ENSG00000163820.10,45995824,chr3-46101567-A-G,rs6772051,-1,A,G,46101567,105743,45799216,46192432,302351
3,ENSG00000129055.8,134485985,chr3-134484505-C-T,rs6772896,-1,C,T,134484505,1480,134289377,134682593,195128
3,ENSG00000164082.10,51707068,chr3-51534121-C-T,rs6773188,1,C,T,51534121,172947,51510460,51903676,23661
3,ENSG00000169981.6,44648732,chr3-44710720-T-C,rs6779503,1,T,C,44710720,61988,44452124,44845340,258596
3,ENSG00000173950.10,195271159,chr3-195200236-G-A,rs6781962,-1,G,A,195200236,70923,195074551,195467767,125685
3,ENSG00000198585.7,131381774,chr3-131372043-G-A,rs6782969,1,G,A,131372043,9731,131185166,131578382,186877
3,ENSG00000144824.14,111859265,chr3-111874737-G-A,rs6786077,1,G,A,111874737,15472,111662657,112055873,212080
3,ENSG00000169313.8,151384753,chr3-151381953-A-G,rs6787801,-1,A,G,151381953,2800,151188145,151581361,193808
3,ENSG00000163536.7,167735721,chr3-167572871-G-A,rs6788437,1,G,A,167572871,162850,167539113,167932329,33758
3,ENSG00000114125.9,141738298,chr3-141717109-A-G,rs6795259,1,A,G,141717109,21189,141541690,141934906,175419
3,ENSG00000114021.6,100334757,chr3-100451981-G-A,rs6797397,1,G,A,100451981,117224,100138149,100531365,313832
3,ENSG00000169251.7,161221311,chr3-161354159-A-G,rs6800515,1,A,G,161354159,132848,161024703,161417919,329456
3,ENSG00000051341.8,121545988,chr3-121435346-C-T,rs6800901,-1,C,T,121435346,110642,121349380,121742596,85966
3,ENSG00000114796.10,183635623,chr3-183516371-C-T,rs6801457,1,C,T,183516371,119252,183439015,183832231,77356
3,ENSG00000113811.6,53891859,chr3-53842191-A-G,rs6801605,-1,A,G,53842191,49668,53695251,54088467,146940
3,ENSG00000168297.9,58332892,chr3-58231310-G-A,rs6802482,1,G,A,58231310,101582,58136284,58529500,95026
3,ENSG00000155893.6,141231825,chr3-141426631-T-C,rs6802753,1,T,C,141426631,194806,141035217,141428433,391414
3,ENSG00000169814.8,15601745,chr3-15602228-A-G,rs6804782,1,A,G,15602228,483,15405137,15798353,197091
3,ENSG00000131378.8,16513699,chr3-16372691-G-A,rs689662,-1,G,A,16372691,141008,16317091,16710307,55600
3,ENSG00000196776.10,108091031,chr3-108124634-C-T,rs721328,-1,C,T,108124634,33603,107894423,108287639,230211
3,ENSG00000145029.6,49429324,chr3-49410990-G-A,rs73088137,-1,G,A,49410990,18334,49232716,49625932,178274
3,ENSG00000154781.10,14651762,chr3-14716632-A-G,rs73137412,1,A,G,14716632,64870,14455154,14848370,261478
3,ENSG00000163347.4,190322446,chr3-190315724-C-T,rs73190602,-1,C,T,190315724,6722,190125838,190519054,189886
3,ENSG00000145113.16,195811929,chr3-195726546-C-G,rs73203948,-1,C,G,195726546,85383,195615321,196008537,111225
3,ENSG00000145113.16,195811929,chr3-195726546-C-T,rs73203948,-1,C,T,195726546,85383,195615321,196008537,111225
3,ENSG00000251287.4,130081831,chr3-130123032-G-A,rs73210765,1,G,A,130123032,41201,129885223,130278439,237809
3,ENSG00000163961.4,196503768,chr3-196392037-C-A,rs73213958,-1,C,A,196392037,111731,196307160,196700376,84877
3,ENSG00000213689.5,48466230,chr3-48478412-C-A,rs734071,1,C,A,48478412,12182,48269622,48662838,208790
3,ENSG00000181458.6,100492619,chr3-100519216-T-G,rs7429392,1,T,G,100519216,26597,100296011,100689227,223205
3,ENSG00000163827.8,46566302,chr3-46609211-C-T,rs74349719,-1,C,T,46609211,42909,46369694,46762910,239517
3,ENSG00000186792.11,50299405,chr3-50405910-C-T,rs74448976,-1,C,T,50405910,106505,50102797,50496013,303113
3,ENSG00000164048.8,48241104,chr3-48231046-T-G,rs745116,1,T,G,48231046,10058,48044496,48437712,186550
3,ENSG00000114853.8,42653697,chr3-42492291-G-A,rs74796215,1,G,A,42492291,161406,42457089,42850305,35202
3,ENSG00000152642.6,32106620,chr3-32107224-G-T,rs748607,1,G,T,32107224,604,31910012,32303228,197212
3,ENSG00000206527.5,123585053,chr3-123585847-G-A,rs75085211,-1,G,A,123585847,794,123388445,123781661,197402
3,ENSG00000136518.11,179562926,chr3-179460067-C-T,rs754574,1,C,T,179460067,102859,179366318,179759534,93749
3,ENSG00000114473.9,197959991,chr3-197811677-G-C,rs75865926,-1,G,C,197811677,148314,197763383,198156599,48294
3,ENSG00000145107.10,196338388,chr3-196451835-C-T,rs75898376,-1,C,T,196451835,113447,196141780,196534996,310055
3,ENSG00000131370.11,15332586,chr3-15353512-T-C,rs7614350,-1,T,C,15353512,20926,15135978,15529194,217534
3,ENSG00000168268.6,52533857,chr3-52532898-C-A,rs7614981,-1,C,A,52532898,959,52337249,52730465,195649
3,ENSG00000163754.12,148991540,chr3-148975613-G-A,rs7615371,1,G,A,148975613,15927,148794932,149188148,180681
3,ENSG00000174007.7,196712250,chr3-196706752-T-C,rs7616240,-1,T,C,196706752,5498,196515642,196908858,191110
3,ENSG00000144655.9,39153591,chr3-39199068-T-C,rs7622284,-1,T,C,39199068,45477,38956983,39350199,242085
3,ENSG00000160801.9,46877721,chr3-46726984-C-T,rs7626129,1,C,T,46726984,150737,46681113,47074329,45871
3,ENSG00000114850.2,156555117,chr3-156652144-T-G,rs7628802,-1,T,G,156652144,97027,156358509,156751725,293635
3,ENSG00000163684.6,58306245,chr3-58454509-T-C,rs7633553,1,T,C,58454509,148264,58109637,58502853,344872
3,ENSG00000078070.6,183099496,chr3-183011505-A-C,rs7635560,-1,A,C,183011505,87991,182902888,183296104,108617
3,ENSG00000173905.4,168095924,chr3-168048703-C-A,rs7639014,-1,C,A,168048703,47221,167899316,168292532,149387
3,ENSG00000163864.10,139677972,chr3-139673526-T-C,rs7639511,-1,T,C,139673526,4446,139481364,139874580,192162
3,ENSG00000181804.9,143848468,chr3-143823166-G-A,rs7641634,-1,G,A,143823166,25302,143651860,144045076,171306
3,ENSG00000114395.6,50350862,chr3-50185260-T-C,rs7642692,1,T,C,50185260,165602,50154254,50547470,31006
3,ENSG00000254999.2,10115675,chr3-10115684-C-T,rs7645759,1,C,T,10115684,9,9919067,10312283,196617
3,ENSG00000144647.5,43106079,chr3-43132737-G-A,rs7648947,-1,G,A,43132737,26658,42909471,43302687,223266
3,ENSG00000163814.3,45146378,chr3-45135816-C-T,rs7652999,-1,C,T,45135816,10562,44949770,45342986,186046
3,ENSG00000114268.7,48556803,chr3-48562712-C-T,rs78159609,-1,C,T,48562712,5909,48360195,48753411,202517
3,ENSG00000144741.12,66221001,chr3-66298096-A-G,rs782749,1,A,G,66298096,77095,66024393,66417609,273703
3,ENSG00000187672.8,56468467,chr3-56655270-C-T,rs78638441,-1,C,T,56655270,186803,56271859,56665075,383411
3,ENSG00000175697.6,120285222,chr3-120280774-T-G,rs787202,-1,T,G,120280774,4448,120088614,120481830,192160
3,ENSG00000138231.8,138174921,chr3-138131046-C-T,rs79791762,-1,C,T,138131046,43875,137978313,138371529,152733
3,ENSG00000205981.2,180989736,chr3-180912884-C-T,rs80057905,-1,C,T,180912884,76852,180793128,181186344,119756
3,ENSG00000168028.8,39406720,chr3-39425703-A-G,rs816506,1,A,G,39425703,18983,39210112,39603328,215591
3,ENSG00000178700.3,94062916,chr3-93894473-A-G,rs8178639,-1,A,G,93894473,168443,93866308,94259524,28165
3,ENSG00000169359.8,155854427,chr3-155970238-T-C,rs819856,-1,T,C,155970238,115811,155657819,156051035,312419
3,ENSG00000174891.8,158110089,chr3-158288574-T-A,rs827139,1,T,A,158288574,178485,157913481,158306697,375093
3,ENSG00000168329.8,39280036,chr3-39394374-G-C,rs870843,-1,G,C,39394374,114338,39083428,39476644,310946
3,ENSG00000114405.6,62319022,chr3-62122552-C-T,rs880416,1,C,T,62122552,196470,62122414,62515630,138
3,ENSG00000159685.6,126704240,chr3-126749978-C-T,rs895825,1,C,T,126749978,45738,126507632,126900848,242346
3,ENSG00000232112.3,48440257,chr3-48371689-G-T,rs898225,1,G,T,48371689,68568,48243649,48636865,128040
3,ENSG00000154310.12,171460405,chr3-171270556-T-C,rs902953,-1,T,C,171270556,189849,171263797,171657013,6759
3,ENSG00000196981.2,122416062,chr3-122416042-T-A,rs9289193,-1,T,A,122416042,20,122219454,122612670,196588
3,ENSG00000114770.11,184017884,chr3-184004187-C-A,rs9290779,-1,C,A,184004187,13697,183821276,184214492,182911
3,ENSG00000160796.10,46979666,chr3-46876985-C-A,rs936173,1,C,A,46876985,102681,46783058,47176274,93927
3,ENSG00000144834.7,111998922,chr3-111904354-A-C,rs937559,1,A,C,111904354,94568,111802314,112195530,102040
3,ENSG00000138468.11,101513212,chr3-101366569-G-A,rs939443,-1,G,A,101366569,146643,101316604,101709820,49965
3,ENSG00000187068.2,185153060,chr3-185064414-T-C,rs9755247,-1,T,C,185064414,88646,184956452,185349668,107962
3,ENSG00000144642.15,29281071,chr3-29283977-C-A,rs9815887,1,C,A,29283977,2906,29084463,29477679,199514
3,ENSG00000121594.7,119559614,chr3-119392915-T-C,rs9831023,-1,T,C,119392915,166699,119363006,119756222,29909
3,ENSG00000188001.5,189171971,chr3-189304353-A-G,rs9834698,1,A,G,189304353,132382,188975363,189368579,328990
3,ENSG00000152492.9,191329394,chr3-191393371-A-G,rs9841435,1,A,G,191393371,63977,191132786,191526002,260585
3,ENSG00000114757.13,180036937,chr3-179895448-C-T,rs9842394,-1,C,T,179895448,141489,179840329,180233545,55119
3,ENSG00000164049.9,48372219,chr3-48223232-G-A,rs9844812,1,G,A,48223232,148987,48175611,48568827,47621
3,ENSG00000180376.12,56557175,chr3-56664397-A-C,rs9847362,1,A,C,56664397,107222,56360567,56753783,303830
3,ENSG00000114503.6,196942528,chr3-196966244-C-T,rs9858636,-1,C,T,196966244,23716,196745920,197139136,220324
3,ENSG00000249992.1,45226287,chr3-45406220-A-G,rs9861724,-1,A,G,45406220,179933,45029679,45422895,376541
3,ENSG00000079257.3,158672648,chr3-158651663-T-C,rs9867957,-1,T,C,158651663,20985,158476040,158869256,175623
3,ENSG00000181744.4,143971823,chr3-144040212-C-T,rs9868954,1,C,T,144040212,68389,143775215,144168431,264997
3,ENSG00000114784.3,40309707,chr3-40381939-A-G,rs9871825,1,A,G,40381939,72232,40113099,40506315,268840
3,ENSG00000171109.13,179347709,chr3-179392605-G-A,rs9874433,1,G,A,179392605,44896,179151101,179544317,241504
3,ENSG00000171121.12,179251114,chr3-179264721-A-G,rs9875304,-1,A,G,179264721,13607,179054506,179447722,210215
3,ENSG00000093167.13,37174582,chr3-37042249-A-G,rs9876116,-1,A,G,37042249,132333,36977974,37371190,64275
3,ENSG00000171757.10,169812904,chr3-169812170-A-G,rs9878797,-1,A,G,169812170,734,169616296,170009512,195874
3,ENSG00000176945.11,195720978,chr3-195627293-G-A,rs9886958,1,G,A,195627293,93685,195524370,195917586,102923
3,ENSG00000171109.13,179347709,chr3-179389059-G-T,rs10049286,1,G,T,179389059,41350,179151101,179544317,237958
3,ENSG00000144741.12,66221001,chr3-66377858-C-T,rs1046844,1,C,T,66377858,156857,66024393,66417609,353465
3,ENSG00000163491.11,27369383,chr3-27401997-T-C,rs10510595,-1,T,C,27401997,32614,27172775,27565991,229222
3,ENSG00000173540.8,49723951,chr3-49857648-T-C,rs10510756,-1,T,C,49857648,133697,49527343,49920559,330305
3,ENSG00000176020.7,49719684,chr3-49857648-T-C,rs10510756,-1,T,C,49857648,137964,49523076,49916292,334572
3,ENSG00000188001.5,189171971,chr3-189317032-A-G,rs10513835,1,A,G,189317032,145061,188975363,189368579,341669
3,ENSG00000163755.4,149129638,chr3-149186647-T-G,rs1053709,1,T,G,149186647,57009,148933030,149326246,253617
3,ENSG00000164068.10,49689557,chr3-49671336-T-C,rs1060970,1,T,C,49671336,18221,49492949,49886165,178387
3,ENSG00000031081.5,119294383,chr3-119187595-G-A,rs10934486,1,G,A,119187595,106788,119097775,119490991,89820
3,ENSG00000129048.5,132597270,chr3-132695152-T-C,rs10935028,1,T,C,132695152,97882,132400662,132793878,294490
3,ENSG00000076201.8,47381021,chr3-47557173-G-A,rs11130138,1,G,A,47557173,176152,47184413,47577629,372760
3,ENSG00000067560.6,49411976,chr3-49578191-G-T,rs11130208,-1,G,T,49578191,166215,49215368,49608584,362823
3,ENSG00000114779.14,51974049,chr3-51971622-G-A,rs114730569,-1,G,A,51971622,2427,51777441,52170657,194181
3,ENSG00000075711.14,197298612,chr3-197421616-G-A,rs115373965,-1,G,A,197421616,123004,197102004,197495220,319612
3,ENSG00000163705.8,10108255,chr3-9928437-C-T,rs115419420,-1,C,T,9928437,179818,9911647,10304863,16790
3,ENSG00000144677.10,37861880,chr3-38006189-G-A,rs11707277,1,G,A,38006189,144309,37665272,38058488,340917
3,ENSG00000197885.6,23916990,chr3-23864972-A-G,rs11710679,-1,A,G,23864972,52018,23720382,24113598,144590
3,ENSG00000206535.3,100401539,chr3-100336281-C-T,rs11714045,1,C,T,100336281,65258,100204931,100598147,131350
3,ENSG00000144857.10,113211557,chr3-113188123-A-G,rs11718413,1,A,G,113188123,23434,113014949,113408165,173174
3,ENSG00000163508.7,27722323,chr3-27668148-G-A,rs11916078,-1,G,A,27668148,54175,27525715,27918931,142433
3,ENSG00000113790.5,185254049,chr3-185291116-C-T,rs11918469,-1,C,T,185291116,37067,185057441,185450657,233675
3,ENSG00000187288.6,9880253,chr3-9884664-A-G,rs11918795,-1,A,G,9884664,4411,9683645,10076861,201019
3,ENSG00000175166.11,184299241,chr3-184173080-A-G,rs11919795,1,A,G,184173080,126161,184102633,184495849,70447
3,ENSG00000058866.9,186362234,chr3-186241827-T-C,rs11921893,-1,T,C,186241827,120407,186165626,186558842,76201
3,ENSG00000163947.7,56801949,chr3-56868802-T-G,rs11923190,-1,T,G,56868802,66853,56605341,56998557,263461
3,ENSG00000114805.12,155745071,chr3-155683902-G-T,rs11928132,-1,G,T,155683902,61169,155548463,155941679,135439
3,ENSG00000168374.6,57597344,chr3-57426468-G-A,rs11929016,-1,G,A,57426468,170876,57400736,57793952,25732
3,ENSG00000144659.5,39383370,chr3-39328191-C-T,rs12107527,1,C,T,39328191,55179,39186762,39579978,141429
3,ENSG00000053524.6,183428619,chr3-183396220-T-C,rs12490878,-1,T,C,183396220,32399,183232011,183625227,164209
3,ENSG00000153551.9,32391853,chr3-32314373-A-G,rs12629727,1,A,G,32314373,77480,32195245,32588461,119128
3,ENSG00000163975.7,197029817,chr3-196948008-A-G,rs12636891,-1,A,G,196948008,81809,196833209,197226425,114799
3,ENSG00000230301.3,98264244,chr3-98317703-G-A,rs12638749,1,G,A,98317703,53459,98067636,98460852,250067
3,ENSG00000188306.6,169812870,chr3-169759718-A-G,rs12638862,1,A,G,169759718,53152,169616262,170009478,143456
3,ENSG00000132155.7,12664117,chr3-12540093-C-T,rs13069599,-1,C,T,12540093,124024,12467509,12860725,72584
3,ENSG00000163389.6,119468963,chr3-119547946-A-C,rs13071247,1,A,C,119547946,78983,119272355,119665571,275591
3,ENSG00000158092.2,136862208,chr3-136706758-T-C,rs13072691,1,T,C,136706758,155450,136665600,137058816,41158
3,ENSG00000174579.3,136196335,chr3-136364418-A-G,rs13076654,-1,A,G,136364418,168083,135999727,136392943,364691
3,ENSG00000177494.5,111595346,chr3-111714579-C-T,rs13083322,-1,C,T,111714579,119233,111398738,111791954,315841
3,ENSG00000182580.2,184561785,chr3-184620030-A-G,rs13085530,1,A,G,184620030,58245,184365177,184758393,254853
3,ENSG00000178075.14,113838788,chr3-113834157-G-A,rs13087470,1,G,A,113834157,4631,113642180,114035396,191977
3,ENSG00000138468.11,101513212,chr3-101523907-A-G,rs13088318,-1,A,G,101523907,10695,101316604,101709820,207303
3,ENSG00000173402.6,49470267,chr3-49664224-T-C,rs13326722,1,T,C,49664224,193957,49273659,49666875,390565
3,ENSG00000153283.7,111542197,chr3-111697463-A-G,rs1355767,1,A,G,111697463,155266,111345589,111738805,351874
3,ENSG00000182568.11,18425339,chr3-18620985-T-C,rs1440968,-1,T,C,18620985,195646,18228731,18621947,392254
3,ENSG00000174007.7,196712250,chr3-196727148-C-T,rs1463628,-1,C,T,196727148,14898,196515642,196908858,211506
3,ENSG00000114529.8,112086389,chr3-112141375-A-G,rs1492480,1,A,G,112141375,54986,111889781,112282997,251594
3,ENSG00000154917.6,133895882,chr3-133816238-C-T,rs1534164,-1,C,T,133816238,79644,133699274,134092490,116964
3,ENSG00000163884.3,126357408,chr3-126457706-A-G,rs1552640,-1,A,G,126457706,100298,126160800,126554016,296906
3,ENSG00000196776.10,108091031,chr3-108105214-T-G,rs162064,-1,T,G,108105214,14183,107894423,108287639,210791
3,ENSG00000163659.8,156674590,chr3-156603142-G-A,rs16826607,1,G,A,156603142,71448,156477982,156871198,125160
3,ENSG00000114520.6,125520202,chr3-125567371-C-T,rs16836866,-1,C,T,125567371,47169,125323594,125716810,243777
3,ENSG00000091513.10,133746393,chr3-133919048-T-C,rs16841148,1,T,C,133919048,172655,133549785,133943001,369263
3,ENSG00000181458.6,100492619,chr3-100346733-C-G,rs16842142,1,C,G,100346733,145886,100296011,100689227,50722
3,ENSG00000114125.9,141738298,chr3-141796708-T-C,rs16851809,1,T,C,141796708,58410,141541690,141934906,255018
3,ENSG00000157087.11,10505586,chr3-10465199-C-T,rs17032929,-1,C,T,10465199,40387,10308978,10702194,156221
3,ENSG00000144597.9,15427598,chr3-15294706-C-T,rs17040969,1,C,T,15294706,132892,15230990,15624206,63716
3,ENSG00000168038.6,41962103,chr3-42032465-G-A,rs17066958,-1,G,A,42032465,70362,41765495,42158711,266970
3,ENSG00000211456.5,45689396,chr3-45850985-A-G,rs17078371,1,A,G,45850985,161589,45492788,45886004,358197
3,ENSG00000184220.6,99817862,chr3-99673089-G-T,rs1711560,1,G,T,99673089,144773,99621254,100014470,51835
3,ENSG00000113924.7,120682239,chr3-120784621-C-G,rs17184204,-1,C,G,120784621,102382,120485631,120878847,298990
3,ENSG00000175792.6,128123812,chr3-127965905-C-T,rs17203687,-1,C,T,127965905,157907,127927204,128320420,38701
3,ENSG00000154174.6,100401089,chr3-100225537-C-T,rs17213695,-1,C,T,100225537,175552,100204481,100597697,21056
3,ENSG00000163428.3,120349354,chr3-120384162-C-T,rs1733324,-1,C,T,120384162,34808,120152746,120545962,231416
3,ENSG00000163378.9,69013684,chr3-69021306-G-A,rs1745,-1,G,A,69021306,7622,68817076,69210292,204230
3,ENSG00000179564.3,50279087,chr3-50403121-C-A,rs17606778,1,C,A,50403121,124034,50082479,50475695,320642
3,ENSG00000180914.6,8769613,chr3-8904551-G-A,rs17791487,-1,G,A,8904551,134938,8573005,8966221,331546
3,ENSG00000093167.13,37174582,chr3-36993455-G-A,rs1800734,-1,G,A,36993455,181127,36977974,37371190,15481
3,ENSG00000205981.2,180989736,chr3-180975952-G-C,rs1805626,-1,G,C,180975952,13784,180793128,181186344,182824
3,ENSG00000241553.5,9793082,chr3-9712650-C-T,rs187310,1,C,T,9712650,80432,9596474,9989690,116176
3,ENSG00000172936.7,38138661,chr3-38314426-C-T,rs194706,1,C,T,38314426,175765,37942053,38335269,372373
3,ENSG00000012171.13,50269147,chr3-50134964-C-T,rs2014830,1,C,T,50134964,134183,50072539,50465755,62425
3,ENSG00000144455.8,4467269,chr3-4295223-G-A,rs2029597,-1,G,A,4295223,172046,4270661,4663877,24562
3,ENSG00000163576.13,19934217,chr3-19967806-C-A,rs2127956,-1,C,A,19967806,33589,19737609,20130825,230197
3,ENSG00000160801.9,46877721,chr3-46877889-A-G,rs2168442,1,A,G,46877889,168,46681113,47074329,196776
3,ENSG00000114388.8,50350775,chr3-50206647-G-A,rs2236940,-1,G,A,50206647,144128,50154167,50547383,52480
3,ENSG00000232112.3,48440257,chr3-48518906-G-A,rs2267846,1,G,A,48518906,78649,48243649,48636865,275257
3,ENSG00000157017.11,10292947,chr3-10249969-C-T,rs2270452,-1,C,T,10249969,42978,10096339,10489555,153630
3,ENSG00000131381.7,15099148,chr3-15269402-C-G,rs2279739,-1,C,G,15269402,170254,14902540,15295756,366862
3,ENSG00000004399.8,129606676,chr3-129585954-G-A,rs2285372,-1,G,A,129585954,20722,129410068,129803284,175886
3,ENSG00000144736.9,72848445,chr3-72660251-A-G,rs2322574,-1,A,G,72660251,188194,72651837,73045053,8414
3,ENSG00000185798.6,196568554,chr3-196541565-C-G,rs2341396,-1,C,G,196541565,26989,196371946,196765162,169619
3,ENSG00000114784.3,40309707,chr3-40223849-G-A,rs2371135,1,G,A,40223849,85858,40113099,40506315,110750
3,ENSG00000163607.8,112990984,chr3-113052658-A-G,rs2399460,1,A,G,113052658,61674,112794376,113187592,258282
3,ENSG00000163710.3,142889083,chr3-142916776-G-C,rs2581626,-1,G,C,142916776,27693,142692475,143085691,224301
3,ENSG00000254999.2,10115675,chr3-10148977-A-G,rs2600005,1,A,G,10148977,33302,9919067,10312283,229910
3,ENSG00000196220.9,9249646,chr3-9360377-C-A,rs2600178,-1,C,A,9360377,110731,9053038,9446254,307339
3,ENSG00000134070.4,10164919,chr3-10174266-T-G,rs2619508,1,T,G,10174266,9347,9968311,10361527,205955
3,ENSG00000156983.11,9731735,chr3-9590630-T-C,rs2648581,1,T,C,9590630,141105,9535127,9928343,55503
3,ENSG00000170876.7,14125052,chr3-14169601-A-G,rs2733537,1,A,G,14169601,44549,13928444,14321660,241157
3,ENSG00000198836.4,193593208,chr3-193709992-G-A,rs280537,1,G,A,193709992,116784,193396600,193789816,313392
3,ENSG00000173200.7,122577650,chr3-122532991-C-A,rs28403550,1,C,A,122532991,44659,122381042,122774258,151949
3,ENSG00000163902.6,128650818,chr3-128801708-C-G,rs28407141,-1,C,G,128801708,150890,128454210,128847426,347498
3,ENSG00000163827.8,46566302,chr3-46551497-A-G,rs28687398,-1,A,G,46551497,14805,46369694,46762910,181803
3,ENSG00000144712.7,12796680,chr3-12788580-G-T,rs28690499,1,G,T,12788580,8100,12600072,12993288,188508
3,ENSG00000163320.6,88059005,chr3-87964218-A-G,rs2915278,-1,A,G,87964218,94787,87862397,88255613,101821
3,ENSG00000213533.7,52897548,chr3-52948280-G-A,rs2952830,-1,G,A,52948280,50732,52700940,53094156,247340
3,ENSG00000164054.10,48504174,chr3-48466268-T-C,rs3135941,-1,T,C,48466268,37906,48307566,48700782,158702
3,ENSG00000251287.4,130081831,chr3-130032033-A-G,rs34233228,1,A,G,130032033,49798,129885223,130278439,146810
3,ENSG00000189058.4,195583940,chr3-195588069-C-T,rs34605848,-1,C,T,195588069,4129,195387332,195780548,200737
3,ENSG00000114757.13,180036937,chr3-180178557-C-T,rs35214500,-1,C,T,180178557,141620,179840329,180233545,338228
3,ENSG00000172046.13,49120823,chr3-49297194-G-A,rs35260967,-1,G,A,49297194,176371,48924215,49317431,372979
3,ENSG00000163959.5,196216534,chr3-196323963-C-T,rs35643777,1,C,T,196323963,107429,196019926,196413142,304037
3,ENSG00000178732.4,194399266,chr3-194342424-G-A,rs3732474,-1,G,A,194342424,56842,194202658,194595874,139766
3,ENSG00000144895.7,150546787,chr3-150602806-A-G,rs3745,1,A,G,150602806,56019,150350179,150743395,252627
3,ENSG00000114859.10,184361605,chr3-184352887-A-G,rs3749223,-1,A,G,184352887,8718,184164997,184558213,187890
3,ENSG00000162244.5,51995895,chr3-51947005-C-T,rs3774344,-1,C,T,51947005,48890,51799287,52192503,147718
3,ENSG00000010318.13,52410660,chr3-52553371-C-A,rs3774367,1,C,A,52553371,142711,52214052,52607268,339319
3,ENSG00000114857.13,42600686,chr3-42653821-G-A,rs3846059,1,G,A,42653821,53135,42404078,42797294,249743
3,ENSG00000182923.11,134486057,chr3-134606694-G-A,rs4074521,1,G,A,134606694,120637,134289449,134682665,317245
3,ENSG00000151576.6,114056737,chr3-114056663-T-G,rs41271379,1,T,G,114056663,74,113860129,114253345,196534
3,ENSG00000163833.6,121593379,chr3-121757201-A-G,rs4234145,1,A,G,121757201,163822,121396771,121789987,360430
3,ENSG00000163833.6,121593379,chr3-121757201-A-C,rs4234145,1,A,C,121757201,163822,121396771,121789987,360430
3,ENSG00000152580.7,151461061,chr3-151518774-A-G,rs4234330,-1,A,G,151518774,57713,151264453,151657669,254321
3,ENSG00000168301.8,58492096,chr3-58540470-C-G,rs4299498,1,C,G,58540470,48374,58295488,58688704,244982
3,ENSG00000188313.7,146544607,chr3-146367634-A-C,rs4308246,-1,A,C,146367634,176973,146347999,146741215,19635
3,ENSG00000114786.11,51975060,chr3-51907769-C-T,rs4416372,1,C,T,51907769,67291,51778452,52171668,129317
3,ENSG00000075975.11,12557087,chr3-12699720-T-A,rs4444694,1,T,A,12699720,142633,12360479,12753695,339241
3,ENSG00000163380.11,69122595,chr3-69231752-C-T,rs4447768,-1,C,T,69231752,109157,68925987,69319203,305765
3,ENSG00000080819.2,98593611,chr3-98414713-C-T,rs4470566,-1,C,T,98414713,178898,98397003,98790219,17710
3,ENSG00000144824.14,111859265,chr3-111898714-A-G,rs4516579,1,A,G,111898714,39449,111662657,112055873,236057
3,ENSG00000168356.7,39051944,chr3-39199946-T-C,rs4676483,-1,T,C,39199946,148002,38855336,39248552,344610
3,ENSG00000082781.6,124887365,chr3-124821985-C-T,rs4678167,-1,C,T,124821985,65380,124690757,125083973,131228
3,ENSG00000082781.6,124887365,chr3-124821985-C-G,rs4678167,-1,C,G,124821985,65380,124690757,125083973,131228
3,ENSG00000169359.8,155854427,chr3-155986141-A-G,rs4680225,-1,A,G,155986141,131714,155657819,156051035,328322
3,ENSG00000056736.5,53846568,chr3-53815483-A-G,rs4687587,1,A,G,53815483,31085,53649960,54043176,165523
3,ENSG00000068001.9,50322745,chr3-50484632-G-A,rs4688718,-1,G,A,50484632,161887,50126137,50519353,358495
3,ENSG00000136522.9,179604638,chr3-179450674-C-T,rs4855074,-1,C,T,179450674,153964,179408030,179801246,42644
3,ENSG00000114455.9,108296490,chr3-108366911-C-A,rs4855644,1,C,A,108366911,70421,108099882,108493098,267029
3,ENSG00000119227.3,196968833,chr3-196872451-T-G,rs4916567,-1,T,G,196872451,96382,196772225,197165441,100226
3,ENSG00000073849.10,186930526,chr3-187017902-A-C,rs5001409,1,A,C,187017902,87376,186733918,187127134,283984
3,ENSG00000151967.14,159839861,chr3-159960395-A-C,rs501636,1,A,C,159960395,120534,159643253,160036469,317142
3,ENSG00000163687.8,58210972,chr3-58193744-C-T,rs55756006,-1,C,T,58193744,17228,58014364,58407580,179380
3,ENSG00000144821.5,108510596,chr3-108648239-G-C,rs56153625,-1,G,C,108648239,137643,108313988,108707204,334251
3,ENSG00000181804.9,143848468,chr3-143795133-A-G,rs56969315,-1,A,G,143795133,53335,143651860,144045076,143273
3,ENSG00000114251.8,55487306,chr3-55517036-C-T,rs570374,-1,C,T,55517036,29730,55290698,55683914,226338
3,ENSG00000163930.5,52410008,chr3-52226388-C-T,rs5743839,-1,C,T,52226388,183620,52213400,52606616,12988
3,ENSG00000131370.11,15332586,chr3-15362621-T-C,rs58163887,-1,T,C,15362621,30035,15135978,15529194,226643
3,ENSG00000168329.8,39280036,chr3-39327476-G-A,rs59744905,-1,G,A,39327476,47440,39083428,39476644,244048
3,ENSG00000240303.3,132659809,chr3-132499231-C-T,rs61748102,-1,C,T,132499231,160578,132463201,132856417,36030
3,ENSG00000227124.4,75785549,chr3-75777035-G-C,rs62269663,-1,G,C,75777035,8514,75588941,75982157,188094
3,ENSG00000227124.4,75785549,chr3-75777035-G-A,rs62269663,-1,G,A,75777035,8514,75588941,75982157,188094
3,ENSG00000173226.12,121835060,chr3-121766392-G-A,rs6438656,-1,G,A,121766392,68668,121638452,122031668,127940
3,ENSG00000196981.2,122416062,chr3-122392074-C-T,rs6438726,-1,C,T,122392074,23988,122219454,122612670,172620
3,ENSG00000181322.9,138329851,chr3-138196362-C-T,rs6439792,-1,C,T,138196362,133489,138133243,138526459,63119
3,ENSG00000145191.6,184135358,chr3-184084809-G-A,rs6443942,1,G,A,184084809,50549,183938750,184331966,146059
3,ENSG00000113838.8,186567339,chr3-186608039-C-T,rs6444150,-1,C,T,186608039,40700,186370731,186763947,237308
3,ENSG00000144749.8,66501022,chr3-66508508-G-A,rs6549157,-1,G,A,66508508,7486,66304414,66697630,204094
3,ENSG00000163961.4,196503768,chr3-196576790-G-A,rs6583322,-1,G,A,196576790,73022,196307160,196700376,269630
3,ENSG00000144843.7,119579492,chr3-119533391-C-T,rs6767853,1,C,T,119533391,46101,119382884,119776100,150507
3,ENSG00000185565.6,116445487,chr3-116607951-A-G,rs6767939,-1,A,G,116607951,162464,116248879,116642095,359072
3,ENSG00000187068.2,185153060,chr3-185096656-A-G,rs6770129,-1,A,G,185096656,56404,184956452,185349668,140204
3,ENSG00000114315.3,194136148,chr3-193986084-C-T,rs6770661,1,C,T,193986084,150064,193939540,194332756,46544
3,ENSG00000168237.12,52287828,chr3-52433195-C-A,rs6771643,1,C,A,52433195,145367,52091220,52484436,341975
3,ENSG00000069849.6,141876643,chr3-141865633-A-G,rs6773662,1,A,G,141865633,11010,141680035,142073251,185598
3,ENSG00000187091.9,38029642,chr3-38067683-T-G,rs6775473,-1,T,G,38067683,38041,37833034,38226250,234649
3,ENSG00000187091.9,38029642,chr3-38067683-T-C,rs6775473,-1,T,C,38067683,38041,37833034,38226250,234649
3,ENSG00000164048.8,48241104,chr3-48342898-C-T,rs6779517,1,C,T,48342898,101794,48044496,48437712,298402
3,ENSG00000163584.13,170870195,chr3-170812792-A-G,rs6779973,-1,A,G,170812792,57403,170673587,171066803,139205
3,ENSG00000131373.10,15601569,chr3-15557776-T-G,rs6781430,-1,T,G,15557776,43793,15404961,15798177,152815
3,ENSG00000206561.6,15521706,chr3-15557776-T-G,rs6781430,-1,T,G,15557776,36070,15325098,15718314,232678
3,ENSG00000171121.12,179251114,chr3-179241356-C-T,rs6786049,-1,C,T,179241356,9758,179054506,179447722,186850
3,ENSG00000198218.5,49094071,chr3-48927339-C-A,rs6787804,-1,C,A,48927339,166732,48897463,49290679,29876
3,ENSG00000174500.8,112133248,chr3-111963195-G-A,rs6788215,-1,G,A,111963195,170053,111936640,112329856,26555
3,ENSG00000183624.8,129278870,chr3-129345879-A-G,rs6795866,1,A,G,129345879,67009,129082262,129475478,263617
3,ENSG00000152642.6,32106620,chr3-31929326-A-G,rs6796265,1,A,G,31929326,177294,31910012,32303228,19314
3,ENSG00000182504.6,101724614,chr3-101824759-G-A,rs6797522,1,G,A,101824759,100145,101528006,101921222,296753
3,ENSG00000161217.6,196287726,chr3-196403134-A-G,rs6799210,-1,A,G,196403134,115408,196091118,196484334,312016
3,ENSG00000127249.10,193554895,chr3-193528134-G-A,rs6799489,-1,G,A,193528134,26761,193358287,193751503,169847
3,ENSG00000144711.8,13073429,chr3-13088896-G-A,rs6801338,-1,G,A,13088896,15467,12876821,13270037,212075
3,ENSG00000058063.9,182793504,chr3-182656261-G-A,rs6803921,1,G,A,182656261,137243,182596896,182990112,59365
3,ENSG00000154165.3,98531978,chr3-98579756-C-T,rs7103,1,C,T,98579756,47778,98335370,98728586,244386
3,ENSG00000010256.6,48609646,chr3-48578858-G-A,rs73078310,-1,G,A,48578858,30788,48413038,48806254,165820
3,ENSG00000004534.9,49940150,chr3-50024528-C-A,rs73079076,1,C,A,50024528,84378,49743542,50136758,280986
3,ENSG00000164091.7,52278649,chr3-52129976-A-T,rs73082782,-1,A,T,52129976,148673,52082041,52475257,47935
3,ENSG00000231861.1,98497681,chr3-98546594-C-G,rs73144182,1,C,G,98546594,48913,98301073,98694289,245521
3,ENSG00000232382.1,98463201,chr3-98546594-C-G,rs73144182,1,C,G,98546594,83393,98266593,98659809,280001
3,ENSG00000198829.4,151873643,chr3-151698140-C-T,rs73164654,1,C,T,151698140,175503,151677035,152070251,21105
3,ENSG00000152492.9,191329394,chr3-191235119-T-C,rs73199661,1,T,C,191235119,94275,191132786,191526002,102333
3,ENSG00000157036.8,38496340,chr3-38577821-A-G,rs7373819,1,A,G,38577821,81481,38299732,38692948,278089
3,ENSG00000214706.6,50292429,chr3-50140578-G-A,rs739983,-1,G,A,50140578,151851,50095821,50489037,44757
3,ENSG00000169313.8,151384753,chr3-151383379-C-T,rs7429509,-1,C,T,151383379,1374,151188145,151581361,195234
3,ENSG00000080200.5,97822011,chr3-98003904-A-C,rs74470022,1,A,C,98003904,181893,97625403,98018619,378501
3,ENSG00000080200.5,97822011,chr3-98003904-A-G,rs74470022,1,A,G,98003904,181893,97625403,98018619,378501
3,ENSG00000074416.8,127822515,chr3-127896934-A-G,rs74505202,-1,A,G,127896934,74419,127625907,128019123,271027
3,ENSG00000176945.11,195720978,chr3-195893937-G-C,rs74861414,1,G,C,195893937,172959,195524370,195917586,369567
3,ENSG00000129810.10,20186206,chr3-20255630-C-T,rs75335460,-1,C,T,20255630,69424,19989598,20382814,266032
3,ENSG00000153767.5,120742744,chr3-120816040-G-A,rs75542933,1,G,A,120816040,73296,120546136,120939352,269904
3,ENSG00000144815.9,101779211,chr3-101655607-G-A,rs75720698,1,G,A,101655607,123604,101582603,101975819,73004
3,ENSG00000164049.9,48372219,chr3-48353882-A-G,rs7610524,1,A,G,48353882,18337,48175611,48568827,178271
3,ENSG00000181788.3,150763169,chr3-150667395-G-T,rs7611154,-1,G,T,150667395,95774,150566561,150959777,100834
3,ENSG00000144559.6,11846885,chr3-11819466-C-T,rs7615782,-1,C,T,11819466,27419,11650277,12043493,169189
3,ENSG00000131386.12,16174680,chr3-16134395-T-G,rs76178935,1,T,G,16134395,40285,15978072,16371288,156323
3,ENSG00000180353.6,121660903,chr3-121730824-A-G,rs7621042,-1,A,G,121730824,69921,121464295,121857511,266529
3,ENSG00000132170.15,12289070,chr3-12143057-A-G,rs7621569,1,A,G,12143057,146013,12092462,12485678,50595
3,ENSG00000008324.6,42590860,chr3-42541650-G-A,rs7622205,1,G,A,42541650,49210,42394252,42787468,147398
3,ENSG00000145103.7,122022247,chr3-122185364-G-T,rs7628990,-1,G,T,122185364,163117,121825639,122218855,359725
3,ENSG00000163823.3,46208313,chr3-46144818-C-A,rs7631551,-1,C,A,46144818,63495,46011705,46404921,133113
3,ENSG00000168297.9,58332892,chr3-58454509-T-C,rs7633553,1,T,C,58454509,121617,58136284,58529500,318225
3,ENSG00000041880.10,51942363,chr3-51979226-T-C,rs7636204,1,T,C,51979226,36863,51745755,52138971,233471
3,ENSG00000174013.7,196568660,chr3-196531081-T-C,rs7638562,1,T,C,196531081,37579,196372052,196765268,159029
3,ENSG00000043093.8,182980538,chr3-183143386-G-T,rs7639990,-1,G,T,183143386,162848,182783930,183177146,359456
3,ENSG00000175697.6,120285222,chr3-120149728-A-G,rs7641727,-1,A,G,120149728,135494,120088614,120481830,61114
3,ENSG00000138496.10,122564300,chr3-122491205-C-T,rs7644540,-1,C,T,122491205,73095,122367692,122760908,123513
3,ENSG00000145014.13,194633419,chr3-194631296-C-T,rs7645514,-1,C,T,194631296,2123,194436811,194830027,194485
3,ENSG00000168028.8,39406720,chr3-39328456-T-C,rs7647254,1,T,C,39328456,78264,39210112,39603328,118344
3,ENSG00000225697.5,48635461,chr3-48795915-G-T,rs7647813,-1,G,T,48795915,160454,48438853,48832069,357062
3,ENSG00000180611.6,192917856,chr3-192921839-G-C,rs769584,-1,G,C,192921839,3983,192721248,193114464,200591
3,ENSG00000171757.10,169812904,chr3-169653876-C-T,rs77280108,-1,C,T,169653876,159028,169616296,170009512,37580
3,ENSG00000114209.10,167734892,chr3-167627286-G-C,rs77319753,-1,G,C,167627286,107606,167538284,167931500,89002
3,ENSG00000144834.7,111998922,chr3-111966019-A-G,rs774861,1,A,G,111966019,32903,111802314,112195530,163705
3,ENSG00000164087.3,52154423,chr3-52126159-G-A,rs77559399,-1,G,A,52126159,28264,51957815,52351031,168344
3,ENSG00000239732.1,52225645,chr3-52126159-G-A,rs77559399,-1,G,A,52126159,99486,52029037,52422253,97122
3,ENSG00000113812.9,53882152,chr3-53907720-G-A,rs77606615,-1,G,A,53907720,25568,53685544,54078760,222176
3,ENSG00000113812.9,53882152,chr3-53907720-G-T,rs77606615,-1,G,T,53907720,25568,53685544,54078760,222176
3,ENSG00000114737.11,50611774,chr3-50660110-A-G,rs78104031,-1,A,G,50660110,48336,50415166,50808382,244944
3,ENSG00000114473.9,197959991,chr3-197851707-A-G,rs78110111,-1,A,G,197851707,108284,197763383,198156599,88324
3,ENSG00000114541.10,69386088,chr3-69473740-G-C,rs78202567,-1,G,C,69473740,87652,69189480,69582696,284260
3,ENSG00000114541.10,69386088,chr3-69473740-G-A,rs78202567,-1,G,A,69473740,87652,69189480,69582696,284260
3,ENSG00000163870.10,127590733,chr3-127716963-T-C,rs782449,-1,T,C,127716963,126230,127394125,127787341,322838
3,ENSG00000144724.13,61561571,chr3-61582527-A-G,rs78288380,1,A,G,61582527,20956,61364963,61758179,217564
3,ENSG00000163430.4,120450992,chr3-120299101-C-T,rs787204,-1,C,T,120299101,151891,120254384,120647600,44717
3,ENSG00000169087.6,122793831,chr3-122670146-T-C,rs790123,-1,T,C,122670146,123685,122597223,122990439,72923
3,ENSG00000197938.4,98282505,chr3-98392143-G-C,rs79116017,1,G,C,98392143,109638,98085897,98479113,306246
3,ENSG00000163513.12,30606601,chr3-30760923-A-G,rs795444,1,A,G,30760923,154322,30409993,30803209,350930
3,ENSG00000163702.14,9917098,chr3-10112101-G-A,rs79677720,1,G,A,10112101,195003,9720490,10113706,391611
3,ENSG00000168026.11,39107680,chr3-39189119-G-C,rs80147433,1,G,C,39189119,81439,38911072,39304288,278047
3,ENSG00000168026.11,39107680,chr3-39189119-G-A,rs80147433,1,G,A,39189119,81439,38911072,39304288,278047
3,ENSG00000093217.5,38346785,chr3-38364294-C-T,rs818838,1,C,T,38364294,17509,38150177,38543393,214117
3,ENSG00000144647.5,43106079,chr3-43029274-T-C,rs870238,-1,T,C,43029274,76805,42909471,43302687,119803
3,ENSG00000180370.5,196739857,chr3-196829972-G-A,rs9109,1,G,A,196829972,90115,196543249,196936465,286723
3,ENSG00000163964.9,196712377,chr3-196829972-G-A,rs9109,1,G,A,196829972,117595,196515769,196908985,314203
3,ENSG00000170819.4,133400056,chr3-133462302-T-A,rs9289447,1,T,A,133462302,62246,133203448,133596664,258854
3,ENSG00000177565.10,177197482,chr3-177032638-C-T,rs9290610,-1,C,T,177032638,164844,177000874,177394090,31764
3,ENSG00000157014.5,10248459,chr3-10435342-T-C,rs929707,1,T,C,10435342,186883,10051851,10445067,383491
3,ENSG00000173950.10,195271159,chr3-195121593-G-A,rs952586,-1,G,A,195121593,149566,195074551,195467767,47042
3,ENSG00000144935.9,142724034,chr3-142818839-G-A,rs9683118,1,G,A,142818839,94805,142527426,142920642,291413
3,ENSG00000174928.9,155806278,chr3-155757090-T-C,rs9811107,-1,T,C,155757090,49188,155609670,156002886,147420
3,ENSG00000214021.10,9810262,chr3-9785085-C-T,rs9813445,1,C,T,9785085,25177,9613654,10006870,171431
3,ENSG00000144645.9,31981262,chr3-31873871-T-C,rs9816424,-1,T,C,31873871,107391,31784654,32177870,89217
3,ENSG00000114670.8,131026877,chr3-131022843-G-A,rs9817842,1,G,A,131022843,4034,130830269,131223485,192574
3,ENSG00000075420.8,172039578,chr3-172146805-G-C,rs9821928,1,G,C,172146805,107227,171842970,172236186,303835
3,ENSG00000075420.8,172039578,chr3-172146805-G-T,rs9821928,1,G,T,172146805,107227,171842970,172236186,303835
3,ENSG00000172037.8,49133050,chr3-49176870-G-T,rs9831648,-1,G,T,49176870,43820,48936442,49329658,240428
3,ENSG00000169255.9,161105349,chr3-161215140-G-A,rs9833270,-1,G,A,161215140,109791,160908741,161301957,306399
3,ENSG00000151093.3,25790090,chr3-25782526-G-C,rs983481,1,G,C,25782526,7564,25593482,25986698,189044
3,ENSG00000151093.3,25790090,chr3-25782526-G-A,rs983481,1,G,A,25782526,7564,25593482,25986698,189044
3,ENSG00000174946.5,151203216,chr3-151020968-A-C,rs9837084,-1,A,C,151020968,182248,151006608,151399824,14360
3,ENSG00000129055.8,134485985,chr3-134488292-C-A,rs9838597,-1,C,A,134488292,2307,134289377,134682593,198915
3,ENSG00000177311.6,141368504,chr3-141345111-C-T,rs9838625,1,C,T,141345111,23393,141171896,141565112,173215
3,ENSG00000145012.8,188154157,chr3-188080402-A-T,rs9849004,1,A,T,188080402,73755,187957549,188350765,122853
3,ENSG00000131378.8,16513699,chr3-16375235-G-A,rs9851148,-1,G,A,16375235,138464,16317091,16710307,58144
3,ENSG00000156976.10,186783577,chr3-186698813-C-T,rs9851706,1,C,T,186698813,84764,186586969,186980185,111844
3,ENSG00000206560.6,15797979,chr3-15926143-G-A,rs9852108,-1,G,A,15926143,128164,15601371,15994587,324772
3,ENSG00000114450.5,179451470,chr3-179278838-G-A,rs9856476,-1,G,A,179278838,172632,179254862,179648078,23976
3,ENSG00000055955.10,52830672,chr3-52879765-C-T,rs9860296,-1,C,T,52879765,49093,52634064,53027280,245701
3,ENSG00000188846.8,40457339,chr3-40267734-G-A,rs9861194,1,G,A,40267734,189605,40260731,40653947,7003
3,ENSG00000188846.8,40457339,chr3-40267734-G-C,rs9861194,1,G,C,40267734,189605,40260731,40653947,7003
3,ENSG00000070476.10,126475891,chr3-126413437-T-C,rs9864203,-1,T,C,126413437,62454,126279283,126672499,134154
3,ENSG00000113811.6,53891859,chr3-53907137-G-A,rs9864389,-1,G,A,53907137,15278,53695251,54088467,211886
3,ENSG00000070087.9,149970895,chr3-150059376-G-A,rs9874505,-1,G,A,150059376,88481,149774287,150167503,285089
3,ENSG00000136059.9,37990786,chr3-38086034-G-A,rs9875897,1,G,A,38086034,95248,37794178,38187394,291856
3,ENSG00000144820.3,100609601,chr3-100778254-C-T,rs9877951,1,C,T,100778254,168653,100412993,100806209,365261
3,ENSG00000172215.5,45943464,chr3-46082347-T-G,rs9990063,1,T,G,46082347,138883,45746856,46140072,335491
3,ENSG00000144724.13,61561571,chr3-61601574-A-G,rs10433637,1,A,G,61601574,40003,61364963,61758179,236611
3,ENSG00000173200.7,122577650,chr3-122574362-C-T,rs1045089,1,C,T,122574362,3288,122381042,122774258,193320
3,ENSG00000168329.8,39280036,chr3-39416098-G-A,rs10454237,-1,G,A,39416098,136062,39083428,39476644,332670
3,ENSG00000163528.8,14124870,chr3-14143219-T-C,rs10468,-1,T,C,14143219,18349,13928262,14321478,214957
3,ENSG00000153283.7,111542197,chr3-111516074-C-T,rs10470385,1,C,T,111516074,26123,111345589,111738805,170485
3,ENSG00000114346.9,172750726,chr3-172898461-A-G,rs10470497,1,A,G,172898461,147735,172554118,172947334,344343
3,ENSG00000196981.2,122416062,chr3-122408942-C-T,rs10511409,-1,C,T,122408942,7120,122219454,122612670,189488
3,ENSG00000163848.13,125375325,chr3-125335525-T-C,rs10512647,-1,T,C,125335525,39800,125178717,125571933,156808
3,ENSG00000174564.8,136957983,chr3-136955626-A-G,rs10513018,1,A,G,136955626,2357,136761375,137154591,194251
3,ENSG00000114450.5,179451470,chr3-179570491-G-A,rs10513761,-1,G,A,179570491,119021,179254862,179648078,315629
3,ENSG00000136518.11,179562926,chr3-179668956-A-G,rs10513763,1,A,G,179668956,106030,179366318,179759534,302638
3,ENSG00000163607.8,112990984,chr3-112794635-A-G,rs10934187,1,A,G,112794635,196349,112794376,113187592,259
3,ENSG00000091527.11,133573686,chr3-133503439-G-A,rs10935066,1,G,A,133503439,70247,133377078,133770294,126361
3,ENSG00000016864.11,52705791,chr3-52862839-C-A,rs11130329,-1,C,A,52862839,157048,52509183,52902399,353656
3,ENSG00000163686.8,58237792,chr3-58385065-T-C,rs11130633,1,T,C,58385065,147273,58041184,58434400,343881
3,ENSG00000163689.13,59050025,chr3-59088051-C-T,rs11130678,-1,C,T,59088051,38026,58853417,59246633,234634
3,ENSG00000186432.4,160565571,chr3-160720652-A-G,rs111325110,-1,A,G,160720652,155081,160368963,160762179,351689
3,ENSG00000161217.6,196287726,chr3-196219664-C-T,rs11185518,-1,C,T,196219664,68062,196091118,196484334,128546
3,ENSG00000163576.13,19934217,chr3-20067054-C-T,rs1124376,-1,C,T,20067054,132837,19737609,20130825,329445
3,ENSG00000173175.10,123449090,chr3-123320961-G-A,rs112520557,-1,G,A,123320961,128129,123252482,123645698,68479
3,ENSG00000181744.4,143971823,chr3-144134680-A-C,rs114750214,1,A,C,144134680,162857,143775215,144168431,359465
3,ENSG00000134107.4,4979437,chr3-4862192-G-A,rs114914874,1,G,A,4862192,117245,4782829,5176045,79363
3,ENSG00000145016.9,197736904,chr3-197742612-C-T,rs115188262,-1,C,T,197742612,5708,197540296,197933512,202316
3,ENSG00000056736.5,53846568,chr3-54000656-C-T,rs115203281,1,C,T,54000656,154088,53649960,54043176,350696
3,ENSG00000114209.10,167734892,chr3-167622022-A-G,rs116240517,-1,A,G,167622022,112870,167538284,167931500,83738
3,ENSG00000188306.6,169812870,chr3-169944087-G-A,rs116409830,1,G,A,169944087,131217,169616262,170009478,327825
3,ENSG00000221955.6,125212748,chr3-125342046-G-A,rs11708180,-1,G,A,125342046,129298,125016140,125409356,325906
3,ENSG00000213689.5,48466230,chr3-48354819-G-A,rs11708617,1,G,A,48354819,111411,48269622,48662838,85197
3,ENSG00000171109.13,179347709,chr3-179464684-G-A,rs11711055,1,G,A,179464684,116975,179151101,179544317,313583
3,ENSG00000074416.8,127822515,chr3-127797141-T-C,rs11715363,-1,T,C,127797141,25374,127625907,128019123,171234
3,ENSG00000164078.7,49903873,chr3-49771548-C-T,rs11717463,-1,C,T,49771548,132325,49707265,50100481,64283
3,ENSG00000131370.11,15332586,chr3-15417821-A-G,rs11919472,-1,A,G,15417821,85235,15135978,15529194,281843
3,ENSG00000161203.8,184174855,chr3-184006670-G-C,rs11926347,1,G,C,184006670,168185,183978247,184371463,28423
3,ENSG00000161203.8,184174855,chr3-184006670-G-A,rs11926347,1,G,A,184006670,168185,183978247,184371463,28423
3,ENSG00000163946.9,56683265,chr3-56823759-C-T,rs11929318,-1,C,T,56823759,140494,56486657,56879873,337102
3,ENSG00000196353.7,132035014,chr3-131908535-T-C,rs1225002,-1,T,C,131908535,126479,131838406,132231622,70129
3,ENSG00000181467.2,153162226,chr3-153171877-T-C,rs12489989,1,T,C,153171877,9651,152965618,153358834,206259
3,ENSG00000072858.6,113532555,chr3-113596175-G-A,rs12490723,1,G,A,113596175,63620,113335947,113729163,260228
3,ENSG00000131389.12,14402606,chr3-14422924-A-G,rs12494428,1,A,G,14422924,20318,14205998,14599214,216926
3,ENSG00000144741.12,66221001,chr3-66401483-T-C,rs12494912,1,T,C,66401483,180482,66024393,66417609,377090
3,ENSG00000114026.15,9749952,chr3-9748794-G-A,rs125701,1,G,A,9748794,1158,9553344,9946560,195450
3,ENSG00000144597.9,15427598,chr3-15487069-A-C,rs12631578,1,A,C,15487069,59471,15230990,15624206,256079
3,ENSG00000136521.8,179604794,chr3-179446764-A-G,rs12632246,1,A,G,179446764,158030,179408186,179801402,38578
3,ENSG00000230301.3,98264244,chr3-98242398-T-C,rs12637336,1,T,C,98242398,21846,98067636,98460852,174762
3,ENSG00000121864.5,179323031,chr3-179347428-C-T,rs13061218,1,C,T,179347428,24397,179126423,179519639,221005
3,ENSG00000189283.5,61251452,chr3-61065916-T-C,rs13061562,-1,T,C,61065916,185536,61054844,61448060,11072
3,ENSG00000168291.8,58433832,chr3-58602292-C-T,rs13076420,-1,C,T,58602292,168460,58237224,58630440,365068
3,ENSG00000255423.1,73061659,chr3-72952449-G-A,rs13091067,1,G,A,72952449,109210,72865051,73258267,87398
3,ENSG00000144824.14,111859265,chr3-111927205-C-T,rs13091880,1,C,T,111927205,67940,111662657,112055873,264548
3,ENSG00000163659.8,156674590,chr3-156519563-G-A,rs13092077,1,G,A,156519563,155027,156477982,156871198,41581
3,ENSG00000197980.6,156826353,chr3-156637615-G-A,rs13092225,1,G,A,156637615,188738,156629745,157022961,7870
3,ENSG00000144647.5,43106079,chr3-43150523-T-G,rs13318004,-1,T,G,43150523,44444,42909471,43302687,241052
3,ENSG00000121552.3,122325248,chr3-122269273-A-G,rs13324814,1,A,G,122269273,55975,122128640,122521856,140633
3,ENSG00000144868.9,133038391,chr3-133172436-A-G,rs1450055,1,A,G,133172436,134045,132841783,133234999,330653
3,ENSG00000075975.11,12557087,chr3-12747439-G-A,rs1467025,1,G,A,12747439,190352,12360479,12753695,386960
3,ENSG00000196542.4,161371517,chr3-161558788-C-A,rs1506469,-1,C,A,161558788,187271,161174909,161568125,383879
3,ENSG00000114790.8,154121390,chr3-153952749-A-G,rs1521302,1,A,G,153952749,168641,153924782,154317998,27967
3,ENSG00000145088.4,121835209,chr3-121912994-G-A,rs1523519,1,G,A,121912994,77785,121638601,122031817,274393
3,ENSG00000134086.6,10141778,chr3-10306023-G-A,rs154235,1,G,A,10306023,164245,9945170,10338386,360853
3,ENSG00000175040.4,143119771,chr3-143242177-C-G,rs1550548,1,C,G,143242177,122406,142923163,143316379,319014
3,ENSG00000175040.4,143119771,chr3-143242177-C-T,rs1550548,1,C,T,143242177,122406,142923163,143316379,319014
3,ENSG00000072756.12,3126940,chr3-3158107-G-A,rs1672766,1,G,A,3158107,31167,2930332,3323548,227775
3,ENSG00000081307.8,132660329,chr3-132785115-C-T,rs16839604,1,C,T,132785115,124786,132463721,132856937,321394
3,ENSG00000231861.1,98497681,chr3-98498868-G-T,rs16839818,1,G,T,98498868,1187,98301073,98694289,197795
3,ENSG00000091513.10,133746393,chr3-133693516-C-A,rs16840612,1,C,A,133693516,52877,133549785,133943001,143731
3,ENSG00000161204.7,184186199,chr3-184331611-G-A,rs16858676,1,G,A,184331611,145412,183989591,184382807,342020
3,ENSG00000114529.8,112086389,chr3-112232856-T-G,rs16859355,1,T,G,112232856,146467,111889781,112282997,343075
3,ENSG00000186265.5,112499472,chr3-112651422-C-T,rs16859905,-1,C,T,112651422,151950,112302864,112696080,348558
3,ENSG00000080200.5,97822011,chr3-98001495-A-G,rs1688378,1,A,G,98001495,179484,97625403,98018619,376092
3,ENSG00000154743.12,12484480,chr3-12477255-A-T,rs17036792,1,A,T,12477255,7225,12287872,12681088,189383
3,ENSG00000154781.10,14651762,chr3-14830783-G-A,rs17040339,1,G,A,14830783,179021,14455154,14848370,375629
3,ENSG00000136068.10,58008422,chr3-57896874-C-T,rs17058639,1,C,T,57896874,111548,57811814,58205030,85060
3,ENSG00000114405.6,62319022,chr3-62203046-A-G,rs17066275,1,A,G,62203046,115976,62122414,62515630,80632
3,ENSG00000114812.8,42502643,chr3-42391813-T-C,rs17074351,1,T,C,42391813,110830,42306035,42699251,85778
3,ENSG00000163810.7,44874608,chr3-44720237-A-G,rs17076938,1,A,G,44720237,154371,44678000,45071216,42237
3,ENSG00000164045.7,48188417,chr3-48156821-T-C,rs17079998,-1,T,C,48156821,31596,47991809,48385025,165012
3,ENSG00000121577.9,119660589,chr3-119629283-G-C,rs17281751,-1,G,C,119629283,31306,119463981,119857197,165302
3,ENSG00000172113.4,48301367,chr3-48138448-G-A,rs17647531,-1,G,A,48138448,162919,48104759,48497975,33689
3,ENSG00000071282.7,8501823,chr3-8551575-G-A,rs17728158,1,G,A,8551575,49752,8305215,8698431,246360
3,ENSG00000163608.9,113019671,chr3-113113587-C-A,rs1795173,-1,C,A,113113587,93916,112823063,113216279,290524
3,ENSG00000114455.9,108296490,chr3-108382476-A-C,rs1870011,1,A,C,108382476,85986,108099882,108493098,282594
3,ENSG00000114013.11,122055362,chr3-122104528-T-A,rs1915092,1,T,A,122104528,49166,121858754,122251970,245774
3,ENSG00000180370.5,196739857,chr3-196827149-C-T,rs2084386,1,C,T,196827149,87292,196543249,196936465,283900
3,ENSG00000114023.10,122384182,chr3-122283331-T-C,rs2134224,1,T,C,122283331,100851,122187574,122580790,95757
3,ENSG00000170854.11,97972431,chr3-97945881-C-T,rs2172257,-1,C,T,97945881,26550,97775823,98169039,170058
3,ENSG00000145191.6,184135358,chr3-184327622-T-C,rs2230570,1,T,C,184327622,192264,183938750,184331966,388872
3,ENSG00000163933.5,53130435,chr3-52934710-T-C,rs2257216,-1,T,C,52934710,195725,52933827,53327043,883
3,ENSG00000196653.6,44712660,chr3-44729451-C-T,rs2257995,1,C,T,44729451,16791,44516052,44909268,213399
3,ENSG00000213672.3,48685915,chr3-48518906-G-A,rs2267846,-1,G,A,48518906,167009,48489307,48882523,29599
3,ENSG00000114850.2,156555117,chr3-156531425-T-C,rs2280031,-1,T,C,156531425,23692,156358509,156751725,172916
3,ENSG00000174738.7,23945286,chr3-23916438-A-G,rs2360610,1,A,G,23916438,28848,23748678,24141894,167760
3,ENSG00000144566.5,19947097,chr3-20074585-T-C,rs2365367,1,T,C,20074585,127488,19750489,20143705,324096
3,ENSG00000168028.8,39406720,chr3-39448570-C-T,rs2370964,1,C,T,39448570,41850,39210112,39603328,238458
3,ENSG00000180914.6,8769613,chr3-8760797-T-C,rs237889,-1,T,C,8760797,8816,8573005,8966221,187792
3,ENSG00000093217.5,38346785,chr3-38349991-C-A,rs2588453,1,C,A,38349991,3206,38150177,38543393,199814
3,ENSG00000114626.12,127672952,chr3-127702011-C-T,rs2630210,1,C,T,127702011,29059,127476344,127869560,225667
3,ENSG00000113811.6,53891859,chr3-53700975-G-C,rs2633732,-1,G,C,53700975,190884,53695251,54088467,5724
3,ENSG00000010256.6,48609646,chr3-48597999-G-A,rs2633958,-1,G,A,48597999,11647,48413038,48806254,184961
3,ENSG00000211456.5,45689396,chr3-45802803-C-T,rs2673059,1,C,T,45802803,113407,45492788,45886004,310015
3,ENSG00000157014.5,10248459,chr3-10335966-C-T,rs26801,1,C,T,10335966,87507,10051851,10445067,284115
3,ENSG00000131386.12,16174680,chr3-16138356-C-T,rs2730338,1,C,T,16138356,36324,15978072,16371288,160284
3,ENSG00000163702.14,9917098,chr3-9928758-C-T,rs279547,1,C,T,9928758,11660,9720490,10113706,208268
3,ENSG00000168026.11,39107680,chr3-39108083-C-T,rs28362641,1,C,T,39108083,403,38911072,39304288,197011
3,ENSG00000134070.4,10164919,chr3-10198475-G-A,rs28473559,1,G,A,10198475,33556,9968311,10361527,230164
3,ENSG00000186792.11,50299405,chr3-50124284-A-C,rs2856236,-1,A,C,50124284,175121,50102797,50496013,21487
3,ENSG00000170017.8,105366909,chr3-105461290-T-C,rs28588542,1,T,C,105461290,94381,105170301,105563517,290989
3,ENSG00000169313.8,151384753,chr3-151227455-C-T,rs2870518,-1,C,T,151227455,157298,151188145,151581361,39310
3,ENSG00000114279.7,192727541,chr3-192898911-T-G,rs2886870,-1,T,G,192898911,171370,192530933,192924149,367978
3,ENSG00000114279.7,192727541,chr3-192898911-T-A,rs2886870,-1,T,A,192898911,171370,192530933,192924149,367978
3,ENSG00000225697.5,48635461,chr3-48694054-G-T,rs3172494,-1,G,T,48694054,58593,48438853,48832069,255201
3,ENSG00000114767.6,51941904,chr3-51987300-A-G,rs323895,-1,A,G,51987300,45396,51745296,52138512,242004
3,ENSG00000244607.1,42773253,chr3-42696547-C-T,rs339693,-1,C,T,42696547,76706,42576645,42969861,119902
3,ENSG00000244607.1,42773253,chr3-42696547-C-G,rs339693,-1,C,G,42696547,76706,42576645,42969861,119902
3,ENSG00000255154.2,58306520,chr3-58176219-A-C,rs34327759,1,A,C,58176219,130301,58109912,58503128,66307
3,ENSG00000068028.13,50340836,chr3-50196693-A-G,rs34877766,-1,A,G,50196693,144143,50144228,50537444,52465
3,ENSG00000182580.2,184561785,chr3-184381590-C-A,rs35929225,1,C,A,184381590,180195,184365177,184758393,16413
3,ENSG00000162267.7,52794796,chr3-52799789-C-A,rs3617,1,C,A,52799789,4993,52598188,52991404,201601
3,ENSG00000114021.6,100334757,chr3-100364801-A-G,rs3772687,1,A,G,100364801,30044,100138149,100531365,226652
3,ENSG00000114423.14,105869012,chr3-105888687-T-C,rs3957515,-1,T,C,105888687,19675,105672404,106065620,216283
3,ENSG00000170142.7,23805955,chr3-23647710-G-A,rs4072410,1,G,A,23647710,158245,23609347,24002563,38363
3,ENSG00000065485.13,123067025,chr3-122875255-A-G,rs41372252,1,A,G,122875255,191770,122870417,123263633,4838
3,ENSG00000214021.10,9810262,chr3-9857921-G-C,rs41523146,1,G,C,9857921,47659,9613654,10006870,244267
3,ENSG00000114446.4,108222424,chr3-108400224-T-C,rs4273371,-1,T,C,108400224,177800,108025816,108419032,374408
3,ENSG00000163961.4,196503768,chr3-196414790-A-G,rs4459932,-1,A,G,196414790,88978,196307160,196700376,107630
3,ENSG00000172340.9,67654612,chr3-67461527-A-G,rs4479607,-1,A,G,67461527,193085,67458004,67851220,3523
3,ENSG00000055955.10,52830672,chr3-52963855-T-C,rs4519686,-1,T,C,52963855,133183,52634064,53027280,329791
3,ENSG00000163882.5,184361710,chr3-184419441-G-A,rs4640598,1,G,A,184419441,57731,184165102,184558318,254339
3,ENSG00000077097.8,25664907,chr3-25587258-G-T,rs4681028,-1,G,T,25587258,77649,25468299,25861515,118959
3,ENSG00000163687.8,58210972,chr3-58211235-T-C,rs4681821,-1,T,C,58211235,263,58014364,58407580,196871
3,ENSG00000163714.11,143001570,chr3-142991222-A-G,rs4683441,1,A,G,142991222,10348,142804962,143198178,186260
3,ENSG00000069849.6,141876643,chr3-141844434-A-G,rs4683630,1,A,G,141844434,32209,141680035,142073251,164399
3,ENSG00000157087.11,10505586,chr3-10626805-T-G,rs4684732,-1,T,G,10626805,121219,10308978,10702194,317827
3,ENSG00000144559.6,11846885,chr3-11848313-C-T,rs4684823,-1,C,T,11848313,1428,11650277,12043493,198036
3,ENSG00000004399.8,129606676,chr3-129590420-T-C,rs4688807,-1,T,C,129590420,16256,129410068,129803284,180352
3,ENSG00000114268.7,48556803,chr3-48448788-C-G,rs4858794,-1,C,G,48448788,108015,48360195,48753411,88593
3,ENSG00000119227.3,196968833,chr3-196959053-C-T,rs495253,-1,C,T,196959053,9780,196772225,197165441,186828
3,ENSG00000153551.9,32391853,chr3-32485841-G-T,rs4955157,1,G,T,32485841,93988,32195245,32588461,290596
3,ENSG00000172667.6,179071809,chr3-179069343-C-T,rs4955806,-1,C,T,179069343,2466,178875201,179268417,194142
3,ENSG00000172667.6,179071809,chr3-179069343-C-G,rs4955806,-1,C,G,179069343,2466,178875201,179268417,194142
3,ENSG00000168038.6,41962103,chr3-41787905-A-G,rs4973892,-1,A,G,41787905,174198,41765495,42158711,22410
3,ENSG00000131378.8,16513699,chr3-16367158-G-A,rs553681,-1,G,A,16367158,146541,16317091,16710307,50067
3,ENSG00000174844.10,57544344,chr3-57659098-C-T,rs55790297,-1,C,T,57659098,114754,57347736,57740952,311362
3,ENSG00000085274.10,169773396,chr3-169629601-G-A,rs56062766,1,G,A,169629601,143795,169576788,169970004,52813
3,ENSG00000240303.3,132659809,chr3-132709856-A-G,rs59376040,-1,A,G,132709856,50047,132463201,132856417,246655
3,ENSG00000163584.13,170870195,chr3-171045722-G-A,rs61791116,-1,G,A,171045722,175527,170673587,171066803,372135
3,ENSG00000144713.8,12841565,chr3-13013270-T-C,rs62242719,-1,T,C,13013270,171705,12644957,13038173,368313
3,ENSG00000091972.13,112333156,chr3-112386242-A-G,rs62262360,1,A,G,112386242,53086,112136548,112529764,249694
3,ENSG00000163655.8,155870650,chr3-155867331-G-C,rs62286789,1,G,C,155867331,3319,155674042,156067258,193289
3,ENSG00000177311.6,141368504,chr3-141220586-T-C,rs6439982,1,T,C,141220586,147918,141171896,141565112,48690
3,ENSG00000163710.3,142889083,chr3-142941525-G-A,rs6440125,-1,G,A,142941525,52442,142692475,143085691,249050
3,ENSG00000114841.11,52316319,chr3-52133157-G-A,rs6445259,1,G,A,52133157,183162,52119711,52512927,13446
3,ENSG00000144635.4,32570858,chr3-32675811-G-A,rs6550149,-1,G,A,32675811,104953,32374250,32767466,301561
3,ENSG00000163320.6,88059005,chr3-88230086-T-A,rs6551300,-1,T,A,88230086,171081,87862397,88255613,367689
3,ENSG00000073111.8,127598411,chr3-127755187-G-A,rs664910,1,G,A,127755187,156776,127401803,127795019,353384
3,ENSG00000180611.6,192917856,chr3-192895447-C-A,rs67168132,-1,C,A,192895447,22409,192721248,193114464,174199
3,ENSG00000129048.5,132597270,chr3-132715307-T-C,rs6765919,1,T,C,132715307,118037,132400662,132793878,314645
3,ENSG00000181322.9,138329851,chr3-138294088-A-G,rs6767873,-1,A,G,138294088,35763,138133243,138526459,160845
3,ENSG00000076242.9,36993518,chr3-36887646-C-A,rs6769447,1,C,A,36887646,105872,36796910,37190126,90736
3,ENSG00000163719.12,9649505,chr3-9758503-A-G,rs6770581,1,A,G,9758503,108998,9452897,9846113,305606
3,ENSG00000169379.11,93980155,chr3-94146284-A-G,rs6784551,1,A,G,94146284,166129,93783547,94176763,362737
3,ENSG00000178537.5,48898882,chr3-48977248-A-G,rs6786593,-1,A,G,48977248,78366,48702274,49095490,274974
3,ENSG00000163507.8,108589438,chr3-108466794-C-T,rs6792242,-1,C,T,108466794,122644,108392830,108786046,73964
3,ENSG00000158258.10,139935185,chr3-140078590-A-C,rs6794087,1,A,C,140078590,143405,139738577,140131793,340013
3,ENSG00000131373.10,15601569,chr3-15581564-G-T,rs6794169,-1,G,T,15581564,20005,15404961,15798177,176603
3,ENSG00000144712.7,12796680,chr3-12798344-C-G,rs6794244,1,C,G,12798344,1664,12600072,12993288,198272
3,ENSG00000227124.4,75785549,chr3-75910143-G-A,rs6803458,-1,G,A,75910143,124594,75588941,75982157,321202
3,ENSG00000175697.6,120285222,chr3-120309797-G-A,rs6803846,-1,G,A,120309797,24575,120088614,120481830,221183
3,ENSG00000114125.9,141738298,chr3-141598252-T-C,rs6804635,1,T,C,141598252,140046,141541690,141934906,56562
3,ENSG00000164077.9,49929811,chr3-49803490-C-T,rs6807837,-1,C,T,49803490,126321,49733203,50126419,70287
3,ENSG00000163807.4,44761619,chr3-44670605-A-C,rs6809116,-1,A,C,44670605,91014,44565011,44958227,105594
3,ENSG00000164062.8,49674351,chr3-49797138-A-G,rs6809879,1,A,G,49797138,122787,49477743,49870959,319395
3,ENSG00000168811.2,159988835,chr3-159981785-C-T,rs692890,1,C,T,159981785,7050,159792227,160185443,189558
3,ENSG00000158234.8,138608771,chr3-138690334-C-T,rs693293,1,C,T,138690334,81563,138412163,138805379,278171
3,ENSG00000144642.15,29281071,chr3-29259807-C-T,rs73072008,1,C,T,29259807,21264,29084463,29477679,175344
3,ENSG00000163602.8,72446621,chr3-72386787-C-A,rs73101478,-1,C,A,72386787,59834,72250013,72643229,136774
3,ENSG00000178750.2,94028597,chr3-94184615-C-A,rs73161420,-1,C,A,94184615,156018,93831989,94225205,352626
3,ENSG00000145194.13,184276022,chr3-184257921-G-T,rs73185796,1,G,T,184257921,18101,184079414,184472630,178507
3,ENSG00000145194.13,184276022,chr3-184257921-G-A,rs73185796,1,G,A,184257921,18101,184079414,184472630,178507
3,ENSG00000114544.10,126084124,chr3-125908289-C-T,rs73196253,-1,C,T,125908289,175835,125887516,126280732,20773
3,ENSG00000172771.7,129428636,chr3-129411175-G-A,rs73202271,-1,G,A,129411175,17461,129232028,129625244,179147
3,ENSG00000182923.11,134486057,chr3-134556605-G-C,rs73221365,1,G,C,134556605,70548,134289449,134682665,267156
3,ENSG00000174007.7,196712250,chr3-196555215-T-C,rs7374776,-1,T,C,196555215,157035,196515642,196908858,39573
3,ENSG00000154310.12,171460405,chr3-171346921-C-T,rs73879538,-1,C,T,171346921,113484,171263797,171657013,83124
3,ENSG00000188001.5,189171971,chr3-189235199-C-T,rs73889141,1,C,T,189235199,63228,188975363,189368579,259836
3,ENSG00000157036.8,38496340,chr3-38604932-C-T,rs7428779,1,C,T,38604932,108592,38299732,38692948,305200
3,ENSG00000198218.5,49094071,chr3-48995534-C-T,rs7434187,-1,C,T,48995534,98537,48897463,49290679,98071
3,ENSG00000184897.4,129316286,chr3-129283277-G-A,rs7434264,-1,G,A,129283277,33009,129119678,129512894,163599
3,ENSG00000163932.9,53161209,chr3-53175933-G-A,rs750527,1,G,A,53175933,14724,52964601,53357817,211332
3,ENSG00000160145.10,124033369,chr3-124115976-G-T,rs75386492,1,G,T,124115976,82607,123836761,124229977,279215
3,ENSG00000010322.10,52455604,chr3-52502292-A-C,rs758801,1,A,C,52502292,46688,52258996,52652212,243296
3,ENSG00000145012.8,188154157,chr3-188039376-A-G,rs7610290,1,A,G,188039376,114781,187957549,188350765,81827
3,ENSG00000114744.4,149752489,chr3-149767506-T-C,rs7610425,-1,T,C,149767506,15017,149555881,149949097,211625
3,ENSG00000152642.6,32106620,chr3-32032703-C-G,rs7612935,1,C,G,32032703,73917,31910012,32303228,122691
3,ENSG00000034533.6,131026825,chr3-131114550-A-G,rs7615213,-1,A,G,131114550,87725,130830217,131223433,284333
3,ENSG00000162244.5,51995895,chr3-51921947-A-G,rs76199570,-1,A,G,51921947,73948,51799287,52192503,122660
3,ENSG00000206560.6,15797979,chr3-15797254-G-A,rs7625615,-1,G,A,15797254,725,15601371,15994587,195883
3,ENSG00000081148.9,101320575,chr3-101414193-G-A,rs7630419,-1,G,A,101414193,93618,101123967,101517183,290226
3,ENSG00000144645.9,31981262,chr3-31973735-G-A,rs7631762,-1,G,A,31973735,7527,31784654,32177870,189081
3,ENSG00000173193.8,122680839,chr3-122700445-A-G,rs7632072,1,A,G,122700445,19606,122484231,122877447,216214
3,ENSG00000058866.9,186362234,chr3-186417082-G-A,rs7635507,-1,G,A,186417082,54848,186165626,186558842,251456
3,ENSG00000182899.10,197950190,chr3-198035752-G-A,rs7640149,1,G,A,198035752,85562,197753582,198146798,282170
3,ENSG00000154783.6,14818962,chr3-14630804-C-T,rs7640236,1,C,T,14630804,188158,14622354,15015570,8450
3,ENSG00000114739.8,38453890,chr3-38586334-A-G,rs7645358,1,A,G,38586334,132444,38257282,38650498,329052
3,ENSG00000261796.1,129161036,chr3-129177080-A-C,rs7645386,-1,A,C,129177080,16044,128964428,129357644,212652
3,ENSG00000047457.9,149221829,chr3-149102871-T-C,rs7647629,-1,T,C,149102871,118958,149025221,149418437,77650
3,ENSG00000152580.7,151461061,chr3-151556558-C-T,rs7649833,-1,C,T,151556558,95497,151264453,151657669,292105
3,ENSG00000163347.4,190322446,chr3-190489120-C-T,rs76821364,-1,C,T,190489120,166674,190125838,190519054,363282
3,ENSG00000114107.4,138594260,chr3-138595170-G-A,rs77947724,-1,G,A,138595170,910,138397652,138790868,197518
3,ENSG00000114541.10,69386088,chr3-69235870-C-T,rs78166695,-1,C,T,69235870,150218,69189480,69582696,46390
3,ENSG00000174013.7,196568660,chr3-196513851-C-T,rs78284331,1,C,T,196513851,54809,196372052,196765268,141799
3,ENSG00000114867.14,184314606,chr3-184405485-C-T,rs79866321,1,C,T,184405485,90879,184117998,184511214,287487
3,ENSG00000168314.12,39467680,chr3-39441662-G-A,rs80250798,1,G,A,39441662,26018,39271072,39664288,170590
3,ENSG00000163888.3,184261553,chr3-184146025-A-T,rs844540,-1,A,T,184146025,115528,184064945,184458161,81080
3,ENSG00000014257.11,132317407,chr3-132325508-C-T,rs860264,1,C,T,132325508,8101,132120799,132514015,204709
3,ENSG00000187715.9,127915232,chr3-127903893-T-C,rs891885,1,T,C,127903893,11339,127718624,128111840,185269
3,ENSG00000206561.6,15521706,chr3-15568563-C-T,rs905650,-1,C,T,15568563,46857,15325098,15718314,243465
3,ENSG00000114503.6,196942528,chr3-196829972-G-A,rs9109,-1,G,A,196829972,112556,196745920,197139136,84052
3,ENSG00000154165.3,98531978,chr3-98555100-C-T,rs9289632,1,C,T,98555100,23122,98335370,98728586,219730
3,ENSG00000154175.11,100993421,chr3-100804515-G-A,rs9290224,-1,G,A,100804515,188906,100796813,101190029,7702
3,ENSG00000144791.5,45594751,chr3-45631433-C-T,rs9311374,1,C,T,45631433,36682,45398143,45791359,233290
3,ENSG00000163935.8,53046073,chr3-52953629-T-G,rs9311485,-1,T,G,52953629,92444,52849465,53242681,104164
3,ENSG00000180376.12,56557175,chr3-56621914-G-A,rs9311608,1,G,A,56621914,64739,56360567,56753783,261347
3,ENSG00000163947.7,56801949,chr3-56920493-G-A,rs9311631,-1,G,A,56920493,118544,56605341,56998557,315152
3,ENSG00000185565.6,116445487,chr3-116298889-G-A,rs960082,-1,G,A,116298889,146598,116248879,116642095,50010
3,ENSG00000178694.4,94063061,chr3-93869720-A-T,rs9683303,1,A,T,93869720,193341,93866453,94259669,3267
3,ENSG00000163864.10,139677972,chr3-139745361-T-C,rs9813586,-1,T,C,139745361,67389,139481364,139874580,263997
3,ENSG00000155903.6,141487027,chr3-141487958-C-T,rs9819371,1,C,T,141487958,931,141290419,141683635,197539
3,ENSG00000041802.6,194672191,chr3-194680083-A-G,rs9820108,-1,A,G,194680083,7892,194475583,194868799,204500
3,ENSG00000118855.12,158802054,chr3-158668800-A-G,rs9844619,1,A,G,158668800,133254,158605446,158998662,63354
3,ENSG00000168301.8,58492096,chr3-58627651-T-G,rs9846601,1,T,G,58627651,135555,58295488,58688704,332163
3,ENSG00000144736.9,72848445,chr3-73038238-A-G,rs9847243,-1,A,G,73038238,189793,72651837,73045053,386401
3,ENSG00000114378.12,50303574,chr3-50254185-G-A,rs9852677,-1,G,A,50254185,49389,50106966,50500182,147219
3,ENSG00000080822.11,98522902,chr3-98439003-G-A,rs9857087,-1,G,A,98439003,83899,98326294,98719510,112709
3,ENSG00000144802.7,101849514,chr3-101943959-C-A,rs9857771,1,C,A,101943959,94445,101652906,102046122,291053
3,ENSG00000197584.6,178536436,chr3-178654249-C-A,rs9861190,1,C,A,178654249,117813,178339828,178733044,314421
3,ENSG00000138459.4,112562045,chr3-112722101-A-G,rs9863500,1,A,G,112722101,160056,112365437,112758653,356664
3,ENSG00000129810.10,20186206,chr3-20311274-T-C,rs9871864,-1,T,C,20311274,125068,19989598,20382814,321676
3,ENSG00000145014.13,194633419,chr3-194665071-T-C,rs9876550,-1,T,C,194665071,31652,194436811,194830027,228260
3,ENSG00000114248.5,169869935,chr3-169915917-T-C,rs9876612,-1,T,C,169915917,45982,169673327,170066543,242590
3,ENSG00000171121.12,179251114,chr3-179318922-A-C,rs9968069,-1,A,C,179318922,67808,179054506,179447722,264416
2,ENSG00000118257.11,205682501,chr2-205682821-T-C,rs10090,1,T,C,205682821,320,205485893,205879109,196928
2,ENSG00000204262.6,189179761,chr2-189083088-C-T,rs10166301,-1,C,T,189083088,96673,188983153,189376369,99935
2,ENSG00000123610.3,151357592,chr2-151308073-A-G,rs10167886,1,A,G,151308073,49519,151160984,151554200,147089
2,ENSG00000143727.10,264947,chr2-70187-G-A,rs10170011,1,G,A,70187,194760,68339,461555,1848
2,ENSG00000115457.5,216633420,chr2-216795048-G-A,rs10170674,1,G,A,216795048,161628,216436812,216830028,358236
2,ENSG00000082153.12,200811910,chr2-200637672-T-C,rs10172572,1,T,C,200637672,174238,200615302,201008518,22370
2,ENSG00000150938.5,36355778,chr2-36357184-A-C,rs10176691,1,A,C,36357184,1406,36159170,36552386,198014
2,ENSG00000115977.13,69643739,chr2-69567851-C-T,rs10178273,-1,C,T,69567851,75888,69447131,69840347,120720
2,ENSG00000118961.9,20823101,chr2-20684826-G-C,rs10182643,-1,G,C,20684826,138275,20626493,21019709,58333
2,ENSG00000170035.9,180980605,chr2-181081388-A-T,rs10184839,1,A,T,181081388,100783,180783997,181177213,297391
2,ENSG00000163026.7,24047391,chr2-24188107-G-T,rs10185445,-1,G,T,24188107,140716,23850783,24243999,337324
2,ENSG00000144115.11,88170346,chr2-88163718-T-C,rs10185660,1,T,C,88163718,6628,87973738,88366954,189980
2,ENSG00000186889.5,62506195,chr2-62497674-G-T,rs10188696,-1,G,T,62497674,8521,62309587,62702803,188087
2,ENSG00000118965.10,19990105,chr2-19848236-A-C,rs10200756,-1,A,C,19848236,141869,19793497,20186713,54739
2,ENSG00000136717.10,127107154,chr2-127084193-C-T,rs10200967,-1,C,T,127084193,22961,126910546,127303762,173647
2,ENSG00000183281.10,87021844,chr2-87051761-G-A,rs10203656,-1,G,A,87051761,29917,86825236,87218452,226525
2,ENSG00000169047.4,226799820,chr2-226749289-C-T,rs10205233,-1,C,T,226749289,50531,226603212,226996428,146077
2,ENSG00000063660.4,240435663,chr2-240426048-G-A,rs10205560,1,G,A,240426048,9615,240239055,240632271,186993
2,ENSG00000138448.6,186590056,chr2-186523931-T-A,rs10208166,1,T,A,186523931,66125,186393448,186786664,130483
2,ENSG00000138036.12,43774039,chr2-43815996-T-G,rs10208987,1,T,G,43815996,41957,43577431,43970647,238565
2,ENSG00000138036.12,43774039,chr2-43815996-T-A,rs10208987,1,T,A,43815996,41957,43577431,43970647,238565
2,ENSG00000115363.9,75560939,chr2-75481829-C-A,rs10439503,-1,C,A,75481829,79110,75364331,75757547,117498
2,ENSG00000152291.9,85327989,chr2-85326661-C-T,rs1044973,-1,C,T,85326661,1328,85131381,85524597,195280
2,ENSG00000077380.11,171687469,chr2-171512890-T-C,rs10490603,1,T,C,171512890,174579,171490861,171884077,22029
2,ENSG00000115919.9,142877664,chr2-143023977-G-A,rs10496939,1,G,A,143023977,146313,142681056,143074272,342921
2,ENSG00000115084.8,113756642,chr2-113714344-A-G,rs1053413,-1,A,G,113714344,42298,113560034,113953250,154310
2,ENSG00000143797.7,9003684,chr2-9102641-C-T,rs10754952,-1,C,T,9102641,98957,8807076,9200292,295565
2,ENSG00000178662.10,165469698,chr2-165617777-C-T,rs10930174,1,C,T,165617777,148079,165273090,165666306,344687
2,ENSG00000144357.11,169827454,chr2-169924659-C-A,rs10930388,1,C,A,169924659,97205,169630846,170024062,293813
2,ENSG00000163492.9,179050137,chr2-178998979-G-A,rs10930850,-1,G,A,178998979,51158,178853529,179246745,145450
2,ENSG00000125618.12,113278921,chr2-113226726-T-C,rs11123172,-1,T,C,113226726,52195,113082313,113475529,144413
2,ENSG00000115526.6,100417668,chr2-100319814-A-C,rs11123826,-1,A,C,100319814,97854,100221060,100614276,98754
2,ENSG00000214711.5,31217515,chr2-31217504-C-T,rs11124255,-1,C,T,31217504,11,31020907,31414123,196597
2,ENSG00000013016.10,31234152,chr2-31217504-C-T,rs11124255,1,C,T,31217504,16648,31037544,31430760,179960
2,ENSG00000243244.1,48530154,chr2-48553788-T-G,rs11125176,1,T,G,48553788,23634,48333546,48726762,220242
2,ENSG00000138395.10,201806537,chr2-201883717-C-T,rs112621228,1,C,T,201883717,77180,201609929,202003145,273788
2,ENSG00000219626.4,24123469,chr2-24119662-G-A,rs1134516,1,G,A,24119662,3807,23926861,24320077,192801
2,ENSG00000151353.10,677406,chr2-708876-A-C,rs114064458,-1,A,C,708876,31470,480798,874014,228078
2,ENSG00000135625.6,73293548,chr2-73161330-T-C,rs114596492,-1,T,C,73161330,132218,73096940,73490156,64390
2,ENSG00000136710.5,130342164,chr2-130343161-G-A,rs11542411,-1,G,A,130343161,997,130145556,130538772,197605
2,ENSG00000144040.8,73071712,chr2-72906716-A-G,rs115749085,-1,A,G,72906716,164996,72875104,73268320,31612
2,ENSG00000182600.5,232870284,chr2-233023317-C-T,rs115874184,1,C,T,233023317,153033,232673676,233066892,349641
2,ENSG00000172086.7,88055783,chr2-88186480-C-T,rs115884283,-1,C,T,88186480,130697,87859175,88252391,327305
2,ENSG00000163121.5,96505357,chr2-96501606-C-T,rs116097873,-1,C,T,96501606,3751,96308749,96701965,192857
2,ENSG00000155760.1,202033855,chr2-201903976-A-C,rs116333240,1,A,C,201903976,129879,201837247,202230463,66729
2,ENSG00000138399.13,169573865,chr2-169508120-C-T,rs116649447,-1,C,T,169508120,65745,169377257,169770473,130863
2,ENSG00000144120.7,119679201,chr2-119659211-C-T,rs11678053,1,C,T,119659211,19990,119482593,119875809,176618
2,ENSG00000077044.5,233354494,chr2-233349455-C-T,rs11679046,1,C,T,233349455,5039,233157886,233551102,191569
2,ENSG00000128699.9,189784339,chr2-189681574-A-G,rs11679767,-1,A,G,189681574,102765,189587731,189980947,93843
2,ENSG00000123607.10,165953776,chr2-165867785-T-C,rs116813114,-1,T,C,165867785,85991,165757168,166150384,110617
2,ENSG00000226124.2,199851192,chr2-199761955-G-A,rs11687699,-1,G,A,199761955,89237,199654584,200047800,107371
2,ENSG00000115525.11,85888990,chr2-85940555-G-A,rs11689401,-1,G,A,85940555,51565,85692382,86085598,248173
2,ENSG00000159399.4,74834127,chr2-74771987-G-A,rs11691168,1,G,A,74771987,62140,74637519,75030735,134468
2,ENSG00000150540.9,137964473,chr2-137881427-T-C,rs11691636,1,T,C,137881427,83046,137767865,138161081,113562
2,ENSG00000135974.5,105337540,chr2-105244501-A-G,rs11695535,1,A,G,105244501,93039,105140932,105534148,103569
2,ENSG00000127838.9,218270519,chr2-218369982-T-C,rs11695562,1,T,C,218369982,99463,218073911,218467127,296071
2,ENSG00000155729.8,200510068,chr2-200477893-C-T,rs117996228,-1,C,T,200477893,32175,200313460,200706676,164433
2,ENSG00000144445.10,210171409,chr2-210340694-A-G,rs11887149,-1,A,G,210340694,169285,209974801,210368017,365893
2,ENSG00000240344.4,200889077,chr2-200908822-T-C,rs11894842,-1,T,C,200908822,19745,200692469,201085685,216353
2,ENSG00000163510.9,180007297,chr2-180009120-T-C,rs11900886,-1,T,C,180009120,1823,179810689,180203905,198431
2,ENSG00000158089.10,31138440,chr2-31123880-T-C,rs11903753,-1,T,C,31123880,14560,30941832,31335048,182048
2,ENSG00000144579.3,218399868,chr2-218374015-G-A,rs11904786,1,G,A,218374015,25853,218203260,218596476,170755
2,ENSG00000178074.5,199911293,chr2-199727787-G-A,rs12052622,1,G,A,199727787,183506,199714685,200107901,13102
2,ENSG00000085760.8,55269231,chr2-55100414-G-T,rs12464877,-1,G,T,55100414,168817,55072623,55465839,27791
2,ENSG00000204128.5,231037523,chr2-231129024-G-T,rs12471957,1,G,T,231129024,91501,230840915,231234131,288109
2,ENSG00000171103.6,28870309,chr2-28807140-T-G,rs12475612,-1,T,G,28807140,63169,28673701,29066917,133439
2,ENSG00000163249.5,207711640,chr2-207666398-T-C,rs12477677,1,T,C,207666398,45242,207515032,207908248,151366
2,ENSG00000138363.10,215312059,chr2-215422370-A-G,rs1250248,1,A,G,215422370,110311,215115451,215508667,306919
2,ENSG00000135973.1,105241743,chr2-105393395-G-A,rs12614625,1,G,A,105393395,151652,105045135,105438351,348260
2,ENSG00000168280.12,148875227,chr2-149041060-A-T,rs12617628,1,A,T,149041060,165833,148678619,149071835,362441
2,ENSG00000156966.6,231395710,chr2-231268271-C-G,rs12621280,1,C,G,231268271,127439,231199102,231592318,69169
2,ENSG00000155755.13,201643503,chr2-201686972-G-A,rs12621886,-1,G,A,201686972,43469,201446895,201840111,240077
2,ENSG00000115840.9,171894244,chr2-171869471-C-T,rs12692978,-1,C,T,171869471,24773,171697636,172090852,171835
2,ENSG00000144320.8,176002267,chr2-175873812-C-A,rs12693085,-1,C,A,175873812,128455,175805659,176198875,68153
2,ENSG00000198130.10,190319826,chr2-190337911-A-G,rs12693568,-1,A,G,190337911,18085,190123218,190516434,214693
2,ENSG00000171853.10,3379694,chr2-3557878-A-G,rs12711976,1,A,G,3557878,178184,3183086,3576302,374792
2,ENSG00000118640.6,85577586,chr2-85560218-C-T,rs12714145,1,C,T,85560218,17368,85380978,85774194,179240
2,ENSG00000162927.8,61018255,chr2-61017528-A-C,rs12988616,-1,A,C,61017528,727,60821647,61214863,195881
2,ENSG00000135913.6,218568351,chr2-218633205-A-C,rs12989189,-1,A,C,218633205,64854,218371743,218764959,261462
2,ENSG00000115350.7,74958643,chr2-75008736-T-G,rs12990965,1,T,G,75008736,50093,74762035,75155251,246701
2,ENSG00000155749.8,201357345,chr2-201472513-A-G,rs12991600,-1,A,G,201472513,115168,201160737,201553953,311776
2,ENSG00000162961.9,32039805,chr2-31996694-T-C,rs12995113,-1,T,C,31996694,43111,31843197,32236413,153497
2,ENSG00000115170.9,157876330,chr2-157924933-G-A,rs12997150,-1,G,A,157924933,48603,157679722,158072938,245211
2,ENSG00000119771.10,23385179,chr2-23383306-A-G,rs12997821,1,A,G,23383306,1873,23188571,23581787,194735
2,ENSG00000151692.9,6917412,chr2-6822251-G-A,rs13012767,1,G,A,6822251,95161,6720804,7114020,101447
2,ENSG00000151692.9,6917412,chr2-6822251-G-T,rs13012767,1,G,T,6822251,95161,6720804,7114020,101447
2,ENSG00000143869.5,20667144,chr2-20637172-G-T,rs13013492,1,G,T,20637172,29972,20470536,20863752,166636
2,ENSG00000138356.9,200586014,chr2-200484908-G-A,rs13019534,1,G,A,200484908,101106,200389406,200782622,95502
2,ENSG00000075884.8,143129419,chr2-143257524-T-C,rs13022541,1,T,C,143257524,128105,142932811,143326027,324713
2,ENSG00000081479.7,169362534,chr2-169390826-A-G,rs13029871,-1,A,G,169390826,28292,169165926,169559142,224900
2,ENSG00000116044.10,177264727,chr2-177334037-C-A,rs13032354,-1,C,A,177334037,69310,177068119,177461335,265918
2,ENSG00000186522.9,109613966,chr2-109533597-T-C,rs13339826,-1,T,C,109533597,80369,109417358,109810574,116239
2,ENSG00000152256.8,172556090,chr2-172584173-T-C,rs13385403,1,T,C,172584173,28083,172359482,172752698,224691
2,ENSG00000154252.11,241776822,chr2-241772819-C-A,rs13392946,1,C,A,241772819,4003,241580214,241973430,192605
2,ENSG00000154252.11,241776822,chr2-241772819-C-T,rs13392946,1,C,T,241772819,4003,241580214,241973430,192605
2,ENSG00000169554.9,144520119,chr2-144488248-A-G,rs13398550,-1,A,G,144488248,31871,144323511,144716727,164737
2,ENSG00000169621.5,68467585,chr2-68484301-A-G,rs13400980,1,A,G,68484301,16716,68270977,68664193,213324
2,ENSG00000163171.6,37671642,chr2-37628294-G-A,rs13401336,-1,G,A,37628294,43348,37475034,37868250,153260
2,ENSG00000116005.7,70258137,chr2-70201920-A-G,rs13403416,1,A,G,70201920,56217,70061529,70454745,140391
2,ENSG00000134326.7,6865907,chr2-6743326-T-C,rs13407528,-1,T,C,6743326,122581,6669299,7062515,74027
2,ENSG00000134321.7,6877777,chr2-6743326-T-C,rs13407528,1,T,C,6743326,134451,6681169,7074385,62157
2,ENSG00000124383.3,71130634,chr2-71142494-C-A,rs13407937,1,C,A,71142494,11860,70934026,71327242,208468
2,ENSG00000084710.8,25042076,chr2-25139815-G-A,rs13408745,1,G,A,25139815,97739,24845468,25238684,294347
2,ENSG00000114982.12,96638312,chr2-96603861-C-T,rs13413510,-1,C,T,96603861,34451,96441704,96834920,162157
2,ENSG00000163040.10,131527888,chr2-131576368-T-G,rs13417184,1,T,G,131576368,48480,131331280,131724496,245088
2,ENSG00000115649.11,219176925,chr2-219104375-A-G,rs13419740,-1,A,G,219104375,72550,218980317,219373533,124058
2,ENSG00000152133.9,37084518,chr2-37050668-A-G,rs13423928,1,A,G,37050668,33850,36887910,37281126,162758
2,ENSG00000168874.8,85753991,chr2-85743580-C-T,rs13430978,1,C,T,85743580,10411,85557383,85950599,186197
2,ENSG00000123983.9,222861036,chr2-223023646-C-G,rs1347998,1,C,G,223023646,162610,222664428,223057644,359218
2,ENSG00000172954.8,30447246,chr2-30473341-A-G,rs1357849,1,A,G,30473341,26095,30250638,30643854,222703
2,ENSG00000115183.9,158968640,chr2-159008541-T-G,rs1365907,1,T,G,159008541,39901,158772032,159165248,236509
2,ENSG00000115946.3,68157888,chr2-68236480-G-A,rs1375371,1,G,A,68236480,78592,67961280,68354496,275200
2,ENSG00000071909.12,170178147,chr2-170173181-C-T,rs1424652,1,C,T,170173181,4966,169981539,170374755,191642
2,ENSG00000006607.8,241356285,chr2-241228073-A-C,rs14345,1,A,C,241228073,128212,241159677,241552893,68396
2,ENSG00000128641.12,191245404,chr2-191237092-C-T,rs1454761,1,C,T,191237092,8312,191048796,191442012,188296
2,ENSG00000146205.9,241188677,chr2-241357034-A-G,rs1476698,1,A,G,241357034,168357,240992069,241385285,364965
2,ENSG00000186854.6,84881084,chr2-84877023-T-A,rs1478782,-1,T,A,84877023,4061,84684476,85077692,192547
2,ENSG00000136536.9,159712506,chr2-159894350-T-C,rs1511224,1,T,C,159894350,181844,159515898,159909114,378452
2,ENSG00000169031.13,227164624,chr2-227154069-A-C,rs1574248,1,A,C,227154069,10555,226968016,227361232,186053
2,ENSG00000115232.8,181457386,chr2-181625027-G-T,rs1596023,1,G,T,181625027,167641,181260778,181653994,364249
2,ENSG00000067066.11,230416201,chr2-230331417-C-A,rs16827136,1,C,A,230331417,84784,230219593,230612809,111824
2,ENSG00000138386.12,190649083,chr2-190704982-G-A,rs16832848,1,G,A,190704982,55899,190452475,190845691,252507
2,ENSG00000055044.5,202265763,chr2-202152977-C-T,rs16838892,1,C,T,202152977,112786,202069155,202462371,83822
2,ENSG00000055044.5,202265763,chr2-202152977-C-A,rs16838892,1,C,A,202152977,112786,202069155,202462371,83822
2,ENSG00000115687.9,241149472,chr2-241091675-G-A,rs16843241,-1,G,A,241091675,57797,240952864,241346080,138811
2,ENSG00000078098.8,162243445,chr2-162195194-G-C,rs16846353,-1,G,C,162195194,48251,162046837,162440053,148357
2,ENSG00000172292.10,168456272,chr2-168483619-T-C,rs16855379,1,T,C,168483619,27347,168259664,168652880,223955
2,ENSG00000127837.5,218270137,chr2-218158594-C-A,rs16858736,-1,C,A,218158594,111543,218073529,218466745,85065
2,ENSG00000127837.5,218270137,chr2-218158594-C-T,rs16858736,-1,C,T,218158594,111543,218073529,218466745,85065
2,ENSG00000163082.9,222424543,chr2-222592474-C-T,rs16863916,1,C,T,222592474,167931,222227935,222621151,364539
2,ENSG00000152056.12,223837582,chr2-223957267-T-C,rs16865355,-1,T,C,223957267,119685,223640974,224034190,316293
2,ENSG00000152056.12,223837582,chr2-223957267-T-G,rs16865355,-1,T,G,223957267,119685,223640974,224034190,316293
2,ENSG00000134308.8,9630997,chr2-9762773-A-G,rs16867155,-1,A,G,9762773,131776,9434389,9827605,328384
2,ENSG00000134317.13,9951693,chr2-9955056-T-C,rs16867251,1,T,C,9955056,3363,9755085,10148301,199971
2,ENSG00000240857.1,18560653,chr2-18504215-C-T,rs16985169,-1,C,T,18504215,56438,18364045,18757261,140170
2,ENSG00000189350.7,28981298,chr2-29030451-G-T,rs17007465,1,G,T,29030451,49153,28784690,29177906,245761
2,ENSG00000005448.12,74421730,chr2-74253532-C-T,rs17009774,1,C,T,74253532,168198,74225122,74618338,28410
2,ENSG00000115317.7,74529933,chr2-74653146-T-C,rs17010131,1,T,C,74653146,123213,74333325,74726541,319821
2,ENSG00000171055.10,36598168,chr2-36556456-T-C,rs17019087,-1,T,C,36556456,41712,36401560,36794776,154896
2,ENSG00000071073.6,98731132,chr2-98639438-A-G,rs17021689,-1,A,G,98639438,91694,98534524,98927740,104914
2,ENSG00000068724.10,46941224,chr2-46944183-A-G,rs17035912,1,A,G,46944183,2959,46744616,47137832,199567
2,ENSG00000153253.10,165204050,chr2-165295879-G-A,rs17183814,-1,G,A,165295879,91829,165007442,165400658,288437
2,ENSG00000071967.7,171522474,chr2-171527478-G-A,rs17288042,1,G,A,171527478,5004,171325866,171719082,201612
2,ENSG00000168758.6,96870080,chr2-96956671-G-C,rs1730127,-1,G,C,96956671,86591,96673472,97066688,283199
2,ENSG00000170745.7,17878667,chr2-17867386-C-T,rs17316177,1,C,T,17867386,11281,17682059,18075275,185327
2,ENSG00000115825.5,37324833,chr2-37316679-T-G,rs17410072,-1,T,G,37316679,8154,37128225,37521441,188454
2,ENSG00000138050.10,39779258,chr2-39897235-G-A,rs17540476,-1,G,A,39897235,117977,39582650,39975866,314585
2,ENSG00000136682.9,113437691,chr2-113379965-G-A,rs17628215,1,G,A,113379965,57726,113241083,113634299,138882
2,ENSG00000135637.9,74482998,chr2-74624016-G-A,rs17667404,-1,G,A,74624016,141018,74286390,74679606,337626
2,ENSG00000159374.13,74648330,chr2-74761442-A-G,rs17675669,-1,A,G,74761442,113112,74451722,74844938,309720
2,ENSG00000091428.11,172735845,chr2-172594862-T-C,rs17702263,1,T,C,172594862,140983,172539237,172932453,55625
2,ENSG00000091436.12,173075846,chr2-173173274-T-C,rs17710437,1,T,C,173173274,97428,172879238,173272454,294036
2,ENSG00000163449.6,216081919,chr2-216238927-C-T,rs17770648,1,C,T,216238927,157008,215885311,216278527,353616
2,ENSG00000138092.6,24793425,chr2-24773846-T-A,rs17799110,1,T,A,24773846,19579,24596817,24990033,177029
2,ENSG00000218739.4,37196496,chr2-37237368-C-G,rs1861444,1,C,G,37237368,40872,36999888,37393104,237480
2,ENSG00000197635.5,162074215,chr2-162073199-T-G,rs1861978,-1,T,G,162073199,1016,161877607,162270823,195592
2,ENSG00000115944.9,42361217,chr2-42350030-A-G,rs1981664,-1,A,G,42350030,11187,42164609,42557825,185421
2,ENSG00000115109.9,120013077,chr2-120086690-G-A,rs1982334,1,G,A,120086690,73613,119816469,120209685,270221
2,ENSG00000118004.12,3595112,chr2-3580793-C-G,rs2071639,1,C,G,3580793,14319,3398504,3791720,182289
2,ENSG00000118004.12,3595112,chr2-3580793-C-A,rs2071639,1,C,A,3580793,14319,3398504,3791720,182289
2,ENSG00000176732.6,24123334,chr2-24128037-A-G,rs2080727,-1,A,G,24128037,4703,23926726,24319942,201311
2,ENSG00000221944.3,232550557,chr2-232545584-C-T,rs2099489,-1,C,T,232545584,4973,232353949,232747165,191635
2,ENSG00000061676.9,183038457,chr2-182962290-G-A,rs2271671,-1,G,A,182962290,76167,182841849,183235065,120441
2,ENSG00000125629.10,118088471,chr2-118057292-C-T,rs2276695,1,C,T,118057292,31179,117891863,118285079,165429
2,ENSG00000144488.10,238100340,chr2-238083155-C-T,rs2278742,1,C,T,238083155,17185,237903732,238296948,179423
2,ENSG00000084774.8,27217369,chr2-27366943-T-C,rs2280737,1,T,C,27366943,149574,27020761,27413977,346182
2,ENSG00000115216.8,27428631,chr2-27366943-T-C,rs2280737,1,T,C,27366943,61688,27232023,27625239,134920
2,ENSG00000115750.10,9843474,chr2-9843557-G-T,rs2303914,1,G,T,9843557,83,9646866,10040082,196691
2,ENSG00000155066.11,95274449,chr2-95196988-T-C,rs2320625,1,T,C,95196988,77461,95077841,95471057,119147
2,ENSG00000115963.9,150487667,chr2-150435090-A-C,rs2334310,-1,A,C,150435090,52577,150291059,150684275,144031
2,ENSG00000115484.10,61888656,chr2-61735826-A-G,rs2421433,-1,A,G,61735826,152830,61692048,62085264,43778
2,ENSG00000196604.7,130129222,chr2-130109037-G-C,rs2438682,-1,G,C,130109037,20185,129932614,130325830,176423
2,ENSG00000144401.9,207625378,chr2-207633241-T-G,rs2464975,-1,T,G,207633241,7863,207428770,207821986,204471
2,ENSG00000138085.11,27212041,chr2-27209632-T-G,rs2580759,1,T,G,27209632,2409,27015433,27408649,194199
2,ENSG00000034510.4,84905656,chr2-85063500-C-A,rs2583544,1,C,A,85063500,157844,84709048,85102264,354452
2,ENSG00000163002.8,183124443,chr2-183113821-A-G,rs2675058,1,A,G,183113821,10622,182927835,183321051,185986
2,ENSG00000154518.5,175181710,chr2-175203668-A-G,rs268174,-1,A,G,175203668,21958,174985102,175378318,218566
2,ENSG00000138375.8,216412484,chr2-216439429-T-G,rs2738278,1,T,G,216439429,26945,216215876,216609092,223553
2,ENSG00000135930.9,232550689,chr2-232370621-A-C,rs2741309,1,A,C,232370621,180068,232354081,232747297,16540
2,ENSG00000204120.9,232697331,chr2-232793599-C-T,rs283468,1,C,T,232793599,96268,232500723,232893939,292876
2,ENSG00000198142.3,109614364,chr2-109656781-G-A,rs28627141,1,G,A,109656781,42417,109417756,109810972,239025
2,ENSG00000115306.10,54456327,chr2-54634866-G-A,rs2941580,1,G,A,54634866,178539,54259719,54652935,375147
2,ENSG00000135916.11,230864942,chr2-230912836-G-C,rs2969126,1,G,C,230912836,47894,230668334,231061550,244502
2,ENSG00000115325.9,74554720,chr2-74640403-C-T,rs3025981,1,C,T,74640403,85683,74358112,74751328,282291
2,ENSG00000162989.3,154698695,chr2-154698578-G-A,rs3111034,1,G,A,154698578,117,154502087,154895303,196491
2,ENSG00000155636.9,178112437,chr2-178203939-T-C,rs334111,1,T,C,178203939,91502,177915829,178309045,288110
2,ENSG00000144231.5,127858155,chr2-127815279-G-A,rs335128,-1,G,A,127815279,42876,127661547,128054763,153732
2,ENSG00000138061.7,38076151,chr2-38031684-C-T,rs336039,-1,C,T,38031684,44467,37879543,38272759,152141
2,ENSG00000055917.11,20350844,chr2-20451204-T-C,rs342054,-1,T,C,20451204,100360,20154236,20547452,296968
2,ENSG00000162929.9,61065871,chr2-61145372-A-G,rs34279970,1,A,G,61145372,79501,60869263,61262479,276109
2,ENSG00000172554.7,950849,chr2-794979-T-C,rs34416867,1,T,C,794979,155870,754241,1147457,40738
2,ENSG00000178295.9,17754138,chr2-17716221-T-C,rs35195207,1,T,C,17716221,37917,17557530,17950746,158691
2,ENSG00000118260.8,207529962,chr2-207498953-G-A,rs35224925,1,G,A,207498953,31009,207333354,207726570,165599
2,ENSG00000142330.15,240586734,chr2-240761259-G-A,rs35945835,1,G,A,240761259,174525,240390126,240783342,371133
2,ENSG00000176946.6,241637158,chr2-241509931-A-G,rs35971633,-1,A,G,241509931,127227,241440550,241833766,69381
2,ENSG00000115318.7,74553942,chr2-74683576-G-T,rs363645,-1,G,T,74683576,129634,74357334,74750550,326242
2,ENSG00000115307.11,74529706,chr2-74683576-G-T,rs363645,-1,G,T,74683576,153870,74333098,74726314,350478
2,ENSG00000075292.11,71331782,chr2-71176051-G-C,rs370068,1,G,C,71176051,155731,71135174,71528390,40877
2,ENSG00000163596.12,202871766,chr2-202955552-T-C,rs3731695,-1,T,C,202955552,83786,202675158,203068374,280394
2,ENSG00000204186.3,206274663,chr2-206309592-T-C,rs3732084,1,T,C,206309592,34929,206078055,206471271,231537
2,ENSG00000187231.8,179264832,chr2-179399974-T-C,rs3749124,-1,T,C,179399974,135142,179068224,179461440,331750
2,ENSG00000250565.2,46542577,chr2-46541996-T-C,rs3754553,-1,T,C,46541996,581,46345969,46739185,196027
2,ENSG00000079150.12,178478600,chr2-178391235-G-A,rs3765020,-1,G,A,178391235,87365,178281992,178675208,109243
2,ENSG00000068784.8,45611267,chr2-45466700-T-A,rs3770268,-1,T,A,45466700,144567,45414659,45807875,52041
2,ENSG00000011523.8,65056416,chr2-65096955-A-G,rs3771105,1,A,G,65096955,40539,64859808,65253024,237147
2,ENSG00000128708.8,171922461,chr2-171978695-T-G,rs3791342,1,T,G,171978695,56234,171725853,172119069,252842
2,ENSG00000179921.10,218261015,chr2-218400673-C-T,rs3795985,1,C,T,218400673,139658,218064407,218457623,336266
2,ENSG00000138400.8,206765328,chr2-206768278-A-G,rs3815686,-1,A,G,206768278,2950,206568720,206961936,199558
2,ENSG00000144354.9,173354872,chr2-173238700-C-A,rs3820831,1,C,A,173238700,116172,173158264,173551480,80436
2,ENSG00000115756.8,10302904,chr2-10424964-C-T,rs3821197,1,C,T,10424964,122060,10106296,10499512,318668
2,ENSG00000163162.4,101308701,chr2-101294923-A-G,rs3828194,-1,A,G,101294923,13778,101112093,101505309,182830
2,ENSG00000213337.4,96858016,chr2-96925933-T-C,rs3903548,-1,T,C,96925933,67917,96661408,97054624,264525
2,ENSG00000228486.2,97669713,chr2-97608974-A-G,rs3906948,1,A,G,97608974,60739,97473105,97866321,135869
2,ENSG00000125538.7,112836779,chr2-112825205-C-T,rs3917368,-1,C,T,112825205,11574,112640171,113033387,185034
2,ENSG00000143942.4,53767804,chr2-53630261-T-C,rs3937481,1,T,C,53630261,137543,53571196,53964412,59065
2,ENSG00000127824.9,219253918,chr2-219079106-T-A,rs41398145,-1,T,A,219079106,174812,219057310,219450526,21796
2,ENSG00000185304.11,87825796,chr2-88007164-T-C,rs4246597,-1,T,C,88007164,181368,87629188,88022404,377976
2,ENSG00000170264.8,61854060,chr2-61853877-A-C,rs4270331,-1,A,C,61853877,183,61657452,62050668,196425
2,ENSG00000068781.14,48580607,chr2-48423169-C-T,rs4316980,1,C,T,48423169,157438,48383999,48777215,39170
2,ENSG00000163806.11,28810834,chr2-28877776-A-C,rs4358081,1,A,C,28877776,66942,28614226,29007442,263550
2,ENSG00000151665.8,46617041,chr2-46562375-A-G,rs4384837,-1,A,G,46562375,54666,46420433,46813649,141942
2,ENSG00000130294.9,240820219,chr2-240741216-G-A,rs4414678,-1,G,A,240741216,79003,240623611,241016827,117605
2,ENSG00000130294.9,240820219,chr2-240741216-G-T,rs4414678,-1,G,T,240741216,79003,240623611,241016827,117605
2,ENSG00000042445.9,85354528,chr2-85320306-G-T,rs4459734,-1,G,T,85320306,34222,85157920,85551136,162386
2,ENSG00000042445.9,85354528,chr2-85320306-G-C,rs4459734,-1,G,C,85320306,34222,85157920,85551136,162386
2,ENSG00000003402.12,201116164,chr2-201157024-T-C,rs4482462,1,T,C,201157024,40860,200919556,201312772,237468
2,ENSG00000136731.8,128091200,chr2-128114854-G-A,rs4497826,1,G,A,128114854,23654,127894592,128287808,220262
2,ENSG00000115884.6,20225130,chr2-20185472-G-A,rs4632301,-1,G,A,20185472,39658,20028522,20421738,156950
2,ENSG00000136560.8,161160428,chr2-161044790-T-C,rs4664395,1,T,C,161044790,115638,160963820,161357036,80970
2,ENSG00000138029.9,26244939,chr2-26295728-G-T,rs4665848,1,G,T,26295728,50789,26048331,26441547,247397
2,ENSG00000163811.7,28894667,chr2-28941156-G-T,rs4666141,1,G,T,28941156,46489,28698059,29091275,243097
2,ENSG00000198648.6,168247595,chr2-168309795-G-A,rs4668060,-1,G,A,168309795,62200,168050987,168444203,258808
2,ENSG00000205795.4,10080411,chr2-10093628-G-A,rs4669527,-1,G,A,10093628,13217,9883803,10277019,209825
2,ENSG00000115902.5,64989399,chr2-64917653-G-A,rs4671631,1,G,A,64917653,71746,64792791,65186007,124862
2,ENSG00000068878.10,53970993,chr2-54126207-G-A,rs4671869,-1,G,A,54126207,155214,53774385,54167601,351822
2,ENSG00000142327.6,240568484,chr2-240621671-G-T,rs4676411,1,G,T,240621671,53187,240371876,240765092,249795
2,ENSG00000142327.6,240568484,chr2-240621671-G-A,rs4676411,1,G,A,240621671,53187,240371876,240765092,249795
2,ENSG00000119185.8,9423528,chr2-9406676-C-T,rs4798,-1,C,T,9406676,16852,9226920,9620136,179756
2,ENSG00000115561.10,86563443,chr2-86751772-G-T,rs4832311,-1,G,T,86751772,188329,86366835,86760051,384937
2,ENSG00000115107.14,119223834,chr2-119293439-A-G,rs4848546,1,A,G,119293439,69605,119027226,119420442,266213
2,ENSG00000088205.7,117814691,chr2-117864651-A-G,rs4849631,1,A,G,117864651,49960,117618083,118011299,246568
2,ENSG00000115539.9,100562993,chr2-100543299-G-A,rs4851329,1,G,A,100543299,19694,100366385,100759601,176914
2,ENSG00000144043.7,70994873,chr2-70990983-C-T,rs4852738,-1,C,T,70990983,3890,70798265,71191481,192718
2,ENSG00000144034.10,73737345,chr2-73700804-A-G,rs4852974,-1,A,G,73700804,36541,73540737,73933953,160067
2,ENSG00000163219.6,68734811,chr2-68790692-T-C,rs4854516,1,T,C,68790692,55881,68538203,68931419,252489
2,ENSG00000163072.10,168802637,chr2-168881876-A-C,rs494859,1,A,C,168881876,79239,168606029,168999245,275847
2,ENSG00000152253.4,168890430,chr2-168881402-A-G,rs525428,-1,A,G,168881402,9028,168693822,169087038,187580
2,ENSG00000184898.6,151261863,chr2-151261757-G-A,rs55775354,-1,G,A,151261757,106,151065255,151458471,196502
2,ENSG00000169599.8,69437435,chr2-69464470-C-A,rs55902961,-1,C,A,69464470,27035,69240827,69634043,223643
2,ENSG00000136709.7,127811171,chr2-127790874-T-C,rs57992231,-1,T,C,127790874,20297,127614563,128007779,176311
2,ENSG00000115339.9,165794247,chr2-165719832-C-T,rs59775523,-1,C,T,165719832,74415,165597639,165990855,122193
2,ENSG00000144580.9,218568839,chr2-218737817-G-T,rs61733652,1,G,T,218737817,168978,218372231,218765447,365586
2,ENSG00000153563.10,86790913,chr2-86747566-A-G,rs62148507,-1,A,G,86747566,43347,86594305,86987521,153261
2,ENSG00000168763.10,96816268,chr2-96928566-C-T,rs62152915,1,C,T,96928566,112298,96619660,97012876,308906
2,ENSG00000144021.2,96266225,chr2-96318221-C-T,rs62153901,1,C,T,96318221,51996,96069617,96462833,248604
2,ENSG00000138430.11,174248532,chr2-174337970-G-A,rs62174228,-1,G,A,174337970,89438,174051924,174445140,286046
2,ENSG00000163466.11,218217189,chr2-218358010-G-A,rs62182089,1,G,A,218358010,140821,218020581,218413797,337429
2,ENSG00000085982.8,233566782,chr2-233566769-G-A,rs62192778,-1,G,A,233566769,13,233370174,233763390,196595
2,ENSG00000177519.3,153478762,chr2-153660997-T-A,rs6434796,-1,T,A,153660997,182235,153282154,153675370,378843
2,ENSG00000177519.3,153478762,chr2-153660997-T-C,rs6434796,-1,T,C,153660997,182235,153282154,153675370,378843
2,ENSG00000162994.11,55232293,chr2-55233615-C-T,rs6545480,-1,C,T,55233615,1322,55035685,55428901,197930
2,ENSG00000168894.5,85595745,chr2-85597128-T-C,rs6643,1,T,C,85597128,1383,85399137,85792353,197991
2,ENSG00000180228.8,178451175,chr2-178477226-G-A,rs6704545,-1,G,A,178477226,26051,178254567,178647783,222659
2,ENSG00000115486.6,85561493,chr2-85534294-A-C,rs6705971,-1,A,C,85534294,27199,85364885,85758101,169409
2,ENSG00000074054.12,121649476,chr2-121597079-G-A,rs6707415,-1,G,A,121597079,52397,121452868,121846084,144211
2,ENSG00000144029.7,95121808,chr2-94927120-G-A,rs6710440,-1,G,A,94927120,194688,94925200,95318416,1920
2,ENSG00000135912.6,218710835,chr2-218636156-T-C,rs6710896,1,T,C,218636156,74679,218514227,218907443,121929
2,ENSG00000135905.12,225042468,chr2-224950362-T-C,rs6711462,-1,T,C,224950362,92106,224845860,225239076,104502
2,ENSG00000072135.7,130356056,chr2-130363576-A-G,rs6713511,1,A,G,130363576,7520,130159448,130552664,204128
2,ENSG00000184731.5,46505,chr2-81986-G-A,rs6714203,-1,G,A,81986,35481,-150103,243113,232089
2,ENSG00000079785.8,15591868,chr2-15603594-A-C,rs6717251,1,A,C,15603594,11726,15395260,15788476,208334
2,ENSG00000188452.9,181657105,chr2-181851599-G-A,rs6718469,-1,G,A,181851599,194494,181460497,181853713,391102
2,ENSG00000168427.7,238138668,chr2-237961242-C-T,rs6723077,1,C,T,237961242,177426,237942060,238335276,19182
2,ENSG00000116062.7,47783145,chr2-47618384-C-T,rs6723080,1,C,T,47618384,164761,47586537,47979753,31847
2,ENSG00000186453.8,24175053,chr2-24344421-C-T,rs6729160,1,C,T,24344421,169368,23978445,24371661,365976
2,ENSG00000173349.4,127701497,chr2-127762973-G-A,rs6731093,1,G,A,127762973,61476,127504889,127898105,258084
2,ENSG00000221823.5,68252532,chr2-68275912-G-A,rs6731373,-1,G,A,68275912,23380,68055924,68449140,219988
2,ENSG00000115159.10,156436379,chr2-156433844-T-C,rs6732240,1,T,C,156433844,2535,156239771,156632987,194073
2,ENSG00000197557.4,177618742,chr2-177615586-T-C,rs6736390,-1,T,C,177615586,3156,177422134,177815350,193452
2,ENSG00000042493.10,85410366,chr2-85375941-G-A,rs6741368,-1,G,A,85375941,34425,85213758,85606974,162183
2,ENSG00000132329.6,237859623,chr2-237890564-C-G,rs6741923,1,C,G,237890564,30941,237663015,238056231,227549
2,ENSG00000115138.6,25168580,chr2-25143380-C-T,rs6742181,-1,C,T,25143380,25200,24971972,25365188,171408
2,ENSG00000115138.6,25168580,chr2-25143380-C-G,rs6742181,-1,C,G,25143380,25200,24971972,25365188,171408
2,ENSG00000168906.7,85539168,chr2-85594081-A-G,rs6742887,1,A,G,85594081,54913,85342560,85735776,251521
2,ENSG00000115241.8,27409591,chr2-27344540-G-T,rs6743819,-1,G,T,27344540,65051,27212983,27606199,131557
2,ENSG00000143971.7,67397333,chr2-67263506-C-T,rs6745786,1,C,T,67263506,133827,67200725,67593941,62781
2,ENSG00000135624.10,73234308,chr2-73306492-G-A,rs6745973,1,G,A,73306492,72184,73037700,73430916,268792
2,ENSG00000157992.8,27442381,chr2-27464044-T-C,rs6747190,1,T,C,27464044,21663,27245773,27638989,218271
2,ENSG00000135972.4,105038069,chr2-105086781-G-T,rs6748981,1,G,T,105086781,48712,104841461,105234677,245320
2,ENSG00000169967.12,127387975,chr2-127438848-T-G,rs6749002,-1,T,G,127438848,50873,127191367,127584583,247481
2,ENSG00000095002.7,47403156,chr2-47545811-T-C,rs6749075,1,T,C,47545811,142655,47206548,47599764,339263
2,ENSG00000132305.15,86195462,chr2-86172969-G-A,rs6749439,-1,G,A,86172969,22493,85998854,86392070,174115
2,ENSG00000132305.15,86195462,chr2-86172969-G-T,rs6749439,-1,G,T,86172969,22493,85998854,86392070,174115
2,ENSG00000035141.3,70302067,chr2-70329205-T-C,rs6750178,-1,T,C,70329205,27138,70105459,70498675,223746
2,ENSG00000156973.9,231781282,chr2-231715085-T-C,rs6755895,-1,T,C,231715085,66197,231584674,231977890,130411
2,ENSG00000138095.13,43995989,chr2-43908858-C-A,rs6756365,-1,C,A,43908858,87131,43799381,44192597,109477
2,ENSG00000138413.9,208255071,chr2-208088086-C-T,rs6758890,-1,C,T,208088086,166985,208058463,208451679,29623
2,ENSG00000153094.15,111120914,chr2-111097681-A-C,rs6759108,1,A,C,111097681,23233,110924306,111317522,173375
2,ENSG00000135631.11,73112948,chr2-73168871-G-T,rs71416778,-1,G,T,73168871,55923,72916340,73309556,252531
2,ENSG00000180902.11,241734630,chr2-241759875-C-T,rs71430382,1,C,T,241759875,25245,241538022,241931238,221853
2,ENSG00000237651.2,61162188,chr2-61149328-T-C,rs720201,1,T,C,61149328,12860,60965580,61358796,183748
2,ENSG00000134313.9,8837613,chr2-8878281-T-G,rs72771515,-1,T,G,8878281,40668,8641005,9034221,237276
2,ENSG00000144031.7,70978630,chr2-70833870-T-A,rs72836219,1,T,A,70833870,144760,70782022,71175238,51848
2,ENSG00000163006.6,108786771,chr2-108857894-T-C,rs72836521,1,T,C,108857894,71123,108590163,108983379,267731
2,ENSG00000204923.2,68467294,chr2-68436367-A-C,rs72900012,-1,A,C,68436367,30927,68270686,68663902,165681
2,ENSG00000204923.2,68467294,chr2-68436367-A-T,rs72900012,-1,A,T,68436367,30927,68270686,68663902,165681
2,ENSG00000197223.7,68063004,chr2-68059504-C-G,rs72906862,-1,C,G,68059504,3500,67866396,68259612,193108
2,ENSG00000173559.7,191678136,chr2-191670816-T-G,rs73063325,1,T,G,191670816,7320,191481528,191874744,189288
2,ENSG00000198612.6,237085889,chr2-237114333-G-A,rs73085508,1,G,A,237114333,28444,236889281,237282497,225052
2,ENSG00000135898.5,230925242,chr2-230946983-A-G,rs7340358,-1,A,G,230946983,21741,230728634,231121850,218349
2,ENSG00000115129.9,24084834,chr2-24055674-C-T,rs74326069,-1,C,T,24055674,29160,23888226,24281442,167448
2,ENSG00000088179.4,119759922,chr2-119617194-G-A,rs74521588,1,G,A,119617194,142728,119563314,119956530,53880
2,ENSG00000115112.6,121285202,chr2-121303429-A-G,rs74593207,-1,A,G,121303429,18227,121088594,121481810,214835
2,ENSG00000135956.3,96265997,chr2-96129975-G-A,rs749459,-1,G,A,96129975,136022,96069389,96462605,60586
2,ENSG00000218819.3,21123968,chr2-21297755-A-G,rs75346744,1,A,G,21297755,173787,20927360,21320576,370395
2,ENSG00000144355.10,172085507,chr2-172252235-A-G,rs75390055,1,A,G,172252235,166728,171888899,172282115,363336
2,ENSG00000168397.11,241637693,chr2-241569597-A-G,rs7558942,1,A,G,241569597,68096,241441085,241834301,128512
2,ENSG00000170634.7,53971113,chr2-54112496-C-T,rs7561836,1,C,T,54112496,141383,53774505,54167721,337991
2,ENSG00000183891.5,19901983,chr2-19897175-C-A,rs7563410,-1,C,A,19897175,4808,19705375,20098591,191800
2,ENSG00000173272.9,131492397,chr2-131507385-G-A,rs7565546,-1,G,A,131507385,14988,131295789,131689005,211596
2,ENSG00000119844.10,64524305,chr2-64538425-C-T,rs7567596,1,C,T,64538425,14120,64327697,64720913,210728
2,ENSG00000073737.11,169069563,chr2-168937193-C-T,rs7568243,1,C,T,168937193,132370,168872955,169266171,64238
2,ENSG00000241399.2,159798208,chr2-159833016-T-C,rs7568814,-1,T,C,159833016,34808,159601600,159994816,231416
2,ENSG00000204843.7,74380311,chr2-74551517-C-T,rs7569357,-1,C,T,74551517,171206,74183703,74576919,367814
2,ENSG00000170340.10,62196115,chr2-62191423-C-T,rs7572994,1,C,T,62191423,4692,61999507,62392723,191916
2,ENSG00000115423.13,84516498,chr2-84468879-A-G,rs7575751,1,A,G,84468879,47619,84319890,84713106,148989
2,ENSG00000116127.13,73385836,chr2-73384153-A-G,rs7576824,1,A,G,73384153,1683,73189228,73582444,194925
2,ENSG00000152292.11,85418714,chr2-85420498-C-T,rs75770276,1,C,T,85420498,1784,85222106,85615322,198392
2,ENSG00000168890.9,85602698,chr2-85420498-C-T,rs75770276,-1,C,T,85420498,182200,85406090,85799306,14408
2,ENSG00000138439.10,202634969,chr2-202686018-T-C,rs7577225,1,T,C,202686018,51049,202438361,202831577,247657
2,ENSG00000068697.6,20051628,chr2-20139347-G-A,rs75772582,-1,G,A,20139347,87719,19855020,20248236,284327
2,ENSG00000153561.8,86720291,chr2-86794326-G-A,rs7577266,1,G,A,86794326,74035,86523683,86916899,270643
2,ENSG00000168542.8,188974373,chr2-188997322-G-C,rs7579815,1,G,C,188997322,22949,188777765,189170981,219557
2,ENSG00000132313.9,86199457,chr2-86220150-T-G,rs7583021,1,T,G,86220150,20693,86002849,86396065,217301
2,ENSG00000198369.5,65432599,chr2-65373033-C-T,rs7583316,-1,C,T,65373033,59566,65235991,65629207,137042
2,ENSG00000152154.5,39665917,chr2-39508758-A-T,rs7585512,1,A,T,39508758,157159,39469309,39862525,39449
2,ENSG00000213639.5,28751830,chr2-28670094-G-A,rs7586033,1,G,A,28670094,81736,28555222,28948438,114872
2,ENSG00000163001.7,55519718,chr2-55558165-T-C,rs7586124,1,T,C,55558165,38447,55323110,55716326,235055
2,ENSG00000163001.7,55519718,chr2-55558165-T-G,rs7586124,1,T,G,55558165,38447,55323110,55716326,235055
2,ENSG00000135926.6,218292503,chr2-218296141-C-A,rs7587220,-1,C,A,218296141,3638,218095895,218489111,200246
2,ENSG00000170485.12,100820139,chr2-100836378-C-T,rs7587573,1,C,T,100836378,16239,100623531,101016747,212847
2,ENSG00000152518.5,43226606,chr2-43312986-T-G,rs7590268,-1,T,G,43312986,86380,43029998,43423214,282988
2,ENSG00000153832.7,229922503,chr2-229988849-T-G,rs7590987,1,T,G,229988849,66346,229725895,230119111,262954
2,ENSG00000169679.9,110678063,chr2-110797585-G-A,rs7592058,-1,G,A,110797585,119522,110481455,110874671,316130
2,ENSG00000018699.7,32628050,chr2-32675263-A-G,rs7594173,1,A,G,32675263,47213,32431442,32824658,243821
2,ENSG00000119013.4,201072001,chr2-200977287-G-A,rs7597440,1,G,A,200977287,94714,200875393,201268609,101894
2,ENSG00000119878.5,46617215,chr2-46629946-T-C,rs7598578,1,T,C,46629946,12731,46420607,46813823,209339
2,ENSG00000169564.5,70087477,chr2-70024862-T-G,rs7604106,1,T,G,70024862,62615,69890869,70284085,133993
2,ENSG00000138030.8,27086772,chr2-27122616-G-A,rs7605526,1,G,A,27122616,35844,26890164,27283380,232452
2,ENSG00000144118.8,120252852,chr2-120287271-T-C,rs76316712,1,T,C,120287271,34419,120056244,120449460,231027
2,ENSG00000226479.3,120223400,chr2-120287271-T-C,rs76316712,-1,T,C,120287271,63871,120026792,120420008,260479
2,ENSG00000162976.8,11155467,chr2-11179724-T-C,rs76651240,1,T,C,11179724,24257,10958859,11352075,220865
2,ENSG00000072163.12,127675530,chr2-127514441-C-T,rs76665584,-1,C,T,127514441,161089,127478922,127872138,35519
2,ENSG00000075568.12,97995948,chr2-98104295-T-C,rs76793380,-1,T,C,98104295,108347,97799340,98192556,304955
2,ENSG00000136002.12,130836914,chr2-130967982-G-A,rs76805414,1,G,A,130967982,131068,130640306,131033522,327676
2,ENSG00000198885.5,96325317,chr2-96325754-A-G,rs772174,1,A,G,96325754,437,96128709,96521925,197045
2,ENSG00000158050.4,96145440,chr2-96297946-A-G,rs772178,-1,A,G,96297946,152506,95948832,96342048,349114
2,ENSG00000128656.9,175005381,chr2-174983279-T-G,rs78093511,-1,T,G,174983279,22102,174808773,175201989,174506
2,ENSG00000163126.10,96844021,chr2-96941073-T-C,rs78131290,-1,T,C,96941073,97052,96647413,97040629,293660
2,ENSG00000172059.6,10043550,chr2-10034265-G-A,rs78389260,1,G,A,10034265,9285,9846942,10240158,187323
2,ENSG00000138079.8,44275480,chr2-44368664-C-T,rs786620,1,C,T,44368664,93184,44078872,44472088,289792
2,ENSG00000019169.8,118942194,chr2-119131054-C-T,rs78780094,1,C,T,119131054,188860,118745586,119138802,385468
2,ENSG00000144015.4,95592001,chr2-95711578-C-T,rs79102712,1,C,T,95711578,119577,95395393,95788609,316185
2,ENSG00000114999.6,112482156,chr2-112310045-A-G,rs79245040,1,A,G,112310045,172111,112285548,112678764,24497
2,ENSG00000115590.9,101991960,chr2-101916417-A-C,rs79676986,1,A,C,101916417,75543,101795352,102188568,121065
2,ENSG00000184261.3,47570985,chr2-47725638-C-T,rs797685,-1,C,T,47725638,154653,47374377,47767593,351261
2,ENSG00000163803.8,28496060,chr2-28577160-C-T,rs80005535,1,C,T,28577160,81100,28299452,28692668,277708
2,ENSG00000152128.12,134719000,chr2-134660613-T-C,rs80076499,-1,T,C,134660613,58387,134522392,134915608,138221
2,ENSG00000115155.11,26558756,chr2-26477505-G-A,rs80356569,-1,G,A,26477505,81251,26362148,26755364,115357
2,ENSG00000163795.9,27380734,chr2-27432253-T-C,rs811904,-1,T,C,27432253,51519,27184126,27577342,248127
2,ENSG00000153201.10,108719482,chr2-108784803-C-T,rs826556,1,C,T,108784803,65321,108522874,108916090,261929
2,ENSG00000114978.12,74178879,chr2-74145551-A-C,rs828888,-1,A,C,74145551,33328,73982271,74375487,163280
2,ENSG00000064989.8,187448252,chr2-187285501-A-C,rs840606,-1,A,C,187285501,162751,187251644,187644860,33857
2,ENSG00000162928.7,61017720,chr2-60868370-G-C,rs842640,1,G,C,60868370,149350,60821112,61214328,47258
2,ENSG00000124831.13,237627587,chr2-237729888-A-G,rs869434,1,A,G,237729888,102301,237430979,237824195,298909
2,ENSG00000119787.9,38377273,chr2-38285380-C-T,rs875653,-1,C,T,38285380,91893,38180665,38573881,104715
2,ENSG00000125611.11,112584609,chr2-112554706-T-C,rs9308673,1,T,C,112554706,29903,112388001,112781217,166705
2,ENSG00000119866.15,60553654,chr2-60450637-C-T,rs9309327,-1,C,T,60450637,103017,60357046,60750262,93591
2,ENSG00000115841.15,37925287,chr2-37837451-C-T,rs934207,1,C,T,37837451,87836,37728679,38121895,108772
2,ENSG00000136718.5,130342897,chr2-130261616-T-C,rs938869,1,T,C,130261616,81281,130146289,130539505,115327
2,ENSG00000130414.6,240025342,chr2-239980874-G-A,rs967476,-1,G,A,239980874,44468,239828734,240221950,152140
2,ENSG00000182551.7,3519531,chr2-3505916-G-A,rs9750132,-1,G,A,3505916,13615,3322923,3716139,182993
2,ENSG00000079263.11,230225736,chr2-230251075-G-A,rs9989746,1,G,A,230251075,25339,230029128,230422344,221947
2,ENSG00000214595.6,54723662,chr2-54875480-G-A,rs10164992,1,G,A,54875480,151818,54527054,54920270,348426
2,ENSG00000163449.6,216081919,chr2-216089849-A-G,rs10182201,1,A,G,216089849,7930,215885311,216278527,204538
2,ENSG00000163006.6,108786771,chr2-108704520-A-G,rs10197130,1,A,G,108704520,82251,108590163,108983379,114357
2,ENSG00000119729.6,46542490,chr2-46454829-G-A,rs10199953,1,G,A,46454829,87661,46345882,46739098,108947
2,ENSG00000119729.6,46542490,chr2-46454829-G-C,rs10199953,1,G,C,46454829,87661,46345882,46739098,108947
2,ENSG00000183891.5,19901983,chr2-19884372-A-G,rs10204428,-1,A,G,19884372,17611,19705375,20098591,178997
2,ENSG00000135925.4,218880852,chr2-218809056-C-T,rs10206109,1,C,T,218809056,71796,218684244,219077460,124812
2,ENSG00000135925.4,218880852,chr2-218809056-C-A,rs10206109,1,C,A,218809056,71796,218684244,219077460,124812
2,ENSG00000138375.8,216412484,chr2-216397237-C-T,rs10211039,1,C,T,216397237,15247,216215876,216609092,181361
2,ENSG00000144231.5,127858155,chr2-127677758-T-C,rs10211103,-1,T,C,127677758,180397,127661547,128054763,16211
2,ENSG00000153561.8,86720291,chr2-86616799-A-G,rs10451632,1,A,G,86616799,103492,86523683,86916899,93116
2,ENSG00000071967.7,171522474,chr2-171554763-G-A,rs10455,1,G,A,171554763,32289,171325866,171719082,228897
2,ENSG00000115935.11,174597804,chr2-174496073-A-G,rs10497409,-1,A,G,174496073,101731,174401196,174794412,94877
2,ENSG00000169031.13,227164624,chr2-227198013-T-C,rs10498215,1,T,C,227198013,33389,226968016,227361232,229997
2,ENSG00000163171.6,37671642,chr2-37644996-G-A,rs10694,-1,G,A,37644996,26646,37475034,37868250,169962
2,ENSG00000054356.6,219309401,chr2-219445905-G-A,rs1078166,-1,G,A,219445905,136504,219112793,219506009,333112
2,ENSG00000219626.4,24123469,chr2-24114724-C-T,rs10865262,1,C,T,24114724,8745,23926861,24320077,187863
2,ENSG00000155755.13,201643503,chr2-201652951-T-C,rs10931966,-1,T,C,201652951,9448,201446895,201840111,206056
2,ENSG00000115649.11,219176925,chr2-219032259-C-A,rs10932793,-1,C,A,219032259,144666,218980317,219373533,51942
2,ENSG00000143797.7,9003684,chr2-9109909-C-A,rs1109670,-1,C,A,9109909,106225,8807076,9200292,302833
2,ENSG00000143797.7,9003684,chr2-9109909-C-G,rs1109670,-1,C,G,9109909,106225,8807076,9200292,302833
2,ENSG00000125618.12,113278921,chr2-113236840-G-T,rs1110839,-1,G,T,113236840,42081,113082313,113475529,154527
2,ENSG00000115274.10,74455087,chr2-74261343-G-A,rs112250416,1,G,A,74261343,193744,74258479,74651695,2864
2,ENSG00000176732.6,24123334,chr2-24119662-G-A,rs1134516,-1,G,A,24119662,3672,23926726,24319942,192936
2,ENSG00000179921.10,218261015,chr2-218129680-C-T,rs113602504,1,C,T,218129680,131335,218064407,218457623,65273
2,ENSG00000163121.5,96505357,chr2-96684492-C-T,rs114200183,-1,C,T,96684492,179135,96308749,96701965,375743
2,ENSG00000154518.5,175181710,chr2-175059456-C-G,rs1145068,-1,C,G,175059456,122254,174985102,175378318,74354
2,ENSG00000187699.6,190180863,chr2-190084481-G-A,rs114794899,1,G,A,190084481,96382,189984255,190377471,100226
2,ENSG00000152102.12,131093460,chr2-131017730-G-A,rs115214719,-1,G,A,131017730,75730,130896852,131290068,120878
2,ENSG00000144591.11,219498891,chr2-219577896-T-C,rs115518306,1,T,C,219577896,79005,219302283,219695499,275613
2,ENSG00000150540.9,137964473,chr2-137964059-G-A,rs11569722,1,G,A,137964059,414,137767865,138161081,196194
2,ENSG00000188738.8,185738804,chr2-185610844-C-T,rs115834632,1,C,T,185610844,127960,185542196,185935412,68648
2,ENSG00000115216.8,27428631,chr2-27419867-A-C,rs11675428,1,A,C,27419867,8764,27232023,27625239,187844
2,ENSG00000135905.12,225042468,chr2-224907117-C-T,rs11677647,-1,C,T,224907117,135351,224845860,225239076,61257
2,ENSG00000163806.11,28810834,chr2-28985950-A-G,rs11682639,1,A,G,28985950,175116,28614226,29007442,371724
2,ENSG00000196843.9,96536752,chr2-96571356-A-G,rs11688674,1,A,G,96571356,34604,96340144,96733360,231212
2,ENSG00000233087.4,131364168,chr2-131348333-C-T,rs117494212,-1,C,T,131348333,15835,131167560,131560776,180773
2,ENSG00000075426.7,28392858,chr2-28556222-C-T,rs118175241,1,C,T,28556222,163364,28196250,28589466,359972
2,ENSG00000226479.3,120223400,chr2-120260961-A-G,rs11893187,-1,A,G,120260961,37561,120026792,120420008,234169
2,ENSG00000143970.11,25878487,chr2-25852344-G-A,rs11894773,-1,G,A,25852344,26143,25681879,26075095,170465
2,ENSG00000138434.11,181891730,chr2-181979817-A-G,rs11895963,1,A,G,181979817,88087,181695122,182088338,284695
2,ENSG00000198369.5,65432599,chr2-65296655-G-A,rs11897123,-1,G,A,65296655,135944,65235991,65629207,60664
2,ENSG00000198369.5,65432599,chr2-65296655-G-C,rs11897123,-1,G,C,65296655,135944,65235991,65629207,60664
2,ENSG00000115604.6,102355796,chr2-102186762-T-G,rs11900775,1,T,G,102186762,169034,102159188,102552404,27574
2,ENSG00000115604.6,102355796,chr2-102186762-T-C,rs11900775,1,T,C,102186762,169034,102159188,102552404,27574
2,ENSG00000143942.4,53767804,chr2-53610941-C-T,rs11901756,1,C,T,53610941,156863,53571196,53964412,39745
2,ENSG00000152291.9,85327989,chr2-85437276-G-T,rs12473017,-1,G,T,85437276,109287,85131381,85524597,305895
2,ENSG00000163093.7,169479494,chr2-169483742-T-C,rs12612150,1,T,C,169483742,4248,169282886,169676102,200856
2,ENSG00000115685.10,241150467,chr2-241130658-A-G,rs12613100,1,A,G,241130658,19809,240953859,241347075,176799
2,ENSG00000115944.9,42361217,chr2-42199384-A-G,rs12614424,-1,A,G,42199384,161833,42164609,42557825,34775
2,ENSG00000130508.6,1744515,chr2-1754994-A-G,rs12614997,-1,A,G,1754994,10479,1547907,1941123,207087
2,ENSG00000115850.4,135837184,chr2-135964033-A-G,rs12615624,-1,A,G,135964033,126849,135640576,136033792,323457
2,ENSG00000124370.6,71130229,chr2-70975503-C-T,rs12616710,-1,C,T,70975503,154726,70933621,71326837,41882
2,ENSG00000197635.5,162074215,chr2-161958313-A-G,rs12619850,-1,A,G,161958313,115902,161877607,162270823,80706
2,ENSG00000243910.3,219253243,chr2-219269288-T-C,rs12694457,1,T,C,219269288,16045,219056635,219449851,212653
2,ENSG00000138092.6,24793425,chr2-24898984-G-A,rs12713419,1,G,A,24898984,105559,24596817,24990033,302167
2,ENSG00000035141.3,70302067,chr2-70200325-A-G,rs12713689,-1,A,G,70200325,101742,70105459,70498675,94866
2,ENSG00000153563.10,86790913,chr2-86672815-C-A,rs12714202,-1,C,A,86672815,118098,86594305,86987521,78510
2,ENSG00000143994.9,27123815,chr2-27163931-T-C,rs1275539,1,T,C,27163931,40116,26927207,27320423,236724
2,ENSG00000151353.10,677406,chr2-674963-G-A,rs12990777,-1,G,A,674963,2443,480798,874014,194165
2,ENSG00000061676.9,183038457,chr2-182864469-C-T,rs12992123,-1,C,T,182864469,173988,182841849,183235065,22620
2,ENSG00000115232.8,181457386,chr2-181548532-A-G,rs12997453,1,A,G,181548532,91146,181260778,181653994,287754
2,ENSG00000019169.8,118942194,chr2-119077251-A-G,rs12999348,1,A,G,119077251,135057,118745586,119138802,331665
2,ENSG00000171055.10,36598168,chr2-36711965-C-T,rs13006747,-1,C,T,36711965,113797,36401560,36794776,310405
2,ENSG00000011523.8,65056416,chr2-64914799-C-T,rs13012644,1,C,T,64914799,141617,64859808,65253024,54991
2,ENSG00000088205.7,117814691,chr2-117827203-C-T,rs13020804,1,C,T,117827203,12512,117618083,118011299,209120
2,ENSG00000118246.9,206765606,chr2-206666603-A-G,rs13023391,1,A,G,206666603,99003,206568998,206962214,97605
2,ENSG00000118257.11,205682501,chr2-205643415-T-C,rs13023594,1,T,C,205643415,39086,205485893,205879109,157522
2,ENSG00000115919.9,142877664,chr2-142953436-A-G,rs13024113,1,A,G,142953436,75772,142681056,143074272,272380
2,ENSG00000135930.9,232550689,chr2-232379271-A-T,rs13026692,1,A,T,232379271,171418,232354081,232747297,25190
2,ENSG00000204186.3,206274663,chr2-206424638-T-C,rs13029574,1,T,C,206424638,149975,206078055,206471271,346583
2,ENSG00000115594.7,102142746,chr2-102092606-G-A,rs13384701,1,G,A,102092606,50140,101946138,102339354,146468
2,ENSG00000074054.12,121649476,chr2-121811751-A-T,rs13391367,-1,A,T,121811751,162275,121452868,121846084,358883
2,ENSG00000151665.8,46617041,chr2-46578234-A-G,rs13404342,-1,A,G,46578234,38807,46420433,46813649,157801
2,ENSG00000158435.3,101252886,chr2-101138894-A-G,rs13412911,1,A,G,101138894,113992,101056278,101449494,82616
2,ENSG00000072135.7,130356056,chr2-130369588-T-C,rs13414462,1,T,C,130369588,13532,130159448,130552664,210140
2,ENSG00000204120.9,232697331,chr2-232661387-G-A,rs13424032,1,G,A,232661387,35944,232500723,232893939,160664
2,ENSG00000124374.8,71227103,chr2-71398637-G-A,rs13424541,-1,G,A,71398637,171534,71030495,71423711,368142
2,ENSG00000119844.10,64524305,chr2-64476152-C-A,rs1345516,1,C,A,64476152,48153,64327697,64720913,148455
2,ENSG00000115183.9,158968640,chr2-159034862-A-G,rs1365906,1,A,G,159034862,66222,158772032,159165248,262830
2,ENSG00000144118.8,120252852,chr2-120257013-C-T,rs1370379,1,C,T,120257013,4161,120056244,120449460,200769
2,ENSG00000138036.12,43774039,chr2-43675618-C-G,rs143787127,1,C,G,43675618,98421,43577431,43970647,98187
2,ENSG00000178385.9,208025527,chr2-208039096-T-C,rs1545503,-1,T,C,208039096,13569,207828919,208222135,210177
2,ENSG00000138386.12,190649083,chr2-190639338-A-C,rs1558473,1,A,C,190639338,9745,190452475,190845691,186863
2,ENSG00000081052.10,227164205,chr2-227154069-A-C,rs1574248,-1,A,C,227154069,10136,226967597,227360813,186472
2,ENSG00000169047.4,226799820,chr2-226783067-A-G,rs16822638,-1,A,G,226783067,16753,226603212,226996428,179855
2,ENSG00000115053.10,231464484,chr2-231336638-T-C,rs16827953,-1,T,C,231336638,127846,231267876,231661092,68762
2,ENSG00000115963.9,150487667,chr2-150457333-A-G,rs16828206,-1,A,G,150457333,30334,150291059,150684275,166274
2,ENSG00000115415.13,191014171,chr2-190822469-A-C,rs16832982,-1,A,C,190822469,191702,190817563,191210779,4906
2,ENSG00000114933.10,206086174,chr2-206198058-G-T,rs16838046,-1,G,T,206198058,111884,205889566,206282782,308492
2,ENSG00000138395.10,201806537,chr2-201780215-A-G,rs16838146,1,A,G,201780215,26322,201609929,202003145,170286
2,ENSG00000155760.1,202033855,chr2-201862313-G-A,rs16838316,1,G,A,201862313,171542,201837247,202230463,25066
2,ENSG00000115020.11,208266255,chr2-208142031-A-C,rs16840549,1,A,C,208142031,124224,208069647,208462863,72384
2,ENSG00000081320.5,196171578,chr2-196324966-G-A,rs16849595,-1,G,A,196324966,153388,195974970,196368186,349996
2,ENSG00000138376.6,214809683,chr2-214810560-G-A,rs16852821,-1,G,A,214810560,877,214613075,215006291,197485
2,ENSG00000185013.11,18589569,chr2-18504215-C-T,rs16985169,-1,C,T,18504215,85354,18392961,18786177,111254
2,ENSG00000118960.8,20651098,chr2-20496481-T-G,rs16987690,-1,T,G,20496481,154617,20454490,20847706,41991
2,ENSG00000143869.5,20667144,chr2-20588293-T-A,rs16987857,1,T,A,20588293,78851,20470536,20863752,117757
2,ENSG00000135637.9,74482998,chr2-74488311-T-C,rs17009977,-1,T,C,74488311,5313,74286390,74679606,201921
2,ENSG00000214711.5,31217515,chr2-31200577-G-A,rs17011001,-1,G,A,31200577,16938,31020907,31414123,179670
2,ENSG00000118004.12,3595112,chr2-3611134-T-C,rs17017737,1,T,C,3611134,16022,3398504,3791720,212630
2,ENSG00000115423.13,84516498,chr2-84705742-G-A,rs17025503,1,G,A,84705742,189244,84319890,84713106,385852
2,ENSG00000135966.7,105329735,chr2-105503899-G-T,rs17031003,-1,G,T,105503899,174164,105133127,105526343,370772
2,ENSG00000183281.10,87021844,chr2-87094919-G-A,rs17041053,-1,G,A,87094919,73075,86825236,87218452,269683
2,ENSG00000153094.15,111120914,chr2-111194199-T-G,rs17041909,1,T,G,111194199,73285,110924306,111317522,269893
2,ENSG00000198885.5,96325317,chr2-96142810-T-C,rs1724121,1,T,C,96142810,182507,96128709,96521925,14101
2,ENSG00000155729.8,200510068,chr2-200571832-A-G,rs17448235,-1,A,G,200571832,61764,200313460,200706676,258372
2,ENSG00000011566.8,39437285,chr2-39508321-C-G,rs17467001,-1,C,G,39508321,71036,39240677,39633893,267644
2,ENSG00000197756.4,216498844,chr2-216450379-A-G,rs17486539,1,A,G,216450379,48465,216302236,216695452,148143
2,ENSG00000168899.4,85584431,chr2-85647722-G-A,rs17508843,1,G,A,85647722,63291,85387823,85781039,259899
2,ENSG00000244617.1,69961631,chr2-69949553-T-C,rs17573853,-1,T,C,69949553,12078,69765023,70158239,184530
2,ENSG00000075340.15,70768200,chr2-70617236-G-T,rs17697184,-1,G,T,70617236,150964,70571592,70964808,45644
2,ENSG00000119878.5,46617215,chr2-46636110-A-C,rs17768132,1,A,C,46636110,18895,46420607,46813823,215503
2,ENSG00000144199.6,97094882,chr2-96957676-G-A,rs1796043,-1,G,A,96957676,137206,96898274,97291490,59402
2,ENSG00000068724.10,46941224,chr2-47005356-A-G,rs1865258,1,A,G,47005356,64132,46744616,47137832,260740
2,ENSG00000042445.9,85354528,chr2-85341687-G-A,rs1969260,-1,G,A,85341687,12841,85157920,85551136,183767
2,ENSG00000115977.13,69643739,chr2-69531795-C-T,rs1985342,-1,C,T,69531795,111944,69447131,69840347,84664
2,ENSG00000136689.14,113127598,chr2-113052709-G-A,rs1992761,1,G,A,113052709,74889,112930990,113324206,121719
2,ENSG00000119185.8,9423528,chr2-9430925-C-T,rs2002044,-1,C,T,9430925,7397,9226920,9620136,204005
2,ENSG00000119771.10,23385179,chr2-23336054-A-G,rs2016432,1,A,G,23336054,49125,23188571,23581787,147483
2,ENSG00000138069.12,65130106,chr2-64966257-C-T,rs2017320,-1,C,T,64966257,163849,64933498,65326714,32759
2,ENSG00000196141.7,200306693,chr2-200438287-G-T,rs2028201,1,G,T,200438287,131594,200110085,200503301,328202
2,ENSG00000085982.8,233566782,chr2-233455780-T-G,rs2034761,-1,T,G,233455780,111002,233370174,233763390,85606
2,ENSG00000136536.9,159712506,chr2-159789781-G-A,rs2042782,1,G,A,159789781,77275,159515898,159909114,273883
2,ENSG00000196975.9,69742134,chr2-69709503-C-T,rs2048255,1,C,T,69709503,32631,69545526,69938742,163977
2,ENSG00000075886.9,131476119,chr2-131553515-T-C,rs2055786,1,T,C,131553515,77396,131279511,131672727,274004
2,ENSG00000144043.7,70994873,chr2-70975947-A-G,rs2058552,-1,A,G,70975947,18926,70798265,71191481,177682
2,ENSG00000142330.15,240586734,chr2-240721561-T-C,rs2060193,1,T,C,240721561,134827,240390126,240783342,331435
2,ENSG00000057935.8,42568632,chr2-42623445-C-T,rs2103338,1,C,T,42623445,54813,42372024,42765240,251421
2,ENSG00000079263.11,230225736,chr2-230210491-G-A,rs2114592,1,G,A,230210491,15245,230029128,230422344,181363
2,ENSG00000163541.7,84459280,chr2-84291508-A-G,rs2124178,-1,A,G,84291508,167772,84262672,84655888,28836
2,ENSG00000143971.7,67397333,chr2-67315322-T-C,rs2128769,1,T,C,67315322,82011,67200725,67593941,114597
2,ENSG00000071909.12,170178147,chr2-170217377-G-A,rs2161916,1,G,A,170217377,39230,169981539,170374755,235838
2,ENSG00000152689.13,33476649,chr2-33514230-T-G,rs2168395,1,T,G,33514230,37581,33280041,33673257,234189
2,ENSG00000115760.9,32357023,chr2-32543730-G-A,rs2254106,1,G,A,32543730,186707,32160415,32553631,383315
2,ENSG00000084754.6,26244632,chr2-26139646-G-T,rs2289021,-1,G,T,26139646,104986,26048024,26441240,91622
2,ENSG00000138100.8,27282429,chr2-27133123-G-T,rs2289358,1,G,T,27133123,149306,27085821,27479037,47302
2,ENSG00000138100.8,27282429,chr2-27133123-G-C,rs2289358,1,G,C,27133123,149306,27085821,27479037,47302
2,ENSG00000180398.7,46915806,chr2-46908107-A-G,rs2289927,-1,A,G,46908107,7699,46719198,47112414,188909
2,ENSG00000138028.9,27119128,chr2-27035383-T-G,rs2304714,-1,T,G,27035383,83745,26922520,27315736,112863
2,ENSG00000071073.6,98731132,chr2-98690041-C-T,rs2309434,-1,C,T,98690041,41091,98534524,98927740,155517
2,ENSG00000115590.9,101991960,chr2-102047167-T-G,rs2310173,1,T,G,102047167,55207,101795352,102188568,251815
2,ENSG00000163219.6,68734811,chr2-68785390-G-A,rs2311413,1,G,A,68785390,50579,68538203,68931419,247187
2,ENSG00000170745.7,17878667,chr2-17882190-G-A,rs2344695,1,G,A,17882190,3523,17682059,18075275,200131
2,ENSG00000138381.4,189661459,chr2-189783193-A-G,rs2352709,1,A,G,189783193,121734,189464851,189858067,318342
2,ENSG00000138400.8,206765328,chr2-206715585-G-A,rs2359682,-1,G,A,206715585,49743,206568720,206961936,146865
2,ENSG00000119862.7,64454162,chr2-64294232-C-T,rs2433390,1,C,T,64294232,159930,64257554,64650770,36678
2,ENSG00000128699.9,189784339,chr2-189875589-G-C,rs256553,-1,G,C,189875589,91250,189587731,189980947,287858
2,ENSG00000121989.10,147845029,chr2-147971481-T-C,rs2627019,1,T,C,147971481,126452,147648421,148041637,323060
2,ENSG00000123600.13,171433990,chr2-171564609-C-T,rs2674489,-1,C,T,171564609,130619,171237382,171630598,327227
2,ENSG00000116016.9,46297407,chr2-46204246-C-T,rs281512,1,C,T,46204246,93161,46100799,46494015,103447
2,ENSG00000115539.9,100562993,chr2-100430830-T-C,rs2871346,1,T,C,100430830,132163,100366385,100759601,64445
2,ENSG00000178623.7,240625480,chr2-240626595-G-A,rs2953153,1,G,A,240626595,1115,240428872,240822088,197723
2,ENSG00000115310.13,55050451,chr2-55080729-C-T,rs2968821,-1,C,T,55080729,30278,54853843,55247059,226886
2,ENSG00000035115.15,264032,chr2-181748-C-A,rs300693,-1,C,A,181748,82284,67424,460640,114324
2,ENSG00000157985.12,235494043,chr2-235599327-A-G,rs34091485,1,A,G,235599327,105284,235297435,235690651,301892
2,ENSG00000125611.11,112584609,chr2-112502162-A-C,rs34179430,1,A,C,112502162,82447,112388001,112781217,114161
2,ENSG00000125611.11,112584609,chr2-112502162-A-G,rs34179430,1,A,G,112502162,82447,112388001,112781217,114161
2,ENSG00000162928.7,61017720,chr2-61029908-A-G,rs34223071,1,A,G,61029908,12188,60821112,61214328,208796
2,ENSG00000138379.3,190062729,chr2-190036972-T-C,rs35285831,-1,T,C,190036972,25757,189866121,190259337,170851
2,ENSG00000198380.7,69387227,chr2-69390545-C-T,rs35380455,-1,C,T,69390545,3318,69190619,69583835,199926
2,ENSG00000115107.14,119223834,chr2-119208364-C-T,rs35741883,1,C,T,119208364,15470,119027226,119420442,181138
2,ENSG00000168542.8,188974373,chr2-189068038-G-A,rs35830636,1,G,A,189068038,93665,188777765,189170981,290273
2,ENSG00000018699.7,32628050,chr2-32704097-A-G,rs35985862,1,A,G,32704097,76047,32431442,32824658,272655
2,ENSG00000135900.3,223957463,chr2-223909431-C-T,rs36053433,1,C,T,223909431,48032,223760855,224154071,148576
2,ENSG00000155066.11,95274449,chr2-95176644-G-A,rs36120917,1,G,A,95176644,97805,95077841,95471057,98803
2,ENSG00000114993.11,74441937,chr2-74624241-G-C,rs363699,-1,G,C,74624241,182304,74245329,74638545,378912
2,ENSG00000135899.11,230219984,chr2-230165838-T-C,rs3731723,-1,T,C,230165838,54146,230023376,230416592,142462
2,ENSG00000115350.7,74958643,chr2-75047000-T-C,rs3732303,1,T,C,75047000,88357,74762035,75155251,284965
2,ENSG00000204099.6,241809193,chr2-241814768-C-T,rs3749155,1,C,T,241814768,5575,241612585,242005801,202183
2,ENSG00000138074.9,27212268,chr2-27076730-G-T,rs3754734,-1,G,T,27076730,135538,27015660,27408876,61070
2,ENSG00000188542.5,240560357,chr2-240742347-G-A,rs3755534,1,G,A,240742347,181990,240363749,240756965,378598
2,ENSG00000125637.10,113173971,chr2-113179986-A-G,rs3762494,1,A,G,113179986,6015,112977363,113370579,202623
2,ENSG00000122085.11,241102287,chr2-241114728-T-C,rs3771355,-1,T,C,241114728,12441,240905679,241298895,209049
2,ENSG00000163170.7,74147912,chr2-74285673-G-A,rs3771730,-1,G,A,74285673,137761,73951304,74344520,334369
2,ENSG00000176946.6,241637158,chr2-241481899-G-A,rs3821285,-1,G,A,241481899,155259,241440550,241833766,41349
2,ENSG00000115808.6,36966536,chr2-36962153-T-C,rs3845780,-1,T,C,36962153,4383,36769928,37163144,192225
2,ENSG00000115008.5,112784493,chr2-112822289-T-C,rs3917386,-1,T,C,112822289,37796,112587885,112981101,234404
2,ENSG00000075292.11,71331782,chr2-71173887-C-A,rs397458,1,C,A,71173887,157895,71135174,71528390,38713
2,ENSG00000003402.12,201116164,chr2-201187058-G-A,rs41339752,1,G,A,201187058,70894,200919556,201312772,267502
2,ENSG00000119812.13,33599299,chr2-33421179-A-G,rs41373249,-1,A,G,33421179,178120,33402691,33795907,18488
2,ENSG00000138061.7,38076151,chr2-38011867-C-T,rs41383748,-1,C,T,38011867,64284,37879543,38272759,132324
2,ENSG00000213901.6,219170029,chr2-219079106-T-A,rs41398145,-1,T,A,219079106,90923,218973421,219366637,105685
2,ENSG00000124019.9,224402107,chr2-224313411-C-T,rs41443452,-1,C,T,224313411,88696,224205499,224598715,107912
2,ENSG00000073737.11,169069563,chr2-169025574-A-G,rs4148770,1,A,G,169025574,43989,168872955,169266171,152619
2,ENSG00000172554.7,950849,chr2-908708-T-C,rs4241338,1,T,C,908708,42141,754241,1147457,154467
2,ENSG00000163001.7,55519718,chr2-55584925-A-G,rs4312532,1,A,G,55584925,65207,55323110,55716326,261815
2,ENSG00000119041.6,196799683,chr2-196764190-G-A,rs4380257,-1,G,A,196764190,35493,196603075,196996291,161115
2,ENSG00000172059.6,10043550,chr2-10053051-C-A,rs4444493,1,C,A,10053051,9501,9846942,10240158,206109
2,ENSG00000125538.7,112836779,chr2-112848380-C-T,rs4447608,-1,C,T,112848380,11601,112640171,113033387,208209
2,ENSG00000138095.13,43995989,chr2-44005710-T-G,rs4521095,-1,T,G,44005710,9721,43799381,44192597,206329
2,ENSG00000115267.4,162318684,chr2-162157663-G-T,rs4664450,-1,G,T,162157663,161021,162122076,162515292,35587
2,ENSG00000115902.5,64989399,chr2-64917523-C-T,rs4671629,1,C,T,64917523,71876,64792791,65186007,124732
2,ENSG00000138083.3,44941702,chr2-44802386-T-C,rs4953133,1,T,C,44802386,139316,44745094,45138310,57292
2,ENSG00000188389.5,241858894,chr2-241979064-T-C,rs4973635,-1,T,C,241979064,120170,241662286,242055502,316778
2,ENSG00000123485.5,233854535,chr2-233849854-G-A,rs529963,-1,G,A,233849854,4681,233657927,234051143,191927
2,ENSG00000152253.4,168890430,chr2-168900420-A-G,rs540524,-1,A,G,168900420,9990,168693822,169087038,206598
2,ENSG00000163013.6,73284478,chr2-73274325-A-G,rs546576,-1,A,G,73274325,10153,73087870,73481086,186455
2,ENSG00000180228.8,178451175,chr2-178531435-C-G,rs56308529,-1,C,G,178531435,80260,178254567,178647783,276868
2,ENSG00000115526.6,100417668,chr2-100395606-A-G,rs57227647,-1,A,G,100395606,22062,100221060,100614276,174546
2,ENSG00000085978.16,233251673,chr2-233100275-A-G,rs57371118,1,A,G,233100275,151398,233055065,233448281,45210
2,ENSG00000198203.5,108288895,chr2-108258814-G-A,rs61743196,1,G,A,108258814,30081,108092287,108485503,166527
2,ENSG00000205795.4,10080411,chr2-10269659-G-A,rs62128497,-1,G,A,10269659,189248,9883803,10277019,385856
2,ENSG00000135638.8,72917519,chr2-73022759-C-T,rs62147729,1,C,T,73022759,105240,72720911,73114127,301848
2,ENSG00000221944.3,232550557,chr2-232563070-C-T,rs62191570,-1,C,T,232563070,12513,232353949,232747165,209121
2,ENSG00000162976.8,11155467,chr2-11160743-T-C,rs6432182,1,T,C,11160743,5276,10958859,11352075,201884
2,ENSG00000077380.11,171687469,chr2-171571895-C-T,rs6433299,1,C,T,171571895,115574,171490861,171884077,81034
2,ENSG00000163002.8,183124443,chr2-183202130-C-T,rs6434019,1,C,T,183202130,77687,182927835,183321051,274295
2,ENSG00000123992.13,219387912,chr2-219381496-T-C,rs6436148,-1,T,C,219381496,6416,219191304,219584520,190192
2,ENSG00000123983.9,222861036,chr2-222945548-G-A,rs6436364,1,G,A,222945548,84512,222664428,223057644,281120
2,ENSG00000115687.9,241149472,chr2-241083115-G-C,rs6437235,-1,G,C,241083115,66357,240952864,241346080,130251
2,ENSG00000146205.9,241188677,chr2-241235916-T-C,rs6437249,1,T,C,241235916,47239,240992069,241385285,243847
2,ENSG00000115884.6,20225130,chr2-20188723-C-A,rs6531222,-1,C,A,20188723,36407,20028522,20421738,160201
2,ENSG00000169629.7,112433645,chr2-112434559-G-A,rs6542056,-1,G,A,112434559,914,112237037,112630253,197522
2,ENSG00000138035.9,55693844,chr2-55588861-T-C,rs6545508,-1,T,C,55588861,104983,55497236,55890452,91625
2,ENSG00000119866.15,60553654,chr2-60622286-T-C,rs6545824,-1,T,C,60622286,68632,60357046,60750262,265240
2,ENSG00000138029.9,26244939,chr2-26359830-G-T,rs6546936,1,G,T,26359830,114891,26048331,26441547,311499
2,ENSG00000116095.5,178480457,chr2-178374452-A-G,rs6706483,1,A,G,178374452,106005,178283849,178677065,90603
2,ENSG00000127824.9,219253918,chr2-219361671-C-T,rs6711142,-1,C,T,219361671,107753,219057310,219450526,304361
2,ENSG00000152256.8,172556090,chr2-172473758-T-C,rs6714597,1,T,C,172473758,82332,172359482,172752698,114276
2,ENSG00000132330.12,238061001,chr2-237956676-G-A,rs6715260,1,G,A,237956676,104325,237864393,238257609,92283
2,ENSG00000115353.5,75199520,chr2-75071228-T-G,rs6715414,-1,T,G,75071228,128292,75002912,75396128,68316
2,ENSG00000143947.8,55232688,chr2-55168596-A-G,rs6717482,1,A,G,55168596,64092,55036080,55429296,132516
2,ENSG00000143947.8,55232688,chr2-55168596-A-C,rs6717482,1,A,C,55168596,64092,55036080,55429296,132516
2,ENSG00000014641.13,63588963,chr2-63684366-C-T,rs6723875,1,C,T,63684366,95403,63392355,63785571,292011
2,ENSG00000185404.12,230327193,chr2-230505697-T-C,rs6725450,1,T,C,230505697,178504,230130585,230523801,375112
2,ENSG00000128641.12,191245404,chr2-191222164-A-G,rs6728759,1,A,G,191222164,23240,191048796,191442012,173368
2,ENSG00000115524.10,197435028,chr2-197628113-C-T,rs6728904,-1,C,T,197628113,193085,197238420,197631636,389693
2,ENSG00000171132.9,45651675,chr2-45472462-C-G,rs6730610,1,C,G,45472462,179213,45455067,45848283,17395
2,ENSG00000153574.6,88691673,chr2-88612588-C-A,rs6732073,1,C,A,88612588,79085,88495065,88888281,117523
2,ENSG00000125629.10,118088471,chr2-118145933-G-C,rs6733556,1,G,C,118145933,57462,117891863,118285079,254070
2,ENSG00000125629.10,118088471,chr2-118145933-G-A,rs6733556,1,G,A,118145933,57462,117891863,118285079,254070
2,ENSG00000065911.7,74198615,chr2-74389743-A-G,rs6740802,1,A,G,74389743,191128,74002007,74395223,387736
2,ENSG00000071082.5,101002289,chr2-100889961-G-A,rs6740935,1,G,A,100889961,112328,100805681,101198897,84280
2,ENSG00000144567.5,219178275,chr2-219284153-C-T,rs6741986,1,C,T,219284153,105878,218981667,219374883,302486
2,ENSG00000168758.6,96870080,chr2-97049174-C-T,rs6744498,-1,C,T,97049174,179094,96673472,97066688,375702
2,ENSG00000091436.12,173075846,chr2-173076286-G-A,rs6746656,1,G,A,173076286,440,172879238,173272454,197048
2,ENSG00000171103.6,28870309,chr2-28886765-T-C,rs6749462,-1,T,C,28886765,16456,28673701,29066917,213064
2,ENSG00000197223.7,68063004,chr2-67914130-A-G,rs6750910,-1,A,G,67914130,148874,67866396,68259612,47734
2,ENSG00000204217.8,202376327,chr2-202300811-C-T,rs6753156,1,C,T,202300811,75516,202179719,202572935,121092
2,ENSG00000144120.7,119679201,chr2-119731062-A-G,rs6757316,1,A,G,119731062,51861,119482593,119875809,248469
2,ENSG00000115364.9,75646783,chr2-75654702-T-C,rs6759555,1,T,C,75654702,7919,75450175,75843391,204527
2,ENSG00000198130.10,190319826,chr2-190251121-T-C,rs713427,-1,T,C,190251121,68705,190123218,190516434,127903
2,ENSG00000115211.10,27370338,chr2-27275976-G-A,rs72817538,-1,G,A,27275976,94362,27173730,27566946,102246
2,ENSG00000115194.6,27263047,chr2-27275976-G-A,rs72817538,-1,G,A,27275976,12929,27066439,27459655,209537
2,ENSG00000196862.7,107826892,chr2-107999828-T-C,rs72826951,1,T,C,107999828,172936,107630284,108023500,369544
2,ENSG00000153201.10,108719482,chr2-108857894-T-C,rs72836521,1,T,C,108857894,138412,108522874,108916090,335020
2,ENSG00000163072.10,168802637,chr2-168793331-G-T,rs72881773,1,G,T,168793331,9306,168606029,168999245,187302
2,ENSG00000136542.4,157257705,chr2-157237323-G-A,rs72918706,1,G,A,157237323,20382,157061097,157454313,176226
2,ENSG00000115750.10,9843474,chr2-9946580-C-T,rs74420056,1,C,T,9946580,103106,9646866,10040082,299714
2,ENSG00000135631.11,73112948,chr2-72938105-C-T,rs746212,-1,C,T,72938105,174843,72916340,73309556,21765
2,ENSG00000162994.11,55232293,chr2-55222276-C-A,rs74785222,-1,C,A,55222276,10017,55035685,55428901,186591
2,ENSG00000115866.6,135985626,chr2-135897998-G-A,rs74869854,-1,G,A,135897998,87628,135789018,136182234,108980
2,ENSG00000115129.9,24084834,chr2-24139658-T-C,rs75208176,-1,T,C,24139658,54824,23888226,24281442,251432
2,ENSG00000136717.10,127107154,chr2-127132061-G-A,rs7561528,-1,G,A,127132061,24907,126910546,127303762,221515
2,ENSG00000152518.5,43226606,chr2-43279120-G-A,rs7561670,-1,G,A,43279120,52514,43029998,43423214,249122
2,ENSG00000213160.4,169733832,chr2-169727369-G-A,rs7562456,1,G,A,169727369,6463,169537224,169930440,190145
2,ENSG00000213160.4,169733832,chr2-169727369-G-T,rs7562456,1,G,T,169727369,6463,169537224,169930440,190145
2,ENSG00000138078.11,44361494,chr2-44462289-T-G,rs7562956,-1,T,G,44462289,100795,44164886,44558102,297403
2,ENSG00000119888.6,47369311,chr2-47196329-A-C,rs75631562,1,A,C,47196329,172982,47172703,47565919,23626
2,ENSG00000115946.3,68157888,chr2-68121555-T-C,rs7564086,1,T,C,68121555,36333,67961280,68354496,160275
2,ENSG00000144283.15,158456952,chr2-158372079-A-G,rs7564839,1,A,G,158372079,84873,158260344,158653560,111735
2,ENSG00000243244.1,48530154,chr2-48498268-T-G,rs7566996,1,T,G,48498268,31886,48333546,48726762,164722
2,ENSG00000138439.10,202634969,chr2-202718531-G-A,rs7571219,1,G,A,202718531,83562,202438361,202831577,280170
2,ENSG00000138378.13,191150994,chr2-191150346-A-G,rs7572482,-1,A,G,191150346,648,190954386,191347602,195960
2,ENSG00000132300.14,86106235,chr2-86262707-C-G,rs7576102,1,C,G,86262707,156472,85909627,86302843,353080
2,ENSG00000169599.8,69437435,chr2-69496578-C-T,rs7577851,-1,C,T,69496578,59143,69240827,69634043,255751
2,ENSG00000079150.12,178478600,chr2-178488130-G-A,rs7577862,-1,G,A,178488130,9530,178281992,178675208,206138
2,ENSG00000168894.5,85595745,chr2-85515493-A-T,rs7579665,1,A,T,85515493,80252,85399137,85792353,116356
2,ENSG00000168894.5,85595745,chr2-85515493-A-C,rs7579665,1,A,C,85515493,80252,85399137,85792353,116356
2,ENSG00000168763.10,96816268,chr2-96879904-C-T,rs7580748,1,C,T,96879904,63636,96619660,97012876,260244
2,ENSG00000157833.7,26173088,chr2-26316938-A-G,rs75819301,1,A,G,26316938,143850,25976480,26369696,340458
2,ENSG00000143727.10,264947,chr2-440230-G-T,rs7585330,1,G,T,440230,175283,68339,461555,371891
2,ENSG00000143727.10,264947,chr2-440230-G-C,rs7585330,1,G,C,440230,175283,68339,461555,371891
2,ENSG00000184898.6,151261863,chr2-151191091-A-C,rs7590868,-1,A,C,151191091,70772,151065255,151458471,125836
2,ENSG00000155657.16,178807423,chr2-178828240-C-T,rs7591759,-1,C,T,178828240,20817,178610815,179004031,217425
2,ENSG00000173349.4,127701497,chr2-127718910-C-T,rs7595381,1,C,T,127718910,17413,127504889,127898105,214021
2,ENSG00000169621.5,68467585,chr2-68420607-C-T,rs7595749,1,C,T,68420607,46978,68270977,68664193,149630
2,ENSG00000171863.8,3575260,chr2-3605986-A-G,rs7604806,1,A,G,3605986,30726,3378652,3771868,227334
2,ENSG00000204128.5,231037523,chr2-231053352-G-A,rs7608781,1,G,A,231053352,15829,230840915,231234131,212437
2,ENSG00000132329.6,237859623,chr2-237871500-T-C,rs77182426,1,T,C,237871500,11877,237663015,238056231,208485
2,ENSG00000168288.7,149587775,chr2-149750922-G-A,rs77214271,-1,G,A,149750922,163147,149391167,149784383,359755
2,ENSG00000115155.11,26558756,chr2-26736699-G-T,rs77244720,-1,G,T,26736699,177943,26362148,26755364,374551
2,ENSG00000155749.8,201357345,chr2-201504465-C-T,rs77508965,-1,C,T,201504465,147120,201160737,201553953,343728
2,ENSG00000077232.10,182716257,chr2-182824793-C-T,rs77634386,1,C,T,182824793,108536,182519649,182912865,305144
2,ENSG00000119737.5,53859967,chr2-53749066-G-C,rs77662424,-1,G,C,53749066,110901,53663359,54056575,85707
2,ENSG00000135919.8,224039286,chr2-224051188-C-G,rs77850344,-1,C,G,224051188,11902,223842678,224235894,208510
2,ENSG00000138050.10,39779258,chr2-39657530-C-G,rs79046700,-1,C,G,39657530,121728,39582650,39975866,74880
2,ENSG00000144320.8,176002267,chr2-176063971-G-A,rs79055742,-1,G,A,176063971,61704,175805659,176198875,258312
2,ENSG00000151779.8,15561334,chr2-15638128-A-C,rs79055811,-1,A,C,15638128,76794,15364726,15757942,273402
2,ENSG00000115484.10,61888656,chr2-61968266-T-C,rs79055900,-1,T,C,61968266,79610,61692048,62085264,276218
2,ENSG00000143870.8,10812785,chr2-10800512-T-C,rs79135340,-1,T,C,10800512,12273,10616177,11009393,184335
2,ENSG00000115295.13,29115415,chr2-29287657-T-G,rs80317127,1,T,G,29287657,172242,28918807,29312023,368850
2,ENSG00000115163.10,26786056,chr2-26770085-A-G,rs828262,1,A,G,26770085,15971,26589448,26982664,180637
2,ENSG00000172954.8,30447246,chr2-30438850-A-G,rs829689,1,A,G,30438850,8396,30250638,30643854,188212
2,ENSG00000077044.5,233354494,chr2-233388004-G-A,rs838718,1,G,A,233388004,33510,233157886,233551102,230118
2,ENSG00000172005.6,95025708,chr2-95057164-C-A,rs872580,1,C,A,95057164,31456,94829100,95222316,228064
2,ENSG00000135973.1,105241743,chr2-105308624-T-C,rs873738,1,T,C,105308624,66881,105045135,105438351,263489
2,ENSG00000042493.10,85410366,chr2-85345910-G-A,rs908302,-1,G,A,85345910,64456,85213758,85606974,132152
2,ENSG00000085449.10,223945335,chr2-224039957-C-A,rs920250,-1,C,A,224039957,94622,223748727,224141943,291230
2,ENSG00000003393.10,201780933,chr2-201800336-A-C,rs9973862,-1,A,C,201800336,19403,201584325,201977541,216011
2,ENSG00000135972.4,105038069,chr2-104907333-C-T,rs1005999,1,C,T,104907333,130736,104841461,105234677,65872
2,ENSG00000221823.5,68252532,chr2-68163778-G-T,rs10153623,-1,G,T,68163778,88754,68055924,68449140,107854
2,ENSG00000173163.6,61905674,chr2-61789950-G-A,rs10166783,1,G,A,61789950,115724,61709066,62102282,80884
2,ENSG00000116005.7,70258137,chr2-70200910-T-C,rs10169872,1,T,C,70200910,57227,70061529,70454745,139381
2,ENSG00000115649.11,219176925,chr2-219109430-G-T,rs10175081,-1,G,T,219109430,67495,218980317,219373533,129113
2,ENSG00000158428.3,218356857,chr2-218172874-T-C,rs10175470,1,T,C,218172874,183983,218160249,218553465,12625
2,ENSG00000157833.7,26173088,chr2-26230627-T-C,rs10179433,1,T,C,26230627,57539,25976480,26369696,254147
2,ENSG00000115504.9,62705713,chr2-62553002-C-A,rs10191929,1,C,A,62553002,152711,62509105,62902321,43897
2,ENSG00000136717.10,127107154,chr2-127082205-C-A,rs10194375,-1,C,A,127082205,24949,126910546,127303762,171659
2,ENSG00000116120.8,222656092,chr2-222653432-A-G,rs10194743,-1,A,G,222653432,2660,222459484,222852700,193948
2,ENSG00000036257.8,224585363,chr2-224546712-A-G,rs10197090,-1,A,G,224546712,38651,224388755,224781971,157957
2,ENSG00000169679.9,110678063,chr2-110790410-C-T,rs10199559,-1,C,T,110790410,112347,110481455,110874671,308955
2,ENSG00000188042.5,234497081,chr2-234310892-T-C,rs10209413,-1,T,C,234310892,186189,234300473,234693689,10419
2,ENSG00000204923.2,68467294,chr2-68415450-C-A,rs10210028,-1,C,A,68415450,51844,68270686,68663902,144764
2,ENSG00000144136.5,112645939,chr2-112699472-A-G,rs10211073,1,A,G,112699472,53533,112449331,112842547,250141
2,ENSG00000128694.7,189762792,chr2-189608618-G-A,rs10497704,-1,G,A,189608618,154174,189566184,189959400,42434
2,ENSG00000115350.7,74958643,chr2-75036902-T-C,rs10515918,1,T,C,75036902,78259,74762035,75155251,274867
2,ENSG00000183891.5,19901983,chr2-20008651-G-A,rs10856792,-1,G,A,20008651,106668,19705375,20098591,303276
2,ENSG00000159399.4,74834127,chr2-74894518-C-T,rs10865404,1,C,T,74894518,60391,74637519,75030735,256999
2,ENSG00000168427.7,238138668,chr2-237970660-G-A,rs10929255,1,G,A,237970660,168008,237942060,238335276,28600
2,ENSG00000115053.10,231464484,chr2-231414209-A-C,rs10933369,-1,A,C,231414209,50275,231267876,231661092,146333
2,ENSG00000119729.6,46542490,chr2-46505266-G-A,rs11125080,1,G,A,46505266,37224,46345882,46739098,159384
2,ENSG00000143933.11,47176511,chr2-47062140-A-G,rs11125114,-1,A,G,47062140,114371,46979903,47373119,82237
2,ENSG00000115902.5,64989399,chr2-64940327-G-A,rs11126024,1,G,A,64940327,49072,64792791,65186007,147536
2,ENSG00000115525.11,85888990,chr2-85828031-T-C,rs11127000,-1,T,C,85828031,60959,85692382,86085598,135649
2,ENSG00000172086.7,88055783,chr2-88034746-T-C,rs11127081,-1,T,C,88034746,21037,87859175,88252391,175571
2,ENSG00000204406.7,148021091,chr2-148067310-T-C,rs112184638,1,T,C,148067310,46219,147824483,148217699,242827
2,ENSG00000197713.9,210002638,chr2-209839258-A-G,rs112831177,1,A,G,209839258,163380,209806030,210199246,33228
2,ENSG00000132313.9,86199457,chr2-86038617-G-A,rs114068877,1,G,A,86038617,160840,86002849,86396065,35768
2,ENSG00000115155.11,26558756,chr2-26574051-G-A,rs1148949,-1,G,A,26574051,15295,26362148,26755364,211903
2,ENSG00000115966.11,175168203,chr2-175052654-G-A,rs1153707,-1,G,A,175052654,115549,174971595,175364811,81059
2,ENSG00000144021.2,96266225,chr2-96248898-T-C,rs11551400,1,T,C,96248898,17327,96069617,96462833,179281
2,ENSG00000186889.5,62506195,chr2-62548472-A-G,rs115837610,-1,A,G,62548472,42277,62309587,62702803,238885
2,ENSG00000115963.9,150487667,chr2-150403900-C-T,rs116420912,-1,C,T,150403900,83767,150291059,150684275,112841
2,ENSG00000239474.2,169509702,chr2-169508120-C-T,rs116649447,1,C,T,169508120,1582,169313094,169706310,195026
2,ENSG00000184182.14,237967014,chr2-237894836-A-G,rs11675972,1,A,G,237894836,72178,237770406,238163622,124430
2,ENSG00000135925.4,218880852,chr2-218885201-G-A,rs11680244,1,G,A,218885201,4349,218684244,219077460,200957
2,ENSG00000134317.13,9951693,chr2-9808205-G-A,rs11682963,1,G,A,9808205,143488,9755085,10148301,53120
2,ENSG00000115677.12,241315672,chr2-241370759-T-C,rs11684105,-1,T,C,241370759,55087,241119064,241512280,251695
2,ENSG00000019169.8,118942194,chr2-118993752-T-C,rs11685286,1,T,C,118993752,51558,118745586,119138802,248166
2,ENSG00000183281.10,87021844,chr2-86855556-C-T,rs11688534,-1,C,T,86855556,166288,86825236,87218452,30320
2,ENSG00000144040.8,73071712,chr2-72974894-C-T,rs11692971,-1,C,T,72974894,96818,72875104,73268320,99790
2,ENSG00000075886.9,131476119,chr2-131419865-G-A,rs11695582,1,G,A,131419865,56254,131279511,131672727,140354
2,ENSG00000172878.8,171999953,chr2-171986638-T-C,rs11695630,1,T,C,171986638,13315,171803345,172196561,183293
2,ENSG00000162927.8,61018255,chr2-61141397-T-G,rs1177274,-1,T,G,61141397,123142,60821647,61214863,319750
2,ENSG00000162929.9,61065871,chr2-61086885-G-A,rs1177301,1,G,A,61086885,21014,60869263,61262479,217622
2,ENSG00000138031.8,24920237,chr2-24896544-C-T,rs11884570,-1,C,T,24896544,23693,24723629,25116845,172915
2,ENSG00000152082.9,130182262,chr2-130241291-C-T,rs11885771,1,C,T,130241291,59029,129985654,130378870,255637
2,ENSG00000168280.12,148875227,chr2-149063450-C-T,rs11888894,1,C,T,149063450,188223,148678619,149071835,384831
2,ENSG00000018510.7,177392773,chr2-177363649-C-T,rs11892161,1,C,T,177363649,29124,177196165,177589381,167484
2,ENSG00000178385.9,208025527,chr2-208124984-G-A,rs12328374,-1,G,A,208124984,99457,207828919,208222135,296065
2,ENSG00000115423.13,84516498,chr2-84322925-C-T,rs12464420,1,C,T,84322925,193573,84319890,84713106,3035
2,ENSG00000115423.13,84516498,chr2-84322925-C-A,rs12464420,1,C,A,84322925,193573,84319890,84713106,3035
2,ENSG00000196141.7,200306693,chr2-200474834-C-T,rs12470550,1,C,T,200474834,168141,200110085,200503301,364749
2,ENSG00000135914.4,231125042,chr2-231129024-G-T,rs12471957,-1,G,T,231129024,3982,230928434,231321650,200590
2,ENSG00000125538.7,112836779,chr2-112897272-C-T,rs12472089,-1,C,T,112897272,60493,112640171,113033387,257101
2,ENSG00000125538.7,112836779,chr2-112897272-C-A,rs12472089,-1,C,A,112897272,60493,112640171,113033387,257101
2,ENSG00000168385.12,241315925,chr2-241249816-T-C,rs12475607,1,T,C,241249816,66109,241119317,241512533,130499
2,ENSG00000163251.3,207769906,chr2-207666398-T-C,rs12477677,-1,T,C,207666398,103508,207573298,207966514,93100
2,ENSG00000144199.6,97094882,chr2-97017702-T-A,rs1256995,-1,T,A,97017702,77180,96898274,97291490,119428
2,ENSG00000072163.12,127675530,chr2-127537479-C-A,rs12616100,-1,C,A,127537479,138051,127478922,127872138,58557
2,ENSG00000163521.11,219245444,chr2-219383723-G-A,rs12617155,-1,G,A,219383723,138279,219048836,219442052,334887
2,ENSG00000085760.8,55269231,chr2-55288967-G-C,rs12619486,-1,G,C,55288967,19736,55072623,55465839,216344
2,ENSG00000068724.10,46941224,chr2-46922519-T-C,rs12621059,1,T,C,46922519,18705,46744616,47137832,177903
2,ENSG00000163029.11,17753810,chr2-17808233-G-A,rs12710648,-1,G,A,17808233,54423,17557202,17950418,251031
2,ENSG00000084764.6,26970637,chr2-27148102-T-C,rs1275513,1,T,C,27148102,177465,26774029,27167245,374073
2,ENSG00000115419.8,190880821,chr2-190978719-G-A,rs13010343,1,G,A,190978719,97898,190684213,191077429,294506
2,ENSG00000003402.12,201116164,chr2-201209375-G-A,rs13010627,1,G,A,201209375,93211,200919556,201312772,289819
2,ENSG00000153253.10,165204050,chr2-165313563-A-G,rs13025009,-1,A,G,165313563,109513,165007442,165400658,306121
2,ENSG00000125611.11,112584609,chr2-112622537-A-G,rs13025131,1,A,G,112622537,37928,112388001,112781217,234536
2,ENSG00000163170.7,74147912,chr2-74110226-T-C,rs13025827,-1,T,C,74110226,37686,73951304,74344520,158922
2,ENSG00000171132.9,45651675,chr2-45824543-G-A,rs13026162,1,G,A,45824543,172868,45455067,45848283,369476
2,ENSG00000138050.10,39779258,chr2-39781901-A-C,rs13026313,-1,A,C,39781901,2643,39582650,39975866,199251
2,ENSG00000151353.10,677406,chr2-692784-G-A,rs1320334,-1,G,A,692784,15378,480798,874014,211986
2,ENSG00000114978.12,74178879,chr2-74153269-G-A,rs13302,-1,G,A,74153269,25610,73982271,74375487,170998
2,ENSG00000162804.9,240998618,chr2-241123935-T-C,rs13385610,1,T,C,241123935,125317,240802010,241195226,321925
2,ENSG00000182551.7,3519531,chr2-3501961-T-G,rs13392776,-1,T,G,3501961,17570,3322923,3716139,179038
2,ENSG00000116096.5,72887408,chr2-72992678-G-T,rs13401894,1,G,T,72992678,105270,72690800,73084016,301878
2,ENSG00000115827.8,171434226,chr2-171596395-G-A,rs13405265,1,G,A,171596395,162169,171237618,171630834,358777
2,ENSG00000115307.11,74529706,chr2-74545989-C-A,rs13405596,-1,C,A,74545989,16283,74333098,74726314,212891
2,ENSG00000163811.7,28894667,chr2-28987032-A-G,rs13406322,1,A,G,28987032,92365,28698059,29091275,288973
2,ENSG00000226479.3,120223400,chr2-120367496-T-C,rs13410055,-1,T,C,120367496,144096,120026792,120420008,340704
2,ENSG00000170634.7,53971113,chr2-54135589-A-G,rs13417064,1,A,G,54135589,164476,53774505,54167721,361084
2,ENSG00000204120.9,232697331,chr2-232617268-T-C,rs13423701,1,T,C,232617268,80063,232500723,232893939,116545
2,ENSG00000198142.3,109614364,chr2-109443178-A-G,rs13426372,1,A,G,109443178,171186,109417756,109810972,25422
2,ENSG00000138400.8,206765328,chr2-206749256-G-A,rs13427620,-1,G,A,206749256,16072,206568720,206961936,180536
2,ENSG00000115970.12,43596038,chr2-43411699-A-C,rs13429458,-1,A,C,43411699,184339,43399430,43792646,12269
2,ENSG00000115414.13,215436068,chr2-215274650-C-A,rs1404774,-1,C,A,215274650,161418,215239460,215632676,35190
2,ENSG00000079263.11,230225736,chr2-230180672-C-T,rs1427292,1,C,T,230180672,45064,230029128,230422344,151544
2,ENSG00000084676.11,24491254,chr2-24518367-A-T,rs1442757,1,A,T,24518367,27113,24294646,24687862,223721
2,ENSG00000084676.11,24491254,chr2-24518367-A-G,rs1442757,1,A,G,24518367,27113,24294646,24687862,223721
2,ENSG00000170340.10,62196115,chr2-62186853-C-T,rs1449947,1,C,T,62186853,9262,61999507,62392723,187346
2,ENSG00000178295.9,17754138,chr2-17940931-C-T,rs1471342,1,C,T,17940931,186793,17557530,17950746,383401
2,ENSG00000162972.6,199955582,chr2-200043420-G-A,rs1509830,1,G,A,200043420,87838,199758974,200152190,284446
2,ENSG00000119878.5,46617215,chr2-46443802-T-C,rs1530628,1,T,C,46443802,173413,46420607,46813823,23195
2,ENSG00000115138.6,25168580,chr2-25146171-C-T,rs1561289,-1,C,T,25146171,22409,24971972,25365188,174199
2,ENSG00000114956.14,73926880,chr2-73901778-G-A,rs1653257,1,G,A,73901778,25102,73730272,74123488,171506
2,ENSG00000135932.6,230712842,chr2-230818223-T-C,rs16827587,1,T,C,230818223,105381,230516234,230909450,301989
2,ENSG00000138378.13,191150994,chr2-190997672-G-A,rs16833157,-1,G,A,190997672,153322,190954386,191347602,43286
2,ENSG00000082126.11,201698644,chr2-201862313-G-A,rs16838316,-1,G,A,201862313,163669,201502036,201895252,360277
2,ENSG00000241399.2,159798208,chr2-159913914-G-A,rs16844494,-1,G,A,159913914,115706,159601600,159994816,312314
2,ENSG00000144452.10,215138626,chr2-215086682-G-A,rs16853334,-1,G,A,215086682,51944,214942018,215335234,144664
2,ENSG00000079246.11,216109348,chr2-216083404-G-T,rs16855402,1,G,T,216083404,25944,215912740,216305956,170664
2,ENSG00000144580.9,218568839,chr2-218547683-A-G,rs16859048,1,A,G,218547683,21156,218372231,218765447,175452
2,ENSG00000072195.9,219434843,chr2-219459106-C-G,rs16859931,1,C,G,219459106,24263,219238235,219631451,220871
2,ENSG00000072195.9,219434843,chr2-219459106-C-T,rs16859931,1,C,T,219459106,24263,219238235,219631451,220871
2,ENSG00000115241.8,27409591,chr2-27386144-C-A,rs17006046,-1,C,A,27386144,23447,27212983,27606199,173161
2,ENSG00000013016.10,31234152,chr2-31200577-G-A,rs17011001,1,G,A,31200577,33575,31037544,31430760,163033
2,ENSG00000135974.5,105337540,chr2-105268737-A-G,rs17030722,1,A,G,105268737,68803,105140932,105534148,127805
2,ENSG00000095002.7,47403156,chr2-47501926-A-G,rs17039235,1,A,G,47501926,98770,47206548,47599764,295378
2,ENSG00000213337.4,96858016,chr2-96985926-C-T,rs17119736,-1,C,T,96985926,127910,96661408,97054624,324518
2,ENSG00000114933.10,206086174,chr2-206223545-C-T,rs17289237,-1,C,T,206223545,137371,205889566,206282782,333979
2,ENSG00000237651.2,61162188,chr2-61076867-A-G,rs1729657,1,A,G,61076867,85321,60965580,61358796,111287
2,ENSG00000115944.9,42361217,chr2-42397825-A-G,rs17389890,-1,A,G,42397825,36608,42164609,42557825,233216
2,ENSG00000115457.5,216633420,chr2-216619506-T-C,rs17496232,1,T,C,216619506,13914,216436812,216830028,182694
2,ENSG00000196151.6,159286703,chr2-159231371-G-A,rs17576859,-1,G,A,159231371,55332,159090095,159483311,141276
2,ENSG00000119737.5,53859967,chr2-53714806-T-C,rs17580080,-1,T,C,53714806,145161,53663359,54056575,51447
2,ENSG00000115364.9,75646783,chr2-75565141-G-T,rs17739099,1,G,T,75565141,81642,75450175,75843391,114966
2,ENSG00000163040.10,131527888,chr2-131638971-G-A,rs17783398,1,G,A,131638971,111083,131331280,131724496,307691
2,ENSG00000163466.11,218217189,chr2-218131403-C-T,rs17844690,1,C,T,218131403,85786,218020581,218413797,110822
2,ENSG00000115594.7,102142746,chr2-101963680-A-G,rs1859713,1,A,G,101963680,179066,101946138,102339354,17542
2,ENSG00000132305.15,86195462,chr2-86332025-C-A,rs1863051,-1,C,A,86332025,136563,85998854,86392070,333171
2,ENSG00000214711.5,31217515,chr2-31205164-G-T,rs1867329,-1,G,T,31205164,12351,31020907,31414123,184257
2,ENSG00000042493.10,85410366,chr2-85427176-G-A,rs1877954,-1,G,A,85427176,16810,85213758,85606974,213418
2,ENSG00000138079.8,44275480,chr2-44315986-C-G,rs1946932,1,C,G,44315986,40506,44078872,44472088,237114
2,ENSG00000169031.13,227164624,chr2-227198236-G-A,rs1950134,1,G,A,227198236,33612,226968016,227361232,230220
2,ENSG00000144118.8,120252852,chr2-120086690-G-A,rs1982334,1,G,A,120086690,166162,120056244,120449460,30446
2,ENSG00000115590.9,101991960,chr2-102022747-A-G,rs2072474,1,A,G,102022747,30787,101795352,102188568,227395
2,ENSG00000155066.11,95274449,chr2-95323101-G-A,rs2113418,1,G,A,95323101,48652,95077841,95471057,245260
2,ENSG00000077044.5,233354494,chr2-233438014-G-A,rs2242102,1,G,A,233438014,83520,233157886,233551102,280128
2,ENSG00000136709.7,127811171,chr2-127648346-C-T,rs2243934,-1,C,T,127648346,162825,127614563,128007779,33783
2,ENSG00000068615.11,86337626,chr2-86239393-T-C,rs2278105,-1,T,C,86239393,98233,86141018,86534234,98375
2,ENSG00000204634.8,101151382,chr2-101013275-A-G,rs2278725,-1,A,G,101013275,138107,100954774,101347990,58501
2,ENSG00000079785.8,15591868,chr2-15595295-G-A,rs2302928,1,G,A,15595295,3427,15395260,15788476,200035
2,ENSG00000196208.9,11534045,chr2-11612509-T-C,rs2304399,1,T,C,11612509,78464,11337437,11730653,275072
2,ENSG00000144589.15,219597857,chr2-219641800-G-A,rs2305054,1,G,A,219641800,43943,219401249,219794465,240551
2,ENSG00000115365.7,210476759,chr2-210647054-G-A,rs2371009,-1,G,A,210647054,170295,210280151,210673367,366903
2,ENSG00000075884.8,143129419,chr2-143284764-A-G,rs2381407,1,A,G,143284764,155345,142932811,143326027,351953
2,ENSG00000197329.6,64144420,chr2-64294232-C-T,rs2433390,-1,C,T,64294232,149812,63947812,64341028,346420
2,ENSG00000119771.10,23385179,chr2-23378685-A-G,rs2577756,1,A,G,23378685,6494,23188571,23581787,190114
2,ENSG00000115935.11,174597804,chr2-174734946-G-A,rs2646176,-1,G,A,174734946,137142,174401196,174794412,333750
2,ENSG00000214595.6,54723662,chr2-54711701-T-A,rs2666035,1,T,A,54711701,11961,54527054,54920270,184647
2,ENSG00000197756.4,216498844,chr2-216514127-C-A,rs284539,1,C,A,216514127,15283,216302236,216695452,211891
2,ENSG00000163283.6,232378751,chr2-232521519-T-C,rs2853444,1,T,C,232521519,142768,232182143,232575359,339376
2,ENSG00000115750.10,9843474,chr2-9845477-T-C,rs287986,1,T,C,9845477,2003,9646866,10040082,198611
2,ENSG00000057935.8,42568632,chr2-42722665-C-T,rs2888840,1,C,T,42722665,154033,42372024,42765240,350641
2,ENSG00000184898.6,151261863,chr2-151149511-C-T,rs289932,-1,C,T,151149511,112352,151065255,151458471,84256
2,ENSG00000138095.13,43995989,chr2-43885283-C-T,rs2955279,-1,C,T,43885283,110706,43799381,44192597,85902
2,ENSG00000084090.9,96208827,chr2-96145695-T-C,rs2969489,-1,T,C,96145695,63132,96012219,96405435,133476
2,ENSG00000163492.9,179050137,chr2-178891210-A-G,rs34940894,-1,A,G,178891210,158927,178853529,179246745,37681
2,ENSG00000135976.11,97113153,chr2-97002285-G-A,rs35608744,1,G,A,97002285,110868,96916545,97309761,85740
2,ENSG00000172005.6,95025708,chr2-95056432-C-T,rs35803313,1,C,T,95056432,30724,94829100,95222316,227332
2,ENSG00000171450.4,218959666,chr2-218963732-T-C,rs35826192,1,T,C,218963732,4066,218763058,219156274,200674
2,ENSG00000115282.14,74483081,chr2-74616082-G-A,rs363694,1,G,A,74616082,133001,74286473,74679689,329609
2,ENSG00000088205.7,117814691,chr2-117748769-A-G,rs367201,1,A,G,117748769,65922,117618083,118011299,130686
2,ENSG00000197557.4,177618742,chr2-177671194-C-T,rs3770008,-1,C,T,177671194,52452,177422134,177815350,249060
2,ENSG00000068784.8,45611267,chr2-45461082-A-G,rs3770266,-1,A,G,45461082,150185,45414659,45807875,46423
2,ENSG00000021826.9,210556599,chr2-210445476-C-T,rs3770696,1,C,T,210445476,111123,210359991,210753207,85485
2,ENSG00000119844.10,64524305,chr2-64591706-A-T,rs3770721,1,A,T,64591706,67401,64327697,64720913,264009
2,ENSG00000150938.5,36355778,chr2-36427629-C-T,rs3770899,1,C,T,36427629,71851,36159170,36552386,268459
2,ENSG00000125629.10,118088471,chr2-117951237-C-T,rs3771941,1,C,T,117951237,137234,117891863,118285079,59374
2,ENSG00000250565.2,46542577,chr2-46536448-G-A,rs3814043,-1,G,A,46536448,6129,46345969,46739185,190479
2,ENSG00000115816.8,37231596,chr2-37359897-C-A,rs3815555,-1,C,A,37359897,128301,37034988,37428204,324909
2,ENSG00000115652.10,106194301,chr2-106091521-T-C,rs3820893,-1,T,C,106091521,102780,105997693,106390909,93828
2,ENSG00000115233.7,161308425,chr2-161494261-G-A,rs3849350,1,G,A,161494261,185836,161111817,161505033,382444
2,ENSG00000118257.11,205682501,chr2-205655877-C-T,rs3856512,1,C,T,205655877,26624,205485893,205879109,169984
2,ENSG00000115685.10,241150467,chr2-241182976-T-C,rs3868,1,T,C,241182976,32509,240953859,241347075,229117
2,ENSG00000018699.7,32628050,chr2-32783443-G-A,rs3931462,1,G,A,32783443,155393,32431442,32824658,352001
2,ENSG00000125630.10,112542465,chr2-112560404-C-T,rs3961914,1,C,T,112560404,17939,112345857,112739073,214547
2,ENSG00000136720.6,128318868,chr2-128288191-C-T,rs4143782,-1,C,T,128288191,30677,128122260,128515476,165931
2,ENSG00000136689.14,113127598,chr2-113116890-T-C,rs4251961,1,T,C,113116890,10708,112930990,113324206,185900
2,ENSG00000162881.5,42764261,chr2-42851530-C-T,rs4277572,-1,C,T,42851530,87269,42567653,42960869,283877
2,ENSG00000119888.6,47369311,chr2-47345021-G-A,rs4380295,1,G,A,47345021,24290,47172703,47565919,172318
2,ENSG00000198885.5,96325317,chr2-96315631-A-C,rs4435501,1,A,C,96315631,9686,96128709,96521925,186922
2,ENSG00000144115.11,88170346,chr2-88223379-T-A,rs4487093,1,T,A,88223379,53033,87973738,88366954,249641
2,ENSG00000182600.5,232870284,chr2-233030956-A-C,rs4511711,1,A,C,233030956,160672,232673676,233066892,357280
2,ENSG00000138039.9,48755724,chr2-48739007-T-C,rs4519576,-1,T,C,48739007,16717,48559116,48952332,179891
2,ENSG00000138375.8,216412484,chr2-216540480-A-G,rs4550645,1,A,G,216540480,127996,216215876,216609092,324604
2,ENSG00000035141.3,70302067,chr2-70293743-C-T,rs4567961,-1,C,T,70293743,8324,70105459,70498675,188284
2,ENSG00000136731.8,128091200,chr2-127998259-C-T,rs4662765,1,C,T,127998259,92941,127894592,128287808,103667
2,ENSG00000136732.10,126656158,chr2-126755391-C-T,rs4663046,1,C,T,126755391,99233,126459550,126852766,295841
2,ENSG00000213160.4,169733832,chr2-169796477-G-A,rs4668168,1,G,A,169796477,62645,169537224,169930440,259253
2,ENSG00000226124.2,199851192,chr2-199732894-C-G,rs4673449,-1,C,G,199732894,118298,199654584,200047800,78310
2,ENSG00000226124.2,199851192,chr2-199732894-C-A,rs4673449,-1,C,A,199732894,118298,199654584,200047800,78310
2,ENSG00000135919.8,224039286,chr2-224057097-C-T,rs4674860,-1,C,T,224057097,17811,223842678,224235894,214419
2,ENSG00000115112.6,121285202,chr2-121270541-G-C,rs4848700,-1,G,C,121270541,14661,121088594,121481810,181947
2,ENSG00000198130.10,190319826,chr2-190382821-T-C,rs4853698,-1,T,C,190382821,62995,190123218,190516434,259603
2,ENSG00000163219.6,68734811,chr2-68796957-G-T,rs4854519,1,G,T,68796957,62146,68538203,68931419,258754
2,ENSG00000198380.7,69387227,chr2-69216205-T-G,rs4854554,-1,T,G,69216205,171022,69190619,69583835,25586
2,ENSG00000162869.11,48440766,chr2-48549078-A-G,rs4953592,1,A,G,48549078,108312,48244158,48637374,304920
2,ENSG00000171853.10,3379694,chr2-3410258-A-G,rs4971502,1,A,G,3410258,30564,3183086,3576302,227172
2,ENSG00000163072.10,168802637,chr2-168881341-A-G,rs524586,1,A,G,168881341,78704,168606029,168999245,275312
2,ENSG00000118961.9,20823101,chr2-20788639-T-C,rs535022,-1,T,C,20788639,34462,20626493,21019709,162146
2,ENSG00000180228.8,178451175,chr2-178530340-C-G,rs56207956,-1,C,G,178530340,79165,178254567,178647783,275773
2,ENSG00000146205.9,241188677,chr2-241381235-C-T,rs57440439,1,C,T,241381235,192558,240992069,241385285,389166
2,ENSG00000171103.6,28870309,chr2-28937670-C-T,rs58905939,-1,C,T,28937670,67361,28673701,29066917,263969
2,ENSG00000152291.9,85327989,chr2-85300463-G-T,rs59211453,-1,G,T,85300463,27526,85131381,85524597,169082
2,ENSG00000163449.6,216081919,chr2-216276218-A-G,rs60529541,1,A,G,216276218,194299,215885311,216278527,390907
2,ENSG00000135956.3,96265997,chr2-96424175-A-G,rs62154787,-1,A,G,96424175,158178,96069389,96462605,354786
2,ENSG00000205795.4,10080411,chr2-10222168-A-G,rs6432075,-1,A,G,10222168,141757,9883803,10277019,338365
2,ENSG00000081052.10,227164205,chr2-227191954-C-T,rs6436661,-1,C,T,227191954,27749,226967597,227360813,224357
2,ENSG00000204128.5,231037523,chr2-231043263-A-C,rs6436996,1,A,C,231043263,5740,230840915,231234131,202348
2,ENSG00000152133.9,37084518,chr2-36956649-T-C,rs6544048,1,T,C,36956649,127869,36887910,37281126,68739
2,ENSG00000138032.16,44168875,chr2-44078101-G-A,rs6544738,1,G,A,44078101,90774,43972267,44365483,105834
2,ENSG00000172554.7,950849,chr2-914641-C-T,rs6548281,1,C,T,914641,36208,754241,1147457,160400
2,ENSG00000116062.7,47783145,chr2-47621097-A-G,rs6705888,1,A,G,47621097,162048,47586537,47979753,34560
2,ENSG00000144218.12,100142590,chr2-99953268-T-C,rs6708436,-1,T,C,99953268,189322,99945982,100339198,7286
2,ENSG00000124839.8,237590734,chr2-237596982-A-G,rs6709393,-1,A,G,237596982,6248,237394126,237787342,202856
2,ENSG00000032389.8,3377818,chr2-3257276-G-A,rs6711665,-1,G,A,3257276,120542,3181210,3574426,76066
2,ENSG00000032389.8,3377818,chr2-3257276-G-C,rs6711665,-1,G,C,3257276,120542,3181210,3574426,76066
2,ENSG00000124357.7,71068648,chr2-71078326-C-T,rs6713,1,C,T,71078326,9678,70872040,71265256,206286
2,ENSG00000023228.8,206159444,chr2-206101113-T-G,rs6718656,-1,T,G,206101113,58331,205962836,206356052,138277
2,ENSG00000071082.5,101002289,chr2-100982609-A-G,rs6719437,1,A,G,100982609,19680,100805681,101198897,176928
2,ENSG00000162882.10,42792583,chr2-42758663-T-C,rs6719977,-1,T,C,42758663,33920,42595975,42989191,162688
2,ENSG00000115548.11,86441371,chr2-86282378-T-C,rs6721458,1,T,C,86282378,158993,86244763,86637979,37615
2,ENSG00000127824.9,219253918,chr2-219260522-T-C,rs6723310,-1,T,C,219260522,6604,219057310,219450526,203212
2,ENSG00000197635.5,162074215,chr2-162050722-C-T,rs6729733,-1,C,T,162050722,23493,161877607,162270823,173115
2,ENSG00000077380.11,171687469,chr2-171554492-G-C,rs6731190,1,G,C,171554492,132977,171490861,171884077,63631
2,ENSG00000244617.1,69961631,chr2-69946195-A-C,rs6731423,-1,A,C,69946195,15436,69765023,70158239,181172
2,ENSG00000244617.1,69961631,chr2-69946195-A-T,rs6731423,-1,A,T,69946195,15436,69765023,70158239,181172
2,ENSG00000153832.7,229922503,chr2-230026935-G-A,rs6737871,1,G,A,230026935,104432,229725895,230119111,301040
2,ENSG00000144485.6,238240038,chr2-238235901-A-G,rs6744132,-1,A,G,238235901,4137,238043430,238436646,192471
2,ENSG00000123609.6,151289668,chr2-151288252-G-A,rs6744327,-1,G,A,151288252,1416,151093060,151486276,195192
2,ENSG00000115758.7,10448327,chr2-10340172-A-G,rs6755655,-1,A,G,10340172,108155,10251719,10644935,88453
2,ENSG00000071967.7,171522474,chr2-171524288-A-G,rs6759240,1,A,G,171524288,1814,171325866,171719082,198422
2,ENSG00000144045.9,74526231,chr2-74575838-C-T,rs72818091,-1,C,T,74575838,49607,74329623,74722839,246215
2,ENSG00000197223.7,68063004,chr2-68001109-T-C,rs72819681,-1,T,C,68001109,61895,67866396,68259612,134713
2,ENSG00000124374.8,71227103,chr2-71362949-T-C,rs72839794,-1,T,C,71362949,135846,71030495,71423711,332454
2,ENSG00000115107.14,119223834,chr2-119266116-G-C,rs72840936,1,G,C,119266116,42282,119027226,119420442,238890
2,ENSG00000115850.4,135837184,chr2-135993220-A-G,rs72845762,-1,A,G,135993220,156036,135640576,136033792,352644
2,ENSG00000071909.12,170178147,chr2-170228988-A-C,rs72885680,1,A,C,170228988,50841,169981539,170374755,247449
2,ENSG00000128641.12,191245404,chr2-191355511-T-G,rs72916599,1,T,G,191355511,110107,191048796,191442012,306715
2,ENSG00000197121.8,196926707,chr2-197052354-G-T,rs73049676,-1,G,T,197052354,125647,196730099,197123315,322255
2,ENSG00000221944.3,232550557,chr2-232523601-C-T,rs733602,-1,C,T,232523601,26956,232353949,232747165,169652
2,ENSG00000011523.8,65056416,chr2-65034295-G-A,rs73934901,1,G,A,65034295,22121,64859808,65253024,174487
2,ENSG00000143952.12,64019428,chr2-64031144-A-C,rs73935051,-1,A,C,64031144,11716,63822820,64216036,208324
2,ENSG00000180902.11,241734630,chr2-241804528-G-T,rs741776,1,G,T,241804528,69898,241538022,241931238,266506
2,ENSG00000091436.12,173075846,chr2-172965284-C-T,rs74468203,1,C,T,172965284,110562,172879238,173272454,86046
2,ENSG00000115947.8,148020737,chr2-147850078-C-T,rs74508961,-1,C,T,147850078,170659,147824129,148217345,25949
2,ENSG00000138092.6,24793425,chr2-24946443-G-A,rs74654316,1,G,A,24946443,153018,24596817,24990033,349626
2,ENSG00000116095.5,178480457,chr2-178398036-A-G,rs747626,1,A,G,178398036,82421,178283849,178677065,114187
2,ENSG00000176732.6,24123334,chr2-24139658-T-C,rs75208176,-1,T,C,24139658,16324,23926726,24319942,212932
2,ENSG00000114993.11,74441937,chr2-74442388-G-T,rs7556852,-1,G,T,74442388,451,74245329,74638545,197059
2,ENSG00000119862.7,64454162,chr2-64421305-T-C,rs7558663,1,T,C,64421305,32857,64257554,64650770,163751
2,ENSG00000144026.6,95159848,chr2-95027029-G-A,rs7560571,-1,G,A,95027029,132819,94963240,95356456,63789
2,ENSG00000132321.11,236507476,chr2-236495594-G-T,rs75620719,-1,G,T,236495594,11882,236310868,236704084,184726
2,ENSG00000135898.5,230925242,chr2-230903208-T-G,rs7562897,-1,T,G,230903208,22034,230728634,231121850,174574
2,ENSG00000155438.6,121736875,chr2-121821936-T-G,rs7571542,-1,T,G,121821936,85061,121540267,121933483,281669
2,ENSG00000163013.6,73284478,chr2-73325414-G-A,rs7573275,-1,G,A,73325414,40936,73087870,73481086,237544
2,ENSG00000115687.9,241149472,chr2-241021929-A-G,rs7573476,-1,A,G,241021929,127543,240952864,241346080,69065
2,ENSG00000115844.6,172102900,chr2-172287780-A-C,rs7574709,-1,A,C,172287780,184880,171906292,172299508,381488
2,ENSG00000084710.8,25042076,chr2-25230181-G-A,rs75781902,1,G,A,25230181,188105,24845468,25238684,384713
2,ENSG00000177917.5,152718620,chr2-152911182-A-G,rs7581172,1,A,G,152911182,192562,152522012,152915228,389170
2,ENSG00000152292.11,85418714,chr2-85435513-C-T,rs7589663,1,C,T,85435513,16799,85222106,85615322,213407
2,ENSG00000162976.8,11155467,chr2-11303444-C-T,rs7598990,1,C,T,11303444,147977,10958859,11352075,344585
2,ENSG00000168758.6,96870080,chr2-96686103-A-G,rs7599598,-1,A,G,96686103,183977,96673472,97066688,12631
2,ENSG00000163516.8,219229806,chr2-219357630-C-G,rs7600361,1,C,G,219357630,127824,219033198,219426414,324432
2,ENSG00000168393.7,241686815,chr2-241657903-G-C,rs7600642,-1,G,C,241657903,28912,241490207,241883423,167696
2,ENSG00000091428.11,172735845,chr2-172811347-C-T,rs76020680,1,C,T,172811347,75502,172539237,172932453,272110
2,ENSG00000169554.9,144520119,chr2-144464070-T-A,rs7605612,-1,T,A,144464070,56049,144323511,144716727,140559
2,ENSG00000176407.12,84971161,chr2-85040233-T-C,rs7607064,1,T,C,85040233,69072,84774553,85167769,265680
2,ENSG00000138363.10,215312059,chr2-215381357-A-G,rs7608342,1,A,G,215381357,69298,215115451,215508667,265906
2,ENSG00000115946.3,68157888,chr2-68292883-G-A,rs76173079,1,G,A,68292883,134995,67961280,68354496,331603
2,ENSG00000115946.3,68157888,chr2-68292883-G-T,rs76173079,1,G,T,68292883,134995,67961280,68354496,331603
2,ENSG00000172059.6,10043550,chr2-10054360-T-C,rs7632,1,T,C,10054360,10810,9846942,10240158,207418
2,ENSG00000123983.9,222861036,chr2-222743688-C-T,rs76459391,1,C,T,222743688,117348,222664428,223057644,79260
2,ENSG00000158089.10,31138440,chr2-31189481-G-A,rs78099670,-1,G,A,31189481,51041,30941832,31335048,247649
2,ENSG00000152253.4,168890430,chr2-169052515-G-C,rs78653364,-1,G,C,169052515,162085,168693822,169087038,358693
2,ENSG00000144120.7,119679201,chr2-119733955-A-C,rs78863627,1,A,C,119733955,54754,119482593,119875809,251362
2,ENSG00000144535.14,231961713,chr2-231895631-C-T,rs78953666,1,C,T,231895631,66082,231765105,232158321,130526
2,ENSG00000170802.9,48314682,chr2-48327816-G-A,rs79247094,1,G,A,48327816,13134,48118074,48511290,209742
2,ENSG00000196811.6,232539692,chr2-232445168-G-T,rs80229452,1,G,T,232445168,94524,232343084,232736300,102084
2,ENSG00000172954.8,30447246,chr2-30408827-G-A,rs829610,1,G,A,30408827,38419,30250638,30643854,158189
2,ENSG00000187514.9,231708525,chr2-231706504-A-G,rs838441,1,A,G,231706504,2021,231511917,231905133,194587
2,ENSG00000085982.8,233566782,chr2-233521871-T-C,rs838546,-1,T,C,233521871,44911,233370174,233763390,151697
2,ENSG00000068024.11,239401020,chr2-239394311-T-C,rs870790,-1,T,C,239394311,6709,239204412,239597628,189899
2,ENSG00000138071.8,65227831,chr2-65329941-G-A,rs871973,1,G,A,65329941,102110,65031223,65424439,298718
2,ENSG00000125618.12,113278921,chr2-113261552-G-T,rs877202,-1,G,T,113261552,17369,113082313,113475529,179239
2,ENSG00000115310.13,55050451,chr2-55120336-A-G,rs894961,-1,A,G,55120336,69885,54853843,55247059,266493
2,ENSG00000132329.6,237859623,chr2-237906610-C-T,rs895572,1,C,T,237906610,46987,237663015,238056231,243595
2,ENSG00000189362.7,190534722,chr2-190385552-T-C,rs9288172,-1,T,C,190385552,149170,190338114,190731330,47438
2,ENSG00000168890.9,85602698,chr2-85671020-C-A,rs934774,-1,C,A,85671020,68322,85406090,85799306,264930
2,ENSG00000065911.7,74198615,chr2-74168944-A-G,rs9677593,1,A,G,74168944,29671,74002007,74395223,166937
2,ENSG00000115091.5,113890089,chr2-113901420-A-C,rs9677951,1,A,C,113901420,11331,113693481,114086697,207939
2,ENSG00000144401.9,207625378,chr2-207644858-T-C,rs9751478,-1,T,C,207644858,19480,207428770,207821986,216088
2,ENSG00000154252.11,241776822,chr2-241786337-G-A,rs9973663,1,G,A,241786337,9515,241580214,241973430,206123
1,ENSG00000143363.10,151008449,chr1-150876627-C-A,rs10305649,1,C,A,150876627,131822,150811841,151205057,64786
1,ENSG00000133048.8,203186704,chr1-203186952-T-C,rs10399931,-1,T,C,203186952,248,202990096,203383312,196856
1,ENSG00000143614.7,153922972,chr1-153936593-G-C,rs1043608,-1,G,C,153936593,13621,153726364,154119580,210229
1,ENSG00000160856.14,157700769,chr1-157699878-G-A,rs10489678,-1,G,A,157699878,891,157504161,157897377,195717
1,ENSG00000116786.7,15684320,chr1-15666843-A-G,rs10492987,1,A,G,15666843,17477,15487712,15880928,179131
1,ENSG00000117226.7,89022866,chr1-89009452-C-T,rs10493821,-1,C,T,89009452,13414,88826258,89219474,183194
1,ENSG00000162836.6,147670524,chr1-147641588-C-T,rs10494247,-1,C,T,147641588,28936,147473916,147867132,167672
1,ENSG00000186141.4,145824200,chr1-145848665-A-C,rs1050057,1,A,C,145848665,24465,145627592,146020808,221073
1,ENSG00000188672.10,25420825,chr1-25361410-T-C,rs1053438,-1,T,C,25361410,59415,25224217,25617433,137193
1,ENSG00000177181.9,42380792,chr1-42414845-T-C,rs1055055,1,T,C,42414845,34053,42184184,42577400,230661
1,ENSG00000007341.12,112619141,chr1-112540817-C-T,rs10745330,-1,C,T,112540817,78324,112422533,112815749,118284
1,ENSG00000162783.7,181088700,chr1-181110178-T-C,rs10752833,1,T,C,181110178,21478,180892092,181285308,218086
1,ENSG00000135821.10,182391790,chr1-182414429-T-A,rs10752871,-1,T,A,182414429,22639,182195182,182588398,219247
1,ENSG00000186283.9,179082070,chr1-179092292-C-T,rs10798652,1,C,T,179092292,10222,178885462,179278678,206830
1,ENSG00000174307.5,201469188,chr1-201433866-C-T,rs10800780,-1,C,T,201433866,35322,201272580,201665796,161286
1,ENSG00000143110.7,111473984,chr1-111391066-A-G,rs10857881,1,A,G,111391066,82918,111277376,111670592,113690
1,ENSG00000143643.8,230978861,chr1-230980141-A-C,rs10864645,-1,A,C,230980141,1280,230782253,231175469,197888
1,ENSG00000117133.6,84479266,chr1-84468163-G-T,rs10874446,1,G,T,84468163,11103,84282658,84675874,185505
1,ENSG00000116863.8,36088892,chr1-36219343-T-C,rs1088201,1,T,C,36219343,130451,35892284,36285500,327059
1,ENSG00000125703.8,62784132,chr1-62831090-C-T,rs10889383,1,C,T,62831090,46958,62587524,62980740,243566
1,ENSG00000116761.7,70411268,chr1-70412281-G-A,rs10889869,1,G,A,70412281,1013,70214660,70607876,197621
1,ENSG00000158796.10,161132667,chr1-161038745-C-G,rs10908821,-1,C,G,161038745,93922,160936059,161329275,102686
1,ENSG00000215845.6,161038964,chr1-161038745-C-G,rs10908821,-1,C,G,161038745,219,160842356,161235572,196389
1,ENSG00000158109.9,3625015,chr1-3622518-A-G,rs10909989,1,A,G,3622518,2497,3428407,3821623,194111
1,ENSG00000162704.10,183635783,chr1-183694014-T-C,rs10911414,-1,T,C,183694014,58231,183439175,183832391,254839
1,ENSG00000116260.12,180154869,chr1-180175350-G-A,rs10913939,1,G,A,180175350,20481,179958261,180351477,217089
1,ENSG00000142910.9,31576515,chr1-31620036-A-G,rs10914455,1,A,G,31620036,43521,31379907,31773123,240129
1,ENSG00000169914.5,19882395,chr1-19877141-T-A,rs10916662,1,T,A,19877141,5254,19685787,20079003,191354
1,ENSG00000197965.7,167721982,chr1-167726262-A-G,rs10918747,1,A,G,167726262,4280,167525374,167918590,200888
1,ENSG00000197965.7,167721982,chr1-167726262-A-T,rs10918747,1,A,T,167726262,4280,167525374,167918590,200888
1,ENSG00000143851.11,202160602,chr1-202183001-C-T,rs10920358,-1,C,T,202183001,22399,201963994,202357210,219007
1,ENSG00000035687.8,244451909,chr1-244353032-A-C,rs10927202,-1,A,C,244353032,98877,244255301,244648517,97731
1,ENSG00000066056.7,43300982,chr1-43320097-G-C,rs1098182,1,G,C,43320097,19115,43104374,43497590,215723
1,ENSG00000135828.6,182589256,chr1-182574196-A-G,rs11072,-1,A,G,182574196,15060,182392648,182785864,181548
1,ENSG00000143479.11,206635536,chr1-206660258-C-G,rs11119256,1,C,G,206660258,24722,206438928,206832144,221330
1,ENSG00000162757.3,209784559,chr1-209850752-G-A,rs11119354,-1,G,A,209850752,66193,209587951,209981167,262801
1,ENSG00000162769.7,212858275,chr1-212858606-G-C,rs11120047,1,G,C,212858606,331,212661667,213054883,196939
1,ENSG00000049245.8,7771296,chr1-7730228-T-C,rs11121007,1,T,C,7730228,41068,7574688,7967904,155540
1,ENSG00000054523.11,10210570,chr1-10211630-C-G,rs11121529,1,C,G,10211630,1060,10013962,10407178,197668
1,ENSG00000162490.6,11691710,chr1-11740421-T-G,rs11121816,1,T,G,11740421,48711,11495102,11888318,245319
1,ENSG00000116353.8,29230934,chr1-29245276-G-T,rs1113735,-1,G,T,29245276,14342,29034326,29427542,210950
1,ENSG00000142867.6,85276632,chr1-85295980-G-A,rs11161585,-1,G,A,85295980,19348,85080024,85473240,215956
1,ENSG00000142867.6,85276632,chr1-85295980-G-C,rs11161585,-1,G,C,85295980,19348,85080024,85473240,215956
1,ENSG00000118733.11,101996926,chr1-101973773-G-A,rs11164354,-1,G,A,101973773,23153,101800318,102193534,173455
1,ENSG00000134215.11,107965180,chr1-108011568-G-A,rs111807063,-1,G,A,108011568,46388,107768572,108161788,242996
1,ENSG00000177606.5,58784047,chr1-58793207-C-T,rs11207306,-1,C,T,58793207,9160,58587439,58980655,205768
1,ENSG00000142864.10,67430402,chr1-67540468-T-G,rs11209108,-1,T,G,67540468,110066,67233794,67627010,306674
1,ENSG00000065978.12,42682418,chr1-42689391-G-T,rs11210696,1,G,T,42689391,6973,42485810,42879026,203581
1,ENSG00000117408.5,43946950,chr1-44044903-C-A,rs11210945,1,C,A,44044903,97953,43750342,44143558,294561
1,ENSG00000117408.5,43946950,chr1-44044903-C-T,rs11210945,1,C,T,44044903,97953,43750342,44143558,294561
1,ENSG00000070785.12,44986595,chr1-44809879-A-C,rs11211037,-1,A,C,44809879,176716,44789987,45183203,19892
1,ENSG00000079277.14,46604268,chr1-46522941-C-G,rs11211299,-1,C,G,46522941,81327,46407660,46800876,115281
1,ENSG00000116731.15,13700188,chr1-13834823-G-A,rs112362960,1,G,A,13834823,134635,13503580,13896796,331243
1,ENSG00000116731.15,13700188,chr1-13834823-G-T,rs112362960,1,G,T,13834823,134635,13503580,13896796,331243
1,ENSG00000182749.5,25875708,chr1-25795606-G-T,rs11247709,-1,G,T,25795606,80102,25679100,26072316,116506
1,ENSG00000142675.11,26177491,chr1-26191176-T-C,rs11247864,1,T,C,26191176,13685,25980883,26374099,210293
1,ENSG00000175087.5,26111824,chr1-26193473-A-G,rs11247868,1,A,G,26193473,81649,25915216,26308432,278257
1,ENSG00000185090.10,37793847,chr1-37734325-G-C,rs11264095,1,G,C,37734325,59522,37597239,37990455,137086
1,ENSG00000143578.11,153967902,chr1-153969038-C-T,rs11264743,1,C,T,153969038,1136,153771294,154164510,197744
1,ENSG00000143578.11,153967902,chr1-153969038-C-A,rs11264743,1,C,A,153969038,1136,153771294,154164510,197744
1,ENSG00000143549.14,154192100,chr1-154184614-T-C,rs11265251,-1,T,C,154184614,7486,153995492,154388708,189122
1,ENSG00000160712.8,154405343,chr1-154391664-G-A,rs11265608,1,G,A,154391664,13679,154208735,154601951,182929
1,ENSG00000143621.12,153670993,chr1-153670433-A-G,rs11265625,-1,A,G,153670433,560,153474385,153867601,196048
1,ENSG00000162520.10,32702770,chr1-32677093-C-T,rs1136258,-1,C,T,32677093,25677,32506162,32899378,170931
1,ENSG00000117153.11,202927234,chr1-202927014-G-C,rs114170147,-1,G,C,202927014,220,202730626,203123842,196388
1,ENSG00000117153.11,202927234,chr1-202927014-G-T,rs114170147,-1,G,T,202927014,220,202730626,203123842,196388
1,ENSG00000184163.3,1246722,chr1-1260503-G-A,rs114569858,-1,G,A,1260503,13781,1050114,1443330,210389
1,ENSG00000158156.7,27959973,chr1-27886368-A-C,rs11485,1,A,C,27886368,73605,27763365,28156581,123003
1,ENSG00000183347.11,89364059,chr1-89201241-C-T,rs115017409,1,C,T,89201241,162818,89167451,89560667,33790
1,ENSG00000184270.3,149887965,chr1-149926400-A-G,rs115070660,-1,A,G,149926400,38435,149691357,150084573,235043
1,ENSG00000183888.4,16004236,chr1-16134201-G-A,rs115292598,1,G,A,16134201,129965,15807628,16200844,326573
1,ENSG00000143633.7,231241175,chr1-231166664-G-T,rs115461650,-1,G,T,231166664,74511,231044567,231437783,122097
1,ENSG00000130764.5,3796498,chr1-3781099-C-T,rs11547615,-1,C,T,3781099,15399,3599890,3993106,181209
1,ENSG00000067208.8,92785108,chr1-92609713-C-T,rs115575692,-1,C,T,92609713,175395,92588500,92981716,21213
1,ENSG00000123685.4,212699840,chr1-212696194-C-A,rs1156058,-1,C,A,212696194,3646,212503232,212896448,192962
1,ENSG00000203943.4,84301708,chr1-84298566-A-G,rs1156085,1,A,G,84298566,3142,84105100,84498316,193466
1,ENSG00000197921.5,2530263,chr1-2529125-C-T,rs115638831,-1,C,T,2529125,1138,2333655,2726871,195470
1,ENSG00000157870.9,2586777,chr1-2529125-C-T,rs115638831,1,C,T,2529125,57652,2390169,2783385,138956
1,ENSG00000134716.5,59926773,chr1-59917437-A-G,rs11572237,-1,A,G,59917437,9336,59730165,60123381,187272
1,ENSG00000162775.9,110339377,chr1-110398888-C-T,rs115744932,1,C,T,110398888,59511,110142769,110535985,256119
1,ENSG00000158481.7,158289923,chr1-158260018-C-G,rs11575806,1,C,G,158260018,29905,158093315,158486531,166703
1,ENSG00000143106.8,109426448,chr1-109580891-G-T,rs11583330,-1,G,T,109580891,154443,109229840,109623056,351051
1,ENSG00000240386.2,152775140,chr1-152866438-G-T,rs115867607,1,G,T,152866438,91298,152578532,152971748,287906
1,ENSG00000197084.3,152806651,chr1-152866438-G-T,rs115867607,-1,G,T,152866438,59787,152610043,153003259,256395
1,ENSG00000185436.7,24187289,chr1-24190390-G-A,rs11587500,-1,G,A,24190390,3101,23990681,24383897,199709
1,ENSG00000197959.8,171841498,chr1-171805343-A-G,rs11588833,1,A,G,171805343,36155,171644890,172038106,160453
1,ENSG00000157184.5,53196824,chr1-53187279-T-C,rs11590250,1,T,C,53187279,9545,53000216,53393432,187063
1,ENSG00000135835.6,180912897,chr1-181088213-G-T,rs116437604,1,G,T,181088213,175316,180716289,181109505,371924
1,ENSG00000121900.12,32901389,chr1-32988663-G-A,rs116583478,-1,G,A,32988663,87274,32704781,33097997,283882
1,ENSG00000162614.13,77888624,chr1-77926761-G-A,rs1166698,1,G,A,77926761,38137,77692016,78085232,234745
1,ENSG00000134245.12,112508965,chr1-112410719-T-C,rs1175630,1,T,C,112410719,98246,112312357,112705573,98362
1,ENSG00000153904.12,85465159,chr1-85278006-G-A,rs11800577,-1,G,A,85278006,187153,85268551,85661767,9455
1,ENSG00000009724.12,11047239,chr1-11220866-G-A,rs11803882,-1,G,A,11220866,173627,10850631,11243847,370235
1,ENSG00000143248.7,163202916,chr1-163299291-G-T,rs11803916,-1,G,T,163299291,96375,163006308,163399524,292983
1,ENSG00000171680.14,6491667,chr1-6490445-C-T,rs11806429,-1,C,T,6490445,1222,6295059,6688275,195386
1,ENSG00000118298.5,150257774,chr1-150131106-C-T,rs11806879,1,C,T,150131106,126668,150061166,150454382,69940
1,ENSG00000162620.10,74198176,chr1-74198025-G-A,rs11806946,-1,G,A,74198025,151,74001568,74394784,196457
1,ENSG00000198912.6,3900272,chr1-3892859-G-A,rs11807227,-1,G,A,3892859,7413,3703664,4096880,189195
1,ENSG00000162396.5,54764523,chr1-54775150-C-A,rs1180959,-1,C,A,54775150,10627,54567915,54961131,207235
1,ENSG00000176393.6,201982648,chr1-201981821-T-C,rs11810017,1,T,C,201981821,827,201786040,202179256,195781
1,ENSG00000162889.6,206684905,chr1-206627456-G-T,rs11811382,1,G,T,206627456,57449,206488297,206881513,139159
1,ENSG00000116514.11,32964809,chr1-32884582-G-A,rs11811702,-1,G,A,32884582,80227,32768201,33161417,116381
1,ENSG00000043514.9,39883504,chr1-39893054-G-A,rs11811998,-1,G,A,39893054,9550,39686896,40080112,206158
1,ENSG00000058804.9,53838296,chr1-53840860-A-G,rs1181209,-1,A,G,53840860,2564,53641688,54034904,199172
1,ENSG00000116983.7,39691433,chr1-39652365-T-C,rs1182964,-1,T,C,39652365,39068,39494825,39888041,157540
1,ENSG00000163218.10,153348841,chr1-153355280-G-T,rs12027903,-1,G,T,153355280,6439,153152233,153545449,203047
1,ENSG00000162433.10,65148203,chr1-65178503-T-C,rs12030227,1,T,C,65178503,30300,64951595,65344811,226908
1,ENSG00000117009.7,241532378,chr1-241540180-T-C,rs12030573,1,T,C,241540180,7802,241335770,241728986,204410
1,ENSG00000163444.7,203007374,chr1-202859552-A-G,rs12031797,1,A,G,202859552,147822,202810766,203203982,48786
1,ENSG00000171612.5,9539465,chr1-9534611-A-C,rs12037667,1,A,C,9534611,4854,9342857,9736073,191754
1,ENSG00000142856.12,63523225,chr1-63607743-A-G,rs12038165,-1,A,G,63607743,84518,63326617,63719833,281126
1,ENSG00000067334.8,93879206,chr1-93871379-C-T,rs12041975,-1,C,T,93871379,7827,93682598,94075814,188781
1,ENSG00000198700.5,201829157,chr1-201847444-G-A,rs12042456,1,G,A,201847444,18287,201632549,202025765,214895
1,ENSG00000160058.13,32394441,chr1-32564306-A-G,rs12044277,-1,A,G,32564306,169865,32197833,32591049,366473
1,ENSG00000157911.5,2412564,chr1-2274142-C-A,rs12045693,-1,C,A,2274142,138422,2215956,2609172,58186
1,ENSG00000085491.11,108200343,chr1-108184285-G-A,rs12047867,-1,G,A,108184285,16058,108003735,108396951,180550
1,ENSG00000159363.13,17011928,chr1-16965909-A-G,rs12059633,-1,A,G,16965909,46019,16815320,17208536,150589
1,ENSG00000122218.10,160343250,chr1-160160730-C-G,rs12064269,-1,C,G,160160730,182520,160146642,160539858,14088
1,ENSG00000118873.10,220272453,chr1-220360394-C-G,rs12064931,-1,C,G,220360394,87941,220075845,220469061,284549
1,ENSG00000118873.10,220272453,chr1-220360394-C-T,rs12064931,-1,C,T,220360394,87941,220075845,220469061,284549
1,ENSG00000187144.7,16437424,chr1-16445151-C-T,rs12071176,-1,C,T,16445151,7727,16240816,16634032,204335
1,ENSG00000143294.9,156767535,chr1-156823152-T-C,rs12073087,1,T,C,156823152,55617,156570927,156964143,252225
1,ENSG00000066027.4,212285410,chr1-212214294-C-T,rs12073206,1,C,T,212214294,71116,212088802,212482018,125492
1,ENSG00000116237.9,6235964,chr1-6233830-G-A,rs12073932,-1,G,A,6233830,2134,6039356,6432572,194474
1,ENSG00000143815.10,225428038,chr1-225435824-C-A,rs12076606,-1,C,A,225435824,7786,225231430,225624646,204394
1,ENSG00000118655.4,113905326,chr1-113901972-T-G,rs12079716,1,T,G,113901972,3354,113708718,114101934,193254
1,ENSG00000122417.9,86396342,chr1-86227513-A-C,rs12083520,-1,A,C,86227513,168829,86199734,86592950,27779
1,ENSG00000143353.7,219173878,chr1-219305896-T-C,rs12086585,1,T,C,219305896,132018,218977270,219370486,328626
1,ENSG00000117222.9,205121978,chr1-205142722-G-A,rs12089690,-1,G,A,205142722,20744,204925370,205318586,217352
1,ENSG00000116691.6,12019498,chr1-12033989-G-A,rs1208991,1,G,A,12033989,14491,11822890,12216106,211099
1,ENSG00000177674.10,11736136,chr1-11737129-T-C,rs12095517,1,T,C,11737129,993,11539528,11932744,197601
1,ENSG00000174529.6,205084460,chr1-205071815-C-G,rs12117194,-1,C,G,205071815,12645,204887852,205281068,183963
1,ENSG00000162849.10,245154985,chr1-245124206-G-A,rs12117676,1,G,A,245124206,30779,244958377,245351593,165829
1,ENSG00000152382.5,166876264,chr1-166891279-C-T,rs12117902,-1,C,T,166891279,15015,166679656,167072872,211623
1,ENSG00000162897.9,206970460,chr1-206958226-T-G,rs12119983,-1,T,G,206958226,12234,206773852,207167068,184374
1,ENSG00000196189.6,156153585,chr1-156157577-T-C,rs12128066,1,T,C,156157577,3992,155956977,156350193,200600
1,ENSG00000240563.1,62194849,chr1-62211446-A-G,rs12130050,1,A,G,62211446,16597,61998241,62391457,213205
1,ENSG00000168159.7,228487382,chr1-228515535-T-C,rs12136157,1,T,C,228515535,28153,228290774,228683990,224761
1,ENSG00000116199.7,179025894,chr1-179076365-C-A,rs1220,1,C,A,179076365,50471,178829286,179222502,247079
1,ENSG00000171603.11,9823965,chr1-9848211-C-T,rs1220395,-1,C,T,9848211,24246,9627357,10020573,220854
1,ENSG00000178585.10,9910269,chr1-9948163-G-A,rs1220421,-1,G,A,9948163,37894,9713661,10106877,234502
1,ENSG00000143190.14,167220886,chr1-167273666-G-A,rs12239612,1,G,A,167273666,52780,167024278,167417494,249388
1,ENSG00000162441.6,9943391,chr1-9943262-G-A,rs1234694,-1,G,A,9943262,129,9746783,10139999,196479
1,ENSG00000189195.5,92080345,chr1-92129343-G-A,rs12385692,1,G,A,92129343,48998,91883737,92276953,245606
1,ENSG00000185523.6,212847649,chr1-212753667-A-G,rs12404618,-1,A,G,212753667,93982,212651041,213044257,102626
1,ENSG00000052723.7,114780685,chr1-114592888-C-T,rs12405486,-1,C,T,114592888,187797,114584077,114977293,8811
1,ENSG00000164010.9,42817122,chr1-42844968-A-G,rs12406279,1,A,G,42844968,27846,42620514,43013730,224454
1,ENSG00000066185.8,42456022,chr1-42586800-T-G,rs12408987,-1,T,G,42586800,130778,42259414,42652630,327386
1,ENSG00000116171.11,52927276,chr1-52820341-A-G,rs1241980,1,A,G,52820341,106935,52730668,53123884,89673
1,ENSG00000121310.11,52921740,chr1-52886344-G-A,rs1242198,-1,G,A,52886344,35396,52725132,53118348,161212
1,ENSG00000189181.3,248682328,chr1-248779833-T-C,rs12563983,-1,T,C,248779833,97505,248485720,248878936,294113
1,ENSG00000132694.14,157045742,chr1-156899255-G-T,rs12566888,-1,G,T,156899255,146487,156849134,157242350,50121
1,ENSG00000085465.10,111427735,chr1-111449473-C-T,rs1264899,-1,C,T,111449473,21738,111231127,111624343,218346
1,ENSG00000186197.7,236394286,chr1-236281673-C-T,rs1269025,1,C,T,236281673,112613,236197678,236590894,83995
1,ENSG00000135778.6,232950611,chr1-232955717-T-A,rs12725558,1,T,A,232955717,5106,232754003,233147219,201714
1,ENSG00000131697.12,5992425,chr1-5969877-G-A,rs12745395,-1,G,A,5969877,22548,5795817,6189033,174060
1,ENSG00000171502.10,86156772,chr1-86083516-C-T,rs12754154,-1,C,T,86083516,73256,85960164,86353380,123352
1,ENSG00000134255.9,111140223,chr1-111200219-A-G,rs12756391,1,A,G,111200219,59996,110943615,111336831,256604
1,ENSG00000198162.6,117367449,chr1-117336057-T-C,rs1289852,1,T,C,117336057,31392,117170841,117564057,165216
1,ENSG00000125459.9,155610218,chr1-155443513-C-A,rs1325908,1,C,A,155443513,166705,155413610,155806826,29903
1,ENSG00000116874.7,119140653,chr1-119041345-T-A,rs1325939,-1,T,A,119041345,99308,118944045,119337261,97300
1,ENSG00000134202.6,109741038,chr1-109740350-G-T,rs1332018,-1,G,T,109740350,688,109544430,109937646,195920
1,ENSG00000162377.4,52698347,chr1-52724144-A-G,rs1332776,-1,A,G,52724144,25797,52501739,52894955,222405
1,ENSG00000116885.14,36450451,chr1-36417489-G-T,rs13375417,-1,G,T,36417489,32962,36253843,36647059,163646
1,ENSG00000169418.7,153678688,chr1-153809781-G-A,rs13375579,1,G,A,153809781,131093,153482080,153875296,327701
1,ENSG00000132185.12,161707229,chr1-161707180-A-C,rs1340978,1,A,C,161707180,49,161510621,161903837,196559
1,ENSG00000132185.12,161707229,chr1-161707180-A-G,rs1340978,1,A,G,161707180,49,161510621,161903837,196559
1,ENSG00000162746.10,161721563,chr1-161707180-A-C,rs1340978,1,A,C,161707180,14383,161524955,161918171,182225
1,ENSG00000162746.10,161721563,chr1-161707180-A-G,rs1340978,1,A,G,161707180,14383,161524955,161918171,182225
1,ENSG00000116830.5,117060326,chr1-117143870-C-A,rs13505,1,C,A,117143870,83544,116863718,117256934,280152
1,ENSG00000143226.8,161505457,chr1-161593764-A-G,rs139529340,1,A,G,161593764,88307,161308849,161702065,284915
1,ENSG00000143147.10,168136930,chr1-168138805-A-G,rs1406822,-1,A,G,168138805,1875,167940322,168333538,198483
1,ENSG00000134709.6,59814949,chr1-59877388-T-A,rs1408478,1,T,A,59877388,62439,59618341,60011557,259047
1,ENSG00000137959.10,78620448,chr1-78601864-G-A,rs1413358,1,G,A,78601864,18584,78423840,78817056,178024
1,ENSG00000116815.11,116571026,chr1-116524285-A-G,rs1414275,-1,A,G,116524285,46741,116374418,116767634,149867
1,ENSG00000116729.9,68232523,chr1-68188593-T-C,rs1430741,-1,T,C,68188593,43930,68035915,68429131,152678
1,ENSG00000117174.6,85708433,chr1-85707615-C-T,rs1539444,-1,C,T,85707615,818,85511825,85905041,195790
1,ENSG00000142794.11,21440137,chr1-21440170-G-C,rs1566523,1,G,C,21440170,33,21243529,21636745,196641
1,ENSG00000197622.7,151059622,chr1-151067959-G-A,rs15740,-1,G,A,151067959,8337,150863014,151256230,204945
1,ENSG00000197147.6,89524829,chr1-89445574-T-A,rs1599155,1,T,A,89445574,79255,89328221,89721437,117353
1,ENSG00000197147.6,89524829,chr1-89445574-T-C,rs1599155,1,T,C,89445574,79255,89328221,89721437,117353
1,ENSG00000049247.8,7853065,chr1-7921974-T-C,rs161827,-1,T,C,7921974,68909,7656457,8049673,265517
1,ENSG00000049249.4,7940839,chr1-7921974-T-C,rs161827,-1,T,C,7921974,18865,7744231,8137447,177743
1,ENSG00000090686.11,21783149,chr1-21727934-C-A,rs16825896,-1,C,A,21727934,55215,21586541,21979757,141393
1,ENSG00000117000.6,40161387,chr1-40041892-G-A,rs16826771,1,G,A,40041892,119495,39964779,40357995,77113
1,ENSG00000143387.8,150808260,chr1-150766283-T-C,rs16827671,-1,T,C,150766283,41977,150611652,151004868,154631
1,ENSG00000142959.4,44788170,chr1-44743989-A-G,rs16832210,-1,A,G,44743989,44181,44591562,44984778,152427
1,ENSG00000143252.9,161314381,chr1-161363458-G-T,rs16832859,1,G,T,161363458,49077,161117773,161510989,245685
1,ENSG00000159445.8,151909511,chr1-151945688-C-A,rs16833668,-1,C,A,151945688,36177,151712903,152106119,232785
1,ENSG00000159445.8,151909511,chr1-151945688-C-G,rs16833668,-1,C,G,151945688,36177,151712903,152106119,232785
1,ENSG00000116819.6,35573314,chr1-35453577-T-C,rs16837364,1,T,C,35453577,119737,35376706,35769922,76871
1,ENSG00000143321.13,156751675,chr1-156835118-G-C,rs16837711,-1,G,C,156835118,83443,156555067,156948283,280051
1,ENSG00000213047.6,197775480,chr1-197824352-T-C,rs16841984,-1,T,C,197824352,48872,197578872,197972088,245480
1,ENSG00000120332.10,175067833,chr1-175123014-G-A,rs16847820,1,G,A,175123014,55181,174871225,175264441,251789
1,ENSG00000169905.7,179877803,chr1-179794476-A-G,rs16854720,-1,A,G,179794476,83327,179681195,180074411,113281
1,ENSG00000162522.6,32741830,chr1-32775688-T-C,rs16866009,1,T,C,32775688,33858,32545222,32938438,230466
1,ENSG00000123684.8,211830763,chr1-211697168-G-C,rs17017943,-1,G,C,211697168,133595,211634155,212027371,63013
1,ENSG00000170385.9,211579161,chr1-211697168-G-C,rs17017943,-1,G,C,211697168,118007,211382553,211775769,314615
1,ENSG00000162772.12,212608761,chr1-212540065-A-G,rs17019266,1,A,G,212540065,68696,212412153,212805369,127912
1,ENSG00000134247.8,116909916,chr1-117094538-C-T,rs17036849,1,C,T,117094538,184622,116713308,117106524,381230
1,ENSG00000215717.4,109090764,chr1-109117336-C-T,rs17038491,1,C,T,109117336,26572,108894156,109287372,223180
1,ENSG00000137955.10,75786256,chr1-75975837-A-T,rs17097780,1,A,T,75975837,189581,75589648,75982864,386189
1,ENSG00000122432.11,84506397,chr1-84512749-T-C,rs17110590,1,T,C,84512749,6352,84309789,84703005,202960
1,ENSG00000055732.7,85048500,chr1-85019487-C-G,rs17119333,-1,C,G,85019487,29013,84851892,85245108,167595
1,ENSG00000131591.12,1116089,chr1-1050520-C-T,rs17160776,-1,C,T,1050520,65569,919481,1312697,131039
1,ENSG00000117748.5,27914575,chr1-27893147-C-G,rs17185038,-1,C,G,27893147,21428,27717967,28111183,175180
1,ENSG00000162604.6,61725141,chr1-61723869-T-C,rs17312971,-1,T,C,61723869,1272,61528533,61921749,195336
1,ENSG00000132681.12,160151603,chr1-160176786-A-G,rs17368598,1,A,G,160176786,25183,159954995,160348211,221791
1,ENSG00000081721.6,161749786,chr1-161758137-C-T,rs17415505,1,C,T,161758137,8351,161553178,161946394,204959
1,ENSG00000079335.13,100352506,chr1-100353172-T-G,rs17420882,1,T,G,100353172,666,100155898,100549114,197274
1,ENSG00000142623.8,17205128,chr1-17196740-T-C,rs17456119,1,T,C,17196740,8388,17008520,17401736,188220
1,ENSG00000134262.8,113904799,chr1-113901277-G-A,rs17464525,-1,G,A,113901277,3522,113708191,114101407,193086
1,ENSG00000163485.11,203127726,chr1-203161543-G-A,rs17465037,1,G,A,203161543,33817,202931118,203324334,230425
1,ENSG00000142621.14,15247223,chr1-15250526-A-G,rs1752005,1,A,G,15250526,3303,15050615,15443831,199911
1,ENSG00000162813.12,220089788,chr1-220219070-A-C,rs17565134,-1,A,C,220219070,129282,219893180,220286396,325890
1,ENSG00000184908.12,16043782,chr1-16012430-T-G,rs1763605,1,T,G,16012430,31352,15847174,16240390,165256
1,ENSG00000173641.12,16018043,chr1-16012430-T-G,rs1763605,-1,T,G,16012430,5613,15821435,16214651,190995
1,ENSG00000092607.8,118988343,chr1-118918773-G-T,rs1779431,-1,G,T,118918773,69570,118791735,119184951,127038
1,ENSG00000168765.10,109656099,chr1-109606352-C-T,rs1799875,1,C,T,109606352,49747,109459491,109852707,146861
1,ENSG00000168765.10,109656099,chr1-109606352-C-A,rs1799875,1,C,A,109606352,49747,109459491,109852707,146861
1,ENSG00000116741.6,192809039,chr1-192815708-T-C,rs1819741,1,T,C,192815708,6669,192612431,193005647,203277
1,ENSG00000162739.9,160523255,chr1-160339874-T-G,rs1886419,-1,T,G,160339874,183381,160326647,160719863,13227
1,ENSG00000162777.12,111200646,chr1-111214085-T-C,rs1886652,-1,T,C,111214085,13439,111004038,111397254,210047
1,ENSG00000116809.6,15976101,chr1-16022234-G-A,rs1889785,-1,G,A,16022234,46133,15779493,16172709,242741
1,ENSG00000072694.13,161663143,chr1-161707945-T-C,rs1954172,1,T,C,161707945,44802,161466535,161859751,241410
1,ENSG00000197852.7,111739395,chr1-111749022-C-T,rs197377,-1,C,T,111749022,9627,111542787,111936003,206235
1,ENSG00000117479.7,169485944,chr1-169476945-A-G,rs1983546,-1,A,G,169476945,8999,169289336,169682552,187609
1,ENSG00000116406.13,184754858,chr1-184684499-T-C,rs2024766,-1,T,C,184684499,70359,184558250,184951466,126249
1,ENSG00000117090.8,160647044,chr1-160500966-T-C,rs2025516,-1,T,C,160500966,146078,160450436,160843652,50530
1,ENSG00000158769.11,161021152,chr1-161015918-A-G,rs2039223,-1,A,G,161015918,5234,160824544,161217760,191374
1,ENSG00000177628.8,155241249,chr1-155225189-T-C,rs2049805,-1,T,C,155225189,16060,155044641,155437857,180548
1,ENSG00000160716.4,154567778,chr1-154576404-G-A,rs2072661,1,G,A,154576404,8626,154371170,154764386,205234
1,ENSG00000143155.8,168178962,chr1-168199512-A-G,rs2072778,1,A,G,168199512,20550,167982354,168375570,217158
1,ENSG00000143194.7,166989280,chr1-166960290-T-G,rs2075982,1,T,G,166960290,28990,166792672,167185888,167618
1,ENSG00000204219.5,23424748,chr1-23451869-C-T,rs2077066,-1,C,T,23451869,27121,23228140,23621356,223729
1,ENSG00000121903.8,33472645,chr1-33586065-G-T,rs2077821,1,G,T,33586065,113420,33276037,33669253,310028
1,ENSG00000127423.6,25859457,chr1-25862134-G-A,rs213637,-1,G,A,25862134,2677,25662849,26056065,199285
1,ENSG00000127423.6,25859457,chr1-25862134-G-T,rs213637,-1,G,T,25862134,2677,25662849,26056065,199285
1,ENSG00000082512.10,211326833,chr1-211332403-T-G,rs2175633,1,T,G,211332403,5570,211130225,211523441,202178
1,ENSG00000143776.12,227318492,chr1-227166834-C-T,rs2175789,-1,C,T,227166834,151658,227121884,227515100,44950
1,ENSG00000142632.10,16212652,chr1-16203554-C-T,rs221045,-1,C,T,16203554,9098,16016044,16409260,187510
1,ENSG00000084636.11,31704017,chr1-31699894-G-T,rs2228552,-1,G,T,31699894,4123,31507409,31900625,192485
1,ENSG00000187801.9,40450476,chr1-40307451-G-C,rs2228567,1,G,C,40307451,143025,40253868,40647084,53583
1,ENSG00000143157.7,166839475,chr1-166852396-C-T,rs2232521,1,C,T,166852396,12921,166642867,167036083,209529
1,ENSG00000010165.13,171781660,chr1-171796451-G-A,rs2232826,1,G,A,171796451,14791,171585052,171978268,211399
1,ENSG00000157881.8,2526596,chr1-2562891-G-A,rs2234167,-1,G,A,2562891,36295,2329988,2723204,232903
1,ENSG00000117115.8,17119451,chr1-17098350-C-T,rs2235914,-1,C,T,17098350,21101,16922843,17316059,175507
1,ENSG00000157873.11,2556371,chr1-2559459-C-T,rs2257763,1,C,T,2559459,3088,2359763,2752979,199696
1,ENSG00000157873.11,2556371,chr1-2559459-C-A,rs2257763,1,C,A,2559459,3088,2359763,2752979,199696
1,ENSG00000178028.8,44213471,chr1-44357036-G-A,rs226070,1,G,A,44357036,143565,44016863,44410079,340173
1,ENSG00000116285.8,8026309,chr1-7898027-A-G,rs227157,-1,A,G,7898027,128282,7829701,8222917,68326
1,ENSG00000049089.9,40317286,chr1-40314169-G-T,rs2273195,-1,G,T,40314169,3117,40120678,40513894,193491
1,ENSG00000225828.1,32362485,chr1-32366691-A-G,rs2273376,-1,A,G,32366691,4206,32165877,32559093,200814
1,ENSG00000242485.1,1407293,chr1-1407232-G-C,rs2275915,-1,G,C,1407232,61,1210685,1603901,196547
1,ENSG00000160781.9,156248056,chr1-156260415-C-A,rs2287024,-1,C,A,156260415,12359,156051448,156444664,208967
1,ENSG00000183856.6,156572565,chr1-156416995-T-C,rs2296373,-1,T,C,156416995,155570,156375957,156769173,41038
1,ENSG00000084072.12,39738882,chr1-39790200-T-G,rs230280,1,T,G,39790200,51318,39542274,39935490,247926
1,ENSG00000116985.6,39788865,chr1-39790200-T-G,rs230280,-1,T,G,39790200,1335,39592257,39985473,197943
1,ENSG00000187961.7,960584,chr1-983193-A-G,rs2341354,1,A,G,983193,22609,763976,1157192,219217
1,ENSG00000188396.2,44807351,chr1-44700841-T-A,rs2355710,-1,T,A,44700841,106510,44610743,45003959,90098
1,ENSG00000143319.11,156728766,chr1-156645402-G-A,rs2365716,-1,G,A,156645402,83364,156532158,156925374,113244
1,ENSG00000130940.9,10796646,chr1-10920941-C-T,rs2387422,-1,C,T,10920941,124295,10600038,10993254,320903
1,ENSG00000116574.4,228735479,chr1-228819379-C-T,rs241342,1,C,T,228819379,83900,228538871,228932087,280508
1,ENSG00000198734.6,169586481,chr1-169759150-T-C,rs2420506,-1,T,C,169759150,172669,169389873,169783089,369277
1,ENSG00000198734.6,169586481,chr1-169759150-T-A,rs2420506,-1,T,A,169759150,172669,169389873,169783089,369277
1,ENSG00000057757.5,23778418,chr1-23786206-A-C,rs2473381,1,A,C,23786206,7788,23581810,23975026,204396
1,ENSG00000160049.6,10472529,chr1-10507601-C-T,rs2480786,-1,C,T,10507601,35072,10275921,10669137,231680
1,ENSG00000143079.7,112396214,chr1-112408537-A-G,rs2492510,1,A,G,112408537,12323,112199606,112592822,208931
1,ENSG00000213085.5,159900165,chr1-159895867-G-C,rs2494488,-1,G,C,159895867,4298,159703557,160096773,192310
1,ENSG00000159527.3,153312952,chr1-153330351-T-G,rs2570440,-1,T,G,153330351,17399,153116344,153509560,214007
1,ENSG00000076356.6,208244384,chr1-208166028-T-G,rs2590684,-1,T,G,208166028,78356,208047776,208440992,118252
1,ENSG00000185155.6,226223664,chr1-226305728-T-C,rs2615803,1,T,C,226305728,82064,226027056,226420272,278672
1,ENSG00000177272.7,110674940,chr1-110667697-C-A,rs2640482,-1,C,A,110667697,7243,110478332,110871548,189365
1,ENSG00000171385.5,111989668,chr1-112086238-T-C,rs269101,-1,T,C,112086238,96570,111793060,112186276,293178
1,ENSG00000159166.9,201399324,chr1-201401119-G-C,rs2719178,-1,G,C,201401119,1795,201202716,201595932,198403
1,ENSG00000163041.5,226062716,chr1-226000198-C-T,rs2755093,1,C,T,226000198,62518,225866108,226259324,134090
1,ENSG00000116704.6,67054148,chr1-67051339-T-C,rs2755259,-1,T,C,67051339,2809,66857540,67250756,193799
1,ENSG00000162623.9,74733152,chr1-74811884-T-G,rs277385,1,T,G,74811884,78732,74536544,74929760,275340
1,ENSG00000156869.7,99766635,chr1-99759761-C-T,rs2788517,-1,C,T,99759761,6874,99570027,99963243,189734
1,ENSG00000143337.11,179882285,chr1-179838803-T-A,rs2794582,1,T,A,179838803,43482,179685677,180078893,153126
1,ENSG00000187642.5,981029,chr1-1014545-C-T,rs2799070,-1,C,T,1014545,33516,784421,1177637,230124
1,ENSG00000159479.12,43389800,chr1-43510486-G-A,rs2819341,-1,G,A,43510486,120686,43193192,43586408,317294
1,ENSG00000196754.5,153565844,chr1-153622905-G-A,rs28416529,-1,G,A,153622905,57061,153369236,153762452,253669
1,ENSG00000204084.6,37947053,chr1-37901732-C-T,rs28469609,-1,C,T,37901732,45321,37750445,38143661,151287
1,ENSG00000183310.2,248574757,chr1-248680577-T-C,rs28520471,-1,T,C,248680577,105820,248378149,248771365,302428
1,ENSG00000188558.4,248508073,chr1-248680577-T-C,rs28520471,1,T,C,248680577,172504,248311465,248704681,369112
1,ENSG00000132881.5,16237183,chr1-16234684-C-T,rs2863845,-1,C,T,16234684,2499,16040575,16433791,194109
1,ENSG00000142676.8,23691806,chr1-23677712-C-A,rs2864704,1,C,A,23677712,14094,23495198,23888414,182514
1,ENSG00000116791.9,74733050,chr1-74742350-C-T,rs28879157,-1,C,T,74742350,9300,74536442,74929658,205908
1,ENSG00000116791.9,74733050,chr1-74742350-C-G,rs28879157,-1,C,G,74742350,9300,74536442,74929658,205908
1,ENSG00000117640.13,25819954,chr1-25929240-T-C,rs298438,1,T,C,25929240,109286,25623346,26016562,305894
1,ENSG00000117632.16,25906419,chr1-25978508-A-G,rs298443,-1,A,G,25978508,72089,25709811,26103027,268697
1,ENSG00000070759.11,45491163,chr1-45533831-G-A,rs2991966,-1,G,A,45533831,42668,45294555,45687771,239276
1,ENSG00000197747.4,151993859,chr1-151999021-C-T,rs2999531,-1,C,T,151999021,5162,151797251,152190467,201770
1,ENSG00000163191.5,152037004,chr1-152042009-T-G,rs2999555,-1,T,G,152042009,5005,151840396,152233612,201613
1,ENSG00000117151.7,84574440,chr1-84547718-C-T,rs3021402,-1,C,T,84547718,26722,84377832,84771048,169886
1,ENSG00000142224.11,206770773,chr1-206768184-T-C,rs3024498,1,T,C,206768184,2589,206574165,206967381,194019
1,ENSG00000126091.15,43707536,chr1-43712399-T-G,rs304303,1,T,G,43712399,4863,43510928,43904144,201471
1,ENSG00000132879.9,11654877,chr1-11658138-A-G,rs3125816,1,A,G,11658138,3261,11458269,11851485,199869
1,ENSG00000116663.6,11664200,chr1-11658138-A-G,rs3125816,1,A,G,11658138,6062,11467592,11860808,190546
1,ENSG00000185420.13,246507279,chr1-246524284-C-T,rs3129586,-1,C,T,246524284,17005,246310671,246703887,213613
1,ENSG00000131238.10,40097252,chr1-40089649-C-T,rs3131651,-1,C,T,40089649,7603,39900644,40293860,189005
1,ENSG00000116990.9,39901917,chr1-39892380-A-T,rs3131690,-1,A,T,39892380,9537,39705309,40098525,187071
1,ENSG00000156150.5,110070672,chr1-110032998-T-C,rs333077,-1,T,C,110032998,37674,109874064,110267280,158934
1,ENSG00000142583.11,9069635,chr1-9041096-T-G,rs34488100,-1,T,G,9041096,28539,8873027,9266243,168069
1,ENSG00000000938.7,27635185,chr1-27631828-C-T,rs34806307,-1,C,T,27631828,3357,27438577,27831793,193251
1,ENSG00000117091.5,160711822,chr1-160712046-C-G,rs352685,-1,C,G,160712046,224,160515214,160908430,196832
1,ENSG00000162461.7,15736258,chr1-15735471-G-A,rs35352784,1,G,A,15735471,787,15539650,15932866,195821
1,ENSG00000143369.10,150508109,chr1-150575462-G-A,rs35392872,1,G,A,150575462,67353,150311501,150704717,263961
1,ENSG00000224051.2,1324802,chr1-1334606-G-A,rs35424002,1,G,A,1334606,9804,1128194,1521410,206412
1,ENSG00000162373.7,48776891,chr1-48592045-T-C,rs35615859,-1,T,C,48592045,184846,48580283,48973499,11762
1,ENSG00000196734.5,152811971,chr1-152878939-G-T,rs35645842,1,G,T,152878939,66968,152615363,153008579,263576
1,ENSG00000158748.3,19664875,chr1-19745589-C-T,rs35760408,1,C,T,19745589,80714,19468267,19861483,277322
1,ENSG00000157978.6,25543606,chr1-25549972-A-G,rs35983441,1,A,G,25549972,6366,25346998,25740214,202974
1,ENSG00000162384.7,53220634,chr1-53218652-A-G,rs3736118,-1,A,G,53218652,1982,53024026,53417242,194626
1,ENSG00000189409.7,1632173,chr1-1689421-G-A,rs3737622,1,G,A,1689421,57248,1435565,1828781,253856
1,ENSG00000157193.10,53328070,chr1-53250744-G-A,rs3737983,-1,G,A,53250744,77326,53131462,53524678,119282
1,ENSG00000157193.10,53328070,chr1-53250744-G-T,rs3737983,-1,G,T,53250744,77326,53131462,53524678,119282
1,ENSG00000160710.11,154608186,chr1-154600943-C-T,rs3738032,-1,C,T,154600943,7243,154411578,154804794,189365
1,ENSG00000117569.12,96721784,chr1-96721527-A-G,rs3748785,1,A,G,96721527,257,96525176,96918392,196351
1,ENSG00000117569.12,96721784,chr1-96721527-A-C,rs3748785,1,A,C,96721527,257,96525176,96918392,196351
1,ENSG00000143013.7,87328880,chr1-87343666-C-T,rs3753290,1,C,T,87343666,14786,87132272,87525488,211394
1,ENSG00000117262.14,145607988,chr1-145716953-T-C,rs3753436,1,T,C,145716953,108965,145411380,145804596,305573
1,ENSG00000171812.5,36125222,chr1-36150736-T-C,rs3754080,-1,T,C,36150736,25514,35928614,36321830,222122
1,ENSG00000203668.1,241640369,chr1-241615528-T-C,rs3765815,-1,T,C,241615528,24841,241443761,241836977,171767
1,ENSG00000182004.8,203861599,chr1-203774525-C-T,rs3766748,1,C,T,203774525,87074,203664991,204058207,109534
1,ENSG00000168653.6,39026350,chr1-39026790-C-T,rs3768324,1,C,T,39026790,440,38829742,39222958,197048
1,ENSG00000143772.5,226739282,chr1-226712714-G-A,rs3768405,-1,G,A,226712714,26568,226542674,226935890,170040
1,ENSG00000183615.5,32247222,chr1-32241190-G-T,rs3795425,1,G,T,32241190,6032,32050614,32443830,190576
1,ENSG00000197956.4,153535991,chr1-153658595-G-A,rs3806234,-1,G,A,153658595,122604,153339383,153732599,319212
1,ENSG00000142920.11,33081153,chr1-33080995-A-G,rs3806246,1,A,G,33080995,158,32884545,33277761,196450
1,ENSG00000143575.10,154272629,chr1-154191663-A-C,rs3811454,1,A,C,154191663,80966,154076021,154469237,115642
1,ENSG00000134256.8,117001760,chr1-117001562-A-G,rs3818446,1,A,G,117001562,198,116805152,117198368,196410
1,ENSG00000187608.5,1013497,chr1-1203533-T-C,rs3819001,1,T,C,1203533,190036,816889,1210105,386644
1,ENSG00000163531.10,204828652,chr1-204991111-C-T,rs3820336,1,C,T,204991111,162459,204632044,205025260,359067
1,ENSG00000134184.7,109687817,chr1-109640399-G-T,rs3850616,1,G,T,109640399,47418,109491209,109884425,149190
1,ENSG00000162817.6,220690363,chr1-220714617-G-C,rs386755,1,G,C,220714617,24254,220493755,220886971,220862
1,ENSG00000186205.8,220786913,chr1-220714617-G-C,rs386755,1,G,C,220714617,72296,220590305,220983521,124312
1,ENSG00000117791.11,220748322,chr1-220714617-G-C,rs386755,1,G,C,220714617,33705,220551714,220944930,162903
1,ENSG00000158715.5,205680509,chr1-205669917-A-G,rs3902968,-1,A,G,205669917,10592,205483901,205877117,186016
1,ENSG00000126070.12,35931105,chr1-36088072-A-G,rs399393,1,A,G,36088072,156967,35734497,36127713,353575
1,ENSG00000001461.11,24415802,chr1-24580924-G-A,rs4073051,1,G,A,24580924,165122,24219194,24612410,361730
1,ENSG00000142765.12,27342022,chr1-27363806-G-T,rs4075731,1,G,T,27363806,21784,27145414,27538630,218392
1,ENSG00000186226.7,152786257,chr1-152786180-C-A,rs41268482,1,C,A,152786180,77,152589649,152982865,196531
1,ENSG00000055070.11,16367242,chr1-16403813-G-T,rs41269193,1,G,T,16403813,36571,16170634,16563850,233179
1,ENSG00000212916.3,232805416,chr1-232805469-A-G,rs41271527,1,A,G,232805469,53,232608808,233002024,196661
1,ENSG00000177000.6,11805964,chr1-11775499-C-T,rs41275456,-1,C,T,11775499,30465,11609356,12002572,166143
1,ENSG00000171357.5,46203334,chr1-46343180-C-T,rs41293287,1,C,T,46343180,139846,46006726,46399942,336454
1,ENSG00000117308.9,23800754,chr1-23696521-C-T,rs41310397,-1,C,T,23696521,104233,23604146,23997362,92375
1,ENSG00000186364.6,145845630,chr1-145872994-T-C,rs41315701,1,T,C,145872994,27364,145649022,146042238,223972
1,ENSG00000186364.6,145845630,chr1-145872994-T-G,rs41315701,1,T,G,145872994,27364,145649022,146042238,223972
1,ENSG00000143198.7,165631234,chr1-165630909-G-A,rs4147592,1,G,A,165630909,325,165434626,165827842,196283
1,ENSG00000162391.5,54623525,chr1-54571211-A-G,rs41503150,-1,A,G,54571211,52314,54426917,54820133,144294
1,ENSG00000117318.8,23559501,chr1-23466405-C-G,rs41521247,-1,C,G,23466405,93096,23362893,23756109,103512
1,ENSG00000162654.8,89198942,chr1-89171264-C-T,rs4233337,-1,C,T,89171264,27678,89002334,89395550,168930
1,ENSG00000154451.10,89272860,chr1-89171264-C-T,rs4233337,-1,C,T,89171264,101596,89076252,89469468,95012
1,ENSG00000154305.11,222618097,chr1-222779028-G-A,rs4256814,1,G,A,222779028,160931,222421489,222814705,357539
1,ENSG00000143222.7,161153978,chr1-161279997-G-A,rs4271232,1,G,A,161279997,126019,160957370,161350586,322627
1,ENSG00000198216.6,181483517,chr1-181430639-G-A,rs4288560,1,G,A,181430639,52878,181286909,181680125,143730
1,ENSG00000162885.6,235504452,chr1-235517074-G-T,rs429328,-1,G,T,235517074,12622,235307844,235701060,209230
1,ENSG00000160679.8,153634066,chr1-153770841-G-A,rs4345834,1,G,A,153770841,136775,153437458,153830674,333383
1,ENSG00000143418.14,150974835,chr1-150964853-C-T,rs4451553,-1,C,T,150964853,9982,150778227,151171443,186626
1,ENSG00000174514.8,205569014,chr1-205611188-T-C,rs4573566,1,T,C,205611188,42174,205372406,205765622,238782
1,ENSG00000184022.2,248597700,chr1-248702256-G-A,rs4587597,-1,G,A,248702256,104556,248401092,248794308,301164
1,ENSG00000116198.8,3857211,chr1-3856525-T-C,rs4648426,-1,T,C,3856525,686,3660603,4053819,195922
1,ENSG00000169885.5,1915260,chr1-1906439-C-T,rs4648732,1,C,T,1906439,8821,1718652,2111868,187787
1,ENSG00000169504.9,24745447,chr1-24770901-A-G,rs4648876,1,A,G,24770901,25454,24548839,24942055,222062
1,ENSG00000054118.9,36224443,chr1-36290890-A-G,rs4653175,1,A,G,36290890,66447,36027835,36421051,263055
1,ENSG00000163875.11,37514766,chr1-37505611-A-G,rs4653295,-1,A,G,37505611,9155,37318158,37711374,187453
1,ENSG00000162594.9,67166454,chr1-67145930-G-A,rs4655683,1,G,A,67145930,20524,66969846,67363062,176084
1,ENSG00000198771.6,167630232,chr1-167642133-A-C,rs4656547,1,A,C,167642133,11901,167433624,167826840,208509
1,ENSG00000143153.7,169106690,chr1-169044645-C-T,rs4656643,1,C,T,169044645,62045,168910082,169303298,134563
1,ENSG00000122223.8,160862887,chr1-160855523-C-T,rs4656938,-1,C,T,160855523,7364,160666279,161059495,189244
1,ENSG00000118217.5,161766320,chr1-161768273-A-G,rs4657100,1,A,G,161768273,1953,161569712,161962928,198561
1,ENSG00000097046.7,91500851,chr1-91395073-G-A,rs4658220,1,G,A,91395073,105778,91304243,91697459,90830
1,ENSG00000169442.4,26317958,chr1-26220884-T-C,rs4659413,1,T,C,26220884,97074,26121350,26514566,99534
1,ENSG00000187815.5,40477290,chr1-40488253-G-A,rs4660411,1,G,A,40488253,10963,40280682,40673898,207571
1,ENSG00000117016.5,40665682,chr1-40585280-G-A,rs4660438,-1,G,A,40585280,80402,40469074,40862290,116206
1,ENSG00000117013.10,40783787,chr1-40799954-C-T,rs4660463,1,C,T,40799954,16167,40587179,40980395,212775
1,ENSG00000177551.5,115841126,chr1-115663802-G-A,rs4839469,-1,G,A,115663802,177324,115644518,116037734,19284
1,ENSG00000163344.5,154936719,chr1-154895579-G-T,rs4845681,-1,G,T,154895579,41140,154740111,155133327,155468
1,ENSG00000163344.5,154936719,chr1-154895579-G-A,rs4845681,-1,G,A,154895579,41140,154740111,155133327,155468
1,ENSG00000169241.12,155135852,chr1-155060538-G-A,rs4845710,1,G,A,155060538,75314,154939244,155332460,121294
1,ENSG00000117505.7,93345907,chr1-93292893-C-T,rs4847406,1,C,T,93292893,53014,93149299,93542515,143594
1,ENSG00000053371.8,19312144,chr1-19311596-G-C,rs4911983,-1,G,C,19311596,548,19115536,19508752,196060
1,ENSG00000162482.4,19288770,chr1-19345882-G-A,rs4912072,-1,G,A,19345882,57112,19092162,19485378,253720
1,ENSG00000159208.11,150282554,chr1-150153788-G-A,rs4926410,1,G,A,150153788,128766,150085946,150479162,67842
1,ENSG00000131778.12,147242684,chr1-147311853-G-A,rs4950398,1,G,A,147311853,69169,147046076,147439292,265777
1,ENSG00000143847.10,203026491,chr1-203043778-G-A,rs4950908,1,G,A,203043778,17287,202829883,203223099,213895
1,ENSG00000031698.8,109213918,chr1-109214673-G-A,rs4970829,1,G,A,109214673,755,109017310,109410526,197363
1,ENSG00000188404.4,169711620,chr1-169696410-G-T,rs4987358,-1,G,T,169696410,15210,169515012,169908228,181398
1,ENSG00000162909.12,223712539,chr1-223653639-A-C,rs4993742,1,A,C,223653639,58900,223515931,223909147,137708
1,ENSG00000175206.6,11847783,chr1-11845917-A-G,rs5068,-1,A,G,11845917,1866,11651175,12044391,194742
1,ENSG00000198754.4,39771348,chr1-39744383-G-A,rs510601,-1,G,A,39744383,26965,39574740,39967956,169643
1,ENSG00000162378.8,52726453,chr1-52871065-C-T,rs514881,1,C,T,52871065,144612,52529845,52923061,341220
1,ENSG00000171492.10,89821032,chr1-89757841-C-A,rs519989,1,C,A,89757841,63191,89624424,90017640,133417
1,ENSG00000171488.9,89633120,chr1-89757841-C-A,rs519989,1,C,A,89757841,124721,89436512,89829728,321329
1,ENSG00000203666.8,244969682,chr1-244996437-A-G,rs522595,1,A,G,244996437,26755,244773074,245166290,223363
1,ENSG00000153936.11,86914635,chr1-86885238-C-G,rs527289,1,C,G,86885238,29397,86718027,87111243,167211
1,ENSG00000142751.7,26890283,chr1-26800452-T-C,rs55748276,-1,T,C,26800452,89831,26693675,27086891,106777
1,ENSG00000119280.12,230868521,chr1-230861593-A-G,rs55762918,-1,A,G,230861593,6928,230671913,231065129,189680
1,ENSG00000134369.10,201648249,chr1-201514986-A-G,rs55898420,1,A,G,201514986,133263,201451641,201844857,63345
1,ENSG00000116473.10,111619789,chr1-111699173-A-G,rs558989,1,A,G,111699173,79384,111423181,111816397,275992
1,ENSG00000183317.11,37765120,chr1-37761596-G-T,rs56276182,-1,G,T,37761596,3524,37568512,37961728,193084
1,ENSG00000214114.4,38873348,chr1-38966141-T-C,rs56285857,-1,T,C,38966141,92793,38676740,39069956,289401
1,ENSG00000171161.7,248838224,chr1-248871149-T-C,rs56331890,1,T,C,248871149,32925,248641616,249034832,229533
1,ENSG00000162543.5,20186096,chr1-20090385-C-G,rs565503,1,C,G,20090385,95711,19989488,20382704,100897
1,ENSG00000117620.7,99969996,chr1-99849298-A-G,rs566460,1,A,G,99849298,120698,99773388,100166604,75910
1,ENSG00000213366.6,109668057,chr1-109670892-A-T,rs574344,1,A,T,109670892,2835,109471449,109864665,199443
1,ENSG00000122224.10,160796174,chr1-160766024-A-G,rs574491,1,A,G,160766024,30150,160599566,160992782,166458
1,ENSG00000120949.10,12063303,chr1-12188682-A-T,rs5746003,1,A,T,12188682,125379,11866695,12259911,321987
1,ENSG00000117592.8,173477335,chr1-173356642-C-T,rs57808485,1,C,T,173356642,120693,173280727,173673943,75915
1,ENSG00000197982.10,37807790,chr1-37790494-G-A,rs579689,1,G,A,37790494,17296,37611182,38004398,179312
1,ENSG00000162616.7,78004939,chr1-78141584-G-T,rs586300,1,G,T,78141584,136645,77808331,78201547,333253
1,ENSG00000081692.7,227735302,chr1-227808608-T-G,rs59541986,-1,T,G,227808608,73306,227538694,227931910,269914
1,ENSG00000117395.5,43172290,chr1-43156889-T-C,rs603786,-1,T,C,43156889,15401,42975682,43368898,181207
1,ENSG00000158828.5,20633458,chr1-20654387-G-A,rs607254,1,G,A,20654387,20929,20436850,20830066,217537
1,ENSG00000117650.8,211675621,chr1-211552051-T-C,rs609832,-1,T,C,211552051,123570,211479013,211872229,73038
1,ENSG00000197472.9,247008057,chr1-247008088-C-G,rs61373194,-1,C,G,247008088,31,246811449,247204665,196639
1,ENSG00000162572.14,1280436,chr1-1228651-A-G,rs61744664,1,A,G,1228651,51785,1083828,1477044,144823
1,ENSG00000158825.5,20589097,chr1-20592369-A-G,rs61781231,1,A,G,20592369,3272,20392489,20785705,199880
1,ENSG00000160783.13,156213007,chr1-156049284-G-T,rs61813293,1,G,T,156049284,163723,156016399,156409615,32885
1,ENSG00000160789.14,156114711,chr1-156049284-G-T,rs61813293,1,G,T,156049284,65427,155918103,156311319,131181
1,ENSG00000054277.8,241640369,chr1-241636236-G-A,rs631143,-1,G,A,241636236,4133,241443761,241836977,192475
1,ENSG00000156171.9,111140093,chr1-111185663-T-C,rs641379,-1,T,C,111185663,45570,110943485,111336701,242178
1,ENSG00000143801.12,226870616,chr1-226826177-C-T,rs6426548,1,C,T,226826177,44439,226674008,227067224,152169
1,ENSG00000127472.6,20070194,chr1-20164025-T-C,rs6426616,1,T,C,20164025,93831,19873586,20266802,290439
1,ENSG00000196420.3,153540934,chr1-153704237-C-A,rs6426989,-1,C,A,153704237,163303,153344326,153737542,359911
1,ENSG00000000460.11,169795040,chr1-169744005-A-G,rs6427213,1,A,G,169744005,51035,169598432,169991648,145573
1,ENSG00000000460.11,169795040,chr1-169744005-A-C,rs6427213,1,A,C,169744005,51035,169598432,169991648,145573
1,ENSG00000187147.11,44405255,chr1-44394552-G-A,rs6429539,1,G,A,44394552,10703,44208647,44601863,185905
1,ENSG00000116489.8,112619832,chr1-112675881-T-C,rs6537749,1,T,C,112675881,56049,112423224,112816440,252657
1,ENSG00000163349.15,113929324,chr1-114082051-C-T,rs6537807,1,C,T,114082051,152727,113732716,114125932,349335
1,ENSG00000171608.9,9651731,chr1-9475560-A-G,rs6541069,1,A,G,9475560,176171,9455123,9848339,20437
1,ENSG00000173409.9,230979094,chr1-230943635-A-G,rs6541239,1,A,G,230943635,35459,230782486,231175702,161149
1,ENSG00000162688.11,99850361,chr1-99934201-T-C,rs6577150,1,T,C,99934201,83840,99653753,100046969,280448
1,ENSG00000172456.11,59297094,chr1-59307712-C-G,rs6587853,1,C,G,59307712,10618,59100486,59493702,207226
1,ENSG00000163909.6,39639643,chr1-39828514-A-C,rs6600301,-1,A,C,39828514,188871,39443035,39836251,385479
1,ENSG00000117597.12,209827972,chr1-209827703-A-C,rs660975,1,A,C,209827703,269,209631364,210024580,196339
1,ENSG00000196449.3,37808208,chr1-37741125-A-G,rs663428,-1,A,G,37741125,67083,37611600,38004816,129525
1,ENSG00000118454.8,70354722,chr1-70431500-G-T,rs663649,-1,G,T,70431500,76778,70158114,70551330,273386
1,ENSG00000131236.11,40040729,chr1-40157648-G-C,rs6656984,1,G,C,40157648,116919,39844121,40237337,313527
1,ENSG00000143553.6,153658703,chr1-153490790-A-G,rs6658948,1,A,G,153490790,167913,153462095,153855311,28695
1,ENSG00000162711.12,247416173,chr1-247445495-T-C,rs6659500,1,T,C,247445495,29322,247219565,247612781,225930
1,ENSG00000135845.4,172444069,chr1-172425061-G-A,rs6660051,-1,G,A,172425061,19008,172247461,172640677,177600
1,ENSG00000085552.11,159945613,chr1-159896000-G-A,rs6660528,-1,G,A,159896000,49613,159749005,160142221,146995
1,ENSG00000185519.8,16073651,chr1-16173418-C-T,rs6661012,-1,C,T,16173418,99767,15877043,16270259,296375
1,ENSG00000158711.8,205632011,chr1-205641646-C-T,rs6661827,-1,C,T,205641646,9635,205435403,205828619,206243
1,ENSG00000116459.6,111449464,chr1-111361872-A-G,rs6663292,1,A,G,111361872,87592,111252856,111646072,109016
1,ENSG00000135823.9,181022870,chr1-180980492-C-A,rs6665134,-1,C,A,180980492,42378,180826262,181219478,154230
1,ENSG00000143158.6,167937072,chr1-168122401-G-A,rs6667401,-1,G,A,168122401,185329,167740464,168133680,381937
1,ENSG00000125944.12,23344284,chr1-23264158-A-C,rs667311,-1,A,C,23264158,80126,23147676,23540892,116482
1,ENSG00000125944.12,23344284,chr1-23264158-A-G,rs667311,-1,A,G,23264158,80126,23147676,23540892,116482
1,ENSG00000143443.8,151047751,chr1-151066444-C-T,rs6674232,1,C,T,151066444,18693,150851143,151244359,215301
1,ENSG00000203965.7,63523525,chr1-63549671-T-C,rs6675580,1,T,C,63549671,26146,63326917,63720133,222754
1,ENSG00000162892.11,206897443,chr1-206881987-C-T,rs6677741,1,C,T,206881987,15456,206700835,207094051,181152
1,ENSG00000188931.3,161367876,chr1-161418623-A-C,rs6678315,-1,A,C,161418623,50747,161171268,161564484,247355
1,ENSG00000126106.9,44674481,chr1-44672031-G-A,rs6678831,-1,G,A,44672031,2450,44477873,44871089,194158
1,ENSG00000116991.6,232630133,chr1-232624362-T-C,rs6680892,-1,T,C,232624362,5771,232433525,232826741,190837
1,ENSG00000171517.5,84893206,chr1-84926641-C-T,rs6681025,-1,C,T,84926641,33435,84696598,85089814,230043
1,ENSG00000137936.11,93681837,chr1-93572574-A-C,rs6681200,-1,A,C,93572574,109263,93485229,93878445,87345
1,ENSG00000075391.11,178094104,chr1-178066720-T-A,rs6681729,1,T,A,178066720,27384,177897496,178290712,169224
1,ENSG00000187862.6,156579723,chr1-156582056-A-G,rs6682716,1,A,G,156582056,2333,156383115,156776331,198941
1,ENSG00000181754.6,109509727,chr1-109512589-T-C,rs6684194,-1,T,C,109512589,2862,109313119,109706335,199470
1,ENSG00000235169.3,3772749,chr1-3873250-A-C,rs66849805,1,A,C,3873250,100501,3576141,3969357,297109
1,ENSG00000251503.2,10430435,chr1-10573188-G-A,rs6687430,1,G,A,10573188,142753,10233827,10627043,339361
1,ENSG00000185278.8,173868355,chr1-173899817-C-T,rs6691053,1,C,T,173899817,31462,173671747,174064963,228070
1,ENSG00000185278.8,173868355,chr1-173899817-C-G,rs6691053,1,C,G,173899817,31462,173671747,174064963,228070
1,ENSG00000116852.8,201023714,chr1-201000638-G-A,rs6692235,-1,G,A,201000638,23076,200827106,201220322,173532
1,ENSG00000143401.10,150236112,chr1-150194509-G-A,rs6692738,-1,G,A,150194509,41603,150039504,150432720,155005
1,ENSG00000143458.6,151070761,chr1-151063152-A-C,rs6694357,1,A,C,151063152,7609,150874153,151267369,188999
1,ENSG00000188290.6,1000097,chr1-981454-G-A,rs6694632,-1,G,A,981454,18643,803489,1196705,177965
1,ENSG00000159352.10,151254734,chr1-151206015-G-A,rs6695344,1,G,A,151206015,48719,151058126,151451342,147889
1,ENSG00000136631.7,150067776,chr1-149907993-C-T,rs6696662,1,C,T,149907993,159783,149871168,150264384,36825
1,ENSG00000088035.8,63367627,chr1-63427723-A-G,rs6697508,1,A,G,63427723,60096,63171019,63564235,256704
1,ENSG00000116213.10,3650103,chr1-3654319-C-T,rs6697769,-1,C,T,3654319,4216,3453495,3846711,200824
1,ENSG00000187942.7,21812265,chr1-21917530-C-T,rs6698486,1,C,T,21917530,105265,21615657,22008873,301873
1,ENSG00000185483.6,63774017,chr1-63829061-G-A,rs67716815,1,G,A,63829061,55044,63577409,63970625,251652
1,ENSG00000117481.5,46340807,chr1-46341744-T-G,rs68083747,1,T,G,46341744,937,46144199,46537415,197545
1,ENSG00000196407.6,151853712,chr1-151763100-T-C,rs7007,-1,T,C,151763100,90612,151657104,152050320,105996
1,ENSG00000196878.7,209652425,chr1-209685334-G-A,rs701950,-1,G,A,209685334,32909,209455817,209849033,229517
1,ENSG00000235098.4,1421276,chr1-1237527-C-T,rs715643,-1,C,T,1237527,183749,1224668,1617884,12859
1,ENSG00000169972.7,1308597,chr1-1237527-C-T,rs715643,1,C,T,1237527,71070,1111989,1505205,125538
1,ENSG00000162374.12,50108920,chr1-50185522-T-A,rs71651139,1,T,A,50185522,76602,49912312,50305528,273210
1,ENSG00000162545.5,20486210,chr1-20648675-C-G,rs71653623,-1,C,G,20648675,162465,20289602,20682818,359073
1,ENSG00000162545.5,20486210,chr1-20648675-C-T,rs71653623,-1,C,T,20648675,162465,20289602,20682818,359073
1,ENSG00000189339.7,1692795,chr1-1665581-C-G,rs72634820,-1,C,G,1665581,27214,1496187,1889403,169394
1,ENSG00000187010.13,25272509,chr1-25257119-C-G,rs72660908,1,C,G,25257119,15390,25075901,25469117,181218
1,ENSG00000162695.6,100896090,chr1-100927481-A-G,rs72734259,1,A,G,100927481,31391,100699482,101092698,227999
1,ENSG00000154309.7,222815039,chr1-222883796-C-G,rs72742233,1,C,G,222883796,68757,222618431,223011647,265365
1,ENSG00000143862.3,202144737,chr1-201952641-T-C,rs72744840,-1,T,C,201952641,192096,201948129,202341345,4512
1,ENSG00000079739.9,63593411,chr1-63465140-C-T,rs72918611,1,C,T,63465140,128271,63396803,63790019,68337
1,ENSG00000131791.6,147172470,chr1-147278083-T-C,rs72999651,-1,T,C,147278083,105613,146975862,147369078,302221
1,ENSG00000116977.13,236523982,chr1-236562727-T-G,rs73113088,1,T,G,236562727,38745,236327374,236720590,235353
1,ENSG00000158286.8,6206119,chr1-6162441-C-A,rs731975,1,C,A,6162441,43678,6009511,6402727,152930
1,ENSG00000198860.7,184051730,chr1-184144111-T-C,rs732812,1,T,C,184144111,92381,183855122,184248338,288989
1,ENSG00000049239.7,9234774,chr1-9249687-G-T,rs732950,1,G,T,9249687,14913,9038166,9431382,211521
1,ENSG00000058453.11,16921931,chr1-16892990-G-T,rs74055949,1,G,T,16892990,28941,16725323,17118539,167667
1,ENSG00000162923.10,224434797,chr1-224314264-C-T,rs74793582,-1,C,T,224314264,120533,224238189,224631405,76075
1,ENSG00000162542.8,19799916,chr1-19811628-C-T,rs7513083,-1,C,T,19811628,11712,19603308,19996524,208320
1,ENSG00000154511.6,92961462,chr1-92969168-G-A,rs7517539,-1,G,A,92969168,7706,92764854,93158070,204314
1,ENSG00000117228.8,89065208,chr1-89041299-G-T,rs7519963,-1,G,T,89041299,23909,88868600,89261816,172699
1,ENSG00000186501.8,27322163,chr1-27261682-T-C,rs7521203,1,T,C,27261682,60481,27125555,27518771,136127
1,ENSG00000117480.10,46394317,chr1-46343819-C-T,rs75216726,1,C,T,46343819,50498,46197709,46590925,146110
1,ENSG00000168275.9,234373456,chr1-234375757-A-G,rs7523348,1,A,G,234375757,2301,234176848,234570064,198909
1,ENSG00000143653.8,246724409,chr1-246734832-C-T,rs7526237,1,C,T,246734832,10423,246527801,246921017,207031
1,ENSG00000174371.11,241848204,chr1-241685745-A-G,rs7527828,1,A,G,241685745,162459,241651596,242044812,34149
1,ENSG00000123091.4,51236273,chr1-51093184-C-A,rs7530673,1,C,A,51093184,143089,51039665,51432881,53519
1,ENSG00000143167.7,167090377,chr1-167280843-C-T,rs7532692,-1,C,T,167280843,190466,166893769,167286985,387074
1,ENSG00000130775.11,27872544,chr1-27907814-A-G,rs7536088,1,A,G,27907814,35270,27675936,28069152,231878
1,ENSG00000189334.4,153616325,chr1-153668351-C-T,rs7536700,-1,C,T,153668351,52026,153419717,153812933,248634
1,ENSG00000174574.9,38991276,chr1-38973866-G-A,rs7537437,1,G,A,38973866,17410,38794668,39187884,179198
1,ENSG00000173110.5,161524540,chr1-161542941-G-A,rs7539036,1,G,A,161542941,18401,161327932,161721148,215009
1,ENSG00000143740.9,227735435,chr1-227654042-G-A,rs7539151,1,G,A,227654042,81393,227538827,227932043,115215
1,ENSG00000198520.5,44674714,chr1-44680736-C-T,rs7539312,1,C,T,44680736,6022,44478106,44871322,202630
1,ENSG00000142694.6,36323645,chr1-36203548-T-C,rs7541007,-1,T,C,36203548,120097,36127037,36520253,76511
1,ENSG00000116857.11,201154474,chr1-201156198-T-C,rs7542768,-1,T,C,201156198,1724,200957866,201351082,198332
1,ENSG00000137996.8,100266216,chr1-100243745-A-G,rs7543453,1,A,G,100243745,22471,100069608,100462824,174137
1,ENSG00000204178.5,25430897,chr1-25551001-C-T,rs75446219,1,C,T,25551001,120104,25234289,25627505,316712
1,ENSG00000074800.8,8878686,chr1-8957975-G-A,rs7545200,-1,G,A,8957975,79289,8682078,9075294,275897
1,ENSG00000143149.8,165698562,chr1-165686867-C-T,rs7546215,-1,C,T,165686867,11695,165501954,165895170,184913
1,ENSG00000142657.14,10399064,chr1-10358768-G-A,rs7546368,1,G,A,10358768,40296,10202456,10595672,156312
1,ENSG00000121454.4,180230264,chr1-180281203-T-G,rs75468761,1,T,G,180281203,50939,180033656,180426872,247547
1,ENSG00000076864.12,21669357,chr1-21814537-C-T,rs75506362,-1,C,T,21814537,145180,21472749,21865965,341788
1,ENSG00000133063.11,203229673,chr1-203274985-C-T,rs7551146,-1,C,T,203274985,45312,203033065,203426281,241920
1,ENSG00000222009.4,44808482,chr1-44839438-G-A,rs7554177,1,G,A,44839438,30956,44611874,45005090,227564
1,ENSG00000143344.9,183805120,chr1-183829667-G-A,rs7556229,1,G,A,183829667,24547,183608512,184001728,221155
1,ENSG00000162736.10,160343383,chr1-160406749-T-G,rs75695145,1,T,G,160406749,63366,160146775,160539991,259974
1,ENSG00000162398.7,54806063,chr1-54929419-T-C,rs76181476,1,T,C,54929419,123356,54609455,55002671,319964
1,ENSG00000198892.6,201888898,chr1-201850966-G-A,rs76577526,1,G,A,201850966,37932,201692290,202085506,158676
1,ENSG00000040487.8,19312326,chr1-19392330-G-A,rs7667,1,G,A,19392330,80004,19115718,19508934,276612
1,ENSG00000198691.6,94121148,chr1-94157711-T-G,rs77144892,-1,T,G,94157711,36563,93924540,94317756,233171
1,ENSG00000127054.12,1324660,chr1-1223644-C-T,rs77472198,-1,C,T,1223644,101016,1128052,1521268,95592
1,ENSG00000176022.3,1232237,chr1-1223644-C-T,rs77472198,1,C,T,1223644,8593,1035629,1428845,188015
1,ENSG00000185220.7,248906235,chr1-248736853-G-A,rs77479833,1,G,A,248736853,169382,248709627,249102843,27226
1,ENSG00000248485.1,161258745,chr1-161261431-C-T,rs77515554,1,C,T,161261431,2686,161062137,161455353,199294
1,ENSG00000162694.9,100894842,chr1-100888830-T-C,rs77649301,-1,T,C,100888830,6012,100698234,101091450,190596
1,ENSG00000133055.4,203175826,chr1-203220529-A-G,rs78014816,-1,A,G,203220529,44703,202979218,203372434,241311
1,ENSG00000132781.11,45339970,chr1-45469384-G-C,rs781058,-1,G,C,45469384,129414,45143362,45536578,326022
1,ENSG00000162631.12,107141039,chr1-106979924-T-A,rs78409645,1,T,A,106979924,161115,106944431,107337647,35493
1,ENSG00000143178.7,168280877,chr1-168267380-C-T,rs78458169,1,C,T,168267380,13497,168084269,168477485,183111
1,ENSG00000198837.5,153946718,chr1-153816674-C-A,rs78740769,-1,C,A,153816674,130044,153750110,154143326,66564
1,ENSG00000198198.9,43389899,chr1-43354522-G-A,rs79064184,1,G,A,43354522,35377,43193291,43586507,161231
1,ENSG00000119285.6,236604516,chr1-236708028-G-T,rs79108886,-1,G,T,236708028,103512,236407908,236801124,300120
1,ENSG00000143786.3,224616317,chr1-224763020-C-A,rs79264717,1,C,A,224763020,146703,224419709,224812925,343311
1,ENSG00000064703.7,111755901,chr1-111873300-C-T,rs79330097,1,C,T,111873300,117399,111559293,111952509,314007
1,ENSG00000159214.8,43991599,chr1-43994960-G-C,rs79401056,1,G,C,43994960,3361,43794991,44188207,199969
1,ENSG00000180758.9,9129102,chr1-9010125-C-T,rs79843700,-1,C,T,9010125,118977,8932494,9325710,77631
1,ENSG00000143127.7,145910050,chr1-146014328-G-A,rs79906727,-1,G,A,146014328,104278,145713442,146106658,300886
1,ENSG00000133065.6,205813198,chr1-205828905-G-A,rs823085,-1,G,A,205828905,15707,205616590,206009806,212315
1,ENSG00000117280.8,205775482,chr1-205720679-T-G,rs823094,-1,T,G,205720679,54803,205578874,205972090,141805
1,ENSG00000131779.6,145918717,chr1-145983931-G-C,rs833941,-1,G,C,145983931,65214,145722109,146115325,261822
1,ENSG00000116157.5,52602371,chr1-52598362-G-A,rs835342,1,G,A,52598362,4009,52405763,52798979,192599
1,ENSG00000130770.12,28236124,chr1-28237741-A-G,rs8559,1,A,G,28237741,1617,28039516,28432732,198225
1,ENSG00000163565.14,159009907,chr1-158914729-C-T,rs860637,1,C,T,158914729,95178,158813299,159206515,101430
1,ENSG00000116833.8,200027710,chr1-200149311-C-T,rs871446,1,C,T,200149311,121601,199831102,200224318,318209
1,ENSG00000116981.3,39672107,chr1-39667123-T-G,rs873917,-1,T,G,39667123,4984,39475499,39868715,191624
1,ENSG00000182827.8,226186741,chr1-226348944-C-T,rs874583,-1,C,T,226348944,162203,225990133,226383349,358811
1,ENSG00000117054.8,75724709,chr1-75763435-T-C,rs8763,1,T,C,75763435,38726,75528101,75921317,235334
1,ENSG00000142684.7,26169908,chr1-26170849-A-C,rs8768,1,A,C,26170849,941,25973300,26366516,197549
1,ENSG00000070831.11,22052709,chr1-21900598-T-C,rs878949,1,T,C,21900598,152111,21856101,22249317,44497
1,ENSG00000116661.8,11654429,chr1-11653506-G-A,rs909934,-1,G,A,11653506,923,11457821,11851037,195685
1,ENSG00000179456.8,244051283,chr1-243922508-C-T,rs938565,1,C,T,243922508,128775,243854675,244247891,67833
1,ENSG00000168509.13,146021735,chr1-145968997-G-A,rs9424932,-1,G,A,145968997,52738,145825127,146218343,143870
1,ENSG00000196154.6,153545806,chr1-153741942-C-T,rs9426891,-1,C,T,153741942,196136,153349198,153742414,392744
1,ENSG00000064886.8,111227713,chr1-111248881-G-C,rs942697,1,G,C,111248881,21168,111031105,111424321,217776
1,ENSG00000186510.6,16022036,chr1-16021917-T-C,rs945425,1,T,C,16021917,119,15825428,16218644,196489
1,ENSG00000162814.5,217631344,chr1-217531804-C-G,rs9633500,1,C,G,217531804,99540,217434736,217827952,97068
1,ENSG00000253831.1,157099808,chr1-157100866-G-A,rs9659081,-1,G,A,157100866,1058,156903200,157296416,197666
1,ENSG00000121644.14,244653126,chr1-244775196-T-C,rs9727042,1,T,C,244775196,122070,244456518,244849734,318678
1,ENSG00000137941.11,83999132,chr1-83827947-G-A,rs976457,-1,G,A,83827947,171185,83802524,84195740,25423
1,ENSG00000000457.8,169893896,chr1-169825218-A-G,rs9803860,-1,A,G,169825218,68678,169697288,170090504,127930
1,ENSG00000116679.11,185317243,chr1-185406834-G-T,rs9803977,-1,G,T,185406834,89591,185120635,185513851,286199
1,ENSG00000189171.8,153627505,chr1-153627648-T-C,rs999418,-1,T,C,153627648,143,153430897,153824113,196751
1,ENSG00000171680.14,6491667,chr1-6482270-T-C,rs1002966,-1,T,C,6482270,9397,6295059,6688275,187211
1,ENSG00000158828.5,20633458,chr1-20670847-G-A,rs10157351,1,G,A,20670847,37389,20436850,20830066,233997
1,ENSG00000158828.5,20633458,chr1-20670847-G-T,rs10157351,1,G,T,20670847,37389,20436850,20830066,233997
1,ENSG00000117281.10,145719499,chr1-145679249-T-G,rs10157535,1,T,G,145679249,40250,145522891,145916107,156358
1,ENSG00000143156.9,169367797,chr1-169347372-G-A,rs10158131,-1,G,A,169347372,20425,169171189,169564405,176183
1,ENSG00000143228.8,163321954,chr1-163275703-G-A,rs10158993,1,G,A,163275703,46251,163125346,163518562,150357
1,ENSG00000215910.3,11762193,chr1-11838976-G-T,rs1023252,1,G,T,11838976,76783,11565585,11958801,273391
1,ENSG00000177000.6,11805964,chr1-11838976-G-T,rs1023252,-1,G,T,11838976,33012,11609356,12002572,229620
1,ENSG00000116761.7,70411268,chr1-70455490-G-A,rs10458561,1,G,A,70455490,44222,70214660,70607876,240830
1,ENSG00000143162.7,167553762,chr1-167536658-T-C,rs10489191,-1,T,C,167536658,17104,167357154,167750370,179504
1,ENSG00000085998.9,46198434,chr1-46341925-G-A,rs10489770,-1,G,A,46341925,143491,46001826,46395042,340099
1,ENSG00000116771.5,15585051,chr1-15666843-A-G,rs10492987,-1,A,G,15666843,81792,15388443,15781659,278400
1,ENSG00000162836.6,147670524,chr1-147552273-G-A,rs10494250,-1,G,A,147552273,118251,147473916,147867132,78357
1,ENSG00000116128.5,147541501,chr1-147545166-C-A,rs10494252,1,C,A,147545166,3665,147344893,147738109,200273
1,ENSG00000116128.5,147541501,chr1-147545166-C-T,rs10494252,1,C,T,147545166,3665,147344893,147738109,200273
1,ENSG00000117036.7,157138395,chr1-157148629-T-C,rs10494309,-1,T,C,157148629,10234,156941787,157335003,206842
1,ENSG00000067533.5,218285293,chr1-218342968-G-A,rs10495098,1,G,A,218342968,57675,218088685,218481901,254283
1,ENSG00000067533.5,218285293,chr1-218342968-G-T,rs10495098,1,G,T,218342968,57675,218088685,218481901,254283
1,ENSG00000183814.10,226309164,chr1-226199917-G-C,rs10495244,-1,G,C,226199917,109247,226112556,226505772,87361
1,ENSG00000183814.10,226309164,chr1-226199917-G-A,rs10495244,-1,G,A,226199917,109247,226112556,226505772,87361
1,ENSG00000260238.1,156212982,chr1-156236330-G-A,rs1052067,1,G,A,156236330,23348,156016374,156409590,219956
1,ENSG00000162600.6,58546726,chr1-58576716-C-G,rs1062964,-1,C,G,58576716,29990,58350118,58743334,226598
1,ENSG00000185155.6,226223664,chr1-226073398-G-A,rs10732206,1,G,A,226073398,150266,226027056,226420272,46342
1,ENSG00000116497.13,32817653,chr1-32995270-C-A,rs10737365,1,C,A,32995270,177617,32621045,33014261,374225
1,ENSG00000117228.8,89065208,chr1-89043816-A-G,rs1074541,-1,A,G,89043816,21392,88868600,89261816,175216
1,ENSG00000235169.3,3772749,chr1-3951579-A-G,rs10753364,1,A,G,3951579,178830,3576141,3969357,375438
1,ENSG00000198216.6,181483517,chr1-181560616-T-A,rs10797728,1,T,A,181560616,77099,181286909,181680125,273707
1,ENSG00000143344.9,183805120,chr1-183916882-A-G,rs10797921,1,A,G,183916882,111762,183608512,184001728,308370
1,ENSG00000171488.9,89633120,chr1-89729340-T-C,rs10801772,1,T,C,89729340,96220,89436512,89829728,292828
1,ENSG00000203666.8,244969682,chr1-244998766-T-C,rs10803250,1,T,C,244998766,29084,244773074,245166290,225692
1,ENSG00000156150.5,110070672,chr1-110052906-C-G,rs10857809,-1,C,G,110052906,17766,109874064,110267280,178842
1,ENSG00000156150.5,110070672,chr1-110052906-C-A,rs10857809,-1,C,A,110052906,17766,109874064,110267280,178842
1,ENSG00000066027.4,212285410,chr1-212178127-C-T,rs10863950,1,C,T,212178127,107283,212088802,212482018,89325
1,ENSG00000153936.11,86914635,chr1-86980595-C-T,rs10873807,1,C,T,86980595,65960,86718027,87111243,262568
1,ENSG00000117505.7,93345907,chr1-93409705-C-T,rs10874784,1,C,T,93409705,63798,93149299,93542515,260406
1,ENSG00000131238.10,40097252,chr1-40095799-C-T,rs10889147,-1,C,T,40095799,1453,39900644,40293860,195155
1,ENSG00000079739.9,63593411,chr1-63498228-C-A,rs10889424,1,C,A,63498228,95183,63396803,63790019,101425
1,ENSG00000079277.14,46604268,chr1-46470751-G-A,rs10890401,-1,G,A,46470751,133517,46407660,46800876,63091
1,ENSG00000133059.12,205211702,chr1-205184184-G-A,rs10900462,-1,G,A,205184184,27518,205015094,205408310,169090
1,ENSG00000169442.4,26317958,chr1-26271790-T-C,rs10902728,1,T,C,26271790,46168,26121350,26514566,150440
1,ENSG00000135828.6,182589256,chr1-182460860-C-A,rs10911080,-1,C,A,182460860,128396,182392648,182785864,68212
1,ENSG00000116711.7,186828949,chr1-186729092-A-C,rs10911915,1,A,C,186729092,99857,186632341,187025557,96751
1,ENSG00000116514.11,32964809,chr1-32833221-T-G,rs10914625,-1,T,G,32833221,131588,32768201,33161417,65020
1,ENSG00000158825.5,20589097,chr1-20608886-C-A,rs10916829,1,C,A,20608886,19789,20392489,20785705,216397
1,ENSG00000090686.11,21783149,chr1-21782877-G-A,rs10917042,-1,G,A,21782877,272,21586541,21979757,196336
1,ENSG00000184677.11,22451851,chr1-22382643-T-C,rs10917221,1,T,C,22382643,69208,22255243,22648459,127400
1,ENSG00000143199.11,167914134,chr1-167779148-A-G,rs10918763,-1,A,G,167779148,134986,167717526,168110742,61622
1,ENSG00000162702.5,200410036,chr1-200218376-T-C,rs10919851,-1,T,C,200218376,191660,200213428,200606644,4948
1,ENSG00000143851.11,202160602,chr1-202203466-C-T,rs10920360,-1,C,T,202203466,42864,201963994,202357210,239472
1,ENSG00000162636.10,108560100,chr1-108713513-T-C,rs11102279,1,T,C,108713513,153413,108363492,108756708,350021
1,ENSG00000116299.11,109114115,chr1-109186746-T-C,rs11102951,1,T,C,109186746,72631,108917507,109310723,269239
1,ENSG00000117594.4,209704846,chr1-209611861-G-A,rs11119315,1,G,A,209611861,92985,209508238,209901454,103623
1,ENSG00000117597.12,209827972,chr1-209770144-G-A,rs11119344,1,G,A,209770144,57828,209631364,210024580,138780
1,ENSG00000177674.10,11736136,chr1-11740421-T-G,rs11121816,1,T,G,11740421,4285,11539528,11932744,200893
1,ENSG00000175206.6,11847783,chr1-11800063-T-C,rs11121832,-1,T,C,11800063,47720,11651175,12044391,148888
1,ENSG00000174514.8,205569014,chr1-205637044-A-G,rs1114126,1,A,G,205637044,68030,205372406,205765622,264638
1,ENSG00000163131.5,150765778,chr1-150614664-T-G,rs11204680,-1,T,G,150614664,151114,150569170,150962386,45494
1,ENSG00000143443.8,151047751,chr1-151178381-T-C,rs11204785,1,T,C,151178381,130630,150851143,151244359,327238
1,ENSG00000143442.16,151459494,chr1-151584655-T-C,rs11204853,-1,T,C,151584655,125161,151262886,151656102,321769
1,ENSG00000123091.4,51236273,chr1-51166212-C-T,rs11205821,1,C,T,51166212,70061,51039665,51432881,126547
1,ENSG00000182183.10,52633168,chr1-52636461-G-A,rs11205983,1,G,A,52636461,3293,52436560,52829776,199901
1,ENSG00000121310.11,52921740,chr1-52794278-G-T,rs11206019,-1,G,T,52794278,127462,52725132,53118348,69146
1,ENSG00000116985.6,39788865,chr1-39750562-A-G,rs11206754,-1,A,G,39750562,38303,39592257,39985473,158305
1,ENSG00000179862.5,40862363,chr1-40860129-G-A,rs11209041,-1,G,A,40860129,2234,40665755,41058971,194374
1,ENSG00000162620.10,74198176,chr1-74238829-T-C,rs11210443,-1,T,C,74238829,40653,74001568,74394784,237261
1,ENSG00000162620.10,74198176,chr1-74238829-T-A,rs11210443,-1,T,A,74238829,40653,74001568,74394784,237261
1,ENSG00000142949.12,43530883,chr1-43634413-G-A,rs11210892,1,G,A,43634413,103530,43334275,43727491,300138
1,ENSG00000117408.5,43946950,chr1-44075615-G-A,rs11210950,1,G,A,44075615,128665,43750342,44143558,325273
1,ENSG00000117419.9,44355257,chr1-44333927-G-A,rs11210983,-1,G,A,44333927,21330,44158649,44551865,175278
1,ENSG00000126106.9,44674481,chr1-44657463-C-A,rs11211021,-1,C,A,44657463,17018,44477873,44871089,179590
1,ENSG00000222009.4,44808482,chr1-44814141-T-C,rs11211038,1,T,C,44814141,5659,44611874,45005090,202267
1,ENSG00000133065.6,205813198,chr1-205838885-C-A,rs11240572,-1,C,A,205838885,25687,205616590,206009806,222295
1,ENSG00000049245.8,7771296,chr1-7694591-G-T,rs112434103,1,G,T,7694591,76705,7574688,7967904,119903
1,ENSG00000130775.11,27872544,chr1-27775196-A-G,rs11247683,1,A,G,27775196,97348,27675936,28069152,99260
1,ENSG00000037637.6,16352480,chr1-16159316-C-T,rs11260822,-1,C,T,16159316,193164,16155872,16549088,3444
1,ENSG00000169991.5,18956676,chr1-18790806-G-T,rs11261069,-1,G,T,18790806,165870,18760068,19153284,30738
1,ENSG00000169991.5,18956676,chr1-18790806-G-C,rs11261069,-1,G,C,18790806,165870,18760068,19153284,30738
1,ENSG00000132688.9,156677407,chr1-156856782-G-T,rs11264574,-1,G,T,156856782,179375,156480799,156874015,375983
1,ENSG00000143224.11,161166426,chr1-161163031-C-A,rs1127525,1,C,A,161163031,3395,160969818,161363034,193213
1,ENSG00000158195.6,27490167,chr1-27550907-G-A,rs113173951,-1,G,A,27550907,60740,27293559,27686775,257348
1,ENSG00000118217.5,161766320,chr1-161958981-G-A,rs1136046,1,G,A,161958981,192661,161569712,161962928,389269
1,ENSG00000169231.8,155207897,chr1-155260340-C-T,rs1142287,-1,C,T,155260340,52443,155011289,155404505,249051
1,ENSG00000188672.10,25420825,chr1-25381201-C-A,rs114311594,-1,C,A,25381201,39624,25224217,25617433,156984
1,ENSG00000123473.10,47314147,chr1-47494407-G-C,rs114369124,-1,G,C,47494407,180260,47117539,47510755,376868
1,ENSG00000175984.8,114670049,chr1-114552458-C-A,rs114506551,-1,C,A,114552458,117591,114473441,114866657,79017
1,ENSG00000186891.9,1206592,chr1-1206007-C-T,rs11466681,-1,C,T,1206007,585,1009984,1403200,196023
1,ENSG00000168509.13,146021735,chr1-145973322-T-C,rs114711577,-1,T,C,145973322,48413,145825127,146218343,148195
1,ENSG00000183598.3,149813693,chr1-149926400-A-G,rs115070660,-1,A,G,149926400,112707,149617085,150010301,309315
1,ENSG00000203852.3,149852608,chr1-149926400-A-G,rs115070660,1,A,G,149926400,73792,149656000,150049216,270400
1,ENSG00000203811.1,149841208,chr1-149926400-A-G,rs115070660,-1,A,G,149926400,85192,149644600,150037816,281800
1,ENSG00000189339.7,1692795,chr1-1671797-G-A,rs11523819,-1,G,A,1671797,20998,1496187,1889403,175610
1,ENSG00000169418.7,153678688,chr1-153613715-G-A,rs115270699,1,G,A,153613715,64973,153482080,153875296,131635
1,ENSG00000137965.6,78649831,chr1-78641282-C-T,rs11577394,1,C,T,78641282,8549,78453223,78846439,188059
1,ENSG00000162946.14,231626790,chr1-231697972-T-C,rs11585959,1,T,C,231697972,71182,231430182,231823398,267790
1,ENSG00000181773.6,27392622,chr1-27339887-G-A,rs11587965,1,G,A,27339887,52735,27196014,27589230,143873
1,ENSG00000239887.3,162381728,chr1-162476071-A-G,rs116408421,1,A,G,162476071,94343,162185120,162578336,290951
1,ENSG00000119285.6,236604516,chr1-236496235-C-T,rs116412151,-1,C,T,236496235,108281,236407908,236801124,88327
1,ENSG00000162551.9,21509423,chr1-21672944-T-C,rs116413838,1,T,C,21672944,163521,21312815,21706031,360129
1,ENSG00000130695.8,26234200,chr1-26076202-G-A,rs116676637,1,G,A,26076202,157998,26037592,26430808,38610
1,ENSG00000203705.5,212791894,chr1-212721236-C-T,rs11800991,1,C,T,212721236,70658,212595286,212988502,125950
1,ENSG00000134184.7,109687817,chr1-109718120-T-C,rs11807,1,T,C,109718120,30303,109491209,109884425,226911
1,ENSG00000118200.10,200738893,chr1-200623167-C-T,rs11807125,1,C,T,200623167,115726,200542285,200935501,80882
1,ENSG00000122482.15,91022035,chr1-90916122-G-A,rs1188952,-1,G,A,90916122,105913,90825427,91218643,90695
1,ENSG00000162746.10,161721563,chr1-161739421-A-G,rs12021510,1,A,G,161739421,17858,161524955,161918171,214466
1,ENSG00000160058.13,32394441,chr1-32485035-C-T,rs12023137,-1,C,T,32485035,90594,32197833,32591049,287202
1,ENSG00000143643.8,230978861,chr1-230885125-A-G,rs1202601,-1,A,G,230885125,93736,230782253,231175469,102872
1,ENSG00000158715.5,205680509,chr1-205501636-C-T,rs12034971,-1,C,T,205501636,178873,205483901,205877117,17735
1,ENSG00000117266.10,205504669,chr1-205572387-C-A,rs12035608,1,C,A,205572387,67718,205308061,205701277,264326
1,ENSG00000154429.6,229343047,chr1-229381508-T-G,rs12040086,-1,T,G,229381508,38461,229146439,229539655,235069
1,ENSG00000177628.8,155241249,chr1-155437305-C-T,rs12041534,-1,C,T,155437305,196056,155044641,155437857,392664
1,ENSG00000171824.9,11099869,chr1-10920244-G-A,rs12046400,-1,G,A,10920244,179625,10903261,11296477,16983
1,ENSG00000159166.9,201399324,chr1-201409360-G-A,rs12048410,-1,G,A,201409360,10036,201202716,201595932,206644
1,ENSG00000214114.4,38873348,chr1-38921118-C-G,rs12061842,-1,C,G,38921118,47770,38676740,39069956,244378
1,ENSG00000010165.13,171781660,chr1-171680362-C-G,rs12063563,1,C,G,171680362,101298,171585052,171978268,95310
1,ENSG00000162897.9,206970460,chr1-206971274-T-C,rs12066378,-1,T,C,206971274,814,206773852,207167068,197422
1,ENSG00000215912.6,2801717,chr1-2825926-A-G,rs12071313,-1,A,G,2825926,24209,2605109,2998325,220817
1,ENSG00000134369.10,201648249,chr1-201756317-G-A,rs12073345,1,G,A,201756317,108068,201451641,201844857,304676
1,ENSG00000175756.8,1375207,chr1-1269775-A-C,rs12073590,-1,A,C,1269775,105432,1178599,1571815,91176
1,ENSG00000198754.4,39771348,chr1-39738050-T-C,rs12074147,-1,T,C,39738050,33298,39574740,39967956,163310
1,ENSG00000171502.10,86156772,chr1-86003852-A-G,rs12079919,-1,A,G,86003852,152920,85960164,86353380,43688
1,ENSG00000142669.8,26280086,chr1-26384008-C-A,rs12084041,1,C,A,26384008,103922,26083478,26476694,300530
1,ENSG00000143341.7,185734391,chr1-185851620-G-A,rs1208452,1,G,A,185851620,117229,185537783,185930999,313837
1,ENSG00000117519.11,94927110,chr1-94961692-T-C,rs12092678,-1,T,C,94961692,34582,94730502,95123718,231190
1,ENSG00000242485.1,1407293,chr1-1243545-G-A,rs12093154,-1,G,A,1243545,163748,1210685,1603901,32860
1,ENSG00000054267.15,235328179,chr1-235221523-G-A,rs12117563,-1,G,A,235221523,106656,235131571,235524787,89952
1,ENSG00000143537.8,155051316,chr1-155125086-C-G,rs12119678,1,C,G,155125086,73770,154854708,155247924,270378
1,ENSG00000162378.8,52726453,chr1-52587287-C-A,rs12120268,1,C,A,52587287,139166,52529845,52923061,57442
1,ENSG00000119280.12,230868521,chr1-230823931-T-C,rs12121390,-1,T,C,230823931,44590,230671913,231065129,152018
1,ENSG00000043514.9,39883504,chr1-39837955-C-T,rs12123609,-1,C,T,39837955,45549,39686896,40080112,151059
1,ENSG00000054523.11,10210570,chr1-10361820-A-G,rs12125492,1,A,G,10361820,151250,10013962,10407178,347858
1,ENSG00000171357.5,46203334,chr1-46214438-C-A,rs12126187,1,C,A,46214438,11104,46006726,46399942,207712
1,ENSG00000117000.6,40161387,chr1-40015112-C-T,rs12127899,1,C,T,40015112,146275,39964779,40357995,50333
1,ENSG00000054277.8,241640369,chr1-241653927-C-A,rs12130136,-1,C,A,241653927,13558,241443761,241836977,210166
1,ENSG00000243480.3,103617427,chr1-103570536-C-T,rs12132911,1,C,T,103570536,46891,103420819,103814035,149717
1,ENSG00000187733.6,103749898,chr1-103570536-C-T,rs12132911,1,C,T,103570536,179362,103553290,103946506,17246
1,ENSG00000143499.9,214281159,chr1-214156523-G-A,rs12135339,1,G,A,214156523,124636,214084551,214477767,71972
1,ENSG00000142684.7,26169908,chr1-26193801-G-T,rs12138368,1,G,T,26193801,23893,25973300,26366516,220501
1,ENSG00000143476.12,212035748,chr1-212186740-A-G,rs12139134,1,A,G,212186740,150992,211839140,212232356,347600
1,ENSG00000156869.7,99766635,chr1-99711970-G-A,rs12141159,-1,G,A,99711970,54665,99570027,99963243,141943
1,ENSG00000225828.1,32362485,chr1-32508317-G-A,rs12142700,-1,G,A,32508317,145832,32165877,32559093,342440
1,ENSG00000169641.9,23177808,chr1-23230924-T-A,rs12143690,-1,T,A,23230924,53116,22981200,23374416,249724
1,ENSG00000173614.9,9943475,chr1-9943262-G-A,rs1234694,1,G,A,9943262,213,9746867,10140083,196395
1,ENSG00000137968.11,75611114,chr1-75450141-G-A,rs12402118,-1,G,A,75450141,160973,75414506,75807722,35635
1,ENSG00000143149.8,165698562,chr1-165698544-T-G,rs12408101,-1,T,G,165698544,18,165501954,165895170,196590
1,ENSG00000173947.9,111346622,chr1-111292362-T-C,rs12410848,1,T,C,111292362,54260,111150014,111543230,142348
1,ENSG00000184022.2,248597700,chr1-248779833-T-C,rs12563983,-1,T,C,248779833,182133,248401092,248794308,378741
1,ENSG00000212916.3,232805416,chr1-232805608-G-T,rs12567597,1,G,T,232805608,192,232608808,233002024,196800
1,ENSG00000162496.4,12618210,chr1-12547102-G-T,rs12568438,-1,G,T,12547102,71108,12421602,12814818,125500
1,ENSG00000187801.9,40450476,chr1-40449693-T-C,rs12727226,1,T,C,40449693,783,40253868,40647084,195825
1,ENSG00000162714.7,247331867,chr1-247428873-C-T,rs12728998,-1,C,T,247428873,97006,247135259,247528475,293614
1,ENSG00000156875.9,100038095,chr1-99900293-G-A,rs12734255,1,G,A,99900293,137802,99841487,100234703,58806
1,ENSG00000135823.9,181022870,chr1-180971776-G-A,rs12740112,-1,G,A,180971776,51094,180826262,181219478,145514
1,ENSG00000162437.10,64745095,chr1-64653226-C-T,rs12742304,1,C,T,64653226,91869,64548487,64941703,104739
1,ENSG00000092607.8,118988343,chr1-118983165-G-A,rs12742627,-1,G,A,118983165,5178,118791735,119184951,191430
1,ENSG00000163041.5,226062716,chr1-225968409-G-A,rs12743653,1,G,A,225968409,94307,225866108,226259324,102301
1,ENSG00000157184.5,53196824,chr1-53316868-C-T,rs1288475,1,C,T,53316868,120044,53000216,53393432,316652
1,ENSG00000157193.10,53328070,chr1-53486468-G-A,rs1288617,-1,G,A,53486468,158398,53131462,53524678,355006
1,ENSG00000116830.5,117060326,chr1-117113466-A-G,rs1289658,1,A,G,117113466,53140,116863718,117256934,249748
1,ENSG00000196407.6,151853712,chr1-151707120-G-A,rs1308153,-1,G,A,151707120,146592,151657104,152050320,50016
1,ENSG00000143614.7,153922972,chr1-153809781-G-A,rs13375579,-1,G,A,153809781,113191,153726364,154119580,83417
1,ENSG00000132185.12,161707229,chr1-161691699-C-A,rs1340976,1,C,A,161691699,15530,161510621,161903837,181078
1,ENSG00000243725.1,54715861,chr1-54641346-G-A,rs1368882,1,G,A,54641346,74515,54519253,54912469,122093
1,ENSG00000014914.14,149936879,chr1-149899512-G-T,rs1376676,-1,G,T,149899512,37367,149740271,150133487,159241
1,ENSG00000117174.6,85708433,chr1-85570890-G-C,rs1378228,-1,G,C,85570890,137543,85511825,85905041,59065
1,ENSG00000117174.6,85708433,chr1-85570890-G-T,rs1378228,-1,G,T,85570890,137543,85511825,85905041,59065
1,ENSG00000197747.4,151993859,chr1-151982416-T-C,rs1387835,-1,T,C,151982416,11443,151797251,152190467,185165
1,ENSG00000134375.6,201955503,chr1-201922126-C-A,rs1390398,1,C,A,201922126,33377,201758895,202152111,163231
1,ENSG00000177272.7,110674940,chr1-110535950-T-C,rs1419293,-1,T,C,110535950,138990,110478332,110871548,57618
1,ENSG00000171385.5,111989668,chr1-112101158-T-A,rs1440176,-1,T,A,112101158,111490,111793060,112186276,308098
1,ENSG00000162542.8,19799916,chr1-19753817-C-T,rs1473689,-1,C,T,19753817,46099,19603308,19996524,150509
1,ENSG00000162607.8,62437049,chr1-62382442-C-T,rs1473752,1,C,T,62382442,54607,62240441,62633657,142001
1,ENSG00000196449.3,37808208,chr1-37954960-C-T,rs1480343,-1,C,T,37954960,146752,37611600,38004816,343360
1,ENSG00000160075.9,1574863,chr1-1450709-C-T,rs149262155,-1,C,T,1450709,124154,1378255,1771471,72454
1,ENSG00000197622.7,151059622,chr1-151037243-A-G,rs1534059,-1,A,G,151037243,22379,150863014,151256230,174229
1,ENSG00000171517.5,84893206,chr1-84916424-G-A,rs1536120,-1,G,A,84916424,23218,84696598,85089814,219826
1,ENSG00000116141.10,220528136,chr1-220420927-C-T,rs1538419,1,C,T,220420927,107209,220331528,220724744,89399
1,ENSG00000162688.11,99850361,chr1-99965164-G-A,rs1541042,1,G,A,99965164,114803,99653753,100046969,311411
1,ENSG00000125945.9,23369836,chr1-23560714-T-C,rs1555026,-1,T,C,23560714,190878,23173228,23566444,387486
1,ENSG00000069702.6,91886151,chr1-91695329-T-C,rs1555890,-1,T,C,91695329,190822,91689543,92082759,5786
1,ENSG00000174529.6,205084460,chr1-205075959-G-A,rs1572993,-1,G,A,205075959,8501,204887852,205281068,188107
1,ENSG00000117586.5,173207331,chr1-173399532-C-T,rs1578624,-1,C,T,173399532,192201,173010723,173403939,388809
1,ENSG00000011007.7,23743471,chr1-23670705-T-C,rs1579047,1,T,C,23670705,72766,23546863,23940079,123842
1,ENSG00000117090.8,160647044,chr1-160620975-C-T,rs164283,-1,C,T,160620975,26069,160450436,160843652,170539
1,ENSG00000121851.8,145964690,chr1-145979299-A-G,rs16827280,1,A,G,145979299,14609,145768082,146161298,211217
1,ENSG00000142937.7,44775540,chr1-44743989-A-G,rs16832210,1,A,G,44743989,31551,44578932,44972148,165057
1,ENSG00000158887.11,161309968,chr1-161363458-G-T,rs16832859,-1,G,T,161363458,53490,161113360,161506576,250098
1,ENSG00000116962.10,236065090,chr1-235999149-C-T,rs16833089,-1,C,T,235999149,65941,235868482,236261698,130667
1,ENSG00000142910.9,31576515,chr1-31510359-G-A,rs16834529,1,G,A,31510359,66156,31379907,31773123,130452
1,ENSG00000025800.8,32108056,chr1-32000730-C-T,rs16834799,1,C,T,32000730,107326,31911448,32304664,89282
1,ENSG00000142920.11,33081153,chr1-33220797-G-A,rs16835313,1,G,A,33220797,139644,32884545,33277761,336252
1,ENSG00000143624.9,153728050,chr1-153558806-C-G,rs16835437,1,C,G,153558806,169244,153531442,153924658,27364
1,ENSG00000163348.3,154961782,chr1-154810975-T-G,rs16836395,-1,T,G,154810975,150807,154765174,155158390,45801
1,ENSG00000163565.14,159009907,chr1-158839399-T-C,rs16841142,1,T,C,158839399,170508,158813299,159206515,26100
1,ENSG00000163554.6,158686715,chr1-158839791-A-G,rs16841144,-1,A,G,158839791,153076,158490107,158883323,349684
1,ENSG00000176393.6,201982648,chr1-202007900-T-C,rs16849558,1,T,C,202007900,25252,201786040,202179256,221860
1,ENSG00000162779.14,179365971,chr1-179394140-C-A,rs16854064,1,C,A,179394140,28169,179169363,179562579,224777
1,ENSG00000152382.5,166876264,chr1-166861054-G-A,rs16858144,-1,G,A,166861054,15210,166679656,167072872,181398
1,ENSG00000067704.8,220094132,chr1-220115616-A-C,rs17007135,1,A,C,220115616,21484,219897524,220290740,218092
1,ENSG00000117691.5,212432920,chr1-212445955-G-A,rs17019084,1,G,A,212445955,13035,212236312,212629528,209643
1,ENSG00000162772.12,212608761,chr1-212599595-T-C,rs17019438,1,T,C,212599595,9166,212412153,212805369,187442
1,ENSG00000203710.5,207496157,chr1-207631132-C-A,rs17048122,1,C,A,207631132,134975,207299549,207692765,331583
1,ENSG00000162374.12,50108920,chr1-50203286-T-C,rs17106016,1,T,C,50203286,94366,49912312,50305528,290974
1,ENSG00000117151.7,84574440,chr1-84512749-T-C,rs17110590,-1,T,C,84512749,61691,84377832,84771048,134917
1,ENSG00000188641.8,97921034,chr1-97764035-C-T,rs17117118,-1,C,T,97764035,156999,97724426,98117642,39609
1,ENSG00000081985.6,67307873,chr1-67320405-A-G,rs17129772,1,A,G,67320405,12532,67111265,67504481,209140
1,ENSG00000130768.8,27935000,chr1-27893973-C-A,rs17257252,1,C,A,27893973,41027,27738392,28131608,155581
1,ENSG00000116157.5,52602371,chr1-52579768-G-A,rs17365357,1,G,A,52579768,22603,52405763,52798979,174005
1,ENSG00000169598.10,3857476,chr1-3703616-A-T,rs17379833,1,A,T,3703616,153860,3660868,4054084,42748
1,ENSG00000242252.1,156242184,chr1-156409352-G-A,rs17383726,1,G,A,156409352,167168,156045576,156438792,363776
1,ENSG00000142794.11,21440137,chr1-21467568-C-T,rs17420195,1,C,T,21467568,27431,21243529,21636745,224039
1,ENSG00000143498.12,222589933,chr1-222650187-A-C,rs17465637,-1,A,C,222650187,60254,222393325,222786541,256862
1,ENSG00000158315.6,38941830,chr1-38779825-T-C,rs17485749,-1,T,C,38779825,162005,38745222,39138438,34603
1,ENSG00000117479.7,169485944,chr1-169482852-G-A,rs17518769,-1,G,A,169482852,3092,169289336,169682552,193516
1,ENSG00000154305.11,222618097,chr1-222674564-T-G,rs17531580,1,T,G,222674564,56467,222421489,222814705,253075
1,ENSG00000143333.6,182604389,chr1-182647001-G-T,rs1758779,-1,G,T,182647001,42612,182407781,182800997,239220
1,ENSG00000085433.11,109042102,chr1-109186705-G-C,rs17642754,-1,G,C,109186705,144603,108845494,109238710,341211
1,ENSG00000162777.12,111200646,chr1-111257063-A-G,rs17654531,-1,A,G,111257063,56417,111004038,111397254,253025
1,ENSG00000153898.8,84997113,chr1-85091108-G-A,rs1770691,-1,G,A,85091108,93995,84800505,85193721,290603
1,ENSG00000169962.4,1331280,chr1-1322213-A-G,rs1810745,1,A,G,1322213,9067,1134672,1527888,187541
1,ENSG00000133069.10,205227946,chr1-205357695-T-C,rs1857507,1,T,C,205357695,129749,205031338,205424554,326357
1,ENSG00000086619.9,236281958,chr1-236153275-A-C,rs1885018,-1,A,C,236153275,128683,236085350,236478566,67925
1,ENSG00000162734.8,160205384,chr1-160343943-C-A,rs1886417,1,C,A,160343943,138559,160008776,160401992,335167
1,ENSG00000197084.3,152806651,chr1-152780320-A-G,rs1888962,-1,A,G,152780320,26331,152610043,153003259,170277
1,ENSG00000132122.6,48472204,chr1-48606963-T-C,rs191189,-1,T,C,48606963,134759,48275596,48668812,331367
1,ENSG00000186226.7,152786257,chr1-152752340-T-C,rs1953057,1,T,C,152752340,33917,152589649,152982865,162691
1,ENSG00000170989.7,101237019,chr1-101215912-A-C,rs1999134,1,A,C,101215912,21107,101040411,101433627,175501
1,ENSG00000090432.5,20508151,chr1-20531137-G-A,rs2000366,-1,G,A,20531137,22986,20311543,20704759,219594
1,ENSG00000196754.5,153565844,chr1-153565973-C-T,rs2071576,-1,C,T,153565973,129,153369236,153762452,196737
1,ENSG00000117602.6,24502836,chr1-24401188-C-T,rs2078445,1,C,T,24401188,101648,24306228,24699444,94960
1,ENSG00000040487.8,19312326,chr1-19431243-C-T,rs2088829,1,C,T,19431243,118917,19115718,19508934,315525
1,ENSG00000173110.5,161524540,chr1-161530340-A-G,rs2099684,1,A,G,161530340,5800,161327932,161721148,202408
1,ENSG00000127423.6,25859457,chr1-25855791-T-C,rs213644,-1,T,C,25855791,3666,25662849,26056065,192942
1,ENSG00000120332.10,175067833,chr1-175180412-G-A,rs2179036,1,G,A,175180412,112579,174871225,175264441,309187
1,ENSG00000116459.6,111449464,chr1-111348570-C-A,rs2184884,1,C,A,111348570,100894,111252856,111646072,95714
1,ENSG00000158109.9,3625015,chr1-3659496-T-C,rs2224718,1,T,C,3659496,34481,3428407,3821623,231089
1,ENSG00000053371.8,19312144,chr1-19311815-A-G,rs2227295,-1,A,G,19311815,329,19115536,19508752,196279
1,ENSG00000162482.4,19288770,chr1-19311815-A-G,rs2227295,-1,A,G,19311815,23045,19092162,19485378,219653
1,ENSG00000196878.7,209652425,chr1-209625860-A-G,rs2229465,-1,A,G,209625860,26565,209455817,209849033,170043
1,ENSG00000169885.5,1915260,chr1-1757725-C-T,rs2235536,1,C,T,1757725,157535,1718652,2111868,39073
1,ENSG00000187815.5,40477290,chr1-40417423-C-T,rs2235701,1,C,T,40417423,59867,40280682,40673898,136741
1,ENSG00000084070.6,40373727,chr1-40417460-A-G,rs2235702,1,A,G,40417460,43733,40177119,40570335,240341
1,ENSG00000134717.13,52056295,chr1-51910005-T-C,rs2244156,1,T,C,51910005,146290,51859687,52252903,50318
1,ENSG00000135821.10,182391790,chr1-182343622-C-T,rs2246475,-1,C,T,182343622,48168,182195182,182588398,148440
1,ENSG00000085552.11,159945613,chr1-159953169-C-T,rs2249707,-1,C,T,159953169,7556,159749005,160142221,204164
1,ENSG00000143850.6,204359929,chr1-204490400-C-T,rs2271417,-1,C,T,204490400,130471,204163321,204556537,327079
1,ENSG00000116863.8,36088892,chr1-36084063-G-A,rs2274122,1,G,A,36084063,4829,35892284,36285500,191779
1,ENSG00000143847.10,203026491,chr1-203067629-T-C,rs2275354,1,T,C,203067629,41138,202829883,203223099,237746
1,ENSG00000153029.10,181033983,chr1-181096671-G-A,rs2275470,1,G,A,181096671,62688,180837375,181230591,259296
1,ENSG00000143314.8,156741088,chr1-156648176-G-A,rs2277873,-1,G,A,156648176,92912,156544480,156937696,103696
1,ENSG00000116288.8,7961711,chr1-7851039-C-T,rs228651,1,C,T,7851039,110672,7765103,8158319,85936
1,ENSG00000162517.8,31644876,chr1-31670172-A-G,rs2292989,-1,A,G,31670172,25296,31448268,31841484,221904
1,ENSG00000142623.8,17205128,chr1-17205087-G-A,rs2293910,1,G,A,17205087,41,17008520,17401736,196567
1,ENSG00000116663.6,11664200,chr1-11661797-C-T,rs2294641,1,C,T,11661797,2403,11467592,11860808,194205
1,ENSG00000158286.8,6206119,chr1-6212753-C-T,rs2294711,1,C,T,6212753,6634,6009511,6402727,203242
1,ENSG00000158769.11,161021152,chr1-161013879-T-G,rs2481082,-1,T,G,161013879,7273,160824544,161217760,189335
1,ENSG00000134245.12,112508965,chr1-112408537-A-G,rs2492510,1,A,G,112408537,100428,112312357,112705573,96180
1,ENSG00000117305.8,23825429,chr1-23912588-T-A,rs2501415,-1,T,A,23912588,87159,23628821,24022037,283767
1,ENSG00000117305.8,23825429,chr1-23912588-T-G,rs2501415,-1,T,G,23912588,87159,23628821,24022037,283767
1,ENSG00000188822.6,23913362,chr1-23937754-C-A,rs2501430,-1,C,A,23937754,24392,23716754,24109970,221000
1,ENSG00000188931.3,161367876,chr1-161265175-G-A,rs2501879,-1,G,A,161265175,102701,161171268,161564484,93907
1,ENSG00000020633.13,24930276,chr1-25112958-A-G,rs2660358,-1,A,G,25112958,182682,24733668,25126884,379290
1,ENSG00000152332.11,162497818,chr1-162350216-G-A,rs2661814,1,G,A,162350216,147602,162301210,162694426,49006
1,ENSG00000143458.6,151070761,chr1-150966140-G-A,rs267739,1,G,A,150966140,104621,150874153,151267369,91987
1,ENSG00000059588.5,234479179,chr1-234465173-G-A,rs270505,-1,G,A,234465173,14006,234282571,234675787,182602
1,ENSG00000142694.6,36323645,chr1-36158970-G-T,rs272831,-1,G,T,36158970,164675,36127037,36520253,31933
1,ENSG00000117632.16,25906419,chr1-26031165-C-A,rs2736831,-1,C,A,26031165,124746,25709811,26103027,321354
1,ENSG00000116213.10,3650103,chr1-3631572-T-C,rs2760321,-1,T,C,3631572,18531,3453495,3846711,178077
1,ENSG00000197721.11,207645133,chr1-207736713-C-T,rs2761429,1,C,T,207736713,91580,207448525,207841741,288188
1,ENSG00000160781.9,156248056,chr1-156365320-T-C,rs2764406,-1,T,C,156365320,117264,156051448,156444664,313872
1,ENSG00000162769.7,212858275,chr1-212865033-G-A,rs2792561,1,G,A,212865033,6758,212661667,213054883,203366
1,ENSG00000117335.13,207752054,chr1-207863631-C-T,rs2796247,1,C,T,207863631,111577,207555446,207948662,308185
1,ENSG00000116473.10,111619789,chr1-111591288-C-T,rs2800881,1,C,T,111591288,28501,111423181,111816397,168107
1,ENSG00000162664.10,89995110,chr1-89874110-A-G,rs2802031,1,A,G,89874110,121000,89798502,90191718,75608
1,ENSG00000162892.11,206897443,chr1-207014862-G-A,rs2842721,1,G,A,207014862,117419,206700835,207094051,314027
1,ENSG00000116809.6,15976101,chr1-16090531-G-A,rs28429281,-1,G,A,16090531,114430,15779493,16172709,311038
1,ENSG00000149527.10,2476289,chr1-2645520-C-T,rs28547181,1,C,T,2645520,169231,2279681,2672897,365839
1,ENSG00000142632.10,16212652,chr1-16234684-C-T,rs2863845,-1,C,T,16234684,22032,16016044,16409260,218640
1,ENSG00000074800.8,8878686,chr1-8998487-G-A,rs2895997,-1,G,A,8998487,119801,8682078,9075294,316409
1,ENSG00000143155.8,168178962,chr1-168148628-A-G,rs2902569,1,A,G,168148628,30334,167982354,168375570,166274
1,ENSG00000117697.10,212791777,chr1-212799988-T-C,rs2940085,-1,T,C,212799988,8211,212595169,212988385,204819
1,ENSG00000175087.5,26111824,chr1-26074840-A-G,rs3008230,1,A,G,26074840,36984,25915216,26308432,159624
1,ENSG00000117411.12,43979210,chr1-43859737-G-A,rs3011227,1,G,A,43859737,119473,43782602,44175818,77135
1,ENSG00000091483.6,241519755,chr1-241468507-C-T,rs3014578,-1,C,T,241468507,51248,241323147,241716363,145360
1,ENSG00000075151.13,21176897,chr1-21255486-C-A,rs3026883,-1,C,A,21255486,78589,20980289,21373505,275197
1,ENSG00000035687.8,244451909,chr1-244414256-G-A,rs3101468,-1,G,A,244414256,37653,244255301,244648517,158955
1,ENSG00000142676.8,23691806,chr1-23522655-C-T,rs3218162,1,C,T,23522655,169151,23495198,23888414,27457
1,ENSG00000088280.11,23484179,chr1-23519471-A-C,rs3218173,-1,A,C,23519471,35292,23287571,23680787,231900
1,ENSG00000186603.4,45326895,chr1-45330682-G-T,rs3219492,1,G,T,45330682,3787,45130287,45523503,200395
1,ENSG00000158869.6,161215295,chr1-161198214-C-T,rs33941127,1,C,T,161198214,17081,161018687,161411903,179527
1,ENSG00000054392.8,210328902,chr1-210360084-T-G,rs34326582,1,T,G,210360084,31182,210132294,210525510,227790
1,ENSG00000134668.7,31816022,chr1-31794190-C-G,rs34341430,-1,C,G,31794190,21832,31619414,32012630,174776
1,ENSG00000134668.7,31816022,chr1-31794190-C-T,rs34341430,-1,C,T,31794190,21832,31619414,32012630,174776
1,ENSG00000090104.6,192575773,chr1-192597217-G-C,rs34558449,1,G,C,192597217,21444,192379165,192772381,218052
1,ENSG00000127074.10,192636147,chr1-192597217-G-C,rs34558449,1,G,C,192597217,38930,192439539,192832755,157678
1,ENSG00000158711.8,205632011,chr1-205631216-C-T,rs34851857,-1,C,T,205631216,795,205435403,205828619,195813
1,ENSG00000259030.1,74198235,chr1-74393124-G-A,rs34961661,1,G,A,74393124,194889,74001627,74394843,391497
1,ENSG00000196240.2,248445512,chr1-248353418-A-G,rs35274032,1,A,G,248353418,92094,248248904,248642120,104514
1,ENSG00000131788.10,145859081,chr1-145773146-T-C,rs35353761,-1,T,C,145773146,85935,145662473,146055689,110673
1,ENSG00000160803.6,156053798,chr1-156207998-A-C,rs35498542,-1,A,C,156207998,154200,155857190,156250406,350808
1,ENSG00000162591.10,3611508,chr1-3605997-T-C,rs35701577,-1,T,C,3605997,5511,3414900,3808116,191097
1,ENSG00000187961.7,960584,chr1-1004823-G-A,rs35940137,1,G,A,1004823,44239,763976,1157192,240847
1,ENSG00000198912.6,3900272,chr1-4054841-C-T,rs35953644,-1,C,T,4054841,154569,3703664,4096880,351177
1,ENSG00000196189.6,156153585,chr1-156177767-C-T,rs3738581,1,C,T,156177767,24182,155956977,156350193,220790
1,ENSG00000067334.8,93879206,chr1-93992865-T-C,rs3747961,-1,T,C,93992865,113659,93682598,94075814,310267
1,ENSG00000136628.11,220046505,chr1-220018404-G-A,rs3767661,-1,G,A,220018404,28101,219849897,220243113,168507
1,ENSG00000187017.10,6424776,chr1-6344171-A-G,rs3789479,1,A,G,6344171,80605,6228168,6621384,116003
1,ENSG00000116833.8,200027710,chr1-200153078-C-T,rs3790793,1,C,T,200153078,125368,199831102,200224318,321976
1,ENSG00000118197.8,200669907,chr1-200666432-T-C,rs3795633,-1,T,C,200666432,3475,200473299,200866515,193133
1,ENSG00000117091.5,160711822,chr1-160682940-T-A,rs3796502,-1,T,A,160682940,28882,160515214,160908430,167726
1,ENSG00000143479.11,206635536,chr1-206470191-T-C,rs3813977,1,T,C,206470191,165345,206438928,206832144,31263
1,ENSG00000186564.5,47438044,chr1-47434225-T-C,rs3814005,1,T,C,47434225,3819,47241436,47634652,192789
1,ENSG00000163220.10,153357854,chr1-153302849-G-A,rs3820142,1,G,A,153302849,55005,153161246,153554462,141603
1,ENSG00000121454.4,180230264,chr1-180271617-C-T,rs3845397,1,C,T,180271617,41353,180033656,180426872,237961
1,ENSG00000204084.6,37947053,chr1-37802725-T-C,rs3845498,-1,T,C,37802725,144328,37750445,38143661,52280
1,ENSG00000168765.10,109656099,chr1-109640399-G-T,rs3850616,1,G,T,109640399,15700,109459491,109852707,180908
1,ENSG00000174574.9,38991276,chr1-39045386-G-A,rs3901310,1,G,A,39045386,54110,38794668,39187884,250718
1,ENSG00000158716.4,159780962,chr1-159776089-T-C,rs4074173,1,T,C,159776089,4873,159584354,159977570,191735
1,ENSG00000143436.6,151763496,chr1-151729587-A-G,rs41263712,-1,A,G,151729587,33909,151566888,151960104,162699
1,ENSG00000143412.5,150982292,chr1-151036732-A-G,rs41266605,1,A,G,151036732,54440,150785684,151178900,251048
1,ENSG00000132881.5,16237183,chr1-16206003-G-A,rs41269185,-1,G,A,16206003,31180,16040575,16433791,165428
1,ENSG00000117480.10,46394317,chr1-46352830-A-G,rs41294480,1,A,G,46352830,41487,46197709,46590925,155121
1,ENSG00000143653.8,246724409,chr1-246767817-A-G,rs41310575,1,A,G,246767817,43408,246527801,246921017,240016
1,ENSG00000203965.7,63523525,chr1-63364808-T-C,rs4142453,1,T,C,63364808,158717,63326917,63720133,37891
1,ENSG00000084652.10,32179675,chr1-32280788-G-A,rs41510850,1,G,A,32280788,101113,31983067,32376283,297721
1,ENSG00000134684.6,32817358,chr1-32713555-A-G,rs419145,-1,A,G,32713555,103803,32620750,33013966,92805
1,ENSG00000117791.11,220748322,chr1-220692403-A-G,rs427216,1,A,G,220692403,55919,220551714,220944930,140689
1,ENSG00000162817.6,220690363,chr1-220692403-A-G,rs427216,1,A,G,220692403,2040,220493755,220886971,198648
1,ENSG00000001461.11,24415802,chr1-24501339-A-G,rs431454,1,A,G,24501339,85537,24219194,24612410,282145
1,ENSG00000042781.8,216423448,chr1-216484506-G-A,rs4348785,-1,G,A,216484506,61058,216226840,216620056,257666
1,ENSG00000177151.3,248645278,chr1-248632551-A-G,rs4359056,-1,A,G,248632551,12727,248448670,248841886,183881
1,ENSG00000143549.14,154192100,chr1-154095720-C-T,rs4459102,-1,C,T,154095720,96380,153995492,154388708,100228
1,ENSG00000143294.9,156767535,chr1-156693425-A-G,rs4492611,1,A,G,156693425,74110,156570927,156964143,122498
1,ENSG00000187010.13,25272509,chr1-25193132-T-C,rs4520361,1,T,C,25193132,79377,25075901,25469117,117231
1,ENSG00000183520.7,38012734,chr1-38015316-C-T,rs4525008,1,C,T,38015316,2582,37816126,38209342,199190
1,ENSG00000173846.7,44800377,chr1-44615094-G-A,rs459420,1,G,A,44615094,185283,44603769,44996985,11325
1,ENSG00000065978.12,42682418,chr1-42546513-A-G,rs4596941,1,A,G,42546513,135905,42485810,42879026,60703
1,ENSG00000183386.5,38005514,chr1-37999643-G-A,rs4634868,-1,G,A,37999643,5871,37808906,38202122,190737
1,ENSG00000011009.5,23791145,chr1-23696642-G-A,rs4649111,1,G,A,23696642,94503,23594537,23987753,102105
1,ENSG00000011009.5,23791145,chr1-23696642-G-T,rs4649111,1,G,T,23696642,94503,23594537,23987753,102105
1,ENSG00000122223.8,160862887,chr1-160860478-A-G,rs4656940,-1,A,G,160860478,2409,160666279,161059495,194199
1,ENSG00000081721.6,161749786,chr1-161768448-A-C,rs4657101,1,A,C,161768448,18662,161553178,161946394,215270
1,ENSG00000162885.6,235504452,chr1-235501194-T-C,rs4659905,-1,T,C,235501194,3258,235307844,235701060,193350
1,ENSG00000117481.5,46340807,chr1-46339550-A-G,rs4660344,1,A,G,46339550,1257,46144199,46537415,195351
1,ENSG00000069248.7,229508341,chr1-229425419-A-C,rs482442,-1,A,C,229425419,82922,229311733,229704949,113686
1,ENSG00000076356.6,208244384,chr1-208169341-C-T,rs4844413,-1,C,T,208169341,75043,208047776,208440992,121565
1,ENSG00000159445.8,151909511,chr1-151858962-T-G,rs4845629,-1,T,G,151858962,50549,151712903,152106119,146059
1,ENSG00000049239.7,9234774,chr1-9237812-A-G,rs4908830,1,A,G,9237812,3038,9038166,9431382,199646
1,ENSG00000162413.11,6602869,chr1-6579787-G-T,rs4908932,-1,G,T,6579787,23082,6406261,6799477,173526
1,ENSG00000162711.12,247416173,chr1-247301942-C-G,rs4925615,1,C,G,247301942,114231,247219565,247612781,82377
1,ENSG00000168528.7,31413213,chr1-31511735-A-G,rs4949419,1,A,G,31511735,98522,31216605,31609821,295130
1,ENSG00000122481.12,95234210,chr1-95251198-A-G,rs4949946,1,A,G,95251198,16988,95037602,95430818,213596
1,ENSG00000065600.8,212414886,chr1-212413978-T-C,rs4951595,-1,T,C,212413978,908,212218278,212611494,195700
1,ENSG00000107404.12,1349418,chr1-1159358-A-G,rs4970362,-1,A,G,1159358,190060,1152810,1546026,6548
1,ENSG00000176022.3,1232237,chr1-1238902-T-C,rs4970364,1,T,C,1238902,6665,1035629,1428845,203273
1,ENSG00000143434.10,151146631,chr1-151031124-T-A,rs4970989,-1,T,A,151031124,115507,150950023,151343239,81101
1,ENSG00000143418.14,150974835,chr1-151031124-T-A,rs4970989,-1,T,A,151031124,56289,150778227,151171443,252897
1,ENSG00000070759.11,45491163,chr1-45544980-A-G,rs518365,-1,A,G,45544980,53817,45294555,45687771,250425
1,ENSG00000162543.5,20186096,chr1-20138951-C-T,rs518588,1,C,T,20138951,47145,19989488,20382704,149463
1,ENSG00000162511.6,30757774,chr1-30645894-A-G,rs522294,-1,A,G,30645894,111880,30561166,30954382,84728
1,ENSG00000116983.7,39691433,chr1-39693156-C-T,rs546422,-1,C,T,39693156,1723,39494825,39888041,198331
1,ENSG00000171161.7,248838224,chr1-248787099-A-C,rs55826813,1,A,C,248787099,51125,248641616,249034832,145483
1,ENSG00000163879.8,37556940,chr1-37588539-G-A,rs56365156,1,G,A,37588539,31599,37360332,37753548,228207
1,ENSG00000134243.7,109397918,chr1-109553275-A-G,rs577953,-1,A,G,109553275,155357,109201310,109594526,351965
1,ENSG00000142875.13,84144271,chr1-84038737-C-T,rs581864,1,C,T,84038737,105534,83947663,84340879,91074
1,ENSG00000131781.8,147225339,chr1-147409534-G-A,rs58671552,-1,G,A,147409534,184195,147028731,147421947,380803
1,ENSG00000116754.9,70221380,chr1-70118777-G-A,rs593467,1,G,A,70118777,102603,70024772,70417988,94005
1,ENSG00000163141.13,151036586,chr1-151001835-G-A,rs59942146,1,G,A,151001835,34751,150839978,151233194,161857
1,ENSG00000121774.11,32013868,chr1-31926308-A-G,rs601261,1,A,G,31926308,87560,31817260,32210476,109048
1,ENSG00000178104.13,148889564,chr1-148989863-G-A,rs611160,1,G,A,148989863,100299,148692956,149086172,296907
1,ENSG00000117009.7,241532378,chr1-241609119-A-G,rs613032,1,A,G,241609119,76741,241335770,241728986,273349
1,ENSG00000171806.7,169794907,chr1-169611647-C-T,rs6131,-1,C,T,169611647,183260,169598299,169991515,13348
1,ENSG00000187608.5,1013497,chr1-1087734-G-A,rs61766340,1,G,A,1087734,74237,816889,1210105,270845
1,ENSG00000122432.11,84506397,chr1-84482283-A-G,rs61768860,1,A,G,84482283,24114,84309789,84703005,172494
1,ENSG00000134748.11,52404602,chr1-52396802-T-C,rs61782544,1,T,C,52396802,7800,52207994,52601210,188808
1,ENSG00000134247.8,116909916,chr1-116726313-G-A,rs61787809,1,G,A,116726313,183603,116713308,117106524,13005
1,ENSG00000117595.6,209806142,chr1-209991371-C-T,rs61820394,-1,C,T,209991371,185229,209609534,210002750,381837
1,ENSG00000197472.9,247008057,chr1-247167626-T-C,rs61837912,-1,T,C,247167626,159569,246811449,247204665,356177
1,ENSG00000197323.6,114511203,chr1-114331749-G-T,rs627205,-1,G,T,114331749,179454,114314595,114707811,17154
1,ENSG00000117395.5,43172290,chr1-43060354-A-G,rs636747,-1,A,G,43060354,111936,42975682,43368898,84672
1,ENSG00000121766.10,31297032,chr1-31180886-T-C,rs6425714,1,T,C,31180886,116146,31100424,31493640,80462
1,ENSG00000119535.13,36482913,chr1-36370750-G-C,rs6425984,-1,G,C,36370750,112163,36286305,36679521,84445
1,ENSG00000143195.7,166975540,chr1-166945021-A-G,rs6427047,-1,A,G,166945021,30519,166778932,167172148,166089
1,ENSG00000198771.6,167630232,chr1-167700250-C-T,rs6427100,1,C,T,167700250,70018,167433624,167826840,266626
1,ENSG00000026751.11,160739247,chr1-160811175-C-A,rs6427548,1,C,A,160811175,71928,160542639,160935855,268536
1,ENSG00000133063.11,203229673,chr1-203269579-C-A,rs6427997,-1,C,A,203269579,39906,203033065,203426281,236514
1,ENSG00000126070.12,35931105,chr1-35908222-C-G,rs645383,1,C,G,35908222,22883,35734497,36127713,173725
1,ENSG00000213366.6,109668057,chr1-109672556-A-G,rs655315,1,A,G,109672556,4499,109471449,109864665,201107
1,ENSG00000159352.10,151254734,chr1-151164668-A-G,rs6587557,1,A,G,151164668,90066,151058126,151451342,106542
1,ENSG00000162735.12,160285133,chr1-160189366-G-A,rs659235,-1,G,A,160189366,95767,160088525,160481741,100841
1,ENSG00000180488.8,77779649,chr1-77823277-G-A,rs6604876,1,G,A,77823277,43628,77583041,77976257,240236
1,ENSG00000122188.8,203765183,chr1-203694307-T-C,rs6656569,1,T,C,203694307,70876,203568575,203961791,125732
1,ENSG00000134256.8,117001760,chr1-116961571-C-T,rs6658749,1,C,T,116961571,40189,116805152,117198368,156419
1,ENSG00000188157.8,1020120,chr1-982890-C-T,rs6659460,1,C,T,982890,37230,823512,1216728,159378
1,ENSG00000196182.6,36385924,chr1-36486834-T-C,rs6662501,-1,T,C,36486834,100910,36189316,36582532,297518
1,ENSG00000116791.9,74733050,chr1-74704459-A-C,rs6662846,-1,A,C,74704459,28591,74536442,74929658,168017
1,ENSG00000143178.7,168280877,chr1-168238059-T-C,rs6664426,1,T,C,168238059,42818,168084269,168477485,153790
1,ENSG00000116678.14,65420668,chr1-65382351-A-C,rs6672992,1,A,C,65382351,38317,65224060,65617276,158291
1,ENSG00000162433.10,65148203,chr1-65081241-C-T,rs6673673,1,C,T,65081241,66962,64951595,65344811,129646
1,ENSG00000132128.11,46303616,chr1-46295717-G-A,rs6676038,-1,G,A,46295717,7899,46107008,46500224,188709
1,ENSG00000116954.7,38859772,chr1-38824387-C-T,rs6681493,-1,C,T,38824387,35385,38663164,39056380,161223
1,ENSG00000162545.5,20486210,chr1-20556030-A-G,rs6689263,-1,A,G,20556030,69820,20289602,20682818,266428
1,ENSG00000116990.9,39901917,chr1-40089602-C-G,rs6689837,-1,C,G,40089602,187685,39705309,40098525,384293
1,ENSG00000117133.6,84479266,chr1-84532762-C-G,rs6690204,1,C,G,84532762,53496,84282658,84675874,250104
1,ENSG00000116918.8,231528669,chr1-231552669-T-G,rs6690785,1,T,G,231552669,24000,231332061,231725277,220608
1,ENSG00000133048.8,203186704,chr1-203187994-G-A,rs6691378,-1,G,A,203187994,1290,202990096,203383312,197898
1,ENSG00000143198.7,165631234,chr1-165630314-T-C,rs6694924,1,T,C,165630314,920,165434626,165827842,195688
1,ENSG00000184260.4,149886918,chr1-149907993-C-T,rs6696662,1,C,T,149907993,21075,149690310,150083526,217683
1,ENSG00000160716.4,154567778,chr1-154701279-G-A,rs6696760,1,G,A,154701279,133501,154371170,154764386,330109
1,ENSG00000117153.11,202927234,chr1-202883973-C-T,rs6698793,-1,C,T,202883973,43261,202730626,203123842,153347
1,ENSG00000185220.7,248906235,chr1-248901731-C-A,rs6700372,1,C,A,248901731,4504,248709627,249102843,192104
1,ENSG00000117592.8,173477335,chr1-173383558-G-C,rs6701066,1,G,C,173383558,93777,173280727,173673943,102831
1,ENSG00000117016.5,40665682,chr1-40531436-A-G,rs6703866,-1,A,G,40531436,134246,40469074,40862290,62362
1,ENSG00000224051.2,1324802,chr1-1262211-C-T,rs6704013,1,C,T,1262211,62591,1128194,1521410,134017
1,ENSG00000240563.1,62194849,chr1-62215309-G-A,rs6704042,1,G,A,62215309,20460,61998241,62391457,217068
1,ENSG00000049246.8,7784291,chr1-7781489-A-C,rs697680,1,A,C,7781489,2802,7587683,7980899,193806
1,ENSG00000162520.10,32702770,chr1-32867503-G-A,rs726344,-1,G,A,32867503,164733,32506162,32899378,361341
1,ENSG00000187144.7,16437424,chr1-16440274-G-A,rs72638043,-1,G,A,16440274,2850,16240816,16634032,199458
1,ENSG00000143153.7,169106690,chr1-169047643-C-G,rs72693515,1,C,G,169047643,59047,168910082,169303298,137561
1,ENSG00000174876.11,103696210,chr1-103772836-A-G,rs72694426,-1,A,G,103772836,76626,103499602,103892818,273234
1,ENSG00000237763.5,103655760,chr1-103772836-A-G,rs72694426,1,A,G,103772836,117076,103459152,103852368,313684
1,ENSG00000134201.5,109712251,chr1-109636825-G-A,rs72705211,1,G,A,109636825,75426,109515643,109908859,121182
1,ENSG00000143751.7,225999343,chr1-226020937-T-C,rs72757027,-1,T,C,226020937,21594,225802735,226195951,218202
1,ENSG00000196154.6,153545806,chr1-153661582-G-T,rs7345,-1,G,T,153661582,115776,153349198,153742414,312384
1,ENSG00000117010.11,40531637,chr1-40465331-A-G,rs736861,1,A,G,40465331,66306,40335029,40728245,130302
1,ENSG00000131584.13,1307930,chr1-1156691-C-A,rs74045142,-1,C,A,1156691,151239,1111322,1504538,45369
1,ENSG00000011021.17,11806191,chr1-11835610-G-C,rs74053327,1,G,C,11835610,29419,11609583,12002799,226027
1,ENSG00000157978.6,25543606,chr1-25541624-G-A,rs74063479,1,G,A,25541624,1982,25346998,25740214,194626
1,ENSG00000160714.5,154558662,chr1-154727775-C-G,rs74115846,-1,C,G,154727775,169113,154362054,154755270,365721
1,ENSG00000182749.5,25875708,chr1-25875935-C-T,rs74378533,-1,C,T,25875935,227,25679100,26072316,196835
1,ENSG00000049247.8,7853065,chr1-7874458-G-A,rs744000,-1,G,A,7874458,21393,7656457,8049673,218001
1,ENSG00000143353.7,219173878,chr1-219296383-G-A,rs74585261,1,G,A,219296383,122505,218977270,219370486,319113
1,ENSG00000197852.7,111739395,chr1-111547597-G-A,rs74928003,-1,G,A,111547597,191798,111542787,111936003,4810
1,ENSG00000175137.9,248825915,chr1-248737772-T-A,rs75018039,-1,T,A,248737772,88143,248629307,249022523,108465
1,ENSG00000117222.9,205121978,chr1-205012123-A-G,rs75127363,-1,A,G,205012123,109855,204925370,205318586,86753
1,ENSG00000159658.5,46719114,chr1-46811147-G-A,rs7513658,-1,G,A,46811147,92033,46522506,46915722,288641
1,ENSG00000162594.9,67166454,chr1-67130689-A-G,rs7515029,1,A,G,67130689,35765,66969846,67363062,160843
1,ENSG00000162461.7,15736258,chr1-15711831-T-C,rs7516540,1,T,C,15711831,24427,15539650,15932866,172181
1,ENSG00000162441.6,9943391,chr1-9952956-A-G,rs7516611,-1,A,G,9952956,9565,9746783,10139999,206173
1,ENSG00000162441.6,9943391,chr1-9952956-A-C,rs7516611,-1,A,C,9952956,9565,9746783,10139999,206173
1,ENSG00000162552.8,22143097,chr1-21985415-G-A,rs7520526,-1,G,A,21985415,157682,21946489,22339705,38926
1,ENSG00000116260.12,180154869,chr1-180208131-G-T,rs7521602,1,G,T,180208131,53262,179958261,180351477,249870
1,ENSG00000117280.8,205775482,chr1-205766763-G-A,rs7522056,-1,G,A,205766763,8719,205578874,205972090,187889
1,ENSG00000183155.4,202889149,chr1-202896576-T-G,rs7523420,-1,T,G,202896576,7427,202692541,203085757,204035
1,ENSG00000168710.13,109984765,chr1-109790194-G-T,rs7524737,1,G,T,109790194,194571,109788157,110181373,2037
1,ENSG00000055732.7,85048500,chr1-85072207-G-A,rs7527292,-1,G,A,85072207,23707,84851892,85245108,220315
1,ENSG00000163545.7,205321745,chr1-205382575-A-T,rs7528008,-1,A,T,205382575,60830,205125137,205518353,257438
1,ENSG00000160856.14,157700769,chr1-157701026-A-G,rs7528684,-1,A,G,157701026,257,157504161,157897377,196865
1,ENSG00000198198.9,43389899,chr1-43579623-A-G,rs752963,1,A,G,43579623,189724,43193291,43586507,386332
1,ENSG00000036549.8,77682658,chr1-77557488-C-T,rs7536433,-1,C,T,77557488,125170,77486050,77879266,71438
1,ENSG00000170385.9,211579161,chr1-211512678-C-T,rs753647,-1,C,T,211512678,66483,211382553,211775769,130125
1,ENSG00000186510.6,16022036,chr1-15992159-C-T,rs75412003,1,C,T,15992159,29877,15825428,16218644,166731
1,ENSG00000203661.2,248488589,chr1-248359594-G-A,rs7541216,1,G,A,248359594,128995,248291981,248685197,67613
1,ENSG00000196944.3,248361665,chr1-248359594-G-A,rs7541216,1,G,A,248359594,2071,248165057,248558273,194537
1,ENSG00000163393.8,115976513,chr1-116165527-G-A,rs7544935,1,G,A,116165527,189014,115779905,116173121,385622
1,ENSG00000160688.14,154983344,chr1-154818175-C-T,rs7546937,1,C,T,154818175,165169,154786736,155179952,31439
1,ENSG00000169504.9,24745447,chr1-24854021-A-G,rs7549156,1,A,G,24854021,108574,24548839,24942055,305182
1,ENSG00000162521.12,32651208,chr1-32463574-C-T,rs7552676,1,C,T,32463574,187634,32454600,32847816,8974
1,ENSG00000157911.5,2412564,chr1-2273316-G-A,rs7553178,-1,G,A,2273316,139248,2215956,2609172,57360
1,ENSG00000131697.12,5992425,chr1-5954384-T-C,rs7555293,-1,T,C,5954384,38041,5795817,6189033,158567
1,ENSG00000085465.10,111427735,chr1-111384542-A-G,rs7555330,-1,A,G,111384542,43193,111231127,111624343,153415
1,ENSG00000162909.12,223712539,chr1-223707187-A-G,rs7555491,1,A,G,223707187,5352,223515931,223909147,191256
1,ENSG00000162407.8,56579563,chr1-56548660-C-G,rs76294340,-1,C,G,56548660,30903,56382955,56776171,165705
1,ENSG00000198860.7,184051730,chr1-184046529-G-A,rs765224,1,G,A,184046529,5201,183855122,184248338,191407
1,ENSG00000189409.7,1632173,chr1-1760401-G-A,rs76601697,1,G,A,1760401,128228,1435565,1828781,324836
1,ENSG00000177868.7,42817397,chr1-43001414-T-C,rs76794017,-1,T,C,43001414,184017,42620789,43014005,380625
1,ENSG00000077152.5,202341936,chr1-202408464-A-G,rs77223088,-1,A,G,202408464,66528,202145328,202538544,263136
1,ENSG00000143819.8,225810124,chr1-225918205-C-T,rs77228649,1,C,T,225918205,108081,225613516,226006732,304689
1,ENSG00000159208.11,150282554,chr1-150434964-T-C,rs78372713,1,T,C,150434964,152410,150085946,150479162,349018
1,ENSG00000116981.3,39672107,chr1-39694476-A-C,rs784192,-1,A,C,39694476,22369,39475499,39868715,218977
1,ENSG00000184163.3,1246722,chr1-1243102-A-G,rs78555129,-1,A,G,1243102,3620,1050114,1443330,192988
1,ENSG00000143554.9,153775407,chr1-153844304-A-G,rs78571619,1,A,G,153844304,68897,153578799,153972015,265505
1,ENSG00000143226.8,161505457,chr1-161589930-G-A,rs78603008,1,G,A,161589930,84473,161308849,161702065,281081
1,ENSG00000158161.11,28088610,chr1-28224028-G-T,rs78730774,-1,G,T,28224028,135418,27892002,28285218,332026
1,ENSG00000143771.7,224356879,chr1-224161395-G-A,rs78789927,1,G,A,224161395,195484,224160271,224553487,1124
1,ENSG00000058085.9,183186264,chr1-183029118-G-A,rs79348617,1,G,A,183029118,157146,182989656,183382872,39462
1,ENSG00000175793.9,26863149,chr1-26758084-A-G,rs79569112,1,A,G,26758084,105065,26666541,27059757,91543
1,ENSG00000155380.7,112956196,chr1-112772771-G-A,rs79681376,-1,G,A,112772771,183425,112759588,113152804,13183
1,ENSG00000134698.10,35808016,chr1-35927557-A-G,rs797000,1,A,G,35927557,119541,35611408,36004624,316149
1,ENSG00000135750.10,233614106,chr1-233500276-C-T,rs79748833,1,C,T,233500276,113830,233417498,233810714,82778
1,ENSG00000118873.10,220272453,chr1-220370189-C-T,rs79800560,-1,C,T,220370189,97736,220075845,220469061,294344
1,ENSG00000143033.11,93079283,chr1-93045830-T-C,rs808833,1,T,C,93045830,33453,92882675,93275891,163155
1,ENSG00000163344.5,154936719,chr1-154966186-T-C,rs8191979,-1,T,C,154966186,29467,154740111,155133327,226075
1,ENSG00000163344.5,154936719,chr1-154966186-T-A,rs8191979,-1,T,A,154966186,29467,154740111,155133327,226075
1,ENSG00000116857.11,201154474,chr1-201179905-C-T,rs831768,-1,C,T,201179905,25431,200957866,201351082,222039
1,ENSG00000121940.11,108963484,chr1-108929012-T-G,rs839854,-1,T,G,108929012,34472,108766876,109160092,162136
1,ENSG00000117528.7,94418389,chr1-94552963-T-C,rs841698,1,T,C,94552963,134574,94221781,94614997,331182
1,ENSG00000173641.12,16018043,chr1-15958847-G-A,rs848194,-1,G,A,15958847,59196,15821435,16214651,137412
1,ENSG00000203995.5,52842760,chr1-52679671-A-G,rs873844,1,A,G,52679671,163089,52646152,53039368,33519
1,ENSG00000173660.7,46303698,chr1-46408231-C-T,rs873978,1,C,T,46408231,104533,46107090,46500306,301141
1,ENSG00000130770.12,28236124,chr1-28193722-C-G,rs905907,1,C,G,28193722,42402,28039516,28432732,154206
1,ENSG00000160685.9,155002802,chr1-154850041-C-G,rs906597,1,C,G,154850041,152761,154806194,155199410,43847
1,ENSG00000173726.6,235128837,chr1-235091308-T-C,rs9287215,-1,T,C,235091308,37529,234932229,235325445,159079
1,ENSG00000142856.12,63523225,chr1-63339451-G-T,rs932748,-1,G,T,63339451,183774,63326617,63719833,12834
1,ENSG00000197147.6,89524829,chr1-89483285-A-G,rs9427984,1,A,G,89483285,41544,89328221,89721437,155064
1,ENSG00000196352.8,207321678,chr1-207475879-G-A,rs9429776,1,G,A,207475879,154201,207125070,207518286,350809
1,ENSG00000162757.3,209784559,chr1-209823197-T-G,rs9430018,-1,T,G,209823197,38638,209587951,209981167,235246
1,ENSG00000117155.10,84690461,chr1-84810967-T-C,rs9729377,-1,T,C,84810967,120506,84493853,84887069,317114
1,ENSG00000117013.10,40783787,chr1-40805265-A-G,rs9970508,1,A,G,40805265,21478,40587179,40980395,218086
1,ENSG00000121766.10,31297032,chr1-31429571-A-G,rs10047085,1,A,G,31429571,132539,31100424,31493640,329147
1,ENSG00000118292.4,150272790,chr1-150238804-T-C,rs10157434,1,T,C,150238804,33986,150076182,150469398,162622
1,ENSG00000143819.8,225810124,chr1-225862909-C-A,rs10158985,1,C,A,225862909,52785,225613516,226006732,249393
1,ENSG00000120370.7,170532166,chr1-170359418-A-G,rs10159293,1,A,G,170359418,172748,170335558,170728774,23860
1,ENSG00000189266.6,23959828,chr1-24052181-G-A,rs10449779,1,G,A,24052181,92353,23763220,24156436,288961
1,ENSG00000117174.6,85708433,chr1-85569181-T-C,rs10493770,-1,T,C,85569181,139252,85511825,85905041,57356
1,ENSG00000156171.9,111140093,chr1-111254763-C-G,rs10494130,-1,C,G,111254763,114670,110943485,111336701,311278
1,ENSG00000153898.8,84997113,chr1-85021837-G-A,rs10518327,-1,G,A,85021837,24724,84800505,85193721,221332
1,ENSG00000116525.7,33182043,chr1-33226350-A-G,rs10737366,-1,A,G,33226350,44307,32985435,33378651,240915
1,ENSG00000162482.4,19288770,chr1-19371421-G-T,rs10753558,-1,G,T,19371421,82651,19092162,19485378,279259
1,ENSG00000162482.4,19288770,chr1-19371421-G-A,rs10753558,-1,G,A,19371421,82651,19092162,19485378,279259
1,ENSG00000162627.12,98661721,chr1-98495172-G-A,rs10783093,1,G,A,98495172,166549,98465113,98858329,30059
1,ENSG00000162600.6,58546726,chr1-58655364-A-C,rs10789069,-1,A,C,58655364,108638,58350118,58743334,305246
1,ENSG00000142684.7,26169908,chr1-26156065-T-C,rs10794522,1,T,C,26156065,13843,25973300,26366516,182765
1,ENSG00000116863.8,36088892,chr1-35955013-A-G,rs10796875,1,A,G,35955013,133879,35892284,36285500,62729
1,ENSG00000185155.6,226223664,chr1-226187566-C-A,rs10799340,1,C,A,226187566,36098,226027056,226420272,160510
1,ENSG00000158828.5,20633458,chr1-20664412-G-A,rs10799659,1,G,A,20664412,30954,20436850,20830066,227562
1,ENSG00000159166.9,201399324,chr1-201351661-C-T,rs10800774,-1,C,T,201351661,47663,201202716,201595932,148945
1,ENSG00000162643.8,85062327,chr1-85001362-T-C,rs10873679,1,T,C,85001362,60965,84865719,85258935,135643
1,ENSG00000162643.8,85062327,chr1-85001362-T-G,rs10873679,1,T,G,85001362,60965,84865719,85258935,135643
1,ENSG00000163545.7,205321745,chr1-205435750-T-C,rs10900490,-1,T,C,205435750,114005,205125137,205518353,310613
1,ENSG00000135829.11,182839347,chr1-182958550-T-C,rs10911167,1,T,C,182958550,119203,182642739,183035955,315811
1,ENSG00000135838.8,182789773,chr1-182958550-T-C,rs10911167,1,T,C,182958550,168777,182593165,182986381,365385
1,ENSG00000116690.7,186296279,chr1-186104049-C-A,rs10911820,1,C,A,186104049,192230,186099671,186492887,4378
1,ENSG00000163362.6,200894900,chr1-200944808-T-A,rs10920075,1,T,A,200944808,49908,200698292,201091508,246516
1,ENSG00000198892.6,201888898,chr1-201887393-C-G,rs10920270,1,C,G,201887393,1505,201692290,202085506,195103
1,ENSG00000162851.6,246566261,chr1-246538517-G-A,rs10924774,-1,G,A,246538517,27744,246369653,246762869,168864
1,ENSG00000143702.10,243255281,chr1-243331437-A-G,rs10926992,-1,A,G,243331437,76156,243058673,243451889,272764
1,ENSG00000054282.10,243256041,chr1-243331437-A-G,rs10926992,1,A,G,243331437,75396,243059433,243452649,272004
1,ENSG00000173728.6,244352635,chr1-244353032-A-C,rs10927202,1,A,C,244353032,397,244156027,244549243,197005
1,ENSG00000233954.4,15809348,chr1-15734397-C-T,rs10927843,-1,C,T,15734397,74951,15612740,16005956,121657
1,ENSG00000058668.10,203626832,chr1-203642035-C-T,rs1106891,1,C,T,203642035,15203,203430224,203823440,211811
1,ENSG00000121940.11,108963484,chr1-108808209-G-C,rs11102473,-1,G,C,108808209,155275,108766876,109160092,41333
1,ENSG00000121940.11,108963484,chr1-108808209-G-A,rs11102473,-1,G,A,108808209,155275,108766876,109160092,41333
1,ENSG00000162817.6,220690363,chr1-220768102-G-A,rs11118598,1,G,A,220768102,77739,220493755,220886971,274347
1,ENSG00000142224.11,206770773,chr1-206750133-T-C,rs11119447,1,T,C,206750133,20640,206574165,206967381,175968
1,ENSG00000136643.7,213051241,chr1-213079805-C-T,rs11120086,1,C,T,213079805,28564,212854633,213247849,225172
1,ENSG00000173409.9,230979094,chr1-230931036-A-G,rs11122623,1,A,G,230931036,48058,230782486,231175702,148550
1,ENSG00000162373.7,48776891,chr1-48743085-C-A,rs11205534,-1,C,A,48743085,33806,48580283,48973499,162802
1,ENSG00000162373.7,48776891,chr1-48743085-C-G,rs11205534,-1,C,G,48743085,33806,48580283,48973499,162802
1,ENSG00000116157.5,52602371,chr1-52638216-G-T,rs11205985,1,G,T,52638216,35845,52405763,52798979,232453
1,ENSG00000162434.7,64966549,chr1-65042741-G-A,rs11208574,-1,G,A,65042741,76192,64769941,65163157,272800
1,ENSG00000162433.10,65148203,chr1-65144024-A-G,rs11208596,1,A,G,65144024,4179,64951595,65344811,192429
1,ENSG00000130695.8,26234200,chr1-26329016-C-A,rs11247917,1,C,A,26329016,94816,26037592,26430808,291424
1,ENSG00000127054.12,1324660,chr1-1194826-G-A,rs11260556,-1,G,A,1194826,129834,1128052,1521268,66774
1,ENSG00000184163.3,1246722,chr1-1229930-G-A,rs11260562,-1,G,A,1229930,16792,1050114,1443330,179816
1,ENSG00000134697.6,37595937,chr1-37552935-G-A,rs11264072,-1,G,A,37552935,43002,37399329,37792545,153606
1,ENSG00000132694.14,157045742,chr1-156932886-G-A,rs11264585,-1,G,A,156932886,112856,156849134,157242350,83752
1,ENSG00000158714.6,159826873,chr1-159802961-G-A,rs11265281,1,G,A,159802961,23912,159630265,160023481,172696
1,ENSG00000117090.8,160647044,chr1-160450533-G-A,rs11265404,-1,G,A,160450533,196511,160450436,160843652,97
1,ENSG00000143258.11,161159500,chr1-161210722-A-G,rs11265565,1,A,G,161210722,51222,160962892,161356108,247830
1,ENSG00000134184.7,109687817,chr1-109707875-G-A,rs112697537,1,G,A,109707875,20058,109491209,109884425,216666
1,ENSG00000183780.8,233904676,chr1-233805822-C-A,rs113801949,1,C,A,233805822,98854,233708068,234101284,97754
1,ENSG00000023902.8,150149916,chr1-150153170-A-G,rs114052060,1,A,G,150153170,3254,149953308,150346524,199862
1,ENSG00000057468.6,75796882,chr1-75799103-T-C,rs1146644,1,T,C,75799103,2221,75600274,75993490,198829
1,ENSG00000143158.6,167937072,chr1-168096451-A-G,rs114884205,-1,A,G,168096451,159379,167740464,168133680,355987
1,ENSG00000187608.5,1013497,chr1-1180224-C-A,rs115023808,1,C,A,1180224,166727,816889,1210105,363335
1,ENSG00000163216.6,153041120,chr1-153141417-G-A,rs115264490,-1,G,A,153141417,100297,152844512,153237728,296905
1,ENSG00000177606.5,58784047,chr1-58930375-G-T,rs115595326,-1,G,T,58930375,146328,58587439,58980655,342936
1,ENSG00000162946.14,231626790,chr1-231630717-C-T,rs11577625,1,C,T,231630717,3927,231430182,231823398,200535
1,ENSG00000177272.7,110674940,chr1-110684273-T-C,rs1158050,-1,T,C,110684273,9333,110478332,110871548,205941
1,ENSG00000079277.14,46604268,chr1-46528677-T-G,rs115830566,-1,T,G,46528677,75591,46407660,46800876,121017
1,ENSG00000173207.7,154974681,chr1-154835459-G-A,rs11584630,1,G,A,154835459,139222,154778073,155171289,57386
1,ENSG00000142959.4,44788170,chr1-44616668-G-A,rs11585508,-1,G,A,44616668,171502,44591562,44984778,25106
1,ENSG00000117862.6,52055191,chr1-52188736-G-T,rs11587003,-1,G,T,52188736,133545,51858583,52251799,330153
1,ENSG00000203685.5,226548764,chr1-226488598-T-C,rs11588657,1,T,C,226488598,60166,226352156,226745372,136442
1,ENSG00000143537.8,155051316,chr1-155060832-G-A,rs11589479,1,G,A,155060832,9516,154854708,155247924,206124
1,ENSG00000215912.6,2801717,chr1-2620461-G-A,rs11590198,-1,G,A,2620461,181256,2605109,2998325,15352
1,ENSG00000010165.13,171781660,chr1-171724747-C-T,rs116141391,1,C,T,171724747,56913,171585052,171978268,139695
1,ENSG00000143387.8,150808260,chr1-150636953-G-A,rs116173394,-1,G,A,150636953,171307,150611652,151004868,25301
1,ENSG00000135801.5,229626047,chr1-229579145-G-A,rs116265206,-1,G,A,229579145,46902,229429439,229822655,149706
1,ENSG00000171680.14,6491667,chr1-6464441-T-C,rs11800462,-1,T,C,6464441,27226,6295059,6688275,169382
1,ENSG00000163866.7,34859749,chr1-34847030-A-G,rs11802507,-1,A,G,34847030,12719,34663141,35056357,183889
1,ENSG00000198754.4,39771348,chr1-39663729-G-A,rs1180271,-1,G,A,39663729,107619,39574740,39967956,88989
1,ENSG00000143155.8,168178962,chr1-168126023-C-A,rs11805261,1,C,A,168126023,52939,167982354,168375570,143669
1,ENSG00000127129.5,41484683,chr1-41510858-C-T,rs11809423,-1,C,T,41510858,26175,41288075,41681291,222783
1,ENSG00000127129.5,41484683,chr1-41510858-C-G,rs11809423,-1,C,G,41510858,26175,41288075,41681291,222783
1,ENSG00000214114.4,38873348,chr1-38941917-C-A,rs11811894,-1,C,A,38941917,68569,38676740,39069956,265177
1,ENSG00000117791.11,220748322,chr1-220793258-T-C,rs12028745,1,T,C,220793258,44936,220551714,220944930,241544
1,ENSG00000117133.6,84479266,chr1-84475894-C-T,rs12031171,1,C,T,84475894,3372,84282658,84675874,193236
1,ENSG00000054116.7,36149486,chr1-36077598-T-C,rs12031376,-1,T,C,36077598,71888,35952878,36346094,124720
1,ENSG00000198771.6,167630232,chr1-167593368-G-A,rs12037105,1,G,A,167593368,36864,167433624,167826840,159744
1,ENSG00000116741.6,192809039,chr1-192640138-T-C,rs12044559,1,T,C,192640138,168901,192612431,193005647,27707
1,ENSG00000197921.5,2530263,chr1-2477796-G-A,rs12045425,-1,G,A,2477796,52467,2333655,2726871,144141
1,ENSG00000160058.13,32394441,chr1-32510360-T-C,rs12045880,-1,T,C,32510360,115919,32197833,32591049,312527
1,ENSG00000160783.13,156213007,chr1-156063096-G-A,rs12049195,1,G,A,156063096,149911,156016399,156409615,46697
1,ENSG00000143149.8,165698562,chr1-165682679-A-G,rs12076579,-1,A,G,165682679,15883,165501954,165895170,180725
1,ENSG00000163435.10,202010587,chr1-202092584-T-A,rs12078828,1,T,A,202092584,81997,201813979,202207195,278605
1,ENSG00000064886.8,111227713,chr1-111256089-T-C,rs12082033,1,T,C,111256089,28376,111031105,111424321,224984
1,ENSG00000117228.8,89065208,chr1-89060617-C-T,rs12082593,-1,C,T,89060617,4591,88868600,89261816,192017
1,ENSG00000116815.11,116571026,chr1-116551600-T-C,rs12086220,-1,T,C,116551600,19426,116374418,116767634,177182
1,ENSG00000143184.4,168576605,chr1-168686483-A-G,rs12090370,1,A,G,168686483,109878,168379997,168773213,306486
1,ENSG00000143185.3,168543997,chr1-168686483-A-G,rs12090370,-1,A,G,168686483,142486,168347389,168740605,339094
1,ENSG00000156150.5,110070672,chr1-109989983-C-T,rs12090731,-1,C,T,109989983,80689,109874064,110267280,115919
1,ENSG00000117151.7,84574440,chr1-84723668-G-A,rs12092806,-1,G,A,84723668,149228,84377832,84771048,345836
1,ENSG00000116962.10,236065090,chr1-235935640-T-C,rs12096155,-1,T,C,235935640,129450,235868482,236261698,67158
1,ENSG00000035687.8,244451909,chr1-244427664-C-A,rs12116865,-1,C,A,244427664,24245,244255301,244648517,172363
1,ENSG00000162892.11,206897443,chr1-206958226-T-G,rs12119983,1,T,G,206958226,60783,206700835,207094051,257391
1,ENSG00000188859.5,166167001,chr1-166305194-C-G,rs12121817,-1,C,G,166305194,138193,165970393,166363609,334801
1,ENSG00000142657.14,10399064,chr1-10553603-C-T,rs12127400,1,C,T,10553603,154539,10202456,10595672,351147
1,ENSG00000069702.6,91886151,chr1-91753511-G-A,rs12127644,-1,G,A,91753511,132640,91689543,92082759,63968
1,ENSG00000116922.9,37690529,chr1-37741370-G-A,rs12130112,-1,G,A,37741370,50841,37493921,37887137,247449
1,ENSG00000197472.9,247008057,chr1-247088151-A-G,rs12135374,-1,A,G,247088151,80094,246811449,247204665,276702
1,ENSG00000135870.7,174022357,chr1-173931780-T-C,rs12137553,-1,T,C,173931780,90577,173825749,174218965,106031
1,ENSG00000204084.6,37947053,chr1-37986909-A-G,rs12138115,-1,A,G,37986909,39856,37750445,38143661,236464
1,ENSG00000184908.12,16043782,chr1-16060950-A-G,rs12144143,1,A,G,16060950,17168,15847174,16240390,213776
1,ENSG00000162391.5,54623525,chr1-54436910-A-G,rs12145055,-1,A,G,54436910,186615,54426917,54820133,9993
1,ENSG00000198799.6,113073198,chr1-113174848-A-G,rs1216870,1,A,G,113174848,101650,112876590,113269806,298258
1,ENSG00000160691.12,154970747,chr1-154828697-C-T,rs1218551,-1,C,T,154828697,142050,154774139,155167355,54558
1,ENSG00000163344.5,154936719,chr1-154837554-A-G,rs1218578,-1,A,G,154837554,99165,154740111,155133327,97443
1,ENSG00000168528.7,31413213,chr1-31521014-G-A,rs12353942,1,G,A,31521014,107801,31216605,31609821,304409
1,ENSG00000131697.12,5992425,chr1-5930657-C-T,rs12353987,-1,C,T,5930657,61768,5795817,6189033,134840
1,ENSG00000117543.13,101025784,chr1-101208442-G-T,rs12403993,-1,G,T,101208442,182658,100829176,101222392,379266
1,ENSG00000163875.11,37514766,chr1-37605131-T-C,rs12404717,-1,T,C,37605131,90365,37318158,37711374,286973
1,ENSG00000142798.11,21937310,chr1-21995057-G-A,rs12405048,-1,G,A,21995057,57747,21740702,22133918,254355
1,ENSG00000143183.10,165768868,chr1-165698544-T-G,rs12408101,-1,T,G,165698544,70324,165572260,165965476,126284
1,ENSG00000162545.5,20486210,chr1-20578365-T-G,rs1253795,-1,T,G,20578365,92155,20289602,20682818,288763
1,ENSG00000197312.7,15617458,chr1-15581413-C-G,rs12691551,1,C,G,15581413,36045,15420850,15814066,160563
1,ENSG00000235750.4,175192776,chr1-175313983-A-G,rs12732088,-1,A,G,175313983,121207,174996168,175389384,317815
1,ENSG00000160856.14,157700769,chr1-157668178-A-G,rs12737968,-1,A,G,157668178,32591,157504161,157897377,164017
1,ENSG00000066135.8,43650149,chr1-43788915-G-A,rs12741964,1,G,A,43788915,138766,43453541,43846757,335374
1,ENSG00000198216.6,181483517,chr1-181559419-G-A,rs12755303,1,G,A,181559419,75902,181286909,181680125,272510
1,ENSG00000197147.6,89524829,chr1-89542136-C-A,rs12755723,1,C,A,89542136,17307,89328221,89721437,213915
1,ENSG00000143033.11,93079283,chr1-92934792-G-A,rs12757307,1,G,A,92934792,144491,92882675,93275891,52117
1,ENSG00000143375.9,151511387,chr1-151707120-G-A,rs1308153,1,G,A,151707120,195733,151314779,151707995,392341
1,ENSG00000187642.5,981029,chr1-1055459-C-T,rs13129,-1,C,T,1055459,74430,784421,1177637,271038
1,ENSG00000121957.7,108876985,chr1-109066619-T-C,rs13303136,1,T,C,109066619,189634,108680377,109073593,386242
1,ENSG00000116857.11,201154474,chr1-201140856-G-A,rs1408869,-1,G,A,201140856,13618,200957866,201351082,182990
1,ENSG00000075945.8,170074695,chr1-170239284-A-G,rs1412788,-1,A,G,170239284,164589,169878087,170271303,361197
1,ENSG00000212916.3,232805416,chr1-232801993-T-C,rs1495986,1,T,C,232801993,3423,232608808,233002024,193185
1,ENSG00000152332.11,162497818,chr1-162358271-C-T,rs1510291,1,C,T,162358271,139547,162301210,162694426,57061
1,ENSG00000116459.6,111449464,chr1-111404336-A-G,rs1539581,1,A,G,111404336,45128,111252856,111646072,151480
1,ENSG00000188015.5,153549258,chr1-153662243-C-A,rs15407,-1,C,A,153662243,112985,153352650,153745866,309593
1,ENSG00000158109.9,3625015,chr1-3626405-A-G,rs16823920,1,A,G,3626405,1390,3428407,3821623,197998
1,ENSG00000117395.5,43172290,chr1-43150975-C-T,rs16830421,-1,C,T,43150975,21315,42975682,43368898,175293
1,ENSG00000162736.10,160343383,chr1-160224560-C-T,rs16831634,1,C,T,160224560,118823,160146775,160539991,77785
1,ENSG00000163191.5,152037004,chr1-152050163-A-G,rs16833811,-1,A,G,152050163,13159,151840396,152233612,209767
1,ENSG00000143384.7,150579610,chr1-150571513-A-G,rs16837756,-1,A,G,150571513,8097,150383002,150776218,188511
1,ENSG00000163518.6,157598085,chr1-157539207-G-T,rs16838748,-1,G,T,157539207,58878,157401477,157794693,137730
1,ENSG00000213047.6,197775480,chr1-197944027-C-T,rs16842169,-1,C,T,197944027,168547,197578872,197972088,365155
1,ENSG00000186283.9,179082070,chr1-179088875-G-A,rs16853640,1,G,A,179088875,6805,178885462,179278678,203413
1,ENSG00000116918.8,231528669,chr1-231692330-T-C,rs16854785,1,T,C,231692330,163661,231332061,231725277,360269
1,ENSG00000163444.7,203007374,chr1-203024974-C-G,rs1690821,1,C,G,203024974,17600,202810766,203203982,214208
1,ENSG00000162772.12,212608761,chr1-212590594-T-C,rs17019397,1,T,C,212590594,18167,212412153,212805369,178441
1,ENSG00000143079.7,112396214,chr1-112323265-C-T,rs17030045,1,C,T,112323265,72949,112199606,112592822,123659
1,ENSG00000117528.7,94418389,chr1-94608128-T-C,rs17111864,1,T,C,94608128,189739,94221781,94614997,386347
1,ENSG00000184588.13,65792895,chr1-65866371-G-A,rs17128076,1,G,A,65866371,73476,65596287,65989503,270084
1,ENSG00000116717.7,67685201,chr1-67779392-A-G,rs17130266,1,A,G,67779392,94191,67488593,67881809,290799
1,ENSG00000203965.7,63523525,chr1-63438990-G-A,rs17319555,1,G,A,63438990,84535,63326917,63720133,112073
1,ENSG00000143479.11,206635536,chr1-206700389-C-T,rs17350838,1,C,T,206700389,64853,206438928,206832144,261461
1,ENSG00000162551.9,21509423,chr1-21557249-G-A,rs17421553,1,G,A,21557249,47826,21312815,21706031,244434
1,ENSG00000116667.7,184387029,chr1-184380898-G-A,rs17577136,1,G,A,184380898,6131,184190421,184583637,190477
1,ENSG00000203814.5,149812370,chr1-149882774-T-C,rs17581380,-1,T,C,149882774,70404,149615762,150008978,267012
1,ENSG00000162620.10,74198176,chr1-74010285-A-G,rs17588367,-1,A,G,74010285,187891,74001568,74394784,8717
1,ENSG00000065526.5,15847707,chr1-16012430-T-G,rs1763605,1,T,G,16012430,164723,15651099,16044315,361331
1,ENSG00000132196.8,162790702,chr1-162796686-C-T,rs1780019,1,C,T,162796686,5984,162594094,162987310,202592
1,ENSG00000076258.5,171314183,chr1-171146080-A-C,rs1795242,1,A,C,171146080,168103,171117575,171510791,28505
1,ENSG00000160087.16,1273854,chr1-1351660-T-C,rs182532,-1,T,C,1351660,77806,1077246,1470462,274414
1,ENSG00000241794.1,153057512,chr1-152908247-A-G,rs1854778,-1,A,G,152908247,149265,152860904,153254120,47343
1,ENSG00000171517.5,84893206,chr1-84888880-G-A,rs1886647,-1,G,A,84888880,4326,84696598,85089814,192282
1,ENSG00000085552.11,159945613,chr1-160011515-G-T,rs1890530,-1,G,T,160011515,65902,159749005,160142221,262510
1,ENSG00000177301.9,110606358,chr1-110592476-A-G,rs1890675,-1,A,G,110592476,13882,110409750,110802966,182726
1,ENSG00000162746.10,161721563,chr1-161707945-T-C,rs1954172,1,T,C,161707945,13618,161524955,161918171,182990
1,ENSG00000001460.12,24413782,chr1-24471893-C-T,rs195729,-1,C,T,24471893,58111,24217174,24610390,254719
1,ENSG00000175206.6,11847783,chr1-11844019-T-C,rs198358,-1,T,C,11844019,3764,11651175,12044391,192844
1,ENSG00000187017.10,6424776,chr1-6591033-G-A,rs201171,1,G,A,6591033,166257,6228168,6621384,362865
1,ENSG00000162739.9,160523255,chr1-160500966-T-C,rs2025516,-1,T,C,160500966,22289,160326647,160719863,174319
1,ENSG00000160781.9,156248056,chr1-156344313-T-C,rs2025577,-1,T,C,156344313,96257,156051448,156444664,292865
1,ENSG00000235098.4,1421276,chr1-1550604-C-A,rs2031709,-1,C,A,1550604,129328,1224668,1617884,325936
1,ENSG00000116711.7,186828949,chr1-186882084-G-A,rs2049963,1,G,A,186882084,53135,186632341,187025557,249743
1,ENSG00000127124.9,41918922,chr1-41759909-C-T,rs2055953,-1,C,T,41759909,159013,41722314,42115530,37595
1,ENSG00000197965.7,167721982,chr1-167753081-G-A,rs2069059,1,G,A,167753081,31099,167525374,167918590,227707
1,ENSG00000125944.12,23344284,chr1-23384883-C-T,rs2092933,-1,C,T,23384883,40599,23147676,23540892,237207
1,ENSG00000075151.13,21176897,chr1-21256818-T-C,rs212524,-1,T,C,21256818,79921,20980289,21373505,276529
1,ENSG00000143434.10,151146631,chr1-151064340-A-G,rs2140709,-1,A,G,151064340,82291,150950023,151343239,114317
1,ENSG00000053371.8,19312144,chr1-19353379-T-G,rs214338,-1,T,G,19353379,41235,19115536,19508752,237843
1,ENSG00000142856.12,63523225,chr1-63378782-C-T,rs2179811,-1,C,T,63378782,144443,63326617,63719833,52165
1,ENSG00000142856.12,63523225,chr1-63378782-C-G,rs2179811,-1,C,G,63378782,144443,63326617,63719833,52165
1,ENSG00000134202.6,109741038,chr1-109714968-T-C,rs2229059,-1,T,C,109714968,26070,109544430,109937646,170538
1,ENSG00000134202.6,109741038,chr1-109714968-T-A,rs2229059,-1,T,A,109714968,26070,109544430,109937646,170538
1,ENSG00000169403.7,28176690,chr1-28236558-C-T,rs2232721,-1,C,T,28236558,59868,27980082,28373298,256476
1,ENSG00000213366.6,109668057,chr1-109736980-T-G,rs2234696,1,T,G,109736980,68923,109471449,109864665,265531
1,ENSG00000162836.6,147670524,chr1-147622086-A-G,rs2236570,-1,A,G,147622086,48438,147473916,147867132,148170
1,ENSG00000173171.9,155208695,chr1-155023027-G-A,rs2242193,1,G,A,155023027,185668,155012087,155405303,10940
1,ENSG00000117602.6,24502836,chr1-24319888-G-A,rs2247991,1,G,A,24319888,182948,24306228,24699444,13660
1,ENSG00000173641.12,16018043,chr1-15948752-C-T,rs2268341,-1,C,T,15948752,69291,15821435,16214651,127317
1,ENSG00000186510.6,16022036,chr1-15948752-C-T,rs2268341,1,C,T,15948752,73284,15825428,16218644,123324
1,ENSG00000049247.8,7853065,chr1-7898027-A-G,rs227157,-1,A,G,7898027,44962,7656457,8049673,241570
1,ENSG00000158286.8,6206119,chr1-6142185-G-A,rs2273032,1,G,A,6142185,63934,6009511,6402727,132674
1,ENSG00000117281.10,145719499,chr1-145899155-G-A,rs2274617,1,G,A,145899155,179656,145522891,145916107,376264
1,ENSG00000135823.9,181022870,chr1-181096671-G-A,rs2275470,-1,G,A,181096671,73801,180826262,181219478,270409
1,ENSG00000049246.8,7784291,chr1-7857497-T-C,rs228636,1,T,C,7857497,73206,7587683,7980899,269814
1,ENSG00000085998.9,46198434,chr1-46194623-T-C,rs2292487,-1,T,C,46194623,3811,46001826,46395042,192797
1,ENSG00000188290.6,1000097,chr1-1129422-T-C,rs2298216,-1,T,C,1129422,129325,803489,1196705,325933
1,ENSG00000162543.5,20186096,chr1-20360357-C-T,rs230172,1,C,T,20360357,174261,19989488,20382704,370869
1,ENSG00000135842.12,184974508,chr1-184929134-A-G,rs234686,-1,A,G,184929134,45374,184777900,185171116,151234
1,ENSG00000134242.11,113871712,chr1-113973095-G-A,rs2358996,-1,G,A,113973095,101383,113675104,114068320,297991
1,ENSG00000187010.13,25272509,chr1-25199424-A-G,rs2375113,1,A,G,25199424,73085,25075901,25469117,123523
1,ENSG00000162631.12,107141039,chr1-107122827-A-T,rs2464046,1,A,T,107122827,18212,106944431,107337647,178396
1,ENSG00000162512.11,30908758,chr1-30857334-T-C,rs2488233,-1,T,C,30857334,51424,30712150,31105366,145184
1,ENSG00000163393.8,115976513,chr1-115984447-G-A,rs2488432,1,G,A,115984447,7934,115779905,116173121,204542
1,ENSG00000215845.6,161038964,chr1-161044937-A-G,rs2516837,-1,A,G,161044937,5973,160842356,161235572,202581
1,ENSG00000143093.9,110034624,chr1-110216833-G-A,rs2603594,1,G,A,110216833,182209,109838016,110231232,378817
1,ENSG00000159363.13,17011928,chr1-17145076-C-T,rs2647151,-1,C,T,17145076,133148,16815320,17208536,329756
1,ENSG00000116761.7,70411268,chr1-70259461-A-C,rs269277,1,A,C,70259461,151807,70214660,70607876,44801
1,ENSG00000059588.5,234479179,chr1-234461946-C-T,rs270508,-1,C,T,234461946,17233,234282571,234675787,179375
1,ENSG00000116731.15,13700188,chr1-13868627-T-C,rs2744671,1,T,C,13868627,168439,13503580,13896796,365047
1,ENSG00000066185.8,42456022,chr1-42576454-A-G,rs2762697,-1,A,G,42576454,120432,42259414,42652630,317040
1,ENSG00000242485.1,1407293,chr1-1361685-C-T,rs2765023,-1,C,T,1361685,45608,1210685,1603901,151000
1,ENSG00000159352.10,151254734,chr1-151329383-G-C,rs2769275,1,G,C,151329383,74649,151058126,151451342,271257
1,ENSG00000116791.9,74733050,chr1-74811884-T-G,rs277385,-1,T,G,74811884,78834,74536442,74929658,275442
1,ENSG00000162729.8,160098619,chr1-159958269-A-G,rs2789426,-1,A,G,159958269,140350,159902011,160295227,56258
1,ENSG00000118200.10,200738893,chr1-200624877-C-T,rs2808257,1,C,T,200624877,114016,200542285,200935501,82592
1,ENSG00000183310.2,248574757,chr1-248413657-G-A,rs28483440,-1,G,A,248413657,161100,248378149,248771365,35508
1,ENSG00000196539.2,248473351,chr1-248413657-G-A,rs28483440,1,G,A,248413657,59694,248276743,248669959,136914
1,ENSG00000159388.5,203305519,chr1-203453530-G-T,rs28495422,1,G,T,203453530,148011,203108911,203502127,344619
1,ENSG00000184022.2,248597700,chr1-248482322-C-T,rs28625479,-1,C,T,248482322,115378,248401092,248794308,81230
1,ENSG00000117222.9,205121978,chr1-205300024-A-G,rs2864843,-1,A,G,205300024,178046,204925370,205318586,374654
1,ENSG00000174371.11,241848204,chr1-242033665-G-A,rs28649433,1,G,A,242033665,185461,241651596,242044812,382069
1,ENSG00000183814.10,226309164,chr1-226213058-C-T,rs2927340,-1,C,T,226213058,96106,226112556,226505772,100502
1,ENSG00000142920.11,33081153,chr1-33175655-C-T,rs2927970,1,C,T,33175655,94502,32884545,33277761,291110
1,ENSG00000117115.8,17119451,chr1-17226380-A-G,rs2977290,-1,A,G,17226380,106929,16922843,17316059,303537
1,ENSG00000126106.9,44674481,chr1-44700235-C-T,rs2983712,-1,C,T,44700235,25754,44477873,44871089,222362
1,ENSG00000155380.7,112956196,chr1-112881847-A-G,rs2996295,-1,A,G,112881847,74349,112759588,113152804,122259
1,ENSG00000143228.8,163321954,chr1-163369064-A-G,rs3010342,1,A,G,163369064,47110,163125346,163518562,243718
1,ENSG00000183726.6,25338334,chr1-25353751-C-T,rs3093621,1,C,T,25353751,15417,25141726,25534942,212025
1,ENSG00000116985.6,39788865,chr1-39968099-A-G,rs3103778,-1,A,G,39968099,179234,39592257,39985473,375842
1,ENSG00000132781.11,45339970,chr1-45340760-C-T,rs3219463,-1,C,T,45340760,790,45143362,45536578,197398
1,ENSG00000116299.11,109114115,chr1-108937665-G-A,rs338485,1,G,A,108937665,176450,108917507,109310723,20158
1,ENSG00000162576.10,1358555,chr1-1315577-G-A,rs34054191,-1,G,A,1315577,42978,1161947,1555163,153630
1,ENSG00000204160.5,26826688,chr1-26877692-T-C,rs34204245,1,T,C,26877692,51004,26630080,27023296,247612
1,ENSG00000116489.8,112619832,chr1-112512037-C-T,rs351370,1,C,T,112512037,107795,112423224,112816440,88813
1,ENSG00000143457.5,150697154,chr1-150575462-G-A,rs35392872,-1,G,A,150575462,121692,150500546,150893762,74916
1,ENSG00000116514.11,32964809,chr1-32882841-G-A,rs35452140,-1,G,A,32882841,81968,32768201,33161417,114640
1,ENSG00000177181.9,42380792,chr1-42402289-A-G,rs35665433,1,A,G,42402289,21497,42184184,42577400,218105
1,ENSG00000117262.14,145607988,chr1-145603903-T-C,rs35724622,1,T,C,145603903,4085,145411380,145804596,192523
1,ENSG00000187634.6,923923,chr1-1004823-G-A,rs35940137,1,G,A,1004823,80900,727315,1120531,277508
1,ENSG00000186205.8,220786913,chr1-220707328-A-G,rs369049,1,A,G,220707328,79585,220590305,220983521,117023
1,ENSG00000143333.6,182604389,chr1-182586901-A-G,rs3738579,-1,A,G,182586901,17488,182407781,182800997,179120
1,ENSG00000156097.7,109539872,chr1-109610399-A-G,rs3738765,1,A,G,109610399,70527,109343264,109736480,267135
1,ENSG00000184678.8,149886682,chr1-149943855-G-A,rs3754041,-1,G,A,149943855,57173,149690074,150083290,253781
1,ENSG00000116977.13,236523982,chr1-236557433-A-T,rs3754246,1,A,T,236557433,33451,236327374,236720590,230059
1,ENSG00000116977.13,236523982,chr1-236557433-A-C,rs3754246,1,A,C,236557433,33451,236327374,236720590,230059
1,ENSG00000162552.8,22143097,chr1-22207749-C-T,rs3765340,-1,C,T,22207749,64652,21946489,22339705,261260
1,ENSG00000122176.8,203351122,chr1-203224133-T-C,rs3766539,-1,T,C,203224133,126989,203154514,203547730,69619
1,ENSG00000143742.8,225777826,chr1-225886673-C-A,rs3766941,1,C,A,225886673,108847,225581218,225974434,305455
1,ENSG00000117013.10,40783787,chr1-40823907-C-T,rs3767939,1,C,T,40823907,40120,40587179,40980395,236728
1,ENSG00000154358.14,228208044,chr1-228288665-G-T,rs3795789,1,G,T,228288665,80621,228011436,228404652,277229
1,ENSG00000203705.5,212791894,chr1-212920399-C-T,rs3816954,1,C,T,212920399,128505,212595286,212988502,325113
1,ENSG00000132879.9,11654877,chr1-11663463-A-G,rs3820340,1,A,G,11663463,8586,11458269,11851485,205194
1,ENSG00000135828.6,182589256,chr1-182523452-A-G,rs3843287,-1,A,G,182523452,65804,182392648,182785864,130804
1,ENSG00000134201.5,109712251,chr1-109640399-G-T,rs3850616,1,G,T,109640399,71852,109515643,109908859,124756
1,ENSG00000117480.10,46394317,chr1-46377544-T-C,rs3863641,1,T,C,46377544,16773,46197709,46590925,179835
1,ENSG00000133055.4,203175826,chr1-203104668-A-C,rs3898276,-1,A,C,203104668,71158,202979218,203372434,125450
1,ENSG00000181817.5,36397908,chr1-36480991-A-G,rs3917920,-1,A,G,36480991,83083,36201300,36594516,279691
1,ENSG00000188931.3,161367876,chr1-161389038-T-C,rs3934593,-1,T,C,161389038,21162,161171268,161564484,217770
1,ENSG00000189409.7,1632173,chr1-1680672-C-T,rs4074197,1,C,T,1680672,48499,1435565,1828781,245107
1,ENSG00000149527.10,2476289,chr1-2605633-C-T,rs4074787,1,C,T,2605633,129344,2279681,2672897,325952
1,ENSG00000197530.8,1615500,chr1-1601796-A-C,rs4075469,1,A,C,1601796,13704,1418892,1812108,182904
1,ENSG00000143450.9,151766655,chr1-151729587-A-G,rs41263712,1,A,G,151729587,37068,151570047,151963263,159540
1,ENSG00000160678.7,153628434,chr1-153630077-C-T,rs41265183,1,C,T,153630077,1643,153431826,153825042,198251
1,ENSG00000143418.14,150974835,chr1-151060221-G-T,rs41266624,-1,G,T,151060221,85386,150778227,151171443,281994
1,ENSG00000142632.10,16212652,chr1-16206003-G-A,rs41269185,-1,G,A,16206003,6649,16016044,16409260,189959
1,ENSG00000158477.6,158254424,chr1-158393029-G-A,rs41447746,1,G,A,158393029,138605,158057816,158451032,335213
1,ENSG00000158477.6,158254424,chr1-158393029-G-T,rs41447746,1,G,T,158393029,138605,158057816,158451032,335213
1,ENSG00000143341.7,185734391,chr1-185539483-T-C,rs41456644,1,T,C,185539483,194908,185537783,185930999,1700
1,ENSG00000203724.6,197902630,chr1-197907973-A-G,rs4147201,1,A,G,197907973,5343,197706022,198099238,201951
1,ENSG00000162390.12,54548228,chr1-54571211-A-G,rs41503150,1,A,G,54571211,22983,54351620,54744836,219591
1,ENSG00000169504.9,24745447,chr1-24694690-G-A,rs4233039,1,G,A,24694690,50757,24548839,24942055,145851
1,ENSG00000171161.7,248838224,chr1-248789037-G-A,rs4281354,1,G,A,248789037,49187,248641616,249034832,147421
1,ENSG00000185220.7,248906235,chr1-248789037-G-A,rs4281354,1,G,A,248789037,117198,248709627,249102843,79410
1,ENSG00000118733.11,101996926,chr1-102072324-G-A,rs4326642,-1,G,A,102072324,75398,101800318,102193534,272006
1,ENSG00000198700.5,201829157,chr1-202001434-T-C,rs4332408,1,T,C,202001434,172277,201632549,202025765,368885
1,ENSG00000189171.8,153627505,chr1-153770841-G-A,rs4345834,-1,G,A,153770841,143336,153430897,153824113,339944
1,ENSG00000185436.7,24187289,chr1-24089569-T-C,rs4393101,-1,T,C,24089569,97720,23990681,24383897,98888
1,ENSG00000185436.7,24187289,chr1-24089569-T-A,rs4393101,-1,T,A,24089569,97720,23990681,24383897,98888
1,ENSG00000204060.4,41361931,chr1-41439678-G-A,rs4397649,1,G,A,41439678,77747,41165323,41558539,274355
1,ENSG00000125703.8,62784132,chr1-62801139-G-A,rs4409690,1,G,A,62801139,17007,62587524,62980740,213615
1,ENSG00000123836.10,207053275,chr1-207120435-C-T,rs4425986,1,C,T,207120435,67160,206856667,207249883,263768
1,ENSG00000132763.9,45500300,chr1-45635651-C-T,rs4431884,1,C,T,45635651,135351,45303692,45696908,331959
1,ENSG00000027869.7,156816848,chr1-156743720-C-T,rs4437869,-1,C,T,156743720,73128,156620240,157013456,123480
1,ENSG00000169885.5,1915260,chr1-2068898-G-A,rs4454477,1,G,A,2068898,153638,1718652,2111868,350246
1,ENSG00000158864.7,161202367,chr1-161219923-C-T,rs4489574,1,C,T,161219923,17556,161005759,161398975,214164
1,ENSG00000142765.12,27342022,chr1-27363272-C-T,rs4525067,1,C,T,27363272,21250,27145414,27538630,217858
1,ENSG00000143126.6,109249539,chr1-109251630-T-C,rs454107,1,T,C,109251630,2091,109052931,109446147,198699
1,ENSG00000067606.11,2050411,chr1-1949922-C-T,rs4648597,1,C,T,1949922,100489,1853803,2247019,96119
1,ENSG00000189339.7,1692795,chr1-1586425-A-G,rs4648786,-1,A,G,1586425,106370,1496187,1889403,90238
1,ENSG00000142676.8,23691806,chr1-23696642-G-A,rs4649111,1,G,A,23696642,4836,23495198,23888414,201444
1,ENSG00000142676.8,23691806,chr1-23696642-G-T,rs4649111,1,G,T,23696642,4836,23495198,23888414,201444
1,ENSG00000214193.5,36306368,chr1-36382165-T-C,rs4653184,1,T,C,36382165,75797,36109760,36502976,272405
1,ENSG00000122223.8,160862887,chr1-160861258-G-A,rs4656942,-1,G,A,160861258,1629,160666279,161059495,194979
1,ENSG00000010072.10,231338293,chr1-231210440-G-A,rs4658872,1,G,A,231210440,127853,231141685,231534901,68755
1,ENSG00000163382.6,156591776,chr1-156626874-A-G,rs4661055,1,A,G,156626874,35098,156395168,156788384,231706
1,ENSG00000143314.8,156741088,chr1-156839414-G-A,rs4661229,-1,G,A,156839414,98326,156544480,156937696,294934
1,ENSG00000116809.6,15976101,chr1-15956281-G-C,rs4661346,-1,G,C,15956281,19820,15779493,16172709,176788
1,ENSG00000132881.5,16237183,chr1-16252575-C-T,rs4661729,-1,C,T,16252575,15392,16040575,16433791,212000
1,ENSG00000168159.7,228487382,chr1-228413937-T-C,rs472594,1,T,C,228413937,73445,228290774,228683990,123163
1,ENSG00000168159.7,228487382,chr1-228413937-T-G,rs472594,1,T,G,228413937,73445,228290774,228683990,123163
1,ENSG00000028137.11,12166991,chr1-12186118-C-T,rs474247,1,C,T,12186118,19127,11970383,12363599,215735
1,ENSG00000116981.3,39672107,chr1-39687469-T-C,rs477913,-1,T,C,39687469,15362,39475499,39868715,211970
1,ENSG00000130940.9,10796646,chr1-10707322-G-A,rs4845952,-1,G,A,10707322,89324,10600038,10993254,107284
1,ENSG00000170989.7,101237019,chr1-101345005-T-C,rs4907936,1,T,C,101345005,107986,101040411,101433627,304594
1,ENSG00000130768.8,27935000,chr1-27946505-T-G,rs4908379,1,T,G,27946505,11505,27738392,28131608,208113
1,ENSG00000162408.10,6554513,chr1-6579787-G-T,rs4908932,-1,G,T,6579787,25274,6357905,6751121,221882
1,ENSG00000134644.10,31065717,chr1-30874552-C-T,rs4949184,-1,C,T,30874552,191165,30869109,31262325,5443
1,ENSG00000172339.7,95072951,chr1-95251198-A-G,rs4949946,-1,A,G,95251198,178247,94876343,95269559,374855
1,ENSG00000117650.8,211675621,chr1-211639668-C-A,rs4951541,-1,C,A,211639668,35953,211479013,211872229,160655
1,ENSG00000123685.4,212699840,chr1-212757873-T-C,rs4951638,-1,T,C,212757873,58033,212503232,212896448,254641
1,ENSG00000197622.7,151059622,chr1-151131602-C-T,rs4971004,-1,C,T,151131602,71980,150863014,151256230,268588
1,ENSG00000000460.11,169795040,chr1-169699307-C-G,rs4987347,1,C,G,169699307,95733,169598432,169991648,100875
1,ENSG00000134690.6,37692516,chr1-37689201-A-G,rs507667,1,A,G,37689201,3315,37495908,37889124,193293
1,ENSG00000162377.4,52698347,chr1-52871065-C-T,rs514881,-1,C,T,52871065,172718,52501739,52894955,369326
1,ENSG00000143028.7,109466546,chr1-109595914-T-A,rs559479,1,T,A,109595914,129368,109269938,109663154,325976
1,ENSG00000142686.6,35718884,chr1-35866901-A-G,rs56183947,-1,A,G,35866901,148017,35522276,35915492,344625
1,ENSG00000085465.10,111427735,chr1-111414970-A-G,rs56294468,-1,A,G,111414970,12765,111231127,111624343,183843
1,ENSG00000069275.11,205750182,chr1-205668531-T-C,rs57021717,-1,T,C,205668531,81651,205553574,205946790,114957
1,ENSG00000116133.6,54887195,chr1-54808791-A-C,rs585802,-1,A,C,54808791,78404,54690587,55083803,118204
1,ENSG00000182866.11,32251265,chr1-32233626-T-C,rs587707,1,T,C,32233626,17639,32054657,32447873,178969
1,ENSG00000158825.5,20589097,chr1-20588925-C-G,rs603412,1,C,G,20588925,172,20392489,20785705,196436
1,ENSG00000243480.3,103617427,chr1-103803865-G-A,rs60555558,1,G,A,103803865,186438,103420819,103814035,383046
1,ENSG00000203666.8,244969682,chr1-245055752-G-A,rs611185,1,G,A,245055752,86070,244773074,245166290,282678
1,ENSG00000243710.3,43172330,chr1-43216790-G-A,rs613956,1,G,A,43216790,44460,42975722,43368938,241068
1,ENSG00000090432.5,20508151,chr1-20535613-G-A,rs616145,-1,G,A,20535613,27462,20311543,20704759,224070
1,ENSG00000117595.6,209806142,chr1-209828241-A-G,rs616227,-1,A,G,209828241,22099,209609534,210002750,218707
1,ENSG00000169914.5,19882395,chr1-19920383-C-T,rs61729970,1,C,T,19920383,37988,19685787,20079003,234596
1,ENSG00000198912.6,3900272,chr1-3832551-T-C,rs61768915,-1,T,C,3832551,67721,3703664,4096880,128887
1,ENSG00000164008.7,42767249,chr1-42863789-G-T,rs61777677,1,G,T,42863789,96540,42570641,42963857,293148
1,ENSG00000116497.13,32817653,chr1-32763526-A-G,rs61798841,1,A,G,32763526,54127,32621045,33014261,142481
1,ENSG00000072694.13,161663143,chr1-161710728-T-A,rs61801161,1,T,A,161710728,47585,161466535,161859751,244193
1,ENSG00000225556.1,151840557,chr1-151889857-G-A,rs61817692,-1,G,A,151889857,49300,151643949,152037165,245908
1,ENSG00000118454.8,70354722,chr1-70511646-A-G,rs620247,-1,A,G,70511646,156924,70158114,70551330,353532
1,ENSG00000142910.9,31576515,chr1-31568644-A-C,rs6425775,1,A,C,31568644,7871,31379907,31773123,188737
1,ENSG00000235169.3,3772749,chr1-3959177-T-C,rs6426393,1,T,C,3959177,186428,3576141,3969357,383036
1,ENSG00000143178.7,168280877,chr1-168305453-C-T,rs6427122,1,C,T,168305453,24576,168084269,168477485,221184
1,ENSG00000158796.10,161132667,chr1-161266666-A-G,rs6427580,-1,A,G,161266666,133999,160936059,161329275,330607
1,ENSG00000162885.6,235504452,chr1-235447778-A-G,rs6429094,-1,A,G,235447778,56674,235307844,235701060,139934
1,ENSG00000168765.10,109656099,chr1-109672556-A-G,rs655315,1,A,G,109672556,16457,109459491,109852707,213065
1,ENSG00000142875.13,84144271,chr1-84263187-C-A,rs655849,1,C,A,84263187,118916,83947663,84340879,315524
1,ENSG00000143443.8,151047751,chr1-151164668-A-G,rs6587557,1,A,G,151164668,116917,150851143,151244359,313525
1,ENSG00000122481.12,95234210,chr1-95316977-C-T,rs6593652,1,C,T,95316977,82767,95037602,95430818,279375
1,ENSG00000133065.6,205813198,chr1-205693209-A-C,rs6593964,-1,A,C,205693209,119989,205616590,206009806,76619
1,ENSG00000000938.7,27635185,chr1-27656792-A-G,rs6598892,-1,A,G,27656792,21607,27438577,27831793,218215
1,ENSG00000154511.6,92961462,chr1-92979860-C-A,rs660870,-1,C,A,92979860,18398,92764854,93158070,215006
1,ENSG00000175087.5,26111824,chr1-26060369-G-A,rs6656100,1,G,A,26060369,51455,25915216,26308432,145153
1,ENSG00000188786.7,37859592,chr1-37676729-T-C,rs6656571,-1,T,C,37676729,182863,37662984,38056200,13745
1,ENSG00000251503.2,10430435,chr1-10451532-T-C,rs666103,1,T,C,10451532,21097,10233827,10627043,217705
1,ENSG00000162769.7,212858275,chr1-212924599-C-A,rs6663614,1,C,A,212924599,66324,212661667,213054883,262932
1,ENSG00000162769.7,212858275,chr1-212924599-C-T,rs6663614,1,C,T,212924599,66324,212661667,213054883,262932
1,ENSG00000143624.9,153728050,chr1-153677532-C-T,rs6665473,1,C,T,153677532,50518,153531442,153924658,146090
1,ENSG00000168509.13,146021735,chr1-146006703-C-A,rs6669494,-1,C,A,146006703,15032,145825127,146218343,181576
1,ENSG00000171502.10,86156772,chr1-86101161-T-C,rs6670074,-1,T,C,86101161,55611,85960164,86353380,140997
1,ENSG00000186086.11,108450343,chr1-108330898-T-A,rs6670322,1,T,A,108330898,119445,108253735,108646951,77163
1,ENSG00000176022.3,1232237,chr1-1177602-C-T,rs6671609,1,C,T,1177602,54635,1035629,1428845,141973
1,ENSG00000117751.12,27830782,chr1-27858814-T-C,rs6672956,1,T,C,27858814,28032,27634174,28027390,224640
1,ENSG00000131778.12,147242684,chr1-147423187-C-T,rs6674207,1,C,T,147423187,180503,147046076,147439292,377111
1,ENSG00000007968.6,23531233,chr1-23372471-G-A,rs6679292,-1,G,A,23372471,158762,23334625,23727841,37846
1,ENSG00000160710.11,154608186,chr1-154738750-C-A,rs6682000,-1,C,A,154738750,130564,154411578,154804794,327172
1,ENSG00000162645.8,89126114,chr1-89024180-T-C,rs6682966,-1,T,C,89024180,101934,88929506,89322722,94674
1,ENSG00000143494.11,212950541,chr1-212796654-A-C,rs6684313,1,A,C,212796654,153887,212753933,213147149,42721
1,ENSG00000183856.6,156572565,chr1-156386688-G-A,rs6686886,-1,G,A,156386688,185877,156375957,156769173,10731
1,ENSG00000143507.12,221742089,chr1-221733140-C-G,rs6689267,-1,C,G,221733140,8949,221545481,221938697,187659
1,ENSG00000132128.11,46303616,chr1-46292588-T-C,rs6692339,-1,T,C,46292588,11028,46107008,46500224,185580
1,ENSG00000187583.5,966482,chr1-967724-C-T,rs6696281,1,C,T,967724,1242,769874,1163090,197850
1,ENSG00000169991.5,18956676,chr1-18779086-G-T,rs6697715,-1,G,T,18779086,177590,18760068,19153284,19018
1,ENSG00000160714.5,154558662,chr1-154610494-A-G,rs6699825,-1,A,G,154610494,51832,154362054,154755270,248440
1,ENSG00000160714.5,154558662,chr1-154610494-A-C,rs6699825,-1,A,C,154610494,51832,154362054,154755270,248440
1,ENSG00000168679.13,110391026,chr1-110526711-T-G,rs6700661,-1,T,G,110526711,135685,110194418,110587634,332293
1,ENSG00000171960.6,42658423,chr1-42757818-C-T,rs6700677,1,C,T,42757818,99395,42461815,42855031,296003
1,ENSG00000168275.9,234373456,chr1-234371254-A-C,rs6702834,1,A,C,234371254,2202,234176848,234570064,194406
1,ENSG00000123091.4,51236273,chr1-51333468-G-A,rs67994022,1,G,A,51333468,97195,51039665,51432881,293803
1,ENSG00000055732.7,85048500,chr1-84952096-G-A,rs679961,-1,G,A,84952096,96404,84851892,85245108,100204
1,ENSG00000197982.10,37807790,chr1-37683093-A-G,rs684260,1,A,G,37683093,124697,37611182,38004398,71911
1,ENSG00000119285.6,236604516,chr1-236701314-G-A,rs707217,-1,G,A,236701314,96798,236407908,236801124,293406
1,ENSG00000120949.10,12063303,chr1-12095014-C-G,rs72641068,1,C,G,12095014,31711,11866695,12259911,228319
1,ENSG00000188672.10,25420825,chr1-25257119-C-G,rs72660908,-1,C,G,25257119,163706,25224217,25617433,32902
1,ENSG00000116824.4,116754430,chr1-116582831-G-A,rs72697343,1,G,A,116582831,171599,116557822,116951038,25009
1,ENSG00000213190.2,151060397,chr1-151035878-C-T,rs72706550,1,C,T,151035878,24519,150863789,151257005,172089
1,ENSG00000188558.4,248508073,chr1-248409872-A-G,rs72766997,1,A,G,248409872,98201,248311465,248704681,98407
1,ENSG00000162714.7,247331867,chr1-247375316-C-T,rs72771953,-1,C,T,247375316,43449,247135259,247528475,240057
1,ENSG00000162714.7,247331867,chr1-247375316-C-A,rs72771953,-1,C,A,247375316,43449,247135259,247528475,240057
1,ENSG00000107404.12,1349418,chr1-1174402-G-A,rs72894004,-1,G,A,1174402,175016,1152810,1546026,21592
1,ENSG00000117519.11,94927110,chr1-95074006-C-T,rs74103646,-1,C,T,95074006,146896,94730502,95123718,343504
1,ENSG00000117697.10,212791777,chr1-212625697-G-A,rs74138590,-1,G,A,212625697,166080,212595169,212988385,30528
1,ENSG00000177674.10,11736136,chr1-11722757-G-A,rs7414943,1,G,A,11722757,13379,11539528,11932744,183229
1,ENSG00000135778.6,232950611,chr1-232960639-G-T,rs74230943,1,G,T,232960639,10028,232754003,233147219,206636
1,ENSG00000162894.7,206921941,chr1-206912849-T-G,rs749860,-1,T,G,206912849,9092,206725333,207118549,187516
1,ENSG00000173614.9,9943475,chr1-9952956-A-C,rs7516611,1,A,C,9952956,9481,9746867,10140083,206089
1,ENSG00000173614.9,9943475,chr1-9952956-A-G,rs7516611,1,A,G,9952956,9481,9746867,10140083,206089
1,ENSG00000067208.8,92785108,chr1-92969168-G-A,rs7517539,-1,G,A,92969168,184060,92588500,92981716,380668
1,ENSG00000240563.1,62194849,chr1-62198115-C-T,rs7518470,1,C,T,62198115,3266,61998241,62391457,199874
1,ENSG00000117054.8,75724709,chr1-75558175-G-T,rs7518629,1,G,T,75558175,166534,75528101,75921317,30074
1,ENSG00000117054.8,75724709,chr1-75558175-G-A,rs7518629,1,G,A,75558175,166534,75528101,75921317,30074
1,ENSG00000170128.2,200872981,chr1-200758745-A-G,rs7519005,1,A,G,200758745,114236,200676373,201069589,82372
1,ENSG00000132185.12,161707229,chr1-161725849-G-T,rs7520519,1,G,T,161725849,18620,161510621,161903837,215228
1,ENSG00000067704.8,220094132,chr1-220172518-C-T,rs7527410,1,C,T,220172518,78386,219897524,220290740,274994
1,ENSG00000162704.10,183635783,chr1-183823661-A-G,rs7531289,-1,A,G,183823661,187878,183439175,183832391,384486
1,ENSG00000143554.9,153775407,chr1-153688513-A-G,rs7533987,1,A,G,153688513,86894,153578799,153972015,109714
1,ENSG00000118197.8,200669907,chr1-200703571-A-G,rs7535122,-1,A,G,200703571,33664,200473299,200866515,230272
1,ENSG00000010932.11,171248494,chr1-171235824-G-A,rs7536822,1,G,A,171235824,12670,171051886,171445102,183938
1,ENSG00000117016.5,40665682,chr1-40566387-G-A,rs7537003,-1,G,A,40566387,99295,40469074,40862290,97313
1,ENSG00000074800.8,8878686,chr1-8951478-G-A,rs7540307,-1,G,A,8951478,72792,8682078,9075294,269400
1,ENSG00000197956.4,153535991,chr1-153699771-G-T,rs7541193,-1,G,T,153699771,163780,153339383,153732599,360388
1,ENSG00000196878.7,209652425,chr1-209660101-T-C,rs7542165,-1,T,C,209660101,7676,209455817,209849033,204284
1,ENSG00000187961.7,960584,chr1-1155177-A-C,rs7553429,1,A,C,1155177,194593,763976,1157192,391201
1,ENSG00000058453.11,16921931,chr1-17030501-A-G,rs7554763,1,A,G,17030501,108570,16725323,17118539,305178
1,ENSG00000162385.6,53238518,chr1-53076267-G-A,rs756052,-1,G,A,53076267,162251,53041910,53435126,34357
1,ENSG00000131584.13,1307930,chr1-1247525-G-A,rs75668831,-1,G,A,1247525,60405,1111322,1504538,136203
1,ENSG00000182749.5,25875708,chr1-25811645-C-A,rs760598,-1,C,A,25811645,64063,25679100,26072316,132545
1,ENSG00000127463.8,19251524,chr1-19353625-C-T,rs761308,-1,C,T,19353625,102101,19054916,19448132,298709
1,ENSG00000075391.11,178094104,chr1-178160818-G-A,rs76233263,1,G,A,178160818,66714,177897496,178290712,263322
1,ENSG00000157881.8,2526596,chr1-2513514-C-T,rs76591030,-1,C,T,2513514,13082,2329988,2723204,183526
1,ENSG00000143110.7,111473984,chr1-111466408-A-C,rs76940009,1,A,C,111466408,7576,111277376,111670592,189032
1,ENSG00000169972.7,1308597,chr1-1184166-G-T,rs77051049,1,G,T,1184166,124431,1111989,1505205,72177
1,ENSG00000169972.7,1308597,chr1-1184166-G-A,rs77051049,1,G,A,1184166,124431,1111989,1505205,72177
1,ENSG00000120948.10,11012654,chr1-11134817-G-A,rs77086655,1,G,A,11134817,122163,10816046,11209262,318771
1,ENSG00000117500.7,93180413,chr1-93348442-G-A,rs771463,-1,G,A,93348442,168029,92983805,93377021,364637
1,ENSG00000179403.10,1435690,chr1-1565709-G-A,rs77167259,1,G,A,1565709,130019,1239082,1632298,326627
1,ENSG00000121903.8,33472645,chr1-33379185-C-T,rs77782749,1,C,T,33379185,93460,33276037,33669253,103148
1,ENSG00000082512.10,211326833,chr1-211392298-A-G,rs784377,1,A,G,211392298,65465,211130225,211523441,262073
1,ENSG00000253304.1,29123903,chr1-29072596-A-C,rs78656686,-1,A,C,29072596,51307,28927295,29320511,145301
1,ENSG00000169418.7,153678688,chr1-153816674-C-A,rs78740769,1,C,A,153816674,137986,153482080,153875296,334594
1,ENSG00000043514.9,39883504,chr1-39826792-C-T,rs79316541,-1,C,T,39826792,56712,39686896,40080112,139896
1,ENSG00000116771.5,15585051,chr1-15741215-C-T,rs79757554,-1,C,T,15741215,156164,15388443,15781659,352772
1,ENSG00000186197.7,236394286,chr1-236255310-C-T,rs79779531,1,C,T,236255310,138976,236197678,236590894,57632
1,ENSG00000160685.9,155002802,chr1-154863968-C-A,rs79810698,1,C,A,154863968,138834,154806194,155199410,57774
1,ENSG00000158062.13,26306636,chr1-26402358-G-A,rs79954464,-1,G,A,26402358,95722,26110028,26503244,292330
1,ENSG00000158747.9,19644311,chr1-19665879-G-T,rs8192529,1,G,T,19665879,21568,19447703,19840919,218176
1,ENSG00000143622.5,155911349,chr1-155880767-T-C,rs822508,-1,T,C,155880767,30582,155714741,156107957,166026
1,ENSG00000090686.11,21783149,chr1-21606700-C-T,rs829370,-1,C,T,21606700,176449,21586541,21979757,20159
1,ENSG00000121851.8,145964690,chr1-145983931-G-C,rs833941,1,G,C,145983931,19241,145768082,146161298,215849
1,ENSG00000133069.10,205227946,chr1-205053886-G-A,rs895932,1,G,A,205053886,174060,205031338,205424554,22548
1,ENSG00000142794.11,21440137,chr1-21489167-C-T,rs904927,1,C,T,21489167,49030,21243529,21636745,245638
1,ENSG00000135845.4,172444069,chr1-172333404-C-A,rs911713,-1,C,A,172333404,110665,172247461,172640677,85943
1,ENSG00000135845.4,172444069,chr1-172333404-C-T,rs911713,-1,C,T,172333404,110665,172247461,172640677,85943
1,ENSG00000116199.7,179025894,chr1-179085557-T-G,rs912758,1,T,G,179085557,59663,178829286,179222502,256271
1,ENSG00000143198.7,165631234,chr1-165631529-A-G,rs9333372,1,A,G,165631529,295,165434626,165827842,196903
1,ENSG00000084636.11,31704017,chr1-31571326-T-C,rs9425884,-1,T,C,31571326,132691,31507409,31900625,63917
1,ENSG00000176261.10,32650550,chr1-32566811-G-T,rs9425886,-1,G,T,32566811,83739,32453942,32847158,112869
1,ENSG00000143321.13,156751675,chr1-156748409-A-G,rs9426941,-1,A,G,156748409,3266,156555067,156948283,193342
1,ENSG00000169242.7,155127876,chr1-155040566-C-T,rs9427170,1,C,T,155040566,87310,154931268,155324484,109298
1,ENSG00000049239.7,9234774,chr1-9232223-G-A,rs9434723,1,G,A,9232223,2551,9038166,9431382,194057
1,ENSG00000116678.14,65420668,chr1-65430244-T-C,rs9436301,1,T,C,65430244,9576,65224060,65617276,206184
1,ENSG00000228594.1,1600135,chr1-1688328-C-T,rs9442411,-1,C,T,1688328,88193,1403527,1796743,284801
1,ENSG00000198821.6,167518529,chr1-167433975-G-A,rs952963,-1,G,A,167433975,84554,167321921,167715137,112054
1,ENSG00000198821.6,167518529,chr1-167433975-G-C,rs952963,-1,G,C,167433975,84554,167321921,167715137,112054
1,ENSG00000159348.8,202967257,chr1-203099592-T-C,rs9660662,-1,T,C,203099592,132335,202770649,203163865,328943
1,ENSG00000116983.7,39691433,chr1-39684484-G-A,rs9662128,-1,G,A,39684484,6949,39494825,39888041,189659
1,ENSG00000117481.5,46340807,chr1-46256717-A-G,rs9793263,1,A,G,46256717,84090,46144199,46537415,112518
1,ENSG00000171357.5,46203334,chr1-46256717-A-G,rs9793263,1,A,G,46256717,53383,46006726,46399942,249991
1,ENSG00000085491.11,108200343,chr1-108033645-C-A,rs9803640,-1,C,A,108033645,166698,108003735,108396951,29910
1,ENSG00000198830.6,26472440,chr1-26579076-A-G,rs998235,1,A,G,26579076,106636,26275832,26669048,303244
