Chromosome,GENE,Transcription start site (TSS),Variant,rsID,Strand,REF,ALT,PHYSICAL,distance_from_TSS,enformer_start,enformer_end,variant_pos_in_window
22,ENSG00000230107.1,42438023,22-42439721-C-T,rs1016109,1,C,T,42439721,1698,42241415,42634631,198306
22,ENSG00000133519.8,23402157,22-23359943-T-C,rs10427608,-1,T,C,23359943,42214,23205549,23598765,154394
22,ENSG00000225335.1,18078884,22-17885381-C-T,rs1076113,-1,C,T,17885381,193503,17882276,18275492,3105
22,ENSG00000235111.1,49615716,22-49648735-T-C,rs1107514,-1,T,C,49648735,33019,49419108,49812324,229627
22,ENSG00000100068.7,25405274,22-25385472-T-G,rs111824621,-1,T,G,25385472,19802,25208666,25601882,176806
22,ENSG00000100068.7,25405274,22-25385472-T-C,rs111824621,-1,T,C,25385472,19802,25208666,25601882,176806
22,ENSG00000226085.2,39875289,22-40004160-G-A,rs117035363,1,G,A,40004160,128871,39678681,40071897,325479
22,ENSG00000226085.2,39875289,22-40004160-G-C,rs117035363,1,G,C,40004160,128871,39678681,40071897,325479
22,ENSG00000188511.8,49657504,22-49660742-C-T,rs11705166,-1,C,T,49660742,3238,49460896,49854112,199846
22,ENSG00000188511.8,49657504,22-49660742-C-A,rs11705166,-1,C,A,49660742,3238,49460896,49854112,199846
22,ENSG00000237214.2,41064052,22-40950641-T-C,rs117912353,1,T,C,40950641,113411,40867444,41260660,83197
22,ENSG00000249590.3,30409262,22-30417826-G-A,rs11913990,1,G,A,30417826,8564,30212654,30605870,205172
22,ENSG00000260708.1,46762564,22-46762282-G-A,rs12389,-1,G,A,46762282,282,46565956,46959172,196326
22,ENSG00000249310.2,38998209,22-38962032-A-G,rs12628403,-1,A,G,38962032,36177,38801601,39194817,160431
22,ENSG00000249310.2,38998209,22-38962032-A-C,rs12628403,-1,A,C,38962032,36177,38801601,39194817,160431
22,ENSG00000205559.3,50586873,22-50586195-T-C,rs131749,1,T,C,50586195,678,50390265,50783481,195930
22,ENSG00000184208.10,41690628,22-41507809-A-C,rs137831,1,A,C,41507809,182819,41494020,41887236,13789
22,ENSG00000244627.1,38384096,22-38393931-G-A,rs138366,-1,G,A,38393931,9835,38187488,38580704,206443
22,ENSG00000235513.1,41228500,22-41231539-T-A,rs139484,-1,T,A,41231539,3039,41031892,41425108,199647
22,ENSG00000235513.1,41228500,22-41231539-T-G,rs139484,-1,T,G,41231539,3039,41031892,41425108,199647
22,ENSG00000234630.1,22293733,22-22379789-T-G,rs1477442,1,T,G,22379789,86056,22097125,22490341,282664
22,ENSG00000232710.1,42139927,22-42216290-C-T,rs17386314,-1,C,T,42216290,76363,41943319,42336535,272971
22,ENSG00000232710.1,42139927,22-42216290-C-A,rs17386314,-1,C,A,42216290,76363,41943319,42336535,272971
22,ENSG00000226328.1,45163781,22-45175565-C-T,rs17548707,-1,C,T,45175565,11784,44967173,45360389,208392
22,ENSG00000185065.6,19447893,22-19470889-A-G,rs17811336,1,A,G,19470889,22996,19251285,19644501,219604
22,ENSG00000261251.1,43812456,22-43660823-A-C,rs2040400,1,A,C,43660823,151633,43615848,44009064,44975
22,ENSG00000261251.1,43812456,22-43660823-A-T,rs2040400,1,A,T,43660823,151633,43615848,44009064,44975
22,ENSG00000261251.1,43812456,22-43660823-A-G,rs2040400,1,A,G,43660823,151633,43615848,44009064,44975
22,ENSG00000237438.1,17044873,22-17076254-A-G,rs2041629,1,A,G,17076254,31381,16848265,17241481,227989
22,ENSG00000237438.1,17044873,22-17076254-A-T,rs2041629,1,A,T,17076254,31381,16848265,17241481,227989
22,ENSG00000215771.2,41190188,22-41225710-G-T,rs2179744,-1,G,T,41225710,35522,40993580,41386796,232130
22,ENSG00000215771.2,41190188,22-41225710-G-A,rs2179744,-1,G,A,41225710,35522,40993580,41386796,232130
22,ENSG00000161149.7,21014287,22-21009671-G-T,rs2239961,-1,G,T,21009671,4616,20817679,21210895,191992
22,ENSG00000161149.7,21014287,22-21009671-G-A,rs2239961,-1,G,A,21009671,4616,20817679,21210895,191992
22,ENSG00000235989.2,30922449,22-31096531-A-C,rs2240430,1,A,C,31096531,174082,30725841,31119057,370690
22,ENSG00000235954.2,27919421,22-27920185-G-A,rs2267128,1,G,A,27920185,764,27722813,28116029,197372
22,ENSG00000205853.5,32382106,22-32394657-A-C,rs2281035,-1,A,C,32394657,12551,32185498,32578714,209159
22,ENSG00000205853.5,32382106,22-32394657-A-T,rs2281035,-1,A,T,32394657,12551,32185498,32578714,209159
22,ENSG00000228274.1,38681860,22-38709943-T-C,rs2284073,-1,T,C,38709943,28083,38485252,38878468,224691
22,ENSG00000228274.1,38681860,22-38709943-T-G,rs2284073,-1,T,G,38709943,28083,38485252,38878468,224691
22,ENSG00000172250.10,42500671,22-42500468-T-G,rs2413692,1,T,G,42500468,203,42304063,42697279,196405
22,ENSG00000172250.10,42500671,22-42500468-T-A,rs2413692,1,T,A,42500468,203,42304063,42697279,196405
22,ENSG00000172250.10,42500671,22-42500468-T-C,rs2413692,1,T,C,42500468,203,42304063,42697279,196405
22,ENSG00000230513.1,21001886,22-21002535-G-A,rs28372939,1,G,A,21002535,649,20805278,21198494,197257
22,ENSG00000230513.1,21001886,22-21002535-G-C,rs28372939,1,G,C,21002535,649,20805278,21198494,197257
22,ENSG00000226471.1,28800683,22-28795944-A-G,rs35873774,1,A,G,28795944,4739,28604075,28997291,191869
22,ENSG00000197182.8,46053869,22-46058328-G-C,rs3744749,1,G,C,46058328,4459,45857261,46250477,201067
22,ENSG00000197182.8,46053869,22-46058328-G-A,rs3744749,1,G,A,46058328,4459,45857261,46250477,201067
22,ENSG00000182257.5,46054144,22-46058328-G-C,rs3744749,-1,G,C,46058328,4184,45857536,46250752,200792
22,ENSG00000182257.5,46054144,22-46058328-G-A,rs3744749,-1,G,A,46058328,4184,45857536,46250752,200792
22,ENSG00000241990.1,46053705,22-46058328-G-C,rs3744749,1,G,C,46058328,4623,45857097,46250313,201231
22,ENSG00000241990.1,46053705,22-46058328-G-A,rs3744749,1,G,A,46058328,4623,45857097,46250313,201231
22,ENSG00000215493.3,20450122,22-20565159-G-A,rs3791192,1,G,A,20565159,115037,20253514,20646730,311645
22,ENSG00000233739.1,38073940,22-38060591-A-C,rs3952,-1,A,C,38060591,13349,37877332,38270548,183259
22,ENSG00000233739.1,38073940,22-38060591-A-G,rs3952,-1,A,G,38060591,13349,37877332,38270548,183259
22,ENSG00000213790.2,42108953,22-42145327-G-C,rs4467371,-1,G,C,42145327,36374,41912345,42305561,232982
22,ENSG00000213790.2,42108953,22-42145327-G-A,rs4467371,-1,G,A,42145327,36374,41912345,42305561,232982
22,ENSG00000213888.2,31346777,22-31291327-A-T,rs4820044,1,A,T,31291327,55450,31150169,31543385,141158
22,ENSG00000213888.2,31346777,22-31291327-A-G,rs4820044,1,A,G,31291327,55450,31150169,31543385,141158
22,ENSG00000213888.2,31346777,22-31291327-A-C,rs4820044,1,A,C,31291327,55450,31150169,31543385,141158
22,ENSG00000182841.8,42582001,22-42510298-A-G,rs4820470,-1,A,G,42510298,71703,42385393,42778609,124905
22,ENSG00000235237.1,37166757,22-37204523-C-G,rs4821599,1,C,G,37204523,37766,36970149,37363365,234374
22,ENSG00000235237.1,37166757,22-37204523-C-A,rs4821599,1,C,A,37204523,37766,36970149,37363365,234374
22,ENSG00000261188.1,26512503,22-26505264-G-T,rs4822730,1,G,T,26505264,7239,26315895,26709111,189369
22,ENSG00000261188.1,26512503,22-26505264-G-A,rs4822730,1,G,A,26505264,7239,26315895,26709111,189369
22,ENSG00000261188.1,26512503,22-26505264-G-C,rs4822730,1,G,C,26505264,7239,26315895,26709111,189369
22,ENSG00000225720.2,39091586,22-39250417-A-G,rs56229619,1,A,G,39250417,158831,38894978,39288194,355439
22,ENSG00000226450.2,42155001,22-42120362-C-T,rs5751221,-1,C,T,42120362,34639,41958393,42351609,161969
22,ENSG00000225282.1,23926900,22-23924860-C-G,rs5751777,1,C,G,23924860,2040,23730292,24123508,194568
22,ENSG00000225282.1,23926900,22-23924860-C-A,rs5751777,1,C,A,23924860,2040,23730292,24123508,194568
22,ENSG00000225282.1,23926900,22-23924860-C-T,rs5751777,1,C,T,23924860,2040,23730292,24123508,194568
22,ENSG00000223704.1,26860553,22-26779895-G-A,rs5752413,1,G,A,26779895,80658,26663945,27057161,115950
22,ENSG00000223704.1,26860553,22-26779895-G-C,rs5752413,1,G,C,26779895,80658,26663945,27057161,115950
22,ENSG00000224086.3,21938293,22-21978846-C-T,rs5756306,1,C,T,21978846,40553,21741685,22134901,237161
22,ENSG00000205702.5,42144577,22-42288812-C-T,rs5758698,-1,C,T,42288812,144235,41947969,42341185,340843
22,ENSG00000211665.2,22747383,22-22661802-G-A,rs57625735,1,G,A,22661802,85581,22550775,22943991,111027
22,ENSG00000223730.1,44901592,22-44787665-T-C,rs5766013,1,T,C,44787665,113927,44704984,45098200,82681
22,ENSG00000223730.1,44901592,22-44787665-T-G,rs5766013,1,T,G,44787665,113927,44704984,45098200,82681
22,ENSG00000223730.1,44901592,22-44787665-T-A,rs5766013,1,T,A,44787665,113927,44704984,45098200,82681
22,ENSG00000254413.4,50579752,22-50631857-T-G,rs5770957,-1,T,G,50631857,52105,50383144,50776360,248713
22,ENSG00000254413.4,50579752,22-50631857-T-C,rs5770957,-1,T,C,50631857,52105,50383144,50776360,248713
22,ENSG00000254413.4,50579752,22-50631857-T-A,rs5770957,-1,T,A,50631857,52105,50383144,50776360,248713
22,ENSG00000223350.2,22343187,22-22457883-T-C,rs57849312,1,T,C,22457883,114696,22146579,22539795,311304
22,ENSG00000185837.3,17159351,22-17312122-G-A,rs5994253,1,G,A,17312122,152771,16962743,17355959,349379
22,ENSG00000185837.3,17159351,22-17312122-G-C,rs5994253,1,G,C,17312122,152771,16962743,17355959,349379
22,ENSG00000100058.7,25455712,22-25460264-C-T,rs6004658,1,C,T,25460264,4552,25259104,25652320,201160
22,ENSG00000238120.1,45620858,22-45531165-T-A,rs6006767,-1,T,A,45531165,89693,45424250,45817466,106915
22,ENSG00000238120.1,45620858,22-45531165-T-C,rs6006767,-1,T,C,45531165,89693,45424250,45817466,106915
22,ENSG00000237668.1,36421644,22-36566805-C-T,rs67656940,-1,C,T,36566805,145161,36225036,36618252,341769
22,ENSG00000233360.2,37658377,22-37668643-C-T,rs713835,-1,C,T,37668643,10266,37461769,37854985,206874
22,ENSG00000225528.1,39960397,22-39930170-A-G,rs713883,1,A,G,39930170,30227,39763789,40157005,166381
22,ENSG00000253239.1,22026076,22-22062249-T-C,rs7288332,1,T,C,22062249,36173,21829468,22222684,232781
22,ENSG00000235776.1,19792294,22-19848625-C-A,rs7288631,1,C,A,19848625,56331,19595686,19988902,252939
22,ENSG00000235776.1,19792294,22-19848625-C-T,rs7288631,1,C,T,19848625,56331,19595686,19988902,252939
22,ENSG00000230736.2,32376664,22-32362984-G-A,rs7289201,1,G,A,32362984,13680,32180056,32573272,182928
22,ENSG00000239435.1,16582707,22-16720766-T-A,rs73159852,-1,T,A,16720766,138059,16386099,16779315,334667
22,ENSG00000211644.2,22322472,22-22372843-G-T,rs738884,1,G,T,22372843,50371,22125864,22519080,246979
22,ENSG00000211644.2,22322472,22-22372843-G-A,rs738884,1,G,A,22372843,50371,22125864,22519080,246979
22,ENSG00000212939.2,49548681,22-49612430-C-T,rs763127,1,C,T,49612430,63749,49352073,49745289,260357
22,ENSG00000237015.1,29260889,22-29224187-G-A,rs78011494,1,G,A,29224187,36702,29064281,29457497,159906
22,ENSG00000232926.1,19887289,22-19882624-C-T,rs8141610,1,C,T,19882624,4665,19690681,20083897,191943
22,ENSG00000230319.1,43038585,22-43134694-G-C,rs872841,1,G,C,43134694,96109,42841977,43235193,292717
22,ENSG00000230319.1,43038585,22-43134694-G-A,rs872841,1,G,A,43134694,96109,42841977,43235193,292717
22,ENSG00000093100.12,17811497,22-17982339-G-A,rs9605480,-1,G,A,17982339,170842,17614889,18008105,367450
22,ENSG00000128254.9,31945346,22-32064007-A-G,rs9609420,-1,A,G,32064007,118661,31748738,32141954,315269
22,ENSG00000226954.1,49724506,22-49918577-T-C,rs9616380,-1,T,C,49918577,194071,49527898,49921114,390679
22,ENSG00000230071.1,40588003,22-40535227-T-C,rs9623181,-1,T,C,40535227,52776,40391395,40784611,143832
22,ENSG00000099984.6,23980123,22-23969285-G-A,rs9624364,1,G,A,23969285,10838,23783515,24176731,185770
22,ENSG00000182057.4,42269744,22-42439721-C-T,rs1016109,1,C,T,42439721,169977,42073136,42466352,366585
22,ENSG00000185837.3,17159351,22-17201404-C-A,rs1076106,1,C,A,17201404,42053,16962743,17355959,238661
22,ENSG00000185065.6,19447893,22-19533775-A-G,rs112135032,1,A,G,19533775,85882,19251285,19644501,282490
22,ENSG00000185065.6,19447893,22-19533775-A-T,rs112135032,1,A,T,19533775,85882,19251285,19644501,282490
22,ENSG00000236670.1,20484105,22-20556195-C-T,rs115069799,-1,C,T,20556195,72090,20287497,20680713,268698
22,ENSG00000214076.3,32269381,22-32440645-A-C,rs12167810,1,A,C,32440645,171264,32072773,32465989,367872
22,ENSG00000214076.3,32269381,22-32440645-A-T,rs12167810,1,A,T,32440645,171264,32072773,32465989,367872
22,ENSG00000214076.3,32269381,22-32440645-A-G,rs12167810,1,A,G,32440645,171264,32072773,32465989,367872
22,ENSG00000212939.2,49548681,22-49658341-A-T,rs13055216,1,A,T,49658341,109660,49352073,49745289,306268
22,ENSG00000212939.2,49548681,22-49658341-A-G,rs13055216,1,A,G,49658341,109660,49352073,49745289,306268
22,ENSG00000100068.7,25405274,22-25409257-T-A,rs13057190,-1,T,A,25409257,3983,25208666,25601882,200591
22,ENSG00000100068.7,25405274,22-25409257-T-C,rs13057190,-1,T,C,25409257,3983,25208666,25601882,200591
22,ENSG00000205559.3,50586873,22-50585879-T-A,rs131750,1,T,A,50585879,994,50390265,50783481,195614
22,ENSG00000205559.3,50586873,22-50585879-T-G,rs131750,1,T,G,50585879,994,50390265,50783481,195614
22,ENSG00000205559.3,50586873,22-50585879-T-C,rs131750,1,T,C,50585879,994,50390265,50783481,195614
22,ENSG00000254413.4,50579752,22-50550897-A-G,rs131778,-1,A,G,50550897,28855,50383144,50776360,167753
22,ENSG00000254413.4,50579752,22-50550897-A-T,rs131778,-1,A,T,50550897,28855,50383144,50776360,167753
22,ENSG00000172250.10,42500671,22-42585161-G-A,rs137086,1,G,A,42585161,84490,42304063,42697279,281098
22,ENSG00000172250.10,42500671,22-42585161-G-C,rs137086,1,G,C,42585161,84490,42304063,42697279,281098
22,ENSG00000260613.1,49838901,22-49726702-A-G,rs139784,-1,A,G,49726702,112199,49642293,50035509,84409
22,ENSG00000260613.1,49838901,22-49726702-A-T,rs139784,-1,A,T,49726702,112199,49642293,50035509,84409
22,ENSG00000224688.1,21142371,22-21023045-C-T,rs1548412,-1,C,T,21023045,119326,20945763,21338979,77282
22,ENSG00000211648.2,22357739,22-22374876-T-C,rs16987822,1,T,C,22374876,17137,22161131,22554347,213745
22,ENSG00000100058.7,25455712,22-25446967-T-C,rs17680597,1,T,C,25446967,8745,25259104,25652320,187863
22,ENSG00000223461.1,19121529,22-19128143-G-A,rs17811029,1,G,A,19128143,6614,18924921,19318137,203222
22,ENSG00000237476.1,20957092,22-20957433-T-C,rs178251,1,T,C,20957433,341,20760484,21153700,196949
22,ENSG00000237476.1,20957092,22-20957433-T-G,rs178251,1,T,G,20957433,341,20760484,21153700,196949
22,ENSG00000161149.7,21014287,22-20996591-T-C,rs178295,-1,T,C,20996591,17696,20817679,21210895,178912
22,ENSG00000230513.1,21001886,22-20999039-G-A,rs178297,1,G,A,20999039,2847,20805278,21198494,193761
22,ENSG00000230513.1,21001886,22-20999039-G-C,rs178297,1,G,C,20999039,2847,20805278,21198494,193761
22,ENSG00000232545.1,24101689,22-23970509-G-C,rs183093330,1,G,C,23970509,131180,23905081,24298297,65428
22,ENSG00000232545.1,24101689,22-23970509-G-T,rs183093330,1,G,T,23970509,131180,23905081,24298297,65428
22,ENSG00000233739.1,38073940,22-38077699-G-A,rs2012859,-1,G,A,38077699,3759,37877332,38270548,200367
22,ENSG00000233739.1,38073940,22-38077699-G-C,rs2012859,-1,G,C,38077699,3759,37877332,38270548,200367
22,ENSG00000188078.5,36537604,22-36575910-A-C,rs2050140,-1,A,C,36575910,38306,36340996,36734212,234914
22,ENSG00000188078.5,36537604,22-36575910-A-G,rs2050140,-1,A,G,36575910,38306,36340996,36734212,234914
22,ENSG00000188078.5,36537604,22-36575910-A-T,rs2050140,-1,A,T,36575910,38306,36340996,36734212,234914
22,ENSG00000224806.2,24686168,22-24594949-G-A,rs2070477,1,G,A,24594949,91219,24489560,24882776,105389
22,ENSG00000224806.2,24686168,22-24594949-G-C,rs2070477,1,G,C,24594949,91219,24489560,24882776,105389
22,ENSG00000205702.5,42144577,22-42146869-A-T,rs2142694,-1,A,T,42146869,2292,41947969,42341185,198900
22,ENSG00000205702.5,42144577,22-42146869-A-G,rs2142694,-1,A,G,42146869,2292,41947969,42341185,198900
22,ENSG00000249310.2,38998209,22-38996385-C-T,rs2179233,-1,C,T,38996385,1824,38801601,39194817,194784
22,ENSG00000249310.2,38998209,22-38996385-C-G,rs2179233,-1,C,G,38996385,1824,38801601,39194817,194784
22,ENSG00000253234.1,22856762,22-22939433-T-A,rs2188131,1,T,A,22939433,82671,22660154,23053370,279279
22,ENSG00000253234.1,22856762,22-22939433-T-C,rs2188131,1,T,C,22939433,82671,22660154,23053370,279279
22,ENSG00000235513.1,41228500,22-41265150-G-A,rs2235852,-1,G,A,41265150,36650,41031892,41425108,233258
22,ENSG00000235513.1,41228500,22-41265150-G-C,rs2235852,-1,G,C,41265150,36650,41031892,41425108,233258
22,ENSG00000235513.1,41228500,22-41265150-G-T,rs2235852,-1,G,T,41265150,36650,41031892,41425108,233258
22,ENSG00000226912.1,26645336,22-26647764-G-T,rs2269671,-1,G,T,26647764,2428,26448728,26841944,199036
22,ENSG00000226912.1,26645336,22-26647764-G-A,rs2269671,-1,G,A,26647764,2428,26448728,26841944,199036
22,ENSG00000226912.1,26645336,22-26647764-G-C,rs2269671,-1,G,C,26647764,2428,26448728,26841944,199036
22,ENSG00000230736.2,32376664,22-32394657-A-T,rs2281035,1,A,T,32394657,17993,32180056,32573272,214601
22,ENSG00000230736.2,32376664,22-32394657-A-C,rs2281035,1,A,C,32394657,17993,32180056,32573272,214601
22,ENSG00000224086.3,21938293,22-21960940-C-T,rs2283797,1,C,T,21960940,22647,21741685,22134901,219255
22,ENSG00000237438.1,17044873,22-17045080-T-C,rs2845393,1,T,C,17045080,207,16848265,17241481,196815
22,ENSG00000237438.1,17044873,22-17045080-T-G,rs2845393,1,T,G,17045080,207,16848265,17241481,196815
22,ENSG00000227484.1,50314631,22-50304506-A-G,rs34544325,1,A,G,50304506,10125,50118023,50511239,186483
22,ENSG00000227484.1,50314631,22-50304506-A-T,rs34544325,1,A,T,50304506,10125,50118023,50511239,186483
22,ENSG00000227484.1,50314631,22-50304506-A-C,rs34544325,1,A,C,50304506,10125,50118023,50511239,186483
22,ENSG00000211651.2,22380766,22-22479416-G-A,rs403517,1,G,A,22479416,98650,22184158,22577374,295258
22,ENSG00000227117.2,30080230,22-30016476-T-C,rs41164,-1,T,C,30016476,63754,29883622,30276838,132854
22,ENSG00000093100.12,17811497,22-18000622-A-T,rs4819654,-1,A,T,18000622,189125,17614889,18008105,385733
22,ENSG00000093100.12,17811497,22-18000622-A-G,rs4819654,-1,A,G,18000622,189125,17614889,18008105,385733
22,ENSG00000093100.12,17811497,22-18000622-A-C,rs4819654,-1,A,C,18000622,189125,17614889,18008105,385733
22,ENSG00000225225.1,18103649,22-18072368-A-T,rs4819666,-1,A,T,18072368,31281,17907041,18300257,165327
22,ENSG00000225225.1,18103649,22-18072368-A-G,rs4819666,-1,A,G,18072368,31281,17907041,18300257,165327
22,ENSG00000214093.3,31559483,22-31518413-A-C,rs4820979,1,A,C,31518413,41070,31362875,31756091,155538
22,ENSG00000214093.3,31559483,22-31518413-A-G,rs4820979,1,A,G,31518413,41070,31362875,31756091,155538
22,ENSG00000214093.3,31559483,22-31518413-A-T,rs4820979,1,A,T,31518413,41070,31362875,31756091,155538
22,ENSG00000235237.1,37166757,22-37213254-A-T,rs4821603,1,A,T,37213254,46497,36970149,37363365,243105
22,ENSG00000235237.1,37166757,22-37213254-A-C,rs4821603,1,A,C,37213254,46497,36970149,37363365,243105
22,ENSG00000235237.1,37166757,22-37213254-A-G,rs4821603,1,A,G,37213254,46497,36970149,37363365,243105
22,ENSG00000211659.2,22686726,22-22520154-G-A,rs4822091,1,G,A,22520154,166572,22490118,22883334,30036
22,ENSG00000099984.6,23980123,22-23913109-C-G,rs4822455,1,C,G,23913109,67014,23783515,24176731,129594
22,ENSG00000099984.6,23980123,22-23913109-C-T,rs4822455,1,C,T,23913109,67014,23783515,24176731,129594
22,ENSG00000226954.1,49724506,22-49726877-G-A,rs4824090,-1,G,A,49726877,2371,49527898,49921114,198979
22,ENSG00000213683.3,50755434,22-50722665-C-T,rs56207913,-1,C,T,50722665,32769,50558826,50952042,163839
22,ENSG00000235776.1,19792294,22-19607792-C-A,rs5748350,1,C,A,19607792,184502,19595686,19988902,12106
22,ENSG00000235776.1,19792294,22-19607792-C-G,rs5748350,1,C,G,19607792,184502,19595686,19988902,12106
22,ENSG00000182841.8,42582001,22-42543702-A-T,rs5758798,-1,A,T,42543702,38299,42385393,42778609,158309
22,ENSG00000182841.8,42582001,22-42543702-A-G,rs5758798,-1,A,G,42543702,38299,42385393,42778609,158309
22,ENSG00000230319.1,43038585,22-43058449-A-G,rs5759124,1,A,G,43058449,19864,42841977,43235193,216472
22,ENSG00000133519.8,23402157,22-23312249-A-G,rs5759698,-1,A,G,23312249,89908,23205549,23598765,106700
22,ENSG00000214526.3,23322927,22-23506857-A-C,rs5759855,-1,A,C,23506857,183930,23126319,23519535,380538
22,ENSG00000214526.3,23322927,22-23506857-A-T,rs5759855,-1,A,T,23506857,183930,23126319,23519535,380538
22,ENSG00000161132.6,20299760,22-20410731-T-C,rs5761913,1,T,C,20410731,110971,20103152,20496368,307579
22,ENSG00000211667.2,22771824,22-22695596-G-A,rs59747512,1,G,A,22695596,76228,22575216,22968432,120380
22,ENSG00000197182.8,46053869,22-46051834-T-C,rs59929908,1,T,C,46051834,2035,45857261,46250477,194573
22,ENSG00000241990.1,46053705,22-46051834-T-C,rs59929908,1,T,C,46051834,1871,45857097,46250313,194737
22,ENSG00000182257.5,46054144,22-46051834-T-C,rs59929908,-1,T,C,46051834,2310,45857536,46250752,194298
22,ENSG00000230107.1,42438023,22-42572530-G-T,rs5996192,1,G,T,42572530,134507,42241415,42634631,331115
22,ENSG00000230107.1,42438023,22-42572530-G-A,rs5996192,1,G,A,42572530,134507,42241415,42634631,331115
22,ENSG00000226287.3,20702007,22-20844177-C-T,rs5996889,1,C,T,20844177,142170,20505399,20898615,338778
22,ENSG00000233388.1,35503586,22-35644117-C-A,rs5999908,-1,C,A,35644117,140531,35306978,35700194,337139
22,ENSG00000233388.1,35503586,22-35644117-C-G,rs5999908,-1,C,G,35644117,140531,35306978,35700194,337139
22,ENSG00000226450.2,42155001,22-42114998-A-C,rs6002621,-1,A,C,42114998,40003,41958393,42351609,156605
22,ENSG00000235111.1,49615716,22-49606629-C-T,rs62232134,-1,C,T,49606629,9087,49419108,49812324,187521
22,ENSG00000235111.1,49615716,22-49606629-C-G,rs62232134,-1,C,G,49606629,9087,49419108,49812324,187521
22,ENSG00000228839.1,31292499,22-31186676-A-G,rs6518737,1,A,G,31186676,105823,31095891,31489107,90785
22,ENSG00000218537.1,23898930,22-23840313-G-A,rs6519476,-1,G,A,23840313,58617,23702322,24095538,137991
22,ENSG00000218537.1,23898930,22-23840313-G-T,rs6519476,-1,G,T,23840313,58617,23702322,24095538,137991
22,ENSG00000260708.1,46762564,22-46749381-G-T,rs710123,-1,G,T,46749381,13183,46565956,46959172,183425
22,ENSG00000260708.1,46762564,22-46749381-G-A,rs710123,-1,G,A,46749381,13183,46565956,46959172,183425
22,ENSG00000197549.5,21995428,22-22062249-T-C,rs7288332,-1,T,C,22062249,66821,21798820,22192036,263429
22,ENSG00000205853.5,32382106,22-32385735-C-T,rs7288743,-1,C,T,32385735,3629,32185498,32578714,200237
22,ENSG00000226328.1,45163781,22-45131934-C-T,rs7290824,-1,C,T,45131934,31847,44967173,45360389,164761
22,ENSG00000213279.2,49575426,22-49658959-C-A,rs739240,-1,C,A,49658959,83533,49378818,49772034,280141
22,ENSG00000184068.2,41834665,22-41869426-G-A,rs744011,-1,G,A,41869426,34761,41638057,42031273,231369
22,ENSG00000249263.2,16659628,22-16833951-G-A,rs74762450,-1,G,A,16833951,174323,16463020,16856236,370931
22,ENSG00000235485.1,34591278,22-34494712-G-A,rs78252251,-1,G,A,34494712,96566,34394670,34787886,100042
22,ENSG00000235485.1,34591278,22-34494712-G-C,rs78252251,-1,G,C,34494712,96566,34394670,34787886,100042
22,ENSG00000233080.2,35194942,22-35045645-G-A,rs80097772,-1,G,A,35045645,149297,34998334,35391550,47311
22,ENSG00000225282.1,23926900,22-23931098-G-T,rs8136062,1,G,T,23931098,4198,23730292,24123508,200806
22,ENSG00000229107.2,20670984,22-20708278-G-C,rs8136747,-1,G,C,20708278,37294,20474376,20867592,233902
22,ENSG00000229107.2,20670984,22-20708278-G-T,rs8136747,-1,G,T,20708278,37294,20474376,20867592,233902
22,ENSG00000229107.2,20670984,22-20708278-G-A,rs8136747,-1,G,A,20708278,37294,20474376,20867592,233902
22,ENSG00000227370.1,42132543,22-42300294-G-A,rs8141607,1,G,A,42300294,167751,41935935,42329151,364359
22,ENSG00000225774.1,30542536,22-30455623-G-T,rs9608930,1,G,T,30455623,86913,30345928,30739144,109695
22,ENSG00000225774.1,30542536,22-30455623-G-A,rs9608930,1,G,A,30455623,86913,30345928,30739144,109695
22,ENSG00000232346.1,32039490,22-31967774-C-T,rs9609396,1,C,T,31967774,71716,31842882,32236098,124892
22,ENSG00000211638.2,22098700,22-22017336-A-G,rs9610872,1,A,G,22017336,81364,21902092,22295308,115244
22,ENSG00000234009.1,42777296,22-42757801-A-G,rs9611875,-1,A,G,42757801,19495,42580688,42973904,177113
22,ENSG00000238120.1,45620858,22-45744048-G-A,rs9614511,-1,G,A,45744048,123190,45424250,45817466,319798
22,ENSG00000188511.8,49657504,22-49657199-G-A,rs9616333,-1,G,A,49657199,305,49460896,49854112,196303
22,ENSG00000188511.8,49657504,22-49657199-G-C,rs9616333,-1,G,C,49657199,305,49460896,49854112,196303
22,ENSG00000237668.1,36421644,22-36588150-G-A,rs9619621,-1,G,A,36588150,166506,36225036,36618252,363114
22,ENSG00000237668.1,36421644,22-36588150-G-C,rs9619621,-1,G,C,36588150,166506,36225036,36618252,363114
22,ENSG00000244625.1,26672805,22-26776863-A-C,rs1004970,1,A,C,26776863,104058,26476197,26869413,300666
22,ENSG00000244625.1,26672805,22-26776863-A-T,rs1004970,1,A,T,26776863,104058,26476197,26869413,300666
22,ENSG00000244625.1,26672805,22-26776863-A-G,rs1004970,1,A,G,26776863,104058,26476197,26869413,300666
22,ENSG00000232926.1,19887289,22-19890991-G-A,rs1015471,1,G,A,19890991,3702,19690681,20083897,200310
22,ENSG00000232926.1,19887289,22-19890991-G-C,rs1015471,1,G,C,19890991,3702,19690681,20083897,200310
22,ENSG00000205702.5,42144577,22-42129623-C-T,rs1081004,-1,C,T,42129623,14954,41947969,42341185,181654
22,ENSG00000100058.7,25455712,22-25493190-T-C,rs11090398,1,T,C,25493190,37478,25259104,25652320,234086
22,ENSG00000100058.7,25455712,22-25493190-T-G,rs11090398,1,T,G,25493190,37478,25259104,25652320,234086
22,ENSG00000185065.6,19447893,22-19509707-T-C,rs117551893,1,T,C,19509707,61814,19251285,19644501,258422
22,ENSG00000228599.1,40107066,22-40080542-A-G,rs118176772,-1,A,G,40080542,26524,39910458,40303674,170084
22,ENSG00000184068.2,41834665,22-41801266-T-C,rs12166503,-1,T,C,41801266,33399,41638057,42031273,163209
22,ENSG00000188511.8,49657504,22-49658341-A-G,rs13055216,-1,A,G,49658341,837,49460896,49854112,197445
22,ENSG00000188511.8,49657504,22-49658341-A-T,rs13055216,-1,A,T,49658341,837,49460896,49854112,197445
22,ENSG00000232710.1,42139927,22-42067685-T-C,rs133368,-1,T,C,42067685,72242,41943319,42336535,124366
22,ENSG00000232710.1,42139927,22-42067685-T-G,rs133368,-1,T,G,42067685,72242,41943319,42336535,124366
22,ENSG00000229107.2,20670984,22-20707980-G-C,rs13471,-1,G,C,20707980,36996,20474376,20867592,233604
22,ENSG00000229107.2,20670984,22-20707980-G-A,rs13471,-1,G,A,20707980,36996,20474376,20867592,233604
22,ENSG00000229107.2,20670984,22-20707980-G-T,rs13471,-1,G,T,20707980,36996,20474376,20867592,233604
22,ENSG00000225528.1,39960397,22-39937125-G-A,rs137985,1,G,A,39937125,23272,39763789,40157005,173336
22,ENSG00000225528.1,39960397,22-39937125-G-T,rs137985,1,G,T,39937125,23272,39763789,40157005,173336
22,ENSG00000233739.1,38073940,22-37963660-A-C,rs139873,-1,A,C,37963660,110280,37877332,38270548,86328
22,ENSG00000202058.1,42565330,22-42519837-C-T,rs141049505,-1,C,T,42519837,45493,42368722,42761938,151115
22,ENSG00000202058.1,42565330,22-42519837-C-G,rs141049505,-1,C,G,42519837,45493,42368722,42761938,151115
22,ENSG00000229598.1,38723505,22-38592339-C-T,rs1569493,-1,C,T,38592339,131166,38526897,38920113,65442
22,ENSG00000229598.1,38723505,22-38592339-C-G,rs1569493,-1,C,G,38592339,131166,38526897,38920113,65442
22,ENSG00000224003.1,25647261,22-25513288-T-C,rs16980329,1,T,C,25513288,133973,25450653,25843869,62635
22,ENSG00000228050.1,22224566,22-22073744-C-A,rs16982463,-1,C,A,22073744,150822,22027958,22421174,45786
22,ENSG00000228050.1,22224566,22-22073744-C-T,rs16982463,-1,C,T,22073744,150822,22027958,22421174,45786
22,ENSG00000231369.1,26887548,22-26967669-T-C,rs16986703,-1,T,C,26967669,80121,26690940,27084156,276729
22,ENSG00000248751.2,30299482,22-30196819-C-T,rs16988381,-1,C,T,30196819,102663,30102874,30496090,93945
22,ENSG00000248751.2,30299482,22-30196819-C-A,rs16988381,-1,C,A,30196819,102663,30102874,30496090,93945
22,ENSG00000225282.1,23926900,22-23877973-C-T,rs17004024,1,C,T,23877973,48927,23730292,24123508,147681
22,ENSG00000099984.6,23980123,22-23908648-A-G,rs17004053,1,A,G,23908648,71475,23783515,24176731,125133
22,ENSG00000231993.1,41197456,22-41103818-G-T,rs17433014,-1,G,T,41103818,93638,41000848,41394064,102970
22,ENSG00000231993.1,41197456,22-41103818-G-A,rs17433014,-1,G,A,41103818,93638,41000848,41394064,102970
22,ENSG00000237015.1,29260889,22-29445653-G-A,rs174719,1,G,A,29445653,184764,29064281,29457497,381372
22,ENSG00000244425.1,23879790,22-23857332-C-G,rs17637865,-1,C,G,23857332,22458,23683182,24076398,174150
22,ENSG00000244425.1,23879790,22-23857332-C-T,rs17637865,-1,C,T,23857332,22458,23683182,24076398,174150
22,ENSG00000225971.1,30137681,22-30234154-C-A,rs17729168,-1,C,A,30234154,96473,29941073,30334289,293081
22,ENSG00000230513.1,21001886,22-20996591-T-C,rs178295,1,T,C,20996591,5295,20805278,21198494,191313
22,ENSG00000133519.8,23402157,22-23552510-C-T,rs179306,-1,C,T,23552510,150353,23205549,23598765,346961
22,ENSG00000215544.6,18858640,22-18950444-G-A,rs2058672,-1,G,A,18950444,91804,18662032,19055248,288412
22,ENSG00000215544.6,18858640,22-18950444-G-C,rs2058672,-1,G,C,18950444,91804,18662032,19055248,288412
22,ENSG00000226328.1,45163781,22-45200368-G-A,rs2072721,-1,G,A,45200368,36587,44967173,45360389,233195
22,ENSG00000161149.7,21014287,22-21009455-T-A,rs2075276,-1,T,A,21009455,4832,20817679,21210895,191776
22,ENSG00000161149.7,21014287,22-21009455-T-G,rs2075276,-1,T,G,21009455,4832,20817679,21210895,191776
22,ENSG00000161149.7,21014287,22-21009455-T-C,rs2075276,-1,T,C,21009455,4832,20817679,21210895,191776
22,ENSG00000240122.1,16595485,22-16613859-A-C,rs2096537,-1,A,C,16613859,18374,16398877,16792093,214982
22,ENSG00000240122.1,16595485,22-16613859-A-T,rs2096537,-1,A,T,16613859,18374,16398877,16792093,214982
22,ENSG00000240122.1,16595485,22-16613859-A-G,rs2096537,-1,A,G,16613859,18374,16398877,16792093,214982
22,ENSG00000223704.1,26860553,22-26815022-A-T,rs2331331,1,A,T,26815022,45531,26663945,27057161,151077
22,ENSG00000223704.1,26860553,22-26815022-A-C,rs2331331,1,A,C,26815022,45531,26663945,27057161,151077
22,ENSG00000230107.1,42438023,22-42500468-T-C,rs2413692,1,T,C,42500468,62445,42241415,42634631,259053
22,ENSG00000230107.1,42438023,22-42500468-T-G,rs2413692,1,T,G,42500468,62445,42241415,42634631,259053
22,ENSG00000230107.1,42438023,22-42500468-T-A,rs2413692,1,T,A,42500468,62445,42241415,42634631,259053
22,ENSG00000226142.2,49214247,22-49246071-A-C,rs2858632,-1,A,C,49246071,31824,49017639,49410855,228432
22,ENSG00000226142.2,49214247,22-49246071-A-G,rs2858632,-1,A,G,49246071,31824,49017639,49410855,228432
22,ENSG00000226142.2,49214247,22-49246071-A-T,rs2858632,-1,A,T,49246071,31824,49017639,49410855,228432
22,ENSG00000224086.3,21938293,22-21851322-A-G,rs2876981,1,A,G,21851322,86971,21741685,22134901,109637
22,ENSG00000224086.3,21938293,22-21851322-A-C,rs2876981,1,A,C,21851322,86971,21741685,22134901,109637
22,ENSG00000234353.2,23640425,22-23682628-C-T,rs3747110,-1,C,T,23682628,42203,23443817,23837033,238811
22,ENSG00000223730.1,44901592,22-44791910-G-A,rs3788622,1,G,A,44791910,109682,44704984,45098200,86926
22,ENSG00000249590.3,30409262,22-30457895-T-C,rs3804078,1,T,C,30457895,48633,30212654,30605870,245241
22,ENSG00000249590.3,30409262,22-30457895-T-G,rs3804078,1,T,G,30457895,48633,30212654,30605870,245241
22,ENSG00000249590.3,30409262,22-30457895-T-A,rs3804078,1,T,A,30457895,48633,30212654,30605870,245241
22,ENSG00000225335.1,18078884,22-18012704-G-A,rs452579,-1,G,A,18012704,66180,17882276,18275492,130428
22,ENSG00000253234.1,22856762,22-22941147-A-G,rs4822352,1,A,G,22941147,84385,22660154,23053370,280993
22,ENSG00000260708.1,46762564,22-46750478-C-T,rs4823572,-1,C,T,46750478,12086,46565956,46959172,184522
22,ENSG00000234735.1,43092167,22-43251948-A-G,rs53724,1,A,G,43251948,159781,42895559,43288775,356389
22,ENSG00000235617.1,18101612,22-17911167-A-G,rs5746492,1,A,G,17911167,190445,17905004,18298220,6163
22,ENSG00000237438.1,17044873,22-17073766-T-C,rs5748851,1,T,C,17073766,28893,16848265,17241481,225501
22,ENSG00000237438.1,17044873,22-17073766-T-G,rs5748851,1,T,G,17073766,28893,16848265,17241481,225501
22,ENSG00000205853.5,32382106,22-32381136-G-C,rs5749416,-1,G,C,32381136,970,32185498,32578714,195638
22,ENSG00000205853.5,32382106,22-32381136-G-A,rs5749416,-1,G,A,32381136,970,32185498,32578714,195638
22,ENSG00000214093.3,31559483,22-31538427-C-G,rs5753682,1,C,G,31538427,21056,31362875,31756091,175552
22,ENSG00000214093.3,31559483,22-31538427-C-A,rs5753682,1,C,A,31538427,21056,31362875,31756091,175552
22,ENSG00000214093.3,31559483,22-31538427-C-T,rs5753682,1,C,T,31538427,21056,31362875,31756091,175552
22,ENSG00000235237.1,37166757,22-37195621-C-T,rs5756552,1,C,T,37195621,28864,36970149,37363365,225472
22,ENSG00000226287.3,20702007,22-20557469-A-G,rs5758468,1,A,G,20557469,144538,20505399,20898615,52070
22,ENSG00000226287.3,20702007,22-20557469-A-C,rs5758468,1,A,C,20557469,144538,20505399,20898615,52070
22,ENSG00000172250.10,42500671,22-42543702-A-T,rs5758798,1,A,T,42543702,43031,42304063,42697279,239639
22,ENSG00000172250.10,42500671,22-42543702-A-G,rs5758798,1,A,G,42543702,43031,42304063,42697279,239639
22,ENSG00000182841.8,42582001,22-42764750-T-C,rs5758922,-1,T,C,42764750,182749,42385393,42778609,379357
22,ENSG00000182841.8,42582001,22-42764750-T-A,rs5758922,-1,T,A,42764750,182749,42385393,42778609,379357
22,ENSG00000235954.2,27919421,22-27910619-T-G,rs5762399,1,T,G,27910619,8802,27722813,28116029,187806
22,ENSG00000235954.2,27919421,22-27910619-T-C,rs5762399,1,T,C,27910619,8802,27722813,28116029,187806
22,ENSG00000235954.2,27919421,22-27910619-T-A,rs5762399,1,T,A,27910619,8802,27722813,28116029,187806
22,ENSG00000211642.2,22214794,22-22029966-C-T,rs58036485,1,C,T,22029966,184828,22018186,22411402,11780
22,ENSG00000185837.3,17159351,22-17301122-G-A,rs5992653,1,G,A,17301122,141771,16962743,17355959,338379
22,ENSG00000253818.1,22404207,22-22418023-G-A,rs5995994,1,G,A,22418023,13816,22207599,22600815,210424
22,ENSG00000233080.2,35194942,22-35144610-A-G,rs5999744,-1,A,G,35144610,50332,34998334,35391550,146276
22,ENSG00000226471.1,28800683,22-28761499-G-A,rs6005864,1,G,A,28761499,39184,28604075,28997291,157424
22,ENSG00000226471.1,28800683,22-28761499-G-C,rs6005864,1,G,C,28761499,39184,28604075,28997291,157424
22,ENSG00000261251.1,43812456,22-43758374-T-G,rs6006540,1,T,G,43758374,54082,43615848,44009064,142526
22,ENSG00000261251.1,43812456,22-43758374-T-C,rs6006540,1,T,C,43758374,54082,43615848,44009064,142526
22,ENSG00000226954.1,49724506,22-49724501-C-T,rs6009846,-1,C,T,49724501,5,49527898,49921114,196603
22,ENSG00000226954.1,49724506,22-49724501-C-G,rs6009846,-1,C,G,49724501,5,49527898,49921114,196603
22,ENSG00000226954.1,49724506,22-49724501-C-A,rs6009846,-1,C,A,49724501,5,49527898,49921114,196603
22,ENSG00000182057.4,42269744,22-42215168-G-A,rs61745937,1,G,A,42215168,54576,42073136,42466352,142032
22,ENSG00000215270.3,15855243,22-15920591-G-T,rs62224618,-1,G,T,15920591,65348,15658635,16051851,261956
22,ENSG00000215270.3,15855243,22-15920591-G-C,rs62224618,-1,G,C,15920591,65348,15658635,16051851,261956
22,ENSG00000215270.3,15855243,22-15920591-G-A,rs62224618,-1,G,A,15920591,65348,15658635,16051851,261956
22,ENSG00000243762.1,20111875,22-20193613-G-A,rs696885,-1,G,A,20193613,81738,19915267,20308483,278346
22,ENSG00000243762.1,20111875,22-20193613-G-T,rs696885,-1,G,T,20193613,81738,19915267,20308483,278346
22,ENSG00000223350.2,22343187,22-22409502-T-A,rs72495405,1,T,A,22409502,66315,22146579,22539795,262923
22,ENSG00000223350.2,22343187,22-22409502-T-G,rs72495405,1,T,G,22409502,66315,22146579,22539795,262923
22,ENSG00000235776.1,19792294,22-19811651-C-T,rs73148929,1,C,T,19811651,19357,19595686,19988902,215965
22,ENSG00000254413.4,50579752,22-50704551-G-T,rs73174414,-1,G,T,50704551,124799,50383144,50776360,321407
22,ENSG00000205559.3,50586873,22-50514560-G-A,rs75276302,1,G,A,50514560,72313,50390265,50783481,124295
22,ENSG00000100068.7,25405274,22-25547395-G-A,rs760553,-1,G,A,25547395,142121,25208666,25601882,338729
22,ENSG00000182257.5,46054144,22-46010902-C-A,rs78358349,-1,C,A,46010902,43242,45857536,46250752,153366
22,ENSG00000182257.5,46054144,22-46010902-C-T,rs78358349,-1,C,T,46010902,43242,45857536,46250752,153366
22,ENSG00000237668.1,36421644,22-36247684-T-C,rs78736759,-1,T,C,36247684,173960,36225036,36618252,22648
22,ENSG00000235513.1,41228500,22-41125553-G-A,rs8137709,-1,G,A,41125553,102947,41031892,41425108,93661
22,ENSG00000235513.1,41228500,22-41125553-G-T,rs8137709,-1,G,T,41125553,102947,41031892,41425108,93661
22,ENSG00000235111.1,49615716,22-49594148-G-C,rs8137793,-1,G,C,49594148,21568,49419108,49812324,175040
22,ENSG00000235111.1,49615716,22-49594148-G-A,rs8137793,-1,G,A,49594148,21568,49419108,49812324,175040
22,ENSG00000230701.1,23262767,22-23420480-C-T,rs8138134,1,C,T,23420480,157713,23066159,23459375,354321
22,ENSG00000228315.5,23717356,22-23913901-C-G,rs9608215,-1,C,G,23913901,196545,23520748,23913964,393153
22,ENSG00000228315.5,23717356,22-23913901-C-T,rs9608215,-1,C,T,23913901,196545,23520748,23913964,393153
22,ENSG00000225774.1,30542536,22-30636089-G-A,rs9609025,1,G,A,30636089,93553,30345928,30739144,290161
22,ENSG00000224688.1,21142371,22-21059718-T-C,rs9625442,-1,T,C,21059718,82653,20945763,21338979,113955
22,ENSG00000230736.2,32376664,22-32394994-C-G,rs9680823,1,C,G,32394994,18330,32180056,32573272,214938
22,ENSG00000230736.2,32376664,22-32394994-C-T,rs9680823,1,C,T,32394994,18330,32180056,32573272,214938
21,ENSG00000235772.1,42561934,21-42506833-A-G,rs10483087,-1,A,G,42506833,55101,42365326,42758542,141507
21,ENSG00000235772.1,42561934,21-42506833-A-T,rs10483087,-1,A,T,42506833,55101,42365326,42758542,141507
21,ENSG00000256073.1,32393095,21-32393251-C-A,rs11702306,1,C,A,32393251,156,32196487,32589703,196764
21,ENSG00000256073.1,32393095,21-32393251-C-T,rs11702306,1,C,T,32393251,156,32196487,32589703,196764
21,ENSG00000239415.1,46254133,21-46185421-C-T,rs12482934,-1,C,T,46185421,68712,46057525,46450741,127896
21,ENSG00000229047.1,14961309,21-14850440-T-G,rs17208695,1,T,G,14850440,110869,14764701,15157917,85739
21,ENSG00000227039.1,44921051,21-44929581-C-T,rs1721,1,C,T,44929581,8530,44724443,45117659,205138
21,ENSG00000260583.1,25583326,21-25578847-T-C,rs1893651,-1,T,C,25578847,4479,25386718,25779934,192129
21,ENSG00000260583.1,25583326,21-25578847-T-A,rs1893651,-1,T,A,25578847,4479,25386718,25779934,192129
21,ENSG00000236883.1,41739373,21-41767035-C-T,rs199825512,1,C,T,41767035,27662,41542765,41935981,224270
21,ENSG00000230479.1,36430360,21-36430331-T-C,rs218642,1,T,C,36430331,29,36233752,36626968,196579
21,ENSG00000230479.1,36430360,21-36430331-T-A,rs218642,1,T,A,36430331,29,36233752,36626968,196579
21,ENSG00000233818.1,36445731,21-36456742-G-A,rs219789,1,G,A,36456742,11011,36249123,36642339,207619
21,ENSG00000237232.2,42009494,21-42024305-G-C,rs220219,1,G,C,42024305,14811,41812886,42206102,211419
21,ENSG00000237232.2,42009494,21-42024305-G-T,rs220219,1,G,T,42024305,14811,41812886,42206102,211419
21,ENSG00000249624.3,33230131,21-33252612-A-G,rs2236757,1,A,G,33252612,22481,33033523,33426739,219089
21,ENSG00000168122.4,13113790,21-13240882-G-T,rs2259138,-1,G,T,13240882,127092,12917182,13310398,323700
21,ENSG00000168122.4,13113790,21-13240882-G-A,rs2259138,-1,G,A,13240882,127092,12917182,13310398,323700
21,ENSG00000223799.1,33266296,21-33259936-C-A,rs2300371,-1,C,A,33259936,6360,33069688,33462904,190248
21,ENSG00000223799.1,33266296,21-33259936-C-T,rs2300371,-1,C,T,33259936,6360,33069688,33462904,190248
21,ENSG00000224598.1,34136071,21-34167611-C-G,rs2834390,-1,C,G,34167611,31540,33939463,34332679,228148
21,ENSG00000224598.1,34136071,21-34167611-C-T,rs2834390,-1,C,T,34167611,31540,33939463,34332679,228148
21,ENSG00000242553.1,37221419,21-37231180-A-G,rs2835678,1,A,G,37231180,9761,37024811,37418027,206369
21,ENSG00000242553.1,37221419,21-37231180-A-C,rs2835678,1,A,C,37231180,9761,37024811,37418027,206369
21,ENSG00000236519.1,44802577,21-44802571-G-A,rs2838690,1,G,A,44802571,6,44605969,44999185,196602
21,ENSG00000223768.1,45288037,21-45264602-C-T,rs2838859,1,C,T,45264602,23435,45091429,45484645,173173
21,ENSG00000236056.1,29222321,21-29193248-A-T,rs4816341,1,A,T,29193248,29073,29025713,29418929,167535
21,ENSG00000236056.1,29222321,21-29193248-A-G,rs4816341,1,A,G,29193248,29073,29025713,29418929,167535
21,ENSG00000228600.1,14757588,21-14720750-A-G,rs56058204,1,A,G,14720750,36838,14560980,14954196,159770
21,ENSG00000184441.4,44331234,21-44338005-G-A,rs56212056,1,G,A,44338005,6771,44134626,44527842,203379
21,ENSG00000184385.2,42108534,21-42108712-C-T,rs57966423,-1,C,T,42108712,178,41911926,42305142,196786
21,ENSG00000224790.1,36966485,21-36957100-T-C,rs61027540,1,T,C,36957100,9385,36769877,37163093,187223
21,ENSG00000235374.1,45072239,21-45115223-G-C,rs62216599,-1,G,C,45115223,42984,44875631,45268847,239592
21,ENSG00000224905.2,14027421,21-14091635-T-C,rs6516610,1,T,C,14091635,64214,13830813,14224029,260822
21,ENSG00000237594.1,31559245,21-31554584-C-T,rs6517046,1,C,T,31554584,4661,31362637,31755853,191947
21,ENSG00000237594.1,31559245,21-31554584-C-G,rs6517046,1,C,G,31554584,4661,31362637,31755853,191947
21,ENSG00000235701.1,39172106,21-39181919-T-G,rs6517522,-1,T,G,39181919,9813,38975498,39368714,206421
21,ENSG00000235701.1,39172106,21-39181919-T-A,rs6517522,-1,T,A,39181919,9813,38975498,39368714,206421
21,ENSG00000235701.1,39172106,21-39181919-T-C,rs6517522,-1,T,C,39181919,9813,38975498,39368714,206421
21,ENSG00000223901.1,46220344,21-46051796-A-G,rs7275542,1,A,G,46051796,168548,46023736,46416952,28060
21,ENSG00000230212.2,36126640,21-36066591-A-G,rs73370485,-1,A,G,36066591,60049,35930032,36323248,136559
21,ENSG00000228314.1,13847713,21-14040570-A-T,rs8129930,-1,A,T,14040570,192857,13651105,14044321,389465
21,ENSG00000228314.1,13847713,21-14040570-A-G,rs8129930,-1,A,G,14040570,192857,13651105,14044321,389465
21,ENSG00000230965.1,13906488,21-14040570-A-T,rs8129930,-1,A,T,14040570,134082,13709880,14103096,330690
21,ENSG00000230965.1,13906488,21-14040570-A-G,rs8129930,-1,A,G,14040570,134082,13709880,14103096,330690
21,ENSG00000231125.1,29060095,21-29052092-T-C,rs8134828,-1,T,C,29052092,8003,28863487,29256703,188605
21,ENSG00000238197.1,32728600,21-32764715-G-A,rs9967977,1,G,A,32764715,36115,32531992,32925208,232723
21,ENSG00000238197.1,32728600,21-32764715-G-T,rs9967977,1,G,T,32764715,36115,32531992,32925208,232723
21,ENSG00000225331.1,44160072,21-44290224-T-C,rs1003854,-1,T,C,44290224,130152,43963464,44356680,326760
21,ENSG00000215458.4,43812567,21-43863789-T-C,rs10084623,-1,T,C,43863789,51222,43615959,44009175,247830
21,ENSG00000184385.2,42108534,21-42110289-C-G,rs113203,-1,C,G,42110289,1755,41911926,42305142,198363
21,ENSG00000184385.2,42108534,21-42110289-C-T,rs113203,-1,C,T,42110289,1755,41911926,42305142,198363
21,ENSG00000235772.1,42561934,21-42572367-A-G,rs12483004,-1,A,G,42572367,10433,42365326,42758542,207041
21,ENSG00000235772.1,42561934,21-42572367-A-C,rs12483004,-1,A,C,42572367,10433,42365326,42758542,207041
21,ENSG00000223822.2,23390258,21-23551012-A-T,rs1557378,1,A,T,23551012,160754,23193650,23586866,357362
21,ENSG00000223822.2,23390258,21-23551012-A-G,rs1557378,1,A,G,23551012,160754,23193650,23586866,357362
21,ENSG00000223822.2,23390258,21-23551012-A-C,rs1557378,1,A,C,23551012,160754,23193650,23586866,357362
21,ENSG00000260583.1,25583326,21-25534136-C-A,rs1783010,-1,C,A,25534136,49190,25386718,25779934,147418
21,ENSG00000260583.1,25583326,21-25534136-C-T,rs1783010,-1,C,T,25534136,49190,25386718,25779934,147418
21,ENSG00000228314.1,13847713,21-13834363-A-G,rs1967441,-1,A,G,13834363,13350,13651105,14044321,183258
21,ENSG00000184441.4,44331234,21-44330463-C-T,rs2070573,1,C,T,44330463,771,44134626,44527842,195837
21,ENSG00000184441.4,44331234,21-44330463-C-A,rs2070573,1,C,A,44330463,771,44134626,44527842,195837
21,ENSG00000184441.4,44331234,21-44330463-C-G,rs2070573,1,C,G,44330463,771,44134626,44527842,195837
21,ENSG00000224905.2,14027421,21-14121040-G-C,rs2155971,1,G,C,14121040,93619,13830813,14224029,290227
21,ENSG00000224905.2,14027421,21-14121040-G-A,rs2155971,1,G,A,14121040,93619,13830813,14224029,290227
21,ENSG00000233818.1,36445731,21-36430331-T-C,rs218642,1,T,C,36430331,15400,36249123,36642339,181208
21,ENSG00000233818.1,36445731,21-36430331-T-A,rs218642,1,T,A,36430331,15400,36249123,36642339,181208
21,ENSG00000228941.1,31063168,21-31255676-T-A,rs2253204,-1,T,A,31255676,192508,30866560,31259776,389116
21,ENSG00000228941.1,31063168,21-31255676-T-C,rs2253204,-1,T,C,31255676,192508,30866560,31259776,389116
21,ENSG00000228941.1,31063168,21-31255676-T-G,rs2253204,-1,T,G,31255676,192508,30866560,31259776,389116
21,ENSG00000234883.1,25561810,21-25487995-A-C,rs2829775,1,A,C,25487995,73815,25365202,25758418,122793
21,ENSG00000222042.1,25361868,21-25495958-C-G,rs2829780,-1,C,G,25495958,134090,25165260,25558476,330698
21,ENSG00000222042.1,25361868,21-25495958-C-T,rs2829780,-1,C,T,25495958,134090,25165260,25558476,330698
21,ENSG00000237594.1,31559245,21-31582452-G-A,rs2833456,1,G,A,31582452,23207,31362637,31755853,219815
21,ENSG00000237594.1,31559245,21-31582452-G-T,rs2833456,1,G,T,31582452,23207,31362637,31755853,219815
21,ENSG00000234107.1,31840341,21-31799518-G-A,rs2833517,1,G,A,31799518,40823,31643733,32036949,155785
21,ENSG00000223799.1,33266296,21-33254349-C-A,rs2834166,-1,C,A,33254349,11947,33069688,33462904,184661
21,ENSG00000223799.1,33266296,21-33254349-C-T,rs2834166,-1,C,T,33254349,11947,33069688,33462904,184661
21,ENSG00000230366.4,37208503,21-37151139-G-A,rs2835631,1,G,A,37151139,57364,37011895,37405111,139244
21,ENSG00000215424.4,46229217,21-46205744-T-C,rs2839143,1,T,C,46205744,23473,46032609,46425825,173135
21,ENSG00000233922.1,45593654,21-45690603-A-C,rs3945438,1,A,C,45690603,96949,45397046,45790262,293557
21,ENSG00000233922.1,45593654,21-45690603-A-G,rs3945438,1,A,G,45690603,96949,45397046,45790262,293557
21,ENSG00000223768.1,45288037,21-45145282-G-A,rs410184,1,G,A,45145282,142755,45091429,45484645,53853
21,ENSG00000212932.2,46690764,21-46610705-G-T,rs4464358,1,G,T,46610705,80059,46494156,46887372,116549
21,ENSG00000237232.2,42009494,21-41996225-C-G,rs469359,1,C,G,41996225,13269,41812886,42206102,183339
21,ENSG00000237232.2,42009494,21-41996225-C-T,rs469359,1,C,T,41996225,13269,41812886,42206102,183339
21,ENSG00000215533.4,29193480,21-29203776-G-A,rs4817276,1,G,A,29203776,10296,28996872,29390088,206904
21,ENSG00000215533.4,29193480,21-29203776-G-C,rs4817276,1,G,C,29203776,10296,28996872,29390088,206904
21,ENSG00000236830.1,36175815,21-36303505-C-T,rs57462585,-1,C,T,36303505,127690,35979207,36372423,324298
21,ENSG00000215317.2,28903697,21-28959613-G-C,rs57646126,-1,G,C,28959613,55916,28707089,29100305,252524
21,ENSG00000215317.2,28903697,21-28959613-G-A,rs57646126,-1,G,A,28959613,55916,28707089,29100305,252524
21,ENSG00000230479.1,36430360,21-36387659-C-T,rs62229404,1,C,T,36387659,42701,36233752,36626968,153907
21,ENSG00000223741.1,36487411,21-36576513-G-A,rs7283441,-1,G,A,36576513,89102,36290803,36684019,285710
21,ENSG00000241728.1,44330221,21-44235154-C-T,rs75967196,-1,C,T,44235154,95067,44133613,44526829,101541
21,ENSG00000230982.1,46654022,21-46584579-C-T,rs77729136,-1,C,T,46584579,69443,46457414,46850630,127165
21,ENSG00000223901.1,46220344,21-46229888-G-A,rs915804,1,G,A,46229888,9544,46023736,46416952,206152
21,ENSG00000223901.1,46220344,21-46229888-G-C,rs915804,1,G,C,46229888,9544,46023736,46416952,206152
21,ENSG00000223901.1,46220344,21-46229888-G-T,rs915804,1,G,T,46229888,9544,46023736,46416952,206152
21,ENSG00000227039.1,44921051,21-44942568-G-A,rs9637166,1,G,A,44942568,21517,44724443,45117659,218125
21,ENSG00000227039.1,44921051,21-44942568-G-C,rs9637166,1,G,C,44942568,21517,44724443,45117659,218125
21,ENSG00000225267.1,30263881,21-30421584-T-G,rs9647137,-1,T,G,30421584,157703,30067273,30460489,354311
21,ENSG00000225267.1,30263881,21-30421584-T-A,rs9647137,-1,T,A,30421584,157703,30067273,30460489,354311
21,ENSG00000225267.1,30263881,21-30421584-T-C,rs9647137,-1,T,C,30421584,157703,30067273,30460489,354311
21,ENSG00000232260.1,17518993,21-17395480-T-G,rs9974114,-1,T,G,17395480,123513,17322385,17715601,73095
21,ENSG00000232260.1,17518993,21-17395480-T-C,rs9974114,-1,T,C,17395480,123513,17322385,17715601,73095
21,ENSG00000242553.1,37221419,21-37288086-C-T,rs9976694,1,C,T,37288086,66667,37024811,37418027,263275
21,ENSG00000249624.3,33230131,21-33262760-C-A,rs9984273,1,C,A,33262760,32629,33033523,33426739,229237
21,ENSG00000249624.3,33230131,21-33262760-C-G,rs9984273,1,C,G,33262760,32629,33033523,33426739,229237
21,ENSG00000249624.3,33230131,21-33262760-C-T,rs9984273,1,C,T,33262760,32629,33033523,33426739,229237
21,ENSG00000242553.1,37221419,21-37271471-T-G,rs1009922,1,T,G,37271471,50052,37024811,37418027,246660
21,ENSG00000230061.1,44425272,21-44305863-C-G,rs118169148,-1,C,G,44305863,119409,44228664,44621880,77199
21,ENSG00000230061.1,44425272,21-44305863-C-T,rs118169148,-1,C,T,44305863,119409,44228664,44621880,77199
21,ENSG00000215533.4,29193480,21-29250404-G-T,rs1236462,1,G,T,29250404,56924,28996872,29390088,253532
21,ENSG00000215533.4,29193480,21-29250404-G-A,rs1236462,1,G,A,29250404,56924,28996872,29390088,253532
21,ENSG00000203616.2,13937325,21-13902170-C-T,rs12627520,-1,C,T,13902170,35155,13740717,14133933,161453
21,ENSG00000238197.1,32728600,21-32820099-C-A,rs16989825,1,C,A,32820099,91499,32531992,32925208,288107
21,ENSG00000238197.1,32728600,21-32820099-C-T,rs16989825,1,C,T,32820099,91499,32531992,32925208,288107
21,ENSG00000235772.1,42561934,21-42554459-G-A,rs1878069,-1,G,A,42554459,7475,42365326,42758542,189133
21,ENSG00000235772.1,42561934,21-42554459-G-C,rs1878069,-1,G,C,42554459,7475,42365326,42758542,189133
21,ENSG00000235772.1,42561934,21-42554459-G-T,rs1878069,-1,G,T,42554459,7475,42365326,42758542,189133
21,ENSG00000215424.4,46229217,21-46397039-G-C,rs2186350,1,G,C,46397039,167822,46032609,46425825,364430
21,ENSG00000215424.4,46229217,21-46397039-G-A,rs2186350,1,G,A,46397039,167822,46032609,46425825,364430
21,ENSG00000223799.1,33266296,21-33208728-C-T,rs2186355,-1,C,T,33208728,57568,33069688,33462904,139040
21,ENSG00000223799.1,33266296,21-33208728-C-A,rs2186355,-1,C,A,33208728,57568,33069688,33462904,139040
21,ENSG00000184385.2,42108534,21-42062474-T-G,rs220265,-1,T,G,42062474,46060,41911926,42305142,150548
21,ENSG00000184385.2,42108534,21-42062474-T-A,rs220265,-1,T,A,42062474,46060,41911926,42305142,150548
21,ENSG00000234380.1,34745756,21-34745975-C-G,rs2246640,1,C,G,34745975,219,34549148,34942364,196827
21,ENSG00000234380.1,34745756,21-34745975-C-T,rs2246640,1,C,T,34745975,219,34549148,34942364,196827
21,ENSG00000228941.1,31063168,21-30915116-G-T,rs2833157,-1,G,T,30915116,148052,30866560,31259776,48556
21,ENSG00000228941.1,31063168,21-30915116-G-C,rs2833157,-1,G,C,30915116,148052,30866560,31259776,48556
21,ENSG00000249624.3,33230131,21-33216189-T-C,rs2834153,1,T,C,33216189,13942,33033523,33426739,182666
21,ENSG00000249624.3,33230131,21-33216189-T-G,rs2834153,1,T,G,33216189,13942,33033523,33426739,182666
21,ENSG00000227039.1,44921051,21-44988875-G-A,rs2838751,1,G,A,44988875,67824,44724443,45117659,264432
21,ENSG00000239415.1,46254133,21-46169185-C-T,rs2839128,-1,C,T,46169185,84948,46057525,46450741,111660
21,ENSG00000237232.2,42009494,21-41998796-T-C,rs2839434,1,T,C,41998796,10698,41812886,42206102,185910
21,ENSG00000237232.2,42009494,21-41998796-T-G,rs2839434,1,T,G,41998796,10698,41812886,42206102,185910
21,ENSG00000223741.1,36487411,21-36493912-C-T,rs2850115,-1,C,T,36493912,6501,36290803,36684019,203109
21,ENSG00000237594.1,31559245,21-31543648-A-G,rs4817403,1,A,G,31543648,15597,31362637,31755853,181011
21,ENSG00000237594.1,31559245,21-31543648-A-C,rs4817403,1,A,C,31543648,15597,31362637,31755853,181011
21,ENSG00000237594.1,31559245,21-31543648-A-T,rs4817403,1,A,T,31543648,15597,31362637,31755853,181011
21,ENSG00000228709.1,44485463,21-44343759-A-G,rs4818908,1,A,G,44343759,141704,44288855,44682071,54904
21,ENSG00000236519.1,44802577,21-44835681-A-T,rs4818979,1,A,T,44835681,33104,44605969,44999185,229712
21,ENSG00000236519.1,44802577,21-44835681-A-C,rs4818979,1,A,C,44835681,33104,44605969,44999185,229712
21,ENSG00000236519.1,44802577,21-44835681-A-G,rs4818979,1,A,G,44835681,33104,44605969,44999185,229712
21,ENSG00000233393.1,36104881,21-35928219-A-G,rs62230760,1,A,G,35928219,176662,35908273,36301489,19946
21,ENSG00000236883.1,41739373,21-41604921-A-G,rs7281496,1,A,G,41604921,134452,41542765,41935981,62156
21,ENSG00000236883.1,41739373,21-41604921-A-C,rs7281496,1,A,C,41604921,134452,41542765,41935981,62156
21,ENSG00000224905.2,14027421,21-14173029-G-T,rs7282646,1,G,T,14173029,145608,13830813,14224029,342216
21,ENSG00000223768.1,45288037,21-45292483-G-A,rs75493996,1,G,A,45292483,4446,45091429,45484645,201054
21,ENSG00000227456.2,34157724,21-34315983-G-A,rs76633561,1,G,A,34315983,158259,33961116,34354332,354867
21,ENSG00000223822.2,23390258,21-23265784-A-G,rs8131740,1,A,G,23265784,124474,23193650,23586866,72134
21,ENSG00000233818.1,36445731,21-36446773-A-G,rs8134233,1,A,G,36446773,1042,36249123,36642339,197650
21,ENSG00000184441.4,44331234,21-44401646-T-G,rs9974831,1,T,G,44401646,70412,44134626,44527842,267020
21,ENSG00000184441.4,44331234,21-44401646-T-C,rs9974831,1,T,C,44401646,70412,44134626,44527842,267020
20,ENSG00000223651.1,41999397,20-41890348-C-T,rs10485682,-1,C,T,41890348,109049,41802789,42196005,87559
20,ENSG00000256566.1,2508907,20-2627511-A-G,rs11087524,-1,A,G,2627511,118604,2312299,2705515,315212
20,ENSG00000256566.1,2508907,20-2627511-A-T,rs11087524,-1,A,T,2627511,118604,2312299,2705515,315212
20,ENSG00000229539.1,3889173,20-4048059-G-T,rs11906481,-1,G,T,4048059,158886,3692565,4085781,355494
20,ENSG00000229539.1,3889173,20-4048059-G-A,rs11906481,-1,G,A,4048059,158886,3692565,4085781,355494
20,ENSG00000230155.1,35491005,20-35503847-G-A,rs17092712,-1,G,A,35503847,12842,35294397,35687613,209450
20,ENSG00000224497.1,35544747,20-35554516-G-T,rs17092784,-1,G,T,35554516,9769,35348139,35741355,206377
20,ENSG00000224497.1,35544747,20-35554516-G-A,rs17092784,-1,G,A,35554516,9769,35348139,35741355,206377
20,ENSG00000224635.1,38416797,20-38398584-A-G,rs1739644,-1,A,G,38398584,18213,38220189,38613405,178395
20,ENSG00000224635.1,38416797,20-38398584-A-C,rs1739644,-1,A,C,38398584,18213,38220189,38613405,178395
20,ENSG00000196756.5,38435381,20-38420312-A-G,rs1739652,-1,A,G,38420312,15069,38238773,38631989,181539
20,ENSG00000196756.5,38435381,20-38420312-A-T,rs1739652,-1,A,T,38420312,15069,38238773,38631989,181539
20,ENSG00000224565.1,47412327,20-47415070-C-T,rs17726408,-1,C,T,47415070,2743,47215719,47608935,199351
20,ENSG00000224565.1,47412327,20-47415070-C-G,rs17726408,-1,C,G,47415070,2743,47215719,47608935,199351
20,ENSG00000149531.9,30377372,20-30295149-A-T,rs1811868,1,A,T,30295149,82223,30180764,30573980,114385
20,ENSG00000149531.9,30377372,20-30295149-A-G,rs1811868,1,A,G,30295149,82223,30180764,30573980,114385
20,ENSG00000228340.1,60138466,20-60140164-C-T,rs2025050,1,C,T,60140164,1698,59941858,60335074,198306
20,ENSG00000228340.1,60138466,20-60140164-C-G,rs2025050,1,C,G,60140164,1698,59941858,60335074,198306
20,ENSG00000228340.1,60138466,20-60140164-C-A,rs2025050,1,C,A,60140164,1698,59941858,60335074,198306
20,ENSG00000204556.4,26018832,20-26004160-T-G,rs2386804,1,T,G,26004160,14672,25822224,26215440,181936
20,ENSG00000204556.4,26018832,20-26004160-T-C,rs2386804,1,T,C,26004160,14672,25822224,26215440,181936
20,ENSG00000250090.1,25836832,20-26004160-T-G,rs2386804,-1,T,G,26004160,167328,25640224,26033440,363936
20,ENSG00000250090.1,25836832,20-26004160-T-C,rs2386804,-1,T,C,26004160,167328,25640224,26033440,363936
20,ENSG00000230563.2,5445838,20-5504492-G-A,rs2423107,1,G,A,5504492,58654,5249230,5642446,255262
20,ENSG00000230563.2,5445838,20-5504492-G-C,rs2423107,1,G,C,5504492,58654,5249230,5642446,255262
20,ENSG00000205181.2,5526606,20-5504492-G-A,rs2423107,-1,G,A,5504492,22114,5329998,5723214,174494
20,ENSG00000205181.2,5526606,20-5504492-G-C,rs2423107,-1,G,C,5504492,22114,5329998,5723214,174494
20,ENSG00000232803.1,62666724,20-62688263-A-G,rs2427385,-1,A,G,62688263,21539,62470116,62863332,218147
20,ENSG00000232803.1,62666724,20-62688263-A-T,rs2427385,-1,A,T,62688263,21539,62470116,62863332,218147
20,ENSG00000236352.1,53940160,20-53905181-A-G,rs2904376,1,A,G,53905181,34979,53743552,54136768,161629
20,ENSG00000236352.1,53940160,20-53905181-A-T,rs2904376,1,A,T,53905181,34979,53743552,54136768,161629
20,ENSG00000236352.1,53940160,20-53905181-A-C,rs2904376,1,A,C,53905181,34979,53743552,54136768,161629
20,ENSG00000215467.2,43652523,20-43727113-C-T,rs3091249,1,C,T,43727113,74590,43455915,43849131,271198
20,ENSG00000215467.2,43652523,20-43727113-C-A,rs3091249,1,C,A,43727113,74590,43455915,43849131,271198
20,ENSG00000215467.2,43652523,20-43727113-C-G,rs3091249,1,C,G,43727113,74590,43455915,43849131,271198
20,ENSG00000226405.1,21488625,20-21302257-A-C,rs34459185,-1,A,C,21302257,186368,21292017,21685233,10240
20,ENSG00000174365.14,38446343,20-38311767-A-G,rs3746476,1,A,G,38311767,134576,38249735,38642951,62032
20,ENSG00000229299.1,63744689,20-63711343-T-C,rs3761121,1,T,C,63711343,33346,63548081,63941297,163262
20,ENSG00000229853.1,47631438,20-47451332-A-G,rs4810639,-1,A,G,47451332,180106,47434830,47828046,16502
20,ENSG00000229853.1,47631438,20-47451332-A-T,rs4810639,-1,A,T,47451332,180106,47434830,47828046,16502
20,ENSG00000176659.5,60055853,20-60073043-G-T,rs4812146,1,G,T,60073043,17190,59859245,60252461,213798
20,ENSG00000236526.1,11918677,20-11941589-G-A,rs4814046,-1,G,A,11941589,22912,11722069,12115285,219520
20,ENSG00000232333.1,17516843,20-17612670-C-T,rs4814628,1,C,T,17612670,95827,17320235,17713451,292435
20,ENSG00000232333.1,17516843,20-17612670-C-A,rs4814628,1,C,A,17612670,95827,17320235,17713451,292435
20,ENSG00000232645.1,23358175,20-23162329-C-A,rs4815179,-1,C,A,23162329,195846,23161567,23554783,762
20,ENSG00000232645.1,23358175,20-23162329-C-T,rs4815179,-1,C,T,23162329,195846,23161567,23554783,762
20,ENSG00000225978.1,63102205,20-63010496-G-A,rs6011530,1,G,A,63010496,91709,62905597,63298813,104899
20,ENSG00000225978.1,63102205,20-63010496-G-T,rs6011530,1,G,T,63010496,91709,62905597,63298813,104899
20,ENSG00000225849.1,46465270,20-46521596-A-G,rs6017891,-1,A,G,46521596,56326,46268662,46661878,252934
20,ENSG00000223891.1,44210907,20-44211379-A-C,rs6031456,1,A,C,44211379,472,44014299,44407515,197080
20,ENSG00000223891.1,44210907,20-44211379-A-G,rs6031456,1,A,G,44211379,472,44014299,44407515,197080
20,ENSG00000228663.1,50913731,20-50838374-G-C,rs6067566,1,G,C,50838374,75357,50717123,51110339,121251
20,ENSG00000228663.1,50913731,20-50838374-G-T,rs6067566,1,G,T,50838374,75357,50717123,51110339,121251
20,ENSG00000228663.1,50913731,20-50838374-G-A,rs6067566,1,G,A,50838374,75357,50717123,51110339,121251
20,ENSG00000234684.1,1325405,20-1360321-G-A,rs6078809,1,G,A,1360321,34916,1128797,1522013,231524
20,ENSG00000234684.1,1325405,20-1360321-G-T,rs6078809,1,G,T,1360321,34916,1128797,1522013,231524
20,ENSG00000234684.1,1325405,20-1360321-G-C,rs6078809,1,G,C,1360321,34916,1128797,1522013,231524
20,ENSG00000212232.1,17962946,20-18026062-A-G,rs6080941,-1,A,G,18026062,63116,17766338,18159554,259724
20,ENSG00000226644.1,2207217,20-2199519-T-A,rs6082366,1,T,A,2199519,7698,2010609,2403825,188910
20,ENSG00000226644.1,2207217,20-2199519-T-C,rs6082366,1,T,C,2199519,7698,2010609,2403825,188910
20,ENSG00000197670.5,53552770,20-53560021-G-A,rs6097480,1,G,A,53560021,7251,53356162,53749378,203859
20,ENSG00000197670.5,53552770,20-53560021-G-C,rs6097480,1,G,C,53560021,7251,53356162,53749378,203859
20,ENSG00000125804.8,25985210,20-25866328-G-A,rs6115350,1,G,A,25866328,118882,25788602,26181818,77726
20,ENSG00000175170.8,25868150,20-25868402-A-T,rs6115355,-1,A,T,25868402,252,25671542,26064758,196860
20,ENSG00000175170.8,25868150,20-25868402-A-G,rs6115355,-1,A,G,25868402,252,25671542,26064758,196860
20,ENSG00000175170.8,25868150,20-25868402-A-C,rs6115355,-1,A,C,25868402,252,25671542,26064758,196860
20,ENSG00000260257.1,32856621,20-32852422-G-T,rs6119294,1,G,T,32852422,4199,32660013,33053229,192409
20,ENSG00000260257.1,32856621,20-32852422-G-A,rs6119294,1,G,A,32852422,4199,32660013,33053229,192409
20,ENSG00000254995.4,58651434,20-58458328-C-T,rs6128347,1,C,T,58458328,193106,58454826,58848042,3502
20,ENSG00000125514.5,63037028,20-63080132-T-C,rs62206577,-1,T,C,63080132,43104,62840420,63233636,239712
20,ENSG00000225377.1,348490,20-410526-C-T,rs7059,-1,C,T,410526,62036,151882,545098,258644
20,ENSG00000213959.2,38615476,20-38665053-A-G,rs732503,-1,A,G,38665053,49577,38418868,38812084,246185
20,ENSG00000230837.1,33752543,20-33893855-T-C,rs733803,-1,T,C,33893855,141312,33555935,33949151,337920
20,ENSG00000214541.3,56601701,20-56698448-C-T,rs74416504,1,C,T,56698448,96747,56405093,56798309,293355
20,ENSG00000214541.3,56601701,20-56698448-C-A,rs74416504,1,C,A,56698448,96747,56405093,56798309,293355
20,ENSG00000231302.1,50620763,20-50792885-G-A,rs74842420,1,G,A,50792885,172122,50424155,50817371,368730
20,ENSG00000167046.4,62643304,20-62822995-G-A,rs760086,-1,G,A,62822995,179691,62446696,62839912,376299
20,ENSG00000235621.3,48359950,20-48353103-C-T,rs8117242,1,C,T,48353103,6847,48163342,48556558,189761
20,ENSG00000235621.3,48359950,20-48353103-C-A,rs8117242,1,C,A,48353103,6847,48163342,48556558,189761
20,ENSG00000227063.4,21755270,20-21719977-C-T,rs8124323,1,C,T,21719977,35293,21558662,21951878,161315
20,ENSG00000184617.9,46484461,20-46522634-A-G,rs847104,1,A,G,46522634,38173,46287853,46681069,234781
20,ENSG00000214185.3,34215892,20-34072384-C-T,rs10485504,-1,C,T,34072384,143508,34019284,34412500,53100
20,ENSG00000132832.4,44696096,20-44736480-A-G,rs113284708,-1,A,G,44736480,40384,44499488,44892704,236992
20,ENSG00000230010.1,18347539,20-18282575-G-A,rs118036933,-1,G,A,18282575,64964,18150931,18544147,131644
20,ENSG00000230010.1,18347539,20-18282575-G-T,rs118036933,-1,G,T,18282575,64964,18150931,18544147,131644
20,ENSG00000177410.8,49278642,20-49323126-C-A,rs11906968,1,C,A,49323126,44484,49082034,49475250,241092
20,ENSG00000229539.1,3889173,20-3888105-C-G,rs12480683,-1,C,G,3888105,1068,3692565,4085781,195540
20,ENSG00000229539.1,3889173,20-3888105-C-T,rs12480683,-1,C,T,3888105,1068,3692565,4085781,195540
20,ENSG00000224565.1,47412327,20-47433971-T-C,rs12624409,-1,T,C,47433971,21644,47215719,47608935,218252
20,ENSG00000230563.2,5445838,20-5509560-C-T,rs13039216,1,C,T,5509560,63722,5249230,5642446,260330
20,ENSG00000205181.2,5526606,20-5509560-C-T,rs13039216,-1,C,T,5509560,17046,5329998,5723214,179562
20,ENSG00000236992.1,19823943,20-19861152-G-A,rs17301007,-1,G,A,19861152,37209,19627335,20020551,233817
20,ENSG00000215467.2,43652523,20-43590279-G-T,rs1894668,1,G,T,43590279,62244,43455915,43849131,134364
20,ENSG00000215467.2,43652523,20-43590279-G-A,rs1894668,1,G,A,43590279,62244,43455915,43849131,134364
20,ENSG00000215467.2,43652523,20-43590279-G-C,rs1894668,1,G,C,43590279,62244,43455915,43849131,134364
20,ENSG00000237595.1,50166223,20-50132435-A-G,rs1980925,-1,A,G,50132435,33788,49969615,50362831,162820
20,ENSG00000230155.1,35491005,20-35564866-C-T,rs2277862,-1,C,T,35564866,73861,35294397,35687613,270469
20,ENSG00000226632.1,3362324,20-3254879-C-T,rs2281495,-1,C,T,3254879,107445,3165716,3558932,89163
20,ENSG00000226632.1,3362324,20-3254879-C-A,rs2281495,-1,C,A,3254879,107445,3165716,3558932,89163
20,ENSG00000226632.1,3362324,20-3254879-C-G,rs2281495,-1,C,G,3254879,107445,3165716,3558932,89163
20,ENSG00000227688.2,36620403,20-36732236-T-C,rs2425266,1,T,C,36732236,111833,36423795,36817011,308441
20,ENSG00000227688.2,36620403,20-36732236-T-A,rs2425266,1,T,A,36732236,111833,36423795,36817011,308441
20,ENSG00000175730.7,32690815,20-32498054-A-C,rs293554,-1,A,C,32498054,192761,32494207,32887423,3847
20,ENSG00000175730.7,32690815,20-32498054-A-T,rs293554,-1,A,T,32498054,192761,32494207,32887423,3847
20,ENSG00000175730.7,32690815,20-32498054-A-G,rs293554,-1,A,G,32498054,192761,32494207,32887423,3847
20,ENSG00000232852.1,64292998,20-64224768-C-T,rs351880,-1,C,T,64224768,68230,64096390,64489606,128378
20,ENSG00000232852.1,64292998,20-64224768-C-A,rs351880,-1,C,A,64224768,68230,64096390,64489606,128378
20,ENSG00000213820.3,46099518,20-45968215-G-A,rs3737063,1,G,A,45968215,131303,45902910,46296126,65305
20,ENSG00000225419.1,18485265,20-18507148-A-G,rs3762199,1,A,G,18507148,21883,18288657,18681873,218491
20,ENSG00000225336.2,34834462,20-34817507-C-A,rs3787217,-1,C,A,34817507,16955,34637854,35031070,179653
20,ENSG00000225336.2,34834462,20-34817507-C-T,rs3787217,-1,C,T,34817507,16955,34637854,35031070,179653
20,ENSG00000235621.3,48359950,20-48340021-T-C,rs380410,1,T,C,48340021,19929,48163342,48556558,176679
20,ENSG00000223651.1,41999397,20-42075463-G-A,rs3827068,-1,G,A,42075463,76066,41802789,42196005,272674
20,ENSG00000215586.2,7832322,20-8011677-A-T,rs4142416,-1,A,T,8011677,179355,7635714,8028930,375963
20,ENSG00000215586.2,7832322,20-8011677-A-C,rs4142416,-1,A,C,8011677,179355,7635714,8028930,375963
20,ENSG00000215586.2,7832322,20-8011677-A-G,rs4142416,-1,A,G,8011677,179355,7635714,8028930,375963
20,ENSG00000101898.5,31547379,20-31450235-T-C,rs45520534,1,T,C,31450235,97144,31350771,31743987,99464
20,ENSG00000026036.16,63659300,20-63829952-C-T,rs4809367,1,C,T,63829952,170652,63462692,63855908,367260
20,ENSG00000026036.16,63659300,20-63829952-C-A,rs4809367,1,C,A,63829952,170652,63462692,63855908,367260
20,ENSG00000233838.4,62845664,20-62850747-T-G,rs4809426,1,T,G,62850747,5083,62649056,63042272,201691
20,ENSG00000231133.1,63102371,20-63042490-T-A,rs4809469,-1,T,A,63042490,59881,62905763,63298979,136727
20,ENSG00000231133.1,63102371,20-63042490-T-C,rs4809469,-1,T,C,63042490,59881,62905763,63298979,136727
20,ENSG00000231133.1,63102371,20-63042490-T-G,rs4809469,-1,T,G,63042490,59881,62905763,63298979,136727
20,ENSG00000223891.1,44210907,20-44216489-A-G,rs4812797,1,A,G,44216489,5582,44014299,44407515,202190
20,ENSG00000223891.1,44210907,20-44216489-A-C,rs4812797,1,A,C,44216489,5582,44014299,44407515,202190
20,ENSG00000223891.1,44210907,20-44216489-A-T,rs4812797,1,A,T,44216489,5582,44014299,44407515,202190
20,ENSG00000215063.3,4060113,20-4239693-G-A,rs4815671,-1,G,A,4239693,179580,3863505,4256721,376188
20,ENSG00000234684.1,1325405,20-1368044-G-A,rs55686498,1,G,A,1368044,42639,1128797,1522013,239247
20,ENSG00000174365.14,38446343,20-38310476-T-C,rs5741801,1,T,C,38310476,135867,38249735,38642951,60741
20,ENSG00000213742.2,25624157,20-25584603-C-T,rs6050690,1,C,T,25584603,39554,25427549,25820765,157054
20,ENSG00000167046.4,62643304,20-62706559-T-C,rs6062915,-1,T,C,62706559,63255,62446696,62839912,259863
20,ENSG00000233347.1,52111049,20-51981647-G-T,rs6068032,-1,G,T,51981647,129402,51914441,52307657,67206
20,ENSG00000233347.1,52111049,20-51981647-G-A,rs6068032,-1,G,A,51981647,129402,51914441,52307657,67206
20,ENSG00000233347.1,52111049,20-51981647-G-C,rs6068032,-1,G,C,51981647,129402,51914441,52307657,67206
20,ENSG00000254995.4,58651434,20-58619923-G-A,rs6070537,1,G,A,58619923,31511,58454826,58848042,165097
20,ENSG00000225022.1,5292831,20-5289618-G-T,rs6085074,-1,G,T,5289618,3213,5096223,5489439,193395
20,ENSG00000234933.1,34402696,20-34515030-A-G,rs6088514,-1,A,G,34515030,112334,34206088,34599304,308942
20,ENSG00000225978.1,63102205,20-63081166-A-T,rs6090229,1,A,T,63081166,21039,62905597,63298813,175569
20,ENSG00000225978.1,63102205,20-63081166-A-C,rs6090229,1,A,C,63081166,21039,62905597,63298813,175569
20,ENSG00000196756.5,38435381,20-38623375-G-A,rs6100437,-1,G,A,38623375,187994,38238773,38631989,384602
20,ENSG00000125804.8,25985210,20-25988629-A-C,rs6115458,1,A,C,25988629,3419,25788602,26181818,200027
20,ENSG00000125804.8,25985210,20-25988629-A-G,rs6115458,1,A,G,25988629,3419,25788602,26181818,200027
20,ENSG00000125804.8,25985210,20-25988629-A-T,rs6115458,1,A,T,25988629,3419,25788602,26181818,200027
20,ENSG00000235590.2,58850903,20-58890516-G-A,rs6123837,-1,G,A,58890516,39613,58654295,59047511,236221
20,ENSG00000260257.1,32856621,20-32752550-T-A,rs6141803,1,T,A,32752550,104071,32660013,33053229,92537
20,ENSG00000260257.1,32856621,20-32752550-T-C,rs6141803,1,T,C,32752550,104071,32660013,33053229,92537
20,ENSG00000224635.1,38416797,20-38442094-C-T,rs62203381,-1,C,T,38442094,25297,38220189,38613405,221905
20,ENSG00000229853.1,47631438,20-47439355-G-C,rs6512444,-1,G,C,47439355,192083,47434830,47828046,4525
20,ENSG00000125514.5,63037028,20-63034623-G-A,rs7273917,-1,G,A,63034623,2405,62840420,63233636,194203
20,ENSG00000125514.5,63037028,20-63034623-G-T,rs7273917,-1,G,T,63034623,2405,62840420,63233636,194203
20,ENSG00000261582.1,35280043,20-35438063-C-T,rs73094730,-1,C,T,35438063,158020,35083435,35476651,354628
20,ENSG00000232043.1,50578041,20-50565107-T-A,rs73272525,-1,T,A,50565107,12934,50381433,50774649,183674
20,ENSG00000232043.1,50578041,20-50565107-T-G,rs73272525,-1,T,G,50565107,12934,50381433,50774649,183674
20,ENSG00000226243.1,44466842,20-44651586-C-G,rs73598374,-1,C,G,44651586,184744,44270234,44663450,381352
20,ENSG00000226243.1,44466842,20-44651586-C-T,rs73598374,-1,C,T,44651586,184744,44270234,44663450,381352
20,ENSG00000226243.1,44466842,20-44651586-C-A,rs73598374,-1,C,A,44651586,184744,44270234,44663450,381352
20,ENSG00000212232.1,17962946,20-17874580-G-T,rs74672829,-1,G,T,17874580,88366,17766338,18159554,108242
20,ENSG00000260032.1,36051018,20-35995025-T-G,rs76775934,-1,T,G,35995025,55993,35854410,36247626,140615
20,ENSG00000225849.1,46465270,20-46407574-G-A,rs77323662,-1,G,A,46407574,57696,46268662,46661878,138912
20,ENSG00000227379.2,25368766,20-25317690-C-T,rs80237741,-1,C,T,25317690,51076,25172158,25565374,145532
20,ENSG00000236526.1,11918677,20-11872507-A-T,rs803880,-1,A,T,11872507,46170,11722069,12115285,150438
20,ENSG00000236526.1,11918677,20-11872507-A-G,rs803880,-1,A,G,11872507,46170,11722069,12115285,150438
20,ENSG00000226143.1,43550949,20-43546060-C-T,rs8116134,-1,C,T,43546060,4889,43354341,43747557,191719
20,ENSG00000228663.1,50913731,20-50845163-G-T,rs8123262,1,G,T,50845163,68568,50717123,51110339,128040
20,ENSG00000224497.1,35544747,20-35425455-G-A,rs8123889,-1,G,A,35425455,119292,35348139,35741355,77316
20,ENSG00000223864.1,38978422,20-39171620-A-G,rs910100,-1,A,G,39171620,193198,38781814,39175030,389806
20,ENSG00000223864.1,38978422,20-39171620-A-C,rs910100,-1,A,C,39171620,193198,38781814,39175030,389806
20,ENSG00000124224.11,58286399,20-58326965-A-G,rs113512307,-1,A,G,58326965,40566,58089791,58483007,237174
20,ENSG00000227379.2,25368766,20-25275962-A-C,rs11697384,-1,A,C,25275962,92804,25172158,25565374,103804
20,ENSG00000227379.2,25368766,20-25275962-A-T,rs11697384,-1,A,T,25275962,92804,25172158,25565374,103804
20,ENSG00000227379.2,25368766,20-25275962-A-G,rs11697384,-1,A,G,25275962,92804,25172158,25565374,103804
20,ENSG00000204556.4,26018832,20-26195902-G-T,rs117281921,1,G,T,26195902,177070,25822224,26215440,373678
20,ENSG00000235698.1,12380056,20-12573808-C-A,rs119008,1,C,A,12573808,193752,12183448,12576664,390360
20,ENSG00000225377.1,348490,20-430598-T-C,rs11906780,-1,T,C,430598,82108,151882,545098,278716
20,ENSG00000175170.8,25868150,20-25756480-C-A,rs11908096,-1,C,A,25756480,111670,25671542,26064758,84938
20,ENSG00000175170.8,25868150,20-25756480-C-T,rs11908096,-1,C,T,25756480,111670,25671542,26064758,84938
20,ENSG00000229873.1,62805961,20-62873233-A-G,rs12479676,-1,A,G,62873233,67272,62609353,63002569,263880
20,ENSG00000175730.7,32690815,20-32603213-C-T,rs12480732,-1,C,T,32603213,87602,32494207,32887423,109006
20,ENSG00000237595.1,50166223,20-50205423-G-A,rs12624521,-1,G,A,50205423,39200,49969615,50362831,235808
20,ENSG00000229222.1,49956745,20-49787786-C-G,rs13039627,1,C,G,49787786,168959,49760137,50153353,27649
20,ENSG00000229222.1,49956745,20-49787786-C-T,rs13039627,1,C,T,49787786,168959,49760137,50153353,27649
20,ENSG00000213742.2,25624157,20-25624891-A-G,rs16987934,1,A,G,25624891,734,25427549,25820765,197342
20,ENSG00000233578.1,5548840,20-5426716-C-A,rs2273470,1,C,A,5426716,122124,5352232,5745448,74484
20,ENSG00000230753.1,33811109,20-33921845-A-G,rs2378026,-1,A,G,33921845,110736,33614501,34007717,307344
20,ENSG00000230753.1,33811109,20-33921845-A-T,rs2378026,-1,A,T,33921845,110736,33614501,34007717,307344
20,ENSG00000184617.9,46484461,20-46636381-A-G,rs2425890,1,A,G,46636381,151920,46287853,46681069,348528
20,ENSG00000184617.9,46484461,20-46636381-A-C,rs2425890,1,A,C,46636381,151920,46287853,46681069,348528
20,ENSG00000176659.5,60055853,20-60074739-G-A,rs242813,1,G,A,60074739,18886,59859245,60252461,215494
20,ENSG00000230155.1,35491005,20-35444024-T-C,rs2889882,-1,T,C,35444024,46981,35294397,35687613,149627
20,ENSG00000224497.1,35544747,20-35444024-T-C,rs2889882,-1,T,C,35444024,100723,35348139,35741355,95885
20,ENSG00000132832.4,44696096,20-44662579-C-T,rs2903744,-1,C,T,44662579,33517,44499488,44892704,163091
20,ENSG00000132832.4,44696096,20-44662579-C-G,rs2903744,-1,C,G,44662579,33517,44499488,44892704,163091
20,ENSG00000232852.1,64292998,20-64199449-G-T,rs3003137,-1,G,T,64199449,93549,64096390,64489606,103059
20,ENSG00000234684.1,1325405,20-1325459-C-T,rs34019978,1,C,T,1325459,54,1128797,1522013,196662
20,ENSG00000225849.1,46465270,20-46512761-A-C,rs366860,-1,A,C,46512761,47491,46268662,46661878,244099
20,ENSG00000225849.1,46465270,20-46512761-A-T,rs366860,-1,A,T,46512761,47491,46268662,46661878,244099
20,ENSG00000223891.1,44210907,20-44211350-T-C,rs3843762,1,T,C,44211350,443,44014299,44407515,197051
20,ENSG00000215388.3,1160584,20-1104061-T-G,rs4813929,1,T,G,1104061,56523,963976,1357192,140085
20,ENSG00000215388.3,1160584,20-1104061-T-A,rs4813929,1,T,A,1104061,56523,963976,1357192,140085
20,ENSG00000215388.3,1160584,20-1104061-T-C,rs4813929,1,T,C,1104061,56523,963976,1357192,140085
20,ENSG00000226332.1,62306325,20-62200128-T-G,rs4925356,-1,T,G,62200128,106197,62109717,62502933,90411
20,ENSG00000226332.1,62306325,20-62200128-T-A,rs4925356,-1,T,A,62200128,106197,62109717,62502933,90411
20,ENSG00000226332.1,62306325,20-62200128-T-C,rs4925356,-1,T,C,62200128,106197,62109717,62502933,90411
20,ENSG00000230568.1,3491005,20-3681495-C-T,rs554743,-1,C,T,3681495,190490,3294397,3687613,387098
20,ENSG00000233838.4,62845664,20-62846860-G-C,rs6011419,1,G,C,62846860,1196,62649056,63042272,197804
20,ENSG00000233838.4,62845664,20-62846860-G-T,rs6011419,1,G,T,62846860,1196,62649056,63042272,197804
20,ENSG00000233838.4,62845664,20-62846860-G-A,rs6011419,1,G,A,62846860,1196,62649056,63042272,197804
20,ENSG00000177410.8,49278642,20-49221331-G-A,rs6019695,1,G,A,49221331,57311,49082034,49475250,139297
20,ENSG00000231302.1,50620763,20-50622747-T-A,rs6020641,1,T,A,50622747,1984,50424155,50817371,198592
20,ENSG00000236352.1,53940160,20-53907007-C-T,rs6022842,1,C,T,53907007,33153,53743552,54136768,163455
20,ENSG00000226243.1,44466842,20-44642914-G-T,rs6031688,-1,G,T,44642914,176072,44270234,44663450,372680
20,ENSG00000226243.1,44466842,20-44642914-G-A,rs6031688,-1,G,A,44642914,176072,44270234,44663450,372680
20,ENSG00000227477.1,44966402,20-44793310-T-G,rs6031797,-1,T,G,44793310,173092,44769794,45163010,23516
20,ENSG00000227477.1,44966402,20-44793310-T-A,rs6031797,-1,T,A,44793310,173092,44769794,45163010,23516
20,ENSG00000227477.1,44966402,20-44793310-T-C,rs6031797,-1,T,C,44793310,173092,44769794,45163010,23516
20,ENSG00000236526.1,11918677,20-12008201-G-C,rs6041030,-1,G,C,12008201,89524,11722069,12115285,286132
20,ENSG00000236526.1,11918677,20-12008201-G-A,rs6041030,-1,G,A,12008201,89524,11722069,12115285,286132
20,ENSG00000236526.1,11918677,20-12008201-G-T,rs6041030,-1,G,T,12008201,89524,11722069,12115285,286132
20,ENSG00000229539.1,3889173,20-4037932-A-G,rs6052257,-1,A,G,4037932,148759,3692565,4085781,345367
20,ENSG00000261582.1,35280043,20-35193167-T-C,rs6060300,-1,T,C,35193167,86876,35083435,35476651,109732
20,ENSG00000237119.1,63038011,20-63016531-T-A,rs6062769,1,T,A,63016531,21480,62841403,63234619,175128
20,ENSG00000237119.1,63038011,20-63016531-T-C,rs6062769,1,T,C,63016531,21480,62841403,63234619,175128
20,ENSG00000125514.5,63037028,20-63024942-A-G,rs6062772,-1,A,G,63024942,12086,62840420,63233636,184522
20,ENSG00000230563.2,5445838,20-5490415-T-C,rs6085178,1,T,C,5490415,44577,5249230,5642446,241185
20,ENSG00000224628.2,31286835,20-31252320-C-A,rs6088630,-1,C,A,31252320,34515,31090227,31483443,162093
20,ENSG00000235065.1,21114723,20-21018345-G-A,rs6113105,1,G,A,21018345,96378,20918115,21311331,100230
20,ENSG00000231133.1,63102371,20-63014756-C-T,rs62197298,-1,C,T,63014756,87615,62905763,63298979,108993
20,ENSG00000231133.1,63102371,20-63014756-C-G,rs62197298,-1,C,G,63014756,87615,62905763,63298979,108993
20,ENSG00000230750.1,10385779,20-10487614-A-G,rs667547,1,A,G,10487614,101835,10189171,10582387,298443
20,ENSG00000174365.14,38446343,20-38608262-C-T,rs7273647,1,C,T,38608262,161919,38249735,38642951,358527
20,ENSG00000224452.1,32170790,20-32091091-A-C,rs74502037,-1,A,C,32091091,79699,31974182,32367398,116909
20,ENSG00000224452.1,32170790,20-32091091-A-T,rs74502037,-1,A,T,32091091,79699,31974182,32367398,116909
20,ENSG00000228340.1,60138466,20-60171129-A-T,rs761258,1,A,T,60171129,32663,59941858,60335074,229271
20,ENSG00000228340.1,60138466,20-60171129-A-G,rs761258,1,A,G,60171129,32663,59941858,60335074,229271
20,ENSG00000226143.1,43550949,20-43548659-G-C,rs79899793,-1,G,C,43548659,2290,43354341,43747557,194318
20,ENSG00000226143.1,43550949,20-43548659-G-T,rs79899793,-1,G,T,43548659,2290,43354341,43747557,194318
20,ENSG00000225978.1,63102205,20-63273900-G-A,rs80124662,1,G,A,63273900,171695,62905597,63298813,368303
20,ENSG00000224635.1,38416797,20-38444448-G-C,rs805528,-1,G,C,38444448,27651,38220189,38613405,224259
20,ENSG00000224635.1,38416797,20-38444448-G-A,rs805528,-1,G,A,38444448,27651,38220189,38613405,224259
19,ENSG00000219665.3,11987679,19-12012019-G-A,rs10404882,1,G,A,12012019,24340,11791071,12184287,220948
19,ENSG00000248015.1,1396467,19-1312729-G-A,rs10405308,-1,G,A,1312729,83738,1199859,1593075,112870
19,ENSG00000248015.1,1396467,19-1312729-G-T,rs10405308,-1,G,T,1312729,83738,1199859,1593075,112870
19,ENSG00000254887.1,42132555,19-42081822-T-C,rs10414151,1,T,C,42081822,50733,41935947,42329163,145875
19,ENSG00000254887.1,42132555,19-42081822-T-G,rs10414151,1,T,G,42081822,50733,41935947,42329163,145875
19,ENSG00000104970.6,54532798,19-54520336-G-C,rs10422190,1,G,C,54520336,12462,54336190,54729406,184146
19,ENSG00000104970.6,54532798,19-54520336-G-A,rs10422190,1,G,A,54520336,12462,54336190,54729406,184146
19,ENSG00000166770.4,56478230,19-56403850-A-G,rs10424112,1,A,G,56403850,74380,56281622,56674838,122228
19,ENSG00000105501.6,51645545,19-51670158-T-A,rs10853839,-1,T,A,51670158,24613,51448937,51842153,221221
19,ENSG00000105501.6,51645545,19-51670158-T-G,rs10853839,-1,T,G,51670158,24613,51448937,51842153,221221
19,ENSG00000105501.6,51645545,19-51670158-T-C,rs10853839,-1,T,C,51670158,24613,51448937,51842153,221221
19,ENSG00000213303.3,11523436,19-11445918-C-G,rs115817702,1,C,G,11445918,77518,11326828,11720044,119090
19,ENSG00000213303.3,11523436,19-11445918-C-T,rs115817702,1,C,T,11445918,77518,11326828,11720044,119090
19,ENSG00000187534.4,39943680,19-39941114-C-T,rs11879271,-1,C,T,39941114,2566,39747072,40140288,194042
19,ENSG00000255441.1,51415906,19-51403314-C-A,rs11880024,1,C,A,51403314,12592,51219298,51612514,184016
19,ENSG00000255441.1,51415906,19-51403314-C-T,rs11880024,1,C,T,51403314,12592,51219298,51612514,184016
19,ENSG00000213253.5,13158788,19-13220929-T-C,rs12461897,-1,T,C,13220929,62141,12962180,13355396,258749
19,ENSG00000205786.2,35399531,19-35407997-A-G,rs16970294,1,A,G,35407997,8466,35202923,35596139,205074
19,ENSG00000176761.6,44467641,19-44472016-C-A,rs16989313,1,C,A,44472016,4375,44271033,44664249,200983
19,ENSG00000176761.6,44467641,19-44472016-C-T,rs16989313,1,C,T,44472016,4375,44271033,44664249,200983
19,ENSG00000242615.1,12142893,19-12128978-T-C,rs17719999,-1,T,C,12128978,13915,11946285,12339501,182693
19,ENSG00000204666.3,50050589,19-50009349-G-A,rs2033262,1,G,A,50009349,41240,49853981,50247197,155368
19,ENSG00000254503.1,17418288,19-17406365-T-C,rs2278233,-1,T,C,17406365,11923,17221680,17614896,184685
19,ENSG00000254503.1,17418288,19-17406365-T-A,rs2278233,-1,T,A,17406365,11923,17221680,17614896,184685
19,ENSG00000226510.1,35673304,19-35663012-G-T,rs2311871,-1,G,T,35663012,10292,35476696,35869912,186316
19,ENSG00000167807.9,10316009,19-10362257-A-C,rs280519,-1,A,C,10362257,46248,10119401,10512617,242856
19,ENSG00000167807.9,10316009,19-10362257-A-G,rs280519,-1,A,G,10362257,46248,10119401,10512617,242856
19,ENSG00000188223.7,35745678,19-35741519-C-T,rs2871921,1,C,T,35741519,4159,35549070,35942286,192449
19,ENSG00000198153.6,22685167,19-22656585-A-G,rs2885221,1,A,G,22656585,28582,22488559,22881775,168026
19,ENSG00000232871.4,48680081,19-48618991-T-G,rs3094287,1,T,G,48618991,61090,48483473,48876689,135518
19,ENSG00000232871.4,48680081,19-48618991-T-C,rs3094287,1,T,C,48618991,61090,48483473,48876689,135518
19,ENSG00000225975.1,36687468,19-36626400-A-T,rs3108171,-1,A,T,36626400,61068,36490860,36884076,135540
19,ENSG00000225975.1,36687468,19-36626400-A-G,rs3108171,-1,A,G,36626400,61068,36490860,36884076,135540
19,ENSG00000225975.1,36687468,19-36626400-A-C,rs3108171,-1,A,C,36626400,61068,36490860,36884076,135540
19,ENSG00000180279.4,50817384,19-50825480-C-G,rs3212810,1,C,G,50825480,8096,50620776,51013992,204704
19,ENSG00000180279.4,50817384,19-50825480-C-T,rs3212810,1,C,T,50825480,8096,50620776,51013992,204704
19,ENSG00000231205.6,20409959,19-20543062-G-A,rs33930,-1,G,A,20543062,133103,20213351,20606567,329711
19,ENSG00000123870.8,52592038,19-52678095-G-A,rs34377664,1,G,A,52678095,86057,52395430,52788646,282665
19,ENSG00000131401.7,50344761,19-50454155-G-A,rs35215508,-1,G,A,50454155,109394,50148153,50541369,306002
19,ENSG00000197813.3,49340303,19-49336666-G-A,rs354025,-1,G,A,49336666,3637,49143695,49536911,192971
19,ENSG00000197813.3,49340303,19-49336666-G-C,rs354025,-1,G,C,49336666,3637,49143695,49536911,192971
19,ENSG00000176593.3,58002061,19-57903145-G-A,rs36098237,1,G,A,57903145,98916,57805453,58198669,97692
19,ENSG00000240296.1,54268005,19-54280068-G-C,rs366337,1,G,C,54280068,12063,54071397,54464613,208671
19,ENSG00000240296.1,54268005,19-54280068-G-A,rs366337,1,G,A,54280068,12063,54071397,54464613,208671
19,ENSG00000240296.1,54268005,19-54280068-G-T,rs366337,1,G,T,54280068,12063,54071397,54464613,208671
19,ENSG00000167747.8,50798910,19-50798809-A-C,rs3745528,-1,A,C,50798809,101,50602302,50995518,196507
19,ENSG00000167747.8,50798910,19-50798809-A-T,rs3745528,-1,A,T,50798809,101,50602302,50995518,196507
19,ENSG00000167747.8,50798910,19-50798809-A-G,rs3745528,-1,A,G,50798809,101,50602302,50995518,196507
19,ENSG00000230510.1,46527072,19-46346549-G-T,rs4802307,-1,G,T,46346549,180523,46330464,46723680,16085
19,ENSG00000249435.1,53426499,19-53431351-A-G,rs4803113,-1,A,G,53431351,4852,53229891,53623107,201460
19,ENSG00000259605.1,45764785,19-45735668-G-T,rs4803852,1,G,T,45735668,29117,45568177,45961393,167491
19,ENSG00000259605.1,45764785,19-45735668-G-C,rs4803852,1,G,C,45735668,29117,45568177,45961393,167491
19,ENSG00000237017.1,54125343,19-54115811-G-A,rs4806711,-1,G,A,54115811,9532,53928735,54321951,187076
19,ENSG00000237017.1,54125343,19-54115811-G-C,rs4806711,-1,G,C,54115811,9532,53928735,54321951,187076
19,ENSG00000142539.7,50415799,19-50344768-G-A,rs59323905,1,G,A,50344768,71031,50219191,50612407,125577
19,ENSG00000242255.1,52564076,19-52580557-T-C,rs62117242,1,T,C,52580557,16481,52367468,52760684,213089
19,ENSG00000241015.2,53441863,19-53439900-G-A,rs6509765,1,G,A,53439900,1963,53245255,53638471,194645
19,ENSG00000241015.2,53441863,19-53439900-G-C,rs6509765,1,G,C,53439900,1963,53245255,53638471,194645
19,ENSG00000224730.1,54638892,19-54617369-G-T,rs7246537,-1,G,T,54617369,21523,54442284,54835500,175085
19,ENSG00000224730.1,54638892,19-54617369-G-A,rs7246537,-1,G,A,54617369,21523,54442284,54835500,175085
19,ENSG00000250731.1,53479350,19-53440585-C-A,rs7246687,1,C,A,53440585,38765,53282742,53675958,157843
19,ENSG00000250731.1,53479350,19-53440585-C-T,rs7246687,1,C,T,53440585,38765,53282742,53675958,157843
19,ENSG00000243066.1,14588357,19-14632433-A-T,rs726788,1,A,T,14632433,44076,14391749,14784965,240684
19,ENSG00000243066.1,14588357,19-14632433-A-G,rs726788,1,A,G,14632433,44076,14391749,14784965,240684
19,ENSG00000236312.3,22368952,19-22327616-C-A,rs73025983,-1,C,A,22327616,41336,22172344,22565560,155272
19,ENSG00000236312.3,22368952,19-22327616-C-G,rs73025983,-1,C,G,22327616,41336,22172344,22565560,155272
19,ENSG00000241069.1,53386233,19-53307797-A-G,rs73592742,1,A,G,53307797,78436,53189625,53582841,118172
19,ENSG00000238150.1,53775599,19-53734954-C-T,rs74704964,1,C,T,53734954,40645,53578991,53972207,155963
19,ENSG00000261770.1,27760849,19-27765442-T-C,rs759045,-1,T,C,27765442,4593,27564241,27957457,201201
19,ENSG00000261770.1,27760849,19-27765442-T-A,rs759045,-1,T,A,27765442,4593,27564241,27957457,201201
19,ENSG00000233527.2,36573070,19-36514396-A-G,rs76808668,1,A,G,36514396,58674,36376462,36769678,137934
19,ENSG00000239830.1,9684073,19-9660910-C-T,rs77719434,-1,C,T,9660910,23163,9487465,9880681,173445
19,ENSG00000226025.3,39681433,19-39679413-G-A,rs8103033,1,G,A,39679413,2020,39484825,39878041,194588
19,ENSG00000226025.3,39681433,19-39679413-G-C,rs8103033,1,G,C,39679413,2020,39484825,39878041,194588
19,ENSG00000142396.4,58305377,19-58309722-T-C,rs8105935,1,T,C,58309722,4345,58108769,58501985,200953
19,ENSG00000248830.1,34545395,19-34677724-G-A,rs8106282,-1,G,A,34677724,132329,34348787,34742003,328937
19,ENSG00000248830.1,34545395,19-34677724-G-T,rs8106282,-1,G,T,34677724,132329,34348787,34742003,328937
19,ENSG00000248830.1,34545395,19-34677724-G-C,rs8106282,-1,G,C,34677724,132329,34348787,34742003,328937
19,ENSG00000254760.1,51414298,19-51406150-C-T,rs8107730,1,C,T,51406150,8148,51217690,51610906,188460
19,ENSG00000254760.1,51414298,19-51406150-C-A,rs8107730,1,C,A,51406150,8148,51217690,51610906,188460
19,ENSG00000213777.4,53503392,19-53408257-G-A,rs8182488,1,G,A,53408257,95135,53306784,53700000,101473
19,ENSG00000261342.1,2729327,19-2781327-A-G,rs878893,-1,A,G,2781327,52000,2532719,2925935,248608
19,ENSG00000242779.1,52970875,19-52948038-T-A,rs9304742,-1,T,A,52948038,22837,52774267,53167483,173771
19,ENSG00000242779.1,52970875,19-52948038-T-C,rs9304742,-1,T,C,52948038,22837,52774267,53167483,173771
19,ENSG00000226800.3,3607247,19-3578655-C-T,rs939209,1,C,T,3578655,28592,3410639,3803855,168016
19,ENSG00000198153.6,22685167,19-22626797-C-A,rs10404732,1,C,A,22626797,58370,22488559,22881775,138238
19,ENSG00000232098.1,58407296,19-58426381-T-A,rs10415197,-1,T,A,58426381,19085,58210688,58603904,215693
19,ENSG00000232098.1,58407296,19-58426381-T-C,rs10415197,-1,T,C,58426381,19085,58210688,58603904,215693
19,ENSG00000180279.4,50817384,19-50820245-A-T,rs1054713,1,A,T,50820245,2861,50620776,51013992,199469
19,ENSG00000180279.4,50817384,19-50820245-A-G,rs1054713,1,A,G,50820245,2861,50620776,51013992,199469
19,ENSG00000259605.1,45764785,19-45877845-G-A,rs112120887,1,G,A,45877845,113060,45568177,45961393,309668
19,ENSG00000205786.2,35399531,19-35577259-G-A,rs114852218,1,G,A,35577259,177728,35202923,35596139,374336
19,ENSG00000250731.1,53479350,19-53439630-A-G,rs11672864,1,A,G,53439630,39720,53282742,53675958,156888
19,ENSG00000197813.3,49340303,19-49381743-C-T,rs11882571,-1,C,T,49381743,41440,49143695,49536911,238048
19,ENSG00000236144.1,35546029,19-35355974-G-C,rs12462800,-1,G,C,35355974,190055,35349421,35742637,6553
19,ENSG00000236144.1,35546029,19-35355974-G-T,rs12462800,-1,G,T,35355974,190055,35349421,35742637,6553
19,ENSG00000236144.1,35546029,19-35355974-G-A,rs12462800,-1,G,A,35355974,190055,35349421,35742637,6553
19,ENSG00000226025.3,39681433,19-39738769-C-G,rs12611334,1,C,G,39738769,57336,39484825,39878041,253944
19,ENSG00000123870.8,52592038,19-52600622-T-C,rs12971484,1,T,C,52600622,8584,52395430,52788646,205192
19,ENSG00000242255.1,52564076,19-52562408-A-G,rs12985487,1,A,G,52562408,1668,52367468,52760684,194940
19,ENSG00000176593.3,58002061,19-58018150-C-T,rs1549495,1,C,T,58018150,16089,57805453,58198669,212697
19,ENSG00000166770.4,56478230,19-56494183-G-A,rs16987292,1,G,A,56494183,15953,56281622,56674838,212561
19,ENSG00000261770.1,27760849,19-27929882-C-G,rs17620611,-1,C,G,27929882,169033,27564241,27957457,365641
19,ENSG00000226696.1,54449014,19-54351651-A-G,rs2287826,-1,A,G,54351651,97363,54252406,54645622,99245
19,ENSG00000226696.1,54449014,19-54351651-A-T,rs2287826,-1,A,T,54351651,97363,54252406,54645622,99245
19,ENSG00000167747.8,50798910,19-50824837-G-A,rs2560934,-1,G,A,50824837,25927,50602302,50995518,222535
19,ENSG00000167747.8,50798910,19-50824837-G-C,rs2560934,-1,G,C,50824837,25927,50602302,50995518,222535
19,ENSG00000249435.1,53426499,19-53429112-C-G,rs2617765,-1,C,G,53429112,2613,53229891,53623107,199221
19,ENSG00000249435.1,53426499,19-53429112-C-T,rs2617765,-1,C,T,53429112,2613,53229891,53623107,199221
19,ENSG00000232220.1,53876049,19-53889327-G-A,rs307947,-1,G,A,53889327,13278,53679441,54072657,209886
19,ENSG00000233527.2,36573070,19-36598063-G-C,rs3096628,1,G,C,36598063,24993,36376462,36769678,221601
19,ENSG00000233527.2,36573070,19-36598063-G-A,rs3096628,1,G,A,36598063,24993,36376462,36769678,221601
19,ENSG00000260160.1,52063703,19-52135509-T-C,rs34216052,-1,T,C,52135509,71806,51867095,52260311,268414
19,ENSG00000104970.6,54532798,19-54546061-G-T,rs4806780,1,G,T,54546061,13263,54336190,54729406,209871
19,ENSG00000104970.6,54532798,19-54546061-G-A,rs4806780,1,G,A,54546061,13263,54336190,54729406,209871
19,ENSG00000261342.1,2729327,19-2738354-A-T,rs4806874,-1,A,T,2738354,9027,2532719,2925935,205635
19,ENSG00000261342.1,2729327,19-2738354-A-G,rs4806874,-1,A,G,2738354,9027,2532719,2925935,205635
19,ENSG00000261342.1,2729327,19-2738354-A-C,rs4806874,-1,A,C,2738354,9027,2532719,2925935,205635
19,ENSG00000176761.6,44467641,19-44520503-C-T,rs61742432,1,C,T,44520503,52862,44271033,44664249,249470
19,ENSG00000204666.3,50050589,19-50059493-G-T,rs61749501,1,G,T,50059493,8904,49853981,50247197,205512
19,ENSG00000204666.3,50050589,19-50059493-G-C,rs61749501,1,G,C,50059493,8904,49853981,50247197,205512
19,ENSG00000262497.1,35233003,19-35396121-C-T,rs71352989,-1,C,T,35396121,163118,35036395,35429611,359726
19,ENSG00000167774.1,8321379,19-8381172-G-A,rs7249520,-1,G,A,8381172,59793,8124771,8517987,256401
19,ENSG00000167774.1,8321379,19-8381172-G-T,rs7249520,-1,G,T,8381172,59793,8124771,8517987,256401
19,ENSG00000171570.5,40778271,19-40718993-A-C,rs7257602,1,A,C,40718993,59278,40581663,40974879,137330
19,ENSG00000171570.5,40778271,19-40718993-A-G,rs7257602,1,A,G,40718993,59278,40581663,40974879,137330
19,ENSG00000223573.1,5567953,19-5432998-C-G,rs74790527,-1,C,G,5432998,134955,5371345,5764561,61653
19,ENSG00000223573.1,5567953,19-5432998-C-T,rs74790527,-1,C,T,5432998,134955,5371345,5764561,61653
19,ENSG00000219665.3,11987679,19-12075917-A-G,rs76842919,1,A,G,12075917,88238,11791071,12184287,284846
19,ENSG00000219665.3,11987679,19-12075917-A-T,rs76842919,1,A,T,12075917,88238,11791071,12184287,284846
19,ENSG00000242779.1,52970875,19-52997291-C-A,rs80008812,-1,C,A,52997291,26416,52774267,53167483,223024
19,ENSG00000241015.2,53441863,19-53444565-G-A,rs8102929,1,G,A,53444565,2702,53245255,53638471,199310
19,ENSG00000241015.2,53441863,19-53444565-G-C,rs8102929,1,G,C,53444565,2702,53245255,53638471,199310
19,ENSG00000243680.1,52143043,19-52311895-G-A,rs8112051,1,G,A,52311895,168852,51946435,52339651,365460
19,ENSG00000242615.1,12142893,19-12085375-G-T,rs8113028,-1,G,T,12085375,57518,11946285,12339501,139090
19,ENSG00000242615.1,12142893,19-12085375-G-A,rs8113028,-1,G,A,12085375,57518,11946285,12339501,139090
19,ENSG00000242615.1,12142893,19-12085375-G-C,rs8113028,-1,G,C,12085375,57518,11946285,12339501,139090
19,ENSG00000231205.6,20409959,19-20377121-G-A,rs8182505,-1,G,A,20377121,32838,20213351,20606567,163770
19,ENSG00000231205.6,20409959,19-20377121-G-T,rs8182505,-1,G,T,20377121,32838,20213351,20606567,163770
19,ENSG00000105501.6,51645545,19-51627385-C-A,rs872629,-1,C,A,51627385,18160,51448937,51842153,178448
19,ENSG00000243066.1,14588357,19-14632112-G-T,rs9305046,1,G,T,14632112,43755,14391749,14784965,240363
19,ENSG00000243066.1,14588357,19-14632112-G-A,rs9305046,1,G,A,14632112,43755,14391749,14784965,240363
19,ENSG00000242100.1,29956988,19-30139404-C-A,rs10415167,-1,C,A,30139404,182416,29760380,30153596,379024
19,ENSG00000243066.1,14588357,19-14502396-C-T,rs10419701,1,C,T,14502396,85961,14391749,14784965,110647
19,ENSG00000255875.1,52809824,19-52821267-G-A,rs111405357,1,G,A,52821267,11443,52613216,53006432,208051
19,ENSG00000167807.9,10316009,19-10431645-C-G,rs111740485,-1,C,G,10431645,115636,10119401,10512617,312244
19,ENSG00000243455.1,18048637,19-18063921-C-T,rs11575935,1,C,T,18063921,15284,17852029,18245245,211892
19,ENSG00000167774.1,8321379,19-8502381-T-C,rs11667920,-1,T,C,8502381,181002,8124771,8517987,377610
19,ENSG00000236312.3,22368952,19-22279213-C-T,rs11668951,-1,C,T,22279213,89739,22172344,22565560,106869
19,ENSG00000240522.1,21150438,19-21230335-C-T,rs11671410,-1,C,T,21230335,79897,20953830,21347046,276505
19,ENSG00000249435.1,53426499,19-53417738-G-A,rs11671655,-1,G,A,53417738,8761,53229891,53623107,187847
19,ENSG00000166770.4,56478230,19-56352299-C-T,rs11672540,1,C,T,56352299,125931,56281622,56674838,70677
19,ENSG00000213293.4,12260126,19-12194220-A-T,rs116848116,1,A,T,12194220,65906,12063518,12456734,130702
19,ENSG00000213293.4,12260126,19-12194220-A-G,rs116848116,1,A,G,12194220,65906,12063518,12456734,130702
19,ENSG00000205790.1,4679282,19-4636484-C-T,rs117882665,1,C,T,4636484,42798,4482674,4875890,153810
19,ENSG00000259436.1,42152569,19-41996461-C-T,rs118075381,1,C,T,41996461,156108,41955961,42349177,40500
19,ENSG00000213777.4,53503392,19-53309491-C-T,rs1428641,1,C,T,53309491,193901,53306784,53700000,2707
19,ENSG00000167747.8,50798910,19-50777968-A-C,rs1465557,-1,A,C,50777968,20942,50602302,50995518,175666
19,ENSG00000167747.8,50798910,19-50777968-A-T,rs1465557,-1,A,T,50777968,20942,50602302,50995518,175666
19,ENSG00000204666.3,50050589,19-50015974-T-C,rs1469694,1,T,C,50015974,34615,49853981,50247197,161993
19,ENSG00000180279.4,50817384,19-50972447-C-A,rs16988619,1,C,A,50972447,155063,50620776,51013992,351671
19,ENSG00000186152.6,54696604,19-54662046-A-G,rs1749311,1,A,G,54662046,34558,54499996,54893212,162050
19,ENSG00000219665.3,11987679,19-12165463-G-A,rs17638694,1,G,A,12165463,177784,11791071,12184287,374392
19,ENSG00000219665.3,11987679,19-12165463-G-T,rs17638694,1,G,T,12165463,177784,11791071,12184287,374392
19,ENSG00000240296.1,54268005,19-54368469-T-G,rs1985840,1,T,G,54368469,100464,54071397,54464613,297072
19,ENSG00000240296.1,54268005,19-54368469-T-C,rs1985840,1,T,C,54368469,100464,54071397,54464613,297072
19,ENSG00000233527.2,36573070,19-36579341-G-A,rs3096620,1,G,A,36579341,6271,36376462,36769678,202879
19,ENSG00000233527.2,36573070,19-36579341-G-C,rs3096620,1,G,C,36579341,6271,36376462,36769678,202879
19,ENSG00000233527.2,36573070,19-36579341-G-T,rs3096620,1,G,T,36579341,6271,36376462,36769678,202879
19,ENSG00000197813.3,49340303,19-49279364-G-A,rs353999,-1,G,A,49279364,60939,49143695,49536911,135669
19,ENSG00000232871.4,48680081,19-48592518-C-A,rs3815692,1,C,A,48592518,87563,48483473,48876689,109045
19,ENSG00000236144.1,35546029,19-35356213-A-G,rs387083,-1,A,G,35356213,189816,35349421,35742637,6792
19,ENSG00000259242.1,19606350,19-19520846-A-C,rs4808965,1,A,C,19520846,85504,19409742,19802958,111104
19,ENSG00000259242.1,19606350,19-19520846-A-G,rs4808965,1,A,G,19520846,85504,19409742,19802958,111104
19,ENSG00000259242.1,19606350,19-19520846-A-T,rs4808965,1,A,T,19520846,85504,19409742,19802958,111104
19,ENSG00000213253.5,13158788,19-13339561-A-C,rs62109119,-1,A,C,13339561,180773,12962180,13355396,377381
19,ENSG00000213253.5,13158788,19-13339561-A-G,rs62109119,-1,A,G,13339561,180773,12962180,13355396,377381
19,ENSG00000161643.7,49969600,19-49907016-T-A,rs62126289,1,T,A,49907016,62584,49772992,50166208,134024
19,ENSG00000161643.7,49969600,19-49907016-T-C,rs62126289,1,T,C,49907016,62584,49772992,50166208,134024
19,ENSG00000123870.8,52592038,19-52589212-C-T,rs7247002,1,C,T,52589212,2826,52395430,52788646,193782
19,ENSG00000123870.8,52592038,19-52589212-C-A,rs7247002,1,C,A,52589212,2826,52395430,52788646,193782
19,ENSG00000214223.3,11667030,19-11499672-G-C,rs7256655,-1,G,C,11499672,167358,11470422,11863638,29250
19,ENSG00000205786.2,35399531,19-35437732-A-T,rs7258037,1,A,T,35437732,38201,35202923,35596139,234809
19,ENSG00000205786.2,35399531,19-35437732-A-G,rs7258037,1,A,G,35437732,38201,35202923,35596139,234809
19,ENSG00000226025.3,39681433,19-39684070-C-T,rs7259291,1,C,T,39684070,2637,39484825,39878041,199245
19,ENSG00000240673.1,20080539,19-20097227-A-G,rs76593070,-1,A,G,20097227,16688,19883931,20277147,213296
19,ENSG00000226510.1,35673304,19-35775463-G-A,rs77750939,-1,G,A,35775463,102159,35476696,35869912,298767
19,ENSG00000142396.4,58305377,19-58496892-A-G,rs78282402,1,A,G,58496892,191515,58108769,58501985,388123
19,ENSG00000241015.2,53441863,19-53433258-G-A,rs79030195,1,G,A,53433258,8605,53245255,53638471,188003
19,ENSG00000230510.1,46527072,19-46532224-T-C,rs8102534,-1,T,C,46532224,5152,46330464,46723680,201760
19,ENSG00000250731.1,53479350,19-53444565-G-C,rs8102929,1,G,C,53444565,34785,53282742,53675958,161823
19,ENSG00000250731.1,53479350,19-53444565-G-A,rs8102929,1,G,A,53444565,34785,53282742,53675958,161823
19,ENSG00000261824.1,27793703,19-27805723-A-G,rs8107238,-1,A,G,27805723,12020,27597095,27990311,208628
19,ENSG00000261824.1,27793703,19-27805723-A-T,rs8107238,-1,A,T,27805723,12020,27597095,27990311,208628
19,ENSG00000238150.1,53775599,19-53910075-G-T,rs8111215,1,G,T,53910075,134476,53578991,53972207,331084
19,ENSG00000238150.1,53775599,19-53910075-G-A,rs8111215,1,G,A,53910075,134476,53578991,53972207,331084
19,ENSG00000231205.6,20409959,19-20379052-A-G,rs8111389,-1,A,G,20379052,30907,20213351,20606567,165701
19,ENSG00000231205.6,20409959,19-20379052-A-T,rs8111389,-1,A,T,20379052,30907,20213351,20606567,165701
19,ENSG00000261342.1,2729327,19-2873441-C-G,rs9304900,-1,C,G,2873441,144114,2532719,2925935,340722
19,ENSG00000261342.1,2729327,19-2873441-C-T,rs9304900,-1,C,T,2873441,144114,2532719,2925935,340722
19,ENSG00000105501.6,51645545,19-51510752-G-A,rs962130,-1,G,A,51510752,134793,51448937,51842153,61815
18,ENSG00000215457.4,51845628,18-52006180-A-G,rs12605027,-1,A,G,52006180,160552,51649020,52042236,357160
18,ENSG00000177337.2,3594099,18-3595286-G-A,rs2240898,1,G,A,3595286,1187,3397491,3790707,197795
18,ENSG00000177337.2,3594099,18-3595286-G-C,rs2240898,1,G,C,3595286,1187,3397491,3790707,197795
18,ENSG00000176912.2,658269,18-706589-A-G,rs2612102,-1,A,G,706589,48320,461661,854877,244928
18,ENSG00000215492.4,32413176,18-32268764-C-A,rs3891458,-1,C,A,32268764,144412,32216568,32609784,52196
18,ENSG00000215492.4,32413176,18-32268764-C-T,rs3891458,-1,C,T,32268764,144412,32216568,32609784,52196
18,ENSG00000260747.1,68278243,18-68297384-A-C,rs517992,-1,A,C,68297384,19141,68081635,68474851,215749
18,ENSG00000260747.1,68278243,18-68297384-A-T,rs517992,-1,A,T,68297384,19141,68081635,68474851,215749
18,ENSG00000260552.1,36187459,18-36164714-T-C,rs684890,-1,T,C,36164714,22745,35990851,36384067,173863
18,ENSG00000259985.1,31685655,18-31689270-C-T,rs71361340,1,C,T,31689270,3615,31489047,31882263,200223
18,ENSG00000215512.5,15330282,18-15215872-C-G,rs7227666,-1,C,G,15215872,114410,15133674,15526890,82198
18,ENSG00000215512.5,15330282,18-15215872-C-T,rs7227666,-1,C,T,15215872,114410,15133674,15526890,82198
18,ENSG00000186481.9,14179395,18-14081149-A-G,rs7242001,1,A,G,14081149,98246,13982787,14376003,98362
18,ENSG00000175886.7,39335672,18-39305746-T-G,rs117685376,-1,T,G,39305746,29926,39139064,39532280,166682
18,ENSG00000242060.1,60149576,18-59973835-C-T,rs17066438,1,C,T,59973835,175741,59952968,60346184,20867
18,ENSG00000214255.4,70430231,18-70500037-C-T,rs17241630,1,C,T,70500037,69806,70233623,70626839,266414
18,ENSG00000260552.1,36187459,18-36132745-G-A,rs17672308,-1,G,A,36132745,54714,35990851,36384067,141894
18,ENSG00000176912.2,658269,18-714118-C-G,rs2847603,-1,C,G,714118,55849,461661,854877,252457
18,ENSG00000176912.2,658269,18-714118-C-T,rs2847603,-1,C,T,714118,55849,461661,854877,252457
18,ENSG00000177337.2,3594099,18-3600188-A-G,rs548849,1,A,G,3600188,6089,3397491,3790707,202697
18,ENSG00000243256.1,61405205,18-61394746-T-A,rs7237834,-1,T,A,61394746,10459,61208597,61601813,186149
18,ENSG00000243256.1,61405205,18-61394746-T-G,rs7237834,-1,T,G,61394746,10459,61208597,61601813,186149
18,ENSG00000260389.1,32511860,18-32688420-T-C,rs8093716,1,T,C,32688420,176560,32315252,32708468,373168
18,ENSG00000214318.3,63496989,18-63505000-C-A,rs11152386,1,C,A,63505000,8011,63300381,63693597,204619
18,ENSG00000214318.3,63496989,18-63505000-C-T,rs11152386,1,C,T,63505000,8011,63300381,63693597,204619
18,ENSG00000243256.1,61405205,18-61319876-C-T,rs117262788,-1,C,T,61319876,85329,61208597,61601813,111279
18,ENSG00000243256.1,61405205,18-61319876-C-A,rs117262788,-1,C,A,61319876,85329,61208597,61601813,111279
18,ENSG00000188985.4,26171284,18-26245893-G-A,rs12458331,-1,G,A,26245893,74609,25974676,26367892,271217
18,ENSG00000188985.4,26171284,18-26245893-G-C,rs12458331,-1,G,C,26245893,74609,25974676,26367892,271217
18,ENSG00000260552.1,36187459,18-36111350-T-C,rs1540043,-1,T,C,36111350,76109,35990851,36384067,120499
18,ENSG00000260552.1,36187459,18-36111350-T-A,rs1540043,-1,T,A,36111350,76109,35990851,36384067,120499
18,ENSG00000260552.1,36187459,18-36111350-T-G,rs1540043,-1,T,G,36111350,76109,35990851,36384067,120499
18,ENSG00000261520.1,4264633,18-4177129-G-C,rs4798191,1,G,C,4177129,87504,4068025,4461241,109104
18,ENSG00000261520.1,4264633,18-4177129-G-A,rs4798191,1,G,A,4177129,87504,4068025,4461241,109104
18,ENSG00000176912.2,658269,18-651091-A-G,rs66483937,-1,A,G,651091,7178,461661,854877,189430
18,ENSG00000261126.1,80046900,18-80143232-A-G,rs78532971,1,A,G,80143232,96332,79850292,80243508,292940
17,ENSG00000241525.2,414023,17-409857-G-T,rs11150882,-1,G,T,409857,4166,217415,610631,192442
17,ENSG00000241525.2,414023,17-409857-G-A,rs11150882,-1,G,A,409857,4166,217415,610631,192442
17,ENSG00000229848.1,81514047,17-81510690-T-C,rs11549223,1,T,C,81510690,3357,81317439,81710655,193251
17,ENSG00000255987.1,35515186,17-35537613-A-G,rs11650473,-1,A,G,35537613,22427,35318578,35711794,219035
17,ENSG00000128438.4,16932505,17-16921595-C-T,rs11651352,-1,C,T,16921595,10910,16735897,17129113,185698
17,ENSG00000262165.1,4802335,17-4801383-G-T,rs11654690,-1,G,T,4801383,952,4605727,4998943,195656
17,ENSG00000262165.1,4802335,17-4801383-G-A,rs11654690,-1,G,A,4801383,952,4605727,4998943,195656
17,ENSG00000262049.1,81703317,17-81681544-C-T,rs117352501,-1,C,T,81681544,21773,81506709,81899925,174835
17,ENSG00000257950.2,3696194,17-3672887-C-T,rs117868196,-1,C,T,3672887,23307,3499586,3892802,173301
17,ENSG00000263164.1,5241543,17-5242264-C-G,rs11867480,-1,C,G,5242264,721,5044935,5438151,197329
17,ENSG00000263164.1,5241543,17-5242264-C-T,rs11867480,-1,C,T,5242264,721,5044935,5438151,197329
17,ENSG00000236618.2,1516877,17-1360270-C-T,rs11871309,1,C,T,1360270,156607,1320269,1713485,40001
17,ENSG00000262879.1,47100289,17-47105786-C-T,rs11871364,-1,C,T,47105786,5497,46903681,47296897,202105
17,ENSG00000175061.9,16439037,17-16439519-T-G,rs11871958,1,T,G,16439519,482,16242429,16635645,197090
17,ENSG00000175061.9,16439037,17-16439519-T-C,rs11871958,1,T,C,16439519,482,16242429,16635645,197090
17,ENSG00000239223.2,27274107,17-27240054-C-T,rs12602978,1,C,T,27240054,34053,27077499,27470715,162555
17,ENSG00000225014.1,20111824,17-20111243-C-T,rs12935996,1,C,T,20111243,581,19915216,20308432,196027
17,ENSG00000263063.1,82716255,17-82713475-T-C,rs12943478,-1,T,C,82713475,2780,82519647,82912863,193828
17,ENSG00000262147.1,82588411,17-82586979-T-A,rs1387545,-1,T,A,82586979,1432,82391803,82785019,195176
17,ENSG00000262147.1,82588411,17-82586979-T-C,rs1387545,-1,T,C,82586979,1432,82391803,82785019,195176
17,ENSG00000226521.2,20716483,17-20672384-T-C,rs16941336,1,T,C,20672384,44099,20519875,20913091,152509
17,ENSG00000259753.1,47253897,17-47225320-A-G,rs16941684,1,A,G,47225320,28577,47057289,47450505,168031
17,ENSG00000259753.1,47253897,17-47225320-A-T,rs16941684,1,A,T,47225320,28577,47057289,47450505,168031
17,ENSG00000256826.1,64491523,17-64553147-T-C,rs16947868,1,T,C,64553147,61624,64294915,64688131,258232
17,ENSG00000204584.1,49845910,17-49803065-G-C,rs16948381,1,G,C,49803065,42845,49649302,50042518,153763
17,ENSG00000204584.1,49845910,17-49803065-G-T,rs16948381,1,G,T,49803065,42845,49649302,50042518,153763
17,ENSG00000261959.1,50165316,17-49987777-G-A,rs16948563,-1,G,A,49987777,177539,49968708,50361924,19069
17,ENSG00000214174.4,64973517,17-64985215-A-C,rs17685439,-1,A,C,64985215,11698,64776909,65170125,208306
17,ENSG00000214174.4,64973517,17-64985215-A-T,rs17685439,-1,A,T,64985215,11698,64776909,65170125,208306
17,ENSG00000198496.5,43125551,17-43071077-T-A,rs1799966,1,T,A,43071077,54474,42928943,43322159,142134
17,ENSG00000198496.5,43125551,17-43071077-T-C,rs1799966,1,T,C,43071077,54474,42928943,43322159,142134
17,ENSG00000189343.6,19446852,17-19570207-A-G,rs1961669,-1,A,G,19570207,123355,19250244,19643460,319963
17,ENSG00000108448.13,18722237,17-18706821-T-C,rs1973459,1,T,C,18706821,15416,18525629,18918845,181192
17,ENSG00000108448.13,18722237,17-18706821-T-G,rs1973459,1,T,G,18706821,15416,18525629,18918845,181192
17,ENSG00000243423.1,35076737,17-35003837-T-C,rs2074521,1,T,C,35003837,72900,34880129,35273345,123708
17,ENSG00000261996.1,6655009,17-6663871-A-G,rs218663,-1,A,G,6663871,8862,6458401,6851617,205470
17,ENSG00000262967.1,50693448,17-50677641-G-A,rs2240802,1,G,A,50677641,15807,50496840,50890056,180801
17,ENSG00000262678.1,4986466,17-4937082-G-A,rs2243107,1,G,A,4937082,49384,4789858,5183074,147224
17,ENSG00000262678.1,4986466,17-4937082-G-C,rs2243107,1,G,C,4937082,49384,4789858,5183074,147224
17,ENSG00000215067.4,7012334,17-7114635-G-A,rs2289646,-1,G,A,7114635,102301,6815726,7208942,298909
17,ENSG00000233175.1,45241734,17-45135596-G-T,rs2291447,-1,G,T,45135596,106138,45045126,45438342,90470
17,ENSG00000223878.1,15506866,17-15554994-C-T,rs236810,1,C,T,15554994,48128,15310258,15703474,244736
17,ENSG00000223878.1,15506866,17-15554994-C-G,rs236810,1,C,G,15554994,48128,15310258,15703474,244736
17,ENSG00000226359.1,17242010,17-17348161-T-G,rs242244,1,T,G,17348161,106151,17045402,17438618,302759
17,ENSG00000226359.1,17242010,17-17348161-T-A,rs242244,1,T,A,17348161,106151,17045402,17438618,302759
17,ENSG00000262456.1,2384847,17-2392339-C-A,rs2429919,1,C,A,2392339,7492,2188239,2581455,204100
17,ENSG00000261879.1,5192007,17-5223379-A-G,rs2641256,1,A,G,5223379,31372,4995399,5388615,227980
17,ENSG00000226478.2,16746761,17-16603247-A-G,rs2970062,-1,A,G,16603247,143514,16550153,16943369,53094
17,ENSG00000226478.2,16746761,17-16603247-A-C,rs2970062,-1,A,C,16603247,143514,16550153,16943369,53094
17,ENSG00000226478.2,16746761,17-16603247-A-T,rs2970062,-1,A,T,16603247,143514,16550153,16943369,53094
17,ENSG00000178977.3,8224043,17-8173337-C-T,rs3202848,-1,C,T,8173337,50706,8027435,8420651,145902
17,ENSG00000226137.3,81034573,17-81094956-G-A,rs34534119,-1,G,A,81094956,60383,80837965,81231181,256991
17,ENSG00000226137.3,81034573,17-81094956-G-T,rs34534119,-1,G,T,81094956,60383,80837965,81231181,256991
17,ENSG00000262663.1,82918282,17-82831592-G-C,rs35653278,1,G,C,82831592,86690,82721674,83114890,109918
17,ENSG00000262663.1,82918282,17-82831592-G-A,rs35653278,1,G,A,82831592,86690,82721674,83114890,109918
17,ENSG00000261924.1,80971213,17-80964698-C-A,rs3751934,-1,C,A,80964698,6515,80774605,81167821,190093
17,ENSG00000261924.1,80971213,17-80964698-C-T,rs3751934,-1,C,T,80964698,6515,80774605,81167821,190093
17,ENSG00000227077.2,18572752,17-18650916-T-A,rs3752015,1,T,A,18650916,78164,18376144,18769360,274772
17,ENSG00000227077.2,18572752,17-18650916-T-C,rs3752015,1,T,C,18650916,78164,18376144,18769360,274772
17,ENSG00000262319.1,19143689,17-19292118-G-A,rs3785784,-1,G,A,19292118,148429,18947081,19340297,345037
17,ENSG00000262319.1,19143689,17-19292118-G-C,rs3785784,-1,G,C,19292118,148429,18947081,19340297,345037
17,ENSG00000197665.4,19158893,17-19287629-G-A,rs3785787,-1,G,A,19287629,128736,18962285,19355501,325344
17,ENSG00000197665.4,19158893,17-19287629-G-T,rs3785787,-1,G,T,19287629,128736,18962285,19355501,325344
17,ENSG00000262292.1,19160789,17-19287629-G-A,rs3785787,1,G,A,19287629,126840,18964181,19357397,323448
17,ENSG00000262292.1,19160789,17-19287629-G-T,rs3785787,1,G,T,19287629,126840,18964181,19357397,323448
17,ENSG00000261915.1,7319174,17-7439363-C-T,rs4151122,-1,C,T,7439363,120189,7122566,7515782,316797
17,ENSG00000261915.1,7319174,17-7439363-C-G,rs4151122,-1,C,G,7439363,120189,7122566,7515782,316797
17,ENSG00000229980.4,50866754,17-50898871-A-C,rs4372735,1,A,C,50898871,32117,50670146,51063362,228725
17,ENSG00000229980.4,50866754,17-50898871-A-T,rs4372735,1,A,T,50898871,32117,50670146,51063362,228725
17,ENSG00000262526.1,7244635,17-7341158-A-G,rs4465647,-1,A,G,7341158,96523,7048027,7441243,293131
17,ENSG00000230897.1,14705534,17-14561983-G-T,rs4614771,-1,G,T,14561983,143551,14508926,14902142,53057
17,ENSG00000230897.1,14705534,17-14561983-G-A,rs4614771,-1,G,A,14561983,143551,14508926,14902142,53057
17,ENSG00000230897.1,14705534,17-14561983-G-C,rs4614771,-1,G,C,14561983,143551,14508926,14902142,53057
17,ENSG00000263321.1,82734143,17-82613184-A-G,rs4789704,-1,A,G,82613184,120959,82537535,82930751,75649
17,ENSG00000244184.1,4704230,17-4742769-A-T,rs4790224,1,A,T,4742769,38539,4507622,4900838,235147
17,ENSG00000244184.1,4704230,17-4742769-A-G,rs4790224,1,A,G,4742769,38539,4507622,4900838,235147
17,ENSG00000234327.2,5097223,17-5111073-T-A,rs55777955,1,T,A,5111073,13850,4900615,5293831,210458
17,ENSG00000230969.2,16988329,17-16989020-C-A,rs57096150,1,C,A,16989020,691,16791721,17184937,197299
17,ENSG00000230969.2,16988329,17-16989020-C-T,rs57096150,1,C,T,16989020,691,16791721,17184937,197299
17,ENSG00000230969.2,16988329,17-16989020-C-G,rs57096150,1,C,G,16989020,691,16791721,17184937,197299
17,ENSG00000154874.9,18625447,17-18710696-C-T,rs59559052,-1,C,T,18710696,85249,18428839,18822055,281857
17,ENSG00000259623.1,41851447,17-42037812-C-T,rs60110245,-1,C,T,42037812,186365,41654839,42048055,382973
17,ENSG00000262410.1,82745068,17-82822154-A-G,rs62073990,1,A,G,82822154,77086,82548460,82941676,273694
17,ENSG00000230709.1,16981353,17-16975174-A-G,rs6502546,-1,A,G,16975174,6179,16784745,17177961,190429
17,ENSG00000230709.1,16981353,17-16975174-A-T,rs6502546,-1,A,T,16975174,6179,16784745,17177961,190429
17,ENSG00000230709.1,16981353,17-16975174-A-C,rs6502546,-1,A,C,16975174,6179,16784745,17177961,190429
17,ENSG00000188933.6,16796043,17-16797711-A-T,rs678522,1,A,T,16797711,1668,16599435,16992651,198276
17,ENSG00000236088.1,14069483,17-14033343-A-G,rs708586,-1,A,G,14033343,36140,13872875,14266091,160468
17,ENSG00000262580.1,80205071,17-80209612-T-C,rs709678,-1,T,C,80209612,4541,80008463,80401679,201149
17,ENSG00000205212.3,20896020,17-20755166-G-A,rs71373613,-1,G,A,20755166,140854,20699412,21092628,55754
17,ENSG00000262188.1,79919310,17-79933000-C-T,rs71387956,1,C,T,79933000,13690,79722702,80115918,210298
17,ENSG00000262585.1,79926725,17-79933000-C-T,rs71387956,-1,C,T,79933000,6275,79730117,80123333,202883
17,ENSG00000214719.4,30607566,17-30584825-A-G,rs7211352,1,A,G,30584825,22741,30410958,30804174,173867
17,ENSG00000239203.1,16427474,17-16412605-A-G,rs7217735,1,A,G,16412605,14869,16230866,16624082,181739
17,ENSG00000262050.1,2712012,17-2777428-G-A,rs72817351,1,G,A,2777428,65416,2515404,2908620,262024
17,ENSG00000237888.1,43476198,17-43657979-G-C,rs739770,1,G,C,43657979,181781,43279590,43672806,378389
17,ENSG00000237888.1,43476198,17-43657979-G-T,rs739770,1,G,T,43657979,181781,43279590,43672806,378389
17,ENSG00000214514.2,41634106,17-41630613-G-A,rs7405662,-1,G,A,41630613,3493,41437498,41830714,193115
17,ENSG00000240494.1,28655557,17-28705349-C-T,rs74866084,1,C,T,28705349,49792,28458949,28852165,246400
17,ENSG00000263301.1,7443327,17-7300759-A-C,rs7502836,-1,A,C,7300759,142568,7246719,7639935,54040
17,ENSG00000263301.1,7443327,17-7300759-A-G,rs7502836,-1,A,G,7300759,142568,7246719,7639935,54040
17,ENSG00000263301.1,7443327,17-7300759-A-T,rs7502836,-1,A,T,7300759,142568,7246719,7639935,54040
17,ENSG00000197291.3,42761257,17-42761487-T-G,rs753152,-1,T,G,42761487,230,42564649,42957865,196838
17,ENSG00000230865.1,17456427,17-17524178-G-A,rs75529714,1,G,A,17524178,67751,17259819,17653035,264359
17,ENSG00000167920.4,40819101,17-40846965-A-G,rs757272,1,A,G,40846965,27864,40622493,41015709,224472
17,ENSG00000167920.4,40819101,17-40846965-A-C,rs757272,1,A,C,40846965,27864,40622493,41015709,224472
17,ENSG00000262979.1,80315651,17-80448547-C-T,rs78986329,1,C,T,80448547,132896,80119043,80512259,329504
17,ENSG00000262228.1,765319,17-601865-T-C,rs79657649,-1,T,C,601865,163454,568711,961927,33154
17,ENSG00000213939.4,4705217,17-4654565-C-T,rs79962533,-1,C,T,4654565,50652,4508609,4901825,145956
17,ENSG00000261335.1,76671942,17-76565240-T-C,rs8067372,1,T,C,76565240,106702,76475334,76868550,89906
17,ENSG00000233483.1,45251129,17-45200857-C-T,rs8069208,-1,C,T,45200857,50272,45054521,45447737,146336
17,ENSG00000263171.1,7354944,17-7342355-G-A,rs8069505,-1,G,A,7342355,12589,7158336,7551552,184019
17,ENSG00000141028.4,14024514,17-13999570-T-C,rs8079249,1,T,C,13999570,24944,13827906,14221122,171664
17,ENSG00000263272.1,5432876,17-5425313-G-A,rs8080400,-1,G,A,5425313,7563,5236268,5629484,189045
17,ENSG00000231784.4,752884,17-752680-G-A,rs910924,1,G,A,752680,204,556276,949492,196404
17,ENSG00000261192.1,57045521,17-57221998-A-G,rs9890106,1,A,G,57221998,176477,56848913,57242129,373085
17,ENSG00000227036.1,72592804,17-72608322-G-A,rs9891641,-1,G,A,72608322,15518,72396196,72789412,212126
17,ENSG00000227036.1,72592804,17-72608322-G-C,rs9891641,-1,G,C,72608322,15518,72396196,72789412,212126
17,ENSG00000228782.3,47492459,17-47429316-T-A,rs9893901,-1,T,A,47429316,63143,47295851,47689067,133465
17,ENSG00000228782.3,47492459,17-47429316-T-G,rs9893901,-1,T,G,47429316,63143,47295851,47689067,133465
17,ENSG00000188755.4,62274115,17-62113269-T-G,rs9897212,-1,T,G,62113269,160846,62077507,62470723,35762
17,ENSG00000188755.4,62274115,17-62113269-T-A,rs9897212,-1,T,A,62113269,160846,62077507,62470723,35762
17,ENSG00000214176.4,64829208,17-64792901-T-C,rs9901569,-1,T,C,64792901,36307,64632600,65025816,160301
17,ENSG00000215769.3,64781626,17-64652208-C-T,rs9902749,-1,C,T,64652208,129418,64585018,64978234,67190
17,ENSG00000262112.1,56888880,17-56871589-A-G,rs9906165,1,A,G,56871589,17291,56692272,57085488,179317
17,ENSG00000262333.1,2306761,17-2309336-A-C,rs9910614,1,A,C,2309336,2575,2110153,2503369,199183
17,ENSG00000242067.1,48691694,17-48707366-T-G,rs9914211,-1,T,G,48707366,15672,48495086,48888302,212280
17,ENSG00000253102.1,50396438,17-50537313-T-G,rs9914894,1,T,G,50537313,140875,50199830,50593046,337483
17,ENSG00000253102.1,50396438,17-50537313-T-C,rs9914894,1,T,C,50537313,140875,50199830,50593046,337483
17,ENSG00000260647.1,18268080,17-18153901-C-T,rs9916193,1,C,T,18153901,114179,18071472,18464688,82429
17,ENSG00000260647.1,18268080,17-18153901-C-G,rs9916193,1,C,G,18153901,114179,18071472,18464688,82429
17,ENSG00000263004.1,57084998,17-57087866-T-C,rs998113,-1,T,C,57087866,2868,56888390,57281606,199476
17,ENSG00000261924.1,80971213,17-80966164-C-T,rs1045626,-1,C,T,80966164,5049,80774605,81167821,191559
17,ENSG00000255987.1,35515186,17-35500057-C-T,rs10512471,-1,C,T,35500057,15129,35318578,35711794,181479
17,ENSG00000197291.3,42761257,17-42760742-A-G,rs1078523,-1,A,G,42760742,515,42564649,42957865,196093
17,ENSG00000197291.3,42761257,17-42760742-A-C,rs1078523,-1,A,C,42760742,515,42564649,42957865,196093
17,ENSG00000175061.9,16439037,17-16486184-G-A,rs11078349,1,G,A,16486184,47147,16242429,16635645,243755
17,ENSG00000229848.1,81514047,17-81458645-A-G,rs111269853,1,A,G,81458645,55402,81317439,81710655,141206
17,ENSG00000239552.2,48557262,17-48726176-C-T,rs11653611,1,C,T,48726176,168914,48360654,48753870,365522
17,ENSG00000108958.4,1858446,17-1836494-T-G,rs11654477,-1,T,G,1836494,21952,1661838,2055054,174656
17,ENSG00000108958.4,1858446,17-1836494-T-C,rs11654477,-1,T,C,1836494,21952,1661838,2055054,174656
17,ENSG00000214174.4,64973517,17-65049958-T-C,rs11656396,-1,T,C,65049958,76441,64776909,65170125,273049
17,ENSG00000262519.1,4572206,17-4734403-G-A,rs11658971,1,G,A,4734403,162197,4375598,4768814,358805
17,ENSG00000242067.1,48691694,17-48589121-G-A,rs117470167,-1,G,A,48589121,102573,48495086,48888302,94035
17,ENSG00000242067.1,48691694,17-48589121-G-T,rs117470167,-1,G,T,48589121,102573,48495086,48888302,94035
17,ENSG00000262333.1,2306761,17-2240911-G-C,rs118075173,1,G,C,2240911,65850,2110153,2503369,130758
17,ENSG00000262333.1,2306761,17-2240911-G-A,rs118075173,1,G,A,2240911,65850,2110153,2503369,130758
17,ENSG00000226359.1,17242010,17-17229634-G-A,rs11869283,1,G,A,17229634,12376,17045402,17438618,184232
17,ENSG00000226359.1,17242010,17-17229634-G-C,rs11869283,1,G,C,17229634,12376,17045402,17438618,184232
17,ENSG00000226359.1,17242010,17-17229634-G-T,rs11869283,1,G,T,17229634,12376,17045402,17438618,184232
17,ENSG00000236088.1,14069483,17-14074145-G-A,rs11870213,-1,G,A,14074145,4662,13872875,14266091,201270
17,ENSG00000263164.1,5241543,17-5216725-A-G,rs12051735,-1,A,G,5216725,24818,5044935,5438151,171790
17,ENSG00000228118.2,71620978,17-71678436-T-C,rs12449963,1,T,C,71678436,57458,71424370,71817586,254066
17,ENSG00000262580.1,80205071,17-80193856-G-C,rs12938321,-1,G,C,80193856,11215,80008463,80401679,185393
17,ENSG00000262580.1,80205071,17-80193856-G-T,rs12938321,-1,G,T,80193856,11215,80008463,80401679,185393
17,ENSG00000262580.1,80205071,17-80193856-G-A,rs12938321,-1,G,A,80193856,11215,80008463,80401679,185393
17,ENSG00000262147.1,82588411,17-82604344-C-T,rs12939611,-1,C,T,82604344,15933,82391803,82785019,212541
17,ENSG00000262624.1,7437523,17-7429611-G-A,rs12943692,-1,G,A,7429611,7912,7240915,7634131,188696
17,ENSG00000141028.4,14024514,17-14003993-G-A,rs12946964,1,G,A,14003993,20521,13827906,14221122,176087
17,ENSG00000237888.1,43476198,17-43578591-G-C,rs1316956,1,G,C,43578591,102393,43279590,43672806,299001
17,ENSG00000237888.1,43476198,17-43578591-G-T,rs1316956,1,G,T,43578591,102393,43279590,43672806,299001
17,ENSG00000262456.1,2384847,17-2392111-C-T,rs1545717,1,C,T,2392111,7264,2188239,2581455,203872
17,ENSG00000198496.5,43125551,17-43002200-A-T,rs1567832,1,A,T,43002200,123351,42928943,43322159,73257
17,ENSG00000198496.5,43125551,17-43002200-A-C,rs1567832,1,A,C,43002200,123351,42928943,43322159,73257
17,ENSG00000198496.5,43125551,17-43002200-A-G,rs1567832,1,A,G,43002200,123351,42928943,43322159,73257
17,ENSG00000230148.4,48544351,17-48607567-A-G,rs15689,1,A,G,48607567,63216,48347743,48740959,259824
17,ENSG00000259753.1,47253897,17-47123725-C-A,rs1634269,1,C,A,47123725,130172,47057289,47450505,66436
17,ENSG00000259753.1,47253897,17-47123725-C-G,rs1634269,1,C,G,47123725,130172,47057289,47450505,66436
17,ENSG00000215769.3,64781626,17-64591736-C-T,rs16947914,-1,C,T,64591736,189890,64585018,64978234,6718
17,ENSG00000231458.1,16683438,17-16620083-G-C,rs16959857,1,G,C,16620083,63355,16486830,16880046,133253
17,ENSG00000231458.1,16683438,17-16620083-G-A,rs16959857,1,G,A,16620083,63355,16486830,16880046,133253
17,ENSG00000204650.6,45633049,17-45699947-A-G,rs1724422,1,A,G,45699947,66898,45436441,45829657,263506
17,ENSG00000227694.1,61069871,17-61245682-A-G,rs17513268,1,A,G,61245682,175811,60873263,61266479,372419
17,ENSG00000240125.1,40439917,17-40514261-A-G,rs17708087,-1,A,G,40514261,74344,40243309,40636525,270952
17,ENSG00000240125.1,40439917,17-40514261-A-C,rs17708087,-1,A,C,40514261,74344,40243309,40636525,270952
17,ENSG00000214708.3,32143135,17-32294911-A-T,rs17805538,-1,A,T,32294911,151776,31946527,32339743,348384
17,ENSG00000214708.3,32143135,17-32294911-A-C,rs17805538,-1,A,C,32294911,151776,31946527,32339743,348384
17,ENSG00000214708.3,32143135,17-32294911-A-G,rs17805538,-1,A,G,32294911,151776,31946527,32339743,348384
17,ENSG00000177338.7,73828520,17-73667012-G-C,rs17836840,-1,G,C,73667012,161508,73631912,74025128,35100
17,ENSG00000177338.7,73828520,17-73667012-G-T,rs17836840,-1,G,T,73667012,161508,73631912,74025128,35100
17,ENSG00000262227.1,4987689,17-4818081-A-T,rs17854914,1,A,T,4818081,169608,4791081,5184297,27000
17,ENSG00000262227.1,4987689,17-4818081-A-G,rs17854914,1,A,G,4818081,169608,4791081,5184297,27000
17,ENSG00000262227.1,4987689,17-4818081-A-C,rs17854914,1,A,C,4818081,169608,4791081,5184297,27000
17,ENSG00000246731.2,74213321,17-74173820-C-G,rs1870995,-1,C,G,74173820,39501,74016713,74409929,157107
17,ENSG00000246731.2,74213321,17-74173820-C-T,rs1870995,-1,C,T,74173820,39501,74016713,74409929,157107
17,ENSG00000161939.11,7013733,17-6996757-G-A,rs2073438,1,G,A,6996757,16976,6817125,7210341,179632
17,ENSG00000262319.1,19143689,17-19014602-C-T,rs2074280,-1,C,T,19014602,129087,18947081,19340297,67521
17,ENSG00000197665.4,19158893,17-19014602-C-T,rs2074280,-1,C,T,19014602,144291,18962285,19355501,52317
17,ENSG00000262292.1,19160789,17-19014602-C-T,rs2074280,1,C,T,19014602,146187,18964181,19357397,50421
17,ENSG00000263063.1,82716255,17-82723196-T-A,rs2246563,-1,T,A,82723196,6941,82519647,82912863,203549
17,ENSG00000263063.1,82716255,17-82723196-T-C,rs2246563,-1,T,C,82723196,6941,82519647,82912863,203549
17,ENSG00000261996.1,6655009,17-6612134-C-T,rs2289643,-1,C,T,6612134,42875,6458401,6851617,153733
17,ENSG00000262678.1,4986466,17-4960115-A-T,rs238224,1,A,T,4960115,26351,4789858,5183074,170257
17,ENSG00000262678.1,4986466,17-4960115-A-C,rs238224,1,A,C,4960115,26351,4789858,5183074,170257
17,ENSG00000262678.1,4986466,17-4960115-A-G,rs238224,1,A,G,4960115,26351,4789858,5183074,170257
17,ENSG00000262089.1,6995189,17-7093498-A-T,rs2455548,-1,A,T,7093498,98309,6798581,7191797,294917
17,ENSG00000262089.1,6995189,17-7093498-A-G,rs2455548,-1,A,G,7093498,98309,6798581,7191797,294917
17,ENSG00000262089.1,6995189,17-7093498-A-C,rs2455548,-1,A,C,7093498,98309,6798581,7191797,294917
17,ENSG00000233327.4,18519674,17-18362153-C-T,rs2461837,-1,C,T,18362153,157521,18323066,18716282,39087
17,ENSG00000232300.1,46562795,17-46755851-C-A,rs35732828,-1,C,A,46755851,193056,46366187,46759403,389664
17,ENSG00000262429.1,4967995,17-4783119-A-C,rs3851,1,A,C,4783119,184876,4771387,5164603,11732
17,ENSG00000262429.1,4967995,17-4783119-A-G,rs3851,1,A,G,4783119,184876,4771387,5164603,11732
17,ENSG00000108448.13,18722237,17-18745734-A-T,rs4315390,1,A,T,18745734,23497,18525629,18918845,220105
17,ENSG00000108448.13,18722237,17-18745734-A-G,rs4315390,1,A,G,18745734,23497,18525629,18918845,220105
17,ENSG00000263171.1,7354944,17-7341158-A-G,rs4465647,-1,A,G,7341158,13786,7158336,7551552,182822
17,ENSG00000163597.8,76557775,17-76559024-T-C,rs4647885,1,T,C,76559024,1249,76361167,76754383,197857
17,ENSG00000263219.1,4222091,17-4064770-A-C,rs4790555,1,A,C,4064770,157321,4025483,4418699,39287
17,ENSG00000128438.4,16932505,17-16942153-T-C,rs4792801,-1,T,C,16942153,9648,16735897,17129113,206256
17,ENSG00000128438.4,16932505,17-16942153-T-A,rs4792801,-1,T,A,16942153,9648,16735897,17129113,206256
17,ENSG00000243423.1,35076737,17-35176322-C-G,rs4795064,1,C,G,35176322,99585,34880129,35273345,296193
17,ENSG00000243423.1,35076737,17-35176322-C-A,rs4795064,1,C,A,35176322,99585,34880129,35273345,296193
17,ENSG00000243423.1,35076737,17-35176322-C-T,rs4795064,1,C,T,35176322,99585,34880129,35273345,296193
17,ENSG00000224126.2,18677261,17-18790039-G-A,rs56156915,1,G,A,18790039,112778,18480653,18873869,309386
17,ENSG00000241525.2,414023,17-386653-G-A,rs56161639,-1,G,A,386653,27370,217415,610631,169238
17,ENSG00000262526.1,7244635,17-7327843-C-T,rs58277032,-1,C,T,7327843,83208,7048027,7441243,279816
17,ENSG00000204584.1,49845910,17-49895290-T-G,rs614279,1,T,G,49895290,49380,49649302,50042518,245988
17,ENSG00000204584.1,49845910,17-49895290-T-A,rs614279,1,T,A,49895290,49380,49649302,50042518,245988
17,ENSG00000204584.1,49845910,17-49895290-T-C,rs614279,1,T,C,49895290,49380,49649302,50042518,245988
17,ENSG00000178977.3,8224043,17-8395675-A-G,rs6503113,-1,A,G,8395675,171632,8027435,8420651,368240
17,ENSG00000236618.2,1516877,17-1504582-C-A,rs7208369,1,C,A,1504582,12295,1320269,1713485,184313
17,ENSG00000236618.2,1516877,17-1504582-C-T,rs7208369,1,C,T,1504582,12295,1320269,1713485,184313
17,ENSG00000236618.2,1516877,17-1504582-C-G,rs7208369,1,C,G,1504582,12295,1320269,1713485,184313
17,ENSG00000167920.4,40819101,17-40884800-C-T,rs7212483,1,C,T,40884800,65699,40622493,41015709,262307
17,ENSG00000233098.2,20868497,17-20992725-A-G,rs7218520,1,A,G,20992725,124228,20671889,21065105,320836
17,ENSG00000214514.2,41634106,17-41676424-G-A,rs7219249,-1,G,A,41676424,42318,41437498,41830714,238926
17,ENSG00000214578.3,42753799,17-42562531-G-T,rs7219522,-1,G,T,42562531,191268,42557191,42950407,5340
17,ENSG00000263293.1,47323613,17-47327778-G-A,rs7221345,-1,G,A,47327778,4165,47127005,47520221,200773
17,ENSG00000263293.1,47323613,17-47327778-G-C,rs7221345,-1,G,C,47327778,4165,47127005,47520221,200773
17,ENSG00000263293.1,47323613,17-47327778-G-T,rs7221345,-1,G,T,47327778,4165,47127005,47520221,200773
17,ENSG00000224738.1,59106598,17-59295737-G-T,rs7224035,1,G,T,59295737,189139,58909990,59303206,385747
17,ENSG00000224738.1,59106598,17-59295737-G-A,rs7224035,1,G,A,59295737,189139,58909990,59303206,385747
17,ENSG00000224738.1,59106598,17-59295737-G-C,rs7224035,1,G,C,59295737,189139,58909990,59303206,385747
17,ENSG00000244184.1,4704230,17-4838423-A-G,rs7225684,1,A,G,4838423,134193,4507622,4900838,330801
17,ENSG00000263321.1,82734143,17-82779675-T-C,rs72854352,-1,T,C,82779675,45532,82537535,82930751,242140
17,ENSG00000240480.1,7754394,17-7819325-C-T,rs75106566,1,C,T,7819325,64931,7557786,7951002,261539
17,ENSG00000262135.1,55551649,17-55389703-G-A,rs75210391,-1,G,A,55389703,161946,55355041,55748257,34662
17,ENSG00000223979.2,17677688,17-17634544-G-A,rs75593451,-1,G,A,17634544,43144,17481080,17874296,153464
17,ENSG00000262823.1,4486353,17-4551867-G-C,rs76953250,-1,G,C,4551867,65514,4289745,4682961,262122
17,ENSG00000262823.1,4486353,17-4551867-G-A,rs76953250,-1,G,A,4551867,65514,4289745,4682961,262122
17,ENSG00000261879.1,5192007,17-5281172-T-G,rs77318561,1,T,G,5281172,89165,4995399,5388615,285773
17,ENSG00000213179.4,67784753,17-67601230-A-G,rs77442771,1,A,G,67601230,183523,67588145,67981361,13085
17,ENSG00000231784.4,752884,17-793810-A-G,rs78152133,1,A,G,793810,40926,556276,949492,237534
17,ENSG00000253102.1,50396438,17-50535072-A-G,rs79723678,1,A,G,50535072,138634,50199830,50593046,335242
17,ENSG00000262967.1,50693448,17-50743979-G-A,rs79777439,1,G,A,50743979,50531,50496840,50890056,247139
17,ENSG00000261868.1,4301372,17-4144787-T-C,rs8066337,1,T,C,4144787,156585,4104764,4497980,40023
17,ENSG00000263004.1,57084998,17-57110686-A-C,rs8068737,-1,A,C,57110686,25688,56888390,57281606,222296
17,ENSG00000262777.1,1424473,17-1376985-C-T,rs8082057,1,C,T,1376985,47488,1227865,1621081,149120
17,ENSG00000213939.4,4705217,17-4705163-G-A,rs9895782,-1,G,A,4705163,54,4508609,4901825,196554
17,ENSG00000232724.1,75074306,17-75095226-C-T,rs9904626,1,C,T,75095226,20920,74877698,75270914,217528
17,ENSG00000214176.4,64829208,17-64758468-T-C,rs9908143,-1,T,C,64758468,70740,64632600,65025816,125868
17,ENSG00000214176.4,64829208,17-64758468-T-A,rs9908143,-1,T,A,64758468,70740,64632600,65025816,125868
17,ENSG00000262879.1,47100289,17-47075548-C-A,rs9908463,-1,C,A,47075548,24741,46903681,47296897,171867
17,ENSG00000263004.1,57084998,17-57125954-C-T,rs1007462,-1,C,T,57125954,40956,56888390,57281606,237564
17,ENSG00000141028.4,14024514,17-14074847-A-G,rs10521253,1,A,G,14074847,50333,13827906,14221122,246941
17,ENSG00000262585.1,79926725,17-79936215-G-A,rs11150816,-1,G,A,79936215,9490,79730117,80123333,206098
17,ENSG00000175061.9,16439037,17-16443443-A-C,rs1141283,1,A,C,16443443,4406,16242429,16635645,201014
17,ENSG00000175061.9,16439037,17-16443443-A-T,rs1141283,1,A,T,16443443,4406,16242429,16635645,201014
17,ENSG00000175061.9,16439037,17-16443443-A-G,rs1141283,1,A,G,16443443,4406,16242429,16635645,201014
17,ENSG00000262879.1,47100289,17-47181970-C-T,rs11570460,-1,C,T,47181970,81681,46903681,47296897,278289
17,ENSG00000228782.3,47492459,17-47341773-A-G,rs11652957,-1,A,G,47341773,150686,47295851,47689067,45922
17,ENSG00000234203.1,4972851,17-4841388-A-G,rs11656534,1,A,G,4841388,131463,4776243,5169459,65145
17,ENSG00000262074.1,19064136,17-18925390-G-A,rs11656953,-1,G,A,18925390,138746,18867528,19260744,57862
17,ENSG00000204584.1,49845910,17-49883443-G-A,rs11657553,1,G,A,49883443,37533,49649302,50042518,234141
17,ENSG00000178977.3,8224043,17-8235325-A-C,rs12603646,-1,A,C,8235325,11282,8027435,8420651,207890
17,ENSG00000178977.3,8224043,17-8235325-A-G,rs12603646,-1,A,G,8235325,11282,8027435,8420651,207890
17,ENSG00000236234.1,45452844,17-45422473-A-G,rs12942666,1,A,G,45422473,30371,45256236,45649452,166237
17,ENSG00000226377.1,32876759,17-32964613-C-T,rs12944754,1,C,T,32964613,87854,32680151,33073367,284462
17,ENSG00000226377.1,32876759,17-32964613-C-G,rs12944754,1,C,G,32964613,87854,32680151,33073367,284462
17,ENSG00000226521.2,20716483,17-20717060-C-T,rs12945283,1,C,T,20717060,577,20519875,20913091,197185
17,ENSG00000214708.3,32143135,17-32053362-A-G,rs17182434,-1,A,G,32053362,89773,31946527,32339743,106835
17,ENSG00000262304.1,3636249,17-3601939-C-T,rs17707155,-1,C,T,3601939,34310,3439641,3832857,162298
17,ENSG00000262456.1,2384847,17-2366475-C-G,rs2002863,1,C,G,2366475,18372,2188239,2581455,178236
17,ENSG00000262456.1,2384847,17-2366475-C-A,rs2002863,1,C,A,2366475,18372,2188239,2581455,178236
17,ENSG00000262456.1,2384847,17-2366475-C-T,rs2002863,1,C,T,2366475,18372,2188239,2581455,178236
17,ENSG00000260647.1,18268080,17-18314644-C-T,rs2230153,1,C,T,18314644,46564,18071472,18464688,243172
17,ENSG00000231784.4,752884,17-753640-G-A,rs2251689,1,G,A,753640,756,556276,949492,197364
17,ENSG00000228331.2,19496943,17-19570764-G-A,rs2253611,1,G,A,19570764,73821,19300335,19693551,270429
17,ENSG00000260005.2,81228707,17-81349843-T-G,rs2279157,1,T,G,81349843,121136,81032099,81425315,317744
17,ENSG00000163597.8,76557775,17-76605857-G-T,rs2532439,1,G,T,76605857,48082,76361167,76754383,244690
17,ENSG00000163597.8,76557775,17-76605857-G-A,rs2532439,1,G,A,76605857,48082,76361167,76754383,244690
17,ENSG00000263164.1,5241543,17-5235218-A-C,rs2585284,-1,A,C,5235218,6325,5044935,5438151,190283
17,ENSG00000263164.1,5241543,17-5235218-A-G,rs2585284,-1,A,G,5235218,6325,5044935,5438151,190283
17,ENSG00000240270.1,80976454,17-80836887-T-G,rs2589143,1,T,G,80836887,139567,80779846,81173062,57041
17,ENSG00000177338.7,73828520,17-73704936-G-A,rs2619989,-1,G,A,73704936,123584,73631912,74025128,73024
17,ENSG00000177338.7,73828520,17-73704936-G-C,rs2619989,-1,G,C,73704936,123584,73631912,74025128,73024
17,ENSG00000177338.7,73828520,17-73704936-G-T,rs2619989,-1,G,T,73704936,123584,73631912,74025128,73024
17,ENSG00000240125.1,40439917,17-40591066-C-T,rs2694130,-1,C,T,40591066,151149,40243309,40636525,347757
17,ENSG00000257178.1,48582259,17-48569553-G-C,rs2740758,-1,G,C,48569553,12706,48385651,48778867,183902
17,ENSG00000257178.1,48582259,17-48569553-G-A,rs2740758,-1,G,A,48569553,12706,48385651,48778867,183902
17,ENSG00000236088.1,14069483,17-14144300-G-A,rs28634134,-1,G,A,14144300,74817,13872875,14266091,271425
17,ENSG00000262519.1,4572206,17-4482321-G-A,rs333126,1,G,A,4482321,89885,4375598,4768814,106723
17,ENSG00000263063.1,82716255,17-82773222-G-A,rs36087138,-1,G,A,82773222,56967,82519647,82912863,253575
17,ENSG00000262663.1,82918282,17-82928652-C-T,rs3785512,1,C,T,82928652,10370,82721674,83114890,206978
17,ENSG00000239291.1,47159993,17-46982534-C-T,rs3851793,-1,C,T,46982534,177459,46963385,47356601,19149
17,ENSG00000237854.1,68101908,17-68156769-T-C,rs41322951,1,T,C,68156769,54861,67905300,68298516,251469
17,ENSG00000212719.4,21573394,17-21383493-G-A,rs4247138,-1,G,A,21383493,189901,21376786,21770002,6707
17,ENSG00000228979.2,63471604,17-63480462-G-A,rs4303,1,G,A,63480462,8858,63274996,63668212,205466
17,ENSG00000228979.2,63471604,17-63480462-G-T,rs4303,1,G,T,63480462,8858,63274996,63668212,205466
17,ENSG00000236319.2,55561577,17-55410675-C-T,rs4794583,-1,C,T,55410675,150902,55364969,55758185,45706
17,ENSG00000262188.1,79919310,17-79930670-C-G,rs4889802,1,C,G,79930670,11360,79722702,80115918,207968
17,ENSG00000262188.1,79919310,17-79930670-C-T,rs4889802,1,C,T,79930670,11360,79722702,80115918,207968
17,ENSG00000262580.1,80205071,17-80220032-T-G,rs4889841,-1,T,G,80220032,14961,80008463,80401679,211569
17,ENSG00000262580.1,80205071,17-80220032-T-C,rs4889841,-1,T,C,80220032,14961,80008463,80401679,211569
17,ENSG00000244097.1,657547,17-603798-G-A,rs4968093,-1,G,A,603798,53749,460939,854155,142859
17,ENSG00000244097.1,657547,17-603798-G-T,rs4968093,-1,G,T,603798,53749,460939,854155,142859
17,ENSG00000188755.4,62274115,17-62186879-G-A,rs4968415,-1,G,A,62186879,87236,62077507,62470723,109372
17,ENSG00000188755.4,62274115,17-62186879-G-T,rs4968415,-1,G,T,62186879,87236,62077507,62470723,109372
17,ENSG00000262410.1,82745068,17-82930288-A-G,rs6502015,1,A,G,82930288,185220,82548460,82941676,381828
17,ENSG00000234327.2,5097223,17-5247358-G-A,rs6502851,1,G,A,5247358,150135,4900615,5293831,346743
17,ENSG00000234327.2,5097223,17-5247358-G-C,rs6502851,1,G,C,5247358,150135,4900615,5293831,346743
17,ENSG00000197291.3,42761257,17-42899463-T-A,rs7209982,-1,T,A,42899463,138206,42564649,42957865,334814
17,ENSG00000197291.3,42761257,17-42899463-T-C,rs7209982,-1,T,C,42899463,138206,42564649,42957865,334814
17,ENSG00000214425.1,45550335,17-45475784-T-C,rs7218394,-1,T,C,45475784,74551,45353727,45746943,122057
17,ENSG00000214425.1,45550335,17-45475784-T-G,rs7218394,-1,T,G,45475784,74551,45353727,45746943,122057
17,ENSG00000229848.1,81514047,17-81418289-T-C,rs7220557,1,T,C,81418289,95758,81317439,81710655,100850
17,ENSG00000229848.1,81514047,17-81418289-T-A,rs7220557,1,T,A,81418289,95758,81317439,81710655,100850
17,ENSG00000260563.1,82293716,17-82301780-T-C,rs73368110,1,T,C,82301780,8064,82097108,82490324,204672
17,ENSG00000213939.4,4705217,17-4646894-C-T,rs748694,-1,C,T,4646894,58323,4508609,4901825,138285
17,ENSG00000234899.2,72120805,17-72177274-G-C,rs75237020,-1,G,C,72177274,56469,71924197,72317413,253077
17,ENSG00000234899.2,72120805,17-72177274-G-T,rs75237020,-1,G,T,72177274,56469,71924197,72317413,253077
17,ENSG00000262943.1,6893782,17-6829341-G-A,rs76018634,1,G,A,6829341,64441,6697174,7090390,132167
17,ENSG00000261996.1,6655009,17-6570204-C-T,rs76525613,-1,C,T,6570204,84805,6458401,6851617,111803
17,ENSG00000229944.2,49424922,17-49469402-G-A,rs76774894,-1,G,A,49469402,44480,49228314,49621530,241088
17,ENSG00000262967.1,50693448,17-50523735-C-T,rs78242165,1,C,T,50523735,169713,50496840,50890056,26895
17,ENSG00000261872.1,47169826,17-47061663-C-T,rs8064557,1,C,T,47061663,108163,46973218,47366434,88445
17,ENSG00000261872.1,47169826,17-47061663-C-G,rs8064557,1,C,G,47061663,108163,46973218,47366434,88445
17,ENSG00000262526.1,7244635,17-7407503-T-C,rs8075459,-1,T,C,7407503,162868,7048027,7441243,359476
17,ENSG00000241525.2,414023,17-438357-C-T,rs8076098,-1,C,T,438357,24334,217415,610631,220942
17,ENSG00000241525.2,414023,17-438357-C-G,rs8076098,-1,C,G,438357,24334,217415,610631,220942
17,ENSG00000263089.1,57096425,17-57039914-A-T,rs8076541,-1,A,T,57039914,56511,56899817,57293033,140097
17,ENSG00000263089.1,57096425,17-57039914-A-G,rs8076541,-1,A,G,57039914,56511,56899817,57293033,140097
17,ENSG00000244184.1,4704230,17-4691670-C-T,rs906453,1,C,T,4691670,12560,4507622,4900838,184048
17,ENSG00000244184.1,4704230,17-4691670-C-G,rs906453,1,C,G,4691670,12560,4507622,4900838,184048
17,ENSG00000240480.1,7754394,17-7889008-C-A,rs931543,1,C,A,7889008,134614,7557786,7951002,331222
17,ENSG00000240480.1,7754394,17-7889008-C-T,rs931543,1,C,T,7889008,134614,7557786,7951002,331222
17,ENSG00000262953.1,2587866,17-2525214-C-T,rs9891572,-1,C,T,2525214,62652,2391258,2784474,133956
17,ENSG00000226049.3,34039872,17-33999558-A-G,rs9895289,-1,A,G,33999558,40314,33843264,34236480,156294
17,ENSG00000259623.1,41851447,17-41827392-A-G,rs9896766,-1,A,G,41827392,24055,41654839,42048055,172553
17,ENSG00000259623.1,41851447,17-41827392-A-C,rs9896766,-1,A,C,41827392,24055,41654839,42048055,172553
17,ENSG00000239552.2,48557262,17-48686136-A-G,rs9903698,1,A,G,48686136,128874,48360654,48753870,325482
17,ENSG00000227077.2,18572752,17-18734838-A-T,rs9916065,1,A,T,18734838,162086,18376144,18769360,358694
17,ENSG00000227077.2,18572752,17-18734838-A-G,rs9916065,1,A,G,18734838,162086,18376144,18769360,358694
17,ENSG00000154874.9,18625447,17-18734838-A-T,rs9916065,-1,A,T,18734838,109391,18428839,18822055,305999
17,ENSG00000154874.9,18625447,17-18734838-A-G,rs9916065,-1,A,G,18734838,109391,18428839,18822055,305999
16,ENSG00000261288.1,2554975,16-2595964-G-A,rs1005273,1,G,A,2595964,40989,2358367,2751583,237597
16,ENSG00000261613.1,2556060,16-2595964-G-A,rs1005273,-1,G,A,2595964,39904,2359452,2752668,236512
16,ENSG00000260176.1,2645214,16-2595964-G-A,rs1005273,-1,G,A,2595964,49250,2448606,2841822,147358
16,ENSG00000260010.1,31603531,16-31792064-A-T,rs1034614,-1,A,T,31792064,188533,31406923,31800139,385141
16,ENSG00000260010.1,31603531,16-31792064-A-G,rs1034614,-1,A,G,31792064,188533,31406923,31800139,385141
16,ENSG00000245694.4,54928843,16-54949465-T-C,rs10459806,-1,T,C,54949465,20622,54732235,55125451,217230
16,ENSG00000245694.4,54928843,16-54949465-T-G,rs10459806,-1,T,G,54949465,20622,54732235,55125451,217230
16,ENSG00000245694.4,54928843,16-54949465-T-A,rs10459806,-1,T,A,54949465,20622,54732235,55125451,217230
16,ENSG00000260853.1,28966436,16-28904206-G-A,rs10499,-1,G,A,28904206,62230,28769828,29163044,134378
16,ENSG00000260853.1,28966436,16-28904206-G-T,rs10499,-1,G,T,28904206,62230,28769828,29163044,134378
16,ENSG00000260755.1,66509437,16-66569368-T-C,rs10500537,1,T,C,66569368,59931,66312829,66706045,256539
16,ENSG00000260735.1,15103135,16-15054789-C-T,rs11075253,1,C,T,15054789,48346,14906527,15299743,148262
16,ENSG00000260735.1,15103135,16-15054789-C-A,rs11075253,1,C,A,15054789,48346,14906527,15299743,148262
16,ENSG00000260379.1,8508069,16-8509499-C-T,rs11077313,1,C,T,8509499,1430,8311461,8704677,198038
16,ENSG00000260379.1,8508069,16-8509499-C-G,rs11077313,1,C,G,8509499,1430,8311461,8704677,198038
16,ENSG00000260379.1,8508069,16-8509499-C-A,rs11077313,1,C,A,8509499,1430,8311461,8704677,198038
16,ENSG00000260279.1,89296128,16-89276630-G-A,rs112043543,1,G,A,89276630,19498,89099520,89492736,177110
16,ENSG00000260279.1,89296128,16-89276630-G-C,rs112043543,1,G,C,89276630,19498,89099520,89492736,177110
16,ENSG00000261602.1,69709874,16-69726438-A-G,rs114238154,1,A,G,69726438,16564,69513266,69906482,213172
16,ENSG00000261602.1,69709874,16-69726438-A-C,rs114238154,1,A,C,69726438,16564,69513266,69906482,213172
16,ENSG00000261602.1,69709874,16-69726438-A-T,rs114238154,1,A,T,69726438,16564,69513266,69906482,213172
16,ENSG00000260668.1,64261239,16-64366849-A-C,rs11639835,-1,A,C,64366849,105610,64064631,64457847,302218
16,ENSG00000260668.1,64261239,16-64366849-A-G,rs11639835,-1,A,G,64366849,105610,64064631,64457847,302218
16,ENSG00000228071.4,17932720,16-18051908-G-C,rs11649237,1,G,C,18051908,119188,17736112,18129328,315796
16,ENSG00000228071.4,17932720,16-18051908-G-A,rs11649237,1,G,A,18051908,119188,17736112,18129328,315796
16,ENSG00000248124.3,21820384,16-21777587-G-A,rs116552188,-1,G,A,21777587,42797,21623776,22016992,153811
16,ENSG00000248124.3,21820384,16-21777587-G-T,rs116552188,-1,G,T,21777587,42797,21623776,22016992,153811
16,ENSG00000261079.1,74367462,16-74217183-G-A,rs117041818,1,G,A,74217183,150279,74170854,74564070,46329
16,ENSG00000261659.2,689494,16-770938-G-A,rs117105357,1,G,A,770938,81444,492886,886102,278052
16,ENSG00000260259.1,89686569,16-89668663-C-G,rs117418297,-1,C,G,89668663,17906,89489961,89883177,178702
16,ENSG00000260259.1,89686569,16-89668663-C-T,rs117418297,-1,C,T,89668663,17906,89489961,89883177,178702
16,ENSG00000261461.1,35170241,16-35299048-C-A,rs117663045,-1,C,A,35299048,128807,34973633,35366849,325415
16,ENSG00000261461.1,35170241,16-35299048-C-G,rs117663045,-1,C,G,35299048,128807,34973633,35366849,325415
16,ENSG00000261461.1,35170241,16-35299048-C-T,rs117663045,-1,C,T,35299048,128807,34973633,35366849,325415
16,ENSG00000205018.2,88939789,16-88950086-A-C,rs12102677,1,A,C,88950086,10297,88743181,89136397,206905
16,ENSG00000261732.1,1632259,16-1644150-G-A,rs12444617,1,G,A,1644150,11891,1435651,1828867,208499
16,ENSG00000215003.4,15932294,16-16051890-A-C,rs12445600,-1,A,C,16051890,119596,15735686,16128902,316204
16,ENSG00000215003.4,15932294,16-16051890-A-G,rs12445600,-1,A,G,16051890,119596,15735686,16128902,316204
16,ENSG00000260886.1,71565789,16-71549752-C-A,rs12447033,1,C,A,71549752,16037,71369181,71762397,180571
16,ENSG00000261519.1,66549280,16-66598482-T-C,rs12448207,1,T,C,66598482,49202,66352672,66745888,245810
16,ENSG00000263179.1,11242653,16-11340245-A-C,rs12599600,1,A,C,11340245,97592,11046045,11439261,294200
16,ENSG00000263179.1,11242653,16-11340245-A-T,rs12599600,1,A,T,11340245,97592,11046045,11439261,294200
16,ENSG00000260934.1,19501689,16-19500944-C-T,rs12708624,1,C,T,19500944,745,19305081,19698297,195863
16,ENSG00000260229.1,81476519,16-81438195-A-G,rs12920983,-1,A,G,81438195,38324,81279911,81673127,158284
16,ENSG00000261731.2,31711984,16-31759402-T-G,rs12921028,-1,T,G,31759402,47418,31515376,31908592,244026
16,ENSG00000261731.2,31711984,16-31759402-T-A,rs12921028,-1,T,A,31759402,47418,31515376,31908592,244026
16,ENSG00000214353.3,70755035,16-70771446-A-C,rs12924064,1,A,C,70771446,16411,70558427,70951643,213019
16,ENSG00000260012.1,47262741,16-47164067-A-G,rs13331589,1,A,G,47164067,98674,47066133,47459349,97934
16,ENSG00000259780.1,2236913,16-2088636-G-A,rs13332015,-1,G,A,2088636,148277,2040305,2433521,48331
16,ENSG00000259780.1,2236913,16-2088636-G-C,rs13332015,-1,G,C,2088636,148277,2040305,2433521,48331
16,ENSG00000260267.1,31459736,16-31440005-C-T,rs13333031,-1,C,T,31440005,19731,31263128,31656344,176877
16,ENSG00000260281.1,47144323,16-47171849-T-C,rs1420563,1,T,C,47171849,27526,46947715,47340931,224134
16,ENSG00000260052.1,48637143,16-48692912-C-A,rs1477135,1,C,A,48692912,55769,48440535,48833751,252377
16,ENSG00000260052.1,48637143,16-48692912-C-T,rs1477135,1,C,T,48692912,55769,48440535,48833751,252377
16,ENSG00000262703.1,11349321,16-11251842-G-C,rs149310,-1,G,C,11251842,97479,11152713,11545929,99129
16,ENSG00000261560.1,11882569,16-11862621-T-A,rs154148,-1,T,A,11862621,19948,11685961,12079177,176660
16,ENSG00000261560.1,11882569,16-11862621-T-C,rs154148,-1,T,C,11862621,19948,11685961,12079177,176660
16,ENSG00000263335.1,15726674,16-15727006-C-T,rs16967494,1,C,T,15727006,332,15530066,15923282,196940
16,ENSG00000263335.1,15726674,16-15727006-C-G,rs16967494,1,C,G,15727006,332,15530066,15923282,196940
16,ENSG00000172460.10,2842710,16-2842960-A-C,rs17659759,-1,A,C,2842960,250,2646102,3039318,196858
16,ENSG00000172460.10,2842710,16-2842960-A-G,rs17659759,-1,A,G,2842960,250,2646102,3039318,196858
16,ENSG00000263280.1,2868251,16-2868291-A-G,rs17660212,-1,A,G,2868291,40,2671643,3064859,196648
16,ENSG00000261741.1,31564783,16-31711093-C-A,rs17839519,-1,C,A,31711093,146310,31368175,31761391,342918
16,ENSG00000261741.1,31564783,16-31711093-C-T,rs17839519,-1,C,T,31711093,146310,31368175,31761391,342918
16,ENSG00000235560.3,30534752,16-30528714-A-G,rs17839547,1,A,G,30528714,6038,30338144,30731360,190570
16,ENSG00000261840.1,30699058,16-30528714-A-G,rs17839547,-1,A,G,30528714,170344,30502450,30895666,26264
16,ENSG00000261471.1,84594393,16-84597896-T-G,rs1807098,1,T,G,84597896,3503,84397785,84791001,200111
16,ENSG00000227624.2,20239247,16-20072371-C-G,rs1886712,-1,C,G,20072371,166876,20042639,20435855,29732
16,ENSG00000261448.1,17134504,16-17025322-A-G,rs2201816,1,A,G,17025322,109182,16937896,17331112,87426
16,ENSG00000261588.1,30587920,16-30506720-G-C,rs2230433,-1,G,C,30506720,81200,30391312,30784528,115408
16,ENSG00000259006.1,89922662,16-90043111-G-C,rs2241032,-1,G,C,90043111,120449,89726054,90119270,317057
16,ENSG00000259006.1,89922662,16-90043111-G-T,rs2241032,-1,G,T,90043111,120449,89726054,90119270,317057
16,ENSG00000259006.1,89922662,16-90043111-G-A,rs2241032,-1,G,A,90043111,120449,89726054,90119270,317057
16,ENSG00000261691.1,553847,16-538054-C-T,rs2266931,-1,C,T,538054,15793,357239,750455,180815
16,ENSG00000261691.1,553847,16-538054-C-G,rs2266931,-1,C,G,538054,15793,357239,750455,180815
16,ENSG00000261889.1,3157483,16-3115682-C-G,rs2280951,-1,C,G,3115682,41801,2960875,3354091,154807
16,ENSG00000261889.1,3157483,16-3115682-C-T,rs2280951,-1,C,T,3115682,41801,2960875,3354091,154807
16,ENSG00000246898.1,66408516,16-66408503-C-A,rs2289149,1,C,A,66408503,13,66211908,66605124,196595
16,ENSG00000246898.1,66408516,16-66408503-C-T,rs2289149,1,C,T,66408503,13,66211908,66605124,196595
16,ENSG00000246898.1,66408516,16-66408503-C-G,rs2289149,1,C,G,66408503,13,66211908,66605124,196595
16,ENSG00000260034.1,25149032,16-25151183-T-A,rs277886,-1,T,A,25151183,2151,24952424,25345640,198759
16,ENSG00000260034.1,25149032,16-25151183-T-C,rs277886,-1,T,C,25151183,2151,24952424,25345640,198759
16,ENSG00000261474.1,31453493,16-31457117-A-C,rs28533031,-1,A,C,31457117,3624,31256885,31650101,200232
16,ENSG00000227827.3,16356224,16-16259309-T-C,rs2856553,1,T,C,16259309,96915,16159616,16552832,99693
16,ENSG00000255198.2,1964895,16-1956098-C-T,rs30254,1,C,T,1956098,8797,1768287,2161503,187811
16,ENSG00000263232.1,72006543,16-72129067-G-T,rs34832584,-1,G,T,72129067,122524,71809935,72203151,319132
16,ENSG00000263232.1,72006543,16-72129067-G-A,rs34832584,-1,G,A,72129067,122524,71809935,72203151,319132
16,ENSG00000261641.1,1445343,16-1456033-C-A,rs35286517,1,C,A,1456033,10690,1248735,1641951,207298
16,ENSG00000246777.1,66751752,16-66604342-G-C,rs35320143,1,G,C,66604342,147410,66555144,66948360,49198
16,ENSG00000246777.1,66751752,16-66604342-G-A,rs35320143,1,G,A,66604342,147410,66555144,66948360,49198
16,ENSG00000260482.1,23670011,16-23665685-A-G,rs35586,1,A,G,23665685,4326,23473403,23866619,192282
16,ENSG00000260630.1,88663298,16-88649934-G-A,rs35601559,1,G,A,88649934,13364,88466690,88859906,183244
16,ENSG00000260894.1,67542572,16-67476298-C-A,rs35790553,-1,C,A,67476298,66274,67345964,67739180,130334
16,ENSG00000261270.1,56940278,16-56884213-C-A,rs35797045,1,C,A,56884213,56065,56743670,57136886,140543
16,ENSG00000261270.1,56940278,16-56884213-C-G,rs35797045,1,C,G,56884213,56065,56743670,57136886,140543
16,ENSG00000258354.1,14911345,16-14889311-C-G,rs3743531,-1,C,G,14889311,22034,14714737,15107953,174574
16,ENSG00000260304.1,31183285,16-31261808-T-A,rs3764327,-1,T,A,31261808,78523,30986677,31379893,275131
16,ENSG00000260304.1,31183285,16-31261808-T-C,rs3764327,-1,T,C,31261808,78523,30986677,31379893,275131
16,ENSG00000261312.1,19706351,16-19711044-T-C,rs3829539,1,T,C,19711044,4693,19509743,19902959,201301
16,ENSG00000260060.1,31196131,16-31336427-A-T,rs3925075,1,A,T,31336427,140296,30999523,31392739,336904
16,ENSG00000260060.1,31196131,16-31336427-A-G,rs3925075,1,A,G,31336427,140296,30999523,31392739,336904
16,ENSG00000260060.1,31196131,16-31336427-A-C,rs3925075,1,A,C,31336427,140296,30999523,31392739,336904
16,ENSG00000262151.1,10888752,16-10930011-A-C,rs4072864,-1,A,C,10930011,41259,10692144,11085360,237867
16,ENSG00000262151.1,10888752,16-10930011-A-G,rs4072864,-1,A,G,10930011,41259,10692144,11085360,237867
16,ENSG00000262151.1,10888752,16-10930011-A-T,rs4072864,-1,A,T,10930011,41259,10692144,11085360,237867
16,ENSG00000260874.1,2459966,16-2404509-A-T,rs4129919,-1,A,T,2404509,55457,2263358,2656574,141151
16,ENSG00000260874.1,2459966,16-2404509-A-C,rs4129919,-1,A,C,2404509,55457,2263358,2656574,141151
16,ENSG00000260874.1,2459966,16-2404509-A-G,rs4129919,-1,A,G,2404509,55457,2263358,2656574,141151
16,ENSG00000262370.1,3087112,16-2973007-G-A,rs4149804,-1,G,A,2973007,114105,2890504,3283720,82503
16,ENSG00000226180.2,87696147,16-87758786-T-C,rs4417557,-1,T,C,87758786,62639,87499539,87892755,259247
16,ENSG00000261286.1,84467361,16-84462764-A-C,rs445001,-1,A,C,84462764,4597,84270753,84663969,192011
16,ENSG00000260350.1,8848724,16-8782988-G-A,rs45515994,-1,G,A,8782988,65736,8652116,9045332,130872
16,ENSG00000260350.1,8848724,16-8782988-G-T,rs45515994,-1,G,T,8782988,65736,8652116,9045332,130872
16,ENSG00000131797.8,31703168,16-31695936-C-T,rs4632148,1,C,T,31695936,7232,31506560,31899776,189376
16,ENSG00000180747.11,21501886,16-21601241-G-A,rs474843,-1,G,A,21601241,99355,21305278,21698494,295963
16,ENSG00000262636.1,11381118,16-11402723-T-A,rs4781083,-1,T,A,11402723,21605,11184510,11577726,218213
16,ENSG00000262636.1,11381118,16-11402723-T-C,rs4781083,-1,T,C,11402723,21605,11184510,11577726,218213
16,ENSG00000262636.1,11381118,16-11402723-T-G,rs4781083,-1,T,G,11402723,21605,11184510,11577726,218213
16,ENSG00000263072.1,3143734,16-3133408-G-A,rs4785929,-1,G,A,3133408,10326,2947126,3340342,186282
16,ENSG00000263072.1,3143734,16-3133408-G-T,rs4785929,-1,G,T,3133408,10326,2947126,3340342,186282
16,ENSG00000262155.1,25067079,16-25034897-A-T,rs4787668,1,A,T,25034897,32182,24870471,25263687,164426
16,ENSG00000262155.1,25067079,16-25034897-A-G,rs4787668,1,A,G,25034897,32182,24870471,25263687,164426
16,ENSG00000261063.1,77249957,16-77210940-T-G,rs4887896,-1,T,G,77210940,39017,77053349,77446565,157591
16,ENSG00000261063.1,77249957,16-77210940-T-C,rs4887896,-1,T,C,77210940,39017,77053349,77446565,157591
16,ENSG00000259810.1,31788202,16-31806240-T-C,rs4889693,1,T,C,31806240,18038,31591594,31984810,214646
16,ENSG00000260177.1,87806476,16-87847868-G-C,rs56225907,-1,G,C,87847868,41392,87609868,88003084,238000
16,ENSG00000260177.1,87806476,16-87847868-G-A,rs56225907,-1,G,A,87847868,41392,87609868,88003084,238000
16,ENSG00000260335.1,29449191,16-29343461-C-A,rs58354524,1,C,A,29343461,105730,29252583,29645799,90878
16,ENSG00000260335.1,29449191,16-29343461-C-T,rs58354524,1,C,T,29343461,105730,29252583,29645799,90878
16,ENSG00000263235.1,3651703,16-3722905-T-C,rs59541166,-1,T,C,3722905,71202,3455095,3848311,267810
16,ENSG00000214331.4,74360859,16-74277555-G-A,rs59681627,-1,G,A,74277555,83304,74164251,74557467,113304
16,ENSG00000233232.2,28472336,16-28498188-G-C,rs61738759,-1,G,C,28498188,25852,28275728,28668944,222460
16,ENSG00000233232.2,28472336,16-28498188-G-A,rs61738759,-1,G,A,28498188,25852,28275728,28668944,222460
16,ENSG00000260121.1,88718615,16-88780144-C-T,rs62048221,1,C,T,88780144,61529,88522007,88915223,258137
16,ENSG00000260999.1,68948261,16-68985376-G-T,rs62055819,-1,G,T,68985376,37115,68751653,69144869,233723
16,ENSG00000260999.1,68948261,16-68985376-G-A,rs62055819,-1,G,A,68985376,37115,68751653,69144869,233723
16,ENSG00000261140.1,2571936,16-2598650-G-T,rs71386677,-1,G,T,2598650,26714,2375328,2768544,223322
16,ENSG00000261707.1,77743000,16-77718311-C-A,rs7184635,-1,C,A,77718311,24689,77546392,77939608,171919
16,ENSG00000261707.1,77743000,16-77718311-C-T,rs7184635,-1,C,T,77718311,24689,77546392,77939608,171919
16,ENSG00000257381.1,16300159,16-16200608-T-A,rs7184653,1,T,A,16200608,99551,16103551,16496767,97057
16,ENSG00000257381.1,16300159,16-16200608-T-C,rs7184653,1,T,C,16200608,99551,16103551,16496767,97057
16,ENSG00000257381.1,16300159,16-16200608-T-G,rs7184653,1,T,G,16200608,99551,16103551,16496767,97057
16,ENSG00000260107.1,1997654,16-1991491-T-G,rs7190048,1,T,G,1991491,6163,1801046,2194262,190445
16,ENSG00000260107.1,1997654,16-1991491-T-A,rs7190048,1,T,A,1991491,6163,1801046,2194262,190445
16,ENSG00000259856.1,46626992,16-46504606-A-G,rs7192689,-1,A,G,46504606,122386,46430384,46823600,74222
16,ENSG00000261777.1,70346806,16-70475935-A-C,rs7199145,-1,A,C,70475935,129129,70150198,70543414,325737
16,ENSG00000261790.1,1990477,16-2005819-G-C,rs72766639,-1,G,C,2005819,15342,1793869,2187085,211950
16,ENSG00000261790.1,1990477,16-2005819-G-A,rs72766639,-1,G,A,2005819,15342,1793869,2187085,211950
16,ENSG00000261158.1,12759282,16-12832453-T-C,rs72780926,1,T,C,12832453,73171,12562674,12955890,269779
16,ENSG00000259982.1,28701540,16-28821061-C-T,rs72793809,-1,C,T,28821061,119521,28504932,28898148,316129
16,ENSG00000240634.1,28814673,16-28978312-T-C,rs72795903,-1,T,C,28978312,163639,28618065,29011281,360247
16,ENSG00000231439.3,22910,16-51277-G-T,rs74003635,1,G,T,51277,28367,-173698,219518,224975
16,ENSG00000231439.3,22910,16-51277-G-A,rs74003635,1,G,A,51277,28367,-173698,219518,224975
16,ENSG00000262470.1,14200357,16-14356817-C-G,rs7404076,1,C,G,14356817,156460,14003749,14396965,353068
16,ENSG00000262470.1,14200357,16-14356817-C-T,rs7404076,1,C,T,14356817,156460,14003749,14396965,353068
16,ENSG00000260682.1,81961926,16-81879436-T-A,rs74943801,1,T,A,81879436,82490,81765318,82158534,114118
16,ENSG00000260682.1,81961926,16-81879436-T-C,rs74943801,1,T,C,81879436,82490,81765318,82158534,114118
16,ENSG00000262587.1,25031881,16-25032248-A-T,rs7498149,1,A,T,25032248,367,24835273,25228489,196975
16,ENSG00000262587.1,25031881,16-25032248-A-G,rs7498149,1,A,G,25032248,367,24835273,25228489,196975
16,ENSG00000238045.4,29820366,16-29887802-G-T,rs75331747,-1,G,T,29887802,67436,29623758,30016974,264044
16,ENSG00000262468.1,4253789,16-4246784-T-G,rs757462,-1,T,G,4246784,7005,4057181,4450397,189603
16,ENSG00000262468.1,4253789,16-4246784-T-C,rs757462,-1,T,C,4246784,7005,4057181,4450397,189603
16,ENSG00000261971.1,3059363,16-3065324-G-C,rs76580947,-1,G,C,3065324,5961,2862755,3255971,202569
16,ENSG00000261971.1,3059363,16-3065324-G-T,rs76580947,-1,G,T,3065324,5961,2862755,3255971,202569
16,ENSG00000241932.1,12881170,16-12916351-C-T,rs76629959,1,C,T,12916351,35181,12684562,13077778,231789
16,ENSG00000262118.1,3369246,16-3484028-G-A,rs77534894,-1,G,A,3484028,114782,3172638,3565854,311390
16,ENSG00000259881.1,88883272,16-88755530-G-A,rs78014167,1,G,A,88755530,127742,88686664,89079880,68866
16,ENSG00000261759.1,19121629,16-19070827-G-T,rs78014980,-1,G,T,19070827,50802,18925021,19318237,145806
16,ENSG00000261759.1,19121629,16-19070827-G-A,rs78014980,-1,G,A,19070827,50802,18925021,19318237,145806
16,ENSG00000261717.1,75464706,16-75273030-C-T,rs79343598,-1,C,T,75273030,191676,75268098,75661314,4932
16,ENSG00000258130.3,30205090,16-30179570-G-A,rs79623117,-1,G,A,30179570,25520,30008482,30401698,171088
16,ENSG00000234769.4,18068,16-56596-C-T,rs80023530,-1,C,T,56596,38528,-178540,214676,235136
16,ENSG00000234769.4,18068,16-56596-C-G,rs80023530,-1,C,G,56596,38528,-178540,214676,235136
16,ENSG00000259945.1,67542963,16-67735190-A-G,rs8046195,-1,A,G,67735190,192227,67346355,67739571,388835
16,ENSG00000260083.1,30875222,16-30697737-T-C,rs8046436,1,T,C,30697737,177485,30678614,31071830,19123
16,ENSG00000261783.1,75381260,16-75400526-C-T,rs8051151,-1,C,T,75400526,19266,75184652,75577868,215874
16,ENSG00000261546.1,89115279,16-89116518-A-G,rs8052780,-1,A,G,89116518,1239,88918671,89311887,197847
16,ENSG00000261546.1,89115279,16-89116518-A-C,rs8052780,-1,A,C,89116518,1239,88918671,89311887,197847
16,ENSG00000260051.1,1451760,16-1382257-A-T,rs8054315,1,A,T,1382257,69503,1255152,1648368,127105
16,ENSG00000260051.1,1451760,16-1382257-A-C,rs8054315,1,A,C,1382257,69503,1255152,1648368,127105
16,ENSG00000260051.1,1451760,16-1382257-A-G,rs8054315,1,A,G,1382257,69503,1255152,1648368,127105
16,ENSG00000260306.1,21795759,16-21726305-G-A,rs8054407,-1,G,A,21726305,69454,21599151,21992367,127154
16,ENSG00000222019.2,90047597,16-90013126-A-T,rs8059973,-1,A,T,90013126,34471,89850989,90244205,162137
16,ENSG00000222019.2,90047597,16-90013126-A-G,rs8059973,-1,A,G,90013126,34471,89850989,90244205,162137
16,ENSG00000251417.1,28802743,16-28845498-C-T,rs8061877,1,C,T,28845498,42755,28606135,28999351,239363
16,ENSG00000261114.1,56941028,16-56896339-T-C,rs8063291,1,T,C,56896339,44689,56744420,57137636,151919
16,ENSG00000262454.1,14302288,16-14301301-T-C,rs878340,1,T,C,14301301,987,14105680,14498896,195621
16,ENSG00000232748.2,31056460,16-31111250-C-T,rs889555,1,C,T,31111250,54790,30859852,31253068,251398
16,ENSG00000261253.1,89321133,16-89320400-A-G,rs889574,1,A,G,89320400,733,89124525,89517741,195875
16,ENSG00000261253.1,89321133,16-89320400-A-T,rs889574,1,A,T,89320400,733,89124525,89517741,195875
16,ENSG00000214725.3,29864308,16-29863614-T-C,rs889695,1,T,C,29863614,694,29667700,30060916,195914
16,ENSG00000220793.4,9156881,16-9130419-A-C,rs956340,-1,A,C,9130419,26462,8960273,9353489,170146
16,ENSG00000220793.4,9156881,16-9130419-A-G,rs956340,-1,A,G,9130419,26462,8960273,9353489,170146
16,ENSG00000260979.1,8962706,16-8987133-C-T,rs964006,1,C,T,8987133,24427,8766098,9159314,221035
16,ENSG00000259940.1,27214993,16-27221697-G-A,rs9788909,-1,G,A,27221697,6704,27018385,27411601,203312
16,ENSG00000262700.1,25093387,16-25093773-A-C,rs9921120,1,A,C,25093773,386,24896779,25289995,196994
16,ENSG00000262700.1,25093387,16-25093773-A-T,rs9921120,1,A,T,25093773,386,24896779,25289995,196994
16,ENSG00000262700.1,25093387,16-25093773-A-G,rs9921120,1,A,G,25093773,386,24896779,25289995,196994
16,ENSG00000260498.1,87779374,16-87749777-C-T,rs9927977,-1,C,T,87749777,29597,87582766,87975982,167011
16,ENSG00000263326.1,25072727,16-25073758-G-A,rs9928693,-1,G,A,25073758,1031,24876119,25269335,197639
16,ENSG00000223959.4,89972631,16-90082388-T-G,rs9929001,1,T,G,90082388,109757,89776023,90169239,306365
16,ENSG00000261278.1,60025141,16-60200244-T-A,rs9930998,-1,T,A,60200244,175103,59828533,60221749,371711
16,ENSG00000261278.1,60025141,16-60200244-T-C,rs9930998,-1,T,C,60200244,175103,59828533,60221749,371711
16,ENSG00000259877.1,89217653,16-89217262-C-T,rs9933428,-1,C,T,89217262,391,89021045,89414261,196217
16,ENSG00000261783.1,75381260,16-75486019-G-C,rs100912,-1,G,C,75486019,104759,75184652,75577868,301367
16,ENSG00000261783.1,75381260,16-75486019-G-A,rs100912,-1,G,A,75486019,104759,75184652,75577868,301367
16,ENSG00000259810.1,31788202,16-31792064-A-T,rs1034614,1,A,T,31792064,3862,31591594,31984810,200470
16,ENSG00000259810.1,31788202,16-31792064-A-G,rs1034614,1,A,G,31792064,3862,31591594,31984810,200470
16,ENSG00000260083.1,30875222,16-30903305-T-G,rs1046276,1,T,G,30903305,28083,30678614,31071830,224691
16,ENSG00000260083.1,30875222,16-30903305-T-C,rs1046276,1,T,C,30903305,28083,30678614,31071830,224691
16,ENSG00000260083.1,30875222,16-30903305-T-A,rs1046276,1,T,A,30903305,28083,30678614,31071830,224691
16,ENSG00000261590.1,60357214,16-60545456-G-A,rs10500418,1,G,A,60545456,188242,60160606,60553822,384850
16,ENSG00000224631.2,61055914,16-60945705-T-A,rs10500437,-1,T,A,60945705,110209,60859306,61252522,86399
16,ENSG00000224631.2,61055914,16-60945705-T-C,rs10500437,-1,T,C,60945705,110209,60859306,61252522,86399
16,ENSG00000261889.1,3157483,16-3142672-T-G,rs1053997,-1,T,G,3142672,14811,2960875,3354091,181797
16,ENSG00000261889.1,3157483,16-3142672-T-C,rs1053997,-1,T,C,3142672,14811,2960875,3354091,181797
16,ENSG00000214725.3,29864308,16-29822393-G-A,rs1057452,1,G,A,29822393,41915,29667700,30060916,154693
16,ENSG00000262155.1,25067079,16-25016734-A-G,rs11074666,1,A,G,25016734,50345,24870471,25263687,146263
16,ENSG00000259843.2,50066224,16-50258073-A-T,rs11076529,-1,A,T,50258073,191849,49869616,50262832,388457
16,ENSG00000259843.2,50066224,16-50258073-A-C,rs11076529,-1,A,C,50258073,191849,49869616,50262832,388457
16,ENSG00000259843.2,50066224,16-50258073-A-G,rs11076529,-1,A,G,50258073,191849,49869616,50262832,388457
16,ENSG00000125122.10,67226998,16-67210172-C-T,rs115503334,-1,C,T,67210172,16826,67030390,67423606,179782
16,ENSG00000259940.1,27214993,16-27233765-G-T,rs11641348,-1,G,T,27233765,18772,27018385,27411601,215380
16,ENSG00000259940.1,27214993,16-27233765-G-C,rs11641348,-1,G,C,27233765,18772,27018385,27411601,215380
16,ENSG00000259940.1,27214993,16-27233765-G-A,rs11641348,-1,G,A,27233765,18772,27018385,27411601,215380
16,ENSG00000198106.6,29291220,16-29409579-A-C,rs11644806,1,A,C,29409579,118359,29094612,29487828,314967
16,ENSG00000198106.6,29291220,16-29409579-A-T,rs11644806,1,A,T,29409579,118359,29094612,29487828,314967
16,ENSG00000198106.6,29291220,16-29409579-A-G,rs11644806,1,A,G,29409579,118359,29094612,29487828,314967
16,ENSG00000260367.1,28978824,16-29144159-G-A,rs11646140,-1,G,A,29144159,165335,28782216,29175432,361943
16,ENSG00000259945.1,67542963,16-67409456-C-T,rs117028005,-1,C,T,67409456,133507,67346355,67739571,63101
16,ENSG00000214331.4,74360859,16-74217183-G-A,rs117041818,-1,G,A,74217183,143676,74164251,74557467,52932
16,ENSG00000261741.1,31564783,16-31686932-C-T,rs117111311,-1,C,T,31686932,122149,31368175,31761391,318757
16,ENSG00000251417.1,28802743,16-28811498-T-C,rs117475154,1,T,C,28811498,8755,28606135,28999351,205363
16,ENSG00000260782.1,46789898,16-46730980-A-G,rs117479788,1,A,G,46730980,58918,46593290,46986506,137690
16,ENSG00000262468.1,4253789,16-4248428-G-A,rs117721843,-1,G,A,4248428,5361,4057181,4450397,191247
16,ENSG00000262468.1,4253789,16-4248428-G-T,rs117721843,-1,G,T,4248428,5361,4057181,4450397,191247
16,ENSG00000259982.1,28701540,16-28841343-T-C,rs11859717,-1,T,C,28841343,139803,28504932,28898148,336411
16,ENSG00000223959.4,89972631,16-89935952-G-A,rs12207,1,G,A,89935952,36679,89776023,90169239,159929
16,ENSG00000223959.4,89972631,16-89935952-G-C,rs12207,1,G,C,89935952,36679,89776023,90169239,159929
16,ENSG00000261270.1,56940278,16-56894304-C-T,rs12445698,1,C,T,56894304,45974,56743670,57136886,150634
16,ENSG00000263276.1,68224713,16-68256297-G-T,rs12446418,1,G,T,68256297,31584,68028105,68421321,228192
16,ENSG00000263276.1,68224713,16-68256297-G-A,rs12446418,1,G,A,68256297,31584,68028105,68421321,228192
16,ENSG00000172460.10,2842710,16-2896054-G-A,rs12447354,-1,G,A,2896054,53344,2646102,3039318,249952
16,ENSG00000172460.10,2842710,16-2896054-G-T,rs12447354,-1,G,T,2896054,53344,2646102,3039318,249952
16,ENSG00000260934.1,19501689,16-19528536-A-G,rs12447418,1,A,G,19528536,26847,19305081,19698297,223455
16,ENSG00000131797.8,31703168,16-31849078-C-T,rs12447780,1,C,T,31849078,145910,31506560,31899776,342518
16,ENSG00000247228.2,70173483,16-70158110-C-T,rs12448586,-1,C,T,70158110,15373,69976875,70370091,181235
16,ENSG00000261067.1,28974804,16-28898301-G-A,rs12596913,1,G,A,28898301,76503,28778196,29171412,120105
16,ENSG00000261067.1,28974804,16-28898301-G-C,rs12596913,1,G,C,28898301,76503,28778196,29171412,120105
16,ENSG00000261067.1,28974804,16-28898301-G-T,rs12596913,1,G,T,28898301,76503,28778196,29171412,120105
16,ENSG00000259877.1,89217653,16-89155387-G-A,rs12597637,-1,G,A,89155387,62266,89021045,89414261,134342
16,ENSG00000261063.1,77249957,16-77242918-A-C,rs12599800,-1,A,C,77242918,7039,77053349,77446565,189569
16,ENSG00000261063.1,77249957,16-77242918-A-T,rs12599800,-1,A,T,77242918,7039,77053349,77446565,189569
16,ENSG00000261063.1,77249957,16-77242918-A-G,rs12599800,-1,A,G,77242918,7039,77053349,77446565,189569
16,ENSG00000259933.1,2091539,16-2094893-G-A,rs12929950,1,G,A,2094893,3354,1894931,2288147,199962
16,ENSG00000259933.1,2091539,16-2094893-G-T,rs12929950,1,G,T,2094893,3354,1894931,2288147,199962
16,ENSG00000241932.1,12881170,16-12707569-T-C,rs1346491,1,T,C,12707569,173601,12684562,13077778,23007
16,ENSG00000261327.1,88186803,16-88175154-T-C,rs148385295,-1,T,C,88175154,11649,87990195,88383411,184959
16,ENSG00000261336.1,47566884,16-47669696-G-A,rs16945483,-1,G,A,47669696,102812,47370276,47763492,299420
16,ENSG00000260816.1,78895361,16-79019713-G-A,rs16949240,1,G,A,79019713,124352,78698753,79091969,320960
16,ENSG00000260643.1,81096296,16-80997755-A-G,rs16954453,-1,A,G,80997755,98541,80899688,81292904,98067
16,ENSG00000260335.1,29449191,16-29642431-G-A,rs17842265,1,G,A,29642431,193240,29252583,29645799,389848
16,ENSG00000261471.1,84594393,16-84597662-T-C,rs2018540,1,T,C,84597662,3269,84397785,84791001,199877
16,ENSG00000261017.1,48059995,16-48096923-C-A,rs2019240,-1,C,A,48096923,36928,47863387,48256603,233536
16,ENSG00000261017.1,48059995,16-48096923-C-T,rs2019240,-1,C,T,48096923,36928,47863387,48256603,233536
16,ENSG00000261158.1,12759282,16-12655814-G-T,rs2059819,1,G,T,12655814,103468,12562674,12955890,93140
16,ENSG00000261158.1,12759282,16-12655814-G-C,rs2059819,1,G,C,12655814,103468,12562674,12955890,93140
16,ENSG00000246777.1,66751752,16-66730775-A-G,rs2068942,1,A,G,66730775,20977,66555144,66948360,175631
16,ENSG00000246777.1,66751752,16-66730775-A-T,rs2068942,1,A,T,66730775,20977,66555144,66948360,175631
16,ENSG00000259006.1,89922662,16-89913443-C-A,rs2270459,-1,C,A,89913443,9219,89726054,90119270,187389
16,ENSG00000263126.1,67882461,16-67868167-G-A,rs2271293,1,G,A,67868167,14294,67685853,68079069,182314
16,ENSG00000263335.1,15726674,16-15756347-A-C,rs2272554,1,A,C,15756347,29673,15530066,15923282,226281
16,ENSG00000263335.1,15726674,16-15756347-A-T,rs2272554,1,A,T,15756347,29673,15530066,15923282,226281
16,ENSG00000263335.1,15726674,16-15756347-A-G,rs2272554,1,A,G,15756347,29673,15530066,15923282,226281
16,ENSG00000260495.1,81313423,16-81486161-A-G,rs2317241,-1,A,G,81486161,172738,81116815,81510031,369346
16,ENSG00000259807.1,29221040,16-29222722-A-G,rs252297,-1,A,G,29222722,1682,29024432,29417648,198290
16,ENSG00000259807.1,29221040,16-29222722-A-T,rs252297,-1,A,T,29222722,1682,29024432,29417648,198290
16,ENSG00000259807.1,29221040,16-29222722-A-C,rs252297,-1,A,C,29222722,1682,29024432,29417648,198290
16,ENSG00000196796.4,29038655,16-29209997-T-G,rs252308,1,T,G,29209997,171342,28842047,29235263,367950
16,ENSG00000196796.4,29038655,16-29209997-T-C,rs252308,1,T,C,29209997,171342,28842047,29235263,367950
16,ENSG00000261532.1,2211997,16-2210566-C-T,rs26857,1,C,T,2210566,1431,2015389,2408605,195177
16,ENSG00000261532.1,2211997,16-2210566-C-G,rs26857,1,C,G,2210566,1431,2015389,2408605,195177
16,ENSG00000263072.1,3143734,16-3101335-C-T,rs2717694,-1,C,T,3101335,42399,2947126,3340342,154209
16,ENSG00000263072.1,3143734,16-3101335-C-G,rs2717694,-1,C,G,3101335,42399,2947126,3340342,154209
16,ENSG00000261207.1,1752262,16-1850146-G-T,rs2815299,-1,G,T,1850146,97884,1555654,1948870,294492
16,ENSG00000261207.1,1752262,16-1850146-G-C,rs2815299,-1,G,C,1850146,97884,1555654,1948870,294492
16,ENSG00000260281.1,47144323,16-47115236-A-C,rs2880117,1,A,C,47115236,29087,46947715,47340931,167521
16,ENSG00000260281.1,47144323,16-47115236-A-G,rs2880117,1,A,G,47115236,29087,46947715,47340931,167521
16,ENSG00000260644.2,32742353,16-32564278-T-G,rs28862011,1,T,G,32564278,178075,32545745,32938961,18533
16,ENSG00000261123.1,2097026,16-1935996-C-T,rs3178732,-1,C,T,1935996,161030,1900418,2293634,35578
16,ENSG00000261123.1,2097026,16-1935996-C-A,rs3178732,-1,C,A,1935996,161030,1900418,2293634,35578
16,ENSG00000222019.2,90047597,16-89854089-C-T,rs34552238,-1,C,T,89854089,193508,89850989,90244205,3100
16,ENSG00000260465.1,66720897,16-66604342-G-A,rs35320143,1,G,A,66604342,116555,66524289,66917505,80053
16,ENSG00000260465.1,66720897,16-66604342-G-C,rs35320143,1,G,C,66604342,116555,66524289,66917505,80053
16,ENSG00000260425.1,1361405,16-1436461-C-T,rs35583599,-1,C,T,1436461,75056,1164797,1558013,271664
16,ENSG00000259804.1,67562309,16-67632192-T-G,rs36008260,-1,T,G,67632192,69883,67365701,67758917,266491
16,ENSG00000236829.4,386763,16-386257-G-A,rs367146,1,G,A,386257,506,190155,583371,196102
16,ENSG00000262528.1,656194,16-790597-C-T,rs3765265,-1,C,T,790597,134403,459586,852802,331011
16,ENSG00000261461.1,35170241,16-35363172-G-A,rs3853178,-1,G,A,35363172,192931,34973633,35366849,389539
16,ENSG00000231439.3,22910,16-36671-T-C,rs41340949,1,T,C,36671,13761,-173698,219518,210369
16,ENSG00000261286.1,84467361,16-84484234-A-T,rs416476,-1,A,T,84484234,16873,84270753,84663969,213481
16,ENSG00000261286.1,84467361,16-84484234-A-C,rs416476,-1,A,C,84484234,16873,84270753,84663969,213481
16,ENSG00000261286.1,84467361,16-84484234-A-G,rs416476,-1,A,G,84484234,16873,84270753,84663969,213481
16,ENSG00000261971.1,3059363,16-3074919-A-T,rs4349147,-1,A,T,3074919,15556,2862755,3255971,212164
16,ENSG00000261971.1,3059363,16-3074919-A-C,rs4349147,-1,A,C,3074919,15556,2862755,3255971,212164
16,ENSG00000261971.1,3059363,16-3074919-A-G,rs4349147,-1,A,G,3074919,15556,2862755,3255971,212164
16,ENSG00000260229.1,81476519,16-81605304-G-A,rs4506892,-1,G,A,81605304,128785,81279911,81673127,325393
16,ENSG00000262636.1,11381118,16-11495905-A-G,rs4520857,-1,A,G,11495905,114787,11184510,11577726,311395
16,ENSG00000262636.1,11381118,16-11495905-A-C,rs4520857,-1,A,C,11495905,114787,11184510,11577726,311395
16,ENSG00000175604.2,12090302,16-12198281-G-A,rs4780416,-1,G,A,12198281,107979,11893694,12286910,304587
16,ENSG00000261226.1,88939651,16-89094965-T-G,rs4782334,-1,T,G,89094965,155314,88743043,89136259,351922
16,ENSG00000261226.1,88939651,16-89094965-T-C,rs4782334,-1,T,C,89094965,155314,88743043,89136259,351922
16,ENSG00000261226.1,88939651,16-89094965-T-A,rs4782334,-1,T,A,89094965,155314,88743043,89136259,351922
16,ENSG00000205018.2,88939789,16-88952758-A-C,rs4782498,1,A,C,88952758,12969,88743181,89136397,209577
16,ENSG00000205018.2,88939789,16-88952758-A-G,rs4782498,1,A,G,88952758,12969,88743181,89136397,209577
16,ENSG00000261613.1,2556060,16-2460602-C-T,rs4786284,-1,C,T,2460602,95458,2359452,2752668,101150
16,ENSG00000205918.5,2642432,16-2827631-T-A,rs4786326,-1,T,A,2827631,185199,2445824,2839040,381807
16,ENSG00000205918.5,2642432,16-2827631-T-C,rs4786326,-1,T,C,2827631,185199,2445824,2839040,381807
16,ENSG00000260482.1,23670011,16-23518768-T-C,rs4968016,1,T,C,23518768,151243,23473403,23866619,45365
16,ENSG00000260482.1,23670011,16-23518768-T-A,rs4968016,1,T,A,23518768,151243,23473403,23866619,45365
16,ENSG00000262700.1,25093387,16-25024306-A-G,rs4993062,1,A,G,25024306,69081,24896779,25289995,127527
16,ENSG00000262700.1,25093387,16-25024306-A-C,rs4993062,1,A,C,25024306,69081,24896779,25289995,127527
16,ENSG00000262700.1,25093387,16-25024306-A-T,rs4993062,1,A,T,25024306,69081,24896779,25289995,127527
16,ENSG00000259881.1,88883272,16-88912442-C-T,rs555191,1,C,T,88912442,29170,88686664,89079880,225778
16,ENSG00000244485.1,76235623,16-76042216-G-A,rs575583,-1,G,A,76042216,193407,76039015,76432231,3201
16,ENSG00000244485.1,76235623,16-76042216-G-T,rs575583,-1,G,T,76042216,193407,76039015,76432231,3201
16,ENSG00000244485.1,76235623,16-76042216-G-C,rs575583,-1,G,C,76042216,193407,76039015,76432231,3201
16,ENSG00000261288.1,2554975,16-2430079-G-A,rs62040704,1,G,A,2430079,124896,2358367,2751583,71712
16,ENSG00000260778.1,2268155,16-2430079-G-A,rs62040704,1,G,A,2430079,161924,2071547,2464763,358532
16,ENSG00000261541.1,32458758,16-32606434-G-C,rs62046077,-1,G,C,32606434,147676,32262150,32655366,344284
16,ENSG00000262151.1,10888752,16-10929968-T-G,rs6416648,-1,T,G,10929968,41216,10692144,11085360,237824
16,ENSG00000262151.1,10888752,16-10929968-T-C,rs6416648,-1,T,C,10929968,41216,10692144,11085360,237824
16,ENSG00000262151.1,10888752,16-10929968-T-A,rs6416648,-1,T,A,10929968,41216,10692144,11085360,237824
16,ENSG00000260630.1,88663298,16-88661325-C-T,rs6500487,1,C,T,88661325,1973,88466690,88859906,194635
16,ENSG00000260630.1,88663298,16-88661325-C-G,rs6500487,1,C,G,88661325,1973,88466690,88859906,194635
16,ENSG00000260177.1,87806476,16-87722441-T-G,rs6540074,-1,T,G,87722441,84035,87609868,88003084,112573
16,ENSG00000235560.3,30534752,16-30535167-G-C,rs6565191,1,G,C,30535167,415,30338144,30731360,197023
16,ENSG00000235560.3,30534752,16-30535167-G-A,rs6565191,1,G,A,30535167,415,30338144,30731360,197023
16,ENSG00000261140.1,2571936,16-2393942-G-C,rs6600201,-1,G,C,2393942,177994,2375328,2768544,18614
16,ENSG00000261140.1,2571936,16-2393942-G-T,rs6600201,-1,G,T,2393942,177994,2375328,2768544,18614
16,ENSG00000261140.1,2571936,16-2393942-G-A,rs6600201,-1,G,A,2393942,177994,2375328,2768544,18614
16,ENSG00000262703.1,11349321,16-11339246-G-C,rs7187741,-1,G,C,11339246,10075,11152713,11545929,186533
16,ENSG00000261707.1,77743000,16-77727501-A-T,rs7191256,-1,A,T,77727501,15499,77546392,77939608,181109
16,ENSG00000261707.1,77743000,16-77727501-A-G,rs7191256,-1,A,G,77727501,15499,77546392,77939608,181109
16,ENSG00000261707.1,77743000,16-77727501-A-C,rs7191256,-1,A,C,77727501,15499,77546392,77939608,181109
16,ENSG00000261243.1,84495599,16-84511002-A-G,rs7191339,1,A,G,84511002,15403,84298991,84692207,212011
16,ENSG00000260755.1,66509437,16-66566576-G-A,rs7193473,1,G,A,66566576,57139,66312829,66706045,253747
16,ENSG00000226180.2,87696147,16-87701428-G-A,rs7193593,-1,G,A,87701428,5281,87499539,87892755,201889
16,ENSG00000226180.2,87696147,16-87701428-G-C,rs7193593,-1,G,C,87701428,5281,87499539,87892755,201889
16,ENSG00000228071.4,17932720,16-17968279-C-T,rs7194356,1,C,T,17968279,35559,17736112,18129328,232167
16,ENSG00000206168.1,231134,16-299331-G-A,rs7200589,1,G,A,299331,68197,34526,427742,264805
16,ENSG00000206168.1,231134,16-299331-G-T,rs7200589,1,G,T,299331,68197,34526,427742,264805
16,ENSG00000250616.2,30096430,16-29922569-C-T,rs72798151,1,C,T,29922569,173861,29899822,30293038,22747
16,ENSG00000226942.2,38321,16-51277-G-T,rs74003635,-1,G,T,51277,12956,-158287,234929,209564
16,ENSG00000226942.2,38321,16-51277-G-A,rs74003635,-1,G,A,51277,12956,-158287,234929,209564
16,ENSG00000259842.1,33950420,16-33796240-C-T,rs74017492,-1,C,T,33796240,154180,33753812,34147028,42428
16,ENSG00000259842.1,33950420,16-33796240-C-A,rs74017492,-1,C,A,33796240,154180,33753812,34147028,42428
16,ENSG00000260249.2,50664903,16-50669105-C-T,rs74017766,1,C,T,50669105,4202,50468295,50861511,200810
16,ENSG00000260259.1,89686569,16-89579438-C-G,rs7404704,-1,C,G,89579438,107131,89489961,89883177,89477
16,ENSG00000260259.1,89686569,16-89579438-C-T,rs7404704,-1,C,T,89579438,107131,89489961,89883177,89477
16,ENSG00000261253.1,89321133,16-89407985-G-A,rs747486,1,G,A,89407985,86852,89124525,89517741,283460
16,ENSG00000261253.1,89321133,16-89407985-G-T,rs747486,1,G,T,89407985,86852,89124525,89517741,283460
16,ENSG00000250685.3,84197053,16-84238932-A-G,rs75063301,-1,A,G,84238932,41879,84000445,84393661,238487
16,ENSG00000261359.2,31201885,16-31082768-T-C,rs750953,1,T,C,31082768,119117,31005277,31398493,77491
16,ENSG00000239763.2,74313390,16-74128763-G-T,rs75723453,-1,G,T,74128763,184627,74116782,74509998,11981
16,ENSG00000239763.2,74313390,16-74128763-G-C,rs75723453,-1,G,C,74128763,184627,74116782,74509998,11981
16,ENSG00000261790.1,1990477,16-1961006-C-T,rs758334,-1,C,T,1961006,29471,1793869,2187085,167137
16,ENSG00000255198.2,1964895,16-1961125-A-T,rs758335,1,A,T,1961125,3770,1768287,2161503,192838
16,ENSG00000255198.2,1964895,16-1961125-A-G,rs758335,1,A,G,1961125,3770,1768287,2161503,192838
16,ENSG00000260107.1,1997654,16-1961125-A-T,rs758335,1,A,T,1961125,36529,1801046,2194262,160079
16,ENSG00000260107.1,1997654,16-1961125-A-G,rs758335,1,A,G,1961125,36529,1801046,2194262,160079
16,ENSG00000260438.1,57713782,16-57580536-G-A,rs76725932,1,G,A,57580536,133246,57517174,57910390,63362
16,ENSG00000262766.1,31118078,16-30989947-T-C,rs77218983,1,T,C,30989947,128131,30921470,31314686,68477
16,ENSG00000260999.1,68948261,16-69036573-C-T,rs78213475,-1,C,T,69036573,88312,68751653,69144869,284920
16,ENSG00000260186.1,58421339,16-58317792-G-A,rs78263708,1,G,A,58317792,103547,58224731,58617947,93061
16,ENSG00000261620.1,35803280,16-35820411-C-G,rs79699765,-1,C,G,35820411,17131,35606672,35999888,213739
16,ENSG00000261620.1,35803280,16-35820411-C-T,rs79699765,-1,C,T,35820411,17131,35606672,35999888,213739
16,ENSG00000261416.1,30184563,16-30080950-C-T,rs8046460,-1,C,T,30080950,103613,29987955,30381171,92995
16,ENSG00000103472.5,29074976,16-29017584-T-C,rs8052343,1,T,C,29017584,57392,28878368,29271584,139216
16,ENSG00000260121.1,88718615,16-88717041-C-T,rs8057031,1,C,T,88717041,1574,88522007,88915223,195034
16,ENSG00000260121.1,88718615,16-88717041-C-G,rs8057031,1,C,G,88717041,1574,88522007,88915223,195034
16,ENSG00000263280.1,2868251,16-2900832-T-A,rs8057363,-1,T,A,2900832,32581,2671643,3064859,229189
16,ENSG00000263280.1,2868251,16-2900832-T-C,rs8057363,-1,T,C,2900832,32581,2671643,3064859,229189
16,ENSG00000263280.1,2868251,16-2900832-T-G,rs8057363,-1,T,G,2900832,32581,2671643,3064859,229189
16,ENSG00000260628.1,31975803,16-31802978-A-T,rs8060086,1,A,T,31802978,172825,31779195,32172411,23783
16,ENSG00000260628.1,31975803,16-31802978-A-C,rs8060086,1,A,C,31802978,172825,31779195,32172411,23783
16,ENSG00000260628.1,31975803,16-31802978-A-G,rs8060086,1,A,G,31802978,172825,31779195,32172411,23783
16,ENSG00000260979.1,8962706,16-8994527-A-G,rs8063445,1,A,G,8994527,31821,8766098,9159314,228429
16,ENSG00000221819.2,90029901,16-90031587-G-A,rs868372,-1,G,A,90031587,1686,89833293,90226509,198294
16,ENSG00000221819.2,90029901,16-90031587-G-T,rs868372,-1,G,T,90031587,1686,89833293,90226509,198294
16,ENSG00000221819.2,90029901,16-90031587-G-C,rs868372,-1,G,C,90031587,1686,89833293,90226509,198294
16,ENSG00000196696.7,70065948,16-69926085-G-C,rs904807,-1,G,C,69926085,139863,69869340,70262556,56745
16,ENSG00000196696.7,70065948,16-69926085-G-A,rs904807,-1,G,A,69926085,139863,69869340,70262556,56745
16,ENSG00000261777.1,70346806,16-70408505-C-T,rs936994,-1,C,T,70408505,61699,70150198,70543414,258307
16,ENSG00000261777.1,70346806,16-70408505-C-G,rs936994,-1,C,G,70408505,61699,70150198,70543414,258307
16,ENSG00000261717.1,75464706,16-75620850-A-T,rs9921233,-1,A,T,75620850,156144,75268098,75661314,352752
16,ENSG00000260267.1,31459736,16-31533048-G-A,rs9923480,-1,G,A,31533048,73312,31263128,31656344,269920
16,ENSG00000260267.1,31459736,16-31533048-G-T,rs9923480,-1,G,T,31533048,73312,31263128,31656344,269920
16,ENSG00000260267.1,31459736,16-31533048-G-C,rs9923480,-1,G,C,31533048,73312,31263128,31656344,269920
16,ENSG00000260565.1,2682369,16-2527012-G-A,rs9935778,-1,G,A,2527012,155357,2485761,2878977,41251
16,ENSG00000246898.1,66408516,16-66364942-G-A,rs9940166,1,G,A,66364942,43574,66211908,66605124,153034
16,ENSG00000260886.1,71565789,16-71452202-C-T,rs9940485,1,C,T,71452202,113587,71369181,71762397,83021
16,ENSG00000263072.1,3143734,16-3180471-G-A,rs1002965,-1,G,A,3180471,36737,2947126,3340342,233345
16,ENSG00000263072.1,3143734,16-3180471-G-C,rs1002965,-1,G,C,3180471,36737,2947126,3340342,233345
16,ENSG00000262714.1,53386944,16-53289837-C-T,rs10852504,1,C,T,53289837,97107,53190336,53583552,99501
16,ENSG00000262714.1,53386944,16-53289837-C-A,rs10852504,1,C,A,53289837,97107,53190336,53583552,99501
16,ENSG00000261731.2,31711984,16-31679087-T-C,rs11644104,-1,T,C,31679087,32897,31515376,31908592,163711
16,ENSG00000228071.4,17932720,16-18019627-G-C,rs11645208,1,G,C,18019627,86907,17736112,18129328,283515
16,ENSG00000228071.4,17932720,16-18019627-G-T,rs11645208,1,G,T,18019627,86907,17736112,18129328,283515
16,ENSG00000228201.1,649200,16-534038-T-A,rs11646982,-1,T,A,534038,115162,452592,845808,81446
16,ENSG00000228201.1,649200,16-534038-T-G,rs11646982,-1,T,G,534038,115162,452592,845808,81446
16,ENSG00000262691.1,67261108,16-67356495-A-G,rs116899303,1,A,G,67356495,95387,67064500,67457716,291995
16,ENSG00000260927.1,58129519,16-57946800-G-C,rs116990110,1,G,C,57946800,182719,57932911,58326127,13889
16,ENSG00000260927.1,58129519,16-57946800-G-T,rs116990110,1,G,T,57946800,182719,57932911,58326127,13889
16,ENSG00000261512.2,46624451,16-46730980-A-G,rs117479788,-1,A,G,46730980,106529,46427843,46821059,303137
16,ENSG00000257391.1,15154903,16-15287491-T-G,rs117770357,1,T,G,15287491,132588,14958295,15351511,329196
16,ENSG00000261804.1,53373479,16-53429699-G-A,rs117857845,1,G,A,53429699,56220,53176871,53570087,252828
16,ENSG00000262514.1,68199795,16-68360802-C-T,rs117949548,1,C,T,68360802,161007,68003187,68396403,357615
16,ENSG00000260518.1,33698504,16-33687931-G-A,rs117949630,-1,G,A,33687931,10573,33501896,33895112,186035
16,ENSG00000260714.1,25015978,16-25125031-A-C,rs11860180,1,A,C,25125031,109053,24819370,25212586,305661
16,ENSG00000260714.1,25015978,16-25125031-A-G,rs11860180,1,A,G,25125031,109053,24819370,25212586,305661
16,ENSG00000260714.1,25015978,16-25125031-A-T,rs11860180,1,A,T,25125031,109053,24819370,25212586,305661
16,ENSG00000262468.1,4253789,16-4231390-T-G,rs11864324,-1,T,G,4231390,22399,4057181,4450397,174209
16,ENSG00000261243.1,84495599,16-84417485-G-A,rs12149164,1,G,A,84417485,78114,84298991,84692207,118494
16,ENSG00000260010.1,31603531,16-31427849-G-A,rs12240,-1,G,A,31427849,175682,31406923,31800139,20926
16,ENSG00000245768.2,58749667,16-58666448-A-C,rs12696,1,A,C,58666448,83219,58553059,58946275,113389
16,ENSG00000245768.2,58749667,16-58666448-A-G,rs12696,1,A,G,58666448,83219,58553059,58946275,113389
16,ENSG00000245768.2,58749667,16-58666448-A-T,rs12696,1,A,T,58666448,83219,58553059,58946275,113389
16,ENSG00000262703.1,11349321,16-11310036-C-T,rs12928822,-1,C,T,11310036,39285,11152713,11545929,157323
16,ENSG00000261641.1,1445343,16-1633743-G-A,rs12932744,1,G,A,1633743,188400,1248735,1641951,385008
16,ENSG00000259933.1,2091539,16-2154834-T-G,rs13242,1,T,G,2154834,63295,1894931,2288147,259903
16,ENSG00000259933.1,2091539,16-2154834-T-C,rs13242,1,T,C,2154834,63295,1894931,2288147,259903
16,ENSG00000259933.1,2091539,16-2154834-T-A,rs13242,1,T,A,2154834,63295,1894931,2288147,259903
16,ENSG00000236829.4,386763,16-468828-G-T,rs13336211,1,G,T,468828,82065,190155,583371,278673
16,ENSG00000236829.4,386763,16-468828-G-A,rs13336211,1,G,A,468828,82065,190155,583371,278673
16,ENSG00000260803.1,35195,16-65187-C-T,rs1366553,-1,C,T,65187,29992,-161413,231803,226600
16,ENSG00000205913.2,2752593,16-2798609-G-T,rs142522686,-1,G,T,2798609,46016,2555985,2949201,242624
16,ENSG00000205913.2,2752593,16-2798609-G-A,rs142522686,-1,G,A,2798609,46016,2555985,2949201,242624
16,ENSG00000262470.1,14200357,16-14009965-C-T,rs1651191,1,C,T,14009965,190392,14003749,14396965,6216
16,ENSG00000261017.1,48059995,16-48167521-T-C,rs16945916,-1,T,C,48167521,107526,47863387,48256603,304134
16,ENSG00000227827.3,16356224,16-16539504-G-C,rs16955286,1,G,C,16539504,183280,16159616,16552832,379888
16,ENSG00000227827.3,16356224,16-16539504-G-T,rs16955286,1,G,T,16539504,183280,16159616,16552832,379888
16,ENSG00000214331.4,74360859,16-74220962-C-T,rs16964162,-1,C,T,74220962,139897,74164251,74557467,56711
16,ENSG00000214331.4,74360859,16-74220962-C-A,rs16964162,-1,C,A,74220962,139897,74164251,74557467,56711
16,ENSG00000259006.1,89922662,16-89784625-C-G,rs16966142,-1,C,G,89784625,138037,89726054,90119270,58571
16,ENSG00000259006.1,89922662,16-89784625-C-T,rs16966142,-1,C,T,89784625,138037,89726054,90119270,58571
16,ENSG00000240311.1,3496201,16-3477077-C-G,rs17136435,1,C,G,3477077,19124,3299593,3692809,177484
16,ENSG00000261707.1,77743000,16-77738102-A-G,rs17716830,-1,A,G,77738102,4898,77546392,77939608,191710
16,ENSG00000238098.4,2361144,16-2332353-C-T,rs17758402,1,C,T,2332353,28791,2164536,2557752,167817
16,ENSG00000262766.1,31118078,16-31089001-G-C,rs17882368,1,G,C,31089001,29077,30921470,31314686,167531
16,ENSG00000262766.1,31118078,16-31089001-G-T,rs17882368,1,G,T,31089001,29077,30921470,31314686,167531
16,ENSG00000262766.1,31118078,16-31089001-G-A,rs17882368,1,G,A,31089001,29077,30921470,31314686,167531
16,ENSG00000261644.1,50742815,16-50717876-G-A,rs1861758,-1,G,A,50717876,24939,50546207,50939423,171669
16,ENSG00000261644.1,50742815,16-50717876-G-T,rs1861758,-1,G,T,50717876,24939,50546207,50939423,171669
16,ENSG00000234769.4,18068,16-51263-G-A,rs216590,-1,G,A,51263,33195,-178540,214676,229803
16,ENSG00000234769.4,18068,16-51263-G-T,rs216590,-1,G,T,51263,33195,-178540,214676,229803
16,ENSG00000231439.3,22910,16-60167-T-A,rs216600,1,T,A,60167,37257,-173698,219518,233865
16,ENSG00000231439.3,22910,16-60167-T-C,rs216600,1,T,C,60167,37257,-173698,219518,233865
16,ENSG00000262488.1,10841544,16-10895694-C-T,rs2229318,-1,C,T,10895694,54150,10644936,11038152,250758
16,ENSG00000261588.1,30587920,16-30506775-C-T,rs2230434,-1,C,T,30506775,81145,30391312,30784528,115463
16,ENSG00000259955.1,25238318,16-25224704-G-T,rs2287799,1,G,T,25224704,13614,25041710,25434926,182994
16,ENSG00000259955.1,25238318,16-25224704-G-C,rs2287799,1,G,C,25224704,13614,25041710,25434926,182994
16,ENSG00000261270.1,56940278,16-56902546-A-G,rs2289117,1,A,G,56902546,37732,56743670,57136886,158876
16,ENSG00000226180.2,87696147,16-87755258-G-T,rs2303771,-1,G,T,87755258,59111,87499539,87892755,255719
16,ENSG00000226180.2,87696147,16-87755258-G-A,rs2303771,-1,G,A,87755258,59111,87499539,87892755,255719
16,ENSG00000246898.1,66408516,16-66422451-A-T,rs2344997,1,A,T,66422451,13935,66211908,66605124,210543
16,ENSG00000246898.1,66408516,16-66422451-A-G,rs2344997,1,A,G,66422451,13935,66211908,66605124,210543
16,ENSG00000246898.1,66408516,16-66422451-A-C,rs2344997,1,A,C,66422451,13935,66211908,66605124,210543
16,ENSG00000262636.1,11381118,16-11291154-C-T,rs243315,-1,C,T,11291154,89964,11184510,11577726,106644
16,ENSG00000260908.1,29107445,16-29083604-C-T,rs252275,-1,C,T,29083604,23841,28910837,29304053,172767
16,ENSG00000261089.1,28413703,16-28325561-T-C,rs2726034,1,T,C,28325561,88142,28217095,28610311,108466
16,ENSG00000261089.1,28413703,16-28325561-T-A,rs2726034,1,T,A,28325561,88142,28217095,28610311,108466
16,ENSG00000261505.1,1322845,16-1211222-A-G,rs2753325,-1,A,G,1211222,111623,1126237,1519453,84985
16,ENSG00000261505.1,1322845,16-1211222-A-C,rs2753325,-1,A,C,1211222,111623,1126237,1519453,84985
16,ENSG00000262700.1,25093387,16-25151183-T-A,rs277886,1,T,A,25151183,57796,24896779,25289995,254404
16,ENSG00000262700.1,25093387,16-25151183-T-C,rs277886,1,T,C,25151183,57796,24896779,25289995,254404
16,ENSG00000260034.1,25149032,16-25160489-G-A,rs277898,-1,G,A,25160489,11457,24952424,25345640,208065
16,ENSG00000251417.1,28802743,16-28814728-C-G,rs28472312,1,C,G,28814728,11985,28606135,28999351,208593
16,ENSG00000251417.1,28802743,16-28814728-C-A,rs28472312,1,C,A,28814728,11985,28606135,28999351,208593
16,ENSG00000251417.1,28802743,16-28814728-C-T,rs28472312,1,C,T,28814728,11985,28606135,28999351,208593
16,ENSG00000172460.10,2842710,16-2699529-C-T,rs3112727,-1,C,T,2699529,143181,2646102,3039318,53427
16,ENSG00000263080.1,11345211,16-11370598-G-C,rs34688318,-1,G,C,11370598,25387,11148603,11541819,221995
16,ENSG00000263080.1,11345211,16-11370598-G-A,rs34688318,-1,G,A,11370598,25387,11148603,11541819,221995
16,ENSG00000260755.1,66509437,16-66623568-G-A,rs355949,1,G,A,66623568,114131,66312829,66706045,310739
16,ENSG00000260755.1,66509437,16-66623568-G-C,rs355949,1,G,C,66623568,114131,66312829,66706045,310739
16,ENSG00000260316.1,905224,16-766977-G-T,rs35935235,-1,G,T,766977,138247,708616,1101832,58361
16,ENSG00000260316.1,905224,16-766977-G-A,rs35935235,-1,G,A,766977,138247,708616,1101832,58361
16,ENSG00000246465.1,28292064,16-28289127-T-C,rs36019610,-1,T,C,28289127,2937,28095456,28488672,193671
16,ENSG00000246465.1,28292064,16-28289127-T-A,rs36019610,-1,T,A,28289127,2937,28095456,28488672,193671
16,ENSG00000183458.8,14911551,16-14889311-C-G,rs3743531,1,C,G,14889311,22240,14714943,15108159,174368
16,ENSG00000261218.1,81739158,16-81701272-T-G,rs3751858,1,T,G,81701272,37886,81542550,81935766,158722
16,ENSG00000260052.1,48637143,16-48575484-C-T,rs3859121,1,C,T,48575484,61659,48440535,48833751,134949
16,ENSG00000260482.1,23670011,16-23617186-A-C,rs425629,1,A,C,23617186,52825,23473403,23866619,143783
16,ENSG00000261889.1,3157483,16-3074919-A-G,rs4349147,-1,A,G,3074919,82564,2960875,3354091,114044
16,ENSG00000261889.1,3157483,16-3074919-A-T,rs4349147,-1,A,T,3074919,82564,2960875,3354091,114044
16,ENSG00000261889.1,3157483,16-3074919-A-C,rs4349147,-1,A,C,3074919,82564,2960875,3354091,114044
16,ENSG00000260498.1,87779374,16-87816457-G-A,rs4442821,-1,G,A,87816457,37083,87582766,87975982,233691
16,ENSG00000260498.1,87779374,16-87816457-G-C,rs4442821,-1,G,C,87816457,37083,87582766,87975982,233691
16,ENSG00000260498.1,87779374,16-87816457-G-T,rs4442821,-1,G,T,87816457,37083,87582766,87975982,233691
16,ENSG00000259940.1,27214993,16-27304962-T-C,rs4523933,-1,T,C,27304962,89969,27018385,27411601,286577
16,ENSG00000260999.1,68948261,16-68860050-T-A,rs4597312,-1,T,A,68860050,88211,68751653,69144869,108397
16,ENSG00000260999.1,68948261,16-68860050-T-G,rs4597312,-1,T,G,68860050,88211,68751653,69144869,108397
16,ENSG00000260999.1,68948261,16-68860050-T-C,rs4597312,-1,T,C,68860050,88211,68751653,69144869,108397
16,ENSG00000260630.1,88663298,16-88660318-T-A,rs4782394,1,T,A,88660318,2980,88466690,88859906,193628
16,ENSG00000260630.1,88663298,16-88660318-T-G,rs4782394,1,T,G,88660318,2980,88466690,88859906,193628
16,ENSG00000205018.2,88939789,16-88963710-T-C,rs4782494,1,T,C,88963710,23921,88743181,89136397,220529
16,ENSG00000260186.1,58421339,16-58433949-G-C,rs4784938,1,G,C,58433949,12610,58224731,58617947,209218
16,ENSG00000260186.1,58421339,16-58433949-G-A,rs4784938,1,G,A,58433949,12610,58224731,58617947,209218
16,ENSG00000261288.1,2554975,16-2460602-C-T,rs4786284,1,C,T,2460602,94373,2358367,2751583,102235
16,ENSG00000263343.1,31165648,16-31312331-G-A,rs4889645,1,G,A,31312331,146683,30969040,31362256,343291
16,ENSG00000260121.1,88718615,16-88912442-C-T,rs555191,1,C,T,88912442,193827,88522007,88915223,390435
16,ENSG00000261405.2,33570935,16-33744400-G-A,rs56163327,-1,G,A,33744400,173465,33374327,33767543,370073
16,ENSG00000260781.1,33937024,16-33744400-G-A,rs56163327,-1,G,A,33744400,192624,33740416,34133632,3984
16,ENSG00000250616.2,30096430,16-30018771-G-A,rs56329348,1,G,A,30018771,77659,29899822,30293038,118949
16,ENSG00000260448.1,25111539,16-25076862-C-T,rs62033319,-1,C,T,25076862,34677,24914931,25308147,161931
16,ENSG00000260448.1,25111539,16-25076862-C-A,rs62033319,-1,C,A,25076862,34677,24914931,25308147,161931
16,ENSG00000261226.1,88939651,16-89082672-C-T,rs6500524,-1,C,T,89082672,143021,88743043,89136259,339629
16,ENSG00000261226.1,88939651,16-89082672-C-A,rs6500524,-1,C,A,89082672,143021,88743043,89136259,339629
16,ENSG00000261226.1,88939651,16-89082672-C-G,rs6500524,-1,C,G,89082672,143021,88743043,89136259,339629
16,ENSG00000260682.1,81961926,16-81836959-C-A,rs6564924,1,C,A,81836959,124967,81765318,82158534,71641
16,ENSG00000260682.1,81961926,16-81836959-C-T,rs6564924,1,C,T,81836959,124967,81765318,82158534,71641
16,ENSG00000260682.1,81961926,16-81836959-C-G,rs6564924,1,C,G,81836959,124967,81765318,82158534,71641
16,ENSG00000261613.1,2556060,16-2598650-G-T,rs71386677,-1,G,T,2598650,42590,2359452,2752668,239198
16,ENSG00000260719.1,29745247,16-29850739-C-T,rs7191050,1,C,T,29850739,105492,29548639,29941855,302100
16,ENSG00000260884.1,74313337,16-74213008-T-C,rs7191483,1,T,C,74213008,100329,74116729,74509945,96279
16,ENSG00000260884.1,74313337,16-74213008-T-A,rs7191483,1,T,A,74213008,100329,74116729,74509945,96279
16,ENSG00000260884.1,74313337,16-74213008-T-G,rs7191483,1,T,G,74213008,100329,74116729,74509945,96279
16,ENSG00000240793.1,48334854,16-48447946-C-T,rs7199557,-1,C,T,48447946,113092,48138246,48531462,309700
16,ENSG00000261777.1,70346806,16-70349209-T-C,rs7200034,-1,T,C,70349209,2403,70150198,70543414,199011
16,ENSG00000261416.1,30184563,16-30145642-C-G,rs7204270,-1,C,G,30145642,38921,29987955,30381171,157687
16,ENSG00000261416.1,30184563,16-30145642-C-T,rs7204270,-1,C,T,30145642,38921,29987955,30381171,157687
16,ENSG00000263280.1,2868251,16-2899247-T-A,rs7281,-1,T,A,2899247,30996,2671643,3064859,227604
16,ENSG00000263280.1,2868251,16-2899247-T-C,rs7281,-1,T,C,2899247,30996,2671643,3064859,227604
16,ENSG00000261461.1,35170241,16-35170816-C-T,rs72810758,-1,C,T,35170816,575,34973633,35366849,197183
16,ENSG00000260177.1,87806476,16-87856040-C-T,rs72814368,-1,C,T,87856040,49564,87609868,88003084,246172
16,ENSG00000261286.1,84467361,16-84454567-G-A,rs747718,-1,G,A,84454567,12794,84270753,84663969,183814
16,ENSG00000261286.1,84467361,16-84454567-G-C,rs747718,-1,G,C,84454567,12794,84270753,84663969,183814
16,ENSG00000261067.1,28974804,16-28999450-A-T,rs7498329,1,A,T,28999450,24646,28778196,29171412,221254
16,ENSG00000261067.1,28974804,16-28999450-A-C,rs7498329,1,A,C,28999450,24646,28778196,29171412,221254
16,ENSG00000125122.10,67226998,16-67199340-G-A,rs75193761,-1,G,A,67199340,27658,67030390,67423606,168950
16,ENSG00000125122.10,67226998,16-67199340-G-C,rs75193761,-1,G,C,67199340,27658,67030390,67423606,168950
16,ENSG00000261620.1,35803280,16-35811812-G-A,rs76190307,-1,G,A,35811812,8532,35606672,35999888,205140
16,ENSG00000261173.1,46973789,16-46860561-A-G,rs77326199,1,A,G,46860561,113228,46777181,47170397,83380
16,ENSG00000260083.1,30875222,16-30803443-T-A,rs77503088,1,T,A,30803443,71779,30678614,31071830,124829
16,ENSG00000260082.1,30822110,16-30803443-T-A,rs77503088,-1,T,A,30803443,18667,30625502,31018718,177941
16,ENSG00000260979.1,8962706,16-9046302-G-T,rs77822111,1,G,T,9046302,83596,8766098,9159314,280204
16,ENSG00000263307.1,11851622,16-11773184-A-T,rs77867524,1,A,T,11773184,78438,11655014,12048230,118170
16,ENSG00000259881.1,88883272,16-88692888-G-A,rs79327070,1,G,A,88692888,190384,88686664,89079880,6224
16,ENSG00000259881.1,88883272,16-88692888-G-C,rs79327070,1,G,C,88692888,190384,88686664,89079880,6224
16,ENSG00000260277.1,22090164,16-22217286-G-T,rs79424032,-1,G,T,22217286,127122,21893556,22286772,323730
16,ENSG00000261123.1,2097026,16-2143421-A-G,rs80175943,-1,A,G,2143421,46395,1900418,2293634,243003
16,ENSG00000261123.1,2097026,16-2143421-A-T,rs80175943,-1,A,T,2143421,46395,1900418,2293634,243003
16,ENSG00000259810.1,31788202,16-31603872-G-A,rs8046892,1,G,A,31603872,184330,31591594,31984810,12278
16,ENSG00000259810.1,31788202,16-31603872-G-T,rs8046892,1,G,T,31603872,184330,31591594,31984810,12278
16,ENSG00000259768.3,72665133,16-72713203-C-T,rs8047850,1,C,T,72713203,48070,72468525,72861741,244678
16,ENSG00000259768.3,72665133,16-72713203-C-G,rs8047850,1,C,G,72713203,48070,72468525,72861741,244678
16,ENSG00000261471.1,84594393,16-84568844-A-G,rs8050366,1,A,G,84568844,25549,84397785,84791001,171059
16,ENSG00000261118.1,89504460,16-89361158-C-T,rs8050487,-1,C,T,89361158,143302,89307852,89701068,53306
16,ENSG00000261118.1,89504460,16-89361158-C-G,rs8050487,-1,C,G,89361158,143302,89307852,89701068,53306
16,ENSG00000260326.1,52934813,16-52823180-G-A,rs8060591,1,G,A,52823180,111633,52738205,53131421,84975
16,ENSG00000260279.1,89296128,16-89360911-T-C,rs8063266,1,T,C,89360911,64783,89099520,89492736,261391
16,ENSG00000175604.2,12090302,16-12191939-G-A,rs830710,-1,G,A,12191939,101637,11893694,12286910,298245
16,ENSG00000215003.4,15932294,16-16029191-C-G,rs875740,-1,C,G,16029191,96897,15735686,16128902,293505
16,ENSG00000215003.4,15932294,16-16029191-C-A,rs875740,-1,C,A,16029191,96897,15735686,16128902,293505
16,ENSG00000261474.1,31453493,16-31533048-G-T,rs9923480,-1,G,T,31533048,79555,31256885,31650101,276163
16,ENSG00000261474.1,31453493,16-31533048-G-C,rs9923480,-1,G,C,31533048,79555,31256885,31650101,276163
16,ENSG00000261474.1,31453493,16-31533048-G-A,rs9923480,-1,G,A,31533048,79555,31256885,31650101,276163
16,ENSG00000261783.1,75381260,16-75208831-T-C,rs9928736,-1,T,C,75208831,172429,75184652,75577868,24179
16,ENSG00000261812.1,90094023,16-89988656-A-T,rs9930046,1,A,T,89988656,105367,89897415,90290631,91241
16,ENSG00000261448.1,17134504,16-16988503-G-T,rs9933070,1,G,T,16988503,146001,16937896,17331112,50607
16,ENSG00000261448.1,17134504,16-16988503-G-A,rs9933070,1,G,A,16988503,146001,16937896,17331112,50607
16,ENSG00000261448.1,17134504,16-16988503-G-C,rs9933070,1,G,C,16988503,146001,16937896,17331112,50607
16,ENSG00000263179.1,11242653,16-11391055-C-A,rs9936640,1,C,A,11391055,148402,11046045,11439261,345010
16,ENSG00000263179.1,11242653,16-11391055-C-T,rs9936640,1,C,T,11391055,148402,11046045,11439261,345010
16,ENSG00000260425.1,1361405,16-1283386-C-G,rs9940055,-1,C,G,1283386,78019,1164797,1558013,118589
16,ENSG00000260425.1,1361405,16-1283386-C-T,rs9940055,-1,C,T,1283386,78019,1164797,1558013,118589
15,ENSG00000258895.1,94033658,15-94185494-A-G,rs10162947,1,A,G,94185494,151836,93837050,94230266,348444
15,ENSG00000259709.1,52124561,15-52159687-G-C,rs10220890,1,G,C,52159687,35126,51927953,52321169,231734
15,ENSG00000259709.1,52124561,15-52159687-G-A,rs10220890,1,G,A,52159687,35126,51927953,52321169,231734
15,ENSG00000260619.1,80993258,15-80993534-C-A,rs10438391,-1,C,A,80993534,276,80796650,81189866,196884
15,ENSG00000260619.1,80993258,15-80993534-C-T,rs10438391,-1,C,T,80993534,276,80796650,81189866,196884
15,ENSG00000259397.1,35092481,15-34945852-A-G,rs10451003,1,A,G,34945852,146629,34895873,35289089,49979
15,ENSG00000259658.1,101745983,15-101737277-G-C,rs1052887,-1,G,C,101737277,8706,101549375,101942591,187902
15,ENSG00000259658.1,101745983,15-101737277-G-T,rs1052887,-1,G,T,101737277,8706,101549375,101942591,187902
15,ENSG00000261460.1,72278867,15-72321144-C-T,rs11072355,1,C,T,72321144,42277,72082259,72475475,238885
15,ENSG00000189419.5,100350725,15-100546155-C-T,rs113028030,-1,C,T,100546155,195430,100154117,100547333,392038
15,ENSG00000189419.5,100350725,15-100546155-C-A,rs113028030,-1,C,A,100546155,195430,100154117,100547333,392038
15,ENSG00000259232.1,65475614,15-65405203-G-T,rs113546394,-1,G,T,65405203,70411,65279006,65672222,126197
15,ENSG00000259232.1,65475614,15-65405203-G-A,rs113546394,-1,G,A,65405203,70411,65279006,65672222,126197
15,ENSG00000259315.1,82727425,15-82557172-C-A,rs1145170,-1,C,A,82557172,170253,82530817,82924033,26355
15,ENSG00000259315.1,82727425,15-82557172-C-T,rs1145170,-1,C,T,82557172,170253,82530817,82924033,26355
15,ENSG00000259375.1,85580178,15-85536603-A-G,rs11632326,-1,A,G,85536603,43575,85383570,85776786,153033
15,ENSG00000259375.1,85580178,15-85536603-A-C,rs11632326,-1,A,C,85536603,43575,85383570,85776786,153033
15,ENSG00000259448.1,31216021,15-31111392-T-C,rs11636447,1,T,C,31111392,104629,31019413,31412629,91979
15,ENSG00000242295.1,96448154,15-96459423-A-T,rs11637980,1,A,T,96459423,11269,96251546,96644762,207877
15,ENSG00000242295.1,96448154,15-96459423-A-G,rs11637980,1,A,G,96459423,11269,96251546,96644762,207877
15,ENSG00000259657.1,59676757,15-59632949-T-G,rs117309407,1,T,G,59632949,43808,59480149,59873365,152800
15,ENSG00000259686.1,33012119,15-32968984-G-T,rs117804335,1,G,T,32968984,43135,32815511,33208727,153473
15,ENSG00000259686.1,33012119,15-32968984-G-A,rs117804335,1,G,A,32968984,43135,32815511,33208727,153473
15,ENSG00000259516.1,35237326,15-35192505-C-T,rs12050867,1,C,T,35192505,44821,35040718,35433934,151787
15,ENSG00000259516.1,35237326,15-35192505-C-A,rs12050867,1,C,A,35192505,44821,35040718,35433934,151787
15,ENSG00000180953.7,79923702,15-79913699-G-T,rs12442814,-1,G,T,79913699,10003,79727094,80120310,186605
15,ENSG00000259540.1,100558677,15-100569613-G-A,rs12460,1,G,A,100569613,10936,100362069,100755285,207544
15,ENSG00000205871.4,43116493,15-43148458-G-A,rs12594277,-1,G,A,43148458,31965,42919885,43313101,228573
15,ENSG00000260928.1,43131008,15-43148458-G-A,rs12594277,1,G,A,43148458,17450,42934400,43327616,214058
15,ENSG00000242088.1,24911125,15-24908662-C-G,rs12594683,-1,C,G,24908662,2463,24714517,25107733,194145
15,ENSG00000242088.1,24911125,15-24908662-C-T,rs12594683,-1,C,T,24908662,2463,24714517,25107733,194145
15,ENSG00000259677.1,89876540,15-89777808-A-G,rs12900413,1,A,G,89777808,98732,89679932,90073148,97876
15,ENSG00000259677.1,89876540,15-89777808-A-T,rs12900413,1,A,T,89777808,98732,89679932,90073148,97876
15,ENSG00000175779.1,38628060,15-38695896-G-T,rs12903120,1,G,T,38695896,67836,38431452,38824668,264444
15,ENSG00000259172.1,101295419,15-101392873-G-A,rs12903394,1,G,A,101392873,97454,101098811,101492027,294062
15,ENSG00000259172.1,101295419,15-101392873-G-T,rs12903394,1,G,T,101392873,97454,101098811,101492027,294062
15,ENSG00000259172.1,101295419,15-101392873-G-C,rs12903394,1,G,C,101392873,97454,101098811,101492027,294062
15,ENSG00000247728.2,30625773,15-30730116-A-G,rs12905321,-1,A,G,30730116,104343,30429165,30822381,300951
15,ENSG00000261822.1,42569994,15-42576088-A-G,rs12910030,-1,A,G,42576088,6094,42373386,42766602,202702
15,ENSG00000259287.1,33864825,15-33729762-T-G,rs12910679,-1,T,G,33729762,135063,33668217,34061433,61545
15,ENSG00000166763.7,43718184,15-43525206-G-A,rs12912505,-1,G,A,43525206,192978,43521576,43914792,3630
15,ENSG00000166763.7,43718184,15-43525206-G-C,rs12912505,-1,G,C,43525206,192978,43521576,43914792,3630
15,ENSG00000259520.1,45279251,15-45262868-G-A,rs12913645,-1,G,A,45262868,16383,45082643,45475859,180225
15,ENSG00000259442.1,82744223,15-82756562-T-G,rs12915384,1,T,G,82756562,12339,82547615,82940831,208947
15,ENSG00000182397.9,99801179,15-99871875-A-G,rs12915935,-1,A,G,99871875,70696,99604571,99997787,267304
15,ENSG00000182397.9,99801179,15-99871875-A-C,rs12915935,-1,A,C,99871875,70696,99604571,99997787,267304
15,ENSG00000259655.1,99791127,15-99871875-A-G,rs12915935,1,A,G,99871875,80748,99594519,99987735,277356
15,ENSG00000259655.1,99791127,15-99871875-A-C,rs12915935,1,A,C,99871875,80748,99594519,99987735,277356
15,ENSG00000215302.4,30470779,15-30660661-G-C,rs13380257,1,G,C,30660661,189882,30274171,30667387,386490
15,ENSG00000215302.4,30470779,15-30660661-G-T,rs13380257,1,G,T,30660661,189882,30274171,30667387,386490
15,ENSG00000259407.1,85750281,15-85600273-G-T,rs1551971,-1,G,T,85600273,150008,85553673,85946889,46600
15,ENSG00000259407.1,85750281,15-85600273-G-A,rs1551971,-1,G,A,85600273,150008,85553673,85946889,46600
15,ENSG00000259407.1,85750281,15-85600273-G-C,rs1551971,-1,G,C,85600273,150008,85553673,85946889,46600
15,ENSG00000245534.2,60479178,15-60508788-G-A,rs16942653,1,G,A,60508788,29610,60282570,60675786,226218
15,ENSG00000245479.2,90660207,15-90662391-T-C,rs16944717,1,T,C,90662391,2184,90463599,90856815,198792
15,ENSG00000214432.5,91022621,15-90875868-C-T,rs16944971,1,C,T,90875868,146753,90826013,91219229,49855
15,ENSG00000258725.1,90966340,15-90982911-A-C,rs16945132,1,A,C,90982911,16571,90769732,91162948,213179
15,ENSG00000258725.1,90966340,15-90982911-A-G,rs16945132,1,A,G,90982911,16571,90769732,91162948,213179
15,ENSG00000258725.1,90966340,15-90982911-A-T,rs16945132,1,A,T,90982911,16571,90769732,91162948,213179
15,ENSG00000235420.6,70797099,15-70908107-C-G,rs16955001,-1,C,G,70908107,111008,70600491,70993707,307616
15,ENSG00000235420.6,70797099,15-70908107-C-T,rs16955001,-1,C,T,70908107,111008,70600491,70993707,307616
15,ENSG00000259468.1,34255286,15-34110067-T-C,rs16958780,1,T,C,34110067,145219,34058678,34451894,51389
15,ENSG00000259468.1,34255286,15-34110067-T-A,rs16958780,1,T,A,34110067,145219,34058678,34451894,51389
15,ENSG00000261315.1,36617089,15-36428599-T-A,rs16963037,1,T,A,36428599,188490,36420481,36813697,8118
15,ENSG00000259460.1,37099339,15-37166593-G-C,rs16964771,1,G,C,37166593,67254,36902731,37295947,263862
15,ENSG00000259460.1,37099339,15-37166593-G-A,rs16964771,1,G,A,37166593,67254,36902731,37295947,263862
15,ENSG00000176700.15,84631963,15-84697473-T-C,rs16974502,1,T,C,84697473,65510,84435355,84828571,262118
15,ENSG00000245975.2,58770974,15-58770945-C-T,rs17269439,-1,C,T,58770945,29,58574366,58967582,196579
15,ENSG00000245975.2,58770974,15-58770945-C-G,rs17269439,-1,C,G,58770945,29,58574366,58967582,196579
15,ENSG00000245975.2,58770974,15-58770945-C-A,rs17269439,-1,C,A,58770945,29,58574366,58967582,196579
15,ENSG00000259732.1,59121034,15-59152453-T-G,rs17269496,1,T,G,59152453,31419,58924426,59317642,228027
15,ENSG00000260579.1,83114566,15-83053307-A-G,rs17507300,-1,A,G,83053307,61259,82917958,83311174,135349
15,ENSG00000259712.1,52100523,15-52099709-T-A,rs17650082,-1,T,A,52099709,814,51903915,52297131,195794
15,ENSG00000259712.1,52100523,15-52099709-T-G,rs17650082,-1,T,G,52099709,814,51903915,52297131,195794
15,ENSG00000260988.1,78141243,15-78169115-A-G,rs17674205,1,A,G,78169115,27872,77944635,78337851,224480
15,ENSG00000260988.1,78141243,15-78169115-A-C,rs17674205,1,A,C,78169115,27872,77944635,78337851,224480
15,ENSG00000259883.1,41921417,15-41913285-G-A,rs17686769,1,G,A,41913285,8132,41724809,42118025,188476
15,ENSG00000259883.1,41921417,15-41913285-G-T,rs17686769,1,G,T,41913285,8132,41724809,42118025,188476
15,ENSG00000259726.1,84186752,15-84080162-G-C,rs17841161,1,G,C,84080162,106590,83990144,84383360,90018
15,ENSG00000259726.1,84186752,15-84080162-G-A,rs17841161,1,G,A,84080162,106590,83990144,84383360,90018
15,ENSG00000259661.1,90921186,15-90908876-C-T,rs2002739,-1,C,T,90908876,12310,90724578,91117794,184298
15,ENSG00000259661.1,90921186,15-90908876-C-A,rs2002739,-1,C,A,90908876,12310,90724578,91117794,184298
15,ENSG00000259661.1,90921186,15-90908876-C-G,rs2002739,-1,C,G,90908876,12310,90724578,91117794,184298
15,ENSG00000259394.1,62953173,15-62994343-G-A,rs2035714,1,G,A,62994343,41170,62756565,63149781,237778
15,ENSG00000259250.1,58587507,15-58660608-T-C,rs2114573,1,T,C,58660608,73101,58390899,58784115,269709
15,ENSG00000260037.1,71818396,15-71903377-G-A,rs2291276,1,G,A,71903377,84981,71621788,72015004,281589
15,ENSG00000244879.2,50355467,15-50374243-T-C,rs2414049,1,T,C,50374243,18776,50158859,50552075,215384
15,ENSG00000244879.2,50355467,15-50374243-T-A,rs2414049,1,T,A,50374243,18776,50158859,50552075,215384
15,ENSG00000244879.2,50355467,15-50374243-T-G,rs2414049,1,T,G,50374243,18776,50158859,50552075,215384
15,ENSG00000259715.1,50360194,15-50374243-T-C,rs2414049,-1,T,C,50374243,14049,50163586,50556802,210657
15,ENSG00000259715.1,50360194,15-50374243-T-A,rs2414049,-1,T,A,50374243,14049,50163586,50556802,210657
15,ENSG00000259715.1,50360194,15-50374243-T-G,rs2414049,-1,T,G,50374243,14049,50163586,50556802,210657
15,ENSG00000260689.1,57247893,15-57351872-T-C,rs2440946,-1,T,C,57351872,103979,57051285,57444501,300587
15,ENSG00000260689.1,57247893,15-57351872-T-G,rs2440946,-1,T,G,57351872,103979,57051285,57444501,300587
15,ENSG00000259704.1,90839641,15-90839685-G-A,rs2532101,1,G,A,90839685,44,90643033,91036249,196652
15,ENSG00000246877.1,75738623,15-75790874-G-A,rs2593289,-1,G,A,75790874,52251,75542015,75935231,248859
15,ENSG00000246877.1,75738623,15-75790874-G-T,rs2593289,-1,G,T,75790874,52251,75542015,75935231,248859
15,ENSG00000260571.1,42313687,15-42359484-A-C,rs28364363,1,A,C,42359484,45797,42117079,42510295,242405
15,ENSG00000260206.1,75636139,15-75615295-G-A,rs28412110,1,G,A,75615295,20844,75439531,75832747,175764
15,ENSG00000214424.4,96756987,15-96890850-G-A,rs28502476,1,G,A,96890850,133863,96560379,96953595,330471
15,ENSG00000259845.1,30815271,15-30959578-T-C,rs2949574,1,T,C,30959578,144307,30618663,31011879,340915
15,ENSG00000259684.1,50557601,15-50569273-T-C,rs3131578,1,T,C,50569273,11672,50360993,50754209,208280
15,ENSG00000259684.1,50557601,15-50569273-T-A,rs3131578,1,T,A,50569273,11672,50360993,50754209,208280
15,ENSG00000260892.1,75676227,15-75495841-T-C,rs34161372,1,T,C,75495841,180386,75479619,75872835,16222
15,ENSG00000240366.1,75186968,15-75228604-G-C,rs34739817,-1,G,C,75228604,41636,74990360,75383576,238244
15,ENSG00000240366.1,75186968,15-75228604-G-A,rs34739817,-1,G,A,75228604,41636,74990360,75383576,238244
15,ENSG00000259642.1,79922771,15-79739771-G-A,rs372447,1,G,A,79739771,183000,79726163,80119379,13608
15,ENSG00000224078.3,25193313,15-25083568-T-G,rs3803326,1,T,G,25083568,109745,24996705,25389921,86863
15,ENSG00000224078.3,25193313,15-25083568-T-C,rs3803326,1,T,C,25083568,109745,24996705,25389921,86863
15,ENSG00000261684.1,42532081,15-42558182-A-G,rs3986280,-1,A,G,42558182,26101,42335473,42728689,222709
15,ENSG00000261684.1,42532081,15-42558182-A-C,rs3986280,-1,A,C,42558182,26101,42335473,42728689,222709
15,ENSG00000259583.1,100919391,15-100914124-T-C,rs4246329,-1,T,C,100914124,5267,100722783,101115999,191341
15,ENSG00000259583.1,100919391,15-100914124-T-A,rs4246329,-1,T,A,100914124,5267,100722783,101115999,191341
15,ENSG00000259583.1,100919391,15-100914124-T-G,rs4246329,-1,T,G,100914124,5267,100722783,101115999,191341
15,ENSG00000259670.1,48783190,15-48873235-T-C,rs4435197,1,T,C,48873235,90045,48586582,48979798,286653
15,ENSG00000262728.1,32615092,15-32639703-T-G,rs4544214,-1,T,G,32639703,24611,32418484,32811700,221219
15,ENSG00000262728.1,32615092,15-32639703-T-C,rs4544214,-1,T,C,32639703,24611,32418484,32811700,221219
15,ENSG00000262728.1,32615092,15-32639703-T-A,rs4544214,-1,T,A,32639703,24611,32418484,32811700,221219
15,ENSG00000260139.1,77894684,15-77810128-T-C,rs4624134,1,T,C,77810128,84556,77698076,78091292,112052
15,ENSG00000260139.1,77894684,15-77810128-T-A,rs4624134,1,T,A,77810128,84556,77698076,78091292,112052
15,ENSG00000260139.1,77894684,15-77810128-T-G,rs4624134,1,T,G,77810128,84556,77698076,78091292,112052
15,ENSG00000177699.4,78978889,15-78998258-C-T,rs4778771,1,C,T,78998258,19369,78782281,79175497,215977
15,ENSG00000259772.1,31230886,15-31236884-C-T,rs4779847,-1,C,T,31236884,5998,31034278,31427494,202606
15,ENSG00000259772.1,31230886,15-31236884-C-A,rs4779847,-1,C,A,31236884,5998,31034278,31427494,202606
15,ENSG00000260266.1,74361552,15-74267137-C-G,rs4887125,1,C,G,74267137,94415,74164944,74558160,102193
15,ENSG00000260266.1,74361552,15-74267137-C-T,rs4887125,1,C,T,74267137,94415,74164944,74558160,102193
15,ENSG00000259577.1,52180028,15-52180454-T-G,rs55860410,1,T,G,52180454,426,51983420,52376636,197034
15,ENSG00000259327.1,52116574,15-52180454-T-G,rs55860410,1,T,G,52180454,63880,51919966,52313182,260488
15,ENSG00000259326.1,38502853,15-38505383-C-T,rs59254910,1,C,T,38505383,2530,38306245,38699461,199138
15,ENSG00000259326.1,38502853,15-38505383-C-G,rs59254910,1,C,G,38505383,2530,38306245,38699461,199138
15,ENSG00000259238.1,59688517,15-59687911-T-C,rs6151447,1,T,C,59687911,606,59491909,59885125,196002
15,ENSG00000259238.1,59688517,15-59687911-T-A,rs6151447,1,T,A,59687911,606,59491909,59885125,196002
15,ENSG00000258965.1,25928575,15-25908174-T-C,rs61993826,-1,T,C,25908174,20401,25731967,26125183,176207
15,ENSG00000260799.1,42802405,15-42684508-C-T,rs62019359,-1,C,T,42684508,117897,42605797,42999013,78711
15,ENSG00000259340.1,96551381,15-96584674-A-T,rs62024494,1,A,T,96584674,33293,96354773,96747989,229901
15,ENSG00000259340.1,96551381,15-96584674-A-G,rs62024494,1,A,G,96584674,33293,96354773,96747989,229901
15,ENSG00000246863.2,39921070,15-40039001-C-A,rs62621371,1,C,A,40039001,117931,39724462,40117678,314539
15,ENSG00000246863.2,39921070,15-40039001-C-T,rs62621371,1,C,T,40039001,117931,39724462,40117678,314539
15,ENSG00000259705.1,48645951,15-48646849-T-G,rs6493333,1,T,G,48646849,898,48449343,48842559,197506
15,ENSG00000259705.1,48645951,15-48646849-T-A,rs6493333,1,T,A,48646849,898,48449343,48842559,197506
15,ENSG00000259705.1,48645951,15-48646849-T-C,rs6493333,1,T,C,48646849,898,48449343,48842559,197506
15,ENSG00000260382.1,30883231,15-30941861-C-A,rs6493352,-1,C,A,30941861,58630,30686623,31079839,255238
15,ENSG00000260382.1,30883231,15-30941861-C-T,rs6493352,-1,C,T,30941861,58630,30686623,31079839,255238
15,ENSG00000260103.1,74481398,15-74502186-A-G,rs6495108,-1,A,G,74502186,20788,74284790,74678006,217396
15,ENSG00000259536.1,40488041,15-40553398-A-C,rs6582,1,A,C,40553398,65357,40291433,40684649,261965
15,ENSG00000259536.1,40488041,15-40553398-A-G,rs6582,1,A,G,40553398,65357,40291433,40684649,261965
15,ENSG00000259536.1,40488041,15-40553398-A-T,rs6582,1,A,T,40553398,65357,40291433,40684649,261965
15,ENSG00000245849.2,40695101,15-40857567-A-T,rs689626,-1,A,T,40857567,162466,40498493,40891709,359074
15,ENSG00000245849.2,40695101,15-40857567-A-C,rs689626,-1,A,C,40857567,162466,40498493,40891709,359074
15,ENSG00000245849.2,40695101,15-40857567-A-G,rs689626,-1,A,G,40857567,162466,40498493,40891709,359074
15,ENSG00000259299.1,29235137,15-29199507-T-C,rs692876,-1,T,C,29199507,35630,29038529,29431745,160978
15,ENSG00000259299.1,29235137,15-29199507-T-A,rs692876,-1,T,A,29199507,35630,29038529,29431745,160978
15,ENSG00000259299.1,29235137,15-29199507-T-G,rs692876,-1,T,G,29199507,35630,29038529,29431745,160978
15,ENSG00000259362.2,77525540,15-77485290-C-T,rs7119,1,C,T,77485290,40250,77328932,77722148,156358
15,ENSG00000259707.1,82692358,15-82729563-C-T,rs7163848,-1,C,T,82729563,37205,82495750,82888966,233813
15,ENSG00000259337.2,19973218,15-19971047-C-T,rs7170864,-1,C,T,19971047,2171,19776610,20169826,194437
15,ENSG00000259363.1,99806991,15-99835169-C-T,rs7173373,1,C,T,99835169,28178,99610383,100003599,224786
15,ENSG00000261187.1,72466262,15-72475437-T-C,rs7174825,-1,T,C,72475437,9175,72269654,72662870,205783
15,ENSG00000260776.1,77926825,15-77944011-A-G,rs7175950,-1,A,G,77944011,17186,77730217,78123433,213794
15,ENSG00000259493.1,79560304,15-79381469-G-A,rs7177291,-1,G,A,79381469,178835,79363696,79756912,17773
15,ENSG00000245750.3,69462993,15-69423149-C-T,rs7180624,1,C,T,69423149,39844,69266385,69659601,156764
15,ENSG00000245750.3,69462993,15-69423149-C-G,rs7180624,1,C,G,69423149,39844,69266385,69659601,156764
15,ENSG00000259205.1,100558954,15-100562307-C-A,rs7183379,-1,C,A,100562307,3353,100362346,100755562,199961
15,ENSG00000259205.1,100558954,15-100562307-C-T,rs7183379,-1,C,T,100562307,3353,100362346,100755562,199961
15,ENSG00000259187.1,44826540,15-44810421-G-C,rs72720062,1,G,C,44810421,16119,44629932,45023148,180489
15,ENSG00000259479.2,44861850,15-44810421-G-C,rs72720062,-1,G,C,44810421,51429,44665242,45058458,145179
15,ENSG00000261229.1,79844304,15-79726151-G-T,rs72732749,-1,G,T,79726151,118153,79647696,80040912,78455
15,ENSG00000259409.1,40088832,15-40234232-G-A,rs73391315,1,G,A,40234232,145400,39892224,40285440,342008
15,ENSG00000259660.2,101751553,15-101766049-G-A,rs74035815,1,G,A,101766049,14496,101554945,101948161,211104
15,ENSG00000259660.2,101751553,15-101766049-G-C,rs74035815,1,G,C,101766049,14496,101554945,101948161,211104
15,ENSG00000259288.1,40218500,15-40242758-C-T,rs76650903,1,C,T,40242758,24258,40021892,40415108,220866
15,ENSG00000247982.2,57300365,15-57299965-T-A,rs76975836,1,T,A,57299965,400,57103757,57496973,196208
15,ENSG00000261054.1,99131806,15-99118115-C-A,rs77358683,-1,C,A,99118115,13691,98935198,99328414,182917
15,ENSG00000259749.1,30005205,15-29905410-C-A,rs785421,1,C,A,29905410,99795,29808597,30201813,96813
15,ENSG00000259749.1,30005205,15-29905410-C-T,rs785421,1,C,T,29905410,99795,29808597,30201813,96813
15,ENSG00000187951.5,30658717,15-30824597-C-T,rs798125,1,C,T,30824597,165880,30462109,30855325,362488
15,ENSG00000187951.5,30658717,15-30824597-C-G,rs798125,1,C,G,30824597,165880,30462109,30855325,362488
15,ENSG00000214896.4,52885595,15-52889958-C-T,rs80261782,1,C,T,52889958,4363,52688987,53082203,200971
15,ENSG00000214896.4,52885595,15-52889958-C-G,rs80261782,1,C,G,52889958,4363,52688987,53082203,200971
15,ENSG00000261616.1,99139317,15-99253969-A-G,rs8028374,1,A,G,99253969,114652,98942709,99335925,311260
15,ENSG00000260174.1,30044455,15-29962283-G-A,rs8036572,1,G,A,29962283,82172,29847847,30241063,114436
15,ENSG00000260174.1,30044455,15-29962283-G-T,rs8036572,1,G,T,29962283,82172,29847847,30241063,114436
15,ENSG00000260174.1,30044455,15-29962283-G-C,rs8036572,1,G,C,29962283,82172,29847847,30241063,114436
15,ENSG00000228141.2,82711877,15-82550590-G-A,rs803686,-1,G,A,82550590,161287,82515269,82908485,35321
15,ENSG00000228141.2,82711877,15-82550590-G-C,rs803686,-1,G,C,82550590,161287,82515269,82908485,35321
15,ENSG00000259414.1,23293667,15-23117883-A-G,rs8040193,-1,A,G,23117883,175784,23097059,23490275,20824
15,ENSG00000248508.2,40039264,15-40038428-C-G,rs8041057,1,C,G,40038428,836,39842656,40235872,195772
15,ENSG00000248508.2,40039264,15-40038428-C-T,rs8041057,1,C,T,40038428,836,39842656,40235872,195772
15,ENSG00000212664.4,71341712,15-71244203-T-C,rs961577,-1,T,C,71244203,97509,71145104,71538320,99099
15,ENSG00000212664.4,71341712,15-71244203-T-A,rs961577,-1,T,A,71244203,97509,71145104,71538320,99099
15,ENSG00000212664.4,71341712,15-71244203-T-G,rs961577,-1,T,G,71244203,97509,71145104,71538320,99099
15,ENSG00000259627.1,63071911,15-63036291-C-T,rs9806545,-1,C,T,63036291,35620,62875303,63268519,160988
15,ENSG00000259363.1,99806991,15-99820131-T-C,rs10152218,1,T,C,99820131,13140,99610383,100003599,209748
15,ENSG00000248508.2,40039264,15-40090240-T-C,rs10518679,1,T,C,40090240,50976,39842656,40235872,247584
15,ENSG00000261315.1,36617089,15-36476020-C-T,rs10518881,1,C,T,36476020,141069,36420481,36813697,55539
15,ENSG00000259792.1,77993405,15-77985989-A-C,rs10851899,1,A,C,77985989,7416,77796797,78190013,189192
15,ENSG00000259792.1,77993405,15-77985989-A-G,rs10851899,1,A,G,77985989,7416,77796797,78190013,189192
15,ENSG00000259792.1,77993405,15-77985989-A-T,rs10851899,1,A,T,77985989,7416,77796797,78190013,189192
15,ENSG00000260898.1,72782835,15-72703918-G-A,rs11072383,1,G,A,72703918,78917,72586227,72979443,117691
15,ENSG00000260898.1,72782835,15-72703918-G-C,rs11072383,1,G,C,72703918,78917,72586227,72979443,117691
15,ENSG00000261147.1,90249556,15-90249274-C-G,rs11073920,1,C,G,90249274,282,90052948,90446164,196326
15,ENSG00000261147.1,90249556,15-90249274-C-T,rs11073920,1,C,T,90249274,282,90052948,90446164,196326
15,ENSG00000259479.2,44861850,15-44916471-G-A,rs111769507,-1,G,A,44916471,54621,44665242,45058458,251229
15,ENSG00000259352.1,45074048,15-44916471-G-A,rs111769507,-1,G,A,44916471,157577,44877440,45270656,39031
15,ENSG00000259187.1,44826540,15-44916471-G-A,rs111769507,1,G,A,44916471,89931,44629932,45023148,286539
15,ENSG00000259520.1,45279251,15-45259066-G-A,rs11632920,-1,G,A,45259066,20185,45082643,45475859,176423
15,ENSG00000259461.1,81118340,15-81308169-A-T,rs11632978,-1,A,T,81308169,189829,80921732,81314948,386437
15,ENSG00000260382.1,30883231,15-30997246-C-A,rs11638295,-1,C,A,30997246,114015,30686623,31079839,310623
15,ENSG00000177699.4,78978889,15-78939176-A-T,rs11638844,1,A,T,78939176,39713,78782281,79175497,156895
15,ENSG00000177699.4,78978889,15-78939176-A-G,rs11638844,1,A,G,78939176,39713,78782281,79175497,156895
15,ENSG00000259394.1,62953173,15-63145653-C-A,rs116985417,1,C,A,63145653,192480,62756565,63149781,389088
15,ENSG00000261069.1,25087661,15-25263518-A-C,rs11857055,1,A,C,25263518,175857,24891053,25284269,372465
15,ENSG00000261183.1,40844332,15-40691482-T-C,rs12101791,-1,T,C,40691482,152850,40647724,41040940,43758
15,ENSG00000259845.1,30815271,15-30750759-A-G,rs12441324,1,A,G,30750759,64512,30618663,31011879,132096
15,ENSG00000259308.1,83044368,15-82934811-G-A,rs12443081,1,G,A,82934811,109557,82847760,83240976,87051
15,ENSG00000259308.1,83044368,15-82934811-G-C,rs12443081,1,G,C,82934811,109557,82847760,83240976,87051
15,ENSG00000259362.2,77525540,15-77482552-A-G,rs12591335,1,A,G,77482552,42988,77328932,77722148,153620
15,ENSG00000259362.2,77525540,15-77482552-A-T,rs12591335,1,A,T,77482552,42988,77328932,77722148,153620
15,ENSG00000227973.1,43876244,15-44055302-T-G,rs12907002,-1,T,G,44055302,179058,43679636,44072852,375666
15,ENSG00000227973.1,43876244,15-44055302-T-C,rs12907002,-1,T,C,44055302,179058,43679636,44072852,375666
15,ENSG00000260689.1,57247893,15-57404877-C-G,rs12909385,-1,C,G,57404877,156984,57051285,57444501,353592
15,ENSG00000260689.1,57247893,15-57404877-C-T,rs12909385,-1,C,T,57404877,156984,57051285,57444501,353592
15,ENSG00000234664.1,29730713,15-29768109-T-G,rs12916720,1,T,G,29768109,37396,29534105,29927321,234004
15,ENSG00000234664.1,29730713,15-29768109-T-C,rs12916720,1,T,C,29768109,37396,29534105,29927321,234004
15,ENSG00000234664.1,29730713,15-29768109-T-A,rs12916720,1,T,A,29768109,37396,29534105,29927321,234004
15,ENSG00000259172.1,101295419,15-101390413-T-C,rs12917106,1,T,C,101390413,94994,101098811,101492027,291602
15,ENSG00000259772.1,31230886,15-31235556-T-C,rs1370062,-1,T,C,31235556,4670,31034278,31427494,201278
15,ENSG00000259404.1,84080168,15-83929047-C-T,rs1480821,1,C,T,83929047,151121,83883560,84276776,45487
15,ENSG00000189419.5,100350725,15-100491333-C-T,rs1503478,-1,C,T,100491333,140608,100154117,100547333,337216
15,ENSG00000174171.3,41892777,15-41892596-T-A,rs1618332,1,T,A,41892596,181,41696169,42089385,196427
15,ENSG00000174171.3,41892777,15-41892596-T-G,rs1618332,1,T,G,41892596,181,41696169,42089385,196427
15,ENSG00000174171.3,41892777,15-41892596-T-C,rs1618332,1,T,C,41892596,181,41696169,42089385,196427
15,ENSG00000259704.1,90839641,15-90840536-G-C,rs16944923,1,G,C,90840536,895,90643033,91036249,197503
15,ENSG00000259704.1,90839641,15-90840536-G-A,rs16944923,1,G,A,90840536,895,90643033,91036249,197503
15,ENSG00000260337.1,92596388,15-92463423-T-C,rs16946962,-1,T,C,92463423,132965,92399780,92792996,63643
15,ENSG00000243404.1,66446777,15-66301610-C-T,rs16949793,-1,C,T,66301610,145167,66250169,66643385,51441
15,ENSG00000260657.1,68277994,15-68471005-C-T,rs16952095,-1,C,T,68471005,193011,68081386,68474602,389619
15,ENSG00000223509.3,32536926,15-32671555-A-C,rs16964074,-1,A,C,32671555,134629,32340318,32733534,331237
15,ENSG00000223509.3,32536926,15-32671555-A-G,rs16964074,-1,A,G,32671555,134629,32340318,32733534,331237
15,ENSG00000260104.1,75249407,15-75138635-C-G,rs16966775,-1,C,G,75138635,110772,75052799,75446015,85836
15,ENSG00000260104.1,75249407,15-75138635-C-A,rs16966775,-1,C,A,75138635,110772,75052799,75446015,85836
15,ENSG00000260104.1,75249407,15-75138635-C-T,rs16966775,-1,C,T,75138635,110772,75052799,75446015,85836
15,ENSG00000259622.1,82010607,15-82062326-C-G,rs16973339,-1,C,G,82062326,51719,81813999,82207215,248327
15,ENSG00000259622.1,82010607,15-82062326-C-T,rs16973339,-1,C,T,82062326,51719,81813999,82207215,248327
15,ENSG00000230373.4,84516785,15-84618041-C-G,rs16974951,-1,C,G,84618041,101256,84320177,84713393,297864
15,ENSG00000230373.4,84516785,15-84618041-C-T,rs16974951,-1,C,T,84618041,101256,84320177,84713393,297864
15,ENSG00000259707.1,82692358,15-82835068-G-A,rs17158255,-1,G,A,82835068,142710,82495750,82888966,339318
15,ENSG00000259250.1,58587507,15-58623239-A-G,rs17236146,1,A,G,58623239,35732,58390899,58784115,232340
15,ENSG00000259250.1,58587507,15-58623239-A-C,rs17236146,1,A,C,58623239,35732,58390899,58784115,232340
15,ENSG00000166104.10,62253235,15-62247695-A-G,rs17271570,-1,A,G,62247695,5540,62056627,62449843,191068
15,ENSG00000261229.1,79844304,15-79731845-A-G,rs17280731,-1,A,G,79731845,112459,79647696,80040912,84149
15,ENSG00000259732.1,59121034,15-59238108-A-G,rs17302233,1,A,G,59238108,117074,58924426,59317642,313682
15,ENSG00000260648.1,40232082,15-40380923-T-C,rs17671250,1,T,C,40380923,148841,40035474,40428690,345449
15,ENSG00000261684.1,42532081,15-42508569-C-T,rs17709867,-1,C,T,42508569,23512,42335473,42728689,173096
15,ENSG00000260490.1,42571927,15-42606414-C-T,rs17767270,1,C,T,42606414,34487,42375319,42768535,231095
15,ENSG00000245750.3,69462993,15-69486984-A-G,rs1857744,1,A,G,69486984,23991,69266385,69659601,220599
15,ENSG00000245534.2,60479178,15-60502560-C-T,rs1869488,1,C,T,60502560,23382,60282570,60675786,219990
15,ENSG00000245534.2,60479178,15-60502560-C-A,rs1869488,1,C,A,60502560,23382,60282570,60675786,219990
15,ENSG00000245534.2,60479178,15-60502560-C-G,rs1869488,1,C,G,60502560,23382,60282570,60675786,219990
15,ENSG00000259661.1,90921186,15-90963222-T-G,rs2034085,-1,T,G,90963222,42036,90724578,91117794,238644
15,ENSG00000259661.1,90921186,15-90963222-T-A,rs2034085,-1,T,A,90963222,42036,90724578,91117794,238644
15,ENSG00000259661.1,90921186,15-90963222-T-C,rs2034085,-1,T,C,90963222,42036,90724578,91117794,238644
15,ENSG00000260139.1,77894684,15-78039680-T-C,rs2044099,1,T,C,78039680,144996,77698076,78091292,341604
15,ENSG00000259715.1,50360194,15-50275579-C-T,rs2114447,-1,C,T,50275579,84615,50163586,50556802,111993
15,ENSG00000244879.2,50355467,15-50275579-C-T,rs2114447,1,C,T,50275579,79888,50158859,50552075,116720
15,ENSG00000259749.1,30005205,15-29968297-A-G,rs2222420,1,A,G,29968297,36908,29808597,30201813,159700
15,ENSG00000244251.1,40481315,15-40303273-A-C,rs2305646,-1,A,C,40303273,178042,40284707,40677923,18566
15,ENSG00000244251.1,40481315,15-40303273-A-T,rs2305646,-1,A,T,40303273,178042,40284707,40677923,18566
15,ENSG00000244251.1,40481315,15-40303273-A-G,rs2305646,-1,A,G,40303273,178042,40284707,40677923,18566
15,ENSG00000259536.1,40488041,15-40501062-G-T,rs2412524,1,G,T,40501062,13021,40291433,40684649,209629
15,ENSG00000259668.1,51455268,15-51390578-G-A,rs2470180,1,G,A,51390578,64690,51258660,51651876,131918
15,ENSG00000259407.1,85750281,15-85755621-A-C,rs2542606,-1,A,C,85755621,5340,85553673,85946889,201948
15,ENSG00000259407.1,85750281,15-85755621-A-G,rs2542606,-1,A,G,85755621,5340,85553673,85946889,201948
15,ENSG00000180953.7,79923702,15-79873026-A-G,rs2586154,-1,A,G,79873026,50676,79727094,80120310,145932
15,ENSG00000180953.7,79923702,15-79873026-A-C,rs2586154,-1,A,C,79873026,50676,79727094,80120310,145932
15,ENSG00000259883.1,41921417,15-42021767-T-C,rs2598465,1,T,C,42021767,100350,41724809,42118025,296958
15,ENSG00000259883.1,41921417,15-42021767-T-G,rs2598465,1,T,G,42021767,100350,41724809,42118025,296958
15,ENSG00000259883.1,41921417,15-42021767-T-A,rs2598465,1,T,A,42021767,100350,41724809,42118025,296958
15,ENSG00000213862.4,47730935,15-47739033-C-A,rs2600867,-1,C,A,47739033,8098,47534327,47927543,204706
15,ENSG00000213862.4,47730935,15-47739033-C-T,rs2600867,-1,C,T,47739033,8098,47534327,47927543,204706
15,ENSG00000213862.4,47730935,15-47739033-C-G,rs2600867,-1,C,G,47739033,8098,47534327,47927543,204706
15,ENSG00000247982.2,57300365,15-57206493-T-G,rs2733310,1,T,G,57206493,93872,57103757,57496973,102736
15,ENSG00000247982.2,57300365,15-57206493-T-A,rs2733310,1,T,A,57206493,93872,57103757,57496973,102736
15,ENSG00000247982.2,57300365,15-57206493-T-C,rs2733310,1,T,C,57206493,93872,57103757,57496973,102736
15,ENSG00000259340.1,96551381,15-96585261-G-T,rs28651426,1,G,T,96585261,33880,96354773,96747989,230488
15,ENSG00000228998.2,90275129,15-90360078-A-C,rs28678568,1,A,C,90360078,84949,90078521,90471737,281557
15,ENSG00000258732.1,22278971,15-22230792-C-G,rs2879943,1,C,G,22230792,48179,22082363,22475579,148429
15,ENSG00000258732.1,22278971,15-22230792-C-T,rs2879943,1,C,T,22230792,48179,22082363,22475579,148429
15,ENSG00000258732.1,22278971,15-22230792-C-A,rs2879943,1,C,A,22230792,48179,22082363,22475579,148429
15,ENSG00000261822.1,42569994,15-42493962-T-C,rs2899051,-1,T,C,42493962,76032,42373386,42766602,120576
15,ENSG00000261187.1,72466262,15-72275616-G-A,rs2912231,-1,G,A,72275616,190646,72269654,72662870,5962
15,ENSG00000261187.1,72466262,15-72275616-G-T,rs2912231,-1,G,T,72275616,190646,72269654,72662870,5962
15,ENSG00000259288.1,40218500,15-40113248-G-A,rs2934776,1,G,A,40113248,105252,40021892,40415108,91356
15,ENSG00000259288.1,40218500,15-40113248-G-C,rs2934776,1,G,C,40113248,105252,40021892,40415108,91356
15,ENSG00000182397.9,99801179,15-99767557-A-C,rs2958959,-1,A,C,99767557,33622,99604571,99997787,162986
15,ENSG00000182397.9,99801179,15-99767557-A-G,rs2958959,-1,A,G,99767557,33622,99604571,99997787,162986
15,ENSG00000182397.9,99801179,15-99767557-A-T,rs2958959,-1,A,T,99767557,33622,99604571,99997787,162986
15,ENSG00000255571.2,89378121,15-89335347-A-G,rs3176149,1,A,G,89335347,42774,89181513,89574729,153834
15,ENSG00000259656.1,49101791,15-48992804-G-C,rs34895054,1,G,C,48992804,108987,48905183,49298399,87621
15,ENSG00000259656.1,49101791,15-48992804-G-A,rs34895054,1,G,A,48992804,108987,48905183,49298399,87621
15,ENSG00000259656.1,49101791,15-48992804-G-T,rs34895054,1,G,T,48992804,108987,48905183,49298399,87621
15,ENSG00000259771.1,59271162,15-59208378-T-C,rs3816814,-1,T,C,59208378,62784,59074554,59467770,133824
15,ENSG00000260266.1,74361552,15-74168534-C-G,rs3848159,1,C,G,74168534,193018,74164944,74558160,3590
15,ENSG00000260266.1,74361552,15-74168534-C-A,rs3848159,1,C,A,74168534,193018,74164944,74558160,3590
15,ENSG00000247240.3,74461284,15-74602696-G-T,rs4077831,1,G,T,74602696,141412,74264676,74657892,338020
15,ENSG00000237550.3,82372888,15-82268478-C-T,rs4296215,-1,C,T,82268478,104410,82176280,82569496,92198
15,ENSG00000259201.1,51901123,15-52031306-C-A,rs4491448,-1,C,A,52031306,130183,51704515,52097731,326791
15,ENSG00000259201.1,51901123,15-52031306-C-T,rs4491448,-1,C,T,52031306,130183,51704515,52097731,326791
15,ENSG00000259322.1,78293286,15-78395583-C-T,rs4516196,1,C,T,78395583,102297,78096678,78489894,298905
15,ENSG00000259212.1,90596447,15-90554732-A-G,rs4566137,-1,A,G,90554732,41715,90399839,90793055,154893
15,ENSG00000259212.1,90596447,15-90554732-A-T,rs4566137,-1,A,T,90554732,41715,90399839,90793055,154893
15,ENSG00000245975.2,58770974,15-58848130-C-T,rs4775096,-1,C,T,58848130,77156,58574366,58967582,273764
15,ENSG00000259577.1,52180028,15-52180486-G-T,rs4776010,1,G,T,52180486,458,51983420,52376636,197066
15,ENSG00000259343.1,81331911,15-81328185-G-A,rs4778897,1,G,A,81328185,3726,81135303,81528519,192882
15,ENSG00000175779.1,38628060,15-38662903-G-C,rs4924280,1,G,C,38662903,34843,38431452,38824668,231451
15,ENSG00000175779.1,38628060,15-38662903-G-A,rs4924280,1,G,A,38662903,34843,38431452,38824668,231451
15,ENSG00000175779.1,38628060,15-38662903-G-T,rs4924280,1,G,T,38662903,34843,38431452,38824668,231451
15,ENSG00000258780.1,20153776,15-20007545-G-T,rs4932072,1,G,T,20007545,146231,19957168,20350384,50377
15,ENSG00000258780.1,20153776,15-20007545-G-A,rs4932072,1,G,A,20007545,146231,19957168,20350384,50377
15,ENSG00000259414.1,23293667,15-23102074-G-T,rs4932679,-1,G,T,23102074,191593,23097059,23490275,5015
15,ENSG00000259414.1,23293667,15-23102074-G-C,rs4932679,-1,G,C,23102074,191593,23097059,23490275,5015
15,ENSG00000259414.1,23293667,15-23102074-G-A,rs4932679,-1,G,A,23102074,191593,23097059,23490275,5015
15,ENSG00000259755.1,101086066,15-101175315-T-G,rs4965803,-1,T,G,101175315,89249,100889458,101282674,285857
15,ENSG00000259755.1,101086066,15-101175315-T-A,rs4965803,-1,T,A,101175315,89249,100889458,101282674,285857
15,ENSG00000259232.1,65475614,15-65403645-G-A,rs591980,-1,G,A,65403645,71969,65279006,65672222,124639
15,ENSG00000259232.1,65475614,15-65403645-G-T,rs591980,-1,G,T,65403645,71969,65279006,65672222,124639
15,ENSG00000182625.3,58686411,15-58753575-A-G,rs593742,1,A,G,58753575,67164,58489803,58883019,263772
15,ENSG00000182625.3,58686411,15-58753575-A-T,rs593742,1,A,T,58753575,67164,58489803,58883019,263772
15,ENSG00000259287.1,33864825,15-34002436-T-G,rs603152,-1,T,G,34002436,137611,33668217,34061433,334219
15,ENSG00000259287.1,33864825,15-34002436-T-C,rs603152,-1,T,C,34002436,137611,33668217,34061433,334219
15,ENSG00000260579.1,83114566,15-83093533-A-T,rs62010181,-1,A,T,83093533,21033,82917958,83311174,175575
15,ENSG00000260579.1,83114566,15-83093533-A-G,rs62010181,-1,A,G,83093533,21033,82917958,83311174,175575
15,ENSG00000261002.1,42208413,15-42102170-A-T,rs645953,1,A,T,42102170,106243,42011805,42405021,90365
15,ENSG00000261002.1,42208413,15-42102170-A-C,rs645953,1,A,C,42102170,106243,42011805,42405021,90365
15,ENSG00000261002.1,42208413,15-42102170-A-G,rs645953,1,A,G,42102170,106243,42011805,42405021,90365
15,ENSG00000259327.1,52116574,15-52179350-G-T,rs67725996,1,G,T,52179350,62776,51919966,52313182,259384
15,ENSG00000179362.9,45555482,15-45658717-C-T,rs677413,1,C,T,45658717,103235,45358874,45752090,299843
15,ENSG00000179362.9,45555482,15-45658717-C-A,rs677413,1,C,A,45658717,103235,45358874,45752090,299843
15,ENSG00000179362.9,45555482,15-45658717-C-G,rs677413,1,C,G,45658717,103235,45358874,45752090,299843
15,ENSG00000259686.1,33012119,15-32898112-T-C,rs71462827,1,T,C,32898112,114007,32815511,33208727,82601
15,ENSG00000230183.3,56007176,15-55938613-A-G,rs7163864,-1,A,G,55938613,68563,55810568,56203784,128045
15,ENSG00000230183.3,56007176,15-55938613-A-C,rs7163864,-1,A,C,55938613,68563,55810568,56203784,128045
15,ENSG00000230183.3,56007176,15-55938613-A-T,rs7163864,-1,A,T,55938613,68563,55810568,56203784,128045
15,ENSG00000261616.1,99139317,15-99126124-A-G,rs7164548,1,A,G,99126124,13193,98942709,99335925,183415
15,ENSG00000259684.1,50557601,15-50420840-A-G,rs7170543,1,A,G,50420840,136761,50360993,50754209,59847
15,ENSG00000259583.1,100919391,15-100948377-T-C,rs7170683,-1,T,C,100948377,28986,100722783,101115999,225594
15,ENSG00000258397.1,20074334,15-19967342-T-A,rs7171651,-1,T,A,19967342,106992,19877726,20270942,89616
15,ENSG00000259647.1,30045848,15-29876778-C-T,rs7178240,-1,C,T,29876778,169070,29849240,30242456,27538
15,ENSG00000259709.1,52124561,15-52095248-G-C,rs72732991,1,G,C,52095248,29313,51927953,52321169,167295
15,ENSG00000259709.1,52124561,15-52095248-G-A,rs72732991,1,G,A,52095248,29313,51927953,52321169,167295
15,ENSG00000259581.1,76261690,15-76169531-G-A,rs72736834,-1,G,A,76169531,92159,76065082,76458298,104449
15,ENSG00000259426.1,69415029,15-69433019-C-T,rs72758418,-1,C,T,69433019,17990,69218421,69611637,214598
15,ENSG00000261054.1,99131806,15-99281840-G-A,rs72758808,-1,G,A,99281840,150034,98935198,99328414,346642
15,ENSG00000259592.1,35122084,15-35085633-C-T,rs730493,-1,C,T,35085633,36451,34925476,35318692,160157
15,ENSG00000259712.1,52100523,15-52135256-C-T,rs73402875,-1,C,T,52135256,34733,51903915,52297131,231341
15,ENSG00000259397.1,35092481,15-35140840-T-C,rs7359241,1,T,C,35140840,48359,34895873,35289089,244967
15,ENSG00000259658.1,101745983,15-101766049-G-A,rs74035815,-1,G,A,101766049,20066,101549375,101942591,216674
15,ENSG00000259658.1,101745983,15-101766049-G-C,rs74035815,-1,G,C,101766049,20066,101549375,101942591,216674
15,ENSG00000259375.1,85580178,15-85509439-G-C,rs756426,-1,G,C,85509439,70739,85383570,85776786,125869
15,ENSG00000259375.1,85580178,15-85509439-G-T,rs756426,-1,G,T,85509439,70739,85383570,85776786,125869
15,ENSG00000260776.1,77926825,15-77878371-G-A,rs76208732,-1,G,A,77878371,48454,77730217,78123433,148154
15,ENSG00000259696.1,31454139,15-31343984-C-T,rs76500275,-1,C,T,31343984,110155,31257531,31650747,86453
15,ENSG00000259337.2,19973218,15-19988969-C-T,rs77117206,-1,C,T,19988969,15751,19776610,20169826,212359
15,ENSG00000259335.1,44449344,15-44570331-A-G,rs78531494,-1,A,G,44570331,120987,44252736,44645952,317595
15,ENSG00000261375.1,32491586,15-32656705-C-T,rs80167305,-1,C,T,32656705,165119,32294978,32688194,361727
15,ENSG00000259655.1,99791127,15-99789846-T-G,rs8027079,1,T,G,99789846,1281,99594519,99987735,195327
15,ENSG00000259655.1,99791127,15-99789846-T-C,rs8027079,1,T,C,99789846,1281,99594519,99987735,195327
15,ENSG00000259655.1,99791127,15-99789846-T-A,rs8027079,1,T,A,99789846,1281,99594519,99987735,195327
15,ENSG00000259286.1,68833830,15-68693076-C-T,rs8028973,1,C,T,68693076,140754,68637222,69030438,55854
15,ENSG00000259378.1,50944663,15-50803116-C-T,rs8030680,1,C,T,50803116,141547,50748055,51141271,55061
15,ENSG00000259378.1,50944663,15-50803116-C-G,rs8030680,1,C,G,50803116,141547,50748055,51141271,55061
15,ENSG00000259274.1,60529973,15-60551386-G-A,rs8033552,1,G,A,60551386,21413,60333365,60726581,218021
15,ENSG00000259274.1,60529973,15-60551386-G-T,rs8033552,1,G,T,60551386,21413,60333365,60726581,218021
15,ENSG00000259205.1,100558954,15-100594092-C-G,rs8033689,-1,C,G,100594092,35138,100362346,100755562,231746
15,ENSG00000259205.1,100558954,15-100594092-C-T,rs8033689,-1,C,T,100594092,35138,100362346,100755562,231746
15,ENSG00000259678.1,51414097,15-51376047-G-A,rs8035834,1,G,A,51376047,38050,51217489,51610705,158558
15,ENSG00000214702.5,74098414,15-73932852-G-A,rs8041685,-1,G,A,73932852,165562,73901806,74295022,31046
15,ENSG00000259307.1,40300670,15-40290298-G-T,rs936211,1,G,T,40290298,10372,40104062,40497278,186236
15,ENSG00000259307.1,40300670,15-40290298-G-C,rs936211,1,G,C,40290298,10372,40104062,40497278,186236
15,ENSG00000259307.1,40300670,15-40290298-G-A,rs936211,1,G,A,40290298,10372,40104062,40497278,186236
15,ENSG00000258787.1,93431217,15-93287388-A-T,rs936679,-1,A,T,93287388,143829,93234609,93627825,52779
15,ENSG00000258787.1,93431217,15-93287388-A-G,rs936679,-1,A,G,93287388,143829,93234609,93627825,52779
15,ENSG00000258787.1,93431217,15-93287388-A-C,rs936679,-1,A,C,93287388,143829,93234609,93627825,52779
15,ENSG00000242327.1,52095295,15-52072334-C-T,rs9806168,1,C,T,52072334,22961,51898687,52291903,173647
15,ENSG00000242327.1,52095295,15-52072334-C-G,rs9806168,1,C,G,52072334,22961,51898687,52291903,173647
15,ENSG00000259656.1,49101791,15-49058222-C-T,rs10519206,1,C,T,49058222,43569,48905183,49298399,153039
15,ENSG00000259668.1,51455268,15-51623615-C-T,rs10519313,1,C,T,51623615,168347,51258660,51651876,364955
15,ENSG00000259668.1,51455268,15-51623615-C-A,rs10519313,1,C,A,51623615,168347,51258660,51651876,364955
15,ENSG00000259660.2,101751553,15-101737277-G-T,rs1052887,1,G,T,101737277,14276,101554945,101948161,182332
15,ENSG00000259660.2,101751553,15-101737277-G-C,rs1052887,1,G,C,101737277,14276,101554945,101948161,182332
15,ENSG00000259661.1,90921186,15-91052787-T-C,rs10852141,-1,T,C,91052787,131601,90724578,91117794,328209
15,ENSG00000261002.1,42208413,15-42133673-G-A,rs11070361,1,G,A,42133673,74740,42011805,42405021,121868
15,ENSG00000175779.1,38628060,15-38634634-T-C,rs11073344,1,T,C,38634634,6574,38431452,38824668,203182
15,ENSG00000175779.1,38628060,15-38634634-T-G,rs11073344,1,T,G,38634634,6574,38431452,38824668,203182
15,ENSG00000214432.5,91022621,15-91035010-G-C,rs11073968,1,G,C,91035010,12389,90826013,91219229,208997
15,ENSG00000214432.5,91022621,15-91035010-G-T,rs11073968,1,G,T,91035010,12389,90826013,91219229,208997
15,ENSG00000214432.5,91022621,15-91035010-G-A,rs11073968,1,G,A,91035010,12389,90826013,91219229,208997
15,ENSG00000246877.1,75738623,15-75657861-A-T,rs111488993,-1,A,T,75657861,80762,75542015,75935231,115846
15,ENSG00000246877.1,75738623,15-75657861-A-G,rs111488993,-1,A,G,75657861,80762,75542015,75935231,115846
15,ENSG00000259201.1,51901123,15-51854488-A-G,rs111967363,-1,A,G,51854488,46635,51704515,52097731,149973
15,ENSG00000250988.3,82750572,15-82750492-T-A,rs1124911,1,T,A,82750492,80,82553964,82947180,196528
15,ENSG00000250988.3,82750572,15-82750492-T-C,rs1124911,1,T,C,82750492,80,82553964,82947180,196528
15,ENSG00000260206.1,75636139,15-75674754-A-T,rs1127648,1,A,T,75674754,38615,75439531,75832747,235223
15,ENSG00000260206.1,75636139,15-75674754-A-G,rs1127648,1,A,G,75674754,38615,75439531,75832747,235223
15,ENSG00000260269.1,75601205,15-75522812-C-T,rs113535866,-1,C,T,75522812,78393,75404597,75797813,118215
15,ENSG00000231409.3,34943080,15-34897743-C-T,rs117298567,1,C,T,34897743,45337,34746472,35139688,151271
15,ENSG00000260898.1,72782835,15-72889160-G-A,rs117358968,1,G,A,72889160,106325,72586227,72979443,302933
15,ENSG00000258397.1,20074334,15-20013263-G-C,rs117773459,-1,G,C,20013263,61071,19877726,20270942,135537
15,ENSG00000258397.1,20074334,15-20013263-G-T,rs117773459,-1,G,T,20013263,61071,19877726,20270942,135537
15,ENSG00000258397.1,20074334,15-20013263-G-A,rs117773459,-1,G,A,20013263,61071,19877726,20270942,135537
15,ENSG00000238244.2,90349197,15-90309155-C-A,rs11857445,-1,C,A,90309155,40042,90152589,90545805,156566
15,ENSG00000260139.1,77894684,15-77864411-G-C,rs11857840,1,G,C,77864411,30273,77698076,78091292,166335
15,ENSG00000260139.1,77894684,15-77864411-G-A,rs11857840,1,G,A,77864411,30273,77698076,78091292,166335
15,ENSG00000250379.1,41827936,15-41784189-A-G,rs1197659,-1,A,G,41784189,43747,41631328,42024544,152861
15,ENSG00000261441.1,89335053,15-89440423-T-C,rs12437880,1,T,C,89440423,105370,89138445,89531661,301978
15,ENSG00000260382.1,30883231,15-30730116-A-G,rs12905321,-1,A,G,30730116,153115,30686623,31079839,43493
15,ENSG00000259238.1,59688517,15-59600123-C-A,rs12912193,1,C,A,59600123,88394,59491909,59885125,108214
15,ENSG00000259238.1,59688517,15-59600123-C-T,rs12912193,1,C,T,59600123,88394,59491909,59885125,108214
15,ENSG00000245479.2,90660207,15-90655794-G-A,rs12915979,1,G,A,90655794,4413,90463599,90856815,192195
15,ENSG00000259755.1,101086066,15-100990011-C-A,rs12916234,-1,C,A,100990011,96055,100889458,101282674,100553
15,ENSG00000261679.1,43268388,15-43279265-G-A,rs148818002,-1,G,A,43279265,10877,43071780,43464996,207485
15,ENSG00000259343.1,81331911,15-81184647-C-T,rs1509557,1,C,T,81184647,147264,81135303,81528519,49344
15,ENSG00000241362.2,89688243,15-89690774-A-C,rs1561725,-1,A,C,89690774,2531,89491635,89884851,199139
15,ENSG00000241362.2,89688243,15-89690774-A-G,rs1561725,-1,A,G,89690774,2531,89491635,89884851,199139
15,ENSG00000259909.1,72638821,15-72680206-T-C,rs16957238,1,T,C,72680206,41385,72442213,72835429,237993
15,ENSG00000261375.1,32491586,15-32668937-T-C,rs16963345,-1,T,C,32668937,177351,32294978,32688194,373959
15,ENSG00000259622.1,82010607,15-81952462-C-G,rs16973250,-1,C,G,81952462,58145,81813999,82207215,138463
15,ENSG00000259622.1,82010607,15-81952462-C-T,rs16973250,-1,C,T,81952462,58145,81813999,82207215,138463
15,ENSG00000259622.1,82010607,15-81952462-C-A,rs16973250,-1,C,A,81952462,58145,81813999,82207215,138463
15,ENSG00000242737.1,50466738,15-50597571-A-G,rs17520224,1,A,G,50597571,130833,50270130,50663346,327441
15,ENSG00000259299.1,29235137,15-29383480-T-C,rs17569233,-1,T,C,29383480,148343,29038529,29431745,344951
15,ENSG00000259883.1,41921417,15-41940879-C-T,rs17687882,1,C,T,41940879,19462,41724809,42118025,216070
15,ENSG00000214896.4,52885595,15-53072799-A-C,rs17710168,1,A,C,53072799,187204,52688987,53082203,383812
15,ENSG00000261187.1,72466262,15-72588333-C-T,rs17753089,-1,C,T,72588333,122071,72269654,72662870,318679
15,ENSG00000259363.1,99806991,15-99837548-C-T,rs2061008,1,C,T,99837548,30557,99610383,100003599,227165
15,ENSG00000255571.2,89378121,15-89510836-T-C,rs2119009,1,T,C,89510836,132715,89181513,89574729,329323
15,ENSG00000248508.2,40039264,15-40030351-G-C,rs2250402,1,G,C,40030351,8913,39842656,40235872,187695
15,ENSG00000248508.2,40039264,15-40030351-G-T,rs2250402,1,G,T,40030351,8913,39842656,40235872,187695
15,ENSG00000259479.2,44861850,15-44803892-A-T,rs2443979,-1,A,T,44803892,57958,44665242,45058458,138650
15,ENSG00000259479.2,44861850,15-44803892-A-G,rs2443979,-1,A,G,44803892,57958,44665242,45058458,138650
15,ENSG00000259187.1,44826540,15-44803892-A-T,rs2443979,1,A,T,44803892,22648,44629932,45023148,173960
15,ENSG00000259187.1,44826540,15-44803892-A-G,rs2443979,1,A,G,44803892,22648,44629932,45023148,173960
15,ENSG00000259704.1,90839641,15-90834020-C-G,rs2532103,1,C,G,90834020,5621,90643033,91036249,190987
15,ENSG00000259698.1,21019388,15-21024744-C-T,rs28409350,1,C,T,21024744,5356,20822780,21215996,201964
15,ENSG00000259698.1,21019388,15-21024744-C-G,rs28409350,1,C,G,21024744,5356,20822780,21215996,201964
15,ENSG00000180229.8,20505462,15-20421874-T-C,rs28621737,-1,T,C,20421874,83588,20308854,20702070,113020
15,ENSG00000259684.1,50557601,15-50514272-C-T,rs3098183,1,C,T,50514272,43329,50360993,50754209,153279
15,ENSG00000259448.1,31216021,15-31111892-C-A,rs34359249,1,C,A,31111892,104129,31019413,31412629,92479
15,ENSG00000241061.2,24909825,15-24828702-G-A,rs35701003,-1,G,A,24828702,81123,24713217,25106433,115485
15,ENSG00000234797.4,59768352,15-59729017-A-C,rs36069816,1,A,C,59729017,39335,59571744,59964960,157273
15,ENSG00000234797.4,59768352,15-59729017-A-G,rs36069816,1,A,G,59729017,39335,59571744,59964960,157273
15,ENSG00000259212.1,90596447,15-90618316-A-G,rs3743406,-1,A,G,90618316,21869,90399839,90793055,218477
15,ENSG00000259212.1,90596447,15-90618316-A-C,rs3743406,-1,A,C,90618316,21869,90399839,90793055,218477
15,ENSG00000259583.1,100919391,15-100939826-A-G,rs4075387,-1,A,G,100939826,20435,100722783,101115999,217043
15,ENSG00000259583.1,100919391,15-100939826-A-C,rs4075387,-1,A,C,100939826,20435,100722783,101115999,217043
15,ENSG00000259461.1,81118340,15-81279962-A-G,rs4076201,-1,A,G,81279962,161622,80921732,81314948,358230
15,ENSG00000259732.1,59121034,15-59136459-C-A,rs4218,1,C,A,59136459,15425,58924426,59317642,212033
15,ENSG00000259732.1,59121034,15-59136459-C-T,rs4218,1,C,T,59136459,15425,58924426,59317642,212033
15,ENSG00000259732.1,59121034,15-59136459-C-G,rs4218,1,C,G,59136459,15425,58924426,59317642,212033
15,ENSG00000260648.1,40232082,15-40304360-C-G,rs4244575,1,C,G,40304360,72278,40035474,40428690,268886
15,ENSG00000260648.1,40232082,15-40304360-C-A,rs4244575,1,C,A,40304360,72278,40035474,40428690,268886
15,ENSG00000260648.1,40232082,15-40304360-C-T,rs4244575,1,C,T,40304360,72278,40035474,40428690,268886
15,ENSG00000259715.1,50360194,15-50402109-A-G,rs4774565,-1,A,G,50402109,41915,50163586,50556802,238523
15,ENSG00000259715.1,50360194,15-50402109-A-C,rs4774565,-1,A,C,50402109,41915,50163586,50556802,238523
15,ENSG00000228992.2,27895704,15-27740052-A-G,rs4778116,1,A,G,27740052,155652,27699096,28092312,40956
15,ENSG00000228992.2,27895704,15-27740052-A-T,rs4778116,1,A,T,27740052,155652,27699096,28092312,40956
15,ENSG00000259409.1,40088832,15-40106553-T-G,rs484943,1,T,G,40106553,17721,39892224,40285440,214329
15,ENSG00000259409.1,40088832,15-40106553-T-A,rs484943,1,T,A,40106553,17721,39892224,40285440,214329
15,ENSG00000259409.1,40088832,15-40106553-T-C,rs484943,1,T,C,40106553,17721,39892224,40285440,214329
15,ENSG00000259514.1,76342063,15-76336099-A-C,rs4886490,-1,A,C,76336099,5964,76145455,76538671,190644
15,ENSG00000259514.1,76342063,15-76336099-A-G,rs4886490,-1,A,G,76336099,5964,76145455,76538671,190644
15,ENSG00000260288.1,75737820,15-75779480-G-C,rs4886741,1,G,C,75779480,41660,75541212,75934428,238268
15,ENSG00000260288.1,75737820,15-75779480-G-A,rs4886741,1,G,A,75779480,41660,75541212,75934428,238268
15,ENSG00000246740.2,41972763,15-41981061-G-C,rs4924593,1,G,C,41981061,8298,41776155,42169371,204906
15,ENSG00000228998.2,90275129,15-90309095-G-C,rs4932320,1,G,C,90309095,33966,90078521,90471737,230574
15,ENSG00000228998.2,90275129,15-90309095-G-T,rs4932320,1,G,T,90309095,33966,90078521,90471737,230574
15,ENSG00000259540.1,100558677,15-100547738-G-A,rs4965671,1,G,A,100547738,10939,100362069,100755285,185669
15,ENSG00000259540.1,100558677,15-100547738-G-C,rs4965671,1,G,C,100547738,10939,100362069,100755285,185669
15,ENSG00000259540.1,100558677,15-100547738-G-T,rs4965671,1,G,T,100547738,10939,100362069,100755285,185669
15,ENSG00000247809.3,96327021,15-96433472-C-T,rs4984547,-1,C,T,96433472,106451,96130413,96523629,303059
15,ENSG00000247809.3,96327021,15-96433472-C-A,rs4984547,-1,C,A,96433472,106451,96130413,96523629,303059
15,ENSG00000259751.1,34850395,15-34728190-A-G,rs518930,-1,A,G,34728190,122205,34653787,35047003,74403
15,ENSG00000261559.1,34494420,15-34660874-G-A,rs55737819,1,G,A,34660874,166454,34297812,34691028,363062
15,ENSG00000237550.3,82372888,15-82237482-T-C,rs56398167,-1,T,C,82237482,135406,82176280,82569496,61202
15,ENSG00000259337.2,19973218,15-19946069-C-A,rs58382218,-1,C,A,19946069,27149,19776610,20169826,169459
15,ENSG00000259632.1,51861293,15-51982279-C-T,rs59391908,-1,C,T,51982279,120986,51664685,52057901,317594
15,ENSG00000259232.1,65475614,15-65409977-G-T,rs612401,-1,G,T,65409977,65637,65279006,65672222,130971
15,ENSG00000244879.2,50355467,15-50399448-C-T,rs6493440,1,C,T,50399448,43981,50158859,50552075,240589
15,ENSG00000259712.1,52100523,15-52087539-T-C,rs6493534,-1,T,C,52087539,12984,51903915,52297131,183624
15,ENSG00000259248.1,63600795,15-63517791-A-C,rs6494409,-1,A,C,63517791,83004,63404187,63797403,113604
15,ENSG00000259248.1,63600795,15-63517791-A-G,rs6494409,-1,A,G,63517791,83004,63404187,63797403,113604
15,ENSG00000261635.1,36613474,15-36423817-T-G,rs6495834,1,T,G,36423817,189657,36416866,36810082,6951
15,ENSG00000261635.1,36613474,15-36423817-T-A,rs6495834,1,T,A,36423817,189657,36416866,36810082,6951
15,ENSG00000261635.1,36613474,15-36423817-T-C,rs6495834,1,T,C,36423817,189657,36416866,36810082,6951
15,ENSG00000218052.3,85270892,15-85413397-C-A,rs6497117,-1,C,A,85413397,142505,85074284,85467500,339113
15,ENSG00000218052.3,85270892,15-85413397-C-G,rs6497117,-1,C,G,85413397,142505,85074284,85467500,339113
15,ENSG00000218052.3,85270892,15-85413397-C-T,rs6497117,-1,C,T,85413397,142505,85074284,85467500,339113
15,ENSG00000259709.1,52124561,15-52097240-G-C,rs66742869,1,G,C,52097240,27321,51927953,52321169,169287
15,ENSG00000180953.7,79923702,15-80018147-C-G,rs67355538,-1,C,G,80018147,94445,79727094,80120310,291053
15,ENSG00000180953.7,79923702,15-80018147-C-A,rs67355538,-1,C,A,80018147,94445,79727094,80120310,291053
15,ENSG00000180953.7,79923702,15-80018147-C-T,rs67355538,-1,C,T,80018147,94445,79727094,80120310,291053
15,ENSG00000259388.1,49794246,15-49798488-A-G,rs677361,1,A,G,49798488,4242,49597638,49990854,200850
15,ENSG00000231169.2,52505191,15-52695991-A-G,rs7161887,1,A,G,52695991,190800,52308583,52701799,387408
15,ENSG00000231169.2,52505191,15-52695991-A-T,rs7161887,1,A,T,52695991,190800,52308583,52701799,387408
15,ENSG00000231169.2,52505191,15-52695991-A-C,rs7161887,1,A,C,52695991,190800,52308583,52701799,387408
15,ENSG00000259288.1,40218500,15-40160761-A-C,rs7162428,1,A,C,40160761,57739,40021892,40415108,138869
15,ENSG00000245975.2,58770974,15-58635961-C-T,rs7166325,-1,C,T,58635961,135013,58574366,58967582,61595
15,ENSG00000245975.2,58770974,15-58635961-C-G,rs7166325,-1,C,G,58635961,135013,58574366,58967582,61595
15,ENSG00000258384.1,90955225,15-90811291-G-C,rs7167216,-1,G,C,90811291,143934,90758617,91151833,52674
15,ENSG00000258384.1,90955225,15-90811291-G-A,rs7167216,-1,G,A,90811291,143934,90758617,91151833,52674
15,ENSG00000260657.1,68277994,15-68331837-C-A,rs7167822,-1,C,A,68331837,53843,68081386,68474602,250451
15,ENSG00000260657.1,68277994,15-68331837-C-G,rs7167822,-1,C,G,68331837,53843,68081386,68474602,250451
15,ENSG00000260657.1,68277994,15-68331837-C-T,rs7167822,-1,C,T,68331837,53843,68081386,68474602,250451
15,ENSG00000260579.1,83114566,15-83176530-G-A,rs7173876,-1,G,A,83176530,61964,82917958,83311174,258572
15,ENSG00000260579.1,83114566,15-83176530-G-T,rs7173876,-1,G,T,83176530,61964,82917958,83311174,258572
15,ENSG00000259362.2,77525540,15-77540420-G-A,rs7177055,1,G,A,77540420,14880,77328932,77722148,211488
15,ENSG00000258780.1,20153776,15-19986488-A-C,rs7179358,1,A,C,19986488,167288,19957168,20350384,29320
15,ENSG00000258780.1,20153776,15-19986488-A-G,rs7179358,1,A,G,19986488,167288,19957168,20350384,29320
15,ENSG00000259408.1,33856809,15-33837156-C-T,rs7182398,-1,C,T,33837156,19653,33660201,34053417,176955
15,ENSG00000223518.3,36818113,15-36636967-A-C,rs723830,-1,A,C,36636967,181146,36621505,37014721,15462
15,ENSG00000223518.3,36818113,15-36636967-A-G,rs723830,-1,A,G,36636967,181146,36621505,37014721,15462
15,ENSG00000259658.1,101745983,15-101830769-T-C,rs73489048,-1,T,C,101830769,84786,101549375,101942591,281394
15,ENSG00000259678.1,51414097,15-51476361-T-G,rs74826398,1,T,G,51476361,62264,51217489,51610705,258872
15,ENSG00000259307.1,40300670,15-40247758-G-C,rs76685399,1,G,C,40247758,52912,40104062,40497278,143696
15,ENSG00000259307.1,40300670,15-40247758-G-T,rs76685399,1,G,T,40247758,52912,40104062,40497278,143696
15,ENSG00000261183.1,40844332,15-40977266-A-C,rs77737558,-1,A,C,40977266,132934,40647724,41040940,329542
15,ENSG00000259469.1,48729844,15-48704508-C-T,rs78430496,-1,C,T,48704508,25336,48533236,48926452,171272
15,ENSG00000259845.1,30815271,15-30823352-T-C,rs798121,1,T,C,30823352,8081,30618663,31011879,204689
15,ENSG00000182397.9,99801179,15-99789846-T-A,rs8027079,-1,T,A,99789846,11333,99604571,99997787,185275
15,ENSG00000182397.9,99801179,15-99789846-T-G,rs8027079,-1,T,G,99789846,11333,99604571,99997787,185275
15,ENSG00000182397.9,99801179,15-99789846-T-C,rs8027079,-1,T,C,99789846,11333,99604571,99997787,185275
15,ENSG00000259627.1,63071911,15-63105008-G-C,rs8034945,-1,G,C,63105008,33097,62875303,63268519,229705
15,ENSG00000259627.1,63071911,15-63105008-G-T,rs8034945,-1,G,T,63105008,33097,62875303,63268519,229705
15,ENSG00000259627.1,63071911,15-63105008-G-A,rs8034945,-1,G,A,63105008,33097,62875303,63268519,229705
15,ENSG00000259185.1,51909642,15-51718807-A-T,rs8035173,-1,A,T,51718807,190835,51713034,52106250,5773
15,ENSG00000259185.1,51909642,15-51718807-A-G,rs8035173,-1,A,G,51718807,190835,51713034,52106250,5773
15,ENSG00000261069.1,25087661,15-25042581-A-G,rs8036980,1,A,G,25042581,45080,24891053,25284269,151528
15,ENSG00000257647.1,25032047,15-24881973-A-G,rs951651,-1,A,G,24881973,150074,24835439,25228655,46534
15,ENSG00000258965.1,25928575,15-25797471-T-C,rs9652531,-1,T,C,25797471,131104,25731967,26125183,65504
15,ENSG00000259520.1,45279251,15-45448014-T-C,rs9806724,-1,T,C,45448014,168763,45082643,45475859,365371
15,ENSG00000259520.1,45279251,15-45448014-T-A,rs9806724,-1,T,A,45448014,168763,45082643,45475859,365371
14,ENSG00000258595.1,93138066,14-93191091-T-C,rs10135149,1,T,C,93191091,53025,92941458,93334674,249633
14,ENSG00000259143.1,95185854,14-95256970-T-C,rs10144795,-1,T,C,95256970,71116,94989246,95382462,267724
14,ENSG00000260285.1,103529072,14-103468884-G-T,rs10151139,-1,G,T,103468884,60188,103332464,103725680,136420
14,ENSG00000260285.1,103529072,14-103468884-G-C,rs10151139,-1,G,C,103468884,60188,103332464,103725680,136420
14,ENSG00000260285.1,103529072,14-103468884-G-A,rs10151139,-1,G,A,103468884,60188,103332464,103725680,136420
14,ENSG00000211829.2,22462932,14-22460708-T-G,rs10162417,1,T,G,22460708,2224,22266324,22659540,194384
14,ENSG00000259144.1,20723127,14-20781965-G-A,rs1045922,-1,G,A,20781965,58838,20526519,20919735,255446
14,ENSG00000258301.2,76786724,14-76715959-C-T,rs10483877,-1,C,T,76715959,70765,76590116,76983332,125843
14,ENSG00000258920.1,89417354,14-89381249-G-A,rs10484022,1,G,A,89381249,36105,89220746,89613962,160503
14,ENSG00000258504.1,100291118,14-100302826-C-A,rs1059264,1,C,A,100302826,11708,100094510,100487726,208316
14,ENSG00000258504.1,100291118,14-100302826-C-G,rs1059264,1,C,G,100302826,11708,100094510,100487726,208316
14,ENSG00000258504.1,100291118,14-100302826-C-T,rs1059264,1,C,T,100302826,11708,100094510,100487726,208316
14,ENSG00000258788.1,96223108,14-96093122-C-G,rs1062710,1,C,G,96093122,129986,96026500,96419716,66622
14,ENSG00000258788.1,96223108,14-96093122-C-A,rs1062710,1,C,A,96093122,129986,96026500,96419716,66622
14,ENSG00000258788.1,96223108,14-96093122-C-T,rs1062710,1,C,T,96093122,129986,96026500,96419716,66622
14,ENSG00000258457.1,22982698,14-23080739-C-T,rs11555803,1,C,T,23080739,98041,22786090,23179306,294649
14,ENSG00000242071.2,69886140,14-70038812-C-T,rs1156445,-1,C,T,70038812,152672,69689532,70082748,349280
14,ENSG00000242071.2,69886140,14-70038812-C-G,rs1156445,-1,C,G,70038812,152672,69689532,70082748,349280
14,ENSG00000206596.1,34546714,14-34710175-G-A,rs115973958,1,G,A,34710175,163461,34350106,34743322,360069
14,ENSG00000206588.1,34556389,14-34710175-G-A,rs115973958,-1,G,A,34710175,153786,34359781,34752997,350394
14,ENSG00000258744.1,24443016,14-24625944-C-T,rs11621263,1,C,T,24625944,182928,24246408,24639624,379536
14,ENSG00000259132.1,22982258,14-22989947-G-A,rs11624528,-1,G,A,22989947,7689,22785650,23178866,204297
14,ENSG00000259132.1,22982258,14-22989947-G-C,rs11624528,-1,G,C,22989947,7689,22785650,23178866,204297
14,ENSG00000259648.1,67615484,14-67572172-C-T,rs116547943,1,C,T,67572172,43312,67418876,67812092,153296
14,ENSG00000211945.2,106185394,14-106276418-C-T,rs117796724,-1,C,T,106276418,91024,105988786,106382002,287632
14,ENSG00000211945.2,106185394,14-106276418-C-G,rs117796724,-1,C,G,106276418,91024,105988786,106382002,287632
14,ENSG00000259515.1,102933574,14-102907823-C-A,rs117897999,1,C,A,102907823,25751,102736966,103130182,170857
14,ENSG00000258760.1,65302680,14-65403410-G-C,rs11844747,-1,G,C,65403410,100730,65106072,65499288,297338
14,ENSG00000211962.2,106511856,14-106647657-T-C,rs11848687,-1,T,C,106647657,135801,106315248,106708464,332409
14,ENSG00000235706.3,95157649,14-95195510-G-C,rs11848957,1,G,C,95195510,37861,94961041,95354257,234469
14,ENSG00000235706.3,95157649,14-95195510-G-T,rs11848957,1,G,T,95195510,37861,94961041,95354257,234469
14,ENSG00000258807.1,87872291,14-87881176-C-T,rs11850661,-1,C,T,87881176,8885,87675683,88068899,205493
14,ENSG00000259775.1,103332367,14-103320219-G-C,rs11850831,-1,G,C,103320219,12148,103135759,103528975,184460
14,ENSG00000259775.1,103332367,14-103320219-G-A,rs11850831,-1,G,A,103320219,12148,103135759,103528975,184460
14,ENSG00000259775.1,103332367,14-103320219-G-T,rs11850831,-1,G,T,103320219,12148,103135759,103528975,184460
14,ENSG00000240837.1,70610086,14-70662119-T-C,rs1205237,1,T,C,70662119,52033,70413478,70806694,248641
14,ENSG00000240837.1,70610086,14-70662119-T-G,rs1205237,1,T,G,70662119,52033,70413478,70806694,248641
14,ENSG00000259086.1,32272301,14-32144853-A-C,rs12100688,-1,A,C,32144853,127448,32075693,32468909,69160
14,ENSG00000258995.1,63123007,14-63176008-C-T,rs12147456,1,C,T,63176008,53001,62926399,63319615,249609
14,ENSG00000259146.1,71321814,14-71170203-C-T,rs12433285,-1,C,T,71170203,151611,71125206,71518422,44997
14,ENSG00000213315.4,90766531,14-90871455-G-A,rs1286267,1,G,A,90871455,104924,90569923,90963139,301532
14,ENSG00000246548.2,77041064,14-77019995-C-T,rs12881493,1,C,T,77019995,21069,76844456,77237672,175539
14,ENSG00000246548.2,77041064,14-77019995-C-G,rs12881493,1,C,G,77019995,21069,76844456,77237672,175539
14,ENSG00000259153.1,70809697,14-70837762-G-T,rs12884068,1,G,T,70837762,28065,70613089,71006305,224673
14,ENSG00000259153.1,70809697,14-70837762-G-C,rs12884068,1,G,C,70837762,28065,70613089,71006305,224673
14,ENSG00000259153.1,70809697,14-70837762-G-A,rs12884068,1,G,A,70837762,28065,70613089,71006305,224673
14,ENSG00000261208.1,52286797,14-52340173-A-G,rs12889653,1,A,G,52340173,53376,52090189,52483405,249984
14,ENSG00000261208.1,52286797,14-52340173-A-T,rs12889653,1,A,T,52340173,53376,52090189,52483405,249984
14,ENSG00000261208.1,52286797,14-52340173-A-C,rs12889653,1,A,C,52340173,53376,52090189,52483405,249984
14,ENSG00000258602.1,76959638,14-76959734-G-A,rs12889775,1,G,A,76959734,96,76763030,77156246,196704
14,ENSG00000258602.1,76959638,14-76959734-G-T,rs12889775,1,G,T,76959734,96,76763030,77156246,196704
14,ENSG00000243225.1,76968683,14-76959734-G-A,rs12889775,1,G,A,76959734,8949,76772075,77165291,187659
14,ENSG00000243225.1,76968683,14-76959734-G-T,rs12889775,1,G,T,76959734,8949,76772075,77165291,187659
14,ENSG00000258629.1,65881070,14-65976778-A-G,rs1663330,-1,A,G,65976778,95708,65684462,66077678,292316
14,ENSG00000257275.2,95711747,14-95544563-T-G,rs17092670,1,T,G,95544563,167184,95515139,95908355,29424
14,ENSG00000257831.1,31248628,14-31082357-A-G,rs17097708,1,A,G,31082357,166271,31052020,31445236,30337
14,ENSG00000258526.1,39432607,14-39480974-T-A,rs17109296,1,T,A,39480974,48367,39235999,39629215,244975
14,ENSG00000258526.1,39432607,14-39480974-T-G,rs17109296,1,T,G,39480974,48367,39235999,39629215,244975
14,ENSG00000259019.1,44077884,14-44138077-A-G,rs17114728,-1,A,G,44138077,60193,43881276,44274492,256801
14,ENSG00000244053.1,47201104,14-47170072-A-G,rs17118127,-1,A,G,47170072,31032,47004496,47397712,165576
14,ENSG00000259151.1,89291594,14-89305004-T-A,rs17125653,-1,T,A,89305004,13410,89094986,89488202,210018
14,ENSG00000259065.1,73787360,14-73802455-C-A,rs17182600,1,C,A,73802455,15095,73590752,73983968,211703
14,ENSG00000258427.1,60397757,14-60262865-C-G,rs17256073,1,C,G,60262865,134892,60201149,60594365,61716
14,ENSG00000258646.1,75008481,14-75031474-A-G,rs175071,-1,A,G,75031474,22993,74811873,75205089,219601
14,ENSG00000258646.1,75008481,14-75031474-A-C,rs175071,-1,A,C,75031474,22993,74811873,75205089,219601
14,ENSG00000258572.1,95516136,14-95517638-G-A,rs179145,1,G,A,95517638,1502,95319528,95712744,198110
14,ENSG00000258525.1,30889808,14-30858598-T-C,rs179666,-1,T,C,30858598,31210,30693200,31086416,165398
14,ENSG00000258525.1,30889808,14-30858598-T-A,rs179666,-1,T,A,30858598,31210,30693200,31086416,165398
14,ENSG00000258525.1,30889808,14-30858598-T-G,rs179666,-1,T,G,30858598,31210,30693200,31086416,165398
14,ENSG00000259081.1,76781518,14-76720718-G-T,rs1861423,-1,G,T,76720718,60800,76584910,76978126,135808
14,ENSG00000259081.1,76781518,14-76720718-G-C,rs1861423,-1,G,C,76720718,60800,76584910,76978126,135808
14,ENSG00000259081.1,76781518,14-76720718-G-A,rs1861423,-1,G,A,76720718,60800,76584910,76978126,135808
14,ENSG00000258454.1,76235817,14-76191413-G-A,rs1900126,1,G,A,76191413,44404,76039209,76432425,152204
14,ENSG00000258454.1,76235817,14-76191413-G-T,rs1900126,1,G,T,76191413,44404,76039209,76432425,152204
14,ENSG00000213598.3,58794654,14-58958444-G-A,rs1950668,1,G,A,58958444,163790,58598046,58991262,360398
14,ENSG00000258843.1,50821880,14-50879841-G-C,rs1953877,1,G,C,50879841,57961,50625272,51018488,254569
14,ENSG00000258843.1,50821880,14-50879841-G-T,rs1953877,1,G,T,50879841,57961,50625272,51018488,254569
14,ENSG00000258843.1,50821880,14-50879841-G-A,rs1953877,1,G,A,50879841,57961,50625272,51018488,254569
14,ENSG00000258757.1,52640839,14-52616806-A-T,rs1957384,1,A,T,52616806,24033,52444231,52837447,172575
14,ENSG00000259083.1,39175880,14-39221650-A-G,rs1998194,-1,A,G,39221650,45770,38979272,39372488,242378
14,ENSG00000259083.1,39175880,14-39221650-A-C,rs1998194,-1,A,C,39221650,45770,38979272,39372488,242378
14,ENSG00000259083.1,39175880,14-39221650-A-T,rs1998194,-1,A,T,39221650,45770,38979272,39372488,242378
14,ENSG00000258867.1,88024550,14-88021345-C-A,rs2119704,1,C,A,88021345,3205,87827942,88221158,193403
14,ENSG00000259105.1,35468272,14-35326338-A-C,rs2145622,1,A,C,35326338,141934,35271664,35664880,54674
14,ENSG00000213176.4,103041469,14-103126189-C-T,rs2234127,1,C,T,103126189,84720,102844861,103238077,281328
14,ENSG00000258704.1,34982526,14-34996359-T-C,rs2254990,-1,T,C,34996359,13833,34785918,35179134,210441
14,ENSG00000258704.1,34982526,14-34996359-T-G,rs2254990,-1,T,G,34996359,13833,34785918,35179134,210441
14,ENSG00000259116.1,64540368,14-64734103-G-T,rs229621,-1,G,T,64734103,193735,64343760,64736976,390343
14,ENSG00000187621.10,95651178,14-95670438-C-T,rs2296310,1,C,T,95670438,19260,95454570,95847786,215868
14,ENSG00000187621.10,95651178,14-95670438-C-A,rs2296310,1,C,A,95670438,19260,95454570,95847786,215868
14,ENSG00000259084.1,95663256,14-95670438-C-T,rs2296310,1,C,T,95670438,7182,95466648,95859864,203790
14,ENSG00000259084.1,95663256,14-95670438-C-A,rs2296310,1,C,A,95670438,7182,95466648,95859864,203790
14,ENSG00000258701.1,104821201,14-104816822-C-A,rs2498778,1,C,A,104816822,4379,104624593,105017809,192229
14,ENSG00000258701.1,104821201,14-104816822-C-T,rs2498778,1,C,T,104816822,4379,104624593,105017809,192229
14,ENSG00000244270.1,49577794,14-49619845-C-T,rs3007030,-1,C,T,49619845,42051,49381186,49774402,238659
14,ENSG00000258377.1,49623480,14-49619845-C-T,rs3007030,-1,C,T,49619845,3635,49426872,49820088,192973
14,ENSG00000258445.1,60779978,14-60774640-T-G,rs4151179,1,T,G,60774640,5338,60583370,60976586,191270
14,ENSG00000259007.1,51969800,14-51849521-G-A,rs4243583,-1,G,A,51849521,120279,51773192,52166408,76329
14,ENSG00000258512.1,101730437,14-101732352-C-G,rs45481791,1,C,G,101732352,1915,101533829,101927045,198523
14,ENSG00000258512.1,101730437,14-101732352-C-T,rs45481791,1,C,T,101732352,1915,101533829,101927045,198523
14,ENSG00000257621.2,58298129,14-58355211-A-G,rs4901852,-1,A,G,58355211,57082,58101521,58494737,253690
14,ENSG00000258940.1,39267061,14-39389946-C-A,rs4902570,-1,C,A,39389946,122885,39070453,39463669,319493
14,ENSG00000258940.1,39267061,14-39389946-C-G,rs4902570,-1,C,G,39389946,122885,39070453,39463669,319493
14,ENSG00000258940.1,39267061,14-39389946-C-T,rs4902570,-1,C,T,39389946,122885,39070453,39463669,319493
14,ENSG00000260711.1,91759798,14-91852472-A-G,rs4904818,-1,A,G,91852472,92674,91563190,91956406,289282
14,ENSG00000260711.1,91759798,14-91852472-A-T,rs4904818,-1,A,T,91852472,92674,91563190,91956406,289282
14,ENSG00000258878.1,65235101,14-65228629-G-A,rs55867601,-1,G,A,65228629,6472,65038493,65431709,190136
14,ENSG00000259079.1,71330738,14-71187683-G-A,rs60536344,-1,G,A,71187683,143055,71134130,71527346,53553
14,ENSG00000257171.1,18412264,14-18488398-G-A,rs61970557,-1,G,A,18488398,76134,18215656,18608872,272742
14,ENSG00000242163.1,81333361,14-81459714-C-T,rs61986618,-1,C,T,81459714,126353,81136753,81529969,322961
14,ENSG00000243730.2,36578005,14-36651924-A-G,rs6571757,-1,A,G,36651924,73919,36381397,36774613,270527
14,ENSG00000258623.1,68685565,14-68683145-A-G,rs6573851,-1,A,G,68683145,2420,68488957,68882173,194188
14,ENSG00000258731.1,53153354,14-53138493-A-G,rs67287328,1,A,G,53138493,14861,52956746,53349962,181747
14,ENSG00000211943.2,106154163,14-106042040-T-C,rs7140202,-1,T,C,106042040,112123,105957555,106350771,84485
14,ENSG00000258733.1,85934609,14-85942015-G-A,rs71421481,1,G,A,85942015,7406,85738001,86131217,204014
14,ENSG00000177776.8,74378418,14-74521984-G-A,rs7145480,-1,G,A,74521984,143566,74181810,74575026,340174
14,ENSG00000258666.1,100333790,14-100489859-G-A,rs7156672,1,G,A,100489859,156069,100137182,100530398,352677
14,ENSG00000211965.2,106557477,14-106671943-C-A,rs7159651,-1,C,A,106671943,114466,106360869,106754085,311074
14,ENSG00000211965.2,106557477,14-106671943-C-T,rs7159651,-1,C,T,106671943,114466,106360869,106754085,311074
14,ENSG00000251533.2,103189028,14-103177491-G-T,rs7161651,-1,G,T,103177491,11537,102992420,103385636,185071
14,ENSG00000251533.2,103189028,14-103177491-G-A,rs7161651,-1,G,A,103177491,11537,102992420,103385636,185071
14,ENSG00000211974.2,106724093,14-106530669-C-T,rs72684962,-1,C,T,106530669,193424,106527485,106920701,3184
14,ENSG00000224373.2,106627825,14-106715489-T-A,rs72690551,-1,T,A,106715489,87664,106431217,106824433,284272
14,ENSG00000224373.2,106627825,14-106715489-T-G,rs72690551,-1,T,G,106715489,87664,106431217,106824433,284272
14,ENSG00000211976.2,106803233,14-106827955-C-T,rs72692465,-1,C,T,106827955,24722,106606625,106999841,221330
14,ENSG00000211976.2,106803233,14-106827955-C-A,rs72692465,-1,C,A,106827955,24722,106606625,106999841,221330
14,ENSG00000247287.2,61322838,14-61277744-G-A,rs74541115,-1,G,A,61277744,45094,61126230,61519446,151514
14,ENSG00000247287.2,61322838,14-61277744-G-T,rs74541115,-1,G,T,61277744,45094,61126230,61519446,151514
14,ENSG00000258985.1,53036755,14-52944673-C-G,rs7494379,1,C,G,52944673,92082,52840147,53233363,104526
14,ENSG00000258985.1,53036755,14-52944673-C-T,rs7494379,1,C,T,52944673,92082,52840147,53233363,104526
14,ENSG00000259136.1,57044960,14-56996685-C-T,rs76098246,-1,C,T,56996685,48275,56848352,57241568,148333
14,ENSG00000258645.1,63601509,14-63457684-C-T,rs766079,1,C,T,63457684,143825,63404901,63798117,52783
14,ENSG00000259004.1,101120840,14-101115276-C-T,rs77379184,1,C,T,101115276,5564,100924232,101317448,191044
14,ENSG00000260792.1,104665558,14-104676854-T-C,rs78706926,-1,T,C,104676854,11296,104468950,104862166,207904
14,ENSG00000258987.1,93939497,14-94079701-G-A,rs79048773,1,G,A,94079701,140204,93742889,94136105,336812
14,ENSG00000258987.1,93939497,14-94079701-G-C,rs79048773,1,G,C,94079701,140204,93742889,94136105,336812
14,ENSG00000211966.2,106579236,14-106698331-C-T,rs79326420,-1,C,T,106698331,119095,106382628,106775844,315703
14,ENSG00000211966.2,106579236,14-106698331-C-G,rs79326420,-1,C,G,106698331,119095,106382628,106775844,315703
14,ENSG00000258738.1,34874343,14-34884012-T-G,rs799674,1,T,G,34884012,9669,34677735,35070951,206277
14,ENSG00000258738.1,34874343,14-34884012-T-C,rs799674,1,T,C,34884012,9669,34677735,35070951,206277
14,ENSG00000258768.1,20264308,14-20209655-G-C,rs8012050,-1,G,C,20209655,54653,20067700,20460916,141955
14,ENSG00000258768.1,20264308,14-20209655-G-T,rs8012050,-1,G,T,20209655,54653,20067700,20460916,141955
14,ENSG00000258768.1,20264308,14-20209655-G-A,rs8012050,-1,G,A,20209655,54653,20067700,20460916,141955
14,ENSG00000243824.1,34740833,14-34777266-A-G,rs8015303,-1,A,G,34777266,36433,34544225,34937441,233041
14,ENSG00000225766.3,24036501,14-23934508-G-A,rs8015308,1,G,A,23934508,101993,23839893,24233109,94615
14,ENSG00000258430.1,104769349,14-104672325-G-C,rs8022211,1,G,C,104672325,97024,104572741,104965957,99584
14,ENSG00000258515.1,20451305,14-20449506-T-C,rs999692,1,T,C,20449506,1799,20254697,20647913,194809
14,ENSG00000258515.1,20451305,14-20449506-T-G,rs999692,1,T,G,20449506,1799,20254697,20647913,194809
14,ENSG00000258515.1,20451305,14-20449506-T-A,rs999692,1,T,A,20449506,1799,20254697,20647913,194809
14,ENSG00000258666.1,100333790,14-100354643-G-A,rs1009812,1,G,A,100354643,20853,100137182,100530398,217461
14,ENSG00000258666.1,100333790,14-100354643-G-C,rs1009812,1,G,C,100354643,20853,100137182,100530398,217461
14,ENSG00000211950.2,106277043,14-106293502-A-G,rs10129879,-1,A,G,106293502,16459,106080435,106473651,213067
14,ENSG00000232216.1,106470800,14-106596292-A-G,rs10133734,-1,A,G,106596292,125492,106274192,106667408,322100
14,ENSG00000258526.1,39432607,14-39332982-T-C,rs10137905,1,T,C,39332982,99625,39235999,39629215,96983
14,ENSG00000258629.1,65881070,14-66054275-A-G,rs10141580,-1,A,G,66054275,173205,65684462,66077678,369813
14,ENSG00000211966.2,106579236,14-106717172-G-A,rs10141910,-1,G,A,106717172,137936,106382628,106775844,334544
14,ENSG00000223648.2,106658258,14-106693609-G-C,rs10147756,-1,G,C,106693609,35351,106461650,106854866,231959
14,ENSG00000223648.2,106658258,14-106693609-G-A,rs10147756,-1,G,A,106693609,35351,106461650,106854866,231959
14,ENSG00000211962.2,106511856,14-106693609-G-C,rs10147756,-1,G,C,106693609,181753,106315248,106708464,378361
14,ENSG00000211962.2,106511856,14-106693609-G-A,rs10147756,-1,G,A,106693609,181753,106315248,106708464,378361
14,ENSG00000240023.1,35389069,14-35409225-T-C,rs10148482,-1,T,C,35409225,20156,35192461,35585677,216764
14,ENSG00000258504.1,100291118,14-100300327-G-T,rs10873515,1,G,T,100300327,9209,100094510,100487726,205817
14,ENSG00000258504.1,100291118,14-100300327-G-C,rs10873515,1,G,C,100300327,9209,100094510,100487726,205817
14,ENSG00000258504.1,100291118,14-100300327-G-A,rs10873515,1,G,A,100300327,9209,100094510,100487726,205817
14,ENSG00000258857.1,50397013,14-50395275-T-A,rs11157743,1,T,A,50395275,1738,50200405,50593621,194870
14,ENSG00000258857.1,50397013,14-50395275-T-C,rs11157743,1,T,C,50395275,1738,50200405,50593621,194870
14,ENSG00000259115.1,70641204,14-70590841-T-C,rs11158869,-1,T,C,70590841,50363,70444596,70837812,146245
14,ENSG00000211895.3,105708665,14-105738439-G-A,rs113862374,-1,G,A,105738439,29774,105512057,105905273,226382
14,ENSG00000258807.1,87872291,14-87986601-G-A,rs11552556,-1,G,A,87986601,114310,87675683,88068899,310918
14,ENSG00000258807.1,87872291,14-87986601-G-T,rs11552556,-1,G,T,87986601,114310,87675683,88068899,310918
14,ENSG00000187621.10,95651178,14-95664581-G-C,rs116068986,1,G,C,95664581,13403,95454570,95847786,210011
14,ENSG00000187621.10,95651178,14-95664581-G-A,rs116068986,1,G,A,95664581,13403,95454570,95847786,210011
14,ENSG00000258733.1,85934609,14-85817407-G-A,rs11622744,1,G,A,85817407,117202,85738001,86131217,79406
14,ENSG00000258733.1,85934609,14-85817407-G-T,rs11622744,1,G,T,85817407,117202,85738001,86131217,79406
14,ENSG00000258757.1,52640839,14-52491846-A-G,rs11623647,1,A,G,52491846,148993,52444231,52837447,47615
14,ENSG00000258757.1,52640839,14-52491846-A-T,rs11623647,1,A,T,52491846,148993,52444231,52837447,47615
14,ENSG00000258757.1,52640839,14-52491846-A-C,rs11623647,1,A,C,52491846,148993,52444231,52837447,47615
14,ENSG00000259146.1,71321814,14-71447986-G-A,rs11625612,-1,G,A,71447986,126172,71125206,71518422,322780
14,ENSG00000258407.1,88015611,14-88072154-T-C,rs11627010,-1,T,C,88072154,56543,87819003,88212219,253151
14,ENSG00000258407.1,88015611,14-88072154-T-G,rs11627010,-1,T,G,88072154,56543,87819003,88212219,253151
14,ENSG00000259137.1,44120761,14-44132528-C-A,rs118062417,-1,C,A,44132528,11767,43924153,44317369,208375
14,ENSG00000224373.2,106627825,14-106647657-T-C,rs11848687,-1,T,C,106647657,19832,106431217,106824433,216440
14,ENSG00000250365.2,31420758,14-31458725-C-G,rs11850273,1,C,G,31458725,37967,31224150,31617366,234575
14,ENSG00000250365.2,31420758,14-31458725-C-T,rs11850273,1,C,T,31458725,37967,31224150,31617366,234575
14,ENSG00000258646.1,75008481,14-74959547-G-A,rs11850328,-1,G,A,74959547,48934,74811873,75205089,147674
14,ENSG00000258646.1,75008481,14-74959547-G-C,rs11850328,-1,G,C,74959547,48934,74811873,75205089,147674
14,ENSG00000253755.1,105669843,14-105537986-T-A,rs12100587,-1,T,A,105537986,131857,105473235,105866451,64751
14,ENSG00000253755.1,105669843,14-105537986-T-C,rs12100587,-1,T,C,105537986,131857,105473235,105866451,64751
14,ENSG00000253755.1,105669843,14-105537986-T-G,rs12100587,-1,T,G,105537986,131857,105473235,105866451,64751
14,ENSG00000211892.2,105626066,14-105537986-T-A,rs12100587,-1,T,A,105537986,88080,105429458,105822674,108528
14,ENSG00000211892.2,105626066,14-105537986-T-C,rs12100587,-1,T,C,105537986,88080,105429458,105822674,108528
14,ENSG00000211892.2,105626066,14-105537986-T-G,rs12100587,-1,T,G,105537986,88080,105429458,105822674,108528
14,ENSG00000257285.1,22929613,14-22902571-T-C,rs1242631,1,T,C,22902571,27042,22733005,23126221,169566
14,ENSG00000258749.1,99512501,14-99358828-T-C,rs1257290,1,T,C,99358828,153673,99315893,99709109,42935
14,ENSG00000232573.1,98973301,14-99015305-C-G,rs1257644,-1,C,G,99015305,42004,98776693,99169909,238612
14,ENSG00000232573.1,98973301,14-99015305-C-A,rs1257644,-1,C,A,99015305,42004,98776693,99169909,238612
14,ENSG00000232573.1,98973301,14-99015305-C-T,rs1257644,-1,C,T,99015305,42004,98776693,99169909,238612
14,ENSG00000234648.1,98973314,14-99027873-A-G,rs1257673,1,A,G,99027873,54559,98776706,99169922,251167
14,ENSG00000234648.1,98973314,14-99027873-A-T,rs1257673,1,A,T,99027873,54559,98776706,99169922,251167
14,ENSG00000259143.1,95185854,14-95345207-C-T,rs12884539,-1,C,T,95345207,159353,94989246,95382462,355961
14,ENSG00000197358.7,28264554,14-28290883-C-T,rs12889761,1,C,T,28290883,26329,28067946,28461162,222937
14,ENSG00000237356.1,53217955,14-53286116-A-T,rs1424827,1,A,T,53286116,68161,53021347,53414563,264769
14,ENSG00000237356.1,53217955,14-53286116-A-G,rs1424827,1,A,G,53286116,68161,53021347,53414563,264769
14,ENSG00000259084.1,95663256,14-95674812-C-T,rs17093221,1,C,T,95674812,11556,95466648,95859864,208164
14,ENSG00000257275.2,95711747,14-95815860-C-T,rs17093479,1,C,T,95815860,104113,95515139,95908355,300721
14,ENSG00000258525.1,30889808,14-30733534-A-G,rs17097160,-1,A,G,30733534,156274,30693200,31086416,40334
14,ENSG00000258559.1,74294425,14-74268054-T-C,rs17098984,-1,T,C,74268054,26371,74097817,74491033,170237
14,ENSG00000258559.1,74294425,14-74268054-T-G,rs17098984,-1,T,G,74268054,26371,74097817,74491033,170237
14,ENSG00000242163.1,81333361,14-81297134-G-A,rs17111687,-1,G,A,81297134,36227,81136753,81529969,160381
14,ENSG00000258458.1,22766457,14-22839195-G-A,rs17123091,-1,G,A,22839195,72738,22569849,22963065,269346
14,ENSG00000258908.1,20477089,14-20470092-A-C,rs1760940,-1,A,C,20470092,6997,20280481,20673697,189611
14,ENSG00000258572.1,95516136,14-95518448-T-C,rs179144,1,T,C,95518448,2312,95319528,95712744,198920
14,ENSG00000258572.1,95516136,14-95518448-T-A,rs179144,1,T,A,95518448,2312,95319528,95712744,198920
14,ENSG00000213867.4,30821419,14-30866397-T-G,rs179646,1,T,G,30866397,44978,30624811,31018027,241586
14,ENSG00000213867.4,30821419,14-30866397-T-A,rs179646,1,T,A,30866397,44978,30624811,31018027,241586
14,ENSG00000259065.1,73787360,14-73829948-T-C,rs1860139,1,T,C,73829948,42588,73590752,73983968,239196
14,ENSG00000259019.1,44077884,14-44112426-C-A,rs1950548,-1,C,A,44112426,34542,43881276,44274492,231150
14,ENSG00000259019.1,44077884,14-44112426-C-T,rs1950548,-1,C,T,44112426,34542,43881276,44274492,231150
14,ENSG00000258731.1,53153354,14-53064861-G-A,rs2065345,1,G,A,53064861,88493,52956746,53349962,108115
14,ENSG00000258788.1,96223108,14-96238615-T-C,rs2242961,1,T,C,96238615,15507,96026500,96419716,212115
14,ENSG00000258956.1,61832369,14-61667367-A-G,rs2265402,-1,A,G,61667367,165002,61635761,62028977,31606
14,ENSG00000258956.1,61832369,14-61667367-A-T,rs2265402,-1,A,T,61667367,165002,61635761,62028977,31606
14,ENSG00000211829.2,22462932,14-22473159-A-C,rs2293732,1,A,C,22473159,10227,22266324,22659540,206835
14,ENSG00000259116.1,64540368,14-64710167-G-A,rs229658,-1,G,A,64710167,169799,64343760,64736976,366407
14,ENSG00000258430.1,104769349,14-104780652-C-G,rs2494739,1,C,G,104780652,11303,104572741,104965957,207911
14,ENSG00000258430.1,104769349,14-104780652-C-T,rs2494739,1,C,T,104780652,11303,104572741,104965957,207911
14,ENSG00000258811.1,104842663,14-104816822-C-A,rs2498778,1,C,A,104816822,25841,104646055,105039271,170767
14,ENSG00000258811.1,104842663,14-104816822-C-T,rs2498778,1,C,T,104816822,25841,104646055,105039271,170767
14,ENSG00000258701.1,104821201,14-104871466-C-T,rs28427389,1,C,T,104871466,50265,104624593,105017809,246873
14,ENSG00000211896.2,105743071,14-105731666-C-T,rs28670024,-1,C,T,105731666,11405,105546463,105939679,185203
14,ENSG00000211967.2,106593347,14-106597440-A-G,rs2879067,-1,A,G,106597440,4093,106396739,106789955,200701
14,ENSG00000240392.1,35262462,14-35408515-T-C,rs3138045,1,T,C,35408515,146053,35065854,35459070,342661
14,ENSG00000240392.1,35262462,14-35408515-T-G,rs3138045,1,T,G,35408515,146053,35065854,35459070,342661
14,ENSG00000186615.6,55580115,14-55409545-C-T,rs35502084,-1,C,T,55409545,170570,55383507,55776723,26038
14,ENSG00000258738.1,34874343,14-34868159-T-G,rs3783315,1,T,G,34868159,6184,34677735,35070951,190424
14,ENSG00000258695.2,73522878,14-73492108-T-G,rs3813563,1,T,G,73492108,30770,73326270,73719486,165838
14,ENSG00000258695.2,73522878,14-73492108-T-A,rs3813563,1,T,A,73492108,30770,73326270,73719486,165838
14,ENSG00000258695.2,73522878,14-73492108-T-C,rs3813563,1,T,C,73492108,30770,73326270,73719486,165838
14,ENSG00000259371.1,24120956,14-24290803-G-A,rs4568,1,G,A,24290803,169847,23924348,24317564,366455
14,ENSG00000240837.1,70610086,14-70649389-T-C,rs4899362,1,T,C,70649389,39303,70413478,70806694,235911
14,ENSG00000240837.1,70610086,14-70649389-T-A,rs4899362,1,T,A,70649389,39303,70413478,70806694,235911
14,ENSG00000259007.1,51969800,14-51829703-A-C,rs4901159,-1,A,C,51829703,140097,51773192,52166408,56511
14,ENSG00000259007.1,51969800,14-51829703-A-T,rs4901159,-1,A,T,51829703,140097,51773192,52166408,56511
14,ENSG00000259007.1,51969800,14-51829703-A-G,rs4901159,-1,A,G,51829703,140097,51773192,52166408,56511
14,ENSG00000259004.1,101120840,14-101291358-C-T,rs4906092,1,C,T,101291358,170518,100924232,101317448,367126
14,ENSG00000259004.1,101120840,14-101291358-C-A,rs4906092,1,C,A,101291358,170518,100924232,101317448,367126
14,ENSG00000246548.2,77041064,14-77053807-G-A,rs59111874,1,G,A,77053807,12743,76844456,77237672,209351
14,ENSG00000257307.1,35881001,14-36018459-T-C,rs61988208,1,T,C,36018459,137458,35684393,36077609,334066
14,ENSG00000257307.1,35881001,14-36018459-T-A,rs61988208,1,T,A,36018459,137458,35684393,36077609,334066
14,ENSG00000253209.1,106666532,14-106681225-A-C,rs61997606,-1,A,C,106681225,14693,106469924,106863140,211301
14,ENSG00000243225.1,76968683,14-76957933-C-T,rs6574343,1,C,T,76957933,10750,76772075,77165291,185858
14,ENSG00000258602.1,76959638,14-76957933-C-T,rs6574343,1,C,T,76957933,1705,76763030,77156246,194903
14,ENSG00000260806.1,96502321,14-96602067-C-T,rs71415040,-1,C,T,96602067,99746,96305713,96698929,296354
14,ENSG00000211974.2,106724093,14-106559411-C-A,rs7142635,-1,C,A,106559411,164682,106527485,106920701,31926
14,ENSG00000260711.1,91759798,14-91871533-T-A,rs7143288,-1,T,A,91871533,111735,91563190,91956406,308343
14,ENSG00000260711.1,91759798,14-91871533-T-C,rs7143288,-1,T,C,91871533,111735,91563190,91956406,308343
14,ENSG00000258512.1,101730437,14-101810391-G-T,rs7143539,1,G,T,101810391,79954,101533829,101927045,276562
14,ENSG00000242951.1,75596206,14-75540034-A-G,rs7147148,-1,A,G,75540034,56172,75399598,75792814,140436
14,ENSG00000211973.2,106715181,14-106815005-G-A,rs7149473,-1,G,A,106815005,99824,106518573,106911789,296432
14,ENSG00000211973.2,106715181,14-106815005-G-C,rs7149473,-1,G,C,106815005,99824,106518573,106911789,296432
14,ENSG00000213315.4,90766531,14-90686138-T-C,rs7151110,1,T,C,90686138,80393,90569923,90963139,116215
14,ENSG00000258563.1,60179382,14-60212390-C-T,rs7156228,1,C,T,60212390,33008,59982774,60375990,229616
14,ENSG00000250366.2,95876430,14-95803450-C-A,rs7158270,1,C,A,95803450,72980,95679822,96073038,123628
14,ENSG00000258648.1,30683598,14-30706367-G-A,rs72666434,-1,G,A,30706367,22769,30486990,30880206,219377
14,ENSG00000224650.2,106811131,14-106715489-T-G,rs72690551,-1,T,G,106715489,95642,106614523,107007739,100966
14,ENSG00000224650.2,106811131,14-106715489-T-A,rs72690551,-1,T,A,106715489,95642,106614523,107007739,100966
14,ENSG00000211979.2,106875071,14-106715489-T-G,rs72690551,-1,T,G,106715489,159582,106678463,107071679,37026
14,ENSG00000211979.2,106875071,14-106715489-T-A,rs72690551,-1,T,A,106715489,159582,106678463,107071679,37026
14,ENSG00000253132.1,106643585,14-106793159-G-A,rs72692452,-1,G,A,106793159,149574,106446977,106840193,346182
14,ENSG00000258920.1,89417354,14-89318058-C-T,rs72701658,1,C,T,89318058,99296,89220746,89613962,97312
14,ENSG00000211952.2,106324760,14-106304614-G-A,rs7493992,-1,G,A,106304614,20146,106128152,106521368,176462
14,ENSG00000211952.2,106324760,14-106304614-G-C,rs7493992,-1,G,C,106304614,20146,106128152,106521368,176462
14,ENSG00000259153.1,70809697,14-70753154-C-T,rs75142804,1,C,T,70753154,56543,70613089,71006305,140065
14,ENSG00000260285.1,103529072,14-103554117-T-C,rs752624,-1,T,C,103554117,25045,103332464,103725680,221653
14,ENSG00000253692.2,105722527,14-105612107-C-T,rs75500838,-1,C,T,105612107,110420,105525919,105919135,86188
14,ENSG00000211976.2,106803233,14-106679700-C-T,rs756584,-1,C,T,106679700,123533,106606625,106999841,73075
14,ENSG00000258791.2,55796731,14-55977823-G-A,rs77179131,-1,G,A,55977823,181092,55600123,55993339,377700
14,ENSG00000258900.1,58521223,14-58534554-C-T,rs8005231,1,C,T,58534554,13331,58324615,58717831,209939
14,ENSG00000258900.1,58521223,14-58534554-C-A,rs8005231,1,C,A,58534554,13331,58324615,58717831,209939
14,ENSG00000258900.1,58521223,14-58534554-C-G,rs8005231,1,C,G,58534554,13331,58324615,58717831,209939
14,ENSG00000225766.3,24036501,14-23926274-T-C,rs8005541,1,T,C,23926274,110227,23839893,24233109,86381
14,ENSG00000259775.1,103332367,14-103348753-G-T,rs8009817,-1,G,T,103348753,16386,103135759,103528975,212994
14,ENSG00000259775.1,103332367,14-103348753-G-A,rs8009817,-1,G,A,103348753,16386,103135759,103528975,212994
14,ENSG00000259151.1,89291594,14-89287612-A-C,rs8013441,-1,A,C,89287612,3982,89094986,89488202,192626
14,ENSG00000258841.1,81661428,14-81704599-C-T,rs8016575,1,C,T,81704599,43171,81464820,81858036,239779
14,ENSG00000203546.3,31457407,14-31543387-G-C,rs8016747,-1,G,C,31543387,85980,31260799,31654015,282588
14,ENSG00000203546.3,31457407,14-31543387-G-A,rs8016747,-1,G,A,31543387,85980,31260799,31654015,282588
14,ENSG00000259032.1,82693055,14-82888594-G-A,rs8023225,-1,G,A,82888594,195539,82496447,82889663,392147
14,ENSG00000259136.1,57044960,14-56903064-G-A,rs850279,-1,G,A,56903064,141896,56848352,57241568,54712
14,ENSG00000259081.1,76781518,14-76651207-A-G,rs850748,-1,A,G,76651207,130311,76584910,76978126,66297
14,ENSG00000259081.1,76781518,14-76651207-A-T,rs850748,-1,A,T,76651207,130311,76584910,76978126,66297
14,ENSG00000259081.1,76781518,14-76651207-A-C,rs850748,-1,A,C,76651207,130311,76584910,76978126,66297
14,ENSG00000258515.1,20451305,14-20448799-T-G,rs938883,1,T,G,20448799,2506,20254697,20647913,194102
14,ENSG00000258515.1,20451305,14-20448799-T-A,rs938883,1,T,A,20448799,2506,20254697,20647913,194102
14,ENSG00000258515.1,20451305,14-20448799-T-C,rs938883,1,T,C,20448799,2506,20254697,20647913,194102
14,ENSG00000259135.1,34556774,14-34647083-G-A,rs9671535,1,G,A,34647083,90309,34360166,34753382,286917
14,ENSG00000258645.1,63601509,14-63555490-T-A,rs972984,1,T,A,63555490,46019,63404901,63798117,150589
14,ENSG00000258645.1,63601509,14-63555490-T-C,rs972984,1,T,C,63555490,46019,63404901,63798117,150589
14,ENSG00000213598.3,58794654,14-58945071-A-G,rs983449,1,A,G,58945071,150417,58598046,58991262,347025
14,ENSG00000259081.1,76781518,14-76752967-A-G,rs1004578,-1,A,G,76752967,28551,76584910,76978126,168057
14,ENSG00000211974.2,106724093,14-106596292-A-G,rs10133734,-1,A,G,106596292,127801,106527485,106920701,68807
14,ENSG00000258951.1,70594552,14-70681974-G-A,rs10140197,1,G,A,70681974,87422,70397944,70791160,284030
14,ENSG00000258988.1,67199062,14-67076707-A-G,rs10144870,1,A,G,67076707,122355,67002454,67395670,74253
14,ENSG00000258301.2,76786724,14-76728983-G-A,rs10483878,-1,G,A,76728983,57741,76590116,76983332,138867
14,ENSG00000259019.1,44077884,14-44076587-T-C,rs10484232,-1,T,C,44076587,1297,43881276,44274492,195311
14,ENSG00000251533.2,103189028,14-103186910-T-C,rs11160730,-1,T,C,103186910,2118,102992420,103385636,194490
14,ENSG00000258727.1,23561097,14-23596015-A-G,rs11535017,1,A,G,23596015,34918,23364489,23757705,231526
14,ENSG00000258727.1,23561097,14-23596015-A-C,rs11535017,1,A,C,23596015,34918,23364489,23757705,231526
14,ENSG00000258727.1,23561097,14-23596015-A-T,rs11535017,1,A,T,23596015,34918,23364489,23757705,231526
14,ENSG00000258811.1,104842663,14-104846598-C-T,rs11624762,1,C,T,104846598,3935,104646055,105039271,200543
14,ENSG00000258701.1,104821201,14-104846598-C-T,rs11624762,1,C,T,104846598,25397,104624593,105017809,222005
14,ENSG00000259775.1,103332367,14-103290384-A-T,rs11625351,-1,A,T,103290384,41983,103135759,103528975,154625
14,ENSG00000259775.1,103332367,14-103290384-A-G,rs11625351,-1,A,G,103290384,41983,103135759,103528975,154625
14,ENSG00000258695.2,73522878,14-73367853-G-A,rs117168412,1,G,A,73367853,155025,73326270,73719486,41583
14,ENSG00000253755.1,105669843,14-105707884-G-A,rs117775520,-1,G,A,105707884,38041,105473235,105866451,234649
14,ENSG00000211898.3,105845677,14-105707884-G-A,rs117775520,-1,G,A,105707884,137793,105649069,106042285,58815
14,ENSG00000211976.2,106803233,14-106779068-T-C,rs11846893,-1,T,C,106779068,24165,106606625,106999841,172443
14,ENSG00000211976.2,106803233,14-106779068-T-A,rs11846893,-1,T,A,106779068,24165,106606625,106999841,172443
14,ENSG00000258758.1,57040885,14-57054171-T-C,rs1189821,1,T,C,57054171,13286,56844277,57237493,209894
14,ENSG00000258758.1,57040885,14-57054171-T-A,rs1189821,1,T,A,57054171,13286,56844277,57237493,209894
14,ENSG00000258758.1,57040885,14-57054171-T-G,rs1189821,1,T,G,57054171,13286,56844277,57237493,209894
14,ENSG00000232216.1,106470800,14-106513421-G-A,rs12050163,-1,G,A,106513421,42621,106274192,106667408,239229
14,ENSG00000232216.1,106470800,14-106513421-G-C,rs12050163,-1,G,C,106513421,42621,106274192,106667408,239229
14,ENSG00000240837.1,70610086,14-70663076-A-T,rs1205235,1,A,T,70663076,52990,70413478,70806694,249598
14,ENSG00000240837.1,70610086,14-70663076-A-G,rs1205235,1,A,G,70663076,52990,70413478,70806694,249598
14,ENSG00000211893.3,105644790,14-105537986-T-C,rs12100587,-1,T,C,105537986,106804,105448182,105841398,89804
14,ENSG00000211893.3,105644790,14-105537986-T-G,rs12100587,-1,T,G,105537986,106804,105448182,105841398,89804
14,ENSG00000211893.3,105644790,14-105537986-T-A,rs12100587,-1,T,A,105537986,106804,105448182,105841398,89804
14,ENSG00000256500.3,103562962,14-103672302-C-T,rs12432994,1,C,T,103672302,109340,103366354,103759570,305948
14,ENSG00000256500.3,103562962,14-103672302-C-G,rs12432994,1,C,G,103672302,109340,103366354,103759570,305948
14,ENSG00000259045.1,32484800,14-32572615-G-A,rs12435734,-1,G,A,32572615,87815,32288192,32681408,284423
14,ENSG00000259318.1,55395233,14-55486659-G-A,rs12587011,-1,G,A,55486659,91426,55198625,55591841,288034
14,ENSG00000259007.1,51969800,14-51867485-A-G,rs12885784,-1,A,G,51867485,102315,51773192,52166408,94293
14,ENSG00000259007.1,51969800,14-51867485-A-T,rs12885784,-1,A,T,51867485,102315,51773192,52166408,94293
14,ENSG00000259169.1,60400013,14-60360092-T-C,rs17097373,-1,T,C,60360092,39921,60203405,60596621,156687
14,ENSG00000225766.3,24036501,14-24231823-G-T,rs17102177,1,G,T,24231823,195322,23839893,24233109,391930
14,ENSG00000258760.1,65302680,14-65322822-C-T,rs17102600,-1,C,T,65322822,20142,65106072,65499288,216750
14,ENSG00000258760.1,65302680,14-65322822-C-G,rs17102600,-1,C,G,65322822,20142,65106072,65499288,216750
14,ENSG00000259022.1,35430260,14-35234633-T-G,rs17103120,1,T,G,35234633,195627,35233652,35626868,981
14,ENSG00000259022.1,35430260,14-35234633-T-C,rs17103120,1,T,C,35234633,195627,35233652,35626868,981
14,ENSG00000253209.1,106666532,14-106823737-A-G,rs17112078,-1,A,G,106823737,157205,106469924,106863140,353813
14,ENSG00000211968.2,106622855,14-106565708-C-A,rs17112960,-1,C,A,106565708,57147,106426247,106819463,139461
14,ENSG00000258603.1,73633722,14-73622861-T-C,rs17128989,-1,T,C,73622861,10861,73437114,73830330,185747
14,ENSG00000259084.1,95663256,14-95673747-G-A,rs1748932,1,G,A,95673747,10491,95466648,95859864,207099
14,ENSG00000214770.2,64338639,14-64148823-G-A,rs17766384,-1,G,A,64148823,189816,64142031,64535247,6792
14,ENSG00000258744.1,24443016,14-24536034-A-C,rs1956913,1,A,C,24536034,93018,24246408,24639624,289626
14,ENSG00000258744.1,24443016,14-24536034-A-G,rs1956913,1,A,G,24536034,93018,24246408,24639624,289626
14,ENSG00000258744.1,24443016,14-24536034-A-T,rs1956913,1,A,T,24536034,93018,24246408,24639624,289626
14,ENSG00000258940.1,39267061,14-39221650-A-C,rs1998194,-1,A,C,39221650,45411,39070453,39463669,151197
14,ENSG00000258940.1,39267061,14-39221650-A-G,rs1998194,-1,A,G,39221650,45411,39070453,39463669,151197
14,ENSG00000258940.1,39267061,14-39221650-A-T,rs1998194,-1,A,T,39221650,45411,39070453,39463669,151197
14,ENSG00000260711.1,91759798,14-91864475-G-A,rs2052204,-1,G,A,91864475,104677,91563190,91956406,301285
14,ENSG00000260711.1,91759798,14-91864475-G-T,rs2052204,-1,G,T,91864475,104677,91563190,91956406,301285
14,ENSG00000258788.1,96223108,14-96263805-A-C,rs2071084,1,A,C,96263805,40697,96026500,96419716,237305
14,ENSG00000258788.1,96223108,14-96263805-A-G,rs2071084,1,A,G,96263805,40697,96026500,96419716,237305
14,ENSG00000258788.1,96223108,14-96263805-A-T,rs2071084,1,A,T,96263805,40697,96026500,96419716,237305
14,ENSG00000211972.2,106675544,14-106852518-G-T,rs2105992,-1,G,T,106852518,176974,106478936,106872152,373582
14,ENSG00000211972.2,106675544,14-106852518-G-A,rs2105992,-1,G,A,106852518,176974,106478936,106872152,373582
14,ENSG00000258512.1,101730437,14-101873224-T-G,rs2144986,1,T,G,101873224,142787,101533829,101927045,339395
14,ENSG00000258610.1,76778952,14-76857439-G-A,rs2272590,1,G,A,76857439,78487,76582344,76975560,275095
14,ENSG00000259371.1,24120956,14-24213631-G-C,rs2295319,1,G,C,24213631,92675,23924348,24317564,289283
14,ENSG00000259371.1,24120956,14-24213631-G-A,rs2295319,1,G,A,24213631,92675,23924348,24317564,289283
14,ENSG00000258856.1,57629926,14-57581964-T-G,rs238389,1,T,G,57581964,47962,57433318,57826534,148646
14,ENSG00000258856.1,57629926,14-57581964-T-C,rs238389,1,T,C,57581964,47962,57433318,57826534,148646
14,ENSG00000258454.1,76235817,14-76121943-T-C,rs2543356,1,T,C,76121943,113874,76039209,76432425,82734
14,ENSG00000260792.1,104665558,14-104652736-T-A,rs28676628,-1,T,A,104652736,12822,104468950,104862166,183786
14,ENSG00000260792.1,104665558,14-104652736-T-C,rs28676628,-1,T,C,104652736,12822,104468950,104862166,183786
14,ENSG00000259321.1,24139445,14-24258855-G-A,rs34597632,1,G,A,24258855,119410,23942837,24336053,316018
14,ENSG00000258805.1,94631863,14-94443293-C-G,rs3818257,1,C,G,94443293,188570,94435255,94828471,8038
14,ENSG00000258805.1,94631863,14-94443293-C-A,rs3818257,1,C,A,94443293,188570,94435255,94828471,8038
14,ENSG00000258805.1,94631863,14-94443293-C-T,rs3818257,1,C,T,94443293,188570,94435255,94828471,8038
14,ENSG00000259143.1,95185854,14-95346140-G-A,rs4641666,-1,G,A,95346140,160286,94989246,95382462,356894
14,ENSG00000258990.1,89111223,14-89030894-A-G,rs4899963,-1,A,G,89030894,80329,88914615,89307831,116279
14,ENSG00000258990.1,89111223,14-89030894-A-T,rs4899963,-1,A,T,89030894,80329,88914615,89307831,116279
14,ENSG00000187621.10,95651178,14-95547798-A-G,rs4900279,1,A,G,95547798,103380,95454570,95847786,93228
14,ENSG00000258422.1,70187123,14-70224994-A-G,rs4902794,1,A,G,70224994,37871,69990515,70383731,234479
14,ENSG00000258422.1,70187123,14-70224994-A-T,rs4902794,1,A,T,70224994,37871,69990515,70383731,234479
14,ENSG00000258422.1,70187123,14-70224994-A-C,rs4902794,1,A,C,70224994,37871,69990515,70383731,234479
14,ENSG00000258559.1,74294425,14-74346366-A-C,rs4903216,-1,A,C,74346366,51941,74097817,74491033,248549
14,ENSG00000258559.1,74294425,14-74346366-A-T,rs4903216,-1,A,T,74346366,51941,74097817,74491033,248549
14,ENSG00000258559.1,74294425,14-74346366-A-G,rs4903216,-1,A,G,74346366,51941,74097817,74491033,248549
14,ENSG00000258867.1,88024550,14-88157926-A-G,rs4904431,1,A,G,88157926,133376,87827942,88221158,329984
14,ENSG00000250366.2,95876430,14-95923031-T-C,rs4905406,1,T,C,95923031,46601,95679822,96073038,243209
14,ENSG00000250366.2,95876430,14-95923031-T-G,rs4905406,1,T,G,95923031,46601,95679822,96073038,243209
14,ENSG00000250366.2,95876430,14-95923031-T-A,rs4905406,1,T,A,95923031,46601,95679822,96073038,243209
14,ENSG00000213867.4,30821419,14-30810280-A-G,rs4981778,1,A,G,30810280,11139,30624811,31018027,185469
14,ENSG00000215256.3,24052509,14-23977905-G-A,rs59082073,-1,G,A,23977905,74604,23855901,24249117,122004
14,ENSG00000258471.1,21014822,14-20834169-G-A,rs60623839,-1,G,A,20834169,180653,20818214,21211430,15955
14,ENSG00000211962.2,106511856,14-106474734-G-A,rs61999684,-1,G,A,106474734,37122,106315248,106708464,159486
14,ENSG00000211962.2,106511856,14-106474734-G-C,rs61999684,-1,G,C,106474734,37122,106315248,106708464,159486
14,ENSG00000240954.1,21750269,14-21644374-A-G,rs6571976,1,A,G,21644374,105895,21553661,21946877,90713
14,ENSG00000244053.1,47201104,14-47093812-G-C,rs6572404,-1,G,C,47093812,107292,47004496,47397712,89316
14,ENSG00000244053.1,47201104,14-47093812-G-T,rs6572404,-1,G,T,47093812,107292,47004496,47397712,89316
14,ENSG00000259133.1,56730506,14-56830946-T-G,rs7143840,-1,T,G,56830946,100440,56533898,56927114,297048
14,ENSG00000259133.1,56730506,14-56830946-T-A,rs7143840,-1,T,A,56830946,100440,56533898,56927114,297048
14,ENSG00000258841.1,81661428,14-81471543-C-T,rs7152448,1,C,T,81471543,189885,81464820,81858036,6723
14,ENSG00000259319.1,75427741,14-75482925-G-C,rs7153685,-1,G,C,75482925,55184,75231133,75624349,251792
14,ENSG00000259319.1,75427741,14-75482925-G-A,rs7153685,-1,G,A,75482925,55184,75231133,75624349,251792
14,ENSG00000258572.1,95516136,14-95510418-T-G,rs7155612,1,T,G,95510418,5718,95319528,95712744,190890
14,ENSG00000259137.1,44120761,14-44019125-C-T,rs7157868,-1,C,T,44019125,101636,43924153,44317369,94972
14,ENSG00000259137.1,44120761,14-44019125-C-G,rs7157868,-1,C,G,44019125,101636,43924153,44317369,94972
14,ENSG00000213176.4,103041469,14-103094249-T-C,rs7160202,1,T,C,103094249,52780,102844861,103238077,249388
14,ENSG00000213176.4,103041469,14-103094249-T-A,rs7160202,1,T,A,103094249,52780,102844861,103238077,249388
14,ENSG00000223648.2,106658258,14-106825455-C-A,rs7161472,-1,C,A,106825455,167197,106461650,106854866,363805
14,ENSG00000223648.2,106658258,14-106825455-C-T,rs7161472,-1,C,T,106825455,167197,106461650,106854866,363805
14,ENSG00000258908.1,20477089,14-20487118-C-T,rs72672774,-1,C,T,20487118,10029,20280481,20673697,206637
14,ENSG00000258908.1,20477089,14-20487118-C-A,rs72672774,-1,C,A,20487118,10029,20280481,20673697,206637
14,ENSG00000211970.2,106639657,14-106715489-T-G,rs72690551,-1,T,G,106715489,75832,106443049,106836265,272440
14,ENSG00000211970.2,106639657,14-106715489-T-A,rs72690551,-1,T,A,106715489,75832,106443049,106836265,272440
14,ENSG00000211899.3,105856218,14-105728477-T-C,rs72713373,-1,T,C,105728477,127741,105659610,106052826,68867
14,ENSG00000247287.2,61322838,14-61295175-A-G,rs72725885,-1,A,G,61295175,27663,61126230,61519446,168945
14,ENSG00000211891.4,105601728,14-105612107-C-T,rs75500838,-1,C,T,105612107,10379,105405120,105798336,206987
14,ENSG00000211973.2,106715181,14-106679700-C-T,rs756584,-1,C,T,106679700,35481,106518573,106911789,161127
14,ENSG00000258401.1,49373966,14-49333363-A-G,rs75988183,1,A,G,49333363,40603,49177358,49570574,156005
14,ENSG00000188831.3,36371412,14-36471089-A-G,rs76424069,1,A,G,36471089,99677,36174804,36568020,296285
14,ENSG00000188831.3,36371412,14-36471089-A-C,rs76424069,1,A,C,36471089,99677,36174804,36568020,296285
14,ENSG00000258377.1,49623480,14-49480609-T-C,rs76881004,-1,T,C,49480609,142871,49426872,49820088,53737
14,ENSG00000258377.1,49623480,14-49480609-T-A,rs76881004,-1,T,A,49480609,142871,49426872,49820088,53737
14,ENSG00000258526.1,39432607,14-39568482-G-C,rs77398632,1,G,C,39568482,135875,39235999,39629215,332483
14,ENSG00000258526.1,39432607,14-39568482-G-T,rs77398632,1,G,T,39568482,135875,39235999,39629215,332483
14,ENSG00000257171.1,18412264,14-18490163-C-G,rs78432465,-1,C,G,18490163,77899,18215656,18608872,274507
14,ENSG00000257171.1,18412264,14-18490163-C-T,rs78432465,-1,C,T,18490163,77899,18215656,18608872,274507
14,ENSG00000258623.1,68685565,14-68848299-C-T,rs78436810,-1,C,T,68848299,162734,68488957,68882173,359342
14,ENSG00000243225.1,76968683,14-77097333-G-A,rs79607813,1,G,A,77097333,128650,76772075,77165291,325258
14,ENSG00000258704.1,34982526,14-34918667-C-A,rs799664,-1,C,A,34918667,63859,34785918,35179134,132749
14,ENSG00000258704.1,34982526,14-34918667-C-T,rs799664,-1,C,T,34918667,63859,34785918,35179134,132749
14,ENSG00000258857.1,50397013,14-50518489-C-T,rs8010115,1,C,T,50518489,121476,50200405,50593621,318084
14,ENSG00000258857.1,50397013,14-50518489-C-A,rs8010115,1,C,A,50518489,121476,50200405,50593621,318084
14,ENSG00000256243.2,35235651,14-35416080-T-A,rs8018407,-1,T,A,35416080,180429,35039043,35432259,377037
14,ENSG00000256243.2,35235651,14-35416080-T-C,rs8018407,-1,T,C,35416080,180429,35039043,35432259,377037
14,ENSG00000258602.1,76959638,14-77014493-G-T,rs80217144,1,G,T,77014493,54855,76763030,77156246,251463
14,ENSG00000258602.1,76959638,14-77014493-G-A,rs80217144,1,G,A,77014493,54855,76763030,77156246,251463
14,ENSG00000258738.1,34874343,14-34890442-T-A,rs811340,1,T,A,34890442,16099,34677735,35070951,212707
14,ENSG00000258738.1,34874343,14-34890442-T-C,rs811340,1,T,C,34890442,16099,34677735,35070951,212707
14,ENSG00000213598.3,58794654,14-58771448-G-A,rs856211,1,G,A,58771448,23206,58598046,58991262,173402
14,ENSG00000258504.1,100291118,14-100315540-A-C,rs9324018,1,A,C,100315540,24422,100094510,100487726,221030
14,ENSG00000258504.1,100291118,14-100315540-A-T,rs9324018,1,A,T,100315540,24422,100094510,100487726,221030
14,ENSG00000239323.1,31463371,14-31281491-A-T,rs956810,-1,A,T,31281491,181880,31266763,31659979,14728
14,ENSG00000239323.1,31463371,14-31281491-A-G,rs956810,-1,A,G,31281491,181880,31266763,31659979,14728
13,ENSG00000215515.2,32384660,13-32402221-G-T,rs10492397,1,G,T,32402221,17561,32188052,32581268,214169
13,ENSG00000215515.2,32384660,13-32402221-G-A,rs10492397,1,G,A,32402221,17561,32188052,32581268,214169
13,ENSG00000205822.5,24408157,13-24435150-C-T,rs1050114,1,C,T,24435150,26993,24211549,24604765,223601
13,ENSG00000176124.6,50082171,13-49914947-A-G,rs1063183,1,A,G,49914947,167224,49885563,50278779,29384
13,ENSG00000235366.1,45701187,13-45877041-G-A,rs113025005,-1,G,A,45877041,175854,45504579,45897795,372462
13,ENSG00000227354.1,79406301,13-79314341-T-C,rs1155848,1,T,C,79314341,91960,79209693,79602909,104648
13,ENSG00000232894.1,19570288,13-19399665-G-A,rs115985822,-1,G,A,19399665,170623,19373680,19766896,25985
13,ENSG00000205861.7,23891459,13-23900585-G-A,rs11617793,1,G,A,23900585,9126,23694851,24088067,205734
13,ENSG00000206192.7,18871967,13-18936342-T-A,rs117190915,-1,T,A,18936342,64375,18675359,19068575,260983
13,ENSG00000206192.7,18871967,13-18936342-T-C,rs117190915,-1,T,C,18936342,64375,18675359,19068575,260983
13,ENSG00000224429.1,21348721,13-21325070-T-A,rs12584088,-1,T,A,21325070,23651,21152113,21545329,172957
13,ENSG00000224429.1,21348721,13-21325070-T-C,rs12584088,-1,T,C,21325070,23651,21152113,21545329,172957
13,ENSG00000260388.1,47932622,13-47878179-A-G,rs12585580,-1,A,G,47878179,54443,47736014,48129230,142165
13,ENSG00000260388.1,47932622,13-47878179-A-C,rs12585580,-1,A,C,47878179,54443,47736014,48129230,142165
13,ENSG00000238121.1,30376971,13-30372309-T-A,rs1275190,-1,T,A,30372309,4662,30180363,30573579,191946
13,ENSG00000238121.1,30376971,13-30372309-T-G,rs1275190,-1,T,G,30372309,4662,30180363,30573579,191946
13,ENSG00000236044.1,51966742,13-51812144-C-A,rs12864768,1,C,A,51812144,154598,51770134,52163350,42010
13,ENSG00000260992.1,99087819,13-99018725-A-G,rs16956240,1,A,G,99018725,69094,98891211,99284427,127514
13,ENSG00000235957.1,49187670,13-49026258-G-T,rs17465832,-1,G,T,49026258,161412,48991062,49384278,35196
13,ENSG00000235957.1,49187670,13-49026258-G-A,rs17465832,-1,G,A,49026258,161412,48991062,49384278,35196
13,ENSG00000215417.4,91347820,13-91375999-A-G,rs17556717,1,A,G,91375999,28179,91151212,91544428,224787
13,ENSG00000215417.4,91347820,13-91375999-A-C,rs17556717,1,A,C,91375999,28179,91151212,91544428,224787
13,ENSG00000232117.1,30159621,13-30252110-T-C,rs17803384,-1,T,C,30252110,92489,29963013,30356229,289097
13,ENSG00000238086.3,48320475,13-48415676-A-G,rs1894255,-1,A,G,48415676,95201,48123867,48517083,291809
13,ENSG00000261553.1,75549773,13-75569436-T-C,rs2296146,1,T,C,75569436,19663,75353165,75746381,216271
13,ENSG00000261553.1,75549773,13-75569436-T-A,rs2296146,1,T,A,75569436,19663,75353165,75746381,216271
13,ENSG00000238286.1,20607268,13-20615802-G-A,rs2442455,1,G,A,20615802,8534,20410660,20803876,205142
13,ENSG00000214182.4,81690068,13-81765224-A-G,rs261475,1,A,G,81765224,75156,81493460,81886676,271764
13,ENSG00000214182.4,81690068,13-81765224-A-C,rs261475,1,A,C,81765224,75156,81493460,81886676,271764
13,ENSG00000214182.4,81690068,13-81765224-A-T,rs261475,1,A,T,81765224,75156,81493460,81886676,271764
13,ENSG00000225674.1,24123814,13-24251913-C-T,rs2793491,-1,C,T,24251913,128099,23927206,24320422,324707
13,ENSG00000234685.1,22915651,13-22734301-A-G,rs314880,1,A,G,22734301,181350,22719043,23112259,15258
13,ENSG00000234685.1,22915651,13-22734301-A-T,rs314880,1,A,T,22734301,181350,22719043,23112259,15258
13,ENSG00000232662.2,113276616,13-113123195-A-G,rs3211719,1,A,G,113123195,153421,113080008,113473224,43187
13,ENSG00000253771.1,24967454,13-24893003-G-T,rs3742166,-1,G,T,24893003,74451,24770846,25164062,122157
13,ENSG00000253771.1,24967454,13-24893003-G-A,rs3742166,-1,G,A,24893003,74451,24770846,25164062,122157
13,ENSG00000225039.1,30422251,13-30431005-T-G,rs4769036,-1,T,G,30431005,8754,30225643,30618859,205362
13,ENSG00000225039.1,30422251,13-30431005-T-C,rs4769036,-1,T,C,30431005,8754,30225643,30618859,205362
13,ENSG00000232489.1,30542897,13-30640089-G-C,rs4769043,-1,G,C,30640089,97192,30346289,30739505,293800
13,ENSG00000232489.1,30542897,13-30640089-G-T,rs4769043,-1,G,T,30640089,97192,30346289,30739505,293800
13,ENSG00000237952.1,22803296,13-22740783-T-G,rs4770296,1,T,G,22740783,62513,22606688,22999904,134095
13,ENSG00000237952.1,22803296,13-22740783-T-C,rs4770296,1,T,C,22740783,62513,22606688,22999904,134095
13,ENSG00000260704.1,27953526,13-28047294-C-G,rs4771206,1,C,G,28047294,93768,27756918,28150134,290376
13,ENSG00000260704.1,27953526,13-28047294-C-T,rs4771206,1,C,T,28047294,93768,27756918,28150134,290376
13,ENSG00000260704.1,27953526,13-28047294-C-A,rs4771206,1,C,A,28047294,93768,27756918,28150134,290376
13,ENSG00000233672.1,50910594,13-50975421-G-A,rs6561604,-1,G,A,50975421,64827,50713986,51107202,261435
13,ENSG00000233672.1,50910594,13-50975421-G-T,rs6561604,-1,G,T,50975421,64827,50713986,51107202,261435
13,ENSG00000227105.1,110936759,13-110956379-G-A,rs67298778,1,G,A,110956379,19620,110740151,111133367,216228
13,ENSG00000229473.2,40993331,13-40885502-A-G,rs7320344,-1,A,G,40885502,107829,40796723,41189939,88779
13,ENSG00000229473.2,40993331,13-40885502-A-T,rs7320344,-1,A,T,40885502,107829,40796723,41189939,88779
13,ENSG00000229473.2,40993331,13-40885502-A-C,rs7320344,-1,A,C,40885502,107829,40796723,41189939,88779
13,ENSG00000176268.5,40863902,13-40776843-G-C,rs7323436,-1,G,C,40776843,87059,40667294,41060510,109549
13,ENSG00000176268.5,40863902,13-40776843-G-A,rs7323436,-1,G,A,40776843,87059,40667294,41060510,109549
13,ENSG00000237636.2,19344825,13-19304185-C-T,rs7329022,-1,C,T,19304185,40640,19148217,19541433,155968
13,ENSG00000237636.2,19344825,13-19304185-C-G,rs7329022,-1,C,G,19304185,40640,19148217,19541433,155968
13,ENSG00000236834.1,19345049,13-19304185-C-T,rs7329022,1,C,T,19304185,40864,19148441,19541657,155744
13,ENSG00000236834.1,19345049,13-19304185-C-G,rs7329022,1,C,G,19304185,40864,19148441,19541657,155744
13,ENSG00000225530.1,89363224,13-89383912-T-G,rs7338116,-1,T,G,89383912,20688,89166616,89559832,217296
13,ENSG00000180172.5,21094714,13-21115861-G-A,rs74686907,-1,G,A,21115861,21147,20898106,21291322,217755
13,ENSG00000237876.1,45688469,13-45702881-A-G,rs755428,-1,A,G,45702881,14412,45491861,45885077,211020
13,ENSG00000168852.7,40864352,13-40770068-G-A,rs76080821,-1,G,A,40770068,94284,40667744,41060960,102324
13,ENSG00000235280.1,112968824,13-112976094-G-A,rs78105344,-1,G,A,112976094,7270,112772216,113165432,203878
13,ENSG00000231607.2,50125541,13-50124017-A-C,rs7981648,-1,A,C,50124017,1524,49928933,50322149,195084
13,ENSG00000236778.1,51452364,13-51618259-G-A,rs7983294,1,G,A,51618259,165895,51255756,51648972,362503
13,ENSG00000233695.1,113815630,13-113818854-G-A,rs7996145,1,G,A,113818854,3224,113619022,114012238,199832
13,ENSG00000233610.1,48590587,13-48591739-G-A,rs8002098,-1,G,A,48591739,1152,48393979,48787195,197760
13,ENSG00000235472.1,28598833,13-28433006-C-T,rs9513113,1,C,T,28433006,165827,28402225,28795441,30781
13,ENSG00000235472.1,28598833,13-28433006-C-A,rs9513113,1,C,A,28433006,165827,28402225,28795441,30781
13,ENSG00000233532.1,106376573,13-106360943-A-G,rs9520040,1,A,G,106360943,15630,106179965,106573181,180978
13,ENSG00000230490.1,33676820,13-33676841-T-C,rs9538300,-1,T,C,33676841,21,33480212,33873428,196629
13,ENSG00000230490.1,33676820,13-33676841-T-G,rs9538300,-1,T,G,33676841,21,33480212,33873428,196629
13,ENSG00000203441.2,99501052,13-99416013-C-T,rs9557217,-1,C,T,99416013,85039,99304444,99697660,111569
13,ENSG00000203441.2,99501052,13-99416013-C-G,rs9557217,-1,C,G,99416013,85039,99304444,99697660,111569
13,ENSG00000203441.2,99501052,13-99416013-C-A,rs9557217,-1,C,A,99416013,85039,99304444,99697660,111569
13,ENSG00000235903.1,46052497,13-46071410-A-T,rs9562637,1,A,T,46071410,18913,45855889,46249105,215521
13,ENSG00000235903.1,46052497,13-46071410-A-G,rs9562637,1,A,G,46071410,18913,45855889,46249105,215521
13,ENSG00000226525.3,21629015,13-21645331-C-T,rs9578394,-1,C,T,21645331,16316,21432407,21825623,212924
13,ENSG00000235879.1,90170866,13-90119341-T-C,rs9583789,1,T,C,90119341,51525,89974258,90367474,145083
13,ENSG00000215480.3,41442770,13-41475559-T-C,rs9590603,1,T,C,41475559,32789,41246162,41639378,229397
13,ENSG00000215480.3,41442770,13-41475559-T-G,rs9590603,1,T,G,41475559,32789,41246162,41639378,229397
13,ENSG00000205240.3,41432201,13-41475559-T-C,rs9590603,-1,T,C,41475559,43358,41235593,41628809,239966
13,ENSG00000205240.3,41432201,13-41475559-T-G,rs9590603,-1,T,G,41475559,43358,41235593,41628809,239966
13,ENSG00000261105.1,75635994,13-75654645-G-A,rs9593109,-1,G,A,75654645,18651,75439386,75832602,215259
13,ENSG00000261105.1,75635994,13-75654645-G-C,rs9593109,-1,G,C,75654645,18651,75439386,75832602,215259
13,ENSG00000213232.2,63811608,13-63793556-C-T,rs115400964,-1,C,T,63793556,18052,63615000,64008216,178556
13,ENSG00000213232.2,63811608,13-63793556-C-G,rs115400964,-1,C,G,63793556,18052,63615000,64008216,178556
13,ENSG00000213232.2,63811608,13-63793556-C-A,rs115400964,-1,C,A,63793556,18052,63615000,64008216,178556
13,ENSG00000235903.1,46052497,13-46044933-C-T,rs116151828,1,C,T,46044933,7564,45855889,46249105,189044
13,ENSG00000231473.2,48303489,13-48148735-T-A,rs1172549,-1,T,A,48148735,154754,48106881,48500097,41854
13,ENSG00000231473.2,48303489,13-48148735-T-C,rs1172549,-1,T,C,48148735,154754,48106881,48500097,41854
13,ENSG00000204718.3,18726706,13-18717590-G-T,rs12585423,1,G,T,18717590,9116,18530098,18923314,187492
13,ENSG00000204718.3,18726706,13-18717590-G-C,rs12585423,1,G,C,18717590,9116,18530098,18923314,187492
13,ENSG00000232380.1,68985058,13-68945930-G-A,rs1340741,1,G,A,68945930,39128,68788450,69181666,157480
13,ENSG00000232380.1,68985058,13-68945930-G-T,rs1340741,1,G,T,68945930,39128,68788450,69181666,157480
13,ENSG00000234377.2,77919689,13-78116051-G-A,rs1576594,1,G,A,78116051,196362,77723081,78116297,392970
13,ENSG00000229696.1,41925598,13-41996719-A-G,rs17062690,1,A,G,41996719,71121,41728990,42122206,267729
13,ENSG00000235366.1,45701187,13-45885024-C-A,rs17067382,-1,C,A,45885024,183837,45504579,45897795,380445
13,ENSG00000235957.1,49187670,13-49107583-G-A,rs17072713,-1,G,A,49107583,80087,48991062,49384278,116521
13,ENSG00000232489.1,30542897,13-30603637-G-A,rs17074775,-1,G,A,30603637,60740,30346289,30739505,257348
13,ENSG00000231650.1,22850101,13-22674769-G-A,rs2042708,1,G,A,22674769,175332,22653493,23046709,21276
13,ENSG00000238121.1,30376971,13-30352593-C-T,rs2183284,-1,C,T,30352593,24378,30180363,30573579,172230
13,ENSG00000227354.1,79406301,13-79366394-G-C,rs2274554,1,G,C,79366394,39907,79209693,79602909,156701
13,ENSG00000227354.1,79406301,13-79366394-G-A,rs2274554,1,G,A,79366394,39907,79209693,79602909,156701
13,ENSG00000251106.1,46270077,13-46343334-G-A,rs2478046,1,G,A,46343334,73257,46073469,46466685,269865
13,ENSG00000235280.1,112968824,13-112963563-C-T,rs2993346,-1,C,T,112963563,5261,112772216,113165432,191347
13,ENSG00000236834.1,19345049,13-19374280-G-C,rs3002071,1,G,C,19374280,29231,19148441,19541657,225839
13,ENSG00000236834.1,19345049,13-19374280-G-A,rs3002071,1,G,A,19374280,29231,19148441,19541657,225839
13,ENSG00000229473.2,40993331,13-41083204-C-T,rs3794330,-1,C,T,41083204,89873,40796723,41189939,286481
13,ENSG00000238086.3,48320475,13-48317700-G-T,rs3825417,-1,G,T,48317700,2775,48123867,48517083,193833
13,ENSG00000238086.3,48320475,13-48317700-G-A,rs3825417,-1,G,A,48317700,2775,48123867,48517083,193833
13,ENSG00000214823.3,39169951,13-39292936-G-T,rs4556672,-1,G,T,39292936,122985,38973343,39366559,319593
13,ENSG00000214823.3,39169951,13-39292936-G-A,rs4556672,-1,G,A,39292936,122985,38973343,39366559,319593
13,ENSG00000215515.2,32384660,13-32349553-C-T,rs4942448,1,C,T,32349553,35107,32188052,32581268,161501
13,ENSG00000238241.1,99408914,13-99224791-A-C,rs61968340,-1,A,C,99224791,184123,99212306,99605522,12485
13,ENSG00000238241.1,99408914,13-99224791-A-G,rs61968340,-1,A,G,99224791,184123,99212306,99605522,12485
13,ENSG00000237876.1,45688469,13-45707017-G-C,rs6561247,-1,G,C,45707017,18548,45491861,45885077,215156
13,ENSG00000237876.1,45688469,13-45707017-G-A,rs6561247,-1,G,A,45707017,18548,45491861,45885077,215156
13,ENSG00000176124.6,50082171,13-50141598-T-C,rs706610,1,T,C,50141598,59427,49885563,50278779,256035
13,ENSG00000224429.1,21348721,13-21338716-G-T,rs7320279,-1,G,T,21338716,10005,21152113,21545329,186603
13,ENSG00000224429.1,21348721,13-21338716-G-A,rs7320279,-1,G,A,21338716,10005,21152113,21545329,186603
13,ENSG00000224429.1,21348721,13-21338716-G-C,rs7320279,-1,G,C,21338716,10005,21152113,21545329,186603
13,ENSG00000261105.1,75635994,13-75788603-T-A,rs7321748,-1,T,A,75788603,152609,75439386,75832602,349217
13,ENSG00000261105.1,75635994,13-75788603-T-C,rs7321748,-1,T,C,75788603,152609,75439386,75832602,349217
13,ENSG00000261105.1,75635994,13-75788603-T-G,rs7321748,-1,T,G,75788603,152609,75439386,75832602,349217
13,ENSG00000227590.1,106663437,13-106472022-G-T,rs73586125,1,G,T,106472022,191415,106466829,106860045,5193
13,ENSG00000227590.1,106663437,13-106472022-G-A,rs73586125,1,G,A,106472022,191415,106466829,106860045,5193
13,ENSG00000227590.1,106663437,13-106472022-G-C,rs73586125,1,G,C,106472022,191415,106466829,106860045,5193
13,ENSG00000229152.1,110899172,13-110719611-G-A,rs76490034,-1,G,A,110719611,179561,110702564,111095780,17047
13,ENSG00000229152.1,110899172,13-110719611-G-C,rs76490034,-1,G,C,110719611,179561,110702564,111095780,17047
13,ENSG00000235472.1,28598833,13-28790671-G-A,rs78353449,1,G,A,28790671,191838,28402225,28795441,388446
13,ENSG00000260509.1,25301438,13-25286135-A-G,rs7982860,-1,A,G,25286135,15303,25104830,25498046,181305
13,ENSG00000260509.1,25301438,13-25286135-A-C,rs7982860,-1,A,C,25286135,15303,25104830,25498046,181305
13,ENSG00000214269.3,64959396,13-65011050-C-T,rs7985106,-1,C,T,65011050,51654,64762788,65156004,248262
13,ENSG00000213411.2,30543461,13-30358630-C-T,rs7997259,-1,C,T,30358630,184831,30346853,30740069,11777
13,ENSG00000213411.2,30543461,13-30358630-C-G,rs7997259,-1,C,G,30358630,184831,30346853,30740069,11777
13,ENSG00000205861.7,23891459,13-23868323-C-G,rs9318099,1,C,G,23868323,23136,23694851,24088067,173472
13,ENSG00000205861.7,23891459,13-23868323-C-A,rs9318099,1,C,A,23868323,23136,23694851,24088067,173472
13,ENSG00000205861.7,23891459,13-23868323-C-T,rs9318099,1,C,T,23868323,23136,23694851,24088067,173472
13,ENSG00000237952.1,22803296,13-22678007-T-C,rs9506903,1,T,C,22678007,125289,22606688,22999904,71319
13,ENSG00000225039.1,30422251,13-30321056-C-T,rs9508703,-1,C,T,30321056,101195,30225643,30618859,95413
13,ENSG00000233672.1,50910594,13-50908576-C-T,rs9535525,-1,C,T,50908576,2018,50713986,51107202,194590
13,ENSG00000226537.1,67910986,13-67828303-A-G,rs9541230,1,A,G,67828303,82683,67714378,68107594,113925
13,ENSG00000232662.2,113276616,13-113290312-C-T,rs9549731,1,C,T,113290312,13696,113080008,113473224,210304
13,ENSG00000232662.2,113276616,13-113290312-C-A,rs9549731,1,C,A,113290312,13696,113080008,113473224,210304
13,ENSG00000232662.2,113276616,13-113290312-C-G,rs9549731,1,C,G,113290312,13696,113080008,113473224,210304
13,ENSG00000237636.2,19344825,13-19398566-C-G,rs9554214,-1,C,G,19398566,53741,19148217,19541433,250349
13,ENSG00000237636.2,19344825,13-19398566-C-A,rs9554214,-1,C,A,19398566,53741,19148217,19541433,250349
13,ENSG00000232378.1,36927219,13-36734778-G-A,rs9566158,-1,G,A,36734778,192441,36730611,37123827,4167
13,ENSG00000232378.1,36927219,13-36734778-G-C,rs9566158,-1,G,C,36734778,192441,36730611,37123827,4167
13,ENSG00000233695.1,113815630,13-113812448-A-G,rs9577876,1,A,G,113812448,3182,113619022,114012238,193426
13,ENSG00000225674.1,24123814,13-24221434-A-C,rs9580898,-1,A,C,24221434,97620,23927206,24320422,294228
13,ENSG00000229696.1,41925598,13-41832992-G-C,rs114734228,1,G,C,41832992,92606,41728990,42122206,104002
13,ENSG00000230584.1,78908919,13-78885610-G-A,rs1218285,1,G,A,78885610,23309,78712311,79105527,173299
13,ENSG00000231473.2,48303489,13-48172327-T-C,rs12875956,-1,T,C,48172327,131162,48106881,48500097,65446
13,ENSG00000231473.2,48303489,13-48172327-T-A,rs12875956,-1,T,A,48172327,131162,48106881,48500097,65446
13,ENSG00000238121.1,30376971,13-30226156-A-T,rs169332,-1,A,T,30226156,150815,30180363,30573579,45793
13,ENSG00000238121.1,30376971,13-30226156-A-C,rs169332,-1,A,C,30226156,150815,30180363,30573579,45793
13,ENSG00000228036.1,37994720,13-38123375-A-T,rs17057228,-1,A,T,38123375,128655,37798112,38191328,325263
13,ENSG00000228036.1,37994720,13-38123375-A-G,rs17057228,-1,A,G,38123375,128655,37798112,38191328,325263
13,ENSG00000260388.1,47932622,13-48078454-G-T,rs2182375,-1,G,T,48078454,145832,47736014,48129230,342440
13,ENSG00000260388.1,47932622,13-48078454-G-C,rs2182375,-1,G,C,48078454,145832,47736014,48129230,342440
13,ENSG00000260388.1,47932622,13-48078454-G-A,rs2182375,-1,G,A,48078454,145832,47736014,48129230,342440
13,ENSG00000233532.1,106376573,13-106473457-T-C,rs2391298,1,T,C,106473457,96884,106179965,106573181,293492
13,ENSG00000224429.1,21348721,13-21330685-G-C,rs261728,-1,G,C,21330685,18036,21152113,21545329,178572
13,ENSG00000224429.1,21348721,13-21330685-G-A,rs261728,-1,G,A,21330685,18036,21152113,21545329,178572
13,ENSG00000213232.2,63811608,13-63881032-C-A,rs275903,-1,C,A,63881032,69424,63615000,64008216,266032
13,ENSG00000213232.2,63811608,13-63881032-C-T,rs275903,-1,C,T,63881032,69424,63615000,64008216,266032
13,ENSG00000227879.2,19227432,13-19399309-T-C,rs3002079,-1,T,C,19399309,171877,19030824,19424040,368485
13,ENSG00000233695.1,113815630,13-113812132-T-C,rs3088277,1,T,C,113812132,3498,113619022,114012238,193110
13,ENSG00000262619.1,22915775,13-22734301-A-G,rs314880,-1,A,G,22734301,181474,22719167,23112383,15134
13,ENSG00000262619.1,22915775,13-22734301-A-T,rs314880,-1,A,T,22734301,181474,22719167,23112383,15134
13,ENSG00000261105.1,75635994,13-75637352-T-G,rs34050766,-1,T,G,75637352,1358,75439386,75832602,197966
13,ENSG00000236608.1,60638097,13-60698269-A-T,rs3920667,-1,A,T,60698269,60172,60441489,60834705,256780
13,ENSG00000236608.1,60638097,13-60698269-A-C,rs3920667,-1,A,C,60698269,60172,60441489,60834705,256780
13,ENSG00000236608.1,60638097,13-60698269-A-G,rs3920667,-1,A,G,60698269,60172,60441489,60834705,256780
13,ENSG00000233524.1,20748057,13-20716717-G-A,rs41445248,-1,G,A,20716717,31340,20551449,20944665,165268
13,ENSG00000170919.9,45341483,13-45443071-G-A,rs55829994,1,G,A,45443071,101588,45144875,45538091,298196
13,ENSG00000232872.2,51910621,13-51835101-T-C,rs621221,-1,T,C,51835101,75520,51714013,52107229,121088
13,ENSG00000205822.5,24408157,13-24368570-A-G,rs7337996,1,A,G,24368570,39587,24211549,24604765,157021
13,ENSG00000168852.7,40864352,13-40776200-C-T,rs7489635,-1,C,T,40776200,88152,40667744,41060960,108456
13,ENSG00000168852.7,40864352,13-40776200-C-A,rs7489635,-1,C,A,40776200,88152,40667744,41060960,108456
13,ENSG00000168852.7,40864352,13-40776200-C-G,rs7489635,-1,C,G,40776200,88152,40667744,41060960,108456
13,ENSG00000232662.2,113276616,13-113143487-A-G,rs753057,1,A,G,113143487,133129,113080008,113473224,63479
13,ENSG00000205861.7,23891459,13-23822464-A-G,rs75674138,1,A,G,23822464,68995,23694851,24088067,127613
13,ENSG00000231856.1,51804297,13-51618259-G-A,rs7983294,1,G,A,51618259,186038,51607689,52000905,10570
13,ENSG00000247400.2,95676920,13-95758966-T-C,rs7995306,-1,T,C,95758966,82046,95480312,95873528,278654
13,ENSG00000247400.2,95676920,13-95758966-T-G,rs7995306,-1,T,G,95758966,82046,95480312,95873528,278654
13,ENSG00000233456.1,48573317,13-48591739-G-A,rs8002098,-1,G,A,48591739,18422,48376709,48769925,215030
13,ENSG00000251106.1,46270077,13-46126650-T-C,rs9316183,1,T,C,46126650,143427,46073469,46466685,53181
13,ENSG00000237876.1,45688469,13-45833938-G-C,rs9526115,-1,G,C,45833938,145469,45491861,45885077,342077
13,ENSG00000237876.1,45688469,13-45833938-G-A,rs9526115,-1,G,A,45833938,145469,45491861,45885077,342077
13,ENSG00000214222.2,41385183,13-41444294-C-T,rs9532820,-1,C,T,41444294,59111,41188575,41581791,255719
13,ENSG00000214222.2,41385183,13-41444294-C-A,rs9532820,-1,C,A,41444294,59111,41188575,41581791,255719
13,ENSG00000214249.3,75240296,13-75261503-T-C,rs9543881,-1,T,C,75261503,21207,75043688,75436904,217815
13,ENSG00000228444.1,75631271,13-75524524-T-A,rs9543956,1,T,A,75524524,106747,75434663,75827879,89861
13,ENSG00000228444.1,75631271,13-75524524-T-C,rs9543956,1,T,C,75524524,106747,75434663,75827879,89861
13,ENSG00000228444.1,75631271,13-75524524-T-G,rs9543956,1,T,G,75524524,106747,75434663,75827879,89861
13,ENSG00000237636.2,19344825,13-19378819-G-T,rs9551398,-1,G,T,19378819,33994,19148217,19541433,230602
13,ENSG00000236834.1,19345049,13-19398566-C-G,rs9554214,1,C,G,19398566,53517,19148441,19541657,250125
13,ENSG00000236834.1,19345049,13-19398566-C-A,rs9554214,1,C,A,19398566,53517,19148441,19541657,250125
13,ENSG00000225823.1,104814327,13-104947926-C-T,rs9555118,1,C,T,104947926,133599,104617719,105010935,330207
13,ENSG00000230490.1,33676820,13-33655932-A-G,rs9569997,-1,A,G,33655932,20888,33480212,33873428,175720
13,ENSG00000215417.4,91347820,13-91322486-C-T,rs9589196,1,C,T,91322486,25334,91151212,91544428,171274
13,ENSG00000238213.1,60274776,13-60124329-G-A,rs9592018,1,G,A,60124329,150447,60078168,60471384,46161
13,ENSG00000232041.1,73036401,13-73215533-A-T,rs9600097,1,A,T,73215533,179132,72839793,73233009,375740
13,ENSG00000232041.1,73036401,13-73215533-A-G,rs9600097,1,A,G,73215533,179132,72839793,73233009,375740
12,ENSG00000257331.1,45065351,12-45179028-A-G,rs1025092,-1,A,G,45179028,113677,44868743,45261959,310285
12,ENSG00000247934.3,28190366,12-28115904-T-A,rs10459087,-1,T,A,28115904,74462,27993758,28386974,122146
12,ENSG00000247934.3,28190366,12-28115904-T-C,rs10459087,-1,T,C,28115904,74462,27993758,28386974,122146
12,ENSG00000221949.2,62603690,12-62583447-A-T,rs10459257,-1,A,T,62583447,20243,62407082,62800298,176365
12,ENSG00000221949.2,62603690,12-62583447-A-G,rs10459257,-1,A,G,62583447,20243,62407082,62800298,176365
12,ENSG00000221949.2,62603690,12-62583447-A-C,rs10459257,-1,A,C,62583447,20243,62407082,62800298,176365
12,ENSG00000258302.1,89561129,12-89592559-C-T,rs10506974,1,C,T,89592559,31430,89364521,89757737,228038
12,ENSG00000258303.1,93836167,12-93857566-T-G,rs10745667,1,T,G,93857566,21399,93639559,94032775,218007
12,ENSG00000258303.1,93836167,12-93857566-T-A,rs10745667,1,T,A,93857566,21399,93639559,94032775,218007
12,ENSG00000248593.2,6884898,12-6796251-T-C,rs1075835,1,T,C,6796251,88647,6688290,7081506,107961
12,ENSG00000256849.1,19941521,12-20077705-A-T,rs10770612,1,A,T,20077705,136184,19744913,20138129,332792
12,ENSG00000256849.1,19941521,12-20077705-A-G,rs10770612,1,A,G,20077705,136184,19744913,20138129,332792
12,ENSG00000212125.2,10965352,12-10986084-C-A,rs10772397,-1,C,A,10986084,20732,10768744,11161960,217340
12,ENSG00000212125.2,10965352,12-10986084-C-T,rs10772397,-1,C,T,10986084,20732,10768744,11161960,217340
12,ENSG00000212125.2,10965352,12-10986084-C-G,rs10772397,-1,C,G,10986084,20732,10768744,11161960,217340
12,ENSG00000257663.1,52082084,12-52068035-G-A,rs10783487,-1,G,A,52068035,14049,51885476,52278692,182559
12,ENSG00000257663.1,52082084,12-52068035-G-T,rs10783487,-1,G,T,52068035,14049,51885476,52278692,182559
12,ENSG00000258449.1,25100980,12-25074481-C-T,rs10842459,-1,C,T,25074481,26499,24904372,25297588,170109
12,ENSG00000258449.1,25100980,12-25074481-C-G,rs10842459,-1,C,G,25074481,26499,24904372,25297588,170109
12,ENSG00000205791.2,12357067,12-12287104-T-C,rs10845508,-1,T,C,12287104,69963,12160459,12553675,126645
12,ENSG00000241129.2,124935860,12-124762160-G-T,rs10846733,-1,G,T,124762160,173700,124739252,125132468,22908
12,ENSG00000241129.2,124935860,12-124762160-G-A,rs10846733,-1,G,A,124762160,173700,124739252,125132468,22908
12,ENSG00000256152.1,122865335,12-122903375-T-G,rs10847980,1,T,G,122903375,38040,122668727,123061943,234648
12,ENSG00000242444.2,4110215,12-4056400-T-C,rs10848977,-1,T,C,4056400,53815,3913607,4306823,142793
12,ENSG00000242444.2,4110215,12-4056400-T-A,rs10848977,-1,T,A,4056400,53815,3913607,4306823,142793
12,ENSG00000242444.2,4110215,12-4056400-T-G,rs10848977,-1,T,G,4056400,53815,3913607,4306823,142793
12,ENSG00000255966.1,6533498,12-6471199-T-G,rs10849465,-1,T,G,6471199,62299,6336890,6730106,134309
12,ENSG00000255966.1,6533498,12-6471199-T-C,rs10849465,-1,T,C,6471199,62299,6336890,6730106,134309
12,ENSG00000256894.1,26126617,12-26272088-T-C,rs11048444,-1,T,C,26272088,145471,25930009,26323225,342079
12,ENSG00000256987.1,31953889,12-31878180-G-T,rs11051645,1,G,T,31878180,75709,31757281,32150497,120899
12,ENSG00000256987.1,31953889,12-31878180-G-C,rs11051645,1,G,C,31878180,75709,31757281,32150497,120899
12,ENSG00000241286.2,110842387,12-110885614-G-A,rs11065744,-1,G,A,110885614,43227,110645779,111038995,239835
12,ENSG00000257359.1,113932569,12-113874201-G-C,rs11066797,1,G,C,113874201,58368,113735961,114129177,138240
12,ENSG00000257359.1,113932569,12-113874201-G-A,rs11066797,1,G,A,113874201,58368,113735961,114129177,138240
12,ENSG00000258308.1,101962414,12-101844351-T-C,rs11111055,-1,T,C,101844351,118063,101765806,102159022,78545
12,ENSG00000257557.1,79934901,12-79918640-T-C,rs11114270,1,T,C,79918640,16261,79738293,80131509,180347
12,ENSG00000257542.2,52107278,12-52175128-T-C,rs11170032,1,T,C,52175128,67850,51910670,52303886,264458
12,ENSG00000256293.1,64338797,12-64346798-A-T,rs11175348,-1,A,T,64346798,8001,64142189,64535405,204609
12,ENSG00000256293.1,64338797,12-64346798-A-C,rs11175348,-1,A,C,64346798,8001,64142189,64535405,204609
12,ENSG00000256293.1,64338797,12-64346798-A-G,rs11175348,-1,A,G,64346798,8001,64142189,64535405,204609
12,ENSG00000255566.1,64443330,12-64544745-T-A,rs11175440,-1,T,A,64544745,101415,64246722,64639938,298023
12,ENSG00000255566.1,64443330,12-64544745-T-C,rs11175440,-1,T,C,64544745,101415,64246722,64639938,298023
12,ENSG00000255566.1,64443330,12-64544745-T-G,rs11175440,-1,T,G,64544745,101415,64246722,64639938,298023
12,ENSG00000247363.2,68686859,12-68770072-A-G,rs11177361,-1,A,G,68770072,83213,68490251,68883467,279821
12,ENSG00000257497.1,75489820,12-75486226-A-T,rs11180548,-1,A,T,75486226,3594,75293212,75686428,193014
12,ENSG00000257497.1,75489820,12-75486226-A-G,rs11180548,-1,A,G,75486226,3594,75293212,75686428,193014
12,ENSG00000257941.1,76057538,12-75962093-C-A,rs11180767,1,C,A,75962093,95445,75860930,76254146,101163
12,ENSG00000257173.1,38078999,12-38257573-G-A,rs11183018,-1,G,A,38257573,178574,37882391,38275607,375182
12,ENSG00000257173.1,38078999,12-38257573-G-T,rs11183018,-1,G,T,38257573,178574,37882391,38275607,375182
12,ENSG00000185684.8,132104021,12-132293618-C-T,rs112224861,1,C,T,132293618,189597,131907413,132300629,386205
12,ENSG00000256804.1,132126764,12-132293618-C-T,rs112224861,-1,C,T,132293618,166854,131930156,132323372,363462
12,ENSG00000244390.2,59020169,12-58849532-G-C,rs1148530,1,G,C,58849532,170637,58823561,59216777,25971
12,ENSG00000244390.2,59020169,12-58849532-G-A,rs1148530,1,G,A,58849532,170637,58823561,59216777,25971
12,ENSG00000247373.2,123585115,12-123504325-C-T,rs11522341,-1,C,T,123504325,80790,123388507,123781723,115818
12,ENSG00000250132.1,990041,12-918208-A-G,rs11571457,-1,A,G,918208,71833,793433,1186649,124775
12,ENSG00000257242.1,92142671,12-91954326-T-C,rs116757761,-1,T,C,91954326,188345,91946063,92339279,8263
12,ENSG00000257242.1,92142671,12-91954326-T-G,rs116757761,-1,T,G,91954326,188345,91946063,92339279,8263
12,ENSG00000239335.4,66130751,12-66119331-C-G,rs1168765,1,C,G,66119331,11420,65934143,66327359,185188
12,ENSG00000239335.4,66130751,12-66119331-C-T,rs1168765,1,C,T,66119331,11420,65934143,66327359,185188
12,ENSG00000214198.3,103915867,12-103904959-T-C,rs117580350,-1,T,C,103904959,10908,103719259,104112475,185700
12,ENSG00000257539.1,111381867,12-111473690-T-A,rs117666960,1,T,A,111473690,91823,111185259,111578475,288431
12,ENSG00000238105.3,100173159,12-100146387-C-A,rs11831483,-1,C,A,100146387,26772,99976551,100369767,169836
12,ENSG00000238105.3,100173159,12-100146387-C-T,rs11831483,-1,C,T,100146387,26772,99976551,100369767,169836
12,ENSG00000245904.2,92146202,12-91992437-G-A,rs11834727,1,G,A,91992437,153765,91949594,92342810,42843
12,ENSG00000258334.1,49324576,12-49302095-G-A,rs11837234,-1,G,A,49302095,22481,49127968,49521184,174127
12,ENSG00000256185.1,26336950,12-26440832-G-A,rs11837826,-1,G,A,26440832,103882,26140342,26533558,300490
12,ENSG00000260329.1,106955504,12-106951830-C-T,rs12099965,-1,C,T,106951830,3674,106758896,107152112,192934
12,ENSG00000258360.1,38207192,12-38369198-G-A,rs12229436,-1,G,A,38369198,162006,38010584,38403800,358614
12,ENSG00000234608.1,111842902,12-112039251-T-C,rs12231744,-1,T,C,112039251,196349,111646294,112039510,392957
12,ENSG00000234608.1,111842902,12-112039251-T-A,rs12231744,-1,T,A,112039251,196349,111646294,112039510,392957
12,ENSG00000258168.1,70468085,12-70510843-T-G,rs12296380,1,T,G,70510843,42758,70271477,70664693,239366
12,ENSG00000250899.2,3041437,12-3148051-C-T,rs12297167,1,C,T,3148051,106614,2844829,3238045,303222
12,ENSG00000213470.4,53633151,12-53698023-T-G,rs12303370,-1,T,G,53698023,64872,53436543,53829759,261480
12,ENSG00000213470.4,53633151,12-53698023-T-A,rs12303370,-1,T,A,53698023,64872,53436543,53829759,261480
12,ENSG00000213470.4,53633151,12-53698023-T-C,rs12303370,-1,T,C,53698023,64872,53436543,53829759,261480
12,ENSG00000205537.2,47882649,12-47858356-G-A,rs12308082,1,G,A,47858356,24293,47686041,48079257,172315
12,ENSG00000242137.1,120594548,12-120437972-T-C,rs12322142,-1,T,C,120437972,156576,120397940,120791156,40032
12,ENSG00000256576.1,132189728,12-132200219-T-G,rs12370221,-1,T,G,132200219,10491,131993120,132386336,207099
12,ENSG00000256576.1,132189728,12-132200219-T-A,rs12370221,-1,T,A,132200219,10491,131993120,132386336,207099
12,ENSG00000255968.1,26318953,12-26237386-T-A,rs12424263,1,T,A,26237386,81567,26122345,26515561,115041
12,ENSG00000255968.1,26318953,12-26237386-T-C,rs12424263,1,T,C,26237386,81567,26122345,26515561,115041
12,ENSG00000257127.1,92421531,12-92425923-A-G,rs12578105,1,A,G,92425923,4392,92224923,92618139,201000
12,ENSG00000229186.2,111899263,12-111893513-G-A,rs12580246,1,G,A,111893513,5750,111702655,112095871,190858
12,ENSG00000257851.1,51713606,12-51630953-C-A,rs12581731,-1,C,A,51630953,82653,51516998,51910214,113955
12,ENSG00000257322.1,93215679,12-93394563-A-T,rs12811952,-1,A,T,93394563,178884,93019071,93412287,375492
12,ENSG00000257261.1,46383652,12-46474128-G-C,rs12824716,1,G,C,46474128,90476,46187044,46580260,287084
12,ENSG00000257261.1,46383652,12-46474128-G-A,rs12824716,1,G,A,46474128,90476,46187044,46580260,287084
12,ENSG00000257261.1,46383652,12-46474128-G-T,rs12824716,1,G,T,46474128,90476,46187044,46580260,287084
12,ENSG00000237176.3,59812102,12-59761690-A-G,rs12826693,1,A,G,59761690,50412,59615494,60008710,146196
12,ENSG00000257453.1,76030494,12-76182795-T-C,rs12833448,1,T,C,76182795,152301,75833886,76227102,348909
12,ENSG00000183935.2,13001499,12-13004333-C-G,rs1291359,1,C,G,13004333,2834,12804891,13198107,199442
12,ENSG00000183935.2,13001499,12-13004333-C-A,rs1291359,1,C,A,13004333,2834,12804891,13198107,199442
12,ENSG00000257839.1,76032658,12-76034754-A-T,rs1368579,1,A,T,76034754,2096,75836050,76229266,198704
12,ENSG00000257839.1,76032658,12-76034754-A-C,rs1368579,1,A,C,76034754,2096,75836050,76229266,198704
12,ENSG00000257839.1,76032658,12-76034754-A-G,rs1368579,1,A,G,76034754,2096,75836050,76229266,198704
12,ENSG00000258179.1,87820918,12-87844556-C-T,rs1381138,-1,C,T,87844556,23638,87624310,88017526,220246
12,ENSG00000258304.1,76115711,12-76288504-A-G,rs1546761,1,A,G,76288504,172793,75919103,76312319,369401
12,ENSG00000256250.1,130810606,12-130795872-T-C,rs1554807,1,T,C,130795872,14734,130613998,131007214,181874
12,ENSG00000256250.1,130810606,12-130795872-T-A,rs1554807,1,T,A,130795872,14734,130613998,131007214,181874
12,ENSG00000256039.1,10553364,12-10536667-G-A,rs1607789,1,G,A,10536667,16697,10356756,10749972,179911
12,ENSG00000261799.1,277123,12-305733-C-T,rs16929318,-1,C,T,305733,28610,80515,473731,225218
12,ENSG00000243015.1,93509487,12-93579094-A-G,rs17021323,1,A,G,93579094,69607,93312879,93706095,266215
12,ENSG00000212443.1,98599635,12-98769318-T-G,rs17028671,1,T,G,98769318,169683,98403027,98796243,366291
12,ENSG00000144785.4,56315943,12-56273820-T-G,rs17118439,-1,T,G,56273820,42123,56119335,56512551,154485
12,ENSG00000144785.4,56315943,12-56273820-T-C,rs17118439,-1,T,C,56273820,42123,56119335,56512551,154485
12,ENSG00000247774.2,47216487,12-47280173-A-C,rs17121783,-1,A,C,47280173,63686,47019879,47413095,260294
12,ENSG00000247774.2,47216487,12-47280173-A-G,rs17121783,-1,A,G,47280173,63686,47019879,47413095,260294
12,ENSG00000256037.1,67351436,12-67165908-G-A,rs17183846,1,G,A,67165908,185528,67154828,67548044,11080
12,ENSG00000257480.1,89752913,12-89876000-C-T,rs17192317,1,C,T,89876000,123087,89556305,89949521,319695
12,ENSG00000248008.2,120495932,12-120474407-G-A,rs17431717,-1,G,A,120474407,21525,120299324,120692540,175083
12,ENSG00000139239.6,62965325,12-62877095-C-T,rs17822974,1,C,T,62877095,88230,62768717,63161933,108378
12,ENSG00000139239.6,62965325,12-62877095-C-G,rs17822974,1,C,G,62877095,88230,62768717,63161933,108378
12,ENSG00000256249.1,122687125,12-122716221-T-A,rs1798192,1,T,A,122716221,29096,122490517,122883733,225704
12,ENSG00000256249.1,122687125,12-122716221-T-C,rs1798192,1,T,C,122716221,29096,122490517,122883733,225704
12,ENSG00000256249.1,122687125,12-122716221-T-G,rs1798192,1,T,G,122716221,29096,122490517,122883733,225704
12,ENSG00000257718.1,38906451,12-38915912-T-C,rs1878224,1,T,C,38915912,9461,38709843,39103059,206069
12,ENSG00000255474.1,4720102,12-4711733-T-C,rs2058209,-1,T,C,4711733,8369,4523494,4916710,188239
12,ENSG00000255474.1,4720102,12-4711733-T-A,rs2058209,-1,T,A,4711733,8369,4523494,4916710,188239
12,ENSG00000213942.3,6410013,12-6522722-G-C,rs2072373,-1,G,C,6522722,112709,6213405,6606621,309317
12,ENSG00000213942.3,6410013,12-6522722-G-A,rs2072373,-1,G,A,6522722,112709,6213405,6606621,309317
12,ENSG00000177406.4,642674,12-607972-G-C,rs2075032,1,G,C,607972,34702,446066,839282,161906
12,ENSG00000177406.4,642674,12-607972-G-A,rs2075032,1,G,A,607972,34702,446066,839282,161906
12,ENSG00000257221.1,108628668,12-108646018-A-T,rs2111212,1,A,T,108646018,17350,108432060,108825276,213958
12,ENSG00000257221.1,108628668,12-108646018-A-C,rs2111212,1,A,C,108646018,17350,108432060,108825276,213958
12,ENSG00000236946.2,68035767,12-68017126-T-C,rs2159064,1,T,C,68017126,18641,67839159,68232375,177967
12,ENSG00000236946.2,68035767,12-68017126-T-G,rs2159064,1,T,G,68017126,18641,67839159,68232375,177967
12,ENSG00000260470.1,54147225,12-54182016-C-A,rs2233921,-1,C,A,54182016,34791,53950617,54343833,231399
12,ENSG00000248265.1,54058254,12-54182016-C-A,rs2233921,1,C,A,54182016,123762,53861646,54254862,320370
12,ENSG00000245648.1,10363769,12-10379727-T-C,rs2255336,1,T,C,10379727,15958,10167161,10560377,212566
12,ENSG00000245648.1,10363769,12-10379727-T-A,rs2255336,1,T,A,10379727,15958,10167161,10560377,212566
12,ENSG00000257176.1,29317848,12-29381276-C-G,rs2278093,-1,C,G,29381276,63428,29121240,29514456,260036
12,ENSG00000257176.1,29317848,12-29381276-C-A,rs2278093,-1,C,A,29381276,63428,29121240,29514456,260036
12,ENSG00000257150.1,95672305,12-95567201-G-A,rs2367360,1,G,A,95567201,105104,95475697,95868913,91504
12,ENSG00000257150.1,95672305,12-95567201-G-T,rs2367360,1,G,T,95567201,105104,95475697,95868913,91504
12,ENSG00000257342.1,57721510,12-57723572-T-C,rs238516,-1,T,C,57723572,2062,57524902,57918118,198670
12,ENSG00000257342.1,57721510,12-57723572-T-G,rs238516,-1,T,G,57723572,2062,57524902,57918118,198670
12,ENSG00000257342.1,57721510,12-57723572-T-A,rs238516,-1,T,A,57723572,2062,57524902,57918118,198670
12,ENSG00000235872.2,67670919,12-67584828-G-T,rs2620779,-1,G,T,67584828,86091,67474311,67867527,110517
12,ENSG00000235872.2,67670919,12-67584828-G-C,rs2620779,-1,G,C,67584828,86091,67474311,67867527,110517
12,ENSG00000235872.2,67670919,12-67584828-G-A,rs2620779,-1,G,A,67584828,86091,67474311,67867527,110517
12,ENSG00000241556.1,95467861,12-95379262-G-A,rs2634001,-1,G,A,95379262,88599,95271253,95664469,108009
12,ENSG00000260943.1,40142876,12-40165260-T-C,rs2708481,-1,T,C,40165260,22384,39946268,40339484,218992
12,ENSG00000260943.1,40142876,12-40165260-T-G,rs2708481,-1,T,G,40165260,22384,39946268,40339484,218992
12,ENSG00000260943.1,40142876,12-40165260-T-A,rs2708481,-1,T,A,40165260,22384,39946268,40339484,218992
12,ENSG00000223914.1,40156113,12-40232887-A-T,rs2723267,1,A,T,40232887,76774,39959505,40352721,273382
12,ENSG00000223914.1,40156113,12-40232887-A-C,rs2723267,1,A,C,40232887,76774,39959505,40352721,273382
12,ENSG00000223914.1,40156113,12-40232887-A-G,rs2723267,1,A,G,40232887,76774,39959505,40352721,273382
12,ENSG00000256569.1,120723639,12-120725051-T-A,rs2948149,-1,T,A,120725051,1412,120527031,120920247,198020
12,ENSG00000256569.1,120723639,12-120725051-T-G,rs2948149,-1,T,G,120725051,1412,120527031,120920247,198020
12,ENSG00000255933.1,131758047,12-131628929-C-T,rs34265926,-1,C,T,131628929,129118,131561439,131954655,67490
12,ENSG00000216306.3,94834147,12-94844483-G-A,rs34697807,1,G,A,94844483,10336,94637539,95030755,206944
12,ENSG00000256364.1,120699501,12-120700474-G-T,rs3751166,-1,G,T,120700474,973,120502893,120896109,197581
12,ENSG00000257681.1,103766906,12-103777677-C-T,rs3751204,-1,C,T,103777677,10771,103570298,103963514,207379
12,ENSG00000257681.1,103766906,12-103777677-C-A,rs3751204,-1,C,A,103777677,10771,103570298,103963514,207379
12,ENSG00000258365.1,94282844,12-94294912-A-C,rs3803070,-1,A,C,94294912,12068,94086236,94479452,208676
12,ENSG00000258092.1,2803938,12-2827110-A-G,rs3814249,-1,A,G,2827110,23172,2607330,3000546,219780
12,ENSG00000256538.1,34037232,12-33966057-A-G,rs421018,1,A,G,33966057,71175,33840624,34233840,125433
12,ENSG00000256667.1,10598209,12-10559023-C-T,rs4237928,-1,C,T,10559023,39186,10401601,10794817,157422
12,ENSG00000257907.1,43659827,12-43780963-C-T,rs4251580,1,C,T,43780963,121136,43463219,43856435,317744
12,ENSG00000257222.1,102063355,12-102005576-T-C,rs4272832,1,T,C,102005576,57779,101866747,102259963,138829
12,ENSG00000256128.1,126772411,12-126771307-A-C,rs4277173,-1,A,C,126771307,1104,126575803,126969019,195504
12,ENSG00000256128.1,126772411,12-126771307-A-G,rs4277173,-1,A,G,126771307,1104,126575803,126969019,195504
12,ENSG00000256128.1,126772411,12-126771307-A-T,rs4277173,-1,A,T,126771307,1104,126575803,126969019,195504
12,ENSG00000258072.1,107903948,12-107930170-A-C,rs4402352,-1,A,C,107930170,26222,107707340,108100556,222830
12,ENSG00000258072.1,107903948,12-107930170-A-G,rs4402352,-1,A,G,107930170,26222,107707340,108100556,222830
12,ENSG00000258072.1,107903948,12-107930170-A-T,rs4402352,-1,A,T,107930170,26222,107707340,108100556,222830
12,ENSG00000258244.1,114588194,12-114734845-A-G,rs4614503,1,A,G,114734845,146651,114391586,114784802,343259
12,ENSG00000261324.1,14767931,12-14663846-G-A,rs4764112,-1,G,A,14663846,104085,14571323,14964539,92523
12,ENSG00000256512.1,27800708,12-27666629-G-A,rs4931235,-1,G,A,27666629,134079,27604100,27997316,62529
12,ENSG00000256512.1,27800708,12-27666629-G-T,rs4931235,-1,G,T,27666629,134079,27604100,27997316,62529
12,ENSG00000257642.1,105327017,12-105282031-T-C,rs4964353,-1,T,C,105282031,44986,105130409,105523625,151622
12,ENSG00000245311.2,27446625,12-27494449-C-T,rs56656482,-1,C,T,27494449,47824,27250017,27643233,244432
12,ENSG00000234925.2,68642993,12-68772675-G-A,rs58381281,-1,G,A,68772675,129682,68446385,68839601,326290
12,ENSG00000205056.6,92466451,12-92465694-T-C,rs59692795,1,T,C,92465694,757,92269843,92663059,195851
12,ENSG00000205057.3,92428148,12-92432684-C-A,rs61935213,-1,C,A,92432684,4536,92231540,92624756,201144
12,ENSG00000241680.1,110460988,12-110500838-G-T,rs61942601,1,G,T,110500838,39850,110264380,110657596,236458
12,ENSG00000245614.2,31073786,12-31072540-A-T,rs6487970,-1,A,T,31072540,1246,30877178,31270394,195362
12,ENSG00000245614.2,31073786,12-31072540-A-C,rs6487970,-1,A,C,31072540,1246,30877178,31270394,195362
12,ENSG00000245614.2,31073786,12-31072540-A-G,rs6487970,-1,A,G,31072540,1246,30877178,31270394,195362
12,ENSG00000226469.1,111927018,12-111890426-C-A,rs6489819,1,C,A,111890426,36592,111730410,112123626,160016
12,ENSG00000226469.1,111927018,12-111890426-C-G,rs6489819,1,C,G,111890426,36592,111730410,112123626,160016
12,ENSG00000260030.1,53754358,12-53754445-G-A,rs67551371,1,G,A,53754445,87,53557750,53950966,196695
12,ENSG00000257878.1,95996460,12-96010116-C-G,rs7296106,1,C,G,96010116,13656,95799852,96193068,210264
12,ENSG00000257878.1,95996460,12-96010116-C-T,rs7296106,1,C,T,96010116,13656,95799852,96193068,210264
12,ENSG00000256393.1,93083675,12-93274943-T-C,rs7296404,-1,T,C,93274943,191268,92887067,93280283,387876
12,ENSG00000258435.1,121391962,12-121409332-A-T,rs7296507,1,A,T,121409332,17370,121195354,121588570,213978
12,ENSG00000258435.1,121391962,12-121409332-A-G,rs7296507,1,A,G,121409332,17370,121195354,121588570,213978
12,ENSG00000250654.2,54080288,12-53932012-G-T,rs7301643,-1,G,T,53932012,148276,53883680,54276896,48332
12,ENSG00000250654.2,54080288,12-53932012-G-C,rs7301643,-1,G,C,53932012,148276,53883680,54276896,48332
12,ENSG00000250654.2,54080288,12-53932012-G-A,rs7301643,-1,G,A,53932012,148276,53883680,54276896,48332
12,ENSG00000257139.1,70180338,12-70327396-A-T,rs7301755,1,A,T,70327396,147058,69983730,70376946,343666
12,ENSG00000257139.1,70180338,12-70327396-A-G,rs7301755,1,A,G,70327396,147058,69983730,70376946,343666
12,ENSG00000225422.2,66235234,12-66089018-G-A,rs73123449,-1,G,A,66089018,146216,66038626,66431842,50392
12,ENSG00000256274.1,11078242,12-11160349-A-G,rs7486717,-1,A,G,11160349,82107,10881634,11274850,278715
12,ENSG00000256274.1,11078242,12-11160349-A-C,rs7486717,-1,A,C,11160349,82107,10881634,11274850,278715
12,ENSG00000255882.1,9867027,12-9867697-T-A,rs75257612,1,T,A,9867697,670,9670419,10063635,197278
12,ENSG00000255882.1,9867027,12-9867697-T-C,rs75257612,1,T,C,9867697,670,9670419,10063635,197278
12,ENSG00000257303.1,56300094,12-56233835-A-G,rs75274818,1,A,G,56233835,66259,56103486,56496702,130349
12,ENSG00000258204.1,98794485,12-98873788-T-C,rs759764,1,T,C,98873788,79303,98597877,98991093,275911
12,ENSG00000258204.1,98794485,12-98873788-T-A,rs759764,1,T,A,98873788,79303,98597877,98991093,275911
12,ENSG00000240399.1,48055253,12-48038153-C-A,rs765260,-1,C,A,48038153,17100,47858645,48251861,179508
12,ENSG00000240399.1,48055253,12-48038153-C-T,rs765260,-1,C,T,48038153,17100,47858645,48251861,179508
12,ENSG00000240399.1,48055253,12-48038153-C-G,rs765260,-1,C,G,48038153,17100,47858645,48251861,179508
12,ENSG00000213235.3,16990670,12-16893920-A-C,rs76768530,1,A,C,16893920,96750,16794062,17187278,99858
12,ENSG00000213235.3,16990670,12-16893920-A-G,rs76768530,1,A,G,16893920,96750,16794062,17187278,99858
12,ENSG00000213235.3,16990670,12-16893920-A-T,rs76768530,1,A,T,16893920,96750,16794062,17187278,99858
12,ENSG00000256211.1,16989126,12-16893920-A-C,rs76768530,1,A,C,16893920,95206,16792518,17185734,101402
12,ENSG00000256211.1,16989126,12-16893920-A-G,rs76768530,1,A,G,16893920,95206,16792518,17185734,101402
12,ENSG00000256211.1,16989126,12-16893920-A-T,rs76768530,1,A,T,16893920,95206,16792518,17185734,101402
12,ENSG00000257815.1,70243366,12-70198588-G-A,rs76787156,-1,G,A,70198588,44778,70046758,70439974,151830
12,ENSG00000256377.1,27710803,12-27699051-C-T,rs76851022,-1,C,T,27699051,11752,27514195,27907411,184856
12,ENSG00000256377.1,27710803,12-27699051-C-G,rs76851022,-1,C,G,27699051,11752,27514195,27907411,184856
12,ENSG00000256234.1,26335856,12-26193901-C-T,rs77263326,-1,C,T,26193901,141955,26139248,26532464,54653
12,ENSG00000258111.1,104514029,12-104553121-T-C,rs77849421,1,T,C,104553121,39092,104317421,104710637,235700
12,ENSG00000247157.2,11556966,12-11745611-C-T,rs78245407,1,C,T,11745611,188645,11360358,11753574,385253
12,ENSG00000247157.2,11556966,12-11745611-C-G,rs78245407,1,C,G,11745611,188645,11360358,11753574,385253
12,ENSG00000255733.1,67989529,12-68012672-C-T,rs7952790,1,C,T,68012672,23143,67792921,68186137,219751
12,ENSG00000255921.1,24949163,12-24960312-T-A,rs7954135,1,T,A,24960312,11149,24752555,25145771,207757
12,ENSG00000255921.1,24949163,12-24960312-T-C,rs7954135,1,T,C,24960312,11149,24752555,25145771,207757
12,ENSG00000256072.1,66257434,12-66090549-G-A,rs7966543,-1,G,A,66090549,166885,66060826,66454042,29723
12,ENSG00000256072.1,66257434,12-66090549-G-C,rs7966543,-1,G,C,66090549,166885,66060826,66454042,29723
12,ENSG00000256072.1,66257434,12-66090549-G-T,rs7966543,-1,G,T,66090549,166885,66060826,66454042,29723
12,ENSG00000258245.1,75689096,12-75677113-C-T,rs7967547,-1,C,T,75677113,11983,75492488,75885704,184625
12,ENSG00000258033.1,101066734,12-101162948-A-G,rs7969185,1,A,G,101162948,96214,100870126,101263342,292822
12,ENSG00000256742.1,121580792,12-121483887-C-T,rs7977709,1,C,T,121483887,96905,121384184,121777400,99703
12,ENSG00000256742.1,121580792,12-121483887-C-G,rs7977709,1,C,G,121483887,96905,121384184,121777400,99703
12,ENSG00000257302.1,70671918,12-70796456-T-C,rs79855232,1,T,C,70796456,124538,70475310,70868526,321146
12,ENSG00000247903.1,26971586,12-26965680-C-A,rs900743,1,C,A,26965680,5906,26774978,27168194,190702
12,ENSG00000247903.1,26971586,12-26965680-C-T,rs900743,1,C,T,26965680,5906,26774978,27168194,190702
12,ENSG00000247903.1,26971586,12-26965680-C-G,rs900743,1,C,G,26965680,5906,26774978,27168194,190702
12,ENSG00000257337.1,53047071,12-53103618-A-G,rs9658625,-1,A,G,53103618,56547,52850463,53243679,253155
12,ENSG00000240759.1,42679124,12-42679110-C-T,rs9669733,-1,C,T,42679110,14,42482516,42875732,196594
12,ENSG00000256988.1,4830747,12-4828409-G-T,rs972884,-1,G,T,4828409,2338,4634139,5027355,194270
12,ENSG00000258017.1,49130909,12-49188909-T-C,rs1039225,1,T,C,49188909,58000,48934301,49327517,254608
12,ENSG00000258017.1,49130909,12-49188909-T-G,rs1039225,1,T,G,49188909,58000,48934301,49327517,254608
12,ENSG00000259884.1,52059332,12-52183701-C-A,rs10444538,-1,C,A,52183701,124369,51862724,52255940,320977
12,ENSG00000259884.1,52059332,12-52183701-C-T,rs10444538,-1,C,T,52183701,124369,51862724,52255940,320977
12,ENSG00000248593.2,6884898,12-6839528-A-T,rs1047776,1,A,T,6839528,45370,6688290,7081506,151238
12,ENSG00000248593.2,6884898,12-6839528-A-G,rs1047776,1,A,G,6839528,45370,6688290,7081506,151238
12,ENSG00000257221.1,108628668,12-108679562-C-T,rs10507231,1,C,T,108679562,50894,108432060,108825276,247502
12,ENSG00000257221.1,108628668,12-108679562-C-A,rs10507231,1,C,A,108679562,50894,108432060,108825276,247502
12,ENSG00000247498.2,12927734,12-12913286-T-C,rs1061047,1,T,C,12913286,14448,12731126,13124342,182160
12,ENSG00000247498.2,12927734,12-12913286-T-A,rs1061047,1,T,A,12913286,14448,12731126,13124342,182160
12,ENSG00000247498.2,12927734,12-12913286-T-G,rs1061047,1,T,G,12913286,14448,12731126,13124342,182160
12,ENSG00000255733.1,67989529,12-68024469-G-A,rs10748093,1,G,A,68024469,34940,67792921,68186137,231548
12,ENSG00000214198.3,103915867,12-103893299-G-A,rs10778301,-1,G,A,103893299,22568,103719259,104112475,174040
12,ENSG00000245648.1,10363769,12-10340383-G-C,rs10845109,1,G,C,10340383,23386,10167161,10560377,173222
12,ENSG00000245648.1,10363769,12-10340383-G-A,rs10845109,1,G,A,10340383,23386,10167161,10560377,173222
12,ENSG00000256667.1,10598209,12-10567965-A-G,rs10845165,-1,A,G,10567965,30244,10401601,10794817,166364
12,ENSG00000256092.1,123363868,12-123348199-G-T,rs10846523,1,G,T,123348199,15669,123167260,123560476,180939
12,ENSG00000256092.1,123363868,12-123348199-G-A,rs10846523,1,G,A,123348199,15669,123167260,123560476,180939
12,ENSG00000256364.1,120699501,12-120644425-C-T,rs10849774,-1,C,T,120644425,55076,120502893,120896109,141532
12,ENSG00000257327.1,103841451,12-103859161-C-T,rs10861124,1,C,T,103859161,17710,103644843,104038059,214318
12,ENSG00000257564.1,78794114,12-78935385-A-G,rs10861175,-1,A,G,78935385,141271,78597506,78990722,337879
12,ENSG00000258168.1,70468085,12-70554465-G-A,rs10879161,1,G,A,70554465,86380,70271477,70664693,282988
12,ENSG00000245205.3,19457648,12-19455504-C-G,rs11044572,-1,C,G,19455504,2144,19261040,19654256,194464
12,ENSG00000257511.1,32727387,12-32560985-T-A,rs11052069,-1,T,A,32560985,166402,32530779,32923995,30206
12,ENSG00000257511.1,32727387,12-32560985-T-C,rs11052069,-1,T,C,32560985,166402,32530779,32923995,30206
12,ENSG00000118976.5,3839459,12-3725161-A-G,rs11062778,1,A,G,3725161,114298,3642851,4036067,82310
12,ENSG00000258179.1,87820918,12-88000139-T-C,rs11104711,-1,T,C,88000139,179221,87624310,88017526,375829
12,ENSG00000186076.4,93641586,12-93684768-G-A,rs11107149,-1,G,A,93684768,43182,93444978,93838194,239790
12,ENSG00000238105.3,100173159,12-100249032-A-G,rs11110316,-1,A,G,100249032,75873,99976551,100369767,272481
12,ENSG00000257433.1,47706085,12-47757011-C-T,rs11168227,1,C,T,47757011,50926,47509477,47902693,247534
12,ENSG00000257718.1,38906451,12-38839236-A-G,rs11169768,1,A,G,38839236,67215,38709843,39103059,129393
12,ENSG00000256072.1,66257434,12-66139549-A-G,rs11176056,-1,A,G,66139549,117885,66060826,66454042,78723
12,ENSG00000256021.1,21448314,12-21294002-T-C,rs11568574,-1,T,C,21294002,154312,21251706,21644922,42296
12,ENSG00000256021.1,21448314,12-21294002-T-A,rs11568574,-1,T,A,21294002,154312,21251706,21644922,42296
12,ENSG00000257453.1,76030494,12-76171719-G-A,rs11611315,1,G,A,76171719,141225,75833886,76227102,337833
12,ENSG00000234925.2,68642993,12-68808776-G-C,rs117039649,-1,G,C,68808776,165783,68446385,68839601,362391
12,ENSG00000216306.3,94834147,12-94855105-C-T,rs117041355,1,C,T,94855105,20958,94637539,95030755,217566
12,ENSG00000216306.3,94834147,12-94855105-C-G,rs117041355,1,C,G,94855105,20958,94637539,95030755,217566
12,ENSG00000258308.1,101962414,12-101945083-A-G,rs117651251,-1,A,G,101945083,17331,101765806,102159022,179277
12,ENSG00000256664.1,68841946,12-68944858-G-C,rs117743406,1,G,C,68944858,102912,68645338,69038554,299520
12,ENSG00000256664.1,68841946,12-68944858-G-A,rs117743406,1,G,A,68944858,102912,68645338,69038554,299520
12,ENSG00000257668.1,57984761,12-57789853-A-G,rs117839344,-1,A,G,57789853,194908,57788153,58181369,1700
12,ENSG00000212443.1,98599635,12-98707679-A-G,rs11831003,1,A,G,98707679,108044,98403027,98796243,304652
12,ENSG00000212443.1,98599635,12-98707679-A-T,rs11831003,1,A,T,98707679,108044,98403027,98796243,304652
12,ENSG00000250790.2,132911470,12-132925152-T-C,rs11833667,1,T,C,132925152,13682,132714862,133108078,210290
12,ENSG00000257653.1,48766194,12-48764707-G-A,rs12307769,1,G,A,48764707,1487,48569586,48962802,195121
12,ENSG00000213442.4,104265309,12-104451090-G-A,rs12311539,1,G,A,104451090,185781,104068701,104461917,382389
12,ENSG00000257222.1,102063355,12-102160355-A-G,rs12372134,1,A,G,102160355,97000,101866747,102259963,293608
12,ENSG00000258204.1,98794485,12-98837716-G-A,rs12423961,1,G,A,98837716,43231,98597877,98991093,239839
12,ENSG00000256075.1,68473741,12-68361459-G-A,rs12424945,1,G,A,68361459,112282,68277133,68670349,84326
12,ENSG00000256075.1,68473741,12-68361459-G-T,rs12424945,1,G,T,68361459,112282,68277133,68670349,84326
12,ENSG00000255760.1,31959316,12-32135930-C-T,rs1260868,-1,C,T,32135930,176614,31762708,32155924,373222
12,ENSG00000257497.1,75489820,12-75525870-T-G,rs1275474,-1,T,G,75525870,36050,75293212,75686428,232658
12,ENSG00000257497.1,75489820,12-75525870-T-A,rs1275474,-1,T,A,75525870,36050,75293212,75686428,232658
12,ENSG00000257611.1,106170004,12-106204692-T-A,rs1465546,1,T,A,106204692,34688,105973396,106366612,231296
12,ENSG00000257611.1,106170004,12-106204692-T-C,rs1465546,1,T,C,106204692,34688,105973396,106366612,231296
12,ENSG00000205057.3,92428148,12-92425363-A-C,rs1515563,-1,A,C,92425363,2785,92231540,92624756,193823
12,ENSG00000205057.3,92428148,12-92425363-A-T,rs1515563,-1,A,T,92425363,2785,92231540,92624756,193823
12,ENSG00000205057.3,92428148,12-92425363-A-G,rs1515563,-1,A,G,92425363,2785,92231540,92624756,193823
12,ENSG00000255750.1,26319720,12-26262724-C-A,rs1600516,-1,C,A,26262724,56996,26123112,26516328,139612
12,ENSG00000255750.1,26319720,12-26262724-C-T,rs1600516,-1,C,T,26262724,56996,26123112,26516328,139612
12,ENSG00000241846.1,25409445,12-25325291-T-G,rs16928693,-1,T,G,25325291,84154,25212837,25606053,112454
12,ENSG00000247903.1,26971586,12-26952477-T-G,rs16931510,1,T,G,26952477,19109,26774978,27168194,177499
12,ENSG00000247903.1,26971586,12-26952477-T-A,rs16931510,1,T,A,26952477,19109,26774978,27168194,177499
12,ENSG00000247903.1,26971586,12-26952477-T-C,rs16931510,1,T,C,26952477,19109,26774978,27168194,177499
12,ENSG00000230291.3,80103333,12-80254189-A-C,rs17006557,-1,A,C,80254189,150856,79906725,80299941,347464
12,ENSG00000230291.3,80103333,12-80254189-A-G,rs17006557,-1,A,G,80254189,150856,79906725,80299941,347464
12,ENSG00000258352.1,47135901,12-47109180-A-G,rs17097599,-1,A,G,47109180,26721,46939293,47332509,169887
12,ENSG00000255850.1,63822156,12-64008888-A-G,rs17099997,-1,A,G,64008888,186732,63625548,64018764,383340
12,ENSG00000255850.1,63822156,12-64008888-A-T,rs17099997,-1,A,T,64008888,186732,63625548,64018764,383340
12,ENSG00000260030.1,53754358,12-53761952-C-G,rs17102640,1,C,G,53761952,7594,53557750,53950966,204202
12,ENSG00000258303.1,93836167,12-93841701-A-G,rs17194635,1,A,G,93841701,5534,93639559,94032775,202142
12,ENSG00000256238.1,16402406,12-16219151-G-A,rs1799510,-1,G,A,16219151,183255,16205798,16599014,13353
12,ENSG00000256238.1,16402406,12-16219151-G-C,rs1799510,-1,G,C,16219151,183255,16205798,16599014,13353
12,ENSG00000258072.1,107903948,12-107939217-A-G,rs1895941,-1,A,G,107939217,35269,107707340,108100556,231877
12,ENSG00000258072.1,107903948,12-107939217-A-T,rs1895941,-1,A,T,107939217,35269,107707340,108100556,231877
12,ENSG00000258072.1,107903948,12-107939217-A-C,rs1895941,-1,A,C,107939217,35269,107707340,108100556,231877
12,ENSG00000257642.1,105327017,12-105299068-T-C,rs2163717,-1,T,C,105299068,27949,105130409,105523625,168659
12,ENSG00000257642.1,105327017,12-105299068-T-A,rs2163717,-1,T,A,105299068,27949,105130409,105523625,168659
12,ENSG00000205056.6,92466451,12-92466766-C-T,rs2277364,1,C,T,92466766,315,92269843,92663059,196923
12,ENSG00000213270.4,83151331,12-83133769-C-A,rs2292826,1,C,A,83133769,17562,82954723,83347939,179046
12,ENSG00000213270.4,83151331,12-83133769-C-T,rs2292826,1,C,T,83133769,17562,82954723,83347939,179046
12,ENSG00000257557.1,79934901,12-80043553-C-G,rs2400693,1,C,G,80043553,108652,79738293,80131509,305260
12,ENSG00000223914.1,40156113,12-40335205-C-T,rs2404834,1,C,T,40335205,179092,39959505,40352721,375700
12,ENSG00000234040.2,68627187,12-68537280-T-C,rs2439757,-1,T,C,68537280,89907,68430579,68823795,106701
12,ENSG00000239335.4,66130751,12-66122980-T-G,rs2576188,1,T,G,66122980,7771,65934143,66327359,188837
12,ENSG00000239335.4,66130751,12-66122980-T-C,rs2576188,1,T,C,66122980,7771,65934143,66327359,188837
12,ENSG00000239335.4,66130751,12-66122980-T-A,rs2576188,1,T,A,66122980,7771,65934143,66327359,188837
12,ENSG00000257663.1,52082084,12-52050993-A-T,rs2603761,-1,A,T,52050993,31091,51885476,52278692,165517
12,ENSG00000257663.1,52082084,12-52050993-A-C,rs2603761,-1,A,C,52050993,31091,51885476,52278692,165517
12,ENSG00000257663.1,52082084,12-52050993-A-G,rs2603761,-1,A,G,52050993,31091,51885476,52278692,165517
12,ENSG00000250742.1,54126191,12-54187830-T-C,rs3087404,1,T,C,54187830,61639,53929583,54322799,258247
12,ENSG00000258056.1,55729094,12-55721994-C-A,rs3138141,1,C,A,55721994,7100,55532486,55925702,189508
12,ENSG00000256356.1,4097451,12-4287540-C-T,rs3217847,1,C,T,4287540,190089,3900843,4294059,386697
12,ENSG00000258177.1,96223973,12-96161293-C-A,rs34600,-1,C,A,96161293,62680,96027365,96420581,133928
12,ENSG00000258177.1,96223973,12-96161293-C-T,rs34600,-1,C,T,96161293,62680,96027365,96420581,133928
12,ENSG00000245614.2,31073786,12-31078670-T-C,rs34895155,-1,T,C,31078670,4884,30877178,31270394,201492
12,ENSG00000258317.1,56129619,12-56220056-A-T,rs35382885,-1,A,T,56220056,90437,55933011,56326227,287045
12,ENSG00000258317.1,56129619,12-56220056-A-C,rs35382885,-1,A,C,56220056,90437,55933011,56326227,287045
12,ENSG00000257176.1,29317848,12-29349008-A-G,rs3764952,-1,A,G,29349008,31160,29121240,29514456,227768
12,ENSG00000257878.1,95996460,12-95972733-T-C,rs3812807,1,T,C,95972733,23727,95799852,96193068,172881
12,ENSG00000258365.1,94282844,12-94378486-A-T,rs3847818,-1,A,T,94378486,95642,94086236,94479452,292250
12,ENSG00000258365.1,94282844,12-94378486-A-G,rs3847818,-1,A,G,94378486,95642,94086236,94479452,292250
12,ENSG00000224713.1,57618065,12-57465985-A-G,rs41292005,-1,A,G,57465985,152080,57421457,57814673,44528
12,ENSG00000189238.4,126723416,12-126771307-A-C,rs4277173,1,A,C,126771307,47891,126526808,126920024,244499
12,ENSG00000189238.4,126723416,12-126771307-A-T,rs4277173,1,A,T,126771307,47891,126526808,126920024,244499
12,ENSG00000189238.4,126723416,12-126771307-A-G,rs4277173,1,A,G,126771307,47891,126526808,126920024,244499
12,ENSG00000260943.1,40142876,12-40127691-A-C,rs4533099,-1,A,C,40127691,15185,39946268,40339484,181423
12,ENSG00000248008.2,120495932,12-120424729-A-T,rs4766961,-1,A,T,120424729,71203,120299324,120692540,125405
12,ENSG00000248008.2,120495932,12-120424729-A-G,rs4766961,-1,A,G,120424729,71203,120299324,120692540,125405
12,ENSG00000248008.2,120495932,12-120424729-A-C,rs4766961,-1,A,C,120424729,71203,120299324,120692540,125405
12,ENSG00000258302.1,89561129,12-89715544-T-C,rs4842499,1,T,C,89715544,154415,89364521,89757737,351023
12,ENSG00000258302.1,89561129,12-89715544-T-G,rs4842499,1,T,G,89715544,154415,89364521,89757737,351023
12,ENSG00000256576.1,132189728,12-132179556-G-A,rs59348626,-1,G,A,132179556,10172,131993120,132386336,186436
12,ENSG00000205537.2,47882649,12-47872761-C-T,rs61919100,1,C,T,47872761,9888,47686041,48079257,186720
12,ENSG00000205537.2,47882649,12-47872761-C-G,rs61919100,1,C,G,47872761,9888,47686041,48079257,186720
12,ENSG00000257322.1,93215679,12-93121746-C-T,rs6538387,-1,C,T,93121746,93933,93019071,93412287,102675
12,ENSG00000248265.1,54058254,12-54167780-T-C,rs6580976,1,T,C,54167780,109526,53861646,54254862,306134
12,ENSG00000260470.1,54147225,12-54167780-T-C,rs6580976,-1,T,C,54167780,20555,53950617,54343833,217163
12,ENSG00000257261.1,46383652,12-46395760-C-T,rs6582636,1,C,T,46395760,12108,46187044,46580260,208716
12,ENSG00000257261.1,46383652,12-46395760-C-G,rs6582636,1,C,G,46395760,12108,46187044,46580260,208716
12,ENSG00000212125.2,10965352,12-10836466-C-A,rs666841,-1,C,A,10836466,128886,10768744,11161960,67722
12,ENSG00000212125.2,10965352,12-10836466-C-T,rs666841,-1,C,T,10836466,128886,10768744,11161960,67722
12,ENSG00000255725.1,25803298,12-25864322-G-T,rs706510,1,G,T,25864322,61024,25606690,25999906,257632
12,ENSG00000255725.1,25803298,12-25864322-G-C,rs706510,1,G,C,25864322,61024,25606690,25999906,257632
12,ENSG00000256249.1,122687125,12-122728193-A-G,rs7131791,1,A,G,122728193,41068,122490517,122883733,237676
12,ENSG00000226982.4,89500093,12-89308292-C-T,rs7294734,1,C,T,89308292,191801,89303485,89696701,4807
12,ENSG00000213942.3,6410013,12-6509888-T-G,rs7298053,-1,T,G,6509888,99875,6213405,6606621,296483
12,ENSG00000213942.3,6410013,12-6509888-T-A,rs7298053,-1,T,A,6509888,99875,6213405,6606621,296483
12,ENSG00000213942.3,6410013,12-6509888-T-C,rs7298053,-1,T,C,6509888,99875,6213405,6606621,296483
12,ENSG00000256682.1,10895882,12-10929812-A-G,rs73042395,-1,A,G,10929812,33930,10699274,11092490,230538
12,ENSG00000245311.2,27446625,12-27391412-C-T,rs7304939,-1,C,T,27391412,55213,27250017,27643233,141395
12,ENSG00000219410.2,6663260,12-6702267-C-T,rs73049715,1,C,T,6702267,39007,6466652,6859868,235615
12,ENSG00000256039.1,10553364,12-10552783-T-A,rs7305642,1,T,A,10552783,581,10356756,10749972,196027
12,ENSG00000256039.1,10553364,12-10552783-T-C,rs7305642,1,T,C,10552783,581,10356756,10749972,196027
12,ENSG00000225422.2,66235234,12-66242800-G-A,rs73127469,-1,G,A,66242800,7566,66038626,66431842,204174
12,ENSG00000258435.1,121391962,12-121432263-C-G,rs7316497,1,C,G,121432263,40301,121195354,121588570,236909
12,ENSG00000258435.1,121391962,12-121432263-C-T,rs7316497,1,C,T,121432263,40301,121195354,121588570,236909
12,ENSG00000243663.1,1758011,12-1569270-G-A,rs74750890,-1,G,A,1569270,188741,1561403,1954619,7867
12,ENSG00000241680.1,110460988,12-110403574-G-A,rs75347070,1,G,A,110403574,57414,110264380,110657596,139194
12,ENSG00000236946.2,68035767,12-67965406-C-T,rs75733598,1,C,T,67965406,70361,67839159,68232375,126247
12,ENSG00000242444.2,4110215,12-4056145-G-C,rs763417,-1,G,C,4056145,54070,3913607,4306823,142538
12,ENSG00000257354.1,62602752,12-62767128-G-C,rs774161,1,G,C,62767128,164376,62406144,62799360,360984
12,ENSG00000257354.1,62602752,12-62767128-G-T,rs774161,1,G,T,62767128,164376,62406144,62799360,360984
12,ENSG00000257354.1,62602752,12-62767128-G-A,rs774161,1,G,A,62767128,164376,62406144,62799360,360984
12,ENSG00000255566.1,64443330,12-64350587-G-C,rs77897211,-1,G,C,64350587,92743,64246722,64639938,103865
12,ENSG00000245904.2,92146202,12-92183773-T-C,rs790463,1,T,C,92183773,37571,91949594,92342810,234179
12,ENSG00000245904.2,92146202,12-92183773-T-A,rs790463,1,T,A,92183773,37571,91949594,92342810,234179
12,ENSG00000257127.1,92421531,12-92306591-G-A,rs79090092,1,G,A,92306591,114940,92224923,92618139,81668
12,ENSG00000257964.1,49577505,12-49741973-C-A,rs79376950,-1,C,A,49741973,164468,49380897,49774113,361076
12,ENSG00000257964.1,49577505,12-49741973-C-T,rs79376950,-1,C,T,49741973,164468,49380897,49774113,361076
12,ENSG00000256988.1,4830747,12-4659271-C-T,rs7958182,-1,C,T,4659271,171476,4634139,5027355,25132
12,ENSG00000232888.3,132825701,12-132760292-A-G,rs7959269,1,A,G,132760292,65409,132629093,133022309,131199
12,ENSG00000258357.1,94521869,12-94609505-T-C,rs7963788,-1,T,C,94609505,87636,94325261,94718477,284244
12,ENSG00000258357.1,94521869,12-94609505-T-A,rs7963788,-1,T,A,94609505,87636,94325261,94718477,284244
12,ENSG00000237766.2,67266966,12-67141831-G-A,rs7966396,-1,G,A,67141831,125135,67070358,67463574,71473
12,ENSG00000237766.2,67266966,12-67141831-G-C,rs7966396,-1,G,C,67141831,125135,67070358,67463574,71473
12,ENSG00000237766.2,67266966,12-67141831-G-T,rs7966396,-1,G,T,67141831,125135,67070358,67463574,71473
12,ENSG00000213970.3,4324811,12-4393244-T-G,rs7967051,-1,T,G,4393244,68433,4128203,4521419,265041
12,ENSG00000256262.1,109053986,12-109032690-C-G,rs7967169,-1,C,G,109032690,21296,108857378,109250594,175312
12,ENSG00000256262.1,109053986,12-109032690-C-T,rs7967169,-1,C,T,109032690,21296,108857378,109250594,175312
12,ENSG00000256262.1,109053986,12-109032690-C-A,rs7967169,-1,C,A,109032690,21296,108857378,109250594,175312
12,ENSG00000257802.1,71850428,12-71695260-A-G,rs7967428,-1,A,G,71695260,155168,71653820,72047036,41440
12,ENSG00000257698.1,57936345,12-57926317-G-A,rs7968265,-1,G,A,57926317,10028,57739737,58132953,186580
12,ENSG00000179899.7,55414787,12-55524002-G-A,rs7968967,-1,G,A,55524002,109215,55218179,55611395,305823
12,ENSG00000257681.1,103766906,12-103787853-C-G,rs7970553,-1,C,G,103787853,20947,103570298,103963514,217555
12,ENSG00000257681.1,103766906,12-103787853-C-T,rs7970553,-1,C,T,103787853,20947,103570298,103963514,217555
12,ENSG00000257681.1,103766906,12-103787853-C-A,rs7970553,-1,C,A,103787853,20947,103570298,103963514,217555
12,ENSG00000256393.1,93083675,12-93278948-T-G,rs7978088,-1,T,G,93278948,195273,92887067,93280283,391881
12,ENSG00000256393.1,93083675,12-93278948-T-A,rs7978088,-1,T,A,93278948,195273,92887067,93280283,391881
12,ENSG00000256420.1,66569194,12-66682621-C-T,rs79822461,-1,C,T,66682621,113427,66372586,66765802,310035
12,ENSG00000257342.1,57721510,12-57814814-C-T,rs79970417,-1,C,T,57814814,93304,57524902,57918118,289912
12,ENSG00000182796.8,55832159,12-55712874-G-A,rs80262739,1,G,A,55712874,119285,55635551,56028767,77323
12,ENSG00000245482.2,34046417,12-33958559-C-T,rs814661,-1,C,T,33958559,87858,33849809,34243025,108750
12,ENSG00000239617.1,48903813,12-48972055-G-A,rs833841,-1,G,A,48972055,68242,48707205,49100421,264850
12,ENSG00000239617.1,48903813,12-48972055-G-C,rs833841,-1,G,C,48972055,68242,48707205,49100421,264850
12,ENSG00000177406.4,642674,12-569044-A-G,rs887512,1,A,G,569044,73630,446066,839282,122978
12,ENSG00000177406.4,642674,12-569044-A-T,rs887512,1,A,T,569044,73630,446066,839282,122978
12,ENSG00000256377.1,27710803,12-27699497-T-C,rs929952,-1,T,C,27699497,11306,27514195,27907411,185302
12,ENSG00000255921.1,24949163,12-24979837-A-T,rs9300165,1,A,T,24979837,30674,24752555,25145771,227282
12,ENSG00000255921.1,24949163,12-24979837-A-G,rs9300165,1,A,G,24979837,30674,24752555,25145771,227282
12,ENSG00000257740.1,56308868,12-56320060-G-A,rs9645801,1,G,A,56320060,11192,56112260,56505476,207800
12,ENSG00000240399.1,48055253,12-48081070-A-G,rs10492081,-1,A,G,48081070,25817,47858645,48251861,222425
12,ENSG00000257497.1,75489820,12-75467307-G-A,rs10732759,-1,G,A,75467307,22513,75293212,75686428,174095
12,ENSG00000257497.1,75489820,12-75467307-G-C,rs10732759,-1,G,C,75467307,22513,75293212,75686428,174095
12,ENSG00000256021.1,21448314,12-21356817-A-G,rs10770800,-1,A,G,21356817,91497,21251706,21644922,105111
12,ENSG00000213443.2,9695384,12-9866454-A-T,rs10772219,1,A,T,9866454,171070,9498776,9891992,367678
12,ENSG00000213443.2,9695384,12-9866454-A-G,rs10772219,1,A,G,9866454,171070,9498776,9891992,367678
12,ENSG00000257225.1,42459366,12-42603742-G-C,rs10785354,1,G,C,42603742,144376,42262758,42655974,340984
12,ENSG00000257225.1,42459366,12-42603742-G-T,rs10785354,1,G,T,42603742,144376,42262758,42655974,340984
12,ENSG00000257225.1,42459366,12-42603742-G-A,rs10785354,1,G,A,42603742,144376,42262758,42655974,340984
12,ENSG00000256849.1,19941521,12-19972015-A-T,rs10841417,1,A,T,19972015,30494,19744913,20138129,227102
12,ENSG00000256849.1,19941521,12-19972015-A-G,rs10841417,1,A,G,19972015,30494,19744913,20138129,227102
12,ENSG00000204603.2,131165011,12-131220576-T-A,rs10848315,1,T,A,131220576,55565,130968403,131361619,252173
12,ENSG00000204603.2,131165011,12-131220576-T-C,rs10848315,1,T,C,131220576,55565,130968403,131361619,252173
12,ENSG00000257433.1,47706085,12-47515959-A-G,rs10875652,1,A,G,47515959,190126,47509477,47902693,6482
12,ENSG00000257616.1,52730425,12-52868087-C-T,rs10876377,1,C,T,52868087,137662,52533817,52927033,334270
12,ENSG00000256293.1,64338797,12-64250931-G-C,rs10878126,-1,G,C,64250931,87866,64142189,64535405,108742
12,ENSG00000256293.1,64338797,12-64250931-G-T,rs10878126,-1,G,T,64250931,87866,64142189,64535405,108742
12,ENSG00000227081.4,3211917,12-3019289-A-T,rs11062460,-1,A,T,3019289,192628,3015309,3408525,3980
12,ENSG00000241680.1,110460988,12-110554127-A-G,rs11065664,1,A,G,110554127,93139,110264380,110657596,289747
12,ENSG00000243015.1,93509487,12-93528241-G-A,rs11107070,1,G,A,93528241,18754,93312879,93706095,215362
12,ENSG00000257847.1,94590821,12-94495948-G-A,rs11107557,1,G,A,94495948,94873,94394213,94787429,101735
12,ENSG00000257222.1,102063355,12-102199966-A-G,rs11111203,1,A,G,102199966,136611,101866747,102259963,333219
12,ENSG00000223914.1,40156113,12-40330098-C-A,rs11176052,1,C,A,40330098,173985,39959505,40352721,370593
12,ENSG00000223914.1,40156113,12-40330098-C-T,rs11176052,1,C,T,40330098,173985,39959505,40352721,370593
12,ENSG00000239335.4,66130751,12-66186955-G-A,rs11176082,1,G,A,66186955,56204,65934143,66327359,252812
12,ENSG00000239335.4,66130751,12-66186955-G-T,rs11176082,1,G,T,66186955,56204,65934143,66327359,252812
12,ENSG00000258168.1,70468085,12-70646548-T-C,rs11178344,1,T,C,70646548,178463,70271477,70664693,375071
12,ENSG00000256576.1,132189728,12-132159685-T-C,rs11246959,-1,T,C,132159685,30043,131993120,132386336,166565
12,ENSG00000256576.1,132189728,12-132159685-T-G,rs11246959,-1,T,G,132159685,30043,131993120,132386336,166565
12,ENSG00000213270.4,83151331,12-83346829-G-C,rs115126527,1,G,C,83346829,195498,82954723,83347939,392106
12,ENSG00000247363.2,68686859,12-68873105-T-A,rs1152929,-1,T,A,68873105,186246,68490251,68883467,382854
12,ENSG00000247363.2,68686859,12-68873105-T-C,rs1152929,-1,T,C,68873105,186246,68490251,68883467,382854
12,ENSG00000257824.1,54544105,12-54637136-T-A,rs1153146,-1,T,A,54637136,93031,54347497,54740713,289639
12,ENSG00000257824.1,54544105,12-54637136-T-C,rs1153146,-1,T,C,54637136,93031,54347497,54740713,289639
12,ENSG00000257824.1,54544105,12-54637136-T-G,rs1153146,-1,T,G,54637136,93031,54347497,54740713,289639
12,ENSG00000234925.2,68642993,12-68760350-T-C,rs11609067,-1,T,C,68760350,117357,68446385,68839601,313965
12,ENSG00000234925.2,68642993,12-68760350-T-G,rs11609067,-1,T,G,68760350,117357,68446385,68839601,313965
12,ENSG00000256948.1,111850,12-239562-C-A,rs11613232,-1,C,A,239562,127712,-84758,308458,324320
12,ENSG00000256185.1,26336950,12-26357047-G-A,rs117217310,-1,G,A,26357047,20097,26140342,26533558,216705
12,ENSG00000257715.1,96025323,12-96027791-G-A,rs117464260,1,G,A,96027791,2468,95828715,96221931,199076
12,ENSG00000257645.1,38533050,12-38553829-C-T,rs118063258,-1,C,T,38553829,20779,38336442,38729658,217387
12,ENSG00000257405.1,42637111,12-42812117-T-C,rs11833302,-1,T,C,42812117,175006,42440503,42833719,371614
12,ENSG00000233381.2,31652058,12-31668082-T-C,rs11833865,-1,T,C,31668082,16024,31455450,31848666,212632
12,ENSG00000245311.2,27446625,12-27455826-G-A,rs11836460,-1,G,A,27455826,9201,27250017,27643233,205809
12,ENSG00000257354.1,62602752,12-62440596-G-A,rs12228446,1,G,A,62440596,162156,62406144,62799360,34452
12,ENSG00000248593.2,6884898,12-6757986-G-T,rs12229492,1,G,T,6757986,126912,6688290,7081506,69696
12,ENSG00000248593.2,6884898,12-6757986-G-A,rs12229492,1,G,A,6757986,126912,6688290,7081506,69696
12,ENSG00000257542.2,52107278,12-52156089-G-A,rs12303087,1,G,A,52156089,48811,51910670,52303886,245419
12,ENSG00000257872.1,76137425,12-76236369-G-A,rs12308795,1,G,A,76236369,98944,75940817,76334033,295552
12,ENSG00000257872.1,76137425,12-76236369-G-T,rs12308795,1,G,T,76236369,98944,75940817,76334033,295552
12,ENSG00000257539.1,111381867,12-111200613-A-G,rs12319398,1,A,G,111200613,181254,111185259,111578475,15354
12,ENSG00000255993.1,18692762,12-18804320-C-G,rs12371073,1,C,G,18804320,111558,18496154,18889370,308166
12,ENSG00000255993.1,18692762,12-18804320-C-T,rs12371073,1,C,T,18804320,111558,18496154,18889370,308166
12,ENSG00000255737.2,57726271,12-57741637-T-C,rs12371356,1,T,C,57741637,15366,57529663,57922879,211974
12,ENSG00000257815.1,70243366,12-70050428-T-A,rs1239913,-1,T,A,70050428,192938,70046758,70439974,3670
12,ENSG00000257194.1,90107739,12-90040192-T-C,rs12424979,1,T,C,90040192,67547,89911131,90304347,129061
12,ENSG00000256987.1,31953889,12-31923802-T-C,rs1259769,1,T,C,31923802,30087,31757281,32150497,166521
12,ENSG00000245904.2,92146202,12-92145814-T-C,rs12694,1,T,C,92145814,388,91949594,92342810,196220
12,ENSG00000245904.2,92146202,12-92145814-T-A,rs12694,1,T,A,92145814,388,91949594,92342810,196220
12,ENSG00000258090.1,76757191,12-76888304-C-T,rs12817642,1,C,T,76888304,131113,76560583,76953799,327721
12,ENSG00000258303.1,93836167,12-93832795-T-C,rs12825691,1,T,C,93832795,3372,93639559,94032775,193236
12,ENSG00000258303.1,93836167,12-93832795-T-G,rs12825691,1,T,G,93832795,3372,93639559,94032775,193236
12,ENSG00000257359.1,113932569,12-114023365-A-G,rs1458708,1,A,G,114023365,90796,113735961,114129177,287404
12,ENSG00000177406.4,642674,12-642142-T-G,rs1471132,1,T,G,642142,532,446066,839282,196076
12,ENSG00000256274.1,11078242,12-11201209-T-C,rs1650044,-1,T,C,11201209,122967,10881634,11274850,319575
12,ENSG00000256274.1,11078242,12-11201209-T-A,rs1650044,-1,T,A,11201209,122967,10881634,11274850,319575
12,ENSG00000256450.1,16513445,12-16545705-T-C,rs16912016,1,T,C,16545705,32260,16316837,16710053,228868
12,ENSG00000256377.1,27710803,12-27651779-A-G,rs16932269,-1,A,G,27651779,59024,27514195,27907411,137584
12,ENSG00000257954.1,49389516,12-49241295-C-A,rs17123627,1,C,A,49241295,148221,49192908,49586124,48387
12,ENSG00000257954.1,49389516,12-49241295-C-T,rs17123627,1,C,T,49241295,148221,49192908,49586124,48387
12,ENSG00000258311.1,55716036,12-55736019-C-T,rs1725357,1,C,T,55736019,19983,55519428,55912644,216591
12,ENSG00000258311.1,55716036,12-55736019-C-G,rs1725357,1,C,G,55736019,19983,55519428,55912644,216591
12,ENSG00000257199.1,76984669,12-77004654-A-G,rs17815571,-1,A,G,77004654,19985,76788061,77181277,216593
12,ENSG00000257199.1,76984669,12-77004654-A-C,rs17815571,-1,A,C,77004654,19985,76788061,77181277,216593
12,ENSG00000256152.1,122865335,12-122819398-C-A,rs1798569,1,C,A,122819398,45937,122668727,123061943,150671
12,ENSG00000224713.1,57618065,12-57625414-C-T,rs1871415,-1,C,T,57625414,7349,57421457,57814673,203957
12,ENSG00000224713.1,57618065,12-57625414-C-G,rs1871415,-1,C,G,57625414,7349,57421457,57814673,203957
12,ENSG00000257261.1,46383652,12-46385098-G-T,rs1948425,1,G,T,46385098,1446,46187044,46580260,198054
12,ENSG00000255733.1,67989529,12-68067917-G-A,rs2041862,1,G,A,68067917,78388,67792921,68186137,274996
12,ENSG00000258177.1,96223973,12-96213111-G-A,rs2075362,-1,G,A,96213111,10862,96027365,96420581,185746
12,ENSG00000257681.1,103766906,12-103859736-G-A,rs2251979,-1,G,A,103859736,92830,103570298,103963514,289438
12,ENSG00000219410.2,6663260,12-6562633-C-T,rs2267967,1,C,T,6562633,100627,6466652,6859868,95981
12,ENSG00000256262.1,109053986,12-109197271-T-C,rs2268392,-1,T,C,109197271,143285,108857378,109250594,339893
12,ENSG00000247853.2,6578622,12-6748960-G-A,rs2302371,1,G,A,6748960,170338,6382014,6775230,366946
12,ENSG00000245614.2,31073786,12-31238715-A-C,rs2374041,-1,A,C,31238715,164929,30877178,31270394,361537
12,ENSG00000215039.2,6451568,12-6476444-T-C,rs2532520,-1,T,C,6476444,24876,6254960,6648176,221484
12,ENSG00000257878.1,95996460,12-96006091-C-A,rs2540499,1,C,A,96006091,9631,95799852,96193068,206239
12,ENSG00000257878.1,95996460,12-96006091-C-T,rs2540499,1,C,T,96006091,9631,95799852,96193068,206239
12,ENSG00000205057.3,92428148,12-92342879-C-G,rs2583146,-1,C,G,92342879,85269,92231540,92624756,111339
12,ENSG00000205057.3,92428148,12-92342879-C-T,rs2583146,-1,C,T,92342879,85269,92231540,92624756,111339
12,ENSG00000257327.1,103841451,12-104000637-T-C,rs2629804,1,T,C,104000637,159186,103644843,104038059,355794
12,ENSG00000255760.1,31959316,12-32063258-G-A,rs2668310,-1,G,A,32063258,103942,31762708,32155924,300550
12,ENSG00000255760.1,31959316,12-32063258-G-C,rs2668310,-1,G,C,32063258,103942,31762708,32155924,300550
12,ENSG00000214198.3,103915867,12-103974671-A-T,rs2723875,-1,A,T,103974671,58804,103719259,104112475,255412
12,ENSG00000214198.3,103915867,12-103974671-A-C,rs2723875,-1,A,C,103974671,58804,103719259,104112475,255412
12,ENSG00000214198.3,103915867,12-103974671-A-G,rs2723875,-1,A,G,103974671,58804,103719259,104112475,255412
12,ENSG00000245648.1,10363769,12-10447769-G-A,rs2734442,1,G,A,10447769,84000,10167161,10560377,280608
12,ENSG00000257813.1,43572038,12-43543390-C-A,rs275628,-1,C,A,43543390,28648,43375430,43768646,167960
12,ENSG00000257813.1,43572038,12-43543390-C-G,rs275628,-1,C,G,43543390,28648,43375430,43768646,167960
12,ENSG00000257813.1,43572038,12-43543390-C-T,rs275628,-1,C,T,43543390,28648,43375430,43768646,167960
12,ENSG00000257663.1,52082084,12-51905475-G-T,rs3759178,-1,G,T,51905475,176609,51885476,52278692,19999
12,ENSG00000257176.1,29317848,12-29301176-G-T,rs3782510,-1,G,T,29301176,16672,29121240,29514456,179936
12,ENSG00000213137.3,120845647,12-120737096-T-C,rs3914,-1,T,C,120737096,108551,120649039,121042255,88057
12,ENSG00000258057.1,49828542,12-49899426-T-C,rs408045,1,T,C,49899426,70884,49631934,50025150,267492
12,ENSG00000258344.1,54276631,12-54342686-A-T,rs4326844,1,A,T,54342686,66055,54080023,54473239,262663
12,ENSG00000258344.1,54276631,12-54342686-A-C,rs4326844,1,A,C,54342686,66055,54080023,54473239,262663
12,ENSG00000258344.1,54276631,12-54342686-A-G,rs4326844,1,A,G,54342686,66055,54080023,54473239,262663
12,ENSG00000256512.1,27800708,12-27831257-G-T,rs4420311,-1,G,T,27831257,30549,27604100,27997316,227157
12,ENSG00000256512.1,27800708,12-27831257-G-C,rs4420311,-1,G,C,27831257,30549,27604100,27997316,227157
12,ENSG00000256512.1,27800708,12-27831257-G-A,rs4420311,-1,G,A,27831257,30549,27604100,27997316,227157
12,ENSG00000183935.2,13001499,12-13039061-C-T,rs4540916,1,C,T,13039061,37562,12804891,13198107,234170
12,ENSG00000183935.2,13001499,12-13039061-C-G,rs4540916,1,C,G,13039061,37562,12804891,13198107,234170
12,ENSG00000259884.1,52059332,12-52169382-A-C,rs4762058,-1,A,C,52169382,110050,51862724,52255940,306658
12,ENSG00000259884.1,52059332,12-52169382-A-T,rs4762058,-1,A,T,52169382,110050,51862724,52255940,306658
12,ENSG00000256988.1,4830747,12-4829151-G-A,rs4766293,-1,G,A,4829151,1596,4634139,5027355,195012
12,ENSG00000256037.1,67351436,12-67501604-A-G,rs4913332,1,A,G,67501604,150168,67154828,67548044,346776
12,ENSG00000258136.1,107736589,12-107641783-G-A,rs4964600,1,G,A,107641783,94806,107539981,107933197,101802
12,ENSG00000256249.1,122687125,12-122672004-T-A,rs598322,1,T,A,122672004,15121,122490517,122883733,181487
12,ENSG00000256249.1,122687125,12-122672004-T-C,rs598322,1,T,C,122672004,15121,122490517,122883733,181487
12,ENSG00000256249.1,122687125,12-122672004-T-G,rs598322,1,T,G,122672004,15121,122490517,122883733,181487
12,ENSG00000257896.1,43738829,12-43810714-A-G,rs61933178,1,A,G,43810714,71885,43542221,43935437,268493
12,ENSG00000257127.1,92421531,12-92291309-A-G,rs61936143,1,A,G,92291309,130222,92224923,92618139,66386
12,ENSG00000258304.1,76115711,12-76299930-C-T,rs6538448,1,C,T,76299930,184219,75919103,76312319,380827
12,ENSG00000258320.1,74170445,12-74171515-C-T,rs6582210,1,C,T,74171515,1070,73973837,74367053,197678
12,ENSG00000258320.1,74170445,12-74171515-C-G,rs6582210,1,C,G,74171515,1070,73973837,74367053,197678
12,ENSG00000255850.1,63822156,12-63823639-G-T,rs7294691,-1,G,T,63823639,1483,63625548,64018764,198091
12,ENSG00000256039.1,10553364,12-10638941-A-C,rs73040690,1,A,C,10638941,85577,10356756,10749972,282185
12,ENSG00000256103.1,6270425,12-6440585-T-C,rs7312492,-1,T,C,6440585,170160,6073817,6467033,366768
12,ENSG00000256103.1,6270425,12-6440585-T-A,rs7312492,-1,T,A,6440585,170160,6073817,6467033,366768
12,ENSG00000256103.1,6270425,12-6440585-T-G,rs7312492,-1,T,G,6440585,170160,6073817,6467033,366768
12,ENSG00000258334.1,49324576,12-49215103-C-A,rs74091020,-1,C,A,49215103,109473,49127968,49521184,87135
12,ENSG00000213343.4,66037235,12-65967462-C-T,rs74097847,1,C,T,65967462,69773,65840627,66233843,126835
12,ENSG00000257242.1,92142671,12-92285725-T-C,rs74371701,-1,T,C,92285725,143054,91946063,92339279,339662
12,ENSG00000257642.1,105327017,12-105212892-C-G,rs752471,-1,C,G,105212892,114125,105130409,105523625,82483
12,ENSG00000257642.1,105327017,12-105212892-C-T,rs752471,-1,C,T,105212892,114125,105130409,105523625,82483
12,ENSG00000256667.1,10598209,12-10508918-C-T,rs75462134,-1,C,T,10508918,89291,10401601,10794817,107317
12,ENSG00000258056.1,55729094,12-55626601-G-A,rs76961143,1,G,A,55626601,102493,55532486,55925702,94115
12,ENSG00000258056.1,55729094,12-55626601-G-T,rs76961143,1,G,T,55626601,102493,55532486,55925702,94115
12,ENSG00000248265.1,54058254,12-54152901-G-A,rs78995220,1,G,A,54152901,94647,53861646,54254862,291255
12,ENSG00000256663.1,20551590,12-20367361-G-T,rs79487310,1,G,T,20367361,184229,20354982,20748198,12379
12,ENSG00000258283.1,48995150,12-49080449-G-T,rs7959831,1,G,T,49080449,85299,48798542,49191758,281907
12,ENSG00000258283.1,48995150,12-49080449-G-A,rs7959831,1,G,A,49080449,85299,48798542,49191758,281907
12,ENSG00000225422.2,66235234,12-66090549-G-C,rs7966543,-1,G,C,66090549,144685,66038626,66431842,51923
12,ENSG00000225422.2,66235234,12-66090549-G-A,rs7966543,-1,G,A,66090549,144685,66038626,66431842,51923
12,ENSG00000225422.2,66235234,12-66090549-G-T,rs7966543,-1,G,T,66090549,144685,66038626,66431842,51923
12,ENSG00000247903.1,26971586,12-27129507-T-G,rs79694243,1,T,G,27129507,157921,26774978,27168194,354529
12,ENSG00000258072.1,107903948,12-107889696-A-C,rs7973759,-1,A,C,107889696,14252,107707340,108100556,182356
12,ENSG00000258072.1,107903948,12-107889696-A-G,rs7973759,-1,A,G,107889696,14252,107707340,108100556,182356
12,ENSG00000255966.1,6533498,12-6495989-A-G,rs7975360,-1,A,G,6495989,37509,6336890,6730106,159099
12,ENSG00000238105.3,100173159,12-100007668-C-A,rs7975540,-1,C,A,100007668,165491,99976551,100369767,31117
12,ENSG00000238105.3,100173159,12-100007668-C-T,rs7975540,-1,C,T,100007668,165491,99976551,100369767,31117
12,ENSG00000238105.3,100173159,12-100007668-C-G,rs7975540,-1,C,G,100007668,165491,99976551,100369767,31117
12,ENSG00000226397.3,25006403,12-25091449-A-G,rs7977670,-1,A,G,25091449,85046,24809795,25203011,281654
12,ENSG00000250742.1,54126191,12-54190546-C-T,rs79811812,1,C,T,54190546,64355,53929583,54322799,260963
12,ENSG00000260470.1,54147225,12-54190546-C-T,rs79811812,-1,C,T,54190546,43321,53950617,54343833,239929
12,ENSG00000257921.1,57773053,12-57762727-C-G,rs8176351,1,C,G,57762727,10326,57576445,57969661,186282
12,ENSG00000257921.1,57773053,12-57762727-C-T,rs8176351,1,C,T,57762727,10326,57576445,57969661,186282
12,ENSG00000250899.2,3041437,12-3178113-G-C,rs878962,1,G,C,3178113,136676,2844829,3238045,333284
12,ENSG00000250899.2,3041437,12-3178113-G-A,rs878962,1,G,A,3178113,136676,2844829,3238045,333284
12,ENSG00000250899.2,3041437,12-3178113-G-T,rs878962,1,G,T,3178113,136676,2844829,3238045,333284
12,ENSG00000255921.1,24949163,12-25011432-A-T,rs904090,1,A,T,25011432,62269,24752555,25145771,258877
12,ENSG00000255921.1,24949163,12-25011432-A-G,rs904090,1,A,G,25011432,62269,24752555,25145771,258877
12,ENSG00000255921.1,24949163,12-25011432-A-C,rs904090,1,A,C,25011432,62269,24752555,25145771,258877
12,ENSG00000139239.6,62965325,12-63089130-C-T,rs949824,1,C,T,63089130,123805,62768717,63161933,320413
12,ENSG00000257480.1,89752913,12-89607038-T-A,rs957525,1,T,A,89607038,145875,89556305,89949521,50733
12,ENSG00000257480.1,89752913,12-89607038-T-C,rs957525,1,T,C,89607038,145875,89556305,89949521,50733
11,ENSG00000196167.5,111305045,11-111350557-C-T,rs10502139,-1,C,T,111350557,45512,111108437,111501653,242120
11,ENSG00000196167.5,111305045,11-111350557-C-G,rs10502139,-1,C,G,111350557,45512,111108437,111501653,242120
11,ENSG00000213713.3,33076460,11-33043848-C-G,rs1064005,-1,C,G,33043848,32612,32879852,33273068,163996
11,ENSG00000213713.3,33076460,11-33043848-C-T,rs1064005,-1,C,T,33043848,32612,32879852,33273068,163996
11,ENSG00000255404.1,65797219,11-65791795-A-G,rs10791824,-1,A,G,65791795,5424,65600611,65993827,191184
11,ENSG00000255404.1,65797219,11-65791795-A-C,rs10791824,-1,A,C,65791795,5424,65600611,65993827,191184
11,ENSG00000255404.1,65797219,11-65791795-A-T,rs10791824,-1,A,T,65791795,5424,65600611,65993827,191184
11,ENSG00000184669.6,17052025,11-16930379-C-G,rs10832702,1,C,G,16930379,121646,16855417,17248633,74962
11,ENSG00000255467.1,108121684,11-107941626-C-T,rs10890780,-1,C,T,107941626,180058,107925076,108318292,16550
11,ENSG00000255467.1,108121684,11-107941626-C-A,rs10890780,-1,C,A,107941626,180058,107925076,108318292,16550
11,ENSG00000227097.4,82689559,11-82691517-T-G,rs10898022,1,T,G,82691517,1958,82492951,82886167,198566
11,ENSG00000247095.2,568449,11-570072-T-C,rs10902173,-1,T,C,570072,1623,371841,765057,198231
11,ENSG00000254911.1,93721513,11-93560561-T-A,rs11020416,1,T,A,93560561,160952,93524905,93918121,35656
11,ENSG00000254911.1,93721513,11-93560561-T-C,rs11020416,1,T,C,93560561,160952,93524905,93918121,35656
11,ENSG00000254911.1,93721513,11-93560561-T-G,rs11020416,1,T,G,93560561,160952,93524905,93918121,35656
11,ENSG00000255375.1,32132657,11-32224800-C-G,rs11031647,1,C,G,32224800,92143,31936049,32329265,288751
11,ENSG00000225101.3,4474813,11-4393849-T-C,rs11032080,1,T,C,4393849,80964,4278205,4671421,115644
11,ENSG00000254595.1,6489377,11-6597318-G-T,rs11040930,-1,G,T,6597318,107941,6292769,6685985,304549
11,ENSG00000254595.1,6489377,11-6597318-G-C,rs11040930,-1,G,C,6597318,107941,6292769,6685985,304549
11,ENSG00000254595.1,6489377,11-6597318-G-A,rs11040930,-1,G,A,6597318,107941,6292769,6685985,304549
11,ENSG00000254860.1,8965048,11-8987127-A-T,rs11042148,1,A,T,8987127,22079,8768440,9161656,218687
11,ENSG00000254860.1,8965048,11-8987127-A-G,rs11042148,1,A,G,8987127,22079,8768440,9161656,218687
11,ENSG00000246308.1,10809204,11-10856137-A-C,rs11042983,1,A,C,10856137,46933,10612596,11005812,243541
11,ENSG00000246308.1,10809204,11-10856137-A-G,rs11042983,1,A,G,10856137,46933,10612596,11005812,243541
11,ENSG00000255045.1,124746337,11-124878300-G-A,rs111277969,-1,G,A,124878300,131963,124549729,124942945,328571
11,ENSG00000250397.2,859795,11-1006874-G-T,rs111317734,-1,G,T,1006874,147079,663187,1056403,343687
11,ENSG00000256779.1,95037482,11-95068375-G-T,rs111408022,1,G,T,95068375,30893,94840874,95234090,227501
11,ENSG00000225215.1,107404589,11-107425373-C-A,rs11212225,-1,C,A,107425373,20784,107207981,107601197,217392
11,ENSG00000254799.1,59263802,11-59198465-C-T,rs11229871,-1,C,T,59198465,65337,59067194,59460410,131271
11,ENSG00000255959.1,60842965,11-60845884-C-A,rs11230503,-1,C,A,60845884,2919,60646357,61039573,199527
11,ENSG00000255959.1,60842965,11-60845884-C-T,rs11230503,-1,C,T,60845884,2919,60646357,61039573,199527
11,ENSG00000158483.11,71787537,11-71787856-G-A,rs11234944,1,G,A,71787856,319,71590929,71984145,196927
11,ENSG00000246174.2,78139774,11-78062880-C-A,rs11237374,1,C,A,78062880,76894,77943166,78336382,119714
11,ENSG00000246174.2,78139774,11-78062880-C-T,rs11237374,1,C,T,78062880,76894,77943166,78336382,119714
11,ENSG00000255010.1,83106961,11-83217776-C-G,rs11530859,-1,C,G,83217776,110815,82910353,83303569,307423
11,ENSG00000255299.1,58505758,11-58667072-C-A,rs11560908,-1,C,A,58667072,161314,58309150,58702366,357922
11,ENSG00000255299.1,58505758,11-58667072-C-G,rs11560908,-1,C,G,58667072,161314,58309150,58702366,357922
11,ENSG00000255299.1,58505758,11-58667072-C-T,rs11560908,-1,C,T,58667072,161314,58309150,58702366,357922
11,ENSG00000255213.1,62330946,11-62259836-C-T,rs11604814,1,C,T,62259836,71110,62134338,62527554,125498
11,ENSG00000256940.1,64245838,11-64240504-C-T,rs11607007,1,C,T,64240504,5334,64049230,64442446,191274
11,ENSG00000256940.1,64245838,11-64240504-C-G,rs11607007,1,C,G,64240504,5334,64049230,64442446,191274
11,ENSG00000251364.2,7513472,11-7653007-C-G,rs117115375,-1,C,G,7653007,139535,7316864,7710080,336143
11,ENSG00000251364.2,7513472,11-7653007-C-A,rs117115375,-1,C,A,7653007,139535,7316864,7710080,336143
11,ENSG00000254854.1,119729583,11-119702945-C-T,rs117236359,1,C,T,119702945,26638,119532975,119926191,169970
11,ENSG00000255234.1,83286128,11-83204756-A-G,rs118059285,1,A,G,83204756,81372,83089520,83482736,115236
11,ENSG00000255084.1,78533176,11-78461069-G-C,rs11822363,1,G,C,78461069,72107,78336568,78729784,124501
11,ENSG00000255084.1,78533176,11-78461069-G-A,rs11822363,1,G,A,78461069,72107,78336568,78729784,124501
11,ENSG00000254416.1,110355130,11-110330999-T-A,rs11823096,1,T,A,110330999,24131,110158522,110551738,172477
11,ENSG00000248027.1,100687955,11-100693484-C-T,rs11823723,-1,C,T,100693484,5529,100491347,100884563,202137
11,ENSG00000254884.1,9311689,11-9184732-G-A,rs12099067,-1,G,A,9184732,126957,9115081,9508297,69651
11,ENSG00000255284.1,777574,11-772490-G-A,rs12224894,1,G,A,772490,5084,580966,974182,191524
11,ENSG00000236129.1,131187022,11-131104326-A-T,rs12271602,1,A,T,131104326,82696,130990414,131383630,113912
11,ENSG00000236129.1,131187022,11-131104326-A-G,rs12271602,1,A,G,131104326,82696,130990414,131383630,113912
11,ENSG00000255070.1,91115961,11-91224412-G-A,rs12272833,1,G,A,91224412,108451,90919353,91312569,305059
11,ENSG00000246273.2,9758268,11-9615307-A-G,rs12273601,1,A,G,9615307,142961,9561660,9954876,53647
11,ENSG00000251323.2,78429836,11-78384141-G-A,rs12274496,-1,G,A,78384141,45695,78233228,78626444,150913
11,ENSG00000256469.1,94925521,11-94934546-T-C,rs12293256,-1,T,C,94934546,9025,94728913,95122129,205633
11,ENSG00000256469.1,94925521,11-94934546-T-G,rs12293256,-1,T,G,94934546,9025,94728913,95122129,205633
11,ENSG00000238184.1,2377992,11-2212292-G-A,rs12361938,-1,G,A,2212292,165700,2181384,2574600,30908
11,ENSG00000254827.1,2903813,11-2916545-G-T,rs12363784,-1,G,T,2916545,12732,2707205,3100421,209340
11,ENSG00000224829.3,77313606,11-77212307-A-G,rs12418037,1,A,G,77212307,101299,77116998,77510214,95309
11,ENSG00000184224.3,67606706,11-67605006-G-T,rs12421329,-1,G,T,67605006,1700,67410098,67803314,194908
11,ENSG00000245148.2,72700474,11-72683661-G-T,rs12576058,1,G,T,72683661,16813,72503866,72897082,179795
11,ENSG00000245148.2,72700474,11-72683661-G-A,rs12576058,1,G,A,72683661,16813,72503866,72897082,179795
11,ENSG00000254602.1,57638376,11-57646470-C-A,rs12793139,1,C,A,57646470,8094,57441768,57834984,204702
11,ENSG00000254602.1,57638376,11-57646470-C-G,rs12793139,1,C,G,57646470,8094,57441768,57834984,204702
11,ENSG00000243742.1,61636680,11-61644229-C-T,rs12805941,1,C,T,61644229,7549,61440072,61833288,204157
11,ENSG00000243742.1,61636680,11-61644229-C-A,rs12805941,1,C,A,61644229,7549,61440072,61833288,204157
11,ENSG00000251194.2,35212550,11-35208126-T-G,rs1467558,1,T,G,35208126,4424,35015942,35409158,192184
11,ENSG00000251194.2,35212550,11-35208126-T-A,rs1467558,1,T,A,35208126,4424,35015942,35409158,192184
11,ENSG00000251194.2,35212550,11-35208126-T-C,rs1467558,1,T,C,35208126,4424,35015942,35409158,192184
11,ENSG00000247271.2,10858219,11-10882223-T-C,rs1554520,1,T,C,10882223,24004,10661611,11054827,220612
11,ENSG00000255042.1,50295334,11-50471785-T-A,rs1602115,-1,T,A,50471785,176451,50098726,50491942,373059
11,ENSG00000255042.1,50295334,11-50471785-T-G,rs1602115,-1,T,G,50471785,176451,50098726,50491942,373059
11,ENSG00000255042.1,50295334,11-50471785-T-C,rs1602115,-1,T,C,50471785,176451,50098726,50491942,373059
11,ENSG00000256898.1,73922196,11-73870179-G-C,rs1623476,-1,G,C,73870179,52017,73725588,74118804,144591
11,ENSG00000256898.1,73922196,11-73870179-G-A,rs1623476,-1,G,A,73870179,52017,73725588,74118804,144591
11,ENSG00000246067.2,83072066,11-83077397-C-G,rs17144544,1,C,G,83077397,5331,82875458,83268674,201939
11,ENSG00000246067.2,83072066,11-83077397-C-T,rs17144544,1,C,T,83077397,5331,82875458,83268674,201939
11,ENSG00000255301.1,57477534,11-57660956-G-A,rs17152015,-1,G,A,57660956,183422,57280926,57674142,380030
11,ENSG00000226268.2,49434438,11-49598815-T-C,rs17473628,-1,T,C,49598815,164377,49237830,49631046,360985
11,ENSG00000254454.2,62371146,11-62273047-A-G,rs17709552,1,A,G,62273047,98099,62174538,62567754,98509
11,ENSG00000254455.1,65145972,11-65170212-C-T,rs17743381,-1,C,T,65170212,24240,64949364,65342580,220848
11,ENSG00000173727.7,65455269,11-65456441-T-A,rs1783210,1,T,A,65456441,1172,65258661,65651877,197780
11,ENSG00000173727.7,65455269,11-65456441-T-C,rs1783210,1,T,C,65456441,1172,65258661,65651877,197780
11,ENSG00000255006.1,120620267,11-120785770-A-T,rs1815771,-1,A,T,120785770,165503,120423659,120816875,362111
11,ENSG00000255006.1,120620267,11-120785770-A-G,rs1815771,-1,A,G,120785770,165503,120423659,120816875,362111
11,ENSG00000255006.1,120620267,11-120785770-A-C,rs1815771,-1,A,C,120785770,165503,120423659,120816875,362111
11,ENSG00000254589.1,58243097,11-58288552-C-T,rs1938644,-1,C,T,58288552,45455,58046489,58439705,242063
11,ENSG00000254589.1,58243097,11-58288552-C-A,rs1938644,-1,C,A,58288552,45455,58046489,58439705,242063
11,ENSG00000255240.1,59058659,11-59079703-C-A,rs1943146,-1,C,A,59079703,21044,58862051,59255267,217652
11,ENSG00000255455.1,130870247,11-130894953-A-G,rs1944148,-1,A,G,130894953,24706,130673639,131066855,221314
11,ENSG00000255455.1,130870247,11-130894953-A-T,rs1944148,-1,A,T,130894953,24706,130673639,131066855,221314
11,ENSG00000245522.2,9759533,11-9651216-T-A,rs2082807,-1,T,A,9651216,108317,9562925,9956141,88291
11,ENSG00000245522.2,9759533,11-9651216-T-C,rs2082807,-1,T,C,9651216,108317,9562925,9956141,88291
11,ENSG00000260196.1,17380649,11-17221242-G-A,rs214910,1,G,A,17221242,159407,17184041,17577257,37201
11,ENSG00000256035.1,102807916,11-102733876-C-A,rs2155053,-1,C,A,102733876,74040,102611308,103004524,122568
11,ENSG00000256035.1,102807916,11-102733876-C-G,rs2155053,-1,C,G,102733876,74040,102611308,103004524,122568
11,ENSG00000256035.1,102807916,11-102733876-C-T,rs2155053,-1,C,T,102733876,74040,102611308,103004524,122568
11,ENSG00000255026.1,287305,11-295876-C-T,rs2242566,1,C,T,295876,8571,90697,483913,205179
11,ENSG00000254966.1,18706537,11-18707103-T-C,rs2289965,1,T,C,18707103,566,18509929,18903145,197174
11,ENSG00000244926.2,43920926,11-43920636-T-C,rs2292891,-1,T,C,43920636,290,43724318,44117534,196318
11,ENSG00000255847.1,73970287,11-73968187-A-T,rs2306818,-1,A,T,73968187,2100,73773679,74166895,194508
11,ENSG00000255847.1,73970287,11-73968187-A-G,rs2306818,-1,A,G,73968187,2100,73773679,74166895,194508
11,ENSG00000254401.1,11020883,11-11172670-A-G,rs2403464,1,A,G,11172670,151787,10824275,11217491,348395
11,ENSG00000255126.1,62393372,11-62359022-A-G,rs2463836,-1,A,G,62359022,34350,62196764,62589980,162258
11,ENSG00000255126.1,62393372,11-62359022-A-T,rs2463836,-1,A,T,62359022,34350,62196764,62589980,162258
11,ENSG00000254447.1,67784229,11-67650707-T-C,rs2509718,-1,T,C,67650707,133522,67587621,67980837,63086
11,ENSG00000254447.1,67784229,11-67650707-T-A,rs2509718,-1,T,A,67650707,133522,67587621,67980837,63086
11,ENSG00000244535.1,32758268,11-32891111-T-G,rs2746036,1,T,G,32891111,132843,32561660,32954876,329451
11,ENSG00000244535.1,32758268,11-32891111-T-C,rs2746036,1,T,C,32891111,132843,32561660,32954876,329451
11,ENSG00000244535.1,32758268,11-32891111-T-A,rs2746036,1,T,A,32891111,132843,32561660,32954876,329451
11,ENSG00000254873.1,118401309,11-118409221-T-G,rs3194726,-1,T,G,118409221,7912,118204701,118597917,204520
11,ENSG00000254873.1,118401309,11-118409221-T-C,rs3194726,-1,T,C,118409221,7912,118204701,118597917,204520
11,ENSG00000257086.1,64249494,11-64117275-C-T,rs35247680,-1,C,T,64117275,132219,64052886,64446102,64389
11,ENSG00000254979.1,57410113,11-57399496-C-T,rs3741085,-1,C,T,57399496,10617,57213505,57606721,185991
11,ENSG00000254965.1,83111442,11-83072772-C-A,rs3763812,-1,C,A,83072772,38670,82914834,83308050,157938
11,ENSG00000254965.1,83111442,11-83072772-C-T,rs3763812,-1,C,T,83072772,38670,82914834,83308050,157938
11,ENSG00000255443.1,35214985,11-35309626-T-A,rs3843609,-1,T,A,35309626,94641,35018377,35411593,291249
11,ENSG00000255443.1,35214985,11-35309626-T-C,rs3843609,-1,T,C,35309626,94641,35018377,35411593,291249
11,ENSG00000255443.1,35214985,11-35309626-T-G,rs3843609,-1,T,G,35309626,94641,35018377,35411593,291249
11,ENSG00000254614.1,65180884,11-65180806-A-C,rs3953797,-1,A,C,65180806,78,64984276,65377492,196530
11,ENSG00000254614.1,65180884,11-65180806-A-G,rs3953797,-1,A,G,65180806,78,64984276,65377492,196530
11,ENSG00000254428.1,119004893,11-118980428-C-T,rs4456264,-1,C,T,118980428,24465,118808285,119201501,172143
11,ENSG00000255121.1,118998004,11-118981816-C-T,rs45527340,-1,C,T,118981816,16188,118801396,119194612,180420
11,ENSG00000255121.1,118998004,11-118981816-C-G,rs45527340,-1,C,G,118981816,16188,118801396,119194612,180420
11,ENSG00000254939.1,98566827,11-98612935-C-T,rs4604847,-1,C,T,98612935,46108,98370219,98763435,242716
11,ENSG00000243802.2,47191542,11-47237428-A-C,rs4647756,-1,A,C,47237428,45886,46994934,47388150,242494
11,ENSG00000236935.1,64340154,11-64340005-T-C,rs479777,-1,T,C,64340005,149,64143546,64536762,196459
11,ENSG00000254429.1,75260127,11-75447404-G-A,rs482458,1,G,A,75447404,187277,75063519,75456735,383885
11,ENSG00000245552.2,95151693,11-95341943-C-T,rs485702,1,C,T,95341943,190250,94955085,95348301,386858
11,ENSG00000226645.1,116773389,11-116657532-A-T,rs492257,1,A,T,116657532,115857,116576781,116969997,80751
11,ENSG00000226645.1,116773389,11-116657532-A-G,rs492257,1,A,G,116657532,115857,116576781,116969997,80751
11,ENSG00000226645.1,116773389,11-116657532-A-C,rs492257,1,A,C,116657532,115857,116576781,116969997,80751
11,ENSG00000174370.5,128906044,11-128909907-C-T,rs4937390,-1,C,T,128909907,3863,128709436,129102652,200471
11,ENSG00000174370.5,128906044,11-128909907-C-G,rs4937390,-1,C,G,128909907,3863,128709436,129102652,200471
11,ENSG00000254682.1,71448562,11-71456989-A-C,rs4944957,1,A,C,71456989,8427,71251954,71645170,205035
11,ENSG00000254682.1,71448562,11-71456989-A-G,rs4944957,1,A,G,71456989,8427,71251954,71645170,205035
11,ENSG00000241170.2,74919587,11-74848401-G-C,rs4944960,1,G,C,74848401,71186,74722979,75116195,125422
11,ENSG00000241170.2,74919587,11-74848401-G-A,rs4944960,1,G,A,74848401,71186,74722979,75116195,125422
11,ENSG00000189398.5,3391752,11-3227385-G-A,rs4998520,-1,G,A,3227385,164367,3195144,3588360,32241
11,ENSG00000245532.2,65422798,11-65423737-C-G,rs512715,1,C,G,65423737,939,65226190,65619406,197547
11,ENSG00000254452.1,66277487,11-66160302-T-G,rs526200,-1,T,G,66160302,117185,66080879,66474095,79423
11,ENSG00000257052.1,60906789,11-60944605-G-A,rs552426,1,G,A,60944605,37816,60710181,61103397,234424
11,ENSG00000257052.1,60906789,11-60944605-G-T,rs552426,1,G,T,60944605,37816,60710181,61103397,234424
11,ENSG00000234964.2,59781722,11-59878206-A-C,rs55794407,-1,A,C,59878206,96484,59585114,59978330,293092
11,ENSG00000234964.2,59781722,11-59878206-A-T,rs55794407,-1,A,T,59878206,96484,59585114,59978330,293092
11,ENSG00000245498.2,124800450,11-124805318-A-G,rs558814,1,A,G,124805318,4868,124603842,124997058,201476
11,ENSG00000254759.1,126067539,11-126129636-A-C,rs576165,1,A,C,126129636,62097,125870931,126264147,258705
11,ENSG00000254759.1,126067539,11-126129636-A-T,rs576165,1,A,T,126129636,62097,125870931,126264147,258705
11,ENSG00000254759.1,126067539,11-126129636-A-G,rs576165,1,A,G,126129636,62097,125870931,126264147,258705
11,ENSG00000250508.1,68870664,11-68862814-T-A,rs584108,1,T,A,68862814,7850,68674056,69067272,188758
11,ENSG00000254837.1,74493366,11-74489694-G-A,rs601904,1,G,A,74489694,3672,74296758,74689974,192936
11,ENSG00000254837.1,74493366,11-74489694-G-C,rs601904,1,G,C,74489694,3672,74296758,74689974,192936
11,ENSG00000255929.1,94740269,11-94602964-T-C,rs608972,-1,T,C,94602964,137305,94543661,94936877,59303
11,ENSG00000255929.1,94740269,11-94602964-T-A,rs608972,-1,T,A,94602964,137305,94543661,94936877,59303
11,ENSG00000254509.1,124791228,11-124838802-A-G,rs610104,1,A,G,124838802,47574,124594620,124987836,244182
11,ENSG00000255428.1,111418186,11-111362586-T-G,rs61896828,-1,T,G,111362586,55600,111221578,111614794,141008
11,ENSG00000255428.1,111418186,11-111362586-T-A,rs61896828,-1,T,A,111362586,55600,111221578,111614794,141008
11,ENSG00000254748.1,87024583,11-87177126-G-T,rs622921,1,G,T,87177126,152543,86827975,87221191,349151
11,ENSG00000254748.1,87024583,11-87177126-G-A,rs622921,1,G,A,87177126,152543,86827975,87221191,349151
11,ENSG00000254748.1,87024583,11-87177126-G-C,rs622921,1,G,C,87177126,152543,86827975,87221191,349151
11,ENSG00000261098.1,107316271,11-107326880-G-C,rs630693,-1,G,C,107326880,10609,107119663,107512879,207217
11,ENSG00000256116.1,64234292,11-64229857-A-G,rs633561,-1,A,G,64229857,4435,64037684,64430900,192173
11,ENSG00000256116.1,64234292,11-64229857-A-T,rs633561,-1,A,T,64229857,4435,64037684,64430900,192173
11,ENSG00000256116.1,64234292,11-64229857-A-C,rs633561,-1,A,C,64229857,4435,64037684,64430900,192173
11,ENSG00000254941.1,124808269,11-124808045-C-G,rs646521,-1,C,G,124808045,224,124611661,125004877,196384
11,ENSG00000254941.1,124808269,11-124808045-C-T,rs646521,-1,C,T,124808045,224,124611661,125004877,196384
11,ENSG00000255337.1,102452919,11-102480978-C-G,rs651319,1,C,G,102480978,28059,102256311,102649527,224667
11,ENSG00000255337.1,102452919,11-102480978-C-T,rs651319,1,C,T,102480978,28059,102256311,102649527,224667
11,ENSG00000254851.1,117135528,11-117131687-A-T,rs6589598,1,A,T,117131687,3841,116938920,117332136,192767
11,ENSG00000254851.1,117135528,11-117131687-A-G,rs6589598,1,A,G,117131687,3841,116938920,117332136,192767
11,ENSG00000214797.3,59284033,11-59213076-A-G,rs6591509,-1,A,G,59213076,70957,59087425,59480641,125651
11,ENSG00000254815.1,557595,11-656523-C-T,rs6598007,1,C,T,656523,98928,360987,754203,295536
11,ENSG00000130600.9,2001470,11-1884062-T-C,rs661348,-1,T,C,1884062,117408,1804862,2198078,79200
11,ENSG00000256341.1,64119210,11-64278557-G-A,rs671976,-1,G,A,64278557,159347,63922602,64315818,355955
11,ENSG00000256341.1,64119210,11-64278557-G-T,rs671976,-1,G,T,64278557,159347,63922602,64315818,355955
11,ENSG00000255893.1,94473570,11-94478988-A-G,rs680695,-1,A,G,94478988,5418,94276962,94670178,202026
11,ENSG00000255893.1,94473570,11-94478988-A-T,rs680695,-1,A,T,94478988,5418,94276962,94670178,202026
11,ENSG00000183562.2,2989863,11-2989200-A-G,rs7105693,1,A,G,2989200,663,2793255,3186471,195945
11,ENSG00000255237.1,463899,11-500248-G-C,rs7113204,-1,G,C,500248,36349,267291,660507,232957
11,ENSG00000255237.1,463899,11-500248-G-A,rs7113204,-1,G,A,500248,36349,267291,660507,232957
11,ENSG00000242208.1,56357328,11-56180708-G-A,rs7117504,1,G,A,56180708,176620,56160720,56553936,19988
11,ENSG00000255498.1,45906461,11-45842772-T-C,rs7121775,-1,T,C,45842772,63689,45709853,46103069,132919
11,ENSG00000255517.1,66480231,11-66471676-C-T,rs7123875,-1,C,T,66471676,8555,66283623,66676839,188053
11,ENSG00000255517.1,66480231,11-66471676-C-G,rs7123875,-1,C,G,66471676,8555,66283623,66676839,188053
11,ENSG00000254528.1,117833910,11-118021855-T-C,rs7127135,1,T,C,118021855,187945,117637302,118030518,384553
11,ENSG00000246250.2,43880726,11-43933531-G-A,rs7128816,-1,G,A,43933531,52805,43684118,44077334,249413
11,ENSG00000245385.2,119337309,11-119447596-A-T,rs7130716,-1,A,T,119447596,110287,119140701,119533917,306895
11,ENSG00000245385.2,119337309,11-119447596-A-G,rs7130716,-1,A,G,119447596,110287,119140701,119533917,306895
11,ENSG00000256196.1,60925397,11-60782852-G-A,rs72914920,-1,G,A,60782852,142545,60728789,61122005,54063
11,ENSG00000246100.2,115760306,11-115888063-G-T,rs72993659,-1,G,T,115888063,127757,115563698,115956914,324365
11,ENSG00000255135.2,76444673,11-76371018-A-G,rs73002555,-1,A,G,76371018,73655,76248065,76641281,122953
11,ENSG00000250073.2,124759129,11-124839956-G-A,rs73014347,1,G,A,124839956,80827,124562521,124955737,277435
11,ENSG00000255328.1,327310,11-324880-G-C,rs7395116,1,G,C,324880,2430,130702,523918,194178
11,ENSG00000255328.1,327310,11-324880-G-A,rs7395116,1,G,A,324880,2430,130702,523918,194178
11,ENSG00000226416.1,1989993,11-1959338-T-C,rs739906,-1,T,C,1959338,30655,1793385,2186601,165953
11,ENSG00000255139.1,59565923,11-59713646-G-T,rs74398490,1,G,T,59713646,147723,59369315,59762531,344331
11,ENSG00000254910.1,311141,11-307025-G-C,rs75117940,-1,G,C,307025,4116,114533,507749,192492
11,ENSG00000254910.1,311141,11-307025-G-A,rs75117940,-1,G,A,307025,4116,114533,507749,192492
11,ENSG00000251661.2,318653,11-307025-G-C,rs75117940,1,G,C,307025,11628,122045,515261,184980
11,ENSG00000251661.2,318653,11-307025-G-A,rs75117940,1,G,A,307025,11628,122045,515261,184980
11,ENSG00000246790.2,121453013,11-121516695-G-T,rs77434062,-1,G,T,121516695,63682,121256405,121649621,260290
11,ENSG00000254559.1,203623,11-253662-G-C,rs7925234,1,G,C,253662,50039,7015,400231,246647
11,ENSG00000254559.1,203623,11-253662-G-T,rs7925234,1,G,T,253662,50039,7015,400231,246647
11,ENSG00000255293.1,23403805,11-23511397-T-C,rs7926648,1,T,C,23511397,107592,23207197,23600413,304200
11,ENSG00000255035.1,17436181,11-17630089-C-T,rs7939102,-1,C,T,17630089,193908,17239573,17632789,390516
11,ENSG00000224295.2,5524955,11-5620771-T-A,rs7939159,-1,T,A,5620771,95816,5328347,5721563,292424
11,ENSG00000224295.2,5524955,11-5620771-T-C,rs7939159,-1,T,C,5620771,95816,5328347,5721563,292424
11,ENSG00000229534.1,5572192,11-5620771-T-A,rs7939159,-1,T,A,5620771,48579,5375584,5768800,245187
11,ENSG00000229534.1,5572192,11-5620771-T-C,rs7939159,-1,T,C,5620771,48579,5375584,5768800,245187
11,ENSG00000255320.1,66257595,11-66209054-T-A,rs7942894,-1,T,A,66209054,48541,66060987,66454203,148067
11,ENSG00000255320.1,66257595,11-66209054-T-C,rs7942894,-1,T,C,66209054,48541,66060987,66454203,148067
11,ENSG00000254463.1,43466392,11-43501529-A-T,rs7947906,1,A,T,43501529,35137,43269784,43663000,231745
11,ENSG00000254463.1,43466392,11-43501529-A-G,rs7947906,1,A,G,43501529,35137,43269784,43663000,231745
11,ENSG00000254463.1,43466392,11-43501529-A-C,rs7947906,1,A,C,43501529,35137,43269784,43663000,231745
11,ENSG00000255449.1,77870091,11-77699003-C-T,rs79819324,-1,C,T,77699003,171088,77673483,78066699,25520
11,ENSG00000254905.1,126294254,11-126293717-T-G,rs8177376,-1,T,G,126293717,537,126097646,126490862,196071
11,ENSG00000181109.3,5726502,11-5738230-T-C,rs9665780,1,T,C,5738230,11728,5529894,5923110,208336
11,ENSG00000255328.1,327310,11-334703-C-T,rs10160661,1,C,T,334703,7393,130702,523918,204001
11,ENSG00000255328.1,327310,11-334703-C-A,rs10160661,1,C,A,334703,7393,130702,523918,204001
11,ENSG00000255949.1,67435399,11-67435355-G-A,rs10274,-1,G,A,67435355,44,67238791,67632007,196564
11,ENSG00000255949.1,67435399,11-67435355-G-T,rs10274,-1,G,T,67435355,44,67238791,67632007,196564
11,ENSG00000255375.1,32132657,11-32197508-G-A,rs1033629,1,G,A,32197508,64851,31936049,32329265,261459
11,ENSG00000246308.1,10809204,11-10853508-T-C,rs1046297,1,T,C,10853508,44304,10612596,11005812,240912
11,ENSG00000213713.3,33076460,11-33022031-G-A,rs10767981,-1,G,A,33022031,54429,32879852,33273068,142179
11,ENSG00000251323.2,78429836,11-78526520-A-G,rs10793321,-1,A,G,78526520,96684,78233228,78626444,293292
11,ENSG00000254911.1,93721513,11-93617617-C-T,rs10831076,1,C,T,93617617,103896,93524905,93918121,92712
11,ENSG00000256282.1,18596571,11-18629711-T-C,rs10832958,-1,T,C,18629711,33140,18399963,18793179,229748
11,ENSG00000187686.4,125113569,11-125092349-A-T,rs10893320,1,A,T,125092349,21220,124916961,125310177,175388
11,ENSG00000187686.4,125113569,11-125092349-A-G,rs10893320,1,A,G,125092349,21220,124916961,125310177,175388
11,ENSG00000254783.1,86283927,11-86261897-T-C,rs10898459,1,T,C,86261897,22030,86087319,86480535,174578
11,ENSG00000254837.1,74493366,11-74647637-A-G,rs10899024,1,A,G,74647637,154271,74296758,74689974,350879
11,ENSG00000255449.1,77870091,11-77997621-G-A,rs10899421,-1,G,A,77997621,127530,77673483,78066699,324138
11,ENSG00000255449.1,77870091,11-77997621-G-C,rs10899421,-1,G,C,77997621,127530,77673483,78066699,324138
11,ENSG00000261645.1,90251204,11-90424350-A-T,rs11019015,1,A,T,90424350,173146,90054596,90447812,369754
11,ENSG00000261645.1,90251204,11-90424350-A-G,rs11019015,1,A,G,90424350,173146,90054596,90447812,369754
11,ENSG00000255521.1,35138032,11-35223096-C-A,rs11033031,-1,C,A,35223096,85064,34941424,35334640,281672
11,ENSG00000255521.1,35138032,11-35223096-C-T,rs11033031,-1,C,T,35223096,85064,34941424,35334640,281672
11,ENSG00000226268.2,49434438,11-49340368-G-A,rs11040341,-1,G,A,49340368,94070,49237830,49631046,102538
11,ENSG00000254506.1,101594020,11-101555808-G-C,rs11224853,1,G,C,101555808,38212,101397412,101790628,158396
11,ENSG00000254506.1,101594020,11-101555808-G-A,rs11224853,1,G,A,101555808,38212,101397412,101790628,158396
11,ENSG00000214797.3,59284033,11-59252946-C-A,rs11229889,-1,C,A,59252946,31087,59087425,59480641,165521
11,ENSG00000214797.3,59284033,11-59252946-C-T,rs11229889,-1,C,T,59252946,31087,59087425,59480641,165521
11,ENSG00000238184.1,2377992,11-2465469-T-G,rs112344603,-1,T,G,2465469,87477,2181384,2574600,284085
11,ENSG00000236304.1,76656984,11-76695997-A-C,rs11236867,1,A,C,76695997,39013,76460376,76853592,235621
11,ENSG00000236304.1,76656984,11-76695997-A-G,rs11236867,1,A,G,76695997,39013,76460376,76853592,235621
11,ENSG00000236304.1,76656984,11-76695997-A-T,rs11236867,1,A,T,76695997,39013,76460376,76853592,235621
11,ENSG00000250397.2,859795,11-718436-G-T,rs11246288,-1,G,T,718436,141359,663187,1056403,55249
11,ENSG00000250397.2,859795,11-718436-G-A,rs11246288,-1,G,A,718436,141359,663187,1056403,55249
11,ENSG00000256035.1,102807916,11-102798678-T-A,rs1144393,-1,T,A,102798678,9238,102611308,103004524,187370
11,ENSG00000256035.1,102807916,11-102798678-T-C,rs1144393,-1,T,C,102798678,9238,102611308,103004524,187370
11,ENSG00000173727.7,65455269,11-65436090-C-T,rs1144924,1,C,T,65436090,19179,65258661,65651877,177429
11,ENSG00000256940.1,64245838,11-64224109-G-A,rs11549690,1,G,A,64224109,21729,64049230,64442446,174879
11,ENSG00000251226.1,134762557,11-134678064-A-C,rs11603224,1,A,C,134678064,84493,134565949,134959165,112115
11,ENSG00000251226.1,134762557,11-134678064-A-G,rs11603224,1,A,G,134678064,84493,134565949,134959165,112115
11,ENSG00000254780.1,47905607,11-47826943-G-T,rs116983862,-1,G,T,47826943,78664,47708999,48102215,117944
11,ENSG00000179038.7,67196126,11-67167106-G-T,rs117044492,-1,G,T,67167106,29020,66999518,67392734,167588
11,ENSG00000179038.7,67196126,11-67167106-G-A,rs117044492,-1,G,A,67167106,29020,66999518,67392734,167588
11,ENSG00000254801.1,49071000,11-49093053-T-C,rs117085965,-1,T,C,49093053,22053,48874392,49267608,218661
11,ENSG00000254801.1,49071000,11-49093053-T-A,rs117085965,-1,T,A,49093053,22053,48874392,49267608,218661
11,ENSG00000254801.1,49071000,11-49093053-T-G,rs117085965,-1,T,G,49093053,22053,48874392,49267608,218661
11,ENSG00000255237.1,463899,11-624400-C-A,rs117610069,-1,C,A,624400,160501,267291,660507,357109
11,ENSG00000255237.1,463899,11-624400-C-T,rs117610069,-1,C,T,624400,160501,267291,660507,357109
11,ENSG00000255351.1,11352426,11-11374694-A-T,rs11827640,1,A,T,11374694,22268,11155818,11549034,218876
11,ENSG00000255351.1,11352426,11-11374694-A-G,rs11827640,1,A,G,11374694,22268,11155818,11549034,218876
11,ENSG00000254614.1,65180884,11-65179387-T-A,rs1195968,-1,T,A,65179387,1497,64984276,65377492,195111
11,ENSG00000254614.1,65180884,11-65179387-T-C,rs1195968,-1,T,C,65179387,1497,64984276,65377492,195111
11,ENSG00000254719.1,10272259,11-10213383-C-G,rs12278680,-1,C,G,10213383,58876,10075651,10468867,137732
11,ENSG00000254719.1,10272259,11-10213383-C-T,rs12278680,-1,C,T,10213383,58876,10075651,10468867,137732
11,ENSG00000213275.2,69303807,11-69176079-C-A,rs12283434,-1,C,A,69176079,127728,69107199,69500415,68880
11,ENSG00000213275.2,69303807,11-69176079-C-T,rs12283434,-1,C,T,69176079,127728,69107199,69500415,68880
11,ENSG00000245573.3,27506847,11-27372339-G-C,rs12284579,1,G,C,27372339,134508,27310239,27703455,62100
11,ENSG00000245573.3,27506847,11-27372339-G-T,rs12284579,1,G,T,27372339,134508,27310239,27703455,62100
11,ENSG00000245573.3,27506847,11-27372339-G-A,rs12284579,1,G,A,27372339,134508,27310239,27703455,62100
11,ENSG00000241782.1,77869195,11-77677975-T-C,rs12286317,-1,T,C,77677975,191220,77672587,78065803,5388
11,ENSG00000241782.1,77869195,11-77677975-T-A,rs12286317,-1,T,A,77677975,191220,77672587,78065803,5388
11,ENSG00000254854.1,119729583,11-119762266-G-A,rs12290653,1,G,A,119762266,32683,119532975,119926191,229291
11,ENSG00000254704.3,59289486,11-59266139-A-G,rs12419479,-1,A,G,59266139,23347,59092878,59486094,173261
11,ENSG00000181109.3,5726502,11-5710519-T-C,rs12419535,1,T,C,5710519,15983,5529894,5923110,180625
11,ENSG00000235027.1,1760348,11-1608947-G-A,rs12792005,1,G,A,1608947,151401,1563740,1956956,45207
11,ENSG00000226645.1,116773389,11-116652346-G-T,rs12805779,1,G,T,116652346,121043,116576781,116969997,75565
11,ENSG00000246273.2,9758268,11-9842851-T-C,rs13377352,1,T,C,9842851,84583,9561660,9954876,281191
11,ENSG00000214264.4,112180773,11-112366607-G-A,rs1357928,1,G,A,112366607,185834,111984165,112377381,382442
11,ENSG00000214264.4,112180773,11-112366607-G-C,rs1357928,1,G,C,112366607,185834,111984165,112377381,382442
11,ENSG00000254894.1,20120632,11-20068432-A-C,rs1442709,-1,A,C,20068432,52200,19924024,20317240,144408
11,ENSG00000254894.1,20120632,11-20068432-A-T,rs1442709,-1,A,T,20068432,52200,19924024,20317240,144408
11,ENSG00000254894.1,20120632,11-20068432-A-G,rs1442709,-1,A,G,20068432,52200,19924024,20317240,144408
11,ENSG00000240808.1,17138265,11-17263761-T-G,rs147866373,-1,T,G,17263761,125496,16941657,17334873,322104
11,ENSG00000255031.1,68050740,11-68149620-C-T,rs1547889,1,C,T,68149620,98880,67854132,68247348,295488
11,ENSG00000214883.3,50409042,11-50549553-A-T,rs1608278,1,A,T,50549553,140511,50212434,50605650,337119
11,ENSG00000183562.2,2989863,11-2921363-G-A,rs1661052,1,G,A,2921363,68500,2793255,3186471,128108
11,ENSG00000183562.2,2989863,11-2921363-G-T,rs1661052,1,G,T,2921363,68500,2793255,3186471,128108
11,ENSG00000255929.1,94740269,11-94587013-T-G,rs16920648,-1,T,G,94587013,153256,94543661,94936877,43352
11,ENSG00000255929.1,94740269,11-94587013-T-C,rs16920648,-1,T,C,94587013,153256,94543661,94936877,43352
11,ENSG00000229368.1,3854612,11-3972833-G-A,rs16929551,1,G,A,3972833,118221,3658004,4051220,314829
11,ENSG00000213305.3,85021655,11-85017664-A-G,rs17147910,-1,A,G,85017664,3991,84825047,85218263,192617
11,ENSG00000213305.3,85021655,11-85017664-A-C,rs17147910,-1,A,C,85017664,3991,84825047,85218263,192617
11,ENSG00000214391.3,90282560,11-90313975-C-T,rs17235041,1,C,T,90313975,31415,90085952,90479168,228023
11,ENSG00000214391.3,90282560,11-90313975-C-G,rs17235041,1,C,G,90313975,31415,90085952,90479168,228023
11,ENSG00000206597.1,62665422,11-62536350-C-A,rs17664979,1,C,A,62536350,129072,62468814,62862030,67536
11,ENSG00000206597.1,62665422,11-62536350-C-T,rs17664979,1,C,T,62536350,129072,62468814,62862030,67536
11,ENSG00000256568.1,73157946,11-73187174-G-T,rs1783577,1,G,T,73187174,29228,72961338,73354554,225836
11,ENSG00000256568.1,73157946,11-73187174-G-A,rs1783577,1,G,A,73187174,29228,72961338,73354554,225836
11,ENSG00000254905.1,126294254,11-126295862-T-A,rs1786704,-1,T,A,126295862,1608,126097646,126490862,198216
11,ENSG00000254905.1,126294254,11-126295862-T-G,rs1786704,-1,T,G,126295862,1608,126097646,126490862,198216
11,ENSG00000254905.1,126294254,11-126295862-T-C,rs1786704,-1,T,C,126295862,1608,126097646,126490862,198216
11,ENSG00000254455.1,65145972,11-65213512-G-A,rs17882241,-1,G,A,65213512,67540,64949364,65342580,264148
11,ENSG00000254455.1,65145972,11-65213512-G-C,rs17882241,-1,G,C,65213512,67540,64949364,65342580,264148
11,ENSG00000256116.1,64234292,11-64227220-T-G,rs1860368,-1,T,G,64227220,7072,64037684,64430900,189536
11,ENSG00000256116.1,64234292,11-64227220-T-C,rs1860368,-1,T,C,64227220,7072,64037684,64430900,189536
11,ENSG00000174370.5,128906044,11-128915228-A-C,rs1940455,-1,A,C,128915228,9184,128709436,129102652,205792
11,ENSG00000174370.5,128906044,11-128915228-A-G,rs1940455,-1,A,G,128915228,9184,128709436,129102652,205792
11,ENSG00000174370.5,128906044,11-128915228-A-T,rs1940455,-1,A,T,128915228,9184,128709436,129102652,205792
11,ENSG00000130600.9,2001470,11-1814802-T-G,rs1983255,-1,T,G,1814802,186668,1804862,2198078,9940
11,ENSG00000130600.9,2001470,11-1814802-T-C,rs1983255,-1,T,C,1814802,186668,1804862,2198078,9940
11,ENSG00000130600.9,2001470,11-1814802-T-A,rs1983255,-1,T,A,1814802,186668,1804862,2198078,9940
11,ENSG00000224555.2,3989463,11-3879255-G-C,rs2018918,-1,G,C,3879255,110208,3792855,4186071,86400
11,ENSG00000224555.2,3989463,11-3879255-G-A,rs2018918,-1,G,A,3879255,110208,3792855,4186071,86400
11,ENSG00000261098.1,107316271,11-107407566-T-C,rs2042535,-1,T,C,107407566,91295,107119663,107512879,287903
11,ENSG00000254416.1,110355130,11-110463456-T-C,rs2044174,1,T,C,110463456,108326,110158522,110551738,304934
11,ENSG00000255213.1,62330946,11-62189598-G-A,rs2232931,1,G,A,62189598,141348,62134338,62527554,55260
11,ENSG00000254528.1,117833910,11-117911923-A-G,rs2277288,1,A,G,117911923,78013,117637302,118030518,274621
11,ENSG00000255517.1,66480231,11-66473411-T-C,rs2277302,-1,T,C,66473411,6820,66283623,66676839,189788
11,ENSG00000249489.1,88409223,11-88604945-T-C,rs2306153,-1,T,C,88604945,195722,88212615,88605831,392330
11,ENSG00000245148.2,72700474,11-72688652-C-T,rs2306610,1,C,T,72688652,11822,72503866,72897082,184786
11,ENSG00000255126.1,62393372,11-62321366-C-G,rs2463829,-1,C,G,62321366,72006,62196764,62589980,124602
11,ENSG00000255126.1,62393372,11-62321366-C-T,rs2463829,-1,C,T,62321366,72006,62196764,62589980,124602
11,ENSG00000254595.1,6489377,11-6511860-T-C,rs2555149,-1,T,C,6511860,22483,6292769,6685985,219091
11,ENSG00000247095.2,568449,11-470331-A-G,rs2613996,-1,A,G,470331,98118,371841,765057,98490
11,ENSG00000254860.1,8965048,11-8971762-G-C,rs2653605,1,G,C,8971762,6714,8768440,9161656,203322
11,ENSG00000256813.1,60851081,11-60975316-A-G,rs2905504,-1,A,G,60975316,124235,60654473,61047689,320843
11,ENSG00000256813.1,60851081,11-60975316-A-T,rs2905504,-1,A,T,60975316,124235,60654473,61047689,320843
11,ENSG00000256813.1,60851081,11-60975316-A-C,rs2905504,-1,A,C,60975316,124235,60654473,61047689,320843
11,ENSG00000256007.1,72685075,11-72548021-T-G,rs341073,1,T,G,72548021,137054,72488467,72881683,59554
11,ENSG00000256007.1,72685075,11-72548021-T-A,rs341073,1,T,A,72548021,137054,72488467,72881683,59554
11,ENSG00000254406.1,119822129,11-119841450-C-A,rs34699720,-1,C,A,119841450,19321,119625521,120018737,215929
11,ENSG00000255108.1,832883,11-830044-G-A,rs35567200,-1,G,A,830044,2839,636275,1029491,193769
11,ENSG00000255045.1,124746337,11-124619378-A-C,rs35569094,-1,A,C,124619378,126959,124549729,124942945,69649
11,ENSG00000255045.1,124746337,11-124619378-A-G,rs35569094,-1,A,G,124619378,126959,124549729,124942945,69649
11,ENSG00000246067.2,83072066,11-83072772-C-A,rs3763812,1,C,A,83072772,706,82875458,83268674,197314
11,ENSG00000246067.2,83072066,11-83072772-C-T,rs3763812,1,C,T,83072772,706,82875458,83268674,197314
11,ENSG00000224829.3,77313606,11-77188220-A-G,rs3781694,1,A,G,77188220,125386,77116998,77510214,71222
11,ENSG00000236935.1,64340154,11-64363808-T-C,rs3782101,-1,T,C,64363808,23654,64143546,64536762,220262
11,ENSG00000251661.2,318653,11-307036-T-C,rs3809112,1,T,C,307036,11617,122045,515261,184991
11,ENSG00000254910.1,311141,11-307036-T-C,rs3809112,-1,T,C,307036,4105,114533,507749,192503
11,ENSG00000229534.1,5572192,11-5634003-G-A,rs3824951,-1,G,A,5634003,61811,5375584,5768800,258419
11,ENSG00000254682.1,71448562,11-71444083-G-A,rs4316537,1,G,A,71444083,4479,71251954,71645170,192129
11,ENSG00000254682.1,71448562,11-71444083-G-C,rs4316537,1,G,C,71444083,4479,71251954,71645170,192129
11,ENSG00000251364.2,7513472,11-7468588-A-C,rs4351800,-1,A,C,7468588,44884,7316864,7710080,151724
11,ENSG00000251364.2,7513472,11-7468588-A-G,rs4351800,-1,A,G,7468588,44884,7316864,7710080,151724
11,ENSG00000254966.1,18706537,11-18711299-A-T,rs4537730,1,A,T,18711299,4762,18509929,18903145,201370
11,ENSG00000254966.1,18706537,11-18711299-A-C,rs4537730,1,A,C,18711299,4762,18509929,18903145,201370
11,ENSG00000254966.1,18706537,11-18711299-A-G,rs4537730,1,A,G,18711299,4762,18509929,18903145,201370
11,ENSG00000255139.1,59565923,11-59591103-A-G,rs488331,1,A,G,59591103,25180,59369315,59762531,221788
11,ENSG00000184224.3,67606706,11-67526727-C-G,rs4930430,-1,C,G,67526727,79979,67410098,67803314,116629
11,ENSG00000184224.3,67606706,11-67526727-C-T,rs4930430,-1,C,T,67526727,79979,67410098,67803314,116629
11,ENSG00000254935.1,122618851,11-122721444-G-C,rs4935803,1,G,C,122721444,102593,122422243,122815459,299201
11,ENSG00000254935.1,122618851,11-122721444-G-A,rs4935803,1,G,A,122721444,102593,122422243,122815459,299201
11,ENSG00000255284.1,777574,11-776335-G-A,rs4963157,1,G,A,776335,1239,580966,974182,195369
11,ENSG00000250644.1,1763954,11-1848981-G-C,rs4980398,-1,G,C,1848981,85027,1567346,1960562,281635
11,ENSG00000250644.1,1763954,11-1848981-G-T,rs4980398,-1,G,T,1848981,85027,1567346,1960562,281635
11,ENSG00000230080.2,1804095,11-1833341-G-A,rs498337,-1,G,A,1833341,29246,1607487,2000703,225854
11,ENSG00000254662.1,57325603,11-57141384-C-G,rs519868,1,C,G,57141384,184219,57128995,57522211,12389
11,ENSG00000254662.1,57325603,11-57141384-C-A,rs519868,1,C,A,57141384,184219,57128995,57522211,12389
11,ENSG00000254662.1,57325603,11-57141384-C-T,rs519868,1,C,T,57141384,184219,57128995,57522211,12389
11,ENSG00000241170.2,74919587,11-74962225-A-C,rs529488,1,A,C,74962225,42638,74722979,75116195,239246
11,ENSG00000241170.2,74919587,11-74962225-A-G,rs529488,1,A,G,74962225,42638,74722979,75116195,239246
11,ENSG00000255893.1,94473570,11-94466106-G-A,rs533984,-1,G,A,94466106,7464,94276962,94670178,189144
11,ENSG00000240652.1,107908420,11-107778300-G-A,rs553663,1,G,A,107778300,130120,107711812,108105028,66488
11,ENSG00000219529.2,77813676,11-77766911-A-C,rs569072,-1,A,C,77766911,46765,77617068,78010284,149843
11,ENSG00000219529.2,77813676,11-77766911-A-G,rs569072,-1,A,G,77766911,46765,77617068,78010284,149843
11,ENSG00000229671.1,1897015,11-1871113-A-G,rs57209236,1,A,G,1871113,25902,1700407,2093623,170706
11,ENSG00000255153.1,1309769,11-1299442-C-T,rs5743922,1,C,T,1299442,10327,1113161,1506377,186281
11,ENSG00000246174.2,78139774,11-78062669-T-C,rs589472,1,T,C,78062669,77105,77943166,78336382,119503
11,ENSG00000255404.1,65797219,11-65745636-T-A,rs593982,-1,T,A,65745636,51583,65600611,65993827,145025
11,ENSG00000255404.1,65797219,11-65745636-T-C,rs593982,-1,T,C,65745636,51583,65600611,65993827,145025
11,ENSG00000225101.3,4474813,11-4449477-T-A,rs61735705,1,T,A,4449477,25336,4278205,4671421,171272
11,ENSG00000225101.3,4474813,11-4449477-T-C,rs61735705,1,T,C,4449477,25336,4278205,4671421,171272
11,ENSG00000246250.2,43880726,11-43913615-T-C,rs61884011,-1,T,C,43913615,32889,43684118,44077334,229497
11,ENSG00000257052.1,60906789,11-60854640-G-T,rs6591629,1,G,T,60854640,52149,60710181,61103397,144459
11,ENSG00000257052.1,60906789,11-60854640-G-A,rs6591629,1,G,A,60854640,52149,60710181,61103397,144459
11,ENSG00000256341.1,64119210,11-64275525-G-A,rs660442,-1,G,A,64275525,156315,63922602,64315818,352923
11,ENSG00000256341.1,64119210,11-64275525-G-C,rs660442,-1,G,C,64275525,156315,63922602,64315818,352923
11,ENSG00000255200.1,65175487,11-65021605-A-G,rs663767,-1,A,G,65021605,153882,64978879,65372095,42726
11,ENSG00000255200.1,65175487,11-65021605-A-T,rs663767,-1,A,T,65021605,153882,64978879,65372095,42726
11,ENSG00000255200.1,65175487,11-65021605-A-C,rs663767,-1,A,C,65021605,153882,64978879,65372095,42726
11,ENSG00000254941.1,124808269,11-124787700-A-G,rs68065265,-1,A,G,124787700,20569,124611661,125004877,176039
11,ENSG00000245498.2,124800450,11-124787700-A-G,rs68065265,1,A,G,124787700,12750,124603842,124997058,183858
11,ENSG00000255121.1,118998004,11-118967310-G-A,rs7117266,-1,G,A,118967310,30694,118801396,119194612,165914
11,ENSG00000255121.1,118998004,11-118967310-G-T,rs7117266,-1,G,T,118967310,30694,118801396,119194612,165914
11,ENSG00000247271.2,10858219,11-10877889-T-C,rs7125450,1,T,C,10877889,19670,10661611,11054827,216278
11,ENSG00000254454.2,62371146,11-62448790-C-A,rs72925328,1,C,A,62448790,77644,62174538,62567754,274252
11,ENSG00000212961.4,74354443,11-74347613-T-C,rs72988791,1,T,C,74347613,6830,74157835,74551051,189778
11,ENSG00000245532.2,65422798,11-65389768-C-T,rs739390,1,C,T,65389768,33030,65226190,65619406,163578
11,ENSG00000254680.1,12263173,11-12148717-G-A,rs74377045,-1,G,A,12148717,114456,12066565,12459781,82152
11,ENSG00000254680.1,12263173,11-12148717-G-C,rs74377045,-1,G,C,12148717,114456,12066565,12459781,82152
11,ENSG00000251143.1,72014291,11-72188516-G-A,rs74611306,1,G,A,72188516,174225,71817683,72210899,370833
11,ENSG00000251143.1,72014291,11-72188516-G-T,rs74611306,1,G,T,72188516,174225,71817683,72210899,370833
11,ENSG00000255089.1,321991,11-391049-C-G,rs7481929,1,C,G,391049,69058,125383,518599,265666
11,ENSG00000255089.1,321991,11-391049-C-T,rs7481929,1,C,T,391049,69058,125383,518599,265666
11,ENSG00000255089.1,321991,11-391049-C-A,rs7481929,1,C,A,391049,69058,125383,518599,265666
11,ENSG00000255240.1,59058659,11-58956534-G-A,rs75540280,-1,G,A,58956534,102125,58862051,59255267,94483
11,ENSG00000226416.1,1989993,11-1953876-T-C,rs757409,-1,T,C,1953876,36117,1793385,2186601,160491
11,ENSG00000213365.3,72280151,11-72393730-G-A,rs76513307,1,G,A,72393730,113579,72083543,72476759,310187
11,ENSG00000196167.5,111305045,11-111436183-C-T,rs7930326,-1,C,T,111436183,131138,111108437,111501653,327746
11,ENSG00000196167.5,111305045,11-111436183-C-A,rs7930326,-1,C,A,111436183,131138,111108437,111501653,327746
11,ENSG00000196167.5,111305045,11-111436183-C-G,rs7930326,-1,C,G,111436183,131138,111108437,111501653,327746
11,ENSG00000255445.1,93152075,11-92989452-G-A,rs79460720,1,G,A,92989452,162623,92955467,93348683,33985
11,ENSG00000239470.2,9660438,11-9548682-G-T,rs7947260,1,G,T,9548682,111756,9463830,9857046,84852
11,ENSG00000239470.2,9660438,11-9548682-G-A,rs7947260,1,G,A,9548682,111756,9463830,9857046,84852
11,ENSG00000224295.2,5524955,11-5608129-C-A,rs80031403,-1,C,A,5608129,83174,5328347,5721563,279782
11,ENSG00000224295.2,5524955,11-5608129-C-T,rs80031403,-1,C,T,5608129,83174,5328347,5721563,279782
11,ENSG00000224295.2,5524955,11-5608129-C-G,rs80031403,-1,C,G,5608129,83174,5328347,5721563,279782
11,ENSG00000255026.1,287305,11-308716-C-T,rs909098,1,C,T,308716,21411,90697,483913,218019
11,ENSG00000254400.1,6604420,11-6662311-T-C,rs937856,-1,T,C,6662311,57891,6407812,6801028,254499
11,ENSG00000254400.1,6604420,11-6662311-T-G,rs937856,-1,T,G,6662311,57891,6407812,6801028,254499
11,ENSG00000260196.1,17380649,11-17384070-C-G,rs1002226,1,C,G,17384070,3421,17184041,17577257,200029
11,ENSG00000260196.1,17380649,11-17384070-C-T,rs1002226,1,C,T,17384070,3421,17184041,17577257,200029
11,ENSG00000240371.1,57577080,11-57599749-C-A,rs1005510,-1,C,A,57599749,22669,57380472,57773688,219277
11,ENSG00000240371.1,57577080,11-57599749-C-T,rs1005510,-1,C,T,57599749,22669,57380472,57773688,219277
11,ENSG00000230724.3,138998,11-252942-G-A,rs1045577,-1,G,A,252942,113944,-57610,335606,310552
11,ENSG00000254783.1,86283927,11-86117143-G-T,rs10792829,1,G,T,86117143,166784,86087319,86480535,29824
11,ENSG00000254783.1,86283927,11-86117143-G-A,rs10792829,1,G,A,86117143,166784,86087319,86480535,29824
11,ENSG00000254907.1,43359296,11-43543926-T-C,rs10838125,-1,T,C,43543926,184630,43162688,43555904,381238
11,ENSG00000254665.1,8693357,11-8858247-T-C,rs10840135,1,T,C,8858247,164890,8496749,8889965,361498
11,ENSG00000254665.1,8693357,11-8858247-T-A,rs10840135,1,T,A,8858247,164890,8496749,8889965,361498
11,ENSG00000255467.1,108121684,11-107954513-G-C,rs10890784,-1,G,C,107954513,167171,107925076,108318292,29437
11,ENSG00000255467.1,108121684,11-107954513-G-A,rs10890784,-1,G,A,107954513,167171,107925076,108318292,29437
11,ENSG00000196167.5,111305045,11-111297067-T-G,rs10891245,-1,T,G,111297067,7978,111108437,111501653,188630
11,ENSG00000196167.5,111305045,11-111297067-T-A,rs10891245,-1,T,A,111297067,7978,111108437,111501653,188630
11,ENSG00000196167.5,111305045,11-111297067-T-C,rs10891245,-1,T,C,111297067,7978,111108437,111501653,188630
11,ENSG00000213368.3,94913047,11-95040995-G-A,rs11021021,1,G,A,95040995,127948,94716439,95109655,324556
11,ENSG00000254595.1,6489377,11-6372946-C-A,rs11040876,-1,C,A,6372946,116431,6292769,6685985,80177
11,ENSG00000245522.2,9759533,11-9710484-A-G,rs11042482,-1,A,G,9710484,49049,9562925,9956141,147559
11,ENSG00000256690.1,62832234,11-62988047-T-C,rs11231294,1,T,C,62988047,155813,62635626,63028842,352421
11,ENSG00000255084.1,78533176,11-78546462-T-C,rs11237539,1,T,C,78546462,13286,78336568,78729784,209894
11,ENSG00000255026.1,287305,11-286134-G-A,rs11246052,1,G,A,286134,1171,90697,483913,195437
11,ENSG00000255328.1,327310,11-324170-A-T,rs11246065,1,A,T,324170,3140,130702,523918,193468
11,ENSG00000255328.1,327310,11-324170-A-C,rs11246065,1,A,C,324170,3140,130702,523918,193468
11,ENSG00000255328.1,327310,11-324170-A-G,rs11246065,1,A,G,324170,3140,130702,523918,193468
11,ENSG00000254506.1,101594020,11-101538730-G-A,rs112548654,1,G,A,101538730,55290,101397412,101790628,141318
11,ENSG00000255387.1,4212091,11-4407034-T-G,rs11493502,-1,T,G,4407034,194943,4015483,4408699,391551
11,ENSG00000255387.1,4212091,11-4407034-T-C,rs11493502,-1,T,C,4407034,194943,4015483,4408699,391551
11,ENSG00000255387.1,4212091,11-4407034-T-A,rs11493502,-1,T,A,4407034,194943,4015483,4408699,391551
11,ENSG00000250508.1,68870664,11-69009855-T-C,rs11544721,1,T,C,69009855,139191,68674056,69067272,335799
11,ENSG00000255070.1,91115961,11-91207259-A-C,rs11600393,1,A,C,91207259,91298,90919353,91312569,287906
11,ENSG00000255455.1,130870247,11-130896330-T-C,rs11602545,-1,T,C,130896330,26083,130673639,131066855,222691
11,ENSG00000245148.2,72700474,11-72513828-A-C,rs11608093,1,A,C,72513828,186646,72503866,72897082,9962
11,ENSG00000245148.2,72700474,11-72513828-A-T,rs11608093,1,A,T,72513828,186646,72503866,72897082,9962
11,ENSG00000226268.2,49434438,11-49306804-G-C,rs1164673,-1,G,C,49306804,127634,49237830,49631046,68974
11,ENSG00000226268.2,49434438,11-49306804-G-A,rs1164673,-1,G,A,49306804,127634,49237830,49631046,68974
11,ENSG00000256897.1,47221751,11-47158226-G-C,rs116870615,-1,G,C,47158226,63525,47025143,47418359,133083
11,ENSG00000256897.1,47221751,11-47158226-G-A,rs116870615,-1,G,A,47158226,63525,47025143,47418359,133083
11,ENSG00000241170.2,74919587,11-74978936-T-C,rs116956418,1,T,C,74978936,59349,74722979,75116195,255957
11,ENSG00000256916.1,102607367,11-102450397-C-A,rs117382339,1,C,A,102450397,156970,102410759,102803975,39638
11,ENSG00000248027.1,100687955,11-100702389-G-C,rs1216743,-1,G,C,100702389,14434,100491347,100884563,211042
11,ENSG00000248027.1,100687955,11-100702389-G-A,rs1216743,-1,G,A,100702389,14434,100491347,100884563,211042
11,ENSG00000246067.2,83072066,11-83012382-A-T,rs12280845,1,A,T,83012382,59684,82875458,83268674,136924
11,ENSG00000254780.1,47905607,11-48056572-T-G,rs12294321,-1,T,G,48056572,150965,47708999,48102215,347573
11,ENSG00000254708.1,34336003,11-34325581-A-G,rs12296062,-1,A,G,34325581,10422,34139395,34532611,186186
11,ENSG00000254708.1,34336003,11-34325581-A-C,rs12296062,-1,A,C,34325581,10422,34139395,34532611,186186
11,ENSG00000255237.1,463899,11-620927-A-G,rs12360820,-1,A,G,620927,157028,267291,660507,353636
11,ENSG00000255237.1,463899,11-620927-A-C,rs12360820,-1,A,C,620927,157028,267291,660507,353636
11,ENSG00000251226.1,134762557,11-134731118-T-A,rs12364470,1,T,A,134731118,31439,134565949,134959165,165169
11,ENSG00000251226.1,134762557,11-134731118-T-C,rs12364470,1,T,C,134731118,31439,134565949,134959165,165169
11,ENSG00000251226.1,134762557,11-134731118-T-G,rs12364470,1,T,G,134731118,31439,134565949,134959165,165169
11,ENSG00000254703.1,128696023,11-128745591-A-G,rs1238566,-1,A,G,128745591,49568,128499415,128892631,246176
11,ENSG00000213365.3,72280151,11-72160550-C-T,rs12418074,1,C,T,72160550,119601,72083543,72476759,77007
11,ENSG00000251364.2,7513472,11-7436510-T-C,rs12575833,-1,T,C,7436510,76962,7316864,7710080,119646
11,ENSG00000254559.1,203623,11-249834-T-C,rs12576259,1,T,C,249834,46211,7015,400231,242819
11,ENSG00000254406.1,119822129,11-119820360-G-A,rs1447149,-1,G,A,119820360,1769,119625521,120018737,194839
11,ENSG00000256148.1,73510658,11-73656253-C-T,rs1474416,1,C,T,73656253,145595,73314050,73707266,342203
11,ENSG00000255350.1,103405834,11-103551207-A-G,rs1481996,-1,A,G,103551207,145373,103209226,103602442,341981
11,ENSG00000255350.1,103405834,11-103551207-A-T,rs1481996,-1,A,T,103551207,145373,103209226,103602442,341981
11,ENSG00000255350.1,103405834,11-103551207-A-C,rs1481996,-1,A,C,103551207,145373,103209226,103602442,341981
11,ENSG00000254416.1,110355130,11-110347455-C-T,rs1676518,1,C,T,110347455,7675,110158522,110551738,188933
11,ENSG00000254416.1,110355130,11-110347455-C-A,rs1676518,1,C,A,110347455,7675,110158522,110551738,188933
11,ENSG00000254416.1,110355130,11-110347455-C-G,rs1676518,1,C,G,110347455,7675,110158522,110551738,188933
11,ENSG00000255010.1,83106961,11-83077397-C-T,rs17144544,-1,C,T,83077397,29564,82910353,83303569,167044
11,ENSG00000255010.1,83106961,11-83077397-C-G,rs17144544,-1,C,G,83077397,29564,82910353,83303569,167044
11,ENSG00000234964.2,59781722,11-59975102-A-G,rs17154321,-1,A,G,59975102,193380,59585114,59978330,389988
11,ENSG00000213305.3,85021655,11-85049683-A-T,rs1783749,-1,A,T,85049683,28028,84825047,85218263,224636
11,ENSG00000260233.1,65570273,11-65527359-C-A,rs1787663,-1,C,A,65527359,42914,65373665,65766881,153694
11,ENSG00000254682.1,71448562,11-71417134-T-C,rs1790336,1,T,C,71417134,31428,71251954,71645170,165180
11,ENSG00000254682.1,71448562,11-71417134-T-A,rs1790336,1,T,A,71417134,31428,71251954,71645170,165180
11,ENSG00000254966.1,18706537,11-18723630-C-T,rs1979050,1,C,T,18723630,17093,18509929,18903145,213701
11,ENSG00000241950.1,33190503,11-33324342-T-G,rs2068825,-1,T,G,33324342,133839,32993895,33387111,330447
11,ENSG00000241950.1,33190503,11-33324342-T-C,rs2068825,-1,T,C,33324342,133839,32993895,33387111,330447
11,ENSG00000241950.1,33190503,11-33324342-T-A,rs2068825,-1,T,A,33324342,133839,32993895,33387111,330447
11,ENSG00000254662.1,57325603,11-57409155-C-T,rs2241899,1,C,T,57409155,83552,57128995,57522211,280160
11,ENSG00000255404.1,65797219,11-65794786-G-A,rs2276133,-1,G,A,65794786,2433,65600611,65993827,194175
11,ENSG00000236129.1,131187022,11-131101849-C-T,rs2276437,1,C,T,131101849,85173,130990414,131383630,111435
11,ENSG00000246174.2,78139774,11-78172080-C-T,rs230663,1,C,T,78172080,32306,77943166,78336382,228914
11,ENSG00000256568.1,73157946,11-73234296-C-T,rs2511241,1,C,T,73234296,76350,72961338,73354554,272958
11,ENSG00000256568.1,73157946,11-73234296-C-G,rs2511241,1,C,G,73234296,76350,72961338,73354554,272958
11,ENSG00000254815.1,557595,11-748958-A-T,rs28455833,1,A,T,748958,191363,360987,754203,387971
11,ENSG00000254815.1,557595,11-748958-A-G,rs28455833,1,A,G,748958,191363,360987,754203,387971
11,ENSG00000255126.1,62393372,11-62411152-G-A,rs3017095,-1,G,A,62411152,17780,62196764,62589980,214388
11,ENSG00000255126.1,62393372,11-62411152-G-T,rs3017095,-1,G,T,62411152,17780,62196764,62589980,214388
11,ENSG00000243721.1,43718676,11-43892483-C-T,rs35278338,1,C,T,43892483,173807,43522068,43915284,370415
11,ENSG00000243721.1,43718676,11-43892483-C-A,rs35278338,1,C,A,43892483,173807,43522068,43915284,370415
11,ENSG00000254602.1,57638376,11-57444941-C-T,rs35947552,1,C,T,57444941,193435,57441768,57834984,3173
11,ENSG00000254454.2,62371146,11-62419070-G-A,rs3741240,1,G,A,62419070,47924,62174538,62567754,244532
11,ENSG00000255449.1,77870091,11-77927135-A-G,rs3758664,-1,A,G,77927135,57044,77673483,78066699,253652
11,ENSG00000224295.2,5524955,11-5605669-G-A,rs3763881,-1,G,A,5605669,80714,5328347,5721563,277322
11,ENSG00000224295.2,5524955,11-5605669-G-C,rs3763881,-1,G,C,5605669,80714,5328347,5721563,277322
11,ENSG00000254837.1,74493366,11-74558772-C-T,rs3902018,1,C,T,74558772,65406,74296758,74689974,262014
11,ENSG00000245532.2,65422798,11-65552515-C-T,rs4099470,1,C,T,65552515,129717,65226190,65619406,326325
11,ENSG00000226645.1,116773389,11-116781585-C-T,rs4417316,1,C,T,116781585,8196,116576781,116969997,204804
11,ENSG00000256035.1,102807916,11-102695665-G-A,rs4754869,-1,G,A,102695665,112251,102611308,103004524,84357
11,ENSG00000255893.1,94473570,11-94345103-A-C,rs484889,-1,A,C,94345103,128467,94276962,94670178,68141
11,ENSG00000255893.1,94473570,11-94345103-A-T,rs484889,-1,A,T,94345103,128467,94276962,94670178,68141
11,ENSG00000255893.1,94473570,11-94345103-A-G,rs484889,-1,A,G,94345103,128467,94276962,94670178,68141
11,ENSG00000247271.2,10858219,11-10893921-T-G,rs4909954,1,T,G,10893921,35702,10661611,11054827,232310
11,ENSG00000247271.2,10858219,11-10893921-T-C,rs4909954,1,T,C,10893921,35702,10661611,11054827,232310
11,ENSG00000247271.2,10858219,11-10893921-T-A,rs4909954,1,T,A,10893921,35702,10661611,11054827,232310
11,ENSG00000226416.1,1989993,11-2003453-C-A,rs4929984,-1,C,A,2003453,13460,1793385,2186601,210068
11,ENSG00000255320.1,66257595,11-66299193-A-G,rs4930351,-1,A,G,66299193,41598,66060987,66454203,238206
11,ENSG00000255108.1,832883,11-837772-C-T,rs5030779,-1,C,T,837772,4889,636275,1029491,201497
11,ENSG00000255121.1,118998004,11-119055223-G-C,rs511134,-1,G,C,119055223,57219,118801396,119194612,253827
11,ENSG00000255121.1,118998004,11-119055223-G-A,rs511134,-1,G,A,119055223,57219,118801396,119194612,253827
11,ENSG00000254905.1,126294254,11-126196145-C-A,rs515917,-1,C,A,126196145,98109,126097646,126490862,98499
11,ENSG00000254905.1,126294254,11-126196145-C-T,rs515917,-1,C,T,126196145,98109,126097646,126490862,98499
11,ENSG00000255959.1,60842965,11-60860110-C-T,rs533116,-1,C,T,60860110,17145,60646357,61039573,213753
11,ENSG00000254759.1,126067539,11-126139605-T-G,rs541601,1,T,G,126139605,72066,125870931,126264147,268674
11,ENSG00000254759.1,126067539,11-126139605-T-A,rs541601,1,T,A,126139605,72066,125870931,126264147,268674
11,ENSG00000254759.1,126067539,11-126139605-T-C,rs541601,1,T,C,126139605,72066,125870931,126264147,268674
11,ENSG00000254455.1,65145972,11-65035879-A-G,rs562590,-1,A,G,65035879,110093,64949364,65342580,86515
11,ENSG00000255153.1,1309769,11-1301483-G-C,rs5743905,1,G,C,1301483,8286,1113161,1506377,188322
11,ENSG00000255153.1,1309769,11-1301483-G-T,rs5743905,1,G,T,1301483,8286,1113161,1506377,188322
11,ENSG00000254704.3,59289486,11-59463399-G-T,rs61041512,-1,G,T,59463399,173913,59092878,59486094,370521
11,ENSG00000254704.3,59289486,11-59463399-G-A,rs61041512,-1,G,A,59463399,173913,59092878,59486094,370521
11,ENSG00000214797.3,59284033,11-59463399-G-T,rs61041512,-1,G,T,59463399,179366,59087425,59480641,375974
11,ENSG00000214797.3,59284033,11-59463399-G-A,rs61041512,-1,G,A,59463399,179366,59087425,59480641,375974
11,ENSG00000254614.1,65180884,11-65210173-C-G,rs625750,-1,C,G,65210173,29289,64984276,65377492,225897
11,ENSG00000254614.1,65180884,11-65210173-C-T,rs625750,-1,C,T,65210173,29289,64984276,65377492,225897
11,ENSG00000225101.3,4474813,11-4433683-T-G,rs6578494,1,T,G,4433683,41130,4278205,4671421,155478
11,ENSG00000225101.3,4474813,11-4433683-T-C,rs6578494,1,T,C,4433683,41130,4278205,4671421,155478
11,ENSG00000261098.1,107316271,11-107386663-T-C,rs661889,-1,T,C,107386663,70392,107119663,107512879,267000
11,ENSG00000261098.1,107316271,11-107386663-T-G,rs661889,-1,T,G,107386663,70392,107119663,107512879,267000
11,ENSG00000261098.1,107316271,11-107386663-T-A,rs661889,-1,T,A,107386663,70392,107119663,107512879,267000
11,ENSG00000246790.2,121453013,11-121437816-G-T,rs668053,-1,G,T,121437816,15197,121256405,121649621,181411
11,ENSG00000246790.2,121453013,11-121437816-G-C,rs668053,-1,G,C,121437816,15197,121256405,121649621,181411
11,ENSG00000246790.2,121453013,11-121437816-G-A,rs668053,-1,G,A,121437816,15197,121256405,121649621,181411
11,ENSG00000206597.1,62665422,11-62498829-T-C,rs677800,1,T,C,62498829,166593,62468814,62862030,30015
11,ENSG00000206597.1,62665422,11-62498829-T-G,rs677800,1,T,G,62498829,166593,62468814,62862030,30015
11,ENSG00000254829.1,78015715,11-78085671-G-A,rs681717,1,G,A,78085671,69956,77819107,78212323,266564
11,ENSG00000227097.4,82689559,11-82547997-T-G,rs7101721,1,T,G,82547997,141562,82492951,82886167,55046
11,ENSG00000227097.4,82689559,11-82547997-T-C,rs7101721,1,T,C,82547997,141562,82492951,82886167,55046
11,ENSG00000245248.2,119381810,11-119429984-G-A,rs7102696,1,G,A,119429984,48174,119185202,119578418,244782
11,ENSG00000246308.1,10809204,11-10827877-T-C,rs7106243,1,T,C,10827877,18673,10612596,11005812,215281
11,ENSG00000254851.1,117135528,11-116958937-T-A,rs7120173,1,T,A,116958937,176591,116938920,117332136,20017
11,ENSG00000254851.1,117135528,11-116958937-T-C,rs7120173,1,T,C,116958937,176591,116938920,117332136,20017
11,ENSG00000254851.1,117135528,11-116958937-T-G,rs7120173,1,T,G,116958937,176591,116938920,117332136,20017
11,ENSG00000183562.2,2989863,11-2988208-T-C,rs7127415,1,T,C,2988208,1655,2793255,3186471,194953
11,ENSG00000254985.1,77718411,11-77793950-T-C,rs728130,-1,T,C,77793950,75539,77521803,77915019,272147
11,ENSG00000213275.2,69303807,11-69114776-C-T,rs73520512,-1,C,T,69114776,189031,69107199,69500415,7577
11,ENSG00000255521.1,35138032,11-35052453-C-T,rs737503,-1,C,T,35052453,85579,34941424,35334640,111029
11,ENSG00000173727.7,65455269,11-65389623-C-T,rs739389,1,C,T,65389623,65646,65258661,65651877,130962
11,ENSG00000173727.7,65455269,11-65389623-C-A,rs739389,1,C,A,65389623,65646,65258661,65651877,130962
11,ENSG00000254910.1,311141,11-331326-C-G,rs7395319,-1,C,G,331326,20185,114533,507749,216793
11,ENSG00000254910.1,311141,11-331326-C-T,rs7395319,-1,C,T,331326,20185,114533,507749,216793
11,ENSG00000251661.2,318653,11-331326-C-G,rs7395319,1,C,G,331326,12673,122045,515261,209281
11,ENSG00000251661.2,318653,11-331326-C-T,rs7395319,1,C,T,331326,12673,122045,515261,209281
11,ENSG00000255284.1,777574,11-752059-A-C,rs7478765,1,A,C,752059,25515,580966,974182,171093
11,ENSG00000255284.1,777574,11-752059-A-T,rs7478765,1,A,T,752059,25515,580966,974182,171093
11,ENSG00000255210.1,110049528,11-110050444-G-A,rs75480922,1,G,A,110050444,916,109852920,110246136,197524
11,ENSG00000241782.1,77869195,11-77806927-T-G,rs75713100,-1,T,G,77806927,62268,77672587,78065803,134340
11,ENSG00000241782.1,77869195,11-77806927-T-C,rs75713100,-1,T,C,77806927,62268,77672587,78065803,134340
11,ENSG00000255139.1,59565923,11-59639387-C-T,rs76129882,1,C,T,59639387,73464,59369315,59762531,270072
11,ENSG00000255139.1,59565923,11-59639387-C-G,rs76129882,1,C,G,59639387,73464,59369315,59762531,270072
11,ENSG00000255045.1,124746337,11-124852526-G-A,rs76175102,-1,G,A,124852526,106189,124549729,124942945,302797
11,ENSG00000256779.1,95037482,11-94951753-C-G,rs765669,1,C,G,94951753,85729,94840874,95234090,110879
11,ENSG00000256779.1,95037482,11-94951753-C-T,rs765669,1,C,T,94951753,85729,94840874,95234090,110879
11,ENSG00000184224.3,67606706,11-67633144-G-A,rs77633476,-1,G,A,67633144,26438,67410098,67803314,223046
11,ENSG00000181109.3,5726502,11-5726992-T-C,rs7933860,1,T,C,5726992,490,5529894,5923110,197098
11,ENSG00000243802.2,47191542,11-47084763-G-A,rs7938933,-1,G,A,47084763,106779,46994934,47388150,89829
11,ENSG00000256034.1,73760563,11-73770202-G-A,rs79532972,1,G,A,73770202,9639,73563955,73957171,206247
11,ENSG00000236935.1,64340154,11-64269561-G-A,rs876064,-1,G,A,64269561,70593,64143546,64536762,126015
11,ENSG00000255292.1,112086903,11-112118945-G-T,rs919478,1,G,T,112118945,32042,111890295,112283511,228650
11,ENSG00000254860.1,8965048,11-9023220-G-A,rs932287,1,G,A,9023220,58172,8768440,9161656,254780
11,ENSG00000254860.1,8965048,11-9023220-G-C,rs932287,1,G,C,9023220,58172,8768440,9161656,254780
10,ENSG00000229124.1,17230018,10-17243290-T-C,rs1037008,-1,T,C,17243290,13272,17033410,17426626,209880
10,ENSG00000240996.1,89697928,10-89857367-A-G,rs10509582,-1,A,G,89857367,159439,89501320,89894536,356047
10,ENSG00000227437.1,119638456,10-119770053-G-A,rs10510058,1,G,A,119770053,131597,119441848,119835064,328205
10,ENSG00000224597.3,29409618,10-29468890-T-C,rs1053636,1,T,C,29468890,59272,29213010,29606226,255880
10,ENSG00000224597.3,29409618,10-29468890-T-A,rs1053636,1,T,A,29468890,59272,29213010,29606226,255880
10,ENSG00000224934.1,99431138,10-99499226-T-A,rs10748777,1,T,A,99499226,68088,99234530,99627746,264696
10,ENSG00000224934.1,99431138,10-99499226-T-G,rs10748777,1,T,G,99499226,68088,99234530,99627746,264696
10,ENSG00000224934.1,99431138,10-99499226-T-C,rs10748777,1,T,C,99499226,68088,99234530,99627746,264696
10,ENSG00000259994.1,30306066,10-30354943-G-A,rs10826790,-1,G,A,30354943,48877,30109458,30502674,245485
10,ENSG00000240291.1,18545651,10-18549925-A-T,rs10828896,-1,A,T,18549925,4274,18349043,18742259,200882
10,ENSG00000240291.1,18545651,10-18549925-A-G,rs10828896,-1,A,G,18549925,4274,18349043,18742259,200882
10,ENSG00000213770.3,27350290,10-27486359-T-C,rs10829261,-1,T,C,27486359,136069,27153682,27546898,332677
10,ENSG00000244332.1,94577439,10-94740174-A-T,rs10882494,1,A,T,94740174,162735,94380831,94774047,359343
10,ENSG00000244332.1,94577439,10-94740174-A-G,rs10882494,1,A,G,94740174,162735,94380831,94774047,359343
10,ENSG00000232470.1,110869743,10-110828597-G-A,rs10885054,1,G,A,110828597,41146,110673135,111066351,155462
10,ENSG00000226864.1,121948188,10-121950102-A-C,rs10887029,1,A,C,121950102,1914,121751580,122144796,198522
10,ENSG00000227474.1,13592323,10-13515960-A-C,rs10906399,-1,A,C,13515960,76363,13395715,13788931,120245
10,ENSG00000227972.1,52411135,10-52289599-A-C,rs11001472,1,A,C,52289599,121536,52214527,52607743,75072
10,ENSG00000227972.1,52411135,10-52289599-A-G,rs11001472,1,A,G,52289599,121536,52214527,52607743,75072
10,ENSG00000226659.1,80536026,10-80535642-G-T,rs11185932,-1,G,T,80535642,384,80339418,80732634,196224
10,ENSG00000226659.1,80536026,10-80535642-G-A,rs11185932,-1,G,A,80535642,384,80339418,80732634,196224
10,ENSG00000213449.2,91667782,10-91688106-G-T,rs11186660,-1,G,T,91688106,20324,91471174,91864390,216932
10,ENSG00000213449.2,91667782,10-91688106-G-A,rs11186660,-1,G,A,91688106,20324,91471174,91864390,216932
10,ENSG00000230091.1,80078895,10-80122198-G-T,rs11201799,-1,G,T,80122198,43303,79882287,80275503,239911
10,ENSG00000230091.1,80078895,10-80122198-G-A,rs11201799,-1,G,A,80122198,43303,79882287,80275503,239911
10,ENSG00000228021.1,125683243,10-125748205-T-A,rs11244632,1,T,A,125748205,64962,125486635,125879851,261570
10,ENSG00000228021.1,125683243,10-125748205-T-C,rs11244632,1,T,C,125748205,64962,125486635,125879851,261570
10,ENSG00000230131.1,123358279,10-123482767-C-T,rs11248546,1,C,T,123482767,124488,123161671,123554887,321096
10,ENSG00000230131.1,123358279,10-123482767-C-A,rs11248546,1,C,A,123482767,124488,123161671,123554887,321096
10,ENSG00000235100.2,89701416,10-89680299-G-A,rs11599335,-1,G,A,89680299,21117,89504808,89898024,175491
10,ENSG00000176236.4,15097319,10-15097371-G-A,rs117151080,-1,G,A,15097371,52,14900711,15293927,196660
10,ENSG00000176236.4,15097319,10-15097371-G-T,rs117151080,-1,G,T,15097371,52,14900711,15293927,196660
10,ENSG00000176236.4,15097319,10-15097371-G-C,rs117151080,-1,G,C,15097371,52,14900711,15293927,196660
10,ENSG00000228657.1,102573225,10-102503756-G-A,rs117169851,-1,G,A,102503756,69469,102376617,102769833,127139
10,ENSG00000204682.5,21497071,10-21346866-T-G,rs117470310,-1,T,G,21346866,150205,21300463,21693679,46403
10,ENSG00000204682.5,21497071,10-21346866-T-C,rs117470310,-1,T,C,21346866,150205,21300463,21693679,46403
10,ENSG00000228755.1,42281819,10-42238566-A-C,rs118068376,-1,A,C,42238566,43253,42085211,42478427,153355
10,ENSG00000180066.5,132445189,10-132385605-C-T,rs11814053,1,C,T,132385605,59584,132248581,132641797,137024
10,ENSG00000254536.1,133380026,10-133535779-A-G,rs11818144,1,A,G,133535779,155753,133183418,133576634,352361
10,ENSG00000225137.1,50264978,10-50437638-C-T,rs1203408,1,C,T,50437638,172660,50068370,50461586,369268
10,ENSG00000237590.1,44261813,10-44225704-A-G,rs12219104,-1,A,G,44225704,36109,44065205,44458421,160499
10,ENSG00000229001.1,69022778,10-69170604-A-G,rs12256853,1,A,G,69170604,147826,68826170,69219386,344434
10,ENSG00000234017.1,112548872,10-112611182-T-A,rs12260096,-1,T,A,112611182,62310,112352264,112745480,258918
10,ENSG00000230306.1,133344906,10-133190047-C-T,rs12359206,-1,C,T,133190047,154859,133148298,133541514,41749
10,ENSG00000229919.2,10174230,10-10177030-C-A,rs12360103,1,C,A,10177030,2800,9977622,10370838,199408
10,ENSG00000229919.2,10174230,10-10177030-C-T,rs12360103,1,C,T,10177030,2800,9977622,10370838,199408
10,ENSG00000261011.1,87001636,10-86966982-G-A,rs1240388,1,G,A,86966982,34654,86805028,87198244,161954
10,ENSG00000261011.1,87001636,10-86966982-G-T,rs1240388,1,G,T,86966982,34654,86805028,87198244,161954
10,ENSG00000261011.1,87001636,10-86966982-G-C,rs1240388,1,G,C,86966982,34654,86805028,87198244,161954
10,ENSG00000229870.1,49815096,10-49744990-T-A,rs1258172,1,T,A,49744990,70106,49618488,50011704,126502
10,ENSG00000229870.1,49815096,10-49744990-T-C,rs1258172,1,T,C,49744990,70106,49618488,50011704,126502
10,ENSG00000230224.1,100248271,10-100297811-T-C,rs12781019,1,T,C,100297811,49540,100051663,100444879,246148
10,ENSG00000213513.3,77781876,10-77944636-C-T,rs1366047,-1,C,T,77944636,162760,77585268,77978484,359368
10,ENSG00000213513.3,77781876,10-77944636-C-A,rs1366047,-1,C,A,77944636,162760,77585268,77978484,359368
10,ENSG00000236154.1,69572906,10-69694167-G-A,rs16926612,1,G,A,69694167,121261,69376298,69769514,317869
10,ENSG00000213700.3,73006595,10-72877840-A-G,rs16930150,-1,A,G,72877840,128755,72809987,73203203,67853
10,ENSG00000236756.3,73247360,10-73247830-A-C,rs16930466,1,A,C,73247830,470,73050752,73443968,197078
10,ENSG00000236756.3,73247360,10-73247830-A-G,rs16930466,1,A,G,73247830,470,73050752,73443968,197078
10,ENSG00000230555.1,43420738,10-43388447-T-A,rs17153601,1,T,A,43388447,32291,43224130,43617346,164317
10,ENSG00000238280.1,62805887,10-62793174-A-G,rs1848797,-1,A,G,62793174,12713,62609279,63002495,183895
10,ENSG00000231233.1,104353625,10-104523220-G-A,rs1999108,-1,G,A,104523220,169595,104157017,104550233,366203
10,ENSG00000231233.1,104353625,10-104523220-G-C,rs1999108,-1,G,C,104523220,169595,104157017,104550233,366203
10,ENSG00000231233.1,104353625,10-104523220-G-T,rs1999108,-1,G,T,104523220,169595,104157017,104550233,366203
10,ENSG00000228701.1,91798309,10-91797862-C-A,rs2066276,-1,C,A,91797862,447,91601701,91994917,196161
10,ENSG00000228701.1,91798309,10-91797862-C-G,rs2066276,-1,C,G,91797862,447,91601701,91994917,196161
10,ENSG00000228701.1,91798309,10-91797862-C-T,rs2066276,-1,C,T,91797862,447,91601701,91994917,196161
10,ENSG00000226646.1,35697300,10-35592898-G-A,rs2216520,1,G,A,35592898,104402,35500692,35893908,92206
10,ENSG00000232591.1,7472040,10-7451736-T-C,rs2247475,-1,T,C,7451736,20304,7275432,7668648,176304
10,ENSG00000232591.1,7472040,10-7451736-T-A,rs2247475,-1,T,A,7451736,20304,7275432,7668648,176304
10,ENSG00000260917.1,112823490,10-112819235-G-A,rs2479124,1,G,A,112819235,4255,112626882,113020098,192353
10,ENSG00000260917.1,112823490,10-112819235-G-C,rs2479124,1,G,C,112819235,4255,112626882,113020098,192353
10,ENSG00000227253.1,32266289,10-32387756-C-T,rs2505342,1,C,T,32387756,121467,32069681,32462897,318075
10,ENSG00000227253.1,32266289,10-32387756-C-A,rs2505342,1,C,A,32387756,121467,32069681,32462897,318075
10,ENSG00000227253.1,32266289,10-32387756-C-G,rs2505342,1,C,G,32387756,121467,32069681,32462897,318075
10,ENSG00000215146.3,42353011,10-42368653-A-G,rs2505803,-1,A,G,42368653,15642,42156403,42549619,212250
10,ENSG00000215146.3,42353011,10-42368653-A-C,rs2505803,-1,A,C,42368653,15642,42156403,42549619,212250
10,ENSG00000228748.1,77782866,10-77971601-A-C,rs2559661,1,A,C,77971601,188735,77586258,77979474,385343
10,ENSG00000228748.1,77782866,10-77971601-A-G,rs2559661,1,A,G,77971601,188735,77586258,77979474,385343
10,ENSG00000228748.1,77782866,10-77971601-A-T,rs2559661,1,A,T,77971601,188735,77586258,77979474,385343
10,ENSG00000236514.1,37857740,10-37904201-T-G,rs2738225,1,T,G,37904201,46461,37661132,38054348,243069
10,ENSG00000236514.1,37857740,10-37904201-T-A,rs2738225,1,T,A,37904201,46461,37661132,38054348,243069
10,ENSG00000233122.1,130106046,10-130070104-T-G,rs2765491,1,T,G,130070104,35942,129909438,130302654,160666
10,ENSG00000233122.1,130106046,10-130070104-T-A,rs2765491,1,T,A,130070104,35942,129909438,130302654,160666
10,ENSG00000233122.1,130106046,10-130070104-T-C,rs2765491,1,T,C,130070104,35942,129909438,130302654,160666
10,ENSG00000234743.1,80247683,10-80161797-T-C,rs2784774,-1,T,C,80161797,85886,80051075,80444291,110722
10,ENSG00000234743.1,80247683,10-80161797-T-A,rs2784774,-1,T,A,80161797,85886,80051075,80444291,110722
10,ENSG00000234743.1,80247683,10-80161797-T-G,rs2784774,-1,T,G,80161797,85886,80051075,80444291,110722
10,ENSG00000230425.1,42725857,10-42890717-G-A,rs2795517,1,G,A,42890717,164860,42529249,42922465,361468
10,ENSG00000214881.4,68544833,10-68537778-T-G,rs2795883,-1,T,G,68537778,7055,68348225,68741441,189553
10,ENSG00000214881.4,68544833,10-68537778-T-C,rs2795883,-1,T,C,68537778,7055,68348225,68741441,189553
10,ENSG00000214881.4,68544833,10-68537778-T-A,rs2795883,-1,T,A,68537778,7055,68348225,68741441,189553
10,ENSG00000234026.1,95231144,10-95238762-T-A,rs2860998,-1,T,A,95238762,7618,95034536,95427752,204226
10,ENSG00000234026.1,95231144,10-95238762-T-C,rs2860998,-1,T,C,95238762,7618,95034536,95427752,204226
10,ENSG00000231187.2,46598150,10-46550427-T-C,rs3127679,-1,T,C,46550427,47723,46401542,46794758,148885
10,ENSG00000231187.2,46598150,10-46550427-T-A,rs3127679,-1,T,A,46550427,47723,46401542,46794758,148885
10,ENSG00000227096.1,116440044,10-116597401-G-T,rs34708330,-1,G,T,116597401,157357,116243436,116636652,353965
10,ENSG00000227096.1,116440044,10-116597401-G-C,rs34708330,-1,G,C,116597401,157357,116243436,116636652,353965
10,ENSG00000229605.4,28899484,10-28721489-C-T,rs34718559,-1,C,T,28721489,177995,28702876,29096092,18613
10,ENSG00000229605.4,28899484,10-28721489-C-A,rs34718559,-1,C,A,28721489,177995,28702876,29096092,18613
10,ENSG00000212743.1,6350316,10-6178690-C-T,rs34836742,1,C,T,6178690,171626,6153708,6546924,24982
10,ENSG00000215151.4,38601418,10-38741984-G-A,rs35322563,1,G,A,38741984,140566,38404810,38798026,337174
10,ENSG00000215151.4,38601418,10-38741984-G-T,rs35322563,1,G,T,38741984,140566,38404810,38798026,337174
10,ENSG00000242338.1,73728580,10-73773690-A-G,rs3740289,-1,A,G,73773690,45110,73531972,73925188,241718
10,ENSG00000099251.10,38356455,10-38265765-T-C,rs4641407,1,T,C,38265765,90690,38159847,38553063,105918
10,ENSG00000242288.3,73730466,10-73717540-A-G,rs4746143,-1,A,G,73717540,12926,73533858,73927074,183682
10,ENSG00000244733.1,79660891,10-79818903-C-G,rs4933801,1,C,G,79818903,158012,79464283,79857499,354620
10,ENSG00000244733.1,79660891,10-79818903-C-A,rs4933801,1,C,A,79818903,158012,79464283,79857499,354620
10,ENSG00000244733.1,79660891,10-79818903-C-T,rs4933801,1,C,T,79818903,158012,79464283,79857499,354620
10,ENSG00000225484.2,79806086,10-79837228-C-G,rs4933929,-1,C,G,79837228,31142,79609478,80002694,227750
10,ENSG00000225484.2,79806086,10-79837228-C-A,rs4933929,-1,C,A,79837228,31142,79609478,80002694,227750
10,ENSG00000231345.2,50658529,10-50598525-G-A,rs4935734,1,G,A,50598525,60004,50461921,50855137,136604
10,ENSG00000226200.1,50624943,10-50598525-G-A,rs4935734,1,G,A,50598525,26418,50428335,50821551,170190
10,ENSG00000237470.2,15021863,10-14832693-G-A,rs6602768,-1,G,A,14832693,189170,14825255,15218471,7438
10,ENSG00000233690.1,99697949,10-99607558-C-T,rs7068079,-1,C,T,99607558,90391,99501341,99894557,106217
10,ENSG00000233690.1,99697949,10-99607558-C-A,rs7068079,-1,C,A,99607558,90391,99501341,99894557,106217
10,ENSG00000233144.1,73381433,10-73231803-A-G,rs7068969,1,A,G,73231803,149630,73184825,73578041,46978
10,ENSG00000232807.1,5945900,10-5906675-C-T,rs7082434,-1,C,T,5906675,39225,5749292,6142508,157383
10,ENSG00000262412.1,27243130,10-27191120-T-G,rs7086553,1,T,G,27191120,52010,27046522,27439738,144598
10,ENSG00000262412.1,27243130,10-27191120-T-C,rs7086553,1,T,C,27191120,52010,27046522,27439738,144598
10,ENSG00000234814.3,30655651,10-30543135-T-G,rs7092510,1,T,G,30543135,112516,30459043,30852259,84092
10,ENSG00000223482.1,87342403,10-87201095-A-G,rs7093841,-1,A,G,87201095,141308,87145795,87539011,55300
10,ENSG00000232936.1,89645272,10-89663111-G-T,rs7098233,1,G,T,89663111,17839,89448664,89841880,214447
10,ENSG00000254635.1,28532743,10-28501070-A-G,rs7098928,-1,A,G,28501070,31673,28336135,28729351,164935
10,ENSG00000235962.4,33058407,10-33137311-G-C,rs722987,-1,G,C,33137311,78904,32861799,33255015,275512
10,ENSG00000235962.4,33058407,10-33137311-G-T,rs722987,-1,G,T,33137311,78904,32861799,33255015,275512
10,ENSG00000235962.4,33058407,10-33137311-G-A,rs722987,-1,G,A,33137311,78904,32861799,33255015,275512
10,ENSG00000225053.1,8161260,10-8187668-G-A,rs72784701,1,G,A,8187668,26408,7964652,8357868,223016
10,ENSG00000221817.2,73496287,10-73483718-G-A,rs72814306,1,G,A,73483718,12569,73299679,73692895,184039
10,ENSG00000231060.1,80778088,10-80923464-T-A,rs729724,-1,T,A,80923464,145376,80581480,80974696,341984
10,ENSG00000231060.1,80778088,10-80923464-T-G,rs729724,-1,T,G,80923464,145376,80581480,80974696,341984
10,ENSG00000231060.1,80778088,10-80923464-T-C,rs729724,-1,T,C,80923464,145376,80581480,80974696,341984
10,ENSG00000165511.4,45000888,10-45052918-A-T,rs7478211,-1,A,T,45052918,52030,44804280,45197496,248638
10,ENSG00000165511.4,45000888,10-45052918-A-G,rs7478211,-1,A,G,45052918,52030,44804280,45197496,248638
10,ENSG00000230534.1,35126657,10-35259297-T-C,rs76458677,-1,T,C,35259297,132640,34930049,35323265,329248
10,ENSG00000213412.3,46415853,10-46237566-C-A,rs77893994,1,C,A,46237566,178287,46219245,46612461,18321
10,ENSG00000213412.3,46415853,10-46237566-C-T,rs77893994,1,C,T,46237566,178287,46219245,46612461,18321
10,ENSG00000232229.1,89829510,10-89827644-G-A,rs7895851,1,G,A,89827644,1866,89632902,90026118,194742
10,ENSG00000215244.1,6271169,10-6321985-A-T,rs7919350,1,A,T,6321985,50816,6074561,6467777,247424
10,ENSG00000215244.1,6271169,10-6321985-A-G,rs7919350,1,A,G,6321985,50816,6074561,6467777,247424
10,ENSG00000228169.3,114690634,10-114814931-T-G,rs808272,-1,T,G,114814931,124297,114494026,114887242,320905
10,ENSG00000228754.1,48746128,10-48589427-G-T,rs870353,-1,G,T,48589427,156701,48549520,48942736,39907
10,ENSG00000151303.10,86992406,10-87035113-T-C,rs9421560,1,T,C,87035113,42707,86795798,87189014,239315
10,ENSG00000230322.1,11171376,10-11172255-A-T,rs9424123,-1,A,T,11172255,879,10974768,11367984,197487
10,ENSG00000230322.1,11171376,10-11172255-A-G,rs9424123,-1,A,G,11172255,879,10974768,11367984,197487
10,ENSG00000228753.1,21028999,10-20992322-A-C,rs946861,1,A,C,20992322,36677,20832391,21225607,159931
10,ENSG00000203497.2,110872253,10-110843268-A-G,rs9633680,-1,A,G,110843268,28985,110675645,111068861,167623
10,ENSG00000260917.1,112823490,10-112816994-C-T,rs1047468,1,C,T,112816994,6496,112626882,113020098,190112
10,ENSG00000260917.1,112823490,10-112816994-C-G,rs1047468,1,C,G,112816994,6496,112626882,113020098,190112
10,ENSG00000260917.1,112823490,10-112816994-C-A,rs1047468,1,C,A,112816994,6496,112626882,113020098,190112
10,ENSG00000216740.2,64825572,10-64661329-C-T,rs10761856,1,C,T,64661329,164243,64628964,65022180,32365
10,ENSG00000235100.2,89701416,10-89806827-A-G,rs10785903,-1,A,G,89806827,105411,89504808,89898024,302019
10,ENSG00000220585.3,91053051,10-91162041-C-A,rs10785991,1,C,A,91162041,108990,90856443,91249659,305598
10,ENSG00000220585.3,91053051,10-91162041-C-G,rs10785991,1,C,G,91162041,108990,90856443,91249659,305598
10,ENSG00000236552.1,96750288,10-96606828-A-G,rs10786304,1,A,G,96606828,143460,96553680,96946896,53148
10,ENSG00000237840.1,45722439,10-45591835-A-G,rs10793620,-1,A,G,45591835,130604,45525831,45919047,66004
10,ENSG00000178429.8,84560443,10-84519497-T-C,rs10887315,1,T,C,84519497,40946,84363835,84757051,155662
10,ENSG00000178429.8,84560443,10-84519497-T-G,rs10887315,1,T,G,84519497,40946,84363835,84757051,155662
10,ENSG00000230091.1,80078895,10-80055712-G-C,rs10887442,-1,G,C,80055712,23183,79882287,80275503,173425
10,ENSG00000230091.1,80078895,10-80055712-G-A,rs10887442,-1,G,A,80055712,23183,79882287,80275503,173425
10,ENSG00000230091.1,80078895,10-80055712-G-T,rs10887442,-1,G,T,80055712,23183,79882287,80275503,173425
10,ENSG00000234961.1,17234833,10-17267905-C-T,rs10904913,-1,C,T,17267905,33072,17038225,17431441,229680
10,ENSG00000214881.4,68544833,10-68422923-C-T,rs10998153,-1,C,T,68422923,121910,68348225,68741441,74698
10,ENSG00000242338.1,73728580,10-73835746-A-G,rs11000790,-1,A,G,73835746,107166,73531972,73925188,303774
10,ENSG00000242338.1,73728580,10-73835746-A-C,rs11000790,-1,A,C,73835746,107166,73531972,73925188,303774
10,ENSG00000213513.3,77781876,10-77825189-A-G,rs11002305,-1,A,G,77825189,43313,77585268,77978484,239921
10,ENSG00000240291.1,18545651,10-18490395-G-C,rs11014484,-1,G,C,18490395,55256,18349043,18742259,141352
10,ENSG00000229278.1,99659284,10-99500686-C-A,rs11190120,-1,C,A,99500686,158598,99462676,99855892,38010
10,ENSG00000227165.1,120851209,10-120772235-C-T,rs11199541,-1,C,T,120772235,78974,120654601,121047817,117634
10,ENSG00000233533.1,36944738,10-36872606-A-G,rs111998417,-1,A,G,36872606,72132,36748130,37141346,124476
10,ENSG00000214297.3,125667950,10-125502466-A-G,rs11244521,-1,A,G,125502466,165484,125471342,125864558,31124
10,ENSG00000224023.5,125719460,10-125748205-T-C,rs11244632,-1,T,C,125748205,28745,125522852,125916068,225353
10,ENSG00000224023.5,125719460,10-125748205-T-A,rs11244632,-1,T,A,125748205,28745,125522852,125916068,225353
10,ENSG00000232591.1,7472040,10-7484062-G-A,rs1157042,-1,G,A,7484062,12022,7275432,7668648,208630
10,ENSG00000229644.4,36524234,10-36358842-G-A,rs11593579,-1,G,A,36358842,165392,36327626,36720842,31216
10,ENSG00000228828.1,37820982,10-37742055-G-A,rs11815066,-1,G,A,37742055,78927,37624374,38017590,117681
10,ENSG00000226200.1,50624943,10-50471969-C-A,rs1203380,1,C,A,50471969,152974,50428335,50821551,43634
10,ENSG00000232936.1,89645272,10-89660239-C-A,rs12218194,1,C,A,89660239,14967,89448664,89841880,211575
10,ENSG00000232936.1,89645272,10-89660239-C-T,rs12218194,1,C,T,89660239,14967,89448664,89841880,211575
10,ENSG00000235677.1,96560185,10-96698294-G-A,rs12266911,1,G,A,96698294,138109,96363577,96756793,334717
10,ENSG00000180221.6,58213036,10-58312730-G-A,rs12267431,-1,G,A,58312730,99694,58016428,58409644,296302
10,ENSG00000231964.1,45453121,10-45354505-G-A,rs12359547,-1,G,A,45354505,98616,45256513,45649729,97992
10,ENSG00000215146.3,42353011,10-42483806-C-G,rs1255406,-1,C,G,42483806,130795,42156403,42549619,327403
10,ENSG00000215146.3,42353011,10-42483806-C-A,rs1255406,-1,C,A,42483806,130795,42156403,42549619,327403
10,ENSG00000215146.3,42353011,10-42483806-C-T,rs1255406,-1,C,T,42483806,130795,42156403,42549619,327403
10,ENSG00000232807.1,5945900,10-6035857-G-A,rs12722525,-1,G,A,6035857,89957,5749292,6142508,286565
10,ENSG00000232807.1,5945900,10-6035857-G-C,rs12722525,-1,G,C,6035857,89957,5749292,6142508,286565
10,ENSG00000227173.1,65169869,10-65354810-T-G,rs1504467,-1,T,G,65354810,184941,64973261,65366477,381549
10,ENSG00000227173.1,65169869,10-65354810-T-A,rs1504467,-1,T,A,65354810,184941,64973261,65366477,381549
10,ENSG00000227173.1,65169869,10-65354810-T-C,rs1504467,-1,T,C,65354810,184941,64973261,65366477,381549
10,ENSG00000204682.5,21497071,10-21394895-T-C,rs16921796,-1,T,C,21394895,102176,21300463,21693679,94432
10,ENSG00000234175.1,13139533,10-13277184-C-T,rs17153041,-1,C,T,13277184,137651,12942925,13336141,334259
10,ENSG00000231970.1,97401115,10-97412994-A-G,rs1932001,1,A,G,97412994,11879,97204507,97597723,208487
10,ENSG00000226086.4,38080877,10-38117464-G-A,rs2021319,-1,G,A,38117464,36587,37884269,38277485,233195
10,ENSG00000213770.3,27350290,10-27535730-A-G,rs2172678,-1,A,G,27535730,185440,27153682,27546898,382048
10,ENSG00000213770.3,27350290,10-27535730-A-C,rs2172678,-1,A,C,27535730,185440,27153682,27546898,382048
10,ENSG00000226389.2,49771841,10-49630828-A-G,rs2177370,1,A,G,49630828,141013,49575233,49968449,55595
10,ENSG00000254635.1,28532743,10-28519170-G-A,rs2185293,-1,G,A,28519170,13573,28336135,28729351,183035
10,ENSG00000254635.1,28532743,10-28519170-G-T,rs2185293,-1,G,T,28519170,13573,28336135,28729351,183035
10,ENSG00000233690.1,99697949,10-99731933-G-A,rs2231679,-1,G,A,99731933,33984,99501341,99894557,230592
10,ENSG00000233690.1,99697949,10-99731933-G-T,rs2231679,-1,G,T,99731933,33984,99501341,99894557,230592
10,ENSG00000230534.1,35126657,10-35034708-G-C,rs2244100,-1,G,C,35034708,91949,34930049,35323265,104659
10,ENSG00000230534.1,35126657,10-35034708-G-A,rs2244100,-1,G,A,35034708,91949,34930049,35323265,104659
10,ENSG00000230534.1,35126657,10-35034708-G-T,rs2244100,-1,G,T,35034708,91949,34930049,35323265,104659
10,ENSG00000229256.1,103215709,10-103093820-T-G,rs2274340,1,T,G,103093820,121889,103019101,103412317,74719
10,ENSG00000229256.1,103215709,10-103093820-T-C,rs2274340,1,T,C,103093820,121889,103019101,103412317,74719
10,ENSG00000180066.5,132445189,10-132304496-C-T,rs2492651,1,C,T,132304496,140693,132248581,132641797,55915
10,ENSG00000230555.1,43420738,10-43360263-C-T,rs2493664,1,C,T,43360263,60475,43224130,43617346,136133
10,ENSG00000235316.1,73731824,10-73866615-T-G,rs2664283,1,T,G,73866615,134791,73535216,73928432,331399
10,ENSG00000235316.1,73731824,10-73866615-T-C,rs2664283,1,T,C,73866615,134791,73535216,73928432,331399
10,ENSG00000222047.4,73922777,10-73888491-C-A,rs2675677,-1,C,A,73888491,34286,73726169,74119385,162322
10,ENSG00000222047.4,73922777,10-73888491-C-T,rs2675677,-1,C,T,73888491,34286,73726169,74119385,162322
10,ENSG00000259994.1,30306066,10-30346819-C-T,rs2771247,-1,C,T,30346819,40753,30109458,30502674,237361
10,ENSG00000099251.10,38356455,10-38297980-C-T,rs2983858,1,C,T,38297980,58475,38159847,38553063,138133
10,ENSG00000236797.1,75382844,10-75506709-G-T,rs3012044,-1,G,T,75506709,123865,75186236,75579452,320473
10,ENSG00000236797.1,75382844,10-75506709-G-A,rs3012044,-1,G,A,75506709,123865,75186236,75579452,320473
10,ENSG00000234699.1,103452846,10-103465444-C-T,rs3014192,1,C,T,103465444,12598,103256238,103649454,209206
10,ENSG00000230224.1,100248271,10-100286623-T-G,rs33965491,1,T,G,100286623,38352,100051663,100444879,234960
10,ENSG00000230224.1,100248271,10-100286623-T-A,rs33965491,1,T,A,100286623,38352,100051663,100444879,234960
10,ENSG00000230224.1,100248271,10-100286623-T-C,rs33965491,1,T,C,100286623,38352,100051663,100444879,234960
10,ENSG00000165511.4,45000888,10-44978995-A-T,rs3818713,-1,A,T,44978995,21893,44804280,45197496,174715
10,ENSG00000165511.4,45000888,10-44978995-A-C,rs3818713,-1,A,C,44978995,21893,44804280,45197496,174715
10,ENSG00000233825.1,32346499,10-32220732-A-G,rs3891660,1,A,G,32220732,125767,32149891,32543107,70841
10,ENSG00000262412.1,27243130,10-27285852-A-G,rs4617487,1,A,G,27285852,42722,27046522,27439738,239330
10,ENSG00000250959.2,73731176,10-73806177-A-G,rs4746150,1,A,G,73806177,75001,73534568,73927784,271609
10,ENSG00000229919.2,10174230,10-10322566-T-C,rs4747852,1,T,C,10322566,148336,9977622,10370838,344944
10,ENSG00000229919.2,10174230,10-10322566-T-G,rs4747852,1,T,G,10322566,148336,9977622,10370838,344944
10,ENSG00000237399.1,3141632,10-3143045-A-G,rs4881109,1,A,G,3143045,1413,2945024,3338240,198021
10,ENSG00000227032.1,96621707,10-96770925-A-G,rs577981,-1,A,G,96770925,149218,96425099,96818315,345826
10,ENSG00000234118.1,110937233,10-110871453-G-C,rs6585018,-1,G,C,110871453,65780,110740625,111133841,130828
10,ENSG00000234118.1,110937233,10-110871453-G-T,rs6585018,-1,G,T,110871453,65780,110740625,111133841,130828
10,ENSG00000234118.1,110937233,10-110871453-G-A,rs6585018,-1,G,A,110871453,65780,110740625,111133841,130828
10,ENSG00000227540.1,73252791,10-73375688-C-T,rs6896,1,C,T,73375688,122897,73056183,73449399,319505
10,ENSG00000227540.1,73252791,10-73375688-C-A,rs6896,1,C,A,73375688,122897,73056183,73449399,319505
10,ENSG00000230322.1,11171376,10-11200817-G-A,rs7085721,-1,G,A,11200817,29441,10974768,11367984,226049
10,ENSG00000224597.3,29409618,10-29479570-C-T,rs7096453,1,C,T,29479570,69952,29213010,29606226,266560
10,ENSG00000226864.1,121948188,10-122091147-T-C,rs7101179,1,T,C,122091147,142959,121751580,122144796,339567
10,ENSG00000226864.1,121948188,10-122091147-T-A,rs7101179,1,T,A,122091147,142959,121751580,122144796,339567
10,ENSG00000225484.2,79806086,10-79828371-T-C,rs72820375,-1,T,C,79828371,22285,79609478,80002694,218893
10,ENSG00000225484.2,79806086,10-79828371-T-G,rs72820375,-1,T,G,79828371,22285,79609478,80002694,218893
10,ENSG00000235489.2,64170850,10-63976691-G-T,rs72832107,-1,G,T,63976691,194159,63974242,64367458,2449
10,ENSG00000235489.2,64170850,10-63976691-G-A,rs72832107,-1,G,A,63976691,194159,63974242,64367458,2449
10,ENSG00000234569.1,119621068,10-119443393-G-A,rs75555098,1,G,A,119443393,177675,119424460,119817676,18933
10,ENSG00000180230.6,119997709,10-120099403-C-T,rs78639536,-1,C,T,120099403,101694,119801101,120194317,298302
10,ENSG00000180230.6,119997709,10-120099403-C-G,rs78639536,-1,C,G,120099403,101694,119801101,120194317,298302
10,ENSG00000226659.1,80536026,10-80540091-A-C,rs7900957,-1,A,C,80540091,4065,80339418,80732634,200673
10,ENSG00000226659.1,80536026,10-80540091-A-G,rs7900957,-1,A,G,80540091,4065,80339418,80732634,200673
10,ENSG00000226659.1,80536026,10-80540091-A-T,rs7900957,-1,A,T,80540091,4065,80339418,80732634,200673
10,ENSG00000231345.2,50658529,10-50631076-A-G,rs7904101,1,A,G,50631076,27453,50461921,50855137,169155
10,ENSG00000220842.5,120355183,10-120411076-C-T,rs79205091,-1,C,T,120411076,55893,120158575,120551791,252501
10,ENSG00000230131.1,123358279,10-123474352-G-T,rs7922033,1,G,T,123474352,116073,123161671,123554887,312681
10,ENSG00000226688.1,96090239,10-96005008-T-A,rs7923326,-1,T,A,96005008,85231,95893631,96286847,111377
10,ENSG00000226688.1,96090239,10-96005008-T-C,rs7923326,-1,T,C,96005008,85231,95893631,96286847,111377
10,ENSG00000238280.1,62805887,10-62887744-A-C,rs9633562,-1,A,C,62887744,81857,62609279,63002495,278465
10,ENSG00000238280.1,62805887,10-62887744-A-T,rs9633562,-1,A,T,62887744,81857,62609279,63002495,278465
10,ENSG00000233837.1,42566677,10-42382133-T-C,rs9988706,1,T,C,42382133,184544,42370069,42763285,12064
10,ENSG00000232734.1,69433371,10-69378377-C-T,rs10128330,-1,C,T,69378377,54994,69236763,69629979,141614
10,ENSG00000228547.4,15000055,10-15103949-T-C,rs10242,-1,T,C,15103949,103894,14803447,15196663,300502
10,ENSG00000228547.4,15000055,10-15103949-T-G,rs10242,-1,T,G,15103949,103894,14803447,15196663,300502
10,ENSG00000227896.1,86521945,10-86581254-C-A,rs10887625,1,C,A,86581254,59309,86325337,86718553,255917
10,ENSG00000227896.1,86521945,10-86581254-C-T,rs10887625,1,C,T,86581254,59309,86325337,86718553,255917
10,ENSG00000254536.1,133380026,10-133207420-G-A,rs11101637,1,G,A,133207420,172606,133183418,133576634,24002
10,ENSG00000235100.2,89701416,10-89815975-A-C,rs11185893,-1,A,C,89815975,114559,89504808,89898024,311167
10,ENSG00000235100.2,89701416,10-89815975-A-T,rs11185893,-1,A,T,89815975,114559,89504808,89898024,311167
10,ENSG00000213449.2,91667782,10-91526259-T-C,rs11186600,-1,T,C,91526259,141523,91471174,91864390,55085
10,ENSG00000227165.1,120851209,10-120925036-T-C,rs11199656,-1,T,C,120925036,73827,120654601,121047817,270435
10,ENSG00000226864.1,121948188,10-121878789-T-C,rs11200207,1,T,C,121878789,69399,121751580,122144796,127209
10,ENSG00000226864.1,121948188,10-121878789-T-A,rs11200207,1,T,A,121878789,69399,121751580,122144796,127209
10,ENSG00000214362.2,95594598,10-95608056-G-C,rs112194607,1,G,C,95608056,13458,95397990,95791206,210066
10,ENSG00000214362.2,95594598,10-95608056-G-A,rs112194607,1,G,A,95608056,13458,95397990,95791206,210066
10,ENSG00000235763.1,13104793,10-13089135-G-C,rs11258183,-1,G,C,13089135,15658,12908185,13301401,180950
10,ENSG00000235763.1,13104793,10-13089135-G-A,rs11258183,-1,G,A,13089135,15658,12908185,13301401,180950
10,ENSG00000234961.1,17234833,10-17428163-G-A,rs11595574,-1,G,A,17428163,193330,17038225,17431441,389938
10,ENSG00000235816.2,63427297,10-63579157-G-A,rs117359294,1,G,A,63579157,151860,63230689,63623905,348468
10,ENSG00000229124.1,17230018,10-17114912-G-A,rs117959007,-1,G,A,17114912,115106,17033410,17426626,81502
10,ENSG00000224597.3,29409618,10-29420957-G-C,rs11816750,1,G,C,29420957,11339,29213010,29606226,207947
10,ENSG00000224597.3,29409618,10-29420957-G-A,rs11816750,1,G,A,29420957,11339,29213010,29606226,207947
10,ENSG00000229932.2,23136924,10-23237439-A-G,rs12255450,1,A,G,23237439,100515,22940316,23333532,297123
10,ENSG00000233665.1,48993046,10-48817559-C-T,rs12264297,-1,C,T,48817559,175487,48796438,49189654,21121
10,ENSG00000233665.1,48993046,10-48817559-C-A,rs12264297,-1,C,A,48817559,175487,48796438,49189654,21121
10,ENSG00000213574.2,118933295,10-118841747-C-T,rs12267145,-1,C,T,118841747,91548,118736687,119129903,105060
10,ENSG00000214279.6,133453945,10-133613032-A-G,rs12412913,1,A,G,133613032,159087,133257337,133650553,355695
10,ENSG00000232470.1,110869743,10-110810372-G-A,rs12572941,1,G,A,110810372,59371,110673135,111066351,137237
10,ENSG00000232470.1,110869743,10-110810372-G-C,rs12572941,1,G,C,110810372,59371,110673135,111066351,137237
10,ENSG00000234026.1,95231144,10-95272855-T-C,rs12769370,-1,T,C,95272855,41711,95034536,95427752,238319
10,ENSG00000230534.1,35126657,10-34997948-C-A,rs12772536,-1,C,A,34997948,128709,34930049,35323265,67899
10,ENSG00000232229.1,89829510,10-89808373-A-G,rs12776628,1,A,G,89808373,21137,89632902,90026118,175471
10,ENSG00000240291.1,18545651,10-18532145-A-G,rs12779641,-1,A,G,18532145,13506,18349043,18742259,183102
10,ENSG00000255339.2,100529881,10-100555064-A-G,rs17113209,-1,A,G,100555064,25183,100333273,100726489,221791
10,ENSG00000213412.3,46415853,10-46219720-T-C,rs17157255,1,T,C,46219720,196133,46219245,46612461,475
10,ENSG00000213412.3,46415853,10-46219720-T-G,rs17157255,1,T,G,46219720,196133,46219245,46612461,475
10,ENSG00000230565.1,43645942,10-43618762-A-C,rs17447650,1,A,C,43618762,27180,43449334,43842550,169428
10,ENSG00000235677.1,96560185,10-96545386-A-C,rs17482894,1,A,C,96545386,14799,96363577,96756793,181809
10,ENSG00000235677.1,96560185,10-96545386-A-T,rs17482894,1,A,T,96545386,14799,96363577,96756793,181809
10,ENSG00000213613.2,87945502,10-87826220-C-T,rs17702687,1,C,T,87826220,119282,87748894,88142110,77326
10,ENSG00000232709.1,92418667,10-92515052-A-G,rs17875327,1,A,G,92515052,96385,92222059,92615275,292993
10,ENSG00000244332.1,94577439,10-94670214-C-T,rs2104543,1,C,T,94670214,92775,94380831,94774047,289383
10,ENSG00000254635.1,28532743,10-28529607-A-C,rs2153302,-1,A,C,28529607,3136,28336135,28729351,193472
10,ENSG00000238280.1,62805887,10-62820301-T-G,rs224277,-1,T,G,62820301,14414,62609279,63002495,211022
10,ENSG00000238280.1,62805887,10-62820301-T-A,rs224277,-1,T,A,62820301,14414,62609279,63002495,211022
10,ENSG00000238280.1,62805887,10-62820301-T-C,rs224277,-1,T,C,62820301,14414,62609279,63002495,211022
10,ENSG00000233690.1,99697949,10-99873690-A-G,rs2256700,-1,A,G,99873690,175741,99501341,99894557,372349
10,ENSG00000229605.4,28899484,10-28925680-G-A,rs2368966,-1,G,A,28925680,26196,28702876,29096092,222804
10,ENSG00000229417.1,96190219,10-96360352-A-G,rs2901990,-1,A,G,96360352,170133,95993611,96386827,366741
10,ENSG00000229417.1,96190219,10-96360352-A-T,rs2901990,-1,A,T,96360352,170133,95993611,96386827,366741
10,ENSG00000231345.2,50658529,10-50567649-T-G,rs2983363,1,T,G,50567649,90880,50461921,50855137,105728
10,ENSG00000231345.2,50658529,10-50567649-T-A,rs2983363,1,T,A,50567649,90880,50461921,50855137,105728
10,ENSG00000231345.2,50658529,10-50567649-T-C,rs2983363,1,T,C,50567649,90880,50461921,50855137,105728
10,ENSG00000165511.4,45000888,10-45003561-A-G,rs3740093,-1,A,G,45003561,2673,44804280,45197496,199281
10,ENSG00000224023.5,125719460,10-125738019-C-A,rs3740180,-1,C,A,125738019,18559,125522852,125916068,215167
10,ENSG00000224023.5,125719460,10-125738019-C-T,rs3740180,-1,C,T,125738019,18559,125522852,125916068,215167
10,ENSG00000237399.1,3141632,10-3113161-C-T,rs3816699,1,C,T,3113161,28471,2945024,3338240,168137
10,ENSG00000230445.4,27251793,10-27211050-G-A,rs41314978,-1,G,A,27211050,40743,27055185,27448401,155865
10,ENSG00000230445.4,27251793,10-27211050-G-T,rs41314978,-1,G,T,27211050,40743,27055185,27448401,155865
10,ENSG00000230091.1,80078895,10-79994628-T-C,rs4357631,-1,T,C,79994628,84267,79882287,80275503,112341
10,ENSG00000230091.1,80078895,10-79994628-T-G,rs4357631,-1,T,G,79994628,84267,79882287,80275503,112341
10,ENSG00000236154.1,69572906,10-69647483-G-A,rs4746882,1,G,A,69647483,74577,69376298,69769514,271185
10,ENSG00000236154.1,69572906,10-69647483-G-C,rs4746882,1,G,C,69647483,74577,69376298,69769514,271185
10,ENSG00000234814.3,30655651,10-30558078-T-C,rs4749568,1,T,C,30558078,97573,30459043,30852259,99035
10,ENSG00000224914.1,87341685,10-87420357-C-A,rs4933443,1,C,A,87420357,78672,87145077,87538293,275280
10,ENSG00000224914.1,87341685,10-87420357-C-G,rs4933443,1,C,G,87420357,78672,87145077,87538293,275280
10,ENSG00000224914.1,87341685,10-87420357-C-T,rs4933443,1,C,T,87420357,78672,87145077,87538293,275280
10,ENSG00000236308.1,100190036,10-100328244-G-A,rs495734,1,G,A,100328244,138208,99993428,100386644,334816
10,ENSG00000236308.1,100190036,10-100328244-G-C,rs495734,1,G,C,100328244,138208,99993428,100386644,334816
10,ENSG00000236308.1,100190036,10-100328244-G-T,rs495734,1,G,T,100328244,138208,99993428,100386644,334816
10,ENSG00000228462.1,45073541,10-44896259-C-G,rs61853974,-1,C,G,44896259,177282,44876933,45270149,19326
10,ENSG00000228462.1,45073541,10-44896259-C-A,rs61853974,-1,C,A,44896259,177282,44876933,45270149,19326
10,ENSG00000228462.1,45073541,10-44896259-C-T,rs61853974,-1,C,T,44896259,177282,44876933,45270149,19326
10,ENSG00000231187.2,46598150,10-46458246-C-G,rs6599582,-1,C,G,46458246,139904,46401542,46794758,56704
10,ENSG00000231187.2,46598150,10-46458246-C-A,rs6599582,-1,C,A,46458246,139904,46401542,46794758,56704
10,ENSG00000231187.2,46598150,10-46458246-C-T,rs6599582,-1,C,T,46458246,139904,46401542,46794758,56704
10,ENSG00000233122.1,130106046,10-130113294-G-A,rs672142,1,G,A,130113294,7248,129909438,130302654,203856
10,ENSG00000213147.3,133778246,10-133592533-A-G,rs7089173,1,A,G,133592533,185713,133581638,133974854,10895
10,ENSG00000230306.1,133344906,10-133160491-G-A,rs71503783,-1,G,A,133160491,184415,133148298,133541514,12193
10,ENSG00000232591.1,7472040,10-7422888-T-G,rs72775588,-1,T,G,7422888,49152,7275432,7668648,147456
10,ENSG00000197308.4,8053484,10-8187668-G-A,rs72784701,-1,G,A,8187668,134184,7856876,8250092,330792
10,ENSG00000215146.3,42353011,10-42475056-A-G,rs72787863,-1,A,G,42475056,122045,42156403,42549619,318653
10,ENSG00000229001.1,69022778,10-68921954-C-T,rs73268355,1,C,T,68921954,100824,68826170,69219386,95784
10,ENSG00000229001.1,69022778,10-68921954-C-G,rs73268355,1,C,G,68921954,100824,68826170,69219386,95784
10,ENSG00000230555.1,43420738,10-43428198-G-A,rs74497314,1,G,A,43428198,7460,43224130,43617346,204068
10,ENSG00000262412.1,27243130,10-27119955-T-C,rs75027886,1,T,C,27119955,123175,27046522,27439738,73433
10,ENSG00000151303.10,86992406,10-86959812-G-A,rs760112,1,G,A,86959812,32594,86795798,87189014,164014
10,ENSG00000226318.1,67961464,10-68140688-T-G,rs76451279,-1,T,G,68140688,179224,67764856,68158072,375832
10,ENSG00000228195.2,116749905,10-116721716-G-A,rs78401167,1,G,A,116721716,28189,116553297,116946513,168419
10,ENSG00000183055.5,58715554,10-58731065-A-G,rs78740117,1,A,G,58731065,15511,58518946,58912162,212119
10,ENSG00000230469.1,69778962,10-69614392-G-C,rs78809390,1,G,C,69614392,164570,69582354,69975570,32038
10,ENSG00000230469.1,69778962,10-69614392-G-A,rs78809390,1,G,A,69614392,164570,69582354,69975570,32038
10,ENSG00000227695.1,99927159,10-99931871-G-C,rs7922447,1,G,C,99931871,4712,99730551,100123767,201320
10,ENSG00000227695.1,99927159,10-99931871-G-T,rs7922447,1,G,T,99931871,4712,99730551,100123767,201320
10,ENSG00000237470.2,15021863,10-14913317-G-T,rs79929834,-1,G,T,14913317,108546,14825255,15218471,88062
10,ENSG00000233261.1,26591310,10-26406821-T-A,rs867354,1,T,A,26406821,184489,26394702,26787918,12119
10,ENSG00000233261.1,26591310,10-26406821-T-C,rs867354,1,T,C,26406821,184489,26394702,26787918,12119
10,ENSG00000214807.2,124867510,10-124725883-G-T,rs869303,1,G,T,124725883,141627,124670902,125064118,54981
10,ENSG00000214807.2,124867510,10-124725883-G-A,rs869303,1,G,A,124725883,141627,124670902,125064118,54981
10,ENSG00000226659.1,80536026,10-80505057-A-G,rs9633739,-1,A,G,80505057,30969,80339418,80732634,165639
10,ENSG00000226659.1,80536026,10-80505057-A-T,rs9633739,-1,A,T,80505057,30969,80339418,80732634,165639
10,ENSG00000226659.1,80536026,10-80505057-A-C,rs9633739,-1,A,C,80505057,30969,80339418,80732634,165639
9,ENSG00000235138.1,134054290,9-134044158-C-T,rs10114627,1,C,T,134044158,10132,133857682,134250898,186476
9,ENSG00000228053.1,110025358,9-109955225-A-C,rs10120878,-1,A,C,109955225,70133,109828750,110221966,126475
9,ENSG00000232104.1,3526535,9-3682354-T-C,rs10733481,1,T,C,3682354,155819,3329927,3723143,352427
9,ENSG00000232104.1,3526535,9-3682354-T-A,rs10733481,1,T,A,3682354,155819,3329927,3723143,352427
9,ENSG00000237999.1,100731240,9-100621917-G-A,rs10760734,1,G,A,100621917,109323,100534632,100927848,87285
9,ENSG00000237999.1,100731240,9-100621917-G-C,rs10760734,1,G,C,100621917,109323,100534632,100927848,87285
9,ENSG00000237999.1,100731240,9-100621917-G-T,rs10760734,1,G,T,100621917,109323,100534632,100927848,87285
9,ENSG00000227388.2,35772311,9-35867904-G-C,rs10814288,1,G,C,35867904,95593,35575703,35968919,292201
9,ENSG00000227388.2,35772311,9-35867904-G-A,rs10814288,1,G,A,35867904,95593,35575703,35968919,292201
9,ENSG00000213612.2,97121659,9-97292147-C-T,rs10817378,1,C,T,97292147,170488,96925051,97318267,367096
9,ENSG00000224001.1,98234709,9-98373461-A-T,rs10818833,1,A,T,98373461,138752,98038101,98431317,335360
9,ENSG00000224001.1,98234709,9-98373461-A-G,rs10818833,1,A,G,98373461,138752,98038101,98431317,335360
9,ENSG00000231744.1,124599580,9-124708615-C-T,rs10818986,-1,C,T,124708615,109035,124402972,124796188,305643
9,ENSG00000224546.1,96146007,9-96136006-C-G,rs10819907,1,C,G,96136006,10001,95949399,96342615,186607
9,ENSG00000224546.1,96146007,9-96136006-C-T,rs10819907,1,C,T,96136006,10001,95949399,96342615,186607
9,ENSG00000255585.1,137788690,9-137880269-T-C,rs10867084,-1,T,C,137880269,91579,137592082,137985298,288187
9,ENSG00000257524.1,127899591,9-127929654-G-A,rs10987776,-1,G,A,127929654,30063,127702983,128096199,226671
9,ENSG00000257524.1,127899591,9-127929654-G-T,rs10987776,-1,G,T,127929654,30063,127702983,128096199,226671
9,ENSG00000234789.1,129640476,9-129684814-C-T,rs10988469,1,C,T,129684814,44338,129443868,129837084,240946
9,ENSG00000234789.1,129640476,9-129684814-C-A,rs10988469,1,C,A,129684814,44338,129443868,129837084,240946
9,ENSG00000227269.1,99183373,9-99194212-C-T,rs10988746,1,C,T,99194212,10839,98986765,99379981,207447
9,ENSG00000175611.6,95875480,9-95957517-C-T,rs10988792,-1,C,T,95957517,82037,95678872,96072088,278645
9,ENSG00000175611.6,95875480,9-95957517-C-A,rs10988792,-1,C,A,95957517,82037,95678872,96072088,278645
9,ENSG00000204429.3,88180673,9-88031534-A-T,rs11142050,1,A,T,88031534,149139,87984065,88377281,47469
9,ENSG00000204429.3,88180673,9-88031534-A-G,rs11142050,1,A,G,88031534,149139,87984065,88377281,47469
9,ENSG00000231527.1,61856614,9-61661378-T-G,rs111646622,1,T,G,61661378,195236,61660006,62053222,1372
9,ENSG00000234042.1,63703065,9-63592674-G-T,rs115695984,1,G,T,63592674,110391,63506457,63899673,86217
9,ENSG00000234042.1,63703065,9-63592674-G-C,rs115695984,1,G,C,63592674,110391,63506457,63899673,86217
9,ENSG00000234771.2,128118693,9-128104485-G-A,rs116975394,-1,G,A,128104485,14208,127922085,128315301,182400
9,ENSG00000183148.4,40223397,9-40195539-T-A,rs117401093,1,T,A,40195539,27858,40026789,40420005,168750
9,ENSG00000183148.4,40223397,9-40195539-T-C,rs117401093,1,T,C,40195539,27858,40026789,40420005,168750
9,ENSG00000228656.1,63762824,9-63840173-A-G,rs118106267,-1,A,G,63840173,77349,63566216,63959432,273957
9,ENSG00000236199.1,2046023,9-2067703-A-C,rs12002861,-1,A,C,2067703,21680,1849415,2242631,218288
9,ENSG00000236199.1,2046023,9-2067703-A-G,rs12002861,-1,A,G,2067703,21680,1849415,2242631,218288
9,ENSG00000235298.1,83972233,9-84081372-C-G,rs12339554,1,C,G,84081372,109139,83775625,84168841,305747
9,ENSG00000235298.1,83972233,9-84081372-C-T,rs12339554,1,C,T,84081372,109139,83775625,84168841,305747
9,ENSG00000235298.1,83972233,9-84081372-C-A,rs12339554,1,C,A,84081372,109139,83775625,84168841,305747
9,ENSG00000231381.1,6670008,9-6645251-C-T,rs12341698,-1,C,T,6645251,24757,6473400,6866616,171851
9,ENSG00000250850.2,37002651,9-37002145-A-T,rs12554596,1,A,T,37002145,506,36806043,37199259,196102
9,ENSG00000250850.2,37002651,9-37002145-A-G,rs12554596,1,A,G,37002145,506,36806043,37199259,196102
9,ENSG00000250850.2,37002651,9-37002145-A-C,rs12554596,1,A,C,37002145,506,36806043,37199259,196102
9,ENSG00000228623.2,112998259,9-113098921-T-G,rs1411604,-1,T,G,113098921,100662,112801651,113194867,297270
9,ENSG00000228623.2,112998259,9-113098921-T-C,rs1411604,-1,T,C,113098921,100662,112801651,113194867,297270
9,ENSG00000235641.1,91159769,9-91090100-G-A,rs16907144,1,G,A,91090100,69669,90963161,91356377,126939
9,ENSG00000215199.2,34922921,9-34792151-G-A,rs16931923,-1,G,A,34792151,130770,34726313,35119529,65838
9,ENSG00000254473.1,83707594,9-83704499-T-A,rs17080575,1,T,A,83704499,3095,83510986,83904202,193513
9,ENSG00000254473.1,83707594,9-83704499-T-C,rs17080575,1,T,C,83704499,3095,83510986,83904202,193513
9,ENSG00000219149.3,76549771,9-76586158-A-G,rs2149589,-1,A,G,76586158,36387,76353163,76746379,232995
9,ENSG00000223478.1,128724435,9-128633289-C-T,rs2228952,1,C,T,128633289,91146,128527827,128921043,105462
9,ENSG00000223478.1,128724435,9-128633289-C-A,rs2228952,1,C,A,128633289,91146,128527827,128921043,105462
9,ENSG00000225693.1,33020165,9-33062130-G-A,rs2274764,-1,G,A,33062130,41965,32823557,33216773,238573
9,ENSG00000230221.1,95292338,9-95476578-T-C,rs2277183,1,T,C,95476578,184240,95095730,95488946,380848
9,ENSG00000230221.1,95292338,9-95476578-T-A,rs2277183,1,T,A,95476578,184240,95095730,95488946,380848
9,ENSG00000236816.2,42852675,9-42839370-T-A,rs2351569,1,T,A,42839370,13305,42656067,43049283,183303
9,ENSG00000236816.2,42852675,9-42839370-T-C,rs2351569,1,T,C,42839370,13305,42656067,43049283,183303
9,ENSG00000260912.1,19453209,9-19448475-A-G,rs2383096,1,A,G,19448475,4734,19256601,19649817,191874
9,ENSG00000233820.1,96725890,9-96842892-T-A,rs2406184,1,T,A,96842892,117002,96529282,96922498,313610
9,ENSG00000233820.1,96725890,9-96842892-T-G,rs2406184,1,T,G,96842892,117002,96529282,96922498,313610
9,ENSG00000233820.1,96725890,9-96842892-T-C,rs2406184,1,T,C,96842892,117002,96529282,96922498,313610
9,ENSG00000229419.1,105520128,9-105392543-G-T,rs2771029,1,G,T,105392543,127585,105323520,105716736,69023
9,ENSG00000238172.1,100117651,9-100251704-G-A,rs2787390,-1,G,A,100251704,134053,99921043,100314259,330661
9,ENSG00000230074.1,34665607,9-34669174-T-C,rs2812347,1,T,C,34669174,3567,34468999,34862215,200175
9,ENSG00000204860.4,38620526,9-38666157-A-C,rs2993183,1,A,C,38666157,45631,38423918,38817134,242239
9,ENSG00000204860.4,38620526,9-38666157-A-G,rs2993183,1,A,G,38666157,45631,38423918,38817134,242239
9,ENSG00000204860.4,38620526,9-38666157-A-T,rs2993183,1,A,T,38666157,45631,38423918,38817134,242239
9,ENSG00000237886.1,136546212,9-136546393-G-A,rs3013306,1,G,A,136546393,181,136349604,136742820,196789
9,ENSG00000220105.2,4782078,9-4596135-G-A,rs301445,-1,G,A,4596135,185943,4585470,4978686,10665
9,ENSG00000220105.2,4782078,9-4596135-G-C,rs301445,-1,G,C,4596135,185943,4585470,4978686,10665
9,ENSG00000220105.2,4782078,9-4596135-G-T,rs301445,-1,G,T,4596135,185943,4585470,4978686,10665
9,ENSG00000204055.4,129176326,9-129143575-G-A,rs3118634,1,G,A,129143575,32751,128979718,129372934,163857
9,ENSG00000229753.1,72741617,9-72900538-T-C,rs348485,-1,T,C,72900538,158921,72545009,72938225,355529
9,ENSG00000225411.1,63814159,9-63844590-G-C,rs35284732,-1,G,C,63844590,30431,63617551,64010767,227039
9,ENSG00000225411.1,63814159,9-63844590-G-A,rs35284732,-1,G,A,63844590,30431,63617551,64010767,227039
9,ENSG00000214121.3,12973438,9-12833756-A-C,rs35509513,-1,A,C,12833756,139682,12776830,13170046,56926
9,ENSG00000234160.1,37509150,9-37489301-T-C,rs3758223,1,T,C,37489301,19849,37312542,37705758,176759
9,ENSG00000177736.2,124968840,9-124859365-G-A,rs3780591,-1,G,A,124859365,109475,124772232,125165448,87133
9,ENSG00000260100.1,37079776,9-36936392-G-A,rs3824342,-1,G,A,36936392,143384,36883168,37276384,53224
9,ENSG00000231864.1,137063535,9-137080743-C-T,rs41302685,1,C,T,137080743,17208,136866927,137260143,213816
9,ENSG00000225032.1,127816066,9-127814318-A-C,rs4451422,1,A,C,127814318,1748,127619458,128012674,194860
9,ENSG00000225032.1,127816066,9-127814318-A-G,rs4451422,1,A,G,127814318,1748,127619458,128012674,194860
9,ENSG00000234618.1,76398699,9-76584937-A-G,rs4504705,1,A,G,76584937,186238,76202091,76595307,382846
9,ENSG00000234618.1,76398699,9-76584937-A-T,rs4504705,1,A,T,76584937,186238,76202091,76595307,382846
9,ENSG00000234618.1,76398699,9-76584937-A-C,rs4504705,1,A,C,76584937,186238,76202091,76595307,382846
9,ENSG00000176868.1,131500191,9-131560893-T-C,rs4740170,-1,T,C,131560893,60702,131303583,131696799,257310
9,ENSG00000225434.1,72305464,9-72312693-C-T,rs4745183,1,C,T,72312693,7229,72108856,72502072,203837
9,ENSG00000234424.1,85753306,9-85923109-G-A,rs483334,1,G,A,85923109,169803,85556698,85949914,366411
9,ENSG00000234424.1,85753306,9-85923109-G-C,rs483334,1,G,C,85923109,169803,85556698,85949914,366411
9,ENSG00000226752.1,120847294,9-120848010-C-G,rs4837796,1,C,G,120848010,716,120650686,121043902,197324
9,ENSG00000226752.1,120847294,9-120848010-C-T,rs4837796,1,C,T,120848010,716,120650686,121043902,197324
9,ENSG00000224020.1,124658412,9-124595399-C-T,rs4838196,1,C,T,124595399,63013,124461804,124855020,133595
9,ENSG00000224020.1,124658412,9-124595399-C-A,rs4838196,1,C,A,124595399,63013,124461804,124855020,133595
9,ENSG00000260193.1,136109424,9-136110133-A-G,rs4842115,-1,A,G,136110133,709,135912816,136306032,197317
9,ENSG00000183784.5,215741,9-268740-G-C,rs526509,-1,G,C,268740,52999,19133,412349,249607
9,ENSG00000183784.5,215741,9-268740-G-T,rs526509,-1,G,T,268740,52999,19133,412349,249607
9,ENSG00000236924.1,6645875,9-6646066-T-G,rs55645178,1,T,G,6646066,191,6449267,6842483,196799
9,ENSG00000236924.1,6645875,9-6646066-T-C,rs55645178,1,T,C,6646066,191,6449267,6842483,196799
9,ENSG00000237357.1,42569353,9-42736192-C-T,rs55755621,-1,C,T,42736192,166839,42372745,42765961,363447
9,ENSG00000204816.4,42625436,9-42736192-C-T,rs55755621,1,C,T,42736192,110756,42428828,42822044,307364
9,ENSG00000228843.1,35757940,9-35742984-G-T,rs58869857,-1,G,T,35742984,14956,35561332,35954548,181652
9,ENSG00000228843.1,35757940,9-35742984-G-A,rs58869857,-1,G,A,35742984,14956,35561332,35954548,181652
9,ENSG00000204814.4,61659733,9-61669536-C-G,rs62534929,1,C,G,61669536,9803,61463125,61856341,206411
9,ENSG00000204814.4,61659733,9-61669536-C-T,rs62534929,1,C,T,61669536,9803,61463125,61856341,206411
9,ENSG00000204814.4,61659733,9-61669536-C-A,rs62534929,1,C,A,61669536,9803,61463125,61856341,206411
9,ENSG00000226801.1,33968518,9-33898825-C-T,rs62555930,-1,C,T,33898825,69693,33771910,34165126,126915
9,ENSG00000213558.3,107458306,9-107626124-A-C,rs6477586,-1,A,C,107626124,167818,107261698,107654914,364426
9,ENSG00000233016.1,136728184,9-136723384-C-T,rs6874,-1,C,T,136723384,4800,136531576,136924792,191808
9,ENSG00000203993.3,137618906,9-137598819-G-A,rs7020339,-1,G,A,137598819,20087,137422298,137815514,176521
9,ENSG00000214110.3,14922334,9-14908058-T-G,rs7034380,-1,T,G,14908058,14276,14725726,15118942,182332
9,ENSG00000214110.3,14922334,9-14908058-T-C,rs7034380,-1,T,C,14908058,14276,14725726,15118942,182332
9,ENSG00000214110.3,14922334,9-14908058-T-A,rs7034380,-1,T,A,14908058,14276,14725726,15118942,182332
9,ENSG00000232063.1,94332459,9-94453881-G-T,rs7037298,1,G,T,94453881,121422,94135851,94529067,318030
9,ENSG00000232815.1,63818462,9-63702618-C-A,rs7041252,-1,C,A,63702618,115844,63621854,64015070,80764
9,ENSG00000232815.1,63818462,9-63702618-C-G,rs7041252,-1,C,G,63702618,115844,63621854,64015070,80764
9,ENSG00000239684.1,63776143,9-63659593-G-T,rs72709884,-1,G,T,63659593,116550,63579535,63972751,80058
9,ENSG00000239684.1,63776143,9-63659593-G-A,rs72709884,-1,G,A,63659593,116550,63579535,63972751,80058
9,ENSG00000239684.1,63776143,9-63659593-G-C,rs72709884,-1,G,C,63659593,116550,63579535,63972751,80058
9,ENSG00000227638.1,88411463,9-88559810-G-A,rs72757733,-1,G,A,88559810,148347,88214855,88608071,344955
9,ENSG00000165121.10,85815966,9-85864099-T-C,rs74686393,1,T,C,85864099,48133,85619358,86012574,244741
9,ENSG00000165121.10,85815966,9-85864099-T-G,rs74686393,1,T,G,85864099,48133,85619358,86012574,244741
9,ENSG00000180539.4,137027464,9-137031950-T-A,rs7469569,1,T,A,137031950,4486,136830856,137224072,201094
9,ENSG00000180539.4,137027464,9-137031950-T-C,rs7469569,1,T,C,137031950,4486,136830856,137224072,201094
9,ENSG00000261793.1,137171984,9-137155084-G-A,rs75845722,-1,G,A,137155084,16900,136975376,137368592,179708
9,ENSG00000225254.1,38454070,9-38436995-G-T,rs769153,-1,G,T,38436995,17075,38257462,38650678,179533
9,ENSG00000225254.1,38454070,9-38436995-G-C,rs769153,-1,G,C,38436995,17075,38257462,38650678,179533
9,ENSG00000223568.1,14041861,9-14021277-G-A,rs77875888,-1,G,A,14021277,20584,13845253,14238469,176024
9,ENSG00000223568.1,14041861,9-14021277-G-C,rs77875888,-1,G,C,14021277,20584,13845253,14238469,176024
9,ENSG00000234705.1,128684493,9-128654590-T-C,rs7849746,-1,T,C,128654590,29903,128487885,128881101,166705
9,ENSG00000234705.1,128684493,9-128654590-T-A,rs7849746,-1,T,A,128654590,29903,128487885,128881101,166705
9,ENSG00000234705.1,128684493,9-128654590-T-G,rs7849746,-1,T,G,128654590,29903,128487885,128881101,166705
9,ENSG00000233178.1,68406454,9-68398884-T-C,rs7851710,-1,T,C,68398884,7570,68209846,68603062,189038
9,ENSG00000225951.1,128473012,9-128384130-T-G,rs7853999,-1,T,G,128384130,88882,128276404,128669620,107726
9,ENSG00000254876.1,97238483,9-97238449-A-G,rs7856254,1,A,G,97238449,34,97041875,97435091,196574
9,ENSG00000255145.1,99906605,9-99758147-T-C,rs7859014,-1,T,C,99758147,148458,99709997,100103213,48150
9,ENSG00000226783.1,122685933,9-122571046-G-C,rs7861129,1,G,C,122571046,114887,122489325,122882541,81721
9,ENSG00000226783.1,122685933,9-122571046-G-A,rs7861129,1,G,A,122571046,114887,122489325,122882541,81721
9,ENSG00000226783.1,122685933,9-122571046-G-T,rs7861129,1,G,T,122571046,114887,122489325,122882541,81721
9,ENSG00000237372.1,89639750,9-89725968-C-G,rs7864036,1,C,G,89725968,86218,89443142,89836358,282826
9,ENSG00000237372.1,89639750,9-89725968-C-T,rs7864036,1,C,T,89725968,86218,89443142,89836358,282826
9,ENSG00000237372.1,89639750,9-89725968-C-A,rs7864036,1,C,A,89725968,86218,89443142,89836358,282826
9,ENSG00000236404.2,2622373,9-2527980-A-G,rs7864942,-1,A,G,2527980,94393,2425765,2818981,102215
9,ENSG00000233554.1,33166948,9-33140978-G-T,rs7865745,1,G,T,33140978,25970,32970340,33363556,170638
9,ENSG00000233554.1,33166948,9-33140978-G-A,rs7865745,1,G,A,33140978,25970,32970340,33363556,170638
9,ENSG00000233554.1,33166948,9-33140978-G-C,rs7865745,1,G,C,33140978,25970,32970340,33363556,170638
9,ENSG00000228544.1,136808848,9-136828956-G-C,rs7866538,-1,G,C,136828956,20108,136612240,137005456,216716
9,ENSG00000228544.1,136808848,9-136828956-G-A,rs7866538,-1,G,A,136828956,20108,136612240,137005456,216716
9,ENSG00000228544.1,136808848,9-136828956-G-T,rs7866538,-1,G,T,136828956,20108,136612240,137005456,216716
9,ENSG00000232630.1,125150653,9-125152931-T-G,rs7867749,1,T,G,125152931,2278,124954045,125347261,198886
9,ENSG00000232630.1,125150653,9-125152931-T-A,rs7867749,1,T,A,125152931,2278,124954045,125347261,198886
9,ENSG00000232630.1,125150653,9-125152931-T-C,rs7867749,1,T,C,125152931,2278,124954045,125347261,198886
9,ENSG00000236156.1,37434177,9-37436108-G-T,rs7867764,1,G,T,37436108,1931,37237569,37630785,198539
9,ENSG00000236156.1,37434177,9-37436108-G-C,rs7867764,1,G,C,37436108,1931,37237569,37630785,198539
9,ENSG00000236156.1,37434177,9-37436108-G-A,rs7867764,1,G,A,37436108,1931,37237569,37630785,198539
9,ENSG00000232743.1,87816465,9-87708054-T-C,rs7868357,1,T,C,87708054,108411,87619857,88013073,88197
9,ENSG00000176007.9,38527097,9-38385854-G-A,rs911756,1,G,A,38385854,141243,38330489,38723705,55365
9,ENSG00000176007.9,38527097,9-38385854-G-T,rs911756,1,G,T,38385854,141243,38330489,38723705,55365
9,ENSG00000176007.9,38527097,9-38385854-G-C,rs911756,1,G,C,38385854,141243,38330489,38723705,55365
9,ENSG00000227518.1,27657,9-45440-C-T,rs9407029,1,C,T,45440,17783,-168951,224265,214391
9,ENSG00000227518.1,27657,9-45440-C-A,rs9407029,1,C,A,45440,17783,-168951,224265,214391
9,ENSG00000235865.2,121285530,9-121189407-C-A,rs942152,-1,C,A,121189407,96123,121088922,121482138,100485
9,ENSG00000235865.2,121285530,9-121189407-C-T,rs942152,-1,C,T,121189407,96123,121088922,121482138,100485
9,ENSG00000227218.1,127934503,9-128012245-T-C,rs947625,1,T,C,128012245,77742,127737895,128131111,274350
9,ENSG00000204054.5,129476946,9-129479582-G-A,rs968477,1,G,A,129479582,2636,129280338,129673554,199244
9,ENSG00000204054.5,129476946,9-129479582-G-T,rs968477,1,G,T,129479582,2636,129280338,129673554,199244
9,ENSG00000228395.1,128552414,9-128572563-T-G,rs10739725,-1,T,G,128572563,20149,128355806,128749022,216757
9,ENSG00000228395.1,128552414,9-128572563-T-A,rs10739725,-1,T,A,128572563,20149,128355806,128749022,216757
9,ENSG00000233554.1,33166948,9-33107710-T-C,rs10758187,1,T,C,33107710,59238,32970340,33363556,137370
9,ENSG00000233554.1,33166948,9-33107710-T-G,rs10758187,1,T,G,33107710,59238,32970340,33363556,137370
9,ENSG00000180539.4,137027464,9-136959647-A-T,rs10781528,1,A,T,136959647,67817,136830856,137224072,128791
9,ENSG00000180539.4,137027464,9-136959647-A-G,rs10781528,1,A,G,136959647,67817,136830856,137224072,128791
9,ENSG00000234042.1,63703065,9-63647087-C-G,rs10796745,1,C,G,63647087,55978,63506457,63899673,140630
9,ENSG00000234042.1,63703065,9-63647087-C-T,rs10796745,1,C,T,63647087,55978,63506457,63899673,140630
9,ENSG00000236404.2,2622373,9-2547628-C-T,rs10812224,-1,C,T,2547628,74745,2425765,2818981,121863
9,ENSG00000236404.2,2622373,9-2547628-C-A,rs10812224,-1,C,A,2547628,74745,2425765,2818981,121863
9,ENSG00000204055.4,129176326,9-129270358-T-C,rs10819484,1,T,C,129270358,94032,128979718,129372934,290640
9,ENSG00000227933.1,35646270,9-35643366-C-T,rs10972542,1,C,T,35643366,2904,35449662,35842878,193704
9,ENSG00000225032.1,127816066,9-127803598-C-T,rs10987742,1,C,T,127803598,12468,127619458,128012674,184140
9,ENSG00000235641.1,91159769,9-91282647-G-A,rs116393496,1,G,A,91282647,122878,90963161,91356377,319486
9,ENSG00000236816.2,42852675,9-42729141-C-G,rs117413457,1,C,G,42729141,123534,42656067,43049283,73074
9,ENSG00000236816.2,42852675,9-42729141-C-T,rs117413457,1,C,T,42729141,123534,42656067,43049283,73074
9,ENSG00000239684.1,63776143,9-63840173-A-G,rs118106267,-1,A,G,63840173,64030,63579535,63972751,260638
9,ENSG00000204790.6,64004155,9-63840173-A-G,rs118106267,-1,A,G,63840173,163982,63807547,64200763,32626
9,ENSG00000226020.3,63775241,9-63840173-A-G,rs118106267,-1,A,G,63840173,64932,63578633,63971849,261540
9,ENSG00000232063.1,94332459,9-94287882-G-C,rs12235970,1,G,C,94287882,44577,94135851,94529067,152031
9,ENSG00000232063.1,94332459,9-94287882-G-A,rs12235970,1,G,A,94287882,44577,94135851,94529067,152031
9,ENSG00000204860.4,38620526,9-38667366-T-C,rs12337426,1,T,C,38667366,46840,38423918,38817134,243448
9,ENSG00000215221.2,22012155,9-22148056-C-T,rs12341394,1,C,T,22148056,135901,21815547,22208763,332509
9,ENSG00000227666.1,94038030,9-93909364-T-C,rs12343357,1,T,C,93909364,128666,93841422,94234638,67942
9,ENSG00000225951.1,128473012,9-128407249-T-C,rs12351561,-1,T,C,128407249,65763,128276404,128669620,130845
9,ENSG00000246851.1,131194205,9-131036101-G-A,rs13283119,-1,G,A,131036101,158104,130997597,131390813,38504
9,ENSG00000204706.6,70175883,9-70326054-A-G,rs13297876,-1,A,G,70326054,150171,69979275,70372491,346779
9,ENSG00000236083.1,35859980,9-35903373-A-G,rs1467577,-1,A,G,35903373,43393,35663372,36056588,240001
9,ENSG00000232905.1,113851632,9-113970903-T-G,rs1544065,-1,T,G,113970903,119271,113655024,114048240,315879
9,ENSG00000236924.1,6645875,9-6679844-C-G,rs1658940,1,C,G,6679844,33969,6449267,6842483,230577
9,ENSG00000256966.1,37592469,9-37521196-G-A,rs16934260,-1,G,A,37521196,71273,37395861,37789077,125335
9,ENSG00000226535.1,107171148,9-107300248-A-C,rs1805260,-1,A,C,107300248,129100,106974540,107367756,325708
9,ENSG00000226535.1,107171148,9-107300248-A-G,rs1805260,-1,A,G,107300248,129100,106974540,107367756,325708
9,ENSG00000223551.1,128342153,9-128218658-G-A,rs2229917,1,G,A,128218658,123495,128145545,128538761,73113
9,ENSG00000223551.1,128342153,9-128218658-G-C,rs2229917,1,G,C,128218658,123495,128145545,128538761,73113
9,ENSG00000232743.1,87816465,9-87727760-C-T,rs2274611,1,C,T,87727760,88705,87619857,88013073,107903
9,ENSG00000227388.2,35772311,9-35708829-C-G,rs2756894,1,C,G,35708829,63482,35575703,35968919,133126
9,ENSG00000227388.2,35772311,9-35708829-C-T,rs2756894,1,C,T,35708829,63482,35575703,35968919,133126
9,ENSG00000227388.2,35772311,9-35708829-C-A,rs2756894,1,C,A,35708829,63482,35575703,35968919,133126
9,ENSG00000228544.1,136808848,9-136807214-G-A,rs2784098,-1,G,A,136807214,1634,136612240,137005456,194974
9,ENSG00000226393.1,21321300,9-21216935-G-A,rs28368161,1,G,A,21216935,104365,21124692,21517908,92243
9,ENSG00000225254.1,38454070,9-38535482-T-C,rs2993153,-1,T,C,38535482,81412,38257462,38650678,278020
9,ENSG00000213866.3,35972318,9-36091260-C-T,rs3736884,-1,C,T,36091260,118942,35775710,36168926,315550
9,ENSG00000176007.9,38527097,9-38680829-T-C,rs4242651,1,T,C,38680829,153732,38330489,38723705,350340
9,ENSG00000176007.9,38527097,9-38680829-T-A,rs4242651,1,T,A,38680829,153732,38330489,38723705,350340
9,ENSG00000215237.5,14993312,9-15064518-T-G,rs4741449,1,T,G,15064518,71206,14796704,15189920,267814
9,ENSG00000215237.5,14993312,9-15064518-T-A,rs4741449,1,T,A,15064518,71206,14796704,15189920,267814
9,ENSG00000204352.2,93346152,9-93173314-T-C,rs4743899,-1,T,C,93173314,172838,93149544,93542760,23770
9,ENSG00000204352.2,93346152,9-93173314-T-G,rs4743899,-1,T,G,93173314,172838,93149544,93542760,23770
9,ENSG00000204352.2,93346152,9-93173314-T-A,rs4743899,-1,T,A,93173314,172838,93149544,93542760,23770
9,ENSG00000183784.5,215741,9-205964-A-G,rs478882,-1,A,G,205964,9777,19133,412349,186831
9,ENSG00000183784.5,215741,9-205964-A-C,rs478882,-1,A,C,205964,9777,19133,412349,186831
9,ENSG00000183784.5,215741,9-205964-A-T,rs478882,-1,A,T,205964,9777,19133,412349,186831
9,ENSG00000230894.1,116568449,9-116620651-C-A,rs4837682,1,C,A,116620651,52202,116371841,116765057,248810
9,ENSG00000230894.1,116568449,9-116620651-C-T,rs4837682,1,C,T,116620651,52202,116371841,116765057,248810
9,ENSG00000232630.1,125150653,9-125029951-G-A,rs4838242,1,G,A,125029951,120702,124954045,125347261,75906
9,ENSG00000230074.1,34665607,9-34674765-G-A,rs4878585,1,G,A,34674765,9158,34468999,34862215,205766
9,ENSG00000227852.1,35592786,9-35610915-A-T,rs4879913,1,A,T,35610915,18129,35396178,35789394,214737
9,ENSG00000227852.1,35592786,9-35610915-A-C,rs4879913,1,A,C,35610915,18129,35396178,35789394,214737
9,ENSG00000227852.1,35592786,9-35610915-A-G,rs4879913,1,A,G,35610915,18129,35396178,35789394,214737
9,ENSG00000233016.1,136728184,9-136725859-A-T,rs4880136,-1,A,T,136725859,2325,136531576,136924792,194283
9,ENSG00000233016.1,136728184,9-136725859-A-C,rs4880136,-1,A,C,136725859,2325,136531576,136924792,194283
9,ENSG00000233016.1,136728184,9-136725859-A-G,rs4880136,-1,A,G,136725859,2325,136531576,136924792,194283
9,ENSG00000232850.1,128128529,9-127986986-G-A,rs55934610,1,G,A,127986986,141543,127931921,128325137,55065
9,ENSG00000175611.6,95875480,9-95878389-T-A,rs589458,-1,T,A,95878389,2909,95678872,96072088,199517
9,ENSG00000175611.6,95875480,9-95878389-T-C,rs589458,-1,T,C,95878389,2909,95678872,96072088,199517
9,ENSG00000234424.1,85753306,9-85629673-T-C,rs591464,1,T,C,85629673,123633,85556698,85949914,72975
9,ENSG00000227518.1,27657,9-126903-G-C,rs62533602,1,G,C,126903,99246,-168951,224265,295854
9,ENSG00000227518.1,27657,9-126903-G-A,rs62533602,1,G,A,126903,99246,-168951,224265,295854
9,ENSG00000225693.1,33020165,9-32890987-C-T,rs62542044,-1,C,T,32890987,129178,32823557,33216773,67430
9,ENSG00000260912.1,19453209,9-19426981-A-G,rs7023514,1,A,G,19426981,26228,19256601,19649817,170380
9,ENSG00000226752.1,120847294,9-120787749-G-A,rs7026635,1,G,A,120787749,59545,120650686,121043902,137063
9,ENSG00000226752.1,120847294,9-120787749-G-T,rs7026635,1,G,T,120787749,59545,120650686,121043902,137063
9,ENSG00000250850.2,37002651,9-37008410-T-C,rs7032647,1,T,C,37008410,5759,36806043,37199259,202367
9,ENSG00000250850.2,37002651,9-37008410-T-A,rs7032647,1,T,A,37008410,5759,36806043,37199259,202367
9,ENSG00000236184.1,32980403,9-32873076-G-A,rs72714885,-1,G,A,32873076,107327,32783795,33177011,89281
9,ENSG00000226327.2,88324454,9-88460248-G-A,rs75561980,1,G,A,88460248,135794,88127846,88521062,332402
9,ENSG00000235330.1,477856,9-653668-C-G,rs78402722,1,C,G,653668,175812,281248,674464,372420
9,ENSG00000236862.1,72656192,9-72810277-T-C,rs7851537,-1,T,C,72810277,154085,72459584,72852800,350693
9,ENSG00000257524.1,127899591,9-128062515-C-T,rs7854266,-1,C,T,128062515,162924,127702983,128096199,359532
9,ENSG00000236254.1,5107937,9-5132309-A-C,rs7854968,1,A,C,5132309,24372,4911329,5304545,220980
9,ENSG00000227218.1,127934503,9-127941286-A-T,rs7859,1,A,T,127941286,6783,127737895,128131111,203391
9,ENSG00000227218.1,127934503,9-127941286-A-G,rs7859,1,A,G,127941286,6783,127737895,128131111,203391
9,ENSG00000214110.3,14922334,9-15075187-A-G,rs7859597,-1,A,G,15075187,152853,14725726,15118942,349461
9,ENSG00000259953.1,112039143,9-112038560-T-C,rs7863109,-1,T,C,112038560,583,111842535,112235751,196025
9,ENSG00000259953.1,112039143,9-112038560-T-A,rs7863109,-1,T,A,112038560,583,111842535,112235751,196025
9,ENSG00000254473.1,83707594,9-83699280-A-C,rs7865296,1,A,C,83699280,8314,83510986,83904202,188294
9,ENSG00000254473.1,83707594,9-83699280-A-T,rs7865296,1,A,T,83699280,8314,83510986,83904202,188294
9,ENSG00000225345.3,38568211,9-38444601-G-C,rs7865314,-1,G,C,38444601,123610,38371603,38764819,72998
9,ENSG00000225345.3,38568211,9-38444601-G-A,rs7865314,-1,G,A,38444601,123610,38371603,38764819,72998
9,ENSG00000232104.1,3526535,9-3584719-T-C,rs7870248,1,T,C,3584719,58184,3329927,3723143,254792
9,ENSG00000226783.1,122685933,9-122508743-G-C,rs7873246,1,G,C,122508743,177190,122489325,122882541,19418
9,ENSG00000226783.1,122685933,9-122508743-G-A,rs7873246,1,G,A,122508743,177190,122489325,122882541,19418
9,ENSG00000214121.3,12973438,9-12823083-A-G,rs7873809,-1,A,G,12823083,150355,12776830,13170046,46253
9,ENSG00000233178.1,68406454,9-68559002-C-A,rs79204107,-1,C,A,68559002,152548,68209846,68603062,349156
9,ENSG00000260193.1,136109424,9-136106764-A-T,rs959016,-1,A,T,136106764,2660,135912816,136306032,193948
9,ENSG00000260193.1,136109424,9-136106764-A-G,rs959016,-1,A,G,136106764,2660,135912816,136306032,193948
9,ENSG00000260193.1,136109424,9-136106764-A-C,rs959016,-1,A,C,136106764,2660,135912816,136306032,193948
9,ENSG00000225511.1,92141438,9-92158213-G-A,rs10465156,1,G,A,92158213,16775,91944830,92338046,213383
9,ENSG00000214121.3,12973438,9-12847827-T-C,rs10491739,-1,T,C,12847827,125611,12776830,13170046,70997
9,ENSG00000232104.1,3526535,9-3701912-A-G,rs10511453,1,A,G,3701912,175377,3329927,3723143,371985
9,ENSG00000228510.1,128444587,9-128541351-C-A,rs10513496,1,C,A,128541351,96764,128247979,128641195,293372
9,ENSG00000237372.1,89639750,9-89599008-T-A,rs1055595,1,T,A,89599008,40742,89443142,89836358,155866
9,ENSG00000237372.1,89639750,9-89599008-T-G,rs1055595,1,T,G,89599008,40742,89443142,89836358,155866
9,ENSG00000230074.1,34665607,9-34649053-G-C,rs1055607,1,G,C,34649053,16554,34468999,34862215,180054
9,ENSG00000230074.1,34665607,9-34649053-G-A,rs1055607,1,G,A,34649053,16554,34468999,34862215,180054
9,ENSG00000228656.1,63762824,9-63647087-C-G,rs10796745,-1,C,G,63647087,115737,63566216,63959432,80871
9,ENSG00000228656.1,63762824,9-63647087-C-T,rs10796745,-1,C,T,63647087,115737,63566216,63959432,80871
9,ENSG00000236404.2,2622373,9-2602831-C-G,rs10812325,-1,C,G,2602831,19542,2425765,2818981,177066
9,ENSG00000236404.2,2622373,9-2602831-C-T,rs10812325,-1,C,T,2602831,19542,2425765,2818981,177066
9,ENSG00000261793.1,137171984,9-137147868-G-A,rs10870198,-1,G,A,137147868,24116,136975376,137368592,172492
9,ENSG00000261793.1,137171984,9-137147868-G-T,rs10870198,-1,G,T,137147868,24116,136975376,137368592,172492
9,ENSG00000261793.1,137171984,9-137147868-G-C,rs10870198,-1,G,C,137147868,24116,136975376,137368592,172492
9,ENSG00000215283.3,36304924,9-36186267-T-C,rs10972784,-1,T,C,36186267,118657,36108316,36501532,77951
9,ENSG00000234160.1,37509150,9-37520897-A-G,rs10973393,1,A,G,37520897,11747,37312542,37705758,208355
9,ENSG00000234160.1,37509150,9-37520897-A-T,rs10973393,1,A,T,37520897,11747,37312542,37705758,208355
9,ENSG00000225254.1,38454070,9-38505211-A-G,rs10973863,-1,A,G,38505211,51141,38257462,38650678,247749
9,ENSG00000220105.2,4782078,9-4943454-C-G,rs10974873,-1,C,G,4943454,161376,4585470,4978686,357984
9,ENSG00000220105.2,4782078,9-4943454-C-A,rs10974873,-1,C,A,4943454,161376,4585470,4978686,357984
9,ENSG00000220105.2,4782078,9-4943454-C-T,rs10974873,-1,C,T,4943454,161376,4585470,4978686,357984
9,ENSG00000256968.1,6748981,9-6919984-A-G,rs10975898,-1,A,G,6919984,171003,6552373,6945589,367611
9,ENSG00000173077.10,114969584,9-115129914-G-C,rs10982551,1,G,C,115129914,160330,114772976,115166192,356938
9,ENSG00000173077.10,114969584,9-115129914-G-A,rs10982551,1,G,A,115129914,160330,114772976,115166192,356938
9,ENSG00000223478.1,128724435,9-128590974-C-A,rs10988052,1,C,A,128590974,133461,128527827,128921043,63147
9,ENSG00000223478.1,128724435,9-128590974-C-T,rs10988052,1,C,T,128590974,133461,128527827,128921043,63147
9,ENSG00000223478.1,128724435,9-128590974-C-G,rs10988052,1,C,G,128590974,133461,128527827,128921043,63147
9,ENSG00000224546.1,96146007,9-96328727-C-A,rs10990535,1,C,A,96328727,182720,95949399,96342615,379328
9,ENSG00000224546.1,96146007,9-96328727-C-G,rs10990535,1,C,G,96328727,182720,95949399,96342615,379328
9,ENSG00000224546.1,96146007,9-96328727-C-T,rs10990535,1,C,T,96328727,182720,95949399,96342615,379328
9,ENSG00000230262.1,94259461,9-94148676-G-T,rs10993070,-1,G,T,94148676,110785,94062853,94456069,85823
9,ENSG00000230262.1,94259461,9-94148676-G-A,rs10993070,-1,G,A,94148676,110785,94062853,94456069,85823
9,ENSG00000230262.1,94259461,9-94148676-G-C,rs10993070,-1,G,C,94148676,110785,94062853,94456069,85823
9,ENSG00000255585.1,137788690,9-137914847-G-T,rs11137301,-1,G,T,137914847,126157,137592082,137985298,322765
9,ENSG00000255585.1,137788690,9-137914847-G-A,rs11137301,-1,G,A,137914847,126157,137592082,137985298,322765
9,ENSG00000225345.3,38568211,9-38572665-G-A,rs111732472,-1,G,A,38572665,4454,38371603,38764819,201062
9,ENSG00000204814.4,61659733,9-61655601-G-A,rs11263320,1,G,A,61655601,4132,61463125,61856341,192476
9,ENSG00000215237.5,14993312,9-15114271-G-A,rs113288755,1,G,A,15114271,120959,14796704,15189920,317567
9,ENSG00000215237.5,14993312,9-15114271-G-C,rs113288755,1,G,C,15114271,120959,14796704,15189920,317567
9,ENSG00000176007.9,38527097,9-38406593-G-A,rs11361,1,G,A,38406593,120504,38330489,38723705,76104
9,ENSG00000226020.3,63775241,9-63592674-G-T,rs115695984,-1,G,T,63592674,182567,63578633,63971849,14041
9,ENSG00000226020.3,63775241,9-63592674-G-C,rs115695984,-1,G,C,63592674,182567,63578633,63971849,14041
9,ENSG00000233555.2,63581834,9-63592674-G-T,rs115695984,-1,G,T,63592674,10840,63385226,63778442,207448
9,ENSG00000233555.2,63581834,9-63592674-G-C,rs115695984,-1,G,C,63592674,10840,63385226,63778442,207448
9,ENSG00000204816.4,42625436,9-42729141-C-G,rs117413457,1,C,G,42729141,103705,42428828,42822044,300313
9,ENSG00000204816.4,42625436,9-42729141-C-T,rs117413457,1,C,T,42729141,103705,42428828,42822044,300313
9,ENSG00000236924.1,6645875,9-6645251-C-T,rs12341698,1,C,T,6645251,624,6449267,6842483,195984
9,ENSG00000228046.1,82428025,9-82616282-T-G,rs12685521,-1,T,G,82616282,188257,82231417,82624633,384865
9,ENSG00000228046.1,82428025,9-82616282-T-C,rs12685521,-1,T,C,82616282,188257,82231417,82624633,384865
9,ENSG00000230894.1,116568449,9-116539328-T-C,rs13283416,1,T,C,116539328,29121,116371841,116765057,167487
9,ENSG00000230894.1,116568449,9-116539328-T-A,rs13283416,1,T,A,116539328,29121,116371841,116765057,167487
9,ENSG00000230894.1,116568449,9-116539328-T-G,rs13283416,1,T,G,116539328,29121,116371841,116765057,167487
9,ENSG00000260193.1,136109424,9-136152913-G-A,rs1622817,-1,G,A,136152913,43489,135912816,136306032,240097
9,ENSG00000229817.1,114845594,9-114989248-C-G,rs16932015,1,C,G,114989248,143654,114648986,115042202,340262
9,ENSG00000257524.1,127899591,9-127837679-C-T,rs2005129,-1,C,T,127837679,61912,127702983,128096199,134696
9,ENSG00000231381.1,6670008,9-6620059-A-G,rs2118653,-1,A,G,6620059,49949,6473400,6866616,146659
9,ENSG00000231381.1,6670008,9-6620059-A-C,rs2118653,-1,A,C,6620059,49949,6473400,6866616,146659
9,ENSG00000231381.1,6670008,9-6620059-A-T,rs2118653,-1,A,T,6620059,49949,6473400,6866616,146659
9,ENSG00000230734.1,117181095,9-117133311-T-C,rs2416590,-1,T,C,117133311,47784,116984487,117377703,148824
9,ENSG00000230734.1,117181095,9-117133311-T-G,rs2416590,-1,T,G,117133311,47784,116984487,117377703,148824
9,ENSG00000230734.1,117181095,9-117133311-T-A,rs2416590,-1,T,A,117133311,47784,116984487,117377703,148824
9,ENSG00000236816.2,42852675,9-42772909-G-A,rs28399829,1,G,A,42772909,79766,42656067,43049283,116842
9,ENSG00000231018.1,131782813,9-131808598-G-A,rs2987367,-1,G,A,131808598,25785,131586205,131979421,222393
9,ENSG00000225489.1,6718965,9-6796922-G-A,rs36098691,1,G,A,6796922,77957,6522357,6915573,274565
9,ENSG00000204860.4,38620526,9-38680829-T-C,rs4242651,1,T,C,38680829,60303,38423918,38817134,256911
9,ENSG00000204860.4,38620526,9-38680829-T-A,rs4242651,1,T,A,38680829,60303,38423918,38817134,256911
9,ENSG00000238110.1,87945023,9-87765109-T-C,rs4878118,-1,T,C,87765109,179914,87748415,88141631,16694
9,ENSG00000238110.1,87945023,9-87765109-T-A,rs4878118,-1,T,A,87765109,179914,87748415,88141631,16694
9,ENSG00000238110.1,87945023,9-87765109-T-G,rs4878118,-1,T,G,87765109,179914,87748415,88141631,16694
9,ENSG00000180539.4,137027464,9-137099650-G-A,rs4880200,1,G,A,137099650,72186,136830856,137224072,268794
9,ENSG00000180539.4,137027464,9-137099650-G-C,rs4880200,1,G,C,137099650,72186,136830856,137224072,268794
9,ENSG00000212952.4,42568865,9-42736192-C-T,rs55755621,1,C,T,42736192,167327,42372257,42765473,363935
9,ENSG00000225693.1,33020165,9-32865571-A-T,rs6476383,-1,A,T,32865571,154594,32823557,33216773,42014
9,ENSG00000225693.1,33020165,9-32865571-A-C,rs6476383,-1,A,C,32865571,154594,32823557,33216773,42014
9,ENSG00000225693.1,33020165,9-32865571-A-G,rs6476383,-1,A,G,32865571,154594,32823557,33216773,42014
9,ENSG00000227638.1,88411463,9-88291034-T-C,rs66502617,-1,T,C,88291034,120429,88214855,88608071,76179
9,ENSG00000206147.5,6639139,9-6486591-A-T,rs66509816,1,A,T,6486591,152548,6442531,6835747,44060
9,ENSG00000206147.5,6639139,9-6486591-A-G,rs66509816,1,A,G,6486591,152548,6442531,6835747,44060
9,ENSG00000175611.6,95875480,9-95939519-T-C,rs680754,-1,T,C,95939519,64039,95678872,96072088,260647
9,ENSG00000227321.2,92110865,9-92003282-G-T,rs7018784,1,G,T,92003282,107583,91914257,92307473,89025
9,ENSG00000232743.1,87816465,9-87802350-C-A,rs7020910,1,C,A,87802350,14115,87619857,88013073,182493
9,ENSG00000237158.1,6568844,9-6611609-G-T,rs7035933,1,G,T,6611609,42765,6372236,6765452,239373
9,ENSG00000237158.1,6568844,9-6611609-G-C,rs7035933,1,G,C,6611609,42765,6372236,6765452,239373
9,ENSG00000233554.1,33166948,9-33186158-T-C,rs7038463,1,T,C,33186158,19210,32970340,33363556,215818
9,ENSG00000186940.6,79391304,9-79509455-C-T,rs7040700,1,C,T,79509455,118151,79194696,79587912,314759
9,ENSG00000232815.1,63818462,9-63659593-G-C,rs72709884,-1,G,C,63659593,158869,63621854,64015070,37739
9,ENSG00000232815.1,63818462,9-63659593-G-A,rs72709884,-1,G,A,63659593,158869,63621854,64015070,37739
9,ENSG00000232815.1,63818462,9-63659593-G-T,rs72709884,-1,G,T,63659593,158869,63621854,64015070,37739
9,ENSG00000232063.1,94332459,9-94288653-G-A,rs73653456,1,G,A,94288653,43806,94135851,94529067,152802
9,ENSG00000204055.4,129176326,9-129243022-C-T,rs749840,1,C,T,129243022,66696,128979718,129372934,263304
9,ENSG00000228053.1,110025358,9-110109457-C-A,rs77031037,-1,C,A,110109457,84099,109828750,110221966,280707
9,ENSG00000204003.3,136748453,9-136642442-A-G,rs77748373,-1,A,G,136642442,106011,136551845,136945061,90597
9,ENSG00000204003.3,136748453,9-136642442-A-C,rs77748373,-1,A,C,136642442,106011,136551845,136945061,90597
9,ENSG00000203993.3,137618906,9-137804404-C-T,rs7852475,-1,C,T,137804404,185498,137422298,137815514,382106
9,ENSG00000203993.3,137618906,9-137804404-C-A,rs7852475,-1,C,A,137804404,185498,137422298,137815514,382106
9,ENSG00000203993.3,137618906,9-137804404-C-G,rs7852475,-1,C,G,137804404,185498,137422298,137815514,382106
9,ENSG00000224001.1,98234709,9-98335587-C-T,rs7871923,1,C,T,98335587,100878,98038101,98431317,297486
9,ENSG00000224820.1,72108312,9-72299078-C-A,rs7874628,-1,C,A,72299078,190766,71911704,72304920,387374
9,ENSG00000224820.1,72108312,9-72299078-C-T,rs7874628,-1,C,T,72299078,190766,71911704,72304920,387374
9,ENSG00000224820.1,72108312,9-72299078-C-G,rs7874628,-1,C,G,72299078,190766,71911704,72304920,387374
9,ENSG00000236184.1,32980403,9-33126186-C-A,rs79864251,-1,C,A,33126186,145783,32783795,33177011,342391
9,ENSG00000196205.7,133019486,9-132987108-C-T,rs8193001,1,C,T,132987108,32378,132822878,133216094,164230
9,ENSG00000225434.1,72305464,9-72306967-T-A,rs911861,1,T,A,72306967,1503,72108856,72502072,198111
9,ENSG00000225434.1,72305464,9-72306967-T-C,rs911861,1,T,C,72306967,1503,72108856,72502072,198111
9,ENSG00000229257.1,137057663,9-137195039-C-G,rs9411252,1,C,G,137195039,137376,136861055,137254271,333984
9,ENSG00000229257.1,137057663,9-137195039-C-T,rs9411252,1,C,T,137195039,137376,136861055,137254271,333984
8,ENSG00000249859.2,127794541,8-127652696-T-C,rs10100504,1,T,C,127652696,141845,127597933,127991149,54763
8,ENSG00000254352.1,78724136,8-78663569-T-C,rs1021156,-1,T,C,78663569,60567,78527528,78920744,136041
8,ENSG00000254266.1,78508485,8-78539135-G-A,rs10504676,-1,G,A,78539135,30650,78311877,78705093,227258
8,ENSG00000183154.1,37737426,8-37853880-G-T,rs10808346,-1,G,T,37853880,116454,37540818,37934034,313062
8,ENSG00000183154.1,37737426,8-37853880-G-C,rs10808346,-1,G,C,37853880,116454,37540818,37934034,313062
8,ENSG00000183154.1,37737426,8-37853880-G-A,rs10808346,-1,G,A,37853880,116454,37540818,37934034,313062
8,ENSG00000225885.1,118291208,8-118216894-G-A,rs10808496,1,G,A,118216894,74314,118094600,118487816,122294
8,ENSG00000254690.1,144315138,8-144441636-A-G,rs10902781,-1,A,G,144441636,126498,144118530,144511746,323106
8,ENSG00000254690.1,144315138,8-144441636-A-T,rs10902781,-1,A,T,144441636,126498,144118530,144511746,323106
8,ENSG00000254690.1,144315138,8-144441636-A-C,rs10902781,-1,A,C,144441636,126498,144118530,144511746,323106
8,ENSG00000177335.6,143039328,8-143043095-T-C,rs11136299,1,T,C,143043095,3767,142842720,143235936,200375
8,ENSG00000253541.1,56477987,8-56638338-C-G,rs1155088,-1,C,G,56638338,160351,56281379,56674595,356959
8,ENSG00000253541.1,56477987,8-56638338-C-T,rs1155088,-1,C,T,56638338,160351,56281379,56674595,356959
8,ENSG00000243181.2,34874159,8-34687373-T-C,rs117251116,1,T,C,34687373,186786,34677551,35070767,9822
8,ENSG00000253716.1,143281705,8-143239885-G-C,rs117340186,-1,G,C,143239885,41820,143085097,143478313,154788
8,ENSG00000260368.1,100914388,8-100970958-C-T,rs117500306,-1,C,T,100970958,56570,100717780,101110996,253178
8,ENSG00000260368.1,100914388,8-100970958-C-G,rs117500306,-1,C,G,100970958,56570,100717780,101110996,253178
8,ENSG00000253570.1,38601200,8-38583437-G-C,rs11776459,-1,G,C,38583437,17763,38404592,38797808,178845
8,ENSG00000223508.4,213707,8-214984-A-T,rs11780869,-1,A,T,214984,1277,17099,410315,197885
8,ENSG00000223508.4,213707,8-214984-A-G,rs11780869,-1,A,G,214984,1277,17099,410315,197885
8,ENSG00000228801.4,51899268,8-51762067-C-T,rs11780891,1,C,T,51762067,137201,51702660,52095876,59407
8,ENSG00000253616.1,23074488,8-23074609-A-C,rs11784599,-1,A,C,23074609,121,22877880,23271096,196729
8,ENSG00000253616.1,23074488,8-23074609-A-T,rs11784599,-1,A,T,23074609,121,22877880,23271096,196729
8,ENSG00000245910.2,66925591,8-66967793-T-G,rs11985129,-1,T,G,66967793,42202,66728983,67122199,238810
8,ENSG00000254244.1,4787332,8-4964846-G-A,rs11991285,1,G,A,4964846,177514,4590724,4983940,374122
8,ENSG00000254244.1,4787332,8-4964846-G-T,rs11991285,1,G,T,4964846,177514,4590724,4983940,374122
8,ENSG00000253389.1,41660991,8-41716164-T-C,rs11994013,1,T,C,41716164,55173,41464383,41857599,251781
8,ENSG00000253389.1,41660991,8-41716164-T-G,rs11994013,1,T,G,41716164,55173,41464383,41857599,251781
8,ENSG00000253389.1,41660991,8-41716164-T-A,rs11994013,1,T,A,41716164,55173,41464383,41857599,251781
8,ENSG00000253133.1,41578421,8-41598060-C-T,rs11996670,-1,C,T,41598060,19639,41381813,41775029,216247
8,ENSG00000253133.1,41578421,8-41598060-C-G,rs11996670,-1,C,G,41598060,19639,41381813,41775029,216247
8,ENSG00000253853.1,2726963,8-2738156-G-A,rs12056807,1,G,A,2738156,11193,2530355,2923571,207801
8,ENSG00000253853.1,2726963,8-2738156-G-T,rs12056807,1,G,T,2738156,11193,2530355,2923571,207801
8,ENSG00000253853.1,2726963,8-2738156-G-C,rs12056807,1,G,C,2738156,11193,2530355,2923571,207801
8,ENSG00000254319.1,2728434,8-2738156-G-A,rs12056807,-1,G,A,2738156,9722,2531826,2925042,206330
8,ENSG00000254319.1,2728434,8-2738156-G-T,rs12056807,-1,G,T,2738156,9722,2531826,2925042,206330
8,ENSG00000254319.1,2728434,8-2738156-G-C,rs12056807,-1,G,C,2738156,9722,2531826,2925042,206330
8,ENSG00000246130.1,23068229,8-23231650-C-T,rs12543863,1,C,T,23231650,163421,22871621,23264837,360029
8,ENSG00000246130.1,23068229,8-23231650-C-A,rs12543863,1,C,A,23231650,163421,22871621,23264837,360029
8,ENSG00000250483.1,15807283,8-15778678-T-C,rs12677979,-1,T,C,15778678,28605,15610675,16003891,168003
8,ENSG00000253896.2,72601,8-248839-C-G,rs12680113,1,C,G,248839,176238,-124007,269209,372846
8,ENSG00000253896.2,72601,8-248839-C-T,rs12680113,1,C,T,248839,176238,-124007,269209,372846
8,ENSG00000253125.1,22690150,8-22755659-A-G,rs12682145,1,A,G,22755659,65509,22493542,22886758,262117
8,ENSG00000253174.1,41545044,8-41554412-C-A,rs13268546,-1,C,A,41554412,9368,41348436,41741652,205976
8,ENSG00000254340.1,9141427,8-9037721-G-C,rs13274157,1,G,C,9037721,103706,8944819,9338035,92902
8,ENSG00000254340.1,9141427,8-9037721-G-T,rs13274157,1,G,T,9037721,103706,8944819,9338035,92902
8,ENSG00000250714.2,23230915,8-23225458-G-C,rs13278062,-1,G,C,23225458,5457,23034307,23427523,191151
8,ENSG00000250714.2,23230915,8-23225458-G-A,rs13278062,-1,G,A,23225458,5457,23034307,23427523,191151
8,ENSG00000250714.2,23230915,8-23225458-G-T,rs13278062,-1,G,T,23225458,5457,23034307,23427523,191151
8,ENSG00000246582.2,23225221,8-23225458-G-C,rs13278062,1,G,C,23225458,237,23028613,23421829,196845
8,ENSG00000246582.2,23225221,8-23225458-G-A,rs13278062,1,G,A,23225458,237,23028613,23421829,196845
8,ENSG00000246582.2,23225221,8-23225458-G-T,rs13278062,1,G,T,23225458,237,23028613,23421829,196845
8,ENSG00000253633.1,102528740,8-102536282-A-G,rs1347320,1,A,G,102536282,7542,102332132,102725348,204150
8,ENSG00000253633.1,102528740,8-102536282-A-T,rs1347320,1,A,T,102536282,7542,102332132,102725348,204150
8,ENSG00000245080.3,95072920,8-95089687-C-T,rs1451711,-1,C,T,95089687,16767,94876312,95269528,213375
8,ENSG00000245080.3,95072920,8-95089687-C-G,rs1451711,-1,C,G,95089687,16767,94876312,95269528,213375
8,ENSG00000245080.3,95072920,8-95089687-C-A,rs1451711,-1,C,A,95089687,16767,94876312,95269528,213375
8,ENSG00000261618.1,78835307,8-78711382-A-G,rs1483573,1,A,G,78711382,123925,78638699,79031915,72683
8,ENSG00000261618.1,78835307,8-78711382-A-C,rs1483573,1,A,C,78711382,123925,78638699,79031915,72683
8,ENSG00000253859.2,81439436,8-81507277-A-C,rs1485999,1,A,C,81507277,67841,81242828,81636044,264449
8,ENSG00000253859.2,81439436,8-81507277-A-G,rs1485999,1,A,G,81507277,67841,81242828,81636044,264449
8,ENSG00000254185.1,109470131,8-109636043-T-C,rs16879844,1,T,C,109636043,165912,109273523,109666739,362520
8,ENSG00000254185.1,109470131,8-109636043-T-A,rs16879844,1,T,A,109636043,165912,109273523,109666739,362520
8,ENSG00000253607.1,123002560,8-123126615-G-T,rs16898012,1,G,T,123126615,124055,122805952,123199168,320663
8,ENSG00000253607.1,123002560,8-123126615-G-A,rs16898012,1,G,A,123126615,124055,122805952,123199168,320663
8,ENSG00000261087.1,101169629,8-101163960-C-T,rs16899063,-1,C,T,101163960,5669,100973021,101366237,190939
8,ENSG00000254088.1,86503591,8-86593578-T-G,rs16915984,1,T,G,86593578,89987,86306983,86700199,286595
8,ENSG00000254088.1,86503591,8-86593578-T-A,rs16915984,1,T,A,86593578,89987,86306983,86700199,286595
8,ENSG00000253431.1,62864181,8-62840236-A-C,rs16929693,-1,A,C,62840236,23945,62667573,63060789,172663
8,ENSG00000253431.1,62864181,8-62840236-A-G,rs16929693,-1,A,G,62840236,23945,62667573,63060789,172663
8,ENSG00000246145.1,66428977,8-66270337-T-C,rs16932701,-1,T,C,66270337,158640,66232369,66625585,37968
8,ENSG00000228451.3,26381519,8-26310975-G-A,rs17055109,-1,G,A,26310975,70544,26184911,26578127,126064
8,ENSG00000246339.3,28702030,8-28712764-T-G,rs17059323,-1,T,G,28712764,10734,28505422,28898638,207342
8,ENSG00000246089.2,6406572,8-6481683-G-A,rs17077108,-1,G,A,6481683,75111,6209964,6603180,271719
8,ENSG00000254198.1,43126397,8-42942814-G-A,rs1723308,-1,G,A,42942814,183583,42929789,43323005,13025
8,ENSG00000250962.1,88485110,8-88420771-A-G,rs17669974,1,A,G,88420771,64339,88288502,88681718,132269
8,ENSG00000255050.1,143573490,8-143580905-G-A,rs1809148,1,G,A,143580905,7415,143376882,143770098,204023
8,ENSG00000250929.2,103121032,8-103085168-G-A,rs2047375,1,G,A,103085168,35864,102924424,103317640,160744
8,ENSG00000253666.1,100475670,8-100479811-C-T,rs2154636,1,C,T,100479811,4141,100279062,100672278,200749
8,ENSG00000254812.1,143632783,8-143613329-C-T,rs2242086,-1,C,T,143613329,19454,143436175,143829391,177154
8,ENSG00000254812.1,143632783,8-143613329-C-A,rs2242086,-1,C,A,143613329,19454,143436175,143829391,177154
8,ENSG00000253923.2,102417979,8-102579009-G-A,rs2436916,1,G,A,102579009,161030,102221371,102614587,357638
8,ENSG00000248738.2,22877984,8-22880458-C-T,rs2466177,1,C,T,22880458,2474,22681376,23074592,199082
8,ENSG00000253741.1,142726992,8-142727533-C-T,rs2585138,-1,C,T,142727533,541,142530384,142923600,197149
8,ENSG00000253741.1,142726992,8-142727533-C-G,rs2585138,-1,C,G,142727533,541,142530384,142923600,197149
8,ENSG00000253690.1,28339255,8-28311442-A-T,rs2722909,-1,A,T,28311442,27813,28142647,28535863,168795
8,ENSG00000253690.1,28339255,8-28311442-A-G,rs2722909,-1,A,G,28311442,27813,28142647,28535863,168795
8,ENSG00000253690.1,28339255,8-28311442-A-C,rs2722909,-1,A,C,28311442,27813,28142647,28535863,168795
8,ENSG00000244998.1,141392574,8-141497430-C-G,rs2748398,-1,C,G,141497430,104856,141195966,141589182,301464
8,ENSG00000244998.1,141392574,8-141497430-C-T,rs2748398,-1,C,T,141497430,104856,141195966,141589182,301464
8,ENSG00000253981.1,8241411,8-8426157-A-G,rs2945861,-1,A,G,8426157,184746,8044803,8438019,381354
8,ENSG00000253981.1,8241411,8-8426157-A-T,rs2945861,-1,A,T,8426157,184746,8044803,8438019,381354
8,ENSG00000253981.1,8241411,8-8426157-A-C,rs2945861,-1,A,C,8426157,184746,8044803,8438019,381354
8,ENSG00000196922.4,144999723,8-144809348-T-C,rs2954669,-1,T,C,144809348,190375,144803115,145196331,6233
8,ENSG00000173295.2,8228605,8-8370514-C-A,rs2976972,1,C,A,8370514,141909,8031997,8425213,338517
8,ENSG00000173295.2,8228605,8-8370514-C-T,rs2976972,1,C,T,8370514,141909,8031997,8425213,338517
8,ENSG00000249898.3,6708209,8-6661022-T-G,rs2980647,-1,T,G,6661022,47187,6511601,6904817,149421
8,ENSG00000254294.1,123400582,8-123342728-G-C,rs34136040,1,G,C,123342728,57854,123203974,123597190,138754
8,ENSG00000253167.1,125040684,8-124996779-A-G,rs3763545,1,A,G,124996779,43905,124844076,125237292,152703
8,ENSG00000254859.1,143549729,8-143529559-A-C,rs4242488,-1,A,C,143529559,20170,143353121,143746337,176438
8,ENSG00000254859.1,143549729,8-143529559-A-T,rs4242488,-1,A,T,143529559,20170,143353121,143746337,176438
8,ENSG00000247317.3,143018447,8-143012733-C-T,rs4270940,-1,C,T,143012733,5714,142821839,143215055,190894
8,ENSG00000261026.1,22684009,8-22854564-G-A,rs4284046,-1,G,A,22854564,170555,22487401,22880617,367163
8,ENSG00000248498.3,46614523,8-46682790-T-C,rs4344090,-1,T,C,46682790,68267,46417915,46811131,264875
8,ENSG00000246366.2,70608577,8-70652432-T-C,rs441890,1,T,C,70652432,43855,70411969,70805185,240463
8,ENSG00000253738.1,91070192,8-91063415-A-G,rs4493873,-1,A,G,91063415,6777,90873584,91266800,189831
8,ENSG00000253738.1,91070192,8-91063415-A-C,rs4493873,-1,A,C,91063415,6777,90873584,91266800,189831
8,ENSG00000253214.1,81154265,8-81135826-A-T,rs4598215,1,A,T,81135826,18439,80957657,81350873,178169
8,ENSG00000253214.1,81154265,8-81135826-A-C,rs4598215,1,A,C,81135826,18439,80957657,81350873,178169
8,ENSG00000253214.1,81154265,8-81135826-A-G,rs4598215,1,A,G,81135826,18439,80957657,81350873,178169
8,ENSG00000255310.1,11109726,8-11111725-T-A,rs4618656,-1,T,A,11111725,1999,10913118,11306334,198607
8,ENSG00000253945.1,95403802,8-95322686-C-A,rs4735360,1,C,A,95322686,81116,95207194,95600410,115492
8,ENSG00000237810.3,62144769,8-62203897-G-A,rs4737600,-1,G,A,62203897,59128,61948161,62341377,255736
8,ENSG00000254129.1,29110573,8-29295520-C-A,rs491687,1,C,A,29295520,184947,28913965,29307181,381555
8,ENSG00000254129.1,29110573,8-29295520-C-T,rs491687,1,C,T,29295520,184947,28913965,29307181,381555
8,ENSG00000253161.1,37554183,8-37490588-T-C,rs6415415,-1,T,C,37490588,63595,37357575,37750791,133013
8,ENSG00000253161.1,37554183,8-37490588-T-A,rs6415415,-1,T,A,37490588,63595,37357575,37750791,133013
8,ENSG00000253161.1,37554183,8-37490588-T-G,rs6415415,-1,T,G,37490588,63595,37357575,37750791,133013
8,ENSG00000254307.1,94792963,8-94722486-C-T,rs6471480,-1,C,T,94722486,70477,94596355,94989571,126131
8,ENSG00000254006.1,64817573,8-64817650-G-A,rs6472155,-1,G,A,64817650,77,64620965,65014181,196685
8,ENSG00000254006.1,64817573,8-64817650-G-C,rs6472155,-1,G,C,64817650,77,64620965,65014181,196685
8,ENSG00000254006.1,64817573,8-64817650-G-T,rs6472155,-1,G,T,64817650,77,64620965,65014181,196685
8,ENSG00000253982.1,1764508,8-1754204-C-G,rs6558522,-1,C,G,1754204,10304,1567900,1961116,186304
8,ENSG00000253982.1,1764508,8-1754204-C-A,rs6558522,-1,C,A,1754204,10304,1567900,1961116,186304
8,ENSG00000251191.2,29735223,8-29745685-G-T,rs6983144,-1,G,T,29745685,10462,29538615,29931831,207070
8,ENSG00000253490.1,29748325,8-29745685-G-T,rs6983144,1,G,T,29745685,2640,29551717,29944933,193968
8,ENSG00000248522.1,55455139,8-55425498-C-T,rs6995409,-1,C,T,55425498,29641,55258531,55651747,166967
8,ENSG00000253204.1,30921060,8-30737425-A-G,rs6995542,1,A,G,30737425,183635,30724452,31117668,12973
8,ENSG00000254389.1,143368548,8-143365185-A-G,rs7003432,-1,A,G,143365185,3363,143171940,143565156,193245
8,ENSG00000253200.1,22616657,8-22662302-A-G,rs7005025,-1,A,G,22662302,45645,22420049,22813265,242253
8,ENSG00000253200.1,22616657,8-22662302-A-C,rs7005025,-1,A,C,22662302,45645,22420049,22813265,242253
8,ENSG00000253210.1,141130064,8-141127535-T-A,rs7009780,-1,T,A,141127535,2529,140933456,141326672,194079
8,ENSG00000253210.1,141130064,8-141127535-T-C,rs7009780,-1,T,C,141127535,2529,140933456,141326672,194079
8,ENSG00000253140.1,48518157,8-48523759-T-C,rs7012665,-1,T,C,48523759,5602,48321549,48714765,202210
8,ENSG00000255559.1,145002811,8-144911030-C-G,rs71522403,1,C,G,144911030,91781,144806203,145199419,104827
8,ENSG00000226098.3,54523297,8-54361320-G-A,rs72655615,-1,G,A,54361320,161977,54326689,54719905,34631
8,ENSG00000226098.3,54523297,8-54361320-G-C,rs72655615,-1,G,C,54361320,161977,54326689,54719905,34631
8,ENSG00000253605.1,141459075,8-141538426-G-A,rs72685498,1,G,A,141538426,79351,141262467,141655683,275959
8,ENSG00000224722.3,127087510,8-127163451-G-A,rs735542,-1,G,A,127163451,75941,126890902,127284118,272549
8,ENSG00000243844.1,29632091,8-29436837-A-G,rs74798523,1,A,G,29436837,195254,29435483,29828699,1354
8,ENSG00000254578.1,144463817,8-144476070-A-C,rs750472,1,A,C,144476070,12253,144267209,144660425,208861
8,ENSG00000254578.1,144463817,8-144476070-A-G,rs750472,1,A,G,144476070,12253,144267209,144660425,208861
8,ENSG00000246528.2,69834153,8-69835886-C-T,rs75069512,1,C,T,69835886,1733,69637545,70030761,198341
8,ENSG00000239917.3,117524061,8-117561710-C-T,rs755982,-1,C,T,117561710,37649,117327453,117720669,234257
8,ENSG00000244593.1,18383917,8-18282807-T-G,rs75699296,-1,T,G,18282807,101110,18187309,18580525,95498
8,ENSG00000254285.2,61578220,8-61608431-C-T,rs76132602,1,C,T,61608431,30211,61381612,61774828,226819
8,ENSG00000254162.1,80539135,8-80462733-A-C,rs76592669,-1,A,C,80462733,76402,80342527,80735743,120206
8,ENSG00000254162.1,80539135,8-80462733-A-G,rs76592669,-1,A,G,80462733,76402,80342527,80735743,120206
8,ENSG00000253320.1,102864271,8-103023225-A-G,rs77481455,1,A,G,103023225,158954,102667663,103060879,355562
8,ENSG00000253824.1,100464613,8-100354814-C-G,rs77744491,-1,C,G,100354814,109799,100268005,100661221,86809
8,ENSG00000253824.1,100464613,8-100354814-C-T,rs77744491,-1,C,T,100354814,109799,100268005,100661221,86809
8,ENSG00000261451.1,10433672,8-10411865-T-C,rs7817793,1,T,C,10411865,21807,10237064,10630280,174801
8,ENSG00000261451.1,10433672,8-10411865-T-A,rs7817793,1,T,A,10411865,21807,10237064,10630280,174801
8,ENSG00000260398.1,78605952,8-78598927-C-T,rs7822892,1,C,T,78598927,7025,78409344,78802560,189583
8,ENSG00000253842.1,100432726,8-100265151-C-G,rs7824192,-1,C,G,100265151,167575,100236118,100629334,29033
8,ENSG00000260317.1,80541300,8-80483375-T-C,rs78289944,1,T,C,80483375,57925,80344692,80737908,138683
8,ENSG00000253550.1,6474288,8-6569623-G-T,rs78340857,-1,G,T,6569623,95335,6277680,6670896,291943
8,ENSG00000253550.1,6474288,8-6569623-G-A,rs78340857,-1,G,A,6569623,95335,6277680,6670896,291943
8,ENSG00000253550.1,6474288,8-6569623-G-C,rs78340857,-1,G,C,6569623,95335,6277680,6670896,291943
8,ENSG00000261220.1,133572158,8-133574394-A-T,rs7839535,1,A,T,133574394,2236,133375550,133768766,198844
8,ENSG00000261220.1,133572158,8-133574394-A-G,rs7839535,1,A,G,133574394,2236,133375550,133768766,198844
8,ENSG00000255046.1,11802512,8-11795641-T-A,rs7845566,-1,T,A,11795641,6871,11605904,11999120,189737
8,ENSG00000255046.1,11802512,8-11795641-T-C,rs7845566,-1,T,C,11795641,6871,11605904,11999120,189737
8,ENSG00000255164.1,144992914,8-144920209-C-T,rs79181160,1,C,T,144920209,72705,144796306,145189522,123903
8,ENSG00000243537.1,133325997,8-133363047-G-A,rs79437414,1,G,A,133363047,37050,133129389,133522605,233658
8,ENSG00000215288.4,27012371,8-27191767-C-G,rs80182079,-1,C,G,27191767,179396,26815763,27208979,376004
8,ENSG00000247081.2,103285907,8-103351442-G-T,rs827589,-1,G,T,103351442,65535,103089299,103482515,262143
8,ENSG00000247081.2,103285907,8-103351442-G-C,rs827589,-1,G,C,103351442,65535,103089299,103482515,262143
8,ENSG00000247081.2,103285907,8-103351442-G-A,rs827589,-1,G,A,103351442,65535,103089299,103482515,262143
8,ENSG00000248492.1,134598071,8-134615506-A-G,rs894348,1,A,G,134615506,17435,134401463,134794679,214043
8,ENSG00000251136.2,89757383,8-89783283-A-G,rs9297722,-1,A,G,89783283,25900,89560775,89953991,222508
8,ENSG00000261693.1,142403652,8-142410112-T-C,rs9324588,1,T,C,142410112,6460,142207044,142600260,203068
8,ENSG00000253704.1,94553668,8-94529074-A-T,rs957448,1,A,T,94529074,24594,94357060,94750276,172014
8,ENSG00000253704.1,94553668,8-94529074-A-G,rs957448,1,A,G,94529074,24594,94357060,94750276,172014
8,ENSG00000246339.3,28702030,8-28751619-G-A,rs10091907,-1,G,A,28751619,49589,28505422,28898638,246197
8,ENSG00000167912.5,59119216,8-58960675-A-C,rs10092016,1,A,C,58960675,158541,58922608,59315824,38067
8,ENSG00000253636.1,73052178,8-73134791-A-C,rs10097640,1,A,C,73134791,82613,72855570,73248786,279221
8,ENSG00000253636.1,73052178,8-73134791-A-T,rs10097640,1,A,T,73134791,82613,72855570,73248786,279221
8,ENSG00000253636.1,73052178,8-73134791-A-G,rs10097640,1,A,G,73134791,82613,72855570,73248786,279221
8,ENSG00000254266.1,78508485,8-78640408-A-G,rs10103897,-1,A,G,78640408,131923,78311877,78705093,328531
8,ENSG00000254266.1,78508485,8-78640408-A-T,rs10103897,-1,A,T,78640408,131923,78311877,78705093,328531
8,ENSG00000253899.1,27065278,8-27237031-A-G,rs10217008,-1,A,G,27237031,171753,26868670,27261886,368361
8,ENSG00000253899.1,27065278,8-27237031-A-T,rs10217008,-1,A,T,27237031,171753,26868670,27261886,368361
8,ENSG00000253899.1,27065278,8-27237031-A-C,rs10217008,-1,A,C,27237031,171753,26868670,27261886,368361
8,ENSG00000250979.1,72251565,8-72366328-A-G,rs10453111,-1,A,G,72366328,114763,72054957,72448173,311371
8,ENSG00000255046.1,11802512,8-11796316-C-A,rs10503424,-1,C,A,11796316,6196,11605904,11999120,190412
8,ENSG00000255046.1,11802512,8-11796316-C-G,rs10503424,-1,C,G,11796316,6196,11605904,11999120,190412
8,ENSG00000255046.1,11802512,8-11796316-C-T,rs10503424,-1,C,T,11796316,6196,11605904,11999120,190412
8,ENSG00000260398.1,78605952,8-78663770-G-A,rs10504680,1,G,A,78663770,57818,78409344,78802560,254426
8,ENSG00000250714.2,23230915,8-23252990-C-T,rs11135712,-1,C,T,23252990,22075,23034307,23427523,218683
8,ENSG00000250714.2,23230915,8-23252990-C-A,rs11135712,-1,C,A,23252990,22075,23034307,23427523,218683
8,ENSG00000255164.1,144992914,8-145039242-A-G,rs11248223,1,A,G,145039242,46328,144796306,145189522,242936
8,ENSG00000255164.1,144992914,8-145039242-A-T,rs11248223,1,A,T,145039242,46328,144796306,145189522,242936
8,ENSG00000258677.1,73878854,8-73898173-G-A,rs113296456,-1,G,A,73898173,19319,73682246,74075462,215927
8,ENSG00000258677.1,73878854,8-73898173-G-C,rs113296456,-1,G,C,73898173,19319,73682246,74075462,215927
8,ENSG00000253995.1,33540185,8-33677947-C-A,rs115503498,1,C,A,33677947,137762,33343577,33736793,334370
8,ENSG00000254129.1,29110573,8-29231230-C-T,rs117559425,1,C,T,29231230,120657,28913965,29307181,317265
8,ENSG00000254352.1,78724136,8-78651952-T-A,rs11782836,-1,T,A,78651952,72184,78527528,78920744,124424
8,ENSG00000254352.1,78724136,8-78651952-T-G,rs11782836,-1,T,G,78651952,72184,78527528,78920744,124424
8,ENSG00000261451.1,10433672,8-10288350-C-T,rs11784779,1,C,T,10288350,145322,10237064,10630280,51286
8,ENSG00000261451.1,10433672,8-10288350-C-A,rs11784779,1,C,A,10288350,145322,10237064,10630280,51286
8,ENSG00000261451.1,10433672,8-10288350-C-G,rs11784779,1,C,G,10288350,145322,10237064,10630280,51286
8,ENSG00000213003.2,70273369,8-70109636-G-A,rs11786496,1,G,A,70109636,163733,70076761,70469977,32875
8,ENSG00000255107.1,69860540,8-69831932-G-A,rs118016633,-1,G,A,69831932,28608,69663932,70057148,168000
8,ENSG00000248738.2,22877984,8-22840696-G-A,rs11986200,1,G,A,22840696,37288,22681376,23074592,159320
8,ENSG00000248738.2,22877984,8-22840696-G-C,rs11986200,1,G,C,22840696,37288,22681376,23074592,159320
8,ENSG00000248738.2,22877984,8-22840696-G-T,rs11986200,1,G,T,22840696,37288,22681376,23074592,159320
8,ENSG00000248492.1,134598071,8-134642499-T-G,rs11995190,1,T,G,134642499,44428,134401463,134794679,241036
8,ENSG00000248492.1,134598071,8-134642499-T-C,rs11995190,1,T,C,134642499,44428,134401463,134794679,241036
8,ENSG00000254231.1,86343429,8-86214786-G-T,rs12542402,-1,G,T,86214786,128643,86146821,86540037,67965
8,ENSG00000254231.1,86343429,8-86214786-G-A,rs12542402,-1,G,A,86214786,128643,86146821,86540037,67965
8,ENSG00000253408.1,42271253,8-42125558-A-G,rs12544318,-1,A,G,42125558,145695,42074645,42467861,50913
8,ENSG00000188856.6,80558870,8-80669869-T-C,rs12547769,1,T,C,80669869,110999,80362262,80755478,307607
8,ENSG00000245970.2,98041726,8-98223600-A-G,rs1319282,1,A,G,98223600,181874,97845118,98238334,378482
8,ENSG00000231942.3,81807772,8-81783833-G-A,rs13251888,1,G,A,81783833,23939,81611164,82004380,172669
8,ENSG00000253133.1,41578421,8-41445042-G-A,rs13260111,-1,G,A,41445042,133379,41381813,41775029,63229
8,ENSG00000253133.1,41578421,8-41445042-G-C,rs13260111,-1,G,C,41445042,133379,41381813,41775029,63229
8,ENSG00000246366.2,70608577,8-70687179-C-G,rs13268714,1,C,G,70687179,78602,70411969,70805185,275210
8,ENSG00000253930.1,23189279,8-23239081-G-A,rs13268919,1,G,A,23239081,49802,22992671,23385887,246410
8,ENSG00000254006.1,64817573,8-64808640-C-T,rs13278868,-1,C,T,64808640,8933,64620965,65014181,187675
8,ENSG00000254006.1,64817573,8-64808640-C-G,rs13278868,-1,C,G,64808640,8933,64620965,65014181,187675
8,ENSG00000249898.3,6708209,8-6675043-T-C,rs13279216,-1,T,C,6675043,33166,6511601,6904817,163442
8,ENSG00000215179.4,46974617,8-46958069-C-T,rs1391995,-1,C,T,46958069,16548,46778009,47171225,180060
8,ENSG00000215179.4,46974617,8-46958069-C-A,rs1391995,-1,C,A,46958069,16548,46778009,47171225,180060
8,ENSG00000253549.1,85464915,8-85306169-C-T,rs1553016,-1,C,T,85306169,158746,85268307,85661523,37862
8,ENSG00000251136.2,89757383,8-89647622-T-C,rs160448,-1,T,C,89647622,109761,89560775,89953991,86847
8,ENSG00000251136.2,89757383,8-89647622-T-A,rs160448,-1,T,A,89647622,109761,89560775,89953991,86847
8,ENSG00000251136.2,89757383,8-89647622-T-G,rs160448,-1,T,G,89647622,109761,89560775,89953991,86847
8,ENSG00000254388.1,123352181,8-123159239-A-G,rs1670190,1,A,G,123159239,192942,123155573,123548789,3666
8,ENSG00000254388.1,123352181,8-123159239-A-T,rs1670190,1,A,T,123159239,192942,123155573,123548789,3666
8,ENSG00000259820.1,134798272,8-134738484-C-T,rs16905235,-1,C,T,134738484,59788,134601664,134994880,136820
8,ENSG00000259820.1,134798272,8-134738484-C-A,rs16905235,-1,C,A,134738484,59788,134601664,134994880,136820
8,ENSG00000236814.1,56051207,8-55941613-C-A,rs16922459,-1,C,A,55941613,109594,55854599,56247815,87014
8,ENSG00000236814.1,56051207,8-55941613-C-T,rs16922459,-1,C,T,55941613,109594,55854599,56247815,87014
8,ENSG00000254065.1,47592609,8-47432026-G-A,rs16926260,-1,G,A,47432026,160583,47396001,47789217,36025
8,ENSG00000254285.2,61578220,8-61609173-C-T,rs16927639,1,C,T,61609173,30953,61381612,61774828,227561
8,ENSG00000254285.2,61578220,8-61609173-C-A,rs16927639,1,C,A,61609173,30953,61381612,61774828,227561
8,ENSG00000254285.2,61578220,8-61609173-C-G,rs16927639,1,C,G,61609173,30953,61381612,61774828,227561
8,ENSG00000251633.3,73915010,8-73760380-A-C,rs16938719,-1,A,C,73760380,154630,73718402,74111618,41978
8,ENSG00000251034.1,22553444,8-22405659-T-C,rs17060826,-1,T,C,22405659,147785,22356836,22750052,48823
8,ENSG00000251034.1,22553444,8-22405659-T-G,rs17060826,-1,T,G,22405659,147785,22356836,22750052,48823
8,ENSG00000244593.1,18383917,8-18216813-A-T,rs17126350,-1,A,T,18216813,167104,18187309,18580525,29504
8,ENSG00000244593.1,18383917,8-18216813-A-G,rs17126350,-1,A,G,18216813,167104,18187309,18580525,29504
8,ENSG00000253853.1,2726963,8-2738578-G-T,rs17755518,1,G,T,2738578,11615,2530355,2923571,208223
8,ENSG00000253853.1,2726963,8-2738578-G-C,rs17755518,1,G,C,2738578,11615,2530355,2923571,208223
8,ENSG00000254319.1,2728434,8-2738578-G-T,rs17755518,-1,G,T,2738578,10144,2531826,2925042,206752
8,ENSG00000254319.1,2728434,8-2738578-G-C,rs17755518,-1,G,C,2738578,10144,2531826,2925042,206752
8,ENSG00000254088.1,86503591,8-86559410-T-A,rs1801830,1,T,A,86559410,55819,86306983,86700199,252427
8,ENSG00000260588.1,41829934,8-41728053-C-G,rs1872877,-1,C,G,41728053,101881,41633326,42026542,94727
8,ENSG00000260588.1,41829934,8-41728053-C-T,rs1872877,-1,C,T,41728053,101881,41633326,42026542,94727
8,ENSG00000253666.1,100475670,8-100492452-T-A,rs2022919,1,T,A,100492452,16782,100279062,100672278,213390
8,ENSG00000223508.4,213707,8-245254-C-T,rs2074718,-1,C,T,245254,31547,17099,410315,228155
8,ENSG00000223508.4,213707,8-245254-C-G,rs2074718,-1,C,G,245254,31547,17099,410315,228155
8,ENSG00000223508.4,213707,8-245254-C-A,rs2074718,-1,C,A,245254,31547,17099,410315,228155
8,ENSG00000255050.1,143573490,8-143581491-G-T,rs2123758,1,G,T,143581491,8001,143376882,143770098,204609
8,ENSG00000255050.1,143573490,8-143581491-G-A,rs2123758,1,G,A,143581491,8001,143376882,143770098,204609
8,ENSG00000253633.1,102528740,8-102564430-G-A,rs2436889,1,G,A,102564430,35690,102332132,102725348,232298
8,ENSG00000254389.1,143368548,8-143328628-A-G,rs2450771,-1,A,G,143328628,39920,143171940,143565156,156688
8,ENSG00000225885.1,118291208,8-118148769-C-T,rs2468147,1,C,T,118148769,142439,118094600,118487816,54169
8,ENSG00000229211.3,31220984,8-31096348-T-C,rs2553260,-1,T,C,31096348,124636,31024376,31417592,71972
8,ENSG00000229211.3,31220984,8-31096348-T-G,rs2553260,-1,T,G,31096348,124636,31024376,31417592,71972
8,ENSG00000229211.3,31220984,8-31096348-T-A,rs2553260,-1,T,A,31096348,124636,31024376,31417592,71972
8,ENSG00000253570.1,38601200,8-38611087-G-A,rs2593095,-1,G,A,38611087,9887,38404592,38797808,206495
8,ENSG00000245080.3,95072920,8-95015078-G-C,rs2599723,-1,G,C,95015078,57842,94876312,95269528,138766
8,ENSG00000245080.3,95072920,8-95015078-G-A,rs2599723,-1,G,A,95015078,57842,94876312,95269528,138766
8,ENSG00000253948.1,99013017,8-99107963-C-A,rs28585625,-1,C,A,99107963,94946,98816409,99209625,291554
8,ENSG00000254332.1,69129598,8-69131451-C-A,rs28623611,1,C,A,69131451,1853,68932990,69326206,198461
8,ENSG00000246477.2,11325429,8-11171381-C-T,rs2898265,-1,C,T,11171381,154048,11128821,11522037,42560
8,ENSG00000246477.2,11325429,8-11171381-C-A,rs2898265,-1,C,A,11171381,154048,11128821,11522037,42560
8,ENSG00000250752.2,6899468,8-6858229-A-T,rs2980945,-1,A,T,6858229,41239,6702860,7096076,155369
8,ENSG00000250752.2,6899468,8-6858229-A-G,rs2980945,-1,A,G,6858229,41239,6702860,7096076,155369
8,ENSG00000253210.1,141130064,8-141182470-G-A,rs307739,-1,G,A,141182470,52406,140933456,141326672,249014
8,ENSG00000253676.1,106698013,8-106603466-A-G,rs3101544,-1,A,G,106603466,94547,106501405,106894621,102061
8,ENSG00000228451.3,26381519,8-26381867-C-A,rs3758098,-1,C,A,26381867,348,26184911,26578127,196956
8,ENSG00000244052.1,102924255,8-102828132-G-A,rs3836,-1,G,A,102828132,96123,102727647,103120863,100485
8,ENSG00000260317.1,80541300,8-80465568-G-A,rs396760,1,G,A,80465568,75732,80344692,80737908,120876
8,ENSG00000246582.2,23225221,8-23103040-C-A,rs41308122,1,C,A,23103040,122181,23028613,23421829,74427
8,ENSG00000251470.1,46697630,8-46682790-T-C,rs4344090,1,T,C,46682790,14840,46501022,46894238,181768
8,ENSG00000253616.1,23074488,8-23075498-G-A,rs4373519,-1,G,A,23075498,1010,22877880,23271096,197618
8,ENSG00000253616.1,23074488,8-23075498-G-C,rs4373519,-1,G,C,23075498,1010,22877880,23271096,197618
8,ENSG00000253167.1,125040684,8-125039544-A-C,rs4601330,1,A,C,125039544,1140,124844076,125237292,195468
8,ENSG00000177335.6,143039328,8-143102029-C-T,rs4607586,1,C,T,143102029,62701,142842720,143235936,259309
8,ENSG00000249859.2,127794541,8-127739317-C-G,rs4645963,1,C,G,127739317,55224,127597933,127991149,141384
8,ENSG00000249859.2,127794541,8-127739317-C-T,rs4645963,1,C,T,127739317,55224,127597933,127991149,141384
8,ENSG00000246528.2,69834153,8-69849675-C-T,rs4738034,1,C,T,69849675,15522,69637545,70030761,212130
8,ENSG00000261542.1,63215981,8-63191534-A-G,rs4739066,1,A,G,63191534,24447,63019373,63412589,172161
8,ENSG00000253981.1,8241411,8-8357833-T-C,rs4840939,-1,T,C,8357833,116422,8044803,8438019,313030
8,ENSG00000253981.1,8241411,8-8357833-T-A,rs4840939,-1,T,A,8357833,116422,8044803,8438019,313030
8,ENSG00000254812.1,143632783,8-143583592-G-A,rs4874157,-1,G,A,143583592,49191,143436175,143829391,147417
8,ENSG00000253389.1,41660991,8-41642195-A-G,rs537519,1,A,G,41642195,18796,41464383,41857599,177812
8,ENSG00000251191.2,29735223,8-29859859-C-G,rs57950553,-1,C,G,29859859,124636,29538615,29931831,321244
8,ENSG00000251191.2,29735223,8-29859859-C-A,rs57950553,-1,C,A,29859859,124636,29538615,29931831,321244
8,ENSG00000251191.2,29735223,8-29859859-C-T,rs57950553,-1,C,T,29859859,124636,29538615,29931831,321244
8,ENSG00000253174.1,41545044,8-41641762-G-A,rs60202299,-1,G,A,41641762,96718,41348436,41741652,293326
8,ENSG00000253174.1,41545044,8-41641762-G-T,rs60202299,-1,G,T,41641762,96718,41348436,41741652,293326
8,ENSG00000255182.1,144505444,8-144686890-G-T,rs62529935,-1,G,T,144686890,181446,144308836,144702052,378054
8,ENSG00000255182.1,144505444,8-144686890-G-A,rs62529935,-1,G,A,144686890,181446,144308836,144702052,378054
8,ENSG00000253330.1,47512141,8-47499323-G-A,rs62539106,-1,G,A,47499323,12818,47315533,47708749,183790
8,ENSG00000242607.1,12571130,8-12762917-T-G,rs6530972,-1,T,G,12762917,191787,12374522,12767738,388395
8,ENSG00000243537.1,133325997,8-133375112-A-C,rs6980814,1,A,C,133375112,49115,133129389,133522605,245723
8,ENSG00000254185.1,109470131,8-109600771-G-T,rs6982592,1,G,T,109600771,130640,109273523,109666739,327248
8,ENSG00000254185.1,109470131,8-109600771-G-A,rs6982592,1,G,A,109600771,130640,109273523,109666739,327248
8,ENSG00000253214.1,81154265,8-81151758-G-A,rs6986622,1,G,A,81151758,2507,80957657,81350873,194101
8,ENSG00000253214.1,81154265,8-81151758-G-C,rs6986622,1,G,C,81151758,2507,80957657,81350873,194101
8,ENSG00000253214.1,81154265,8-81151758-G-T,rs6986622,1,G,T,81151758,2507,80957657,81350873,194101
8,ENSG00000247317.3,143018447,8-142905775-G-A,rs6987382,-1,G,A,142905775,112672,142821839,143215055,83936
8,ENSG00000247317.3,143018447,8-142905775-G-T,rs6987382,-1,G,T,142905775,112672,142821839,143215055,83936
8,ENSG00000247317.3,143018447,8-142905775-G-C,rs6987382,-1,G,C,142905775,112672,142821839,143215055,83936
8,ENSG00000254859.1,143549729,8-143542268-C-T,rs6991958,-1,C,T,143542268,7461,143353121,143746337,189147
8,ENSG00000254741.1,143579636,8-143541958-A-G,rs6998917,1,A,G,143541958,37678,143383028,143776244,158930
8,ENSG00000254741.1,143579636,8-143541958-A-C,rs6998917,1,A,C,143541958,37678,143383028,143776244,158930
8,ENSG00000253541.1,56477987,8-56621416-G-A,rs7017225,-1,G,A,56621416,143429,56281379,56674595,340037
8,ENSG00000253541.1,56477987,8-56621416-G-T,rs7017225,-1,G,T,56621416,143429,56281379,56674595,340037
8,ENSG00000253550.1,6474288,8-6433344-A-G,rs73196775,-1,A,G,6433344,40944,6277680,6670896,155664
8,ENSG00000233915.4,86661922,8-86808936-C-T,rs73280539,-1,C,T,86808936,147014,86465314,86858530,343622
8,ENSG00000243498.2,123236852,8-123096378-C-T,rs74597467,1,C,T,123096378,140474,123040244,123433460,56134
8,ENSG00000245281.2,18084386,8-18076520-T-A,rs7462991,1,T,A,18076520,7866,17887778,18280994,188742
8,ENSG00000245281.2,18084386,8-18076520-T-C,rs7462991,1,T,C,18076520,7866,17887778,18280994,188742
8,ENSG00000183154.1,37737426,8-37778131-A-G,rs7463174,-1,A,G,37778131,40705,37540818,37934034,237313
8,ENSG00000253716.1,143281705,8-143223253-A-G,rs75548654,-1,A,G,143223253,58452,143085097,143478313,138156
8,ENSG00000236191.3,68525906,8-68668440-C-T,rs763845,-1,C,T,68668440,142534,68329298,68722514,339142
8,ENSG00000228801.4,51899268,8-51928701-A-G,rs7814421,1,A,G,51928701,29433,51702660,52095876,226041
8,ENSG00000245025.2,23007531,8-22918701-A-G,rs7832111,-1,A,G,22918701,88830,22810923,23204139,107778
8,ENSG00000253669.2,102805517,8-102981228-G-A,rs78483911,1,G,A,102981228,175711,102608909,103002125,372319
8,ENSG00000253982.1,1764508,8-1857326-G-A,rs78760458,-1,G,A,1857326,92818,1567900,1961116,289426
8,ENSG00000255559.1,145002811,8-144837006-C-T,rs79007298,1,C,T,144837006,165805,144806203,145199419,30803
8,ENSG00000245164.2,126292788,8-126252930-T-C,rs79283829,-1,T,C,126252930,39858,126096180,126489396,156750
8,ENSG00000253317.1,72196334,8-72342256-T-C,rs79632275,1,T,C,72342256,145922,71999726,72392942,342530
8,ENSG00000245149.3,124474564,8-124594634-C-T,rs80220466,-1,C,T,124594634,120070,124277956,124671172,316678
8,ENSG00000245149.3,124474564,8-124594634-C-G,rs80220466,-1,C,G,124594634,120070,124277956,124671172,316678
8,ENSG00000261220.1,133572158,8-133609443-A-G,rs9643306,1,A,G,133609443,37285,133375550,133768766,233893
8,ENSG00000249898.3,6708209,8-6670089-C-G,rs10092065,-1,C,G,6670089,38120,6511601,6904817,158488
8,ENSG00000243181.2,34874159,8-35005684-T-G,rs10103839,1,T,G,35005684,131525,34677551,35070767,328133
8,ENSG00000243181.2,34874159,8-35005684-T-C,rs10103839,1,T,C,35005684,131525,34677551,35070767,328133
8,ENSG00000251191.2,29735223,8-29678789-C-A,rs10105138,-1,C,A,29678789,56434,29538615,29931831,140174
8,ENSG00000253629.1,101686547,8-101758750-C-G,rs10111993,1,C,G,101758750,72203,101489939,101883155,268811
8,ENSG00000254812.1,143632783,8-143614871-A-T,rs1049832,-1,A,T,143614871,17912,143436175,143829391,178696
8,ENSG00000254812.1,143632783,8-143614871-A-G,rs1049832,-1,A,G,143614871,17912,143436175,143829391,178696
8,ENSG00000248492.1,134598071,8-134623238-C-A,rs1077224,1,C,A,134623238,25167,134401463,134794679,221775
8,ENSG00000248492.1,134598071,8-134623238-C-T,rs1077224,1,C,T,134623238,25167,134401463,134794679,221775
8,ENSG00000245970.2,98041726,8-98214929-T-C,rs10955157,1,T,C,98214929,173203,97845118,98238334,369811
8,ENSG00000240738.1,33860223,8-33692373-T-A,rs1121332,-1,T,A,33692373,167850,33663615,34056831,28758
8,ENSG00000240738.1,33860223,8-33692373-T-G,rs1121332,-1,T,G,33692373,167850,33663615,34056831,28758
8,ENSG00000240738.1,33860223,8-33692373-T-C,rs1121332,-1,T,C,33692373,167850,33663615,34056831,28758
8,ENSG00000253793.1,30984321,8-31116944-T-C,rs11574307,-1,T,C,31116944,132623,30787713,31180929,329231
8,ENSG00000188512.5,33969879,8-33999157-C-T,rs117164842,-1,C,T,33999157,29278,33773271,34166487,225886
8,ENSG00000253837.1,23336208,8-23193842-T-A,rs11779484,1,T,A,23193842,142366,23139600,23532816,54242
8,ENSG00000253837.1,23336208,8-23193842-T-G,rs11779484,1,T,G,23193842,142366,23139600,23532816,54242
8,ENSG00000253837.1,23336208,8-23193842-T-C,rs11779484,1,T,C,23193842,142366,23139600,23532816,54242
8,ENSG00000253468.1,98413784,8-98423424-A-G,rs11785588,-1,A,G,98423424,9640,98217176,98610392,206248
8,ENSG00000212994.4,100895771,8-100861443-T-C,rs11994674,1,T,C,100861443,34328,100699163,101092379,162280
8,ENSG00000247134.2,32927913,8-32980776-C-T,rs11997316,1,C,T,32980776,52863,32731305,33124521,249471
8,ENSG00000247081.2,103285907,8-103153554-C-T,rs12335035,-1,C,T,103153554,132353,103089299,103482515,64255
8,ENSG00000246339.3,28702030,8-28760798-C-T,rs12544882,-1,C,T,28760798,58768,28505422,28898638,255376
8,ENSG00000232600.2,144437675,8-144378477-C-G,rs12548842,1,C,G,144378477,59198,144241067,144634283,137410
8,ENSG00000232600.2,144437675,8-144378477-C-T,rs12548842,1,C,T,144378477,59198,144241067,144634283,137410
8,ENSG00000232600.2,144437675,8-144378477-C-A,rs12548842,1,C,A,144378477,59198,144241067,144634283,137410
8,ENSG00000254006.1,64817573,8-64833339-T-C,rs12550805,-1,T,C,64833339,15766,64620965,65014181,212374
8,ENSG00000254244.1,4787332,8-4952410-T-C,rs12675859,1,T,C,4952410,165078,4590724,4983940,361686
8,ENSG00000253690.1,28339255,8-28314981-A-T,rs12677384,-1,A,T,28314981,24274,28142647,28535863,172334
8,ENSG00000253690.1,28339255,8-28314981-A-G,rs12677384,-1,A,G,28314981,24274,28142647,28535863,172334
8,ENSG00000253704.1,94553668,8-94596511-A-T,rs12681615,1,A,T,94596511,42843,94357060,94750276,239451
8,ENSG00000253704.1,94553668,8-94596511-A-G,rs12681615,1,A,G,94596511,42843,94357060,94750276,239451
8,ENSG00000248738.2,22877984,8-22806014-A-G,rs12682049,1,A,G,22806014,71970,22681376,23074592,124638
8,ENSG00000261220.1,133572158,8-133592474-C-T,rs12682528,1,C,T,133592474,20316,133375550,133768766,216924
8,ENSG00000250979.1,72251565,8-72075660-G-C,rs13269625,-1,G,C,72075660,175905,72054957,72448173,20703
8,ENSG00000250979.1,72251565,8-72075660-G-T,rs13269625,-1,G,T,72075660,175905,72054957,72448173,20703
8,ENSG00000250979.1,72251565,8-72075660-G-A,rs13269625,-1,G,A,72075660,175905,72054957,72448173,20703
8,ENSG00000253716.1,143281705,8-143201207-T-C,rs13270969,-1,T,C,143201207,80498,143085097,143478313,116110
8,ENSG00000260588.1,41829934,8-41995368-T-C,rs13271816,-1,T,C,41995368,165434,41633326,42026542,362042
8,ENSG00000250031.1,58426685,8-58393415-G-C,rs1457049,-1,G,C,58393415,33270,58230077,58623293,163338
8,ENSG00000250031.1,58426685,8-58393415-G-T,rs1457049,-1,G,T,58393415,33270,58230077,58623293,163338
8,ENSG00000225885.1,118291208,8-118175275-G-A,rs1457199,1,G,A,118175275,115933,118094600,118487816,80675
8,ENSG00000253374.1,81521618,8-81507277-A-G,rs1485999,1,A,G,81507277,14341,81325010,81718226,182267
8,ENSG00000253374.1,81521618,8-81507277-A-C,rs1485999,1,A,C,81507277,14341,81325010,81718226,182267
8,ENSG00000253389.1,41660991,8-41581105-A-C,rs1559742,1,A,C,41581105,79886,41464383,41857599,116722
8,ENSG00000254013.1,30027713,8-30221133-A-G,rs1566739,1,A,G,30221133,193420,29831105,30224321,390028
8,ENSG00000253607.1,123002560,8-123187200-G-C,rs1670171,1,G,C,123187200,184640,122805952,123199168,381248
8,ENSG00000253607.1,123002560,8-123187200-G-A,rs1670171,1,G,A,123187200,184640,122805952,123199168,381248
8,ENSG00000228451.3,26381519,8-26422349-C-A,rs17055205,-1,C,A,26422349,40830,26184911,26578127,237438
8,ENSG00000228451.3,26381519,8-26422349-C-T,rs17055205,-1,C,T,26422349,40830,26184911,26578127,237438
8,ENSG00000253930.1,23189279,8-23027075-C-A,rs17088896,1,C,A,23027075,162204,22992671,23385887,34404
8,ENSG00000253930.1,23189279,8-23027075-C-G,rs17088896,1,C,G,23027075,162204,22992671,23385887,34404
8,ENSG00000253893.1,8226614,8-8294694-T-A,rs17155246,-1,T,A,8294694,68080,8030006,8423222,264688
8,ENSG00000261618.1,78835307,8-78777400-C-T,rs17505589,1,C,T,78777400,57907,78638699,79031915,138701
8,ENSG00000240395.1,42342634,8-42272011-C-T,rs17875658,-1,C,T,42272011,70623,42146026,42539242,125985
8,ENSG00000240395.1,42342634,8-42272011-C-A,rs17875658,-1,C,A,42272011,70623,42146026,42539242,125985
8,ENSG00000245080.3,95072920,8-95111153-A-G,rs2044035,-1,A,G,95111153,38233,94876312,95269528,234841
8,ENSG00000246089.2,6406572,8-6406418-C-T,rs2243755,-1,C,T,6406418,154,6209964,6603180,196454
8,ENSG00000255050.1,143573490,8-143575430-G-A,rs2290416,1,G,A,143575430,1940,143376882,143770098,198548
8,ENSG00000254285.2,61578220,8-61615586-C-T,rs2350622,1,C,T,61615586,37366,61381612,61774828,233974
8,ENSG00000254285.2,61578220,8-61615586-C-G,rs2350622,1,C,G,61615586,37366,61381612,61774828,233974
8,ENSG00000254389.1,143368548,8-143331246-G-T,rs2450772,-1,G,T,143331246,37302,143171940,143565156,159306
8,ENSG00000254389.1,143368548,8-143331246-G-A,rs2450772,-1,G,A,143331246,37302,143171940,143565156,159306
8,ENSG00000251013.1,100551713,8-100583678-T-C,rs2507778,-1,T,C,100583678,31965,100355105,100748321,228573
8,ENSG00000251013.1,100551713,8-100583678-T-A,rs2507778,-1,T,A,100583678,31965,100355105,100748321,228573
8,ENSG00000229211.3,31220984,8-31199581-A-T,rs2553239,-1,A,T,31199581,21403,31024376,31417592,175205
8,ENSG00000229211.3,31220984,8-31199581-A-C,rs2553239,-1,A,C,31199581,21403,31024376,31417592,175205
8,ENSG00000253476.1,25426580,8-25317207-T-A,rs2666168,-1,T,A,25317207,109373,25229972,25623188,87235
8,ENSG00000253476.1,25426580,8-25317207-T-C,rs2666168,-1,T,C,25317207,109373,25229972,25623188,87235
8,ENSG00000253167.1,125040684,8-124961673-T-A,rs2725881,1,T,A,124961673,79011,124844076,125237292,117597
8,ENSG00000253167.1,125040684,8-124961673-T-G,rs2725881,1,T,G,124961673,79011,124844076,125237292,117597
8,ENSG00000188856.6,80558870,8-80560139-A-G,rs272596,1,A,G,80560139,1269,80362262,80755478,197877
8,ENSG00000188856.6,80558870,8-80560139-A-T,rs272596,1,A,T,80560139,1269,80362262,80755478,197877
8,ENSG00000250483.1,15807283,8-15848734-A-C,rs2736003,-1,A,C,15848734,41451,15610675,16003891,238059
8,ENSG00000250483.1,15807283,8-15848734-A-G,rs2736003,-1,A,G,15848734,41451,15610675,16003891,238059
8,ENSG00000250483.1,15807283,8-15848734-A-T,rs2736003,-1,A,T,15848734,41451,15610675,16003891,238059
8,ENSG00000253896.2,72601,8-244943-C-G,rs2906332,1,C,G,244943,172342,-124007,269209,368950
8,ENSG00000253896.2,72601,8-244943-C-T,rs2906332,1,C,T,244943,172342,-124007,269209,368950
8,ENSG00000223508.4,213707,8-244943-C-G,rs2906332,-1,C,G,244943,31236,17099,410315,227844
8,ENSG00000223508.4,213707,8-244943-C-T,rs2906332,-1,C,T,244943,31236,17099,410315,227844
8,ENSG00000245149.3,124474564,8-124430010-C-G,rs35630807,-1,C,G,124430010,44554,124277956,124671172,152054
8,ENSG00000245149.3,124474564,8-124430010-C-T,rs35630807,-1,C,T,124430010,44554,124277956,124671172,152054
8,ENSG00000181097.5,143696154,8-143848710-A-G,rs35978234,1,A,G,143848710,152556,143499546,143892762,349164
8,ENSG00000249258.2,17131181,8-17058255-G-A,rs3862107,1,G,A,17058255,72926,16934573,17327789,123682
8,ENSG00000251136.2,89757383,8-89833814-T-G,rs39519,-1,T,G,89833814,76431,89560775,89953991,273039
8,ENSG00000253981.1,8241411,8-8385290-C-A,rs4240617,-1,C,A,8385290,143879,8044803,8438019,340487
8,ENSG00000253981.1,8241411,8-8385290-C-G,rs4240617,-1,C,G,8385290,143879,8044803,8438019,340487
8,ENSG00000253981.1,8241411,8-8385290-C-T,rs4240617,-1,C,T,8385290,143879,8044803,8438019,340487
8,ENSG00000251470.1,46697630,8-46573448-T-C,rs4480127,1,T,C,46573448,124182,46501022,46894238,72426
8,ENSG00000253214.1,81154265,8-81118320-T-C,rs4481546,1,T,C,81118320,35945,80957657,81350873,160663
8,ENSG00000243095.1,39158701,8-39285031-G-C,rs4551318,-1,G,C,39285031,126330,38962093,39355309,322938
8,ENSG00000243095.1,39158701,8-39285031-G-T,rs4551318,-1,G,T,39285031,126330,38962093,39355309,322938
8,ENSG00000243095.1,39158701,8-39285031-G-A,rs4551318,-1,G,A,39285031,126330,38962093,39355309,322938
8,ENSG00000253408.1,42271253,8-42149300-G-A,rs4615558,-1,G,A,42149300,121953,42074645,42467861,74655
8,ENSG00000253633.1,102528740,8-102541773-G-C,rs4734638,1,G,C,102541773,13033,102332132,102725348,209641
8,ENSG00000254741.1,143579636,8-143462025-C-T,rs4874138,1,C,T,143462025,117611,143383028,143776244,78997
8,ENSG00000254578.1,144463817,8-144411764-G-C,rs4925820,1,G,C,144411764,52053,144267209,144660425,144555
8,ENSG00000254578.1,144463817,8-144411764-G-T,rs4925820,1,G,T,144411764,52053,144267209,144660425,144555
8,ENSG00000177335.6,143039328,8-143098043-T-G,rs4977114,1,T,G,143098043,58715,142842720,143235936,255323
8,ENSG00000177335.6,143039328,8-143098043-T-C,rs4977114,1,T,C,143098043,58715,142842720,143235936,255323
8,ENSG00000253200.1,22616657,8-22614675-A-G,rs55677256,-1,A,G,22614675,1982,22420049,22813265,194626
8,ENSG00000244052.1,102924255,8-102951456-G-T,rs56255879,-1,G,T,102951456,27201,102727647,103120863,223809
8,ENSG00000244052.1,102924255,8-102951456-G-C,rs56255879,-1,G,C,102951456,27201,102727647,103120863,223809
8,ENSG00000246582.2,23225221,8-23097822-C-T,rs62501084,1,C,T,23097822,127399,23028613,23421829,69209
8,ENSG00000250714.2,23230915,8-23097822-C-T,rs62501084,-1,C,T,23097822,133093,23034307,23427523,63515
8,ENSG00000260253.1,29353170,8-29216886-C-G,rs62502853,-1,C,G,29216886,136284,29156562,29549778,60324
8,ENSG00000260253.1,29353170,8-29216886-C-T,rs62502853,-1,C,T,29216886,136284,29156562,29549778,60324
8,ENSG00000183154.1,37737426,8-37623272-A-G,rs6468424,-1,A,G,37623272,114154,37540818,37934034,82454
8,ENSG00000183154.1,37737426,8-37623272-A-T,rs6468424,-1,A,T,37623272,114154,37540818,37934034,82454
8,ENSG00000183154.1,37737426,8-37623272-A-C,rs6468424,-1,A,C,37623272,114154,37540818,37934034,82454
8,ENSG00000254319.1,2728434,8-2725657-G-A,rs6558680,-1,G,A,2725657,2777,2531826,2925042,193831
8,ENSG00000254319.1,2728434,8-2725657-G-T,rs6558680,-1,G,T,2725657,2777,2531826,2925042,193831
8,ENSG00000253605.1,141459075,8-141528639-C-G,rs6578201,1,C,G,141528639,69564,141262467,141655683,266172
8,ENSG00000253605.1,141459075,8-141528639-C-T,rs6578201,1,C,T,141528639,69564,141262467,141655683,266172
8,ENSG00000255559.1,145002811,8-144917236-T-G,rs6599542,1,T,G,144917236,85575,144806203,145199419,111033
8,ENSG00000255559.1,145002811,8-144917236-T-C,rs6599542,1,T,C,144917236,85575,144806203,145199419,111033
8,ENSG00000259366.1,29055929,8-29239127-T-A,rs66594408,1,T,A,29239127,183198,28859321,29252537,379806
8,ENSG00000259366.1,29055929,8-29239127-T-C,rs66594408,1,T,C,29239127,183198,28859321,29252537,379806
8,ENSG00000253174.1,41545044,8-41659396-C-T,rs6981587,-1,C,T,41659396,114352,41348436,41741652,310960
8,ENSG00000254129.1,29110573,8-29203064-G-A,rs6989058,1,G,A,29203064,92491,28913965,29307181,289099
8,ENSG00000254037.1,119480775,8-119491107-G-T,rs6996535,-1,G,T,119491107,10332,119284167,119677383,206940
8,ENSG00000254037.1,119480775,8-119491107-G-A,rs6996535,-1,G,A,119491107,10332,119284167,119677383,206940
8,ENSG00000254266.1,78508485,8-78372272-A-C,rs7016026,-1,A,C,78372272,136213,78311877,78705093,60395
8,ENSG00000254266.1,78508485,8-78372272-A-T,rs7016026,-1,A,T,78372272,136213,78311877,78705093,60395
8,ENSG00000213750.4,97625079,8-97783971-T-C,rs72671588,-1,T,C,97783971,158892,97428471,97821687,355500
8,ENSG00000254185.1,109470131,8-109497855-C-T,rs72687045,1,C,T,109497855,27724,109273523,109666739,224332
8,ENSG00000245281.2,18084386,8-18085674-A-G,rs7388634,1,A,G,18085674,1288,17887778,18280994,197896
8,ENSG00000254088.1,86503591,8-86322968-G-A,rs7460286,1,G,A,86322968,180623,86306983,86700199,15985
8,ENSG00000254088.1,86503591,8-86322968-G-C,rs7460286,1,G,C,86322968,180623,86306983,86700199,15985
8,ENSG00000253125.1,22690150,8-22883948-T-C,rs74753129,1,T,C,22883948,193798,22493542,22886758,390406
8,ENSG00000255164.1,144992914,8-145038733-T-C,rs75940910,1,T,C,145038733,45819,144796306,145189522,242427
8,ENSG00000253517.1,62857134,8-62982677-C-T,rs76268189,-1,C,T,62982677,125543,62660526,63053742,322151
8,ENSG00000253616.1,23074488,8-23108797-G-A,rs76666473,-1,G,A,23108797,34309,22877880,23271096,230917
8,ENSG00000248578.1,56102267,8-56221766-G-A,rs76895802,-1,G,A,56221766,119499,55905659,56298875,316107
8,ENSG00000253741.1,142726992,8-142737982-C-T,rs77377310,-1,C,T,142737982,10990,142530384,142923600,207598
8,ENSG00000254162.1,80539135,8-80421426-C-T,rs77717708,-1,C,T,80421426,117709,80342527,80735743,78899
8,ENSG00000253649.1,10517983,8-10411865-T-A,rs7817793,-1,T,A,10411865,106118,10321375,10714591,90490
8,ENSG00000253649.1,10517983,8-10411865-T-C,rs7817793,-1,T,C,10411865,106118,10321375,10714591,90490
8,ENSG00000261451.1,10433672,8-10520895-T-A,rs7834351,1,T,A,10520895,87223,10237064,10630280,283831
8,ENSG00000261451.1,10433672,8-10520895-T-G,rs7834351,1,T,G,10520895,87223,10237064,10630280,283831
8,ENSG00000261451.1,10433672,8-10520895-T-C,rs7834351,1,T,C,10520895,87223,10237064,10630280,283831
8,ENSG00000167912.5,59119216,8-59008854-C-G,rs826595,1,C,G,59008854,110362,58922608,59315824,86246
8,ENSG00000167912.5,59119216,8-59008854-C-T,rs826595,1,C,T,59008854,110362,58922608,59315824,86246
8,ENSG00000255046.1,11802512,8-11878430-C-A,rs880632,-1,C,A,11878430,75918,11605904,11999120,272526
8,ENSG00000254859.1,143549729,8-143566472-A-T,rs896946,-1,A,T,143566472,16743,143353121,143746337,213351
8,ENSG00000254859.1,143549729,8-143566472-A-C,rs896946,-1,A,C,143566472,16743,143353121,143746337,213351
8,ENSG00000254859.1,143549729,8-143566472-A-G,rs896946,-1,A,G,143566472,16743,143353121,143746337,213351
8,ENSG00000250929.2,103121032,8-103047974-C-A,rs9283939,1,C,A,103047974,73058,102924424,103317640,123550
8,ENSG00000250929.2,103121032,8-103047974-C-T,rs9283939,1,C,T,103047974,73058,102924424,103317640,123550
8,ENSG00000254307.1,94792963,8-94806406-C-A,rs9643349,-1,C,A,94806406,13443,94596355,94989571,210051
8,ENSG00000254307.1,94792963,8-94806406-C-G,rs9643349,-1,C,G,94806406,13443,94596355,94989571,210051
8,ENSG00000254307.1,94792963,8-94806406-C-T,rs9643349,-1,C,T,94806406,13443,94596355,94989571,210051
8,ENSG00000254690.1,144315138,8-144231580-G-A,rs9720889,-1,G,A,144231580,83558,144118530,144511746,113050
8,ENSG00000254690.1,144315138,8-144231580-G-C,rs9720889,-1,G,C,144231580,83558,144118530,144511746,113050
8,ENSG00000241511.1,30117779,8-30020213-G-A,rs991124,-1,G,A,30020213,97566,29921171,30314387,99042
8,ENSG00000241511.1,30117779,8-30020213-G-T,rs991124,-1,G,T,30020213,97566,29921171,30314387,99042
7,ENSG00000235368.1,57424503,7-57505226-G-A,rs10081282,1,G,A,57505226,80723,57227895,57621111,277331
7,ENSG00000235368.1,57424503,7-57505226-G-C,rs10081282,1,G,C,57505226,80723,57227895,57621111,277331
7,ENSG00000214293.4,77696265,7-77699012-A-C,rs10216002,-1,A,C,77699012,2747,77499657,77892873,199355
7,ENSG00000214783.4,44019149,7-43945746-T-C,rs10229021,-1,T,C,43945746,73403,43822541,44215757,123205
7,ENSG00000227053.1,101017665,7-101015436-T-C,rs10229453,-1,T,C,101015436,2229,100821057,101214273,194379
7,ENSG00000230658.1,23105703,7-23110331-C-T,rs10239760,-1,C,T,23110331,4628,22909095,23302311,201236
7,ENSG00000237286.1,2944035,7-2781966-T-C,rs10254662,1,T,C,2781966,162069,2747427,3140643,34539
7,ENSG00000224046.1,87152420,7-87226691-A-C,rs10273826,-1,A,C,87226691,74271,86955812,87349028,270879
7,ENSG00000224046.1,87152420,7-87226691-A-T,rs10273826,-1,A,T,87226691,74271,86955812,87349028,270879
7,ENSG00000240758.1,128455937,7-128429608-A-G,rs1035971,1,A,G,128429608,26329,128259329,128652545,170279
7,ENSG00000240758.1,128455937,7-128429608-A-T,rs1035971,1,A,T,128429608,26329,128259329,128652545,170279
7,ENSG00000188185.6,39733632,7-39610768-T-C,rs10486797,1,T,C,39610768,122864,39537024,39930240,73744
7,ENSG00000213261.3,131662624,7-131792785-A-G,rs10488337,-1,A,G,131792785,130161,131466016,131859232,326769
7,ENSG00000236081.1,1742272,7-1748644-G-C,rs10950352,-1,G,C,1748644,6372,1545664,1938880,202980
7,ENSG00000236081.1,1742272,7-1748644-G-A,rs10950352,-1,G,A,1748644,6372,1545664,1938880,202980
7,ENSG00000224016.2,149909704,7-149814897-A-T,rs10952230,-1,A,T,149814897,94807,149713096,150106312,101801
7,ENSG00000224016.2,149909704,7-149814897-A-G,rs10952230,-1,A,G,149814897,94807,149713096,150106312,101801
7,ENSG00000242562.1,106125371,7-106150519-C-T,rs10953493,1,C,T,106150519,25148,105928763,106321979,221756
7,ENSG00000242562.1,106125371,7-106150519-C-A,rs10953493,1,C,A,106150519,25148,105928763,106321979,221756
7,ENSG00000237181.1,602792,7-592301-G-A,rs112653255,1,G,A,592301,10491,406184,799400,186117
7,ENSG00000235859.4,30371508,7-30338371-C-T,rs112995369,1,C,T,30338371,33137,30174900,30568116,163471
7,ENSG00000239969.1,102375808,7-102473643-T-G,rs1131359,1,T,G,102473643,97835,102179200,102572416,294443
7,ENSG00000239969.1,102375808,7-102473643-T-C,rs1131359,1,T,C,102473643,97835,102179200,102572416,294443
7,ENSG00000242258.1,150433654,7-150628290-T-C,rs114540180,1,T,C,150628290,194636,150237046,150630262,391244
7,ENSG00000224138.1,127350128,7-127361603-A-C,rs11563465,1,A,C,127361603,11475,127153520,127546736,208083
7,ENSG00000224138.1,127350128,7-127361603-A-G,rs11563465,1,A,G,127361603,11475,127153520,127546736,208083
7,ENSG00000241136.1,143782667,7-143735459-G-A,rs117060634,1,G,A,143735459,47208,143586059,143979275,149400
7,ENSG00000234927.1,121050927,7-121130056-A-G,rs117201097,1,A,G,121130056,79129,120854319,121247535,275737
7,ENSG00000234927.1,121050927,7-121130056-A-C,rs117201097,1,A,C,121130056,79129,120854319,121247535,275737
7,ENSG00000228335.1,99443496,7-99334497-C-G,rs117316159,-1,C,G,99334497,108999,99246888,99640104,87609
7,ENSG00000224448.1,99638767,7-99632145-G-A,rs11734,-1,G,A,99632145,6622,99442159,99835375,189986
7,ENSG00000224448.1,99638767,7-99632145-G-C,rs11734,-1,G,C,99632145,6622,99442159,99835375,189986
7,ENSG00000228960.4,144299373,7-144126740-T-C,rs11763619,1,T,C,144126740,172633,144102765,144495981,23975
7,ENSG00000204959.3,144286966,7-144126740-T-C,rs11763619,-1,T,C,144126740,160226,144090358,144483574,36382
7,ENSG00000228775.3,141738230,7-141762737-G-A,rs11763979,-1,G,A,141762737,24507,141541622,141934838,221115
7,ENSG00000228775.3,141738230,7-141762737-G-T,rs11763979,-1,G,T,141762737,24507,141541622,141934838,221115
7,ENSG00000261305.1,150337483,7-150328826-G-A,rs11764936,1,G,A,150328826,8657,150140875,150534091,187951
7,ENSG00000261305.1,150337483,7-150328826-G-T,rs11764936,1,G,T,150328826,8657,150140875,150534091,187951
7,ENSG00000227986.1,64355078,7-64385366-G-A,rs11765812,1,G,A,64385366,30288,64158470,64551686,226896
7,ENSG00000078319.7,100335860,7-100475669-A-G,rs11766752,-1,A,G,100475669,139809,100139252,100532468,336417
7,ENSG00000164556.7,38687037,7-38708182-T-C,rs11770470,-1,T,C,38708182,21145,38490429,38883645,217753
7,ENSG00000164556.7,38687037,7-38708182-T-G,rs11770470,-1,T,G,38708182,21145,38490429,38883645,217753
7,ENSG00000237310.1,66493659,7-66517644-T-G,rs11773628,1,T,G,66517644,23985,66297051,66690267,220593
7,ENSG00000230882.1,76074963,7-75900750-C-T,rs118025992,-1,C,T,75900750,174213,75878355,76271571,22395
7,ENSG00000238228.1,97947998,7-97963894-T-C,rs11971168,-1,T,C,97963894,15896,97751390,98144606,212504
7,ENSG00000182165.12,87345551,7-87337602-C-T,rs11976069,-1,C,T,87337602,7949,87148943,87542159,188659
7,ENSG00000226869.2,104804088,7-104657355-T-C,rs11977439,-1,T,C,104657355,146733,104607480,105000696,49875
7,ENSG00000232729.1,74728862,7-74592868-G-A,rs11978193,-1,G,A,74592868,135994,74532254,74925470,60614
7,ENSG00000232729.1,74728862,7-74592868-G-T,rs11978193,-1,G,T,74592868,135994,74532254,74925470,60614
7,ENSG00000225969.1,73735407,7-73774244-C-T,rs11979680,1,C,T,73774244,38837,73538799,73932015,235445
7,ENSG00000225969.1,73735407,7-73774244-C-G,rs11979680,1,C,G,73774244,38837,73538799,73932015,235445
7,ENSG00000260997.1,44960909,7-45046439-C-T,rs12531817,-1,C,T,45046439,85530,44764301,45157517,282138
7,ENSG00000227233.1,51382284,7-51324906-C-T,rs12536042,1,C,T,51324906,57378,51185676,51578892,139230
7,ENSG00000227233.1,51382284,7-51324906-C-A,rs12536042,1,C,A,51324906,57378,51185676,51578892,139230
7,ENSG00000254959.1,30752137,7-30774528-C-T,rs12701027,1,C,T,30774528,22391,30555529,30948745,218999
7,ENSG00000231531.3,143313061,7-143465551-G-A,rs12703532,-1,G,A,143465551,152490,143116453,143509669,349098
7,ENSG00000231531.3,143313061,7-143465551-G-C,rs12703532,-1,G,C,143465551,152490,143116453,143509669,349098
7,ENSG00000231531.3,143313061,7-143465551-G-T,rs12703532,-1,G,T,143465551,152490,143116453,143509669,349098
7,ENSG00000231198.1,39833793,7-39711559-C-G,rs13228455,-1,C,G,39711559,122234,39637185,40030401,74374
7,ENSG00000231198.1,39833793,7-39711559-C-A,rs13228455,-1,C,A,39711559,122234,39637185,40030401,74374
7,ENSG00000231198.1,39833793,7-39711559-C-T,rs13228455,-1,C,T,39711559,122234,39637185,40030401,74374
7,ENSG00000239919.1,129477875,7-129592879-G-A,rs13233824,1,G,A,129592879,115004,129281267,129674483,311612
7,ENSG00000197258.5,104667749,7-104504457-A-T,rs13234004,1,A,T,104504457,163292,104471141,104864357,33316
7,ENSG00000232053.1,136092923,7-135937098-T-C,rs13242292,1,T,C,135937098,155825,135896315,136289531,40783
7,ENSG00000186676.3,125033453,7-125144551-A-C,rs13246702,1,A,C,125144551,111098,124836845,125230061,307706
7,ENSG00000186676.3,125033453,7-125144551-A-T,rs13246702,1,A,T,125144551,111098,124836845,125230061,307706
7,ENSG00000214754.3,47052793,7-46932135-C-T,rs13247397,1,C,T,46932135,120658,46856185,47249401,75950
7,ENSG00000231519.1,30075115,7-29962992-C-A,rs1465327,-1,C,A,29962992,112123,29878507,30271723,84485
7,ENSG00000231519.1,30075115,7-29962992-C-T,rs1465327,-1,C,T,29962992,112123,29878507,30271723,84485
7,ENSG00000236976.1,64142401,7-64065867-A-G,rs1595620,-1,A,G,64065867,76534,63945793,64339009,120074
7,ENSG00000232400.1,16866308,7-16844617-T-C,rs17136737,-1,T,C,16844617,21691,16669700,17062916,174917
7,ENSG00000232400.1,16866308,7-16844617-T-G,rs17136737,-1,T,G,16844617,21691,16669700,17062916,174917
7,ENSG00000242261.1,128306649,7-128319168-G-A,rs17152002,1,G,A,128319168,12519,128110041,128503257,209127
7,ENSG00000226624.1,105819492,7-105810520-T-G,rs17152163,1,T,G,105810520,8972,105622884,106016100,187636
7,ENSG00000226624.1,105819492,7-105810520-T-C,rs17152163,1,T,C,105810520,8972,105622884,106016100,187636
7,ENSG00000244480.1,30524535,7-30594717-C-T,rs17159262,-1,C,T,30594717,70182,30327927,30721143,266790
7,ENSG00000243746.1,144648575,7-144637715-C-T,rs17287011,-1,C,T,144637715,10860,144451967,144845183,185748
7,ENSG00000232533.1,143381036,7-143342613-T-C,rs17381401,-1,T,C,143342613,38423,143184428,143577644,158185
7,ENSG00000232533.1,143381036,7-143342613-T-A,rs17381401,-1,T,A,143342613,38423,143184428,143577644,158185
7,ENSG00000227017.1,30179014,7-30183931-G-A,rs17451490,-1,G,A,30183931,4917,29982406,30375622,201525
7,ENSG00000244479.2,144355520,7-144173412-C-G,rs17591937,-1,C,G,144173412,182108,144158912,144552128,14500
7,ENSG00000244479.2,144355520,7-144173412-C-A,rs17591937,-1,C,A,144173412,182108,144158912,144552128,14500
7,ENSG00000244479.2,144355520,7-144173412-C-T,rs17591937,-1,C,T,144173412,182108,144158912,144552128,14500
7,ENSG00000237972.1,43918697,7-43952298-G-A,rs17654788,1,G,A,43952298,33601,43722089,44115305,230209
7,ENSG00000236105.1,127295620,7-127270520-T-C,rs17869257,1,T,C,127270520,25100,127099012,127492228,171508
7,ENSG00000239377.1,150383885,7-150394943-G-T,rs1880316,-1,G,T,150394943,11058,150187277,150580493,207666
7,ENSG00000239377.1,150383885,7-150394943-G-A,rs1880316,-1,G,A,150394943,11058,150187277,150580493,207666
7,ENSG00000224079.1,1074450,7-1057130-A-C,rs1881124,1,A,C,1057130,17320,877842,1271058,179288
7,ENSG00000235090.1,75922755,7-76003891-T-A,rs2058389,1,T,A,76003891,81136,75726147,76119363,277744
7,ENSG00000235090.1,75922755,7-76003891-T-C,rs2058389,1,T,C,76003891,81136,75726147,76119363,277744
7,ENSG00000233306.2,38363518,7-38377955-A-C,rs2080284,-1,A,C,38377955,14437,38166910,38560126,211045
7,ENSG00000211701.2,38368169,7-38377955-A-C,rs2080284,-1,A,C,38377955,9786,38171561,38564777,206394
7,ENSG00000240132.1,151501878,7-151372608-A-G,rs2108725,1,A,G,151372608,129270,151305270,151698486,67338
7,ENSG00000205236.5,102642869,7-102735579-G-A,rs2109994,-1,G,A,102735579,92710,102446261,102839477,289318
7,ENSG00000211699.2,38359162,7-38365370-A-T,rs2160195,-1,A,T,38365370,6208,38162554,38555770,202816
7,ENSG00000211699.2,38359162,7-38365370-A-C,rs2160195,-1,A,C,38365370,6208,38162554,38555770,202816
7,ENSG00000211698.2,38354517,7-38365370-A-T,rs2160195,-1,A,T,38365370,10853,38157909,38551125,207461
7,ENSG00000211698.2,38354517,7-38365370-A-C,rs2160195,-1,A,C,38365370,10853,38157909,38551125,207461
7,ENSG00000236015.1,39570198,7-39514211-C-T,rs2329401,-1,C,T,39514211,55987,39373590,39766806,140621
7,ENSG00000236015.1,39570198,7-39514211-C-G,rs2329401,-1,C,G,39514211,55987,39373590,39766806,140621
7,ENSG00000236015.1,39570198,7-39514211-C-A,rs2329401,-1,C,A,39514211,55987,39373590,39766806,140621
7,ENSG00000243302.2,128651185,7-128641202-G-A,rs2402923,1,G,A,128641202,9983,128454577,128847793,186625
7,ENSG00000243302.2,128651185,7-128641202-G-T,rs2402923,1,G,T,128641202,9983,128454577,128847793,186625
7,ENSG00000243679.1,128653969,7-128641202-G-A,rs2402923,1,G,A,128641202,12767,128457361,128850577,183841
7,ENSG00000243679.1,128653969,7-128641202-G-T,rs2402923,1,G,T,128641202,12767,128457361,128850577,183841
7,ENSG00000233429.4,27096094,7-27104138-T-A,rs2522828,1,T,A,27104138,8044,26899486,27292702,204652
7,ENSG00000233429.4,27096094,7-27104138-T-G,rs2522828,1,T,G,27104138,8044,26899486,27292702,204652
7,ENSG00000233429.4,27096094,7-27104138-T-C,rs2522828,1,T,C,27104138,8044,26899486,27292702,204652
7,ENSG00000231419.2,159008421,7-158851177-T-C,rs2657323,1,T,C,158851177,157244,158811813,159205029,39364
7,ENSG00000196295.4,30562825,7-30602883-C-A,rs2709809,-1,C,A,30602883,40058,30366217,30759433,236666
7,ENSG00000196295.4,30562825,7-30602883-C-T,rs2709809,-1,C,T,30602883,40058,30366217,30759433,236666
7,ENSG00000196295.4,30562825,7-30602883-C-G,rs2709809,-1,C,G,30602883,40058,30366217,30759433,236666
7,ENSG00000260231.1,140177184,7-140349492-A-G,rs28670038,1,A,G,140349492,172308,139980576,140373792,368916
7,ENSG00000182722.5,64853354,7-64969122-G-A,rs28762167,-1,G,A,64969122,115768,64656746,65049962,312376
7,ENSG00000182722.5,64853354,7-64969122-G-T,rs28762167,-1,G,T,64969122,115768,64656746,65049962,312376
7,ENSG00000229043.1,1160374,7-1165064-C-T,rs2960840,1,C,T,1165064,4690,963766,1356982,201298
7,ENSG00000229043.1,1160374,7-1165064-C-G,rs2960840,1,C,G,1165064,4690,963766,1356982,201298
7,ENSG00000261455.1,152463786,7-152465124-A-C,rs3087586,1,A,C,152465124,1338,152267178,152660394,197946
7,ENSG00000261455.1,152463786,7-152465124-A-G,rs3087586,1,A,G,152465124,1338,152267178,152660394,197946
7,ENSG00000232445.1,101308270,7-101317673-A-G,rs34169259,1,A,G,101317673,9403,101111662,101504878,206011
7,ENSG00000214765.4,45765812,7-45728142-A-G,rs34262641,-1,A,G,45728142,37670,45569204,45962420,158938
7,ENSG00000214765.4,45765812,7-45728142-A-C,rs34262641,-1,A,C,45728142,37670,45569204,45962420,158938
7,ENSG00000230487.3,1570073,7-1588347-C-G,rs34990622,1,C,G,1588347,18274,1373465,1766681,214882
7,ENSG00000230487.3,1570073,7-1588347-C-T,rs34990622,1,C,T,1588347,18274,1373465,1766681,214882
7,ENSG00000234985.2,121441261,7-121329358-G-C,rs35391640,-1,G,C,121329358,111903,121244653,121637869,84705
7,ENSG00000230359.3,129056019,7-129150650-T-C,rs35625644,1,T,C,129150650,94631,128859411,129252627,291239
7,ENSG00000232956.2,44986961,7-45108420-C-T,rs3757574,-1,C,T,45108420,121459,44790353,45183569,318067
7,ENSG00000242798.1,100127139,7-100119278-C-G,rs3807479,-1,C,G,100119278,7861,99930531,100323747,188747
7,ENSG00000242798.1,100127139,7-100119278-C-A,rs3807479,-1,C,A,100119278,7861,99930531,100323747,188747
7,ENSG00000186704.8,76978617,7-76806756-A-C,rs38629,1,A,C,76806756,171861,76782009,77175225,24747
7,ENSG00000237004.2,32728569,7-32765338-T-A,rs4283951,1,T,A,32765338,36769,32531961,32925177,233377
7,ENSG00000228668.1,38345499,7-38373387-T-C,rs4373430,-1,T,C,38373387,27888,38148891,38542107,224496
7,ENSG00000182648.7,156640599,7-156649341-T-C,rs4716437,-1,T,C,156649341,8742,156443991,156837207,205350
7,ENSG00000229358.2,32761787,7-32663289-G-A,rs4723187,-1,G,A,32663289,98498,32565179,32958395,98110
7,ENSG00000228974.4,5560743,7-5471016-T-A,rs4724694,1,T,A,5471016,89727,5364135,5757351,106881
7,ENSG00000228974.4,5560743,7-5471016-T-C,rs4724694,1,T,C,5471016,89727,5364135,5757351,106881
7,ENSG00000228974.4,5560743,7-5471016-T-G,rs4724694,1,T,G,5471016,89727,5364135,5757351,106881
7,ENSG00000232581.1,6588974,7-6562061-A-C,rs4724823,-1,A,C,6562061,26913,6392366,6785582,169695
7,ENSG00000232581.1,6588974,7-6562061-A-T,rs4724823,-1,A,T,6562061,26913,6392366,6785582,169695
7,ENSG00000230191.1,56163145,7-56003589-T-C,rs4947533,1,T,C,56003589,159556,55966537,56359753,37052
7,ENSG00000230191.1,56163145,7-56003589-T-A,rs4947533,1,T,A,56003589,159556,55966537,56359753,37052
7,ENSG00000230191.1,56163145,7-56003589-T-G,rs4947533,1,T,G,56003589,159556,55966537,56359753,37052
7,ENSG00000188693.7,92134604,7-92089560-A-T,rs56295910,1,A,T,92089560,45044,91937996,92331212,151564
7,ENSG00000188693.7,92134604,7-92089560-A-G,rs56295910,1,A,G,92089560,45044,91937996,92331212,151564
7,ENSG00000243554.1,97972254,7-98000588-T-C,rs56310266,-1,T,C,98000588,28334,97775646,98168862,224942
7,ENSG00000243554.1,97972254,7-98000588-T-G,rs56310266,-1,T,G,98000588,28334,97775646,98168862,224942
7,ENSG00000214106.3,154928485,7-154924722-C-T,rs57164738,1,C,T,154924722,3763,154731877,155125093,192845
7,ENSG00000232759.1,22563337,7-22567443-A-G,rs59026448,1,A,G,22567443,4106,22366729,22759945,200714
7,ENSG00000127957.12,75516235,7-75420076-C-T,rs60932781,-1,C,T,75420076,96159,75319627,75712843,100449
7,ENSG00000223855.1,522573,7-522201-T-A,rs62433354,1,T,A,522201,372,325965,719181,196236
7,ENSG00000223855.1,522573,7-522201-T-G,rs62433354,1,T,G,522201,372,325965,719181,196236
7,ENSG00000223855.1,522573,7-522201-T-C,rs62433354,1,T,C,522201,372,325965,719181,196236
7,ENSG00000211697.2,38350022,7-38372517-G-A,rs62445058,-1,G,A,38372517,22495,38153414,38546630,219103
7,ENSG00000226278.1,55764797,7-55733981-G-A,rs62456609,1,G,A,55733981,30816,55568189,55961405,165792
7,ENSG00000233830.2,27458849,7-27626763-C-G,rs6462039,-1,C,G,27626763,167914,27262241,27655457,364522
7,ENSG00000233830.2,27458849,7-27626763-C-A,rs6462039,-1,C,A,27626763,167914,27262241,27655457,364522
7,ENSG00000236018.2,157198511,7-157190637-A-G,rs6951930,-1,A,G,157190637,7874,157001903,157395119,188734
7,ENSG00000231357.1,2835621,7-2879144-C-G,rs6957938,1,C,G,2879144,43523,2639013,3032229,240131
7,ENSG00000231357.1,2835621,7-2879144-C-T,rs6957938,1,C,T,2879144,43523,2639013,3032229,240131
7,ENSG00000224273.1,76132187,7-75963607-T-C,rs6965343,-1,T,C,75963607,168580,75935579,76328795,28028
7,ENSG00000229877.1,143546735,7-143431406-G-A,rs6966814,-1,G,A,143431406,115329,143350127,143743343,81279
7,ENSG00000239775.1,44064908,7-44058097-T-A,rs6968228,1,T,A,44058097,6811,43868300,44261516,189797
7,ENSG00000239775.1,44064908,7-44058097-T-C,rs6968228,1,T,C,44058097,6811,43868300,44261516,189797
7,ENSG00000237773.1,17299288,7-17247645-A-T,rs6968865,-1,A,T,17247645,51643,17102680,17495896,144965
7,ENSG00000235944.3,5823207,7-5814372-C-A,rs6969131,1,C,A,5814372,8835,5626599,6019815,187773
7,ENSG00000235944.3,5823207,7-5814372-C-T,rs6969131,1,C,T,5814372,8835,5626599,6019815,187773
7,ENSG00000235944.3,5823207,7-5814372-C-G,rs6969131,1,C,G,5814372,8835,5626599,6019815,187773
7,ENSG00000133624.9,149624565,7-149487759-C-A,rs6971236,-1,C,A,149487759,136806,149427957,149821173,59802
7,ENSG00000249773.3,55887277,7-55909457-G-C,rs6971250,1,G,C,55909457,22180,55690669,56083885,218788
7,ENSG00000249773.3,55887277,7-55909457-G-A,rs6971250,1,G,A,55909457,22180,55690669,56083885,218788
7,ENSG00000242588.1,128531707,7-128533903-G-A,rs6976331,1,G,A,128533903,2196,128335099,128728315,198804
7,ENSG00000230715.2,128652841,7-128533903-G-A,rs6976331,1,G,A,128533903,118938,128456233,128849449,77670
7,ENSG00000223500.1,135128444,7-135160561-T-G,rs700415,1,T,G,135160561,32117,134931836,135325052,228725
7,ENSG00000223500.1,135128444,7-135160561-T-A,rs700415,1,T,A,135160561,32117,134931836,135325052,228725
7,ENSG00000225792.1,26376237,7-26441611-C-T,rs73074126,-1,C,T,26441611,65374,26179629,26572845,261982
7,ENSG00000225792.1,26376237,7-26441611-C-A,rs73074126,-1,C,A,26441611,65374,26179629,26572845,261982
7,ENSG00000183444.9,97967074,7-97973341-T-C,rs73140974,-1,T,C,97973341,6267,97770466,98163682,202875
7,ENSG00000232199.1,109999624,7-110025238-T-A,rs73197951,-1,T,A,110025238,25614,109803016,110196232,222222
7,ENSG00000232199.1,109999624,7-110025238-T-G,rs73197951,-1,T,G,110025238,25614,109803016,110196232,222222
7,ENSG00000232199.1,109999624,7-110025238-T-C,rs73197951,-1,T,C,110025238,25614,109803016,110196232,222222
7,ENSG00000257607.1,1059261,7-1172231-G-A,rs73265375,-1,G,A,1172231,112970,862653,1255869,309578
7,ENSG00000257607.1,1059261,7-1172231-G-C,rs73265375,-1,G,C,1172231,112970,862653,1255869,309578
7,ENSG00000235243.1,84848253,7-84970513-A-G,rs74297479,-1,A,G,84970513,122260,84651645,85044861,318868
7,ENSG00000235243.1,84848253,7-84970513-A-C,rs74297479,-1,A,C,84970513,122260,84651645,85044861,318868
7,ENSG00000179131.6,66914581,7-66780299-G-A,rs74838615,1,G,A,66780299,134282,66717973,67111189,62326
7,ENSG00000224903.1,156659582,7-156514971-C-T,rs77129616,-1,C,T,156514971,144611,156462974,156856190,51997
7,ENSG00000230583.2,66833026,7-66841692-G-A,rs77366096,-1,G,A,66841692,8666,66636418,67029634,205274
7,ENSG00000067601.6,67299424,7-67235151-A-C,rs77634321,-1,A,C,67235151,64273,67102816,67496032,132335
7,ENSG00000067601.6,67299424,7-67235151-A-G,rs77634321,-1,A,G,67235151,64273,67102816,67496032,132335
7,ENSG00000223459.4,143598039,7-143734790-A-C,rs7776595,1,A,C,143734790,136751,143401431,143794647,333359
7,ENSG00000223459.4,143598039,7-143734790-A-T,rs7776595,1,A,T,143734790,136751,143401431,143794647,333359
7,ENSG00000223459.4,143598039,7-143734790-A-G,rs7776595,1,A,G,143734790,136751,143401431,143794647,333359
7,ENSG00000213394.3,101204495,7-101192334-G-A,rs7777110,-1,G,A,101192334,12161,101007887,101401103,184447
7,ENSG00000236453.1,94022833,7-93855969-G-C,rs7777209,1,G,C,93855969,166864,93826225,94219441,29744
7,ENSG00000236453.1,94022833,7-93855969-G-T,rs7777209,1,G,T,93855969,166864,93826225,94219441,29744
7,ENSG00000236453.1,94022833,7-93855969-G-A,rs7777209,1,G,A,93855969,166864,93826225,94219441,29744
7,ENSG00000170356.8,144251603,7-144164657-A-C,rs7779313,-1,A,C,144164657,86946,144054995,144448211,109662
7,ENSG00000170356.8,144251603,7-144164657-A-G,rs7779313,-1,A,G,144164657,86946,144054995,144448211,109662
7,ENSG00000225535.2,115030564,7-114985291-T-A,rs7786588,1,T,A,114985291,45273,114833956,115227172,151335
7,ENSG00000244701.1,141656810,7-141689840-A-G,rs7791469,-1,A,G,141689840,33030,141460202,141853418,229638
7,ENSG00000231006.1,108510233,7-108430511-G-C,rs7792321,1,G,C,108430511,79722,108313625,108706841,116886
7,ENSG00000231006.1,108510233,7-108430511-G-A,rs7792321,1,G,A,108430511,79722,108313625,108706841,116886
7,ENSG00000204934.6,149880610,7-149874377-A-G,rs7795944,-1,A,G,149874377,6233,149684002,150077218,190375
7,ENSG00000223886.3,105530209,7-105453311-C-T,rs7799326,1,C,T,105453311,76898,105333601,105726817,119710
7,ENSG00000205578.4,73293497,7-73329980-A-C,rs7801936,1,A,C,73329980,36483,73096889,73490105,233091
7,ENSG00000205578.4,73293497,7-73329980-A-G,rs7801936,1,A,G,73329980,36483,73096889,73490105,233091
7,ENSG00000234141.1,7950709,7-7946235-T-G,rs7806407,-1,T,G,7946235,4474,7754101,8147317,192134
7,ENSG00000234141.1,7950709,7-7946235-T-C,rs7806407,-1,T,C,7946235,4474,7754101,8147317,192134
7,ENSG00000234141.1,7950709,7-7946235-T-A,rs7806407,-1,T,A,7946235,4474,7754101,8147317,192134
7,ENSG00000233834.2,20217536,7-20239019-G-T,rs7806550,1,G,T,20239019,21483,20020928,20414144,218091
7,ENSG00000233834.2,20217536,7-20239019-G-A,rs7806550,1,G,A,20239019,21483,20020928,20414144,218091
7,ENSG00000235920.1,11821294,7-11821311-G-C,rs7807756,-1,G,C,11821311,17,11624686,12017902,196625
7,ENSG00000235920.1,11821294,7-11821311-G-A,rs7807756,-1,G,A,11821311,17,11624686,12017902,196625
7,ENSG00000235920.1,11821294,7-11821311-G-T,rs7807756,-1,G,T,11821311,17,11624686,12017902,196625
7,ENSG00000228649.1,22854159,7-22859490-T-A,rs7811699,1,T,A,22859490,5331,22657551,23050767,201939
7,ENSG00000228649.1,22854159,7-22859490-T-C,rs7811699,1,T,C,22859490,5331,22657551,23050767,201939
7,ENSG00000228649.1,22854159,7-22859490-T-G,rs7811699,1,T,G,22859490,5331,22657551,23050767,201939
7,ENSG00000224172.1,64736743,7-64628227-T-C,rs78750842,-1,T,C,64628227,108516,64540135,64933351,88092
7,ENSG00000233559.1,130853732,7-130811306-A-G,rs78773570,1,A,G,130811306,42426,130657124,131050340,154182
7,ENSG00000223705.5,75410368,7-75568472-T-C,rs794355,1,T,C,75568472,158104,75213760,75606976,354712
7,ENSG00000223705.5,75410368,7-75568472-T-A,rs794355,1,T,A,75568472,158104,75213760,75606976,354712
7,ENSG00000236048.2,12471352,7-12461083-G-A,rs79786674,1,G,A,12461083,10269,12274744,12667960,186339
7,ENSG00000236048.2,12471352,7-12461083-G-T,rs79786674,1,G,T,12461083,10269,12274744,12667960,186339
7,ENSG00000226816.2,23205787,7-23201196-G-T,rs858234,1,G,T,23201196,4591,23009179,23402395,192017
7,ENSG00000219039.2,75835663,7-75888589-T-A,rs872792,1,T,A,75888589,52926,75639055,76032271,249534
7,ENSG00000219039.2,75835663,7-75888589-T-C,rs872792,1,T,C,75888589,52926,75639055,76032271,249534
7,ENSG00000219039.2,75835663,7-75888589-T-G,rs872792,1,T,G,75888589,52926,75639055,76032271,249534
7,ENSG00000106610.10,67305987,7-67320150-C-A,rs9443,1,C,A,67320150,14163,67109379,67502595,210771
7,ENSG00000106610.10,67305987,7-67320150-C-T,rs9443,1,C,T,67320150,14163,67109379,67502595,210771
7,ENSG00000224057.1,55188977,7-55269571-G-A,rs9642396,-1,G,A,55269571,80594,54992369,55385585,277202
7,ENSG00000231087.2,76969250,7-77080835-T-C,rs9886341,-1,T,C,77080835,111585,76772642,77165858,308193
7,ENSG00000224079.1,1074450,7-1042336-C-G,rs10224368,1,C,G,1042336,32114,877842,1271058,164494
7,ENSG00000224079.1,1074450,7-1042336-C-A,rs10224368,1,C,A,1042336,32114,877842,1271058,164494
7,ENSG00000250561.1,6880626,7-6698035-G-A,rs10231608,-1,G,A,6698035,182591,6684018,7077234,14017
7,ENSG00000231006.1,108510233,7-108423670-C-A,rs10241941,1,C,A,108423670,86563,108313625,108706841,110045
7,ENSG00000231006.1,108510233,7-108423670-C-T,rs10241941,1,C,T,108423670,86563,108313625,108706841,110045
7,ENSG00000231006.1,108510233,7-108423670-C-G,rs10241941,1,C,G,108423670,86563,108313625,108706841,110045
7,ENSG00000223969.1,90597398,7-90579060-G-A,rs10254430,-1,G,A,90579060,18338,90400790,90794006,178270
7,ENSG00000232736.1,35768640,7-35643118-T-C,rs10260422,-1,T,C,35643118,125522,35572032,35965248,71086
7,ENSG00000225314.1,37821210,7-37892653-T-G,rs10268173,1,T,G,37892653,71443,37624602,38017818,268051
7,ENSG00000242258.1,150433654,7-150447329-C-G,rs10276935,1,C,G,150447329,13675,150237046,150630262,210283
7,ENSG00000237773.1,17299288,7-17441687-G-A,rs10499499,-1,G,A,17441687,142399,17102680,17495896,339007
7,ENSG00000237773.1,17299288,7-17441687-G-T,rs10499499,-1,G,T,17441687,142399,17102680,17495896,339007
7,ENSG00000204934.6,149880610,7-149886081-C-T,rs10807976,-1,C,T,149886081,5471,149684002,150077218,202079
7,ENSG00000204934.6,149880610,7-149886081-C-A,rs10807976,-1,C,A,149886081,5471,149684002,150077218,202079
7,ENSG00000261455.1,152463786,7-152495036-A-G,rs1107394,1,A,G,152495036,31250,152267178,152660394,227858
7,ENSG00000261455.1,152463786,7-152495036-A-T,rs1107394,1,A,T,152495036,31250,152267178,152660394,227858
7,ENSG00000183444.9,97967074,7-97986932-C-T,rs111371470,-1,C,T,97986932,19858,97770466,98163682,216466
7,ENSG00000231812.1,97885868,7-97925971-T-C,rs111637838,1,T,C,97925971,40103,97689260,98082476,236711
7,ENSG00000232533.1,143381036,7-143379943-C-T,rs1135411,-1,C,T,143379943,1093,143184428,143577644,195515
7,ENSG00000127957.12,75516235,7-75543861-G-A,rs1167796,-1,G,A,75543861,27626,75319627,75712843,224234
7,ENSG00000236305.1,100852635,7-100945319-C-G,rs117002451,-1,C,G,100945319,92684,100656027,101049243,289292
7,ENSG00000236305.1,100852635,7-100945319-C-T,rs117002451,-1,C,T,100945319,92684,100656027,101049243,289292
7,ENSG00000236305.1,100852635,7-100945319-C-A,rs117002451,-1,C,A,100945319,92684,100656027,101049243,289292
7,ENSG00000234450.1,156633355,7-156591616-A-G,rs11764772,1,A,G,156591616,41739,156436747,156829963,154869
7,ENSG00000236529.1,65840055,7-66008011-C-A,rs11773552,1,C,A,66008011,167956,65643447,66036663,364564
7,ENSG00000236529.1,65840055,7-66008011-C-T,rs11773552,1,C,T,66008011,167956,65643447,66036663,364564
7,ENSG00000235368.1,57424503,7-57512420-T-C,rs117801264,1,T,C,57512420,87917,57227895,57621111,284525
7,ENSG00000179406.6,66491616,7-66505583-T-G,rs118065642,-1,T,G,66505583,13967,66295008,66688224,210575
7,ENSG00000182165.12,87345551,7-87227136-G-A,rs11975795,-1,G,A,87227136,118415,87148943,87542159,78193
7,ENSG00000182165.12,87345551,7-87227136-G-T,rs11975795,-1,G,T,87227136,118415,87148943,87542159,78193
7,ENSG00000227986.1,64355078,7-64300703-T-C,rs11978712,1,T,C,64300703,54375,64158470,64551686,142233
7,ENSG00000226278.1,55764797,7-55787487-G-C,rs11982736,1,G,C,55787487,22690,55568189,55961405,219298
7,ENSG00000226278.1,55764797,7-55787487-G-A,rs11982736,1,G,A,55787487,22690,55568189,55961405,219298
7,ENSG00000226278.1,55764797,7-55787487-G-T,rs11982736,1,G,T,55787487,22690,55568189,55961405,219298
7,ENSG00000232956.2,44986961,7-44983904-T-A,rs12108,-1,T,A,44983904,3057,44790353,45183569,193551
7,ENSG00000243679.1,128653969,7-128472655-T-C,rs12530672,1,T,C,128472655,181314,128457361,128850577,15294
7,ENSG00000228554.1,39703296,7-39583171-T-C,rs12535994,-1,T,C,39583171,120125,39506688,39899904,76483
7,ENSG00000106610.10,67305987,7-67325604-C-A,rs12537527,1,C,A,67325604,19617,67109379,67502595,216225
7,ENSG00000106610.10,67305987,7-67325604-C-T,rs12537527,1,C,T,67325604,19617,67109379,67502595,216225
7,ENSG00000232400.1,16866308,7-16806127-T-C,rs12665886,-1,T,C,16806127,60181,16669700,17062916,136427
7,ENSG00000227017.1,30179014,7-30181214-G-C,rs12701008,-1,G,C,30181214,2200,29982406,30375622,198808
7,ENSG00000227017.1,30179014,7-30181214-G-T,rs12701008,-1,G,T,30181214,2200,29982406,30375622,198808
7,ENSG00000227017.1,30179014,7-30181214-G-A,rs12701008,-1,G,A,30181214,2200,29982406,30375622,198808
7,ENSG00000260231.1,140177184,7-140228461-C-T,rs12703630,1,C,T,140228461,51277,139980576,140373792,247885
7,ENSG00000164556.7,38687037,7-38724568-T-C,rs13231320,-1,T,C,38724568,37531,38490429,38883645,234139
7,ENSG00000234432.2,5428927,7-5233833-C-T,rs13244634,-1,C,T,5233833,195094,5232319,5625535,1514
7,ENSG00000229153.1,143407813,7-143477570-A-T,rs1473653,1,A,T,143477570,69757,143211205,143604421,266365
7,ENSG00000229153.1,143407813,7-143477570-A-C,rs1473653,1,A,C,143477570,69757,143211205,143604421,266365
7,ENSG00000229153.1,143407813,7-143477570-A-G,rs1473653,1,A,G,143477570,69757,143211205,143604421,266365
7,ENSG00000229091.2,10451311,7-10438320-G-A,rs1524241,1,G,A,10438320,12991,10254703,10647919,183617
7,ENSG00000237064.1,109960184,7-109768430-C-T,rs1608659,-1,C,T,109768430,191754,109763576,110156792,4854
7,ENSG00000237064.1,109960184,7-109768430-C-G,rs1608659,-1,C,G,109768430,191754,109763576,110156792,4854
7,ENSG00000237064.1,109960184,7-109768430-C-A,rs1608659,-1,C,A,109768430,191754,109763576,110156792,4854
7,ENSG00000224897.2,124929943,7-125062345-A-G,rs17147889,1,A,G,125062345,132402,124733335,125126551,329010
7,ENSG00000224046.1,87152420,7-87129922-T-C,rs17161323,-1,T,C,87129922,22498,86955812,87349028,174110
7,ENSG00000224448.1,99638767,7-99758701-A-C,rs17161886,-1,A,C,99758701,119934,99442159,99835375,316542
7,ENSG00000214035.3,145009961,7-145181064-A-G,rs17173034,1,A,G,145181064,171103,144813353,145206569,367711
7,ENSG00000235828.4,15701752,7-15866670-C-T,rs1942645,-1,C,T,15866670,164918,15505144,15898360,361526
7,ENSG00000235828.4,15701752,7-15866670-C-A,rs1942645,-1,C,A,15866670,164918,15505144,15898360,361526
7,ENSG00000230583.2,66833026,7-66816053-A-G,rs1984651,-1,A,G,66816053,16973,66636418,67029634,179635
7,ENSG00000226279.2,22881893,7-22728252-T-C,rs2069835,1,T,C,22728252,153641,22685285,23078501,42967
7,ENSG00000211698.2,38354517,7-38377955-A-C,rs2080284,-1,A,C,38377955,23438,38157909,38551125,220046
7,ENSG00000067601.6,67299424,7-67393463-T-C,rs2110004,-1,T,C,67393463,94039,67102816,67496032,290647
7,ENSG00000179428.2,22727620,7-22667088-C-T,rs2157958,-1,C,T,22667088,60532,22531012,22924228,136076
7,ENSG00000233306.2,38363518,7-38365370-A-T,rs2160195,-1,A,T,38365370,1852,38166910,38560126,198460
7,ENSG00000233306.2,38363518,7-38365370-A-C,rs2160195,-1,A,C,38365370,1852,38166910,38560126,198460
7,ENSG00000205236.5,102642869,7-102473640-C-T,rs2229796,-1,C,T,102473640,169229,102446261,102839477,27379
7,ENSG00000205236.5,102642869,7-102473640-C-A,rs2229796,-1,C,A,102473640,169229,102446261,102839477,27379
7,ENSG00000223500.1,135128444,7-134993772-C-T,rs2252826,1,C,T,134993772,134672,134931836,135325052,61936
7,ENSG00000228668.1,38345499,7-38402043-C-T,rs2299945,-1,C,T,38402043,56544,38148891,38542107,253152
7,ENSG00000233429.4,27096094,7-27156450-A-C,rs2301720,1,A,C,27156450,60356,26899486,27292702,256964
7,ENSG00000235459.4,122681315,7-122651666-A-C,rs2471189,1,A,C,122651666,29649,122484707,122877923,166959
7,ENSG00000235459.4,122681315,7-122651666-A-T,rs2471189,1,A,T,122651666,29649,122484707,122877923,166959
7,ENSG00000235459.4,122681315,7-122651666-A-G,rs2471189,1,A,G,122651666,29649,122484707,122877923,166959
7,ENSG00000228546.2,102337316,7-102252952-A-T,rs2529113,1,A,T,102252952,84364,102140708,102533924,112244
7,ENSG00000228546.2,102337316,7-102252952-A-G,rs2529113,1,A,G,102252952,84364,102140708,102533924,112244
7,ENSG00000228546.2,102337316,7-102252952-A-C,rs2529113,1,A,C,102252952,84364,102140708,102533924,112244
7,ENSG00000168255.12,102572653,7-102759410-C-T,rs2539336,-1,C,T,102759410,186757,102376045,102769261,383365
7,ENSG00000211699.2,38359162,7-38362895-A-G,rs2735118,-1,A,G,38362895,3733,38162554,38555770,200341
7,ENSG00000223855.1,522573,7-511485-A-T,rs28472363,1,A,T,511485,11088,325965,719181,185520
7,ENSG00000223855.1,522573,7-511485-A-G,rs28472363,1,A,G,511485,11088,325965,719181,185520
7,ENSG00000226329.2,22881350,7-22962537-C-T,rs28879789,-1,C,T,22962537,81187,22684742,23077958,277795
7,ENSG00000235436.6,90119539,7-90102666-T-A,rs2888738,1,T,A,90102666,16873,89922931,90316147,179735
7,ENSG00000235436.6,90119539,7-90102666-T-C,rs2888738,1,T,C,90102666,16873,89922931,90316147,179735
7,ENSG00000242261.1,128306649,7-128254797-G-A,rs28954114,1,G,A,128254797,51852,128110041,128503257,144756
7,ENSG00000242588.1,128531707,7-128490492-C-T,rs34742251,1,C,T,128490492,41215,128335099,128728315,155393
7,ENSG00000239969.1,102375808,7-102401030-G-A,rs34804264,1,G,A,102401030,25222,102179200,102572416,221830
7,ENSG00000233476.2,22511999,7-22369326-C-T,rs34835504,-1,C,T,22369326,142673,22315391,22708607,53935
7,ENSG00000233559.1,130853732,7-130735979-A-G,rs35775580,1,A,G,130735979,117753,130657124,131050340,78855
7,ENSG00000196295.4,30562825,7-30556253-T-C,rs38474,-1,T,C,30556253,6572,30366217,30759433,190036
7,ENSG00000196295.4,30562825,7-30556253-T-A,rs38474,-1,T,A,30556253,6572,30366217,30759433,190036
7,ENSG00000226874.1,30544053,7-30556253-T-C,rs38474,1,T,C,30556253,12200,30347445,30740661,208808
7,ENSG00000226874.1,30544053,7-30556253-T-A,rs38474,1,T,A,30556253,12200,30347445,30740661,208808
7,ENSG00000240859.1,149597,7-194247-A-C,rs4275177,1,A,C,194247,44650,-47011,346205,241258
7,ENSG00000240859.1,149597,7-194247-A-G,rs4275177,1,A,G,194247,44650,-47011,346205,241258
7,ENSG00000211697.2,38350022,7-38373387-T-C,rs4373430,-1,T,C,38373387,23365,38153414,38546630,219973
7,ENSG00000236281.1,131754252,7-131692601-C-T,rs4560722,-1,C,T,131692601,61651,131557644,131950860,134957
7,ENSG00000256646.3,42932214,7-43119026-A-T,rs4612244,-1,A,T,43119026,186812,42735606,43128822,383420
7,ENSG00000256646.3,42932214,7-43119026-A-G,rs4612244,-1,A,G,43119026,186812,42735606,43128822,383420
7,ENSG00000232759.1,22563337,7-22445549-G-A,rs4722141,1,G,A,22445549,117788,22366729,22759945,78820
7,ENSG00000227053.1,101017665,7-101058329-T-G,rs4729656,-1,T,G,101058329,40664,100821057,101214273,237272
7,ENSG00000227053.1,101017665,7-101058329-T-C,rs4729656,-1,T,C,101058329,40664,100821057,101214273,237272
7,ENSG00000227053.1,101017665,7-101058329-T-A,rs4729656,-1,T,A,101058329,40664,100821057,101214273,237272
7,ENSG00000225918.1,145040941,7-144927903-C-T,rs55695248,-1,C,T,144927903,113038,144844333,145237549,83570
7,ENSG00000228649.1,22854159,7-23030164-T-C,rs55921023,1,T,C,23030164,176005,22657551,23050767,372613
7,ENSG00000235314.1,44039523,7-44206718-C-T,rs56298219,1,C,T,44206718,167195,43842915,44236131,363803
7,ENSG00000228903.2,44041892,7-44206718-C-T,rs56298219,-1,C,T,44206718,164826,43845284,44238500,361434
7,ENSG00000214106.3,154928485,7-154930985-G-A,rs56377766,1,G,A,154930985,2500,154731877,155125093,199108
7,ENSG00000225969.1,73735407,7-73788263-G-T,rs60996614,1,G,T,73788263,52856,73538799,73932015,249464
7,ENSG00000239377.1,150383885,7-150572829-G-A,rs61741802,-1,G,A,150572829,188944,150187277,150580493,385552
7,ENSG00000225535.2,115030564,7-115037927-G-T,rs62470701,1,G,T,115037927,7363,114833956,115227172,203971
7,ENSG00000240758.1,128455937,7-128497441-T-C,rs62481140,1,T,C,128497441,41504,128259329,128652545,238112
7,ENSG00000230658.1,23105703,7-23076844-T-C,rs6461686,-1,T,C,23076844,28859,22909095,23302311,167749
7,ENSG00000230658.1,23105703,7-23076844-T-A,rs6461686,-1,T,A,23076844,28859,22909095,23302311,167749
7,ENSG00000230658.1,23105703,7-23076844-T-G,rs6461686,-1,T,G,23076844,28859,22909095,23302311,167749
7,ENSG00000261305.1,150337483,7-150391022-C-T,rs6464061,1,C,T,150391022,53539,150140875,150534091,250147
7,ENSG00000244198.1,144195321,7-144144679-C-T,rs6464580,1,C,T,144144679,50642,143998713,144391929,145966
7,ENSG00000170356.8,144251603,7-144144679-C-T,rs6464580,-1,C,T,144144679,106924,144054995,144448211,89684
7,ENSG00000228960.4,144299373,7-144144679-C-T,rs6464580,1,C,T,144144679,154694,144102765,144495981,41914
7,ENSG00000229161.2,42794906,7-42932812-A-G,rs647618,1,A,G,42932812,137906,42598298,42991514,334514
7,ENSG00000229161.2,42794906,7-42932812-A-T,rs647618,1,A,T,42932812,137906,42598298,42991514,334514
7,ENSG00000229161.2,42794906,7-42932812-A-C,rs647618,1,A,C,42932812,137906,42598298,42991514,334514
7,ENSG00000227499.1,55877912,7-56054365-A-C,rs6593297,1,A,C,56054365,176453,55681304,56074520,373061
7,ENSG00000227499.1,55877912,7-56054365-A-G,rs6593297,1,A,G,56054365,176453,55681304,56074520,373061
7,ENSG00000227499.1,55877912,7-56054365-A-T,rs6593297,1,A,T,56054365,176453,55681304,56074520,373061
7,ENSG00000232445.1,101308270,7-101398477-C-A,rs6947185,1,C,A,101398477,90207,101111662,101504878,286815
7,ENSG00000243230.1,129213545,7-129393900-G-A,rs6953598,-1,G,A,129393900,180355,129016937,129410153,376963
7,ENSG00000243230.1,129213545,7-129393900-G-C,rs6953598,-1,G,C,129393900,180355,129016937,129410153,376963
7,ENSG00000229043.1,1160374,7-1132094-G-A,rs6957709,1,G,A,1132094,28280,963766,1356982,168328
7,ENSG00000234585.2,65064999,7-64992154-T-C,rs6957874,1,T,C,64992154,72845,64868391,65261607,123763
7,ENSG00000228653.2,64500825,7-64562993-T-C,rs6969879,1,T,C,64562993,62168,64304217,64697433,258776
7,ENSG00000228653.2,64500825,7-64562993-T-A,rs6969879,1,T,A,64562993,62168,64304217,64697433,258776
7,ENSG00000226816.2,23205787,7-23176069-T-C,rs6972117,1,T,C,23176069,29718,23009179,23402395,166890
7,ENSG00000225308.2,21221428,7-21298613-T-C,rs6976044,-1,T,C,21298613,77185,21024820,21418036,273793
7,ENSG00000146677.6,44467897,7-44607262-T-C,rs73109403,1,T,C,44607262,139365,44271289,44664505,335973
7,ENSG00000146677.6,44467897,7-44607262-T-G,rs73109403,1,T,G,44607262,139365,44271289,44664505,335973
7,ENSG00000224138.1,127350128,7-127533677-C-T,rs73234806,1,C,T,127533677,183549,127153520,127546736,380157
7,ENSG00000244218.1,128761338,7-128933391-G-A,rs73461567,1,G,A,128933391,172053,128564730,128957946,368661
7,ENSG00000244218.1,128761338,7-128933391-G-T,rs73461567,1,G,T,128933391,172053,128564730,128957946,368661
7,ENSG00000242474.1,149438,7-125510-G-C,rs73669600,-1,G,C,125510,23928,-47170,346046,172680
7,ENSG00000242474.1,149438,7-125510-G-T,rs73669600,-1,G,T,125510,23928,-47170,346046,172680
7,ENSG00000233834.2,20217536,7-20127277-T-A,rs73683382,1,T,A,20127277,90259,20020928,20414144,106349
7,ENSG00000232818.2,23490473,7-23345632-G-A,rs74452222,1,G,A,23345632,144841,23293865,23687081,51767
7,ENSG00000226102.2,35946294,7-35750074-C-A,rs74511011,1,C,A,35750074,196220,35749686,36142902,388
7,ENSG00000226102.2,35946294,7-35750074-C-T,rs74511011,1,C,T,35750074,196220,35749686,36142902,388
7,ENSG00000234722.2,153413981,7-153419891-G-A,rs75692465,-1,G,A,153419891,5910,153217373,153610589,202518
7,ENSG00000227436.1,23619333,7-23534127-C-T,rs75923419,1,C,T,23534127,85206,23422725,23815941,111402
7,ENSG00000228335.1,99443496,7-99247782-G-A,rs75958338,-1,G,A,99247782,195714,99246888,99640104,894
7,ENSG00000211701.2,38368169,7-38377213-C-T,rs76283292,-1,C,T,38377213,9044,38171561,38564777,205652
7,ENSG00000226342.1,63910453,7-63834097-T-A,rs76540627,-1,T,A,63834097,76356,63713845,64107061,120252
7,ENSG00000217825.2,155198455,7-155265743-C-T,rs77642229,-1,C,T,155265743,67288,155001847,155395063,263896
7,ENSG00000228540.1,110725825,7-110742009-C-A,rs7781323,-1,C,A,110742009,16184,110529217,110922433,212792
7,ENSG00000228540.1,110725825,7-110742009-C-T,rs7781323,-1,C,T,110742009,16184,110529217,110922433,212792
7,ENSG00000182648.7,156640599,7-156671520-T-C,rs7790357,-1,T,C,156671520,30921,156443991,156837207,227529
7,ENSG00000238228.1,97947998,7-97858659-T-C,rs7792744,-1,T,C,97858659,89339,97751390,98144606,107269
7,ENSG00000205596.4,66071318,7-66050289-G-A,rs7811214,-1,G,A,66050289,21029,65874710,66267926,175579
7,ENSG00000205596.4,66071318,7-66050289-G-C,rs7811214,-1,G,C,66050289,21029,65874710,66267926,175579
7,ENSG00000223459.4,143598039,7-143733941-T-C,rs7811442,1,T,C,143733941,135902,143401431,143794647,332510
7,ENSG00000223459.4,143598039,7-143733941-T-G,rs7811442,1,T,G,143733941,135902,143401431,143794647,332510
7,ENSG00000224273.1,76132187,7-76216519-C-A,rs78663390,-1,C,A,76216519,84332,75935579,76328795,280940
7,ENSG00000224273.1,76132187,7-76216519-C-T,rs78663390,-1,C,T,76216519,84332,75935579,76328795,280940
7,ENSG00000244701.1,141656810,7-141598179-C-G,rs79030772,-1,C,G,141598179,58631,141460202,141853418,137977
7,ENSG00000243302.2,128651185,7-128719406-C-T,rs79548510,1,C,T,128719406,68221,128454577,128847793,264829
7,ENSG00000226824.2,66654513,7-66639940-C-T,rs79736939,1,C,T,66639940,14573,66457905,66851121,182035
7,ENSG00000242562.1,106125371,7-106318111-A-G,rs79751113,1,A,G,106318111,192740,105928763,106321979,389348
7,ENSG00000242562.1,106125371,7-106318111-A-C,rs79751113,1,A,C,106318111,192740,105928763,106321979,389348
7,ENSG00000237286.1,2944035,7-2750070-G-A,rs798503,1,G,A,2750070,193965,2747427,3140643,2643
7,ENSG00000260997.1,44960909,7-45123078-G-A,rs79994371,-1,G,A,45123078,162169,44764301,45157517,358777
7,ENSG00000260997.1,44960909,7-45123078-G-T,rs79994371,-1,G,T,45123078,162169,44764301,45157517,358777
7,ENSG00000133624.9,149624565,7-149507457-A-G,rs855912,-1,A,G,149507457,117108,149427957,149821173,79500
7,ENSG00000242798.1,100127139,7-100222427-T-C,rs858506,-1,T,C,100222427,95288,99930531,100323747,291896
7,ENSG00000233264.2,7980312,7-7824142-C-T,rs960746,1,C,T,7824142,156170,7783704,8176920,40438
7,ENSG00000233264.2,7980312,7-7824142-C-G,rs960746,1,C,G,7824142,156170,7783704,8176920,40438
7,ENSG00000214293.4,77696265,7-77668098-C-G,rs9641271,-1,C,G,77668098,28167,77499657,77892873,168441
7,ENSG00000214293.4,77696265,7-77668098-C-A,rs9641271,-1,C,A,77668098,28167,77499657,77892873,168441
7,ENSG00000214293.4,77696265,7-77668098-C-T,rs9641271,-1,C,T,77668098,28167,77499657,77892873,168441
7,ENSG00000234985.2,121441261,7-121505623-A-T,rs10228676,-1,A,T,121505623,64362,121244653,121637869,260970
7,ENSG00000234985.2,121441261,7-121505623-A-G,rs10228676,-1,A,G,121505623,64362,121244653,121637869,260970
7,ENSG00000234985.2,121441261,7-121505623-A-C,rs10228676,-1,A,C,121505623,64362,121244653,121637869,260970
7,ENSG00000242294.1,100338197,7-100246420-G-A,rs10250275,1,G,A,100246420,91777,100141589,100534805,104831
7,ENSG00000235955.1,45819016,7-45655873-T-G,rs10254640,-1,T,G,45655873,163143,45622408,46015624,33465
7,ENSG00000228393.3,105013044,7-104820300-A-C,rs10256308,-1,A,C,104820300,192744,104816436,105209652,3864
7,ENSG00000228393.3,105013044,7-104820300-A-G,rs10256308,-1,A,G,104820300,192744,104816436,105209652,3864
7,ENSG00000228393.3,105013044,7-104820300-A-T,rs10256308,-1,A,T,104820300,192744,104816436,105209652,3864
7,ENSG00000235859.4,30371508,7-30514081-A-G,rs10268380,1,A,G,30514081,142573,30174900,30568116,339181
7,ENSG00000229043.1,1160374,7-1008296-T-C,rs10276204,1,T,C,1008296,152078,963766,1356982,44530
7,ENSG00000229043.1,1160374,7-1008296-T-A,rs10276204,1,T,A,1008296,152078,963766,1356982,44530
7,ENSG00000231167.3,105583256,7-105767569-T-G,rs10281039,-1,T,G,105767569,184313,105386648,105779864,380921
7,ENSG00000231167.3,105583256,7-105767569-T-C,rs10281039,-1,T,C,105767569,184313,105386648,105779864,380921
7,ENSG00000230191.1,56163145,7-56177912-C-T,rs10281437,1,C,T,56177912,14767,55966537,56359753,211375
7,ENSG00000230191.1,56163145,7-56177912-C-A,rs10281437,1,C,A,56177912,14767,55966537,56359753,211375
7,ENSG00000213296.4,124480524,7-124445799-A-C,rs10435284,1,A,C,124445799,34725,124283916,124677132,161883
7,ENSG00000213296.4,124480524,7-124445799-A-T,rs10435284,1,A,T,124445799,34725,124283916,124677132,161883
7,ENSG00000213296.4,124480524,7-124445799-A-G,rs10435284,1,A,G,124445799,34725,124283916,124677132,161883
7,ENSG00000223969.1,90597398,7-90506197-A-C,rs10487118,-1,A,C,90506197,91201,90400790,90794006,105407
7,ENSG00000226279.2,22881893,7-22848898-A-T,rs1073599,1,A,T,22848898,32995,22685285,23078501,163613
7,ENSG00000226279.2,22881893,7-22848898-A-C,rs1073599,1,A,C,22848898,32995,22685285,23078501,163613
7,ENSG00000226279.2,22881893,7-22848898-A-G,rs1073599,1,A,G,22848898,32995,22685285,23078501,163613
7,ENSG00000237286.1,2944035,7-3036419-G-A,rs10951010,1,G,A,3036419,92384,2747427,3140643,288992
7,ENSG00000237286.1,2944035,7-3036419-G-C,rs10951010,1,G,C,3036419,92384,2747427,3140643,288992
7,ENSG00000236305.1,100852635,7-100948709-G-C,rs111461090,-1,G,C,100948709,96074,100656027,101049243,292682
7,ENSG00000233264.2,7980312,7-7870665-G-A,rs111623954,1,G,A,7870665,109647,7783704,8176920,86961
7,ENSG00000230487.3,1570073,7-1541764-C-T,rs111764525,1,C,T,1541764,28309,1373465,1766681,168299
7,ENSG00000230487.3,1570073,7-1541764-C-A,rs111764525,1,C,A,1541764,28309,1373465,1766681,168299
7,ENSG00000239622.1,25689959,7-25817789-C-A,rs1159802,-1,C,A,25817789,127830,25493351,25886567,324438
7,ENSG00000205236.5,102642869,7-102820511-C-G,rs116943888,-1,C,G,102820511,177642,102446261,102839477,374250
7,ENSG00000205236.5,102642869,7-102820511-C-T,rs116943888,-1,C,T,102820511,177642,102446261,102839477,374250
7,ENSG00000214293.4,77696265,7-77863304-A-G,rs117374332,-1,A,G,77863304,167039,77499657,77892873,363647
7,ENSG00000240211.1,100436204,7-100481131-C-G,rs11760536,1,C,G,100481131,44927,100239596,100632812,241535
7,ENSG00000240211.1,100436204,7-100481131-C-T,rs11760536,1,C,T,100481131,44927,100239596,100632812,241535
7,ENSG00000240211.1,100436204,7-100481131-C-A,rs11760536,1,C,A,100481131,44927,100239596,100632812,241535
7,ENSG00000225918.1,145040941,7-145064291-A-C,rs117615634,-1,A,C,145064291,23350,144844333,145237549,219958
7,ENSG00000227986.1,64355078,7-64234704-C-T,rs11763256,1,C,T,64234704,120374,64158470,64551686,76234
7,ENSG00000106610.10,67305987,7-67308879-A-G,rs11766843,1,A,G,67308879,2892,67109379,67502595,199500
7,ENSG00000242258.1,150433654,7-150434396-G-A,rs11770221,1,G,A,150434396,742,150237046,150630262,197350
7,ENSG00000235421.1,65554744,7-65435908-T-C,rs11771033,-1,T,C,65435908,118836,65358136,65751352,77772
7,ENSG00000230733.2,5475804,7-5562470-C-T,rs118083363,1,C,T,5562470,86666,5279196,5672412,283274
7,ENSG00000225329.1,104926645,7-104811499-C-G,rs11981642,-1,C,G,104811499,115146,104730037,105123253,81462
7,ENSG00000257607.1,1059261,7-923196-T-C,rs12381369,-1,T,C,923196,136065,862653,1255869,60543
7,ENSG00000232727.2,64433830,7-64382528-T-C,rs12530839,1,T,C,64382528,51302,64237222,64630438,145306
7,ENSG00000242588.1,128531707,7-128408923-G-C,rs12536006,1,G,C,128408923,122784,128335099,128728315,73824
7,ENSG00000242588.1,128531707,7-128408923-G-A,rs12536006,1,G,A,128408923,122784,128335099,128728315,73824
7,ENSG00000179406.6,66491616,7-66305652-C-T,rs12538379,-1,C,T,66305652,185964,66295008,66688224,10644
7,ENSG00000228303.1,56650696,7-56740039-A-T,rs12538805,-1,A,T,56740039,89343,56454088,56847304,285951
7,ENSG00000228303.1,56650696,7-56740039-A-G,rs12538805,-1,A,G,56740039,89343,56454088,56847304,285951
7,ENSG00000224059.1,85027828,7-85071317-G-A,rs12673176,1,G,A,85071317,43489,84831220,85224436,240097
7,ENSG00000224059.1,85027828,7-85071317-G-T,rs12673176,1,G,T,85071317,43489,84831220,85224436,240097
7,ENSG00000224059.1,85027828,7-85071317-G-C,rs12673176,1,G,C,85071317,43489,84831220,85224436,240097
7,ENSG00000196295.4,30562825,7-30391357-G-A,rs12701010,-1,G,A,30391357,171468,30366217,30759433,25140
7,ENSG00000196295.4,30562825,7-30391357-G-C,rs12701010,-1,G,C,30391357,171468,30366217,30759433,25140
7,ENSG00000225308.2,21221428,7-21031769-G-A,rs13232779,-1,G,A,21031769,189659,21024820,21418036,6949
7,ENSG00000225308.2,21221428,7-21031769-G-C,rs13232779,-1,G,C,21031769,189659,21024820,21418036,6949
7,ENSG00000235090.1,75922755,7-75733069-A-G,rs13238507,1,A,G,75733069,189686,75726147,76119363,6922
7,ENSG00000244560.2,149287614,7-149402516-G-C,rs1636334,1,G,C,149402516,114902,149091006,149484222,311510
7,ENSG00000233369.2,73175415,7-73352951-C-T,rs17339094,1,C,T,73352951,177536,72978807,73372023,374144
7,ENSG00000228960.4,144299373,7-144173412-C-G,rs17591937,1,C,G,144173412,125961,144102765,144495981,70647
7,ENSG00000228960.4,144299373,7-144173412-C-T,rs17591937,1,C,T,144173412,125961,144102765,144495981,70647
7,ENSG00000228960.4,144299373,7-144173412-C-A,rs17591937,1,C,A,144173412,125961,144102765,144495981,70647
7,ENSG00000224163.3,128914063,7-129069735-A-G,rs1901198,-1,A,G,129069735,155672,128717455,129110671,352280
7,ENSG00000204959.3,144286966,7-144141777-G-C,rs1919955,-1,G,C,144141777,145189,144090358,144483574,51419
7,ENSG00000225507.1,47956793,7-47965653-A-G,rs2037484,1,A,G,47965653,8860,47760185,48153401,205468
7,ENSG00000225507.1,47956793,7-47965653-A-T,rs2037484,1,A,T,47965653,8860,47760185,48153401,205468
7,ENSG00000179428.2,22727620,7-22721583-C-T,rs2056576,-1,C,T,22721583,6037,22531012,22924228,190571
7,ENSG00000256646.3,42932214,7-42888275-T-G,rs2114771,-1,T,G,42888275,43939,42735606,43128822,152669
7,ENSG00000256646.3,42932214,7-42888275-T-C,rs2114771,-1,T,C,42888275,43939,42735606,43128822,152669
7,ENSG00000228668.1,38345499,7-38310243-C-T,rs2159500,-1,C,T,38310243,35256,38148891,38542107,161352
7,ENSG00000211701.2,38368169,7-38365370-A-T,rs2160195,-1,A,T,38365370,2799,38171561,38564777,193809
7,ENSG00000211701.2,38368169,7-38365370-A-C,rs2160195,-1,A,C,38365370,2799,38171561,38564777,193809
7,ENSG00000232581.1,6588974,7-6664701-A-T,rs2251188,-1,A,T,6664701,75727,6392366,6785582,272335
7,ENSG00000232581.1,6588974,7-6664701-A-G,rs2251188,-1,A,G,6664701,75727,6392366,6785582,272335
7,ENSG00000232581.1,6588974,7-6664701-A-C,rs2251188,-1,A,C,6664701,75727,6392366,6785582,272335
7,ENSG00000229180.2,66576923,7-66645741-T-C,rs2533285,-1,T,C,66645741,68818,66380315,66773531,265426
7,ENSG00000229180.2,66576923,7-66645741-T-G,rs2533285,-1,T,G,66645741,68818,66380315,66773531,265426
7,ENSG00000229180.2,66576923,7-66645741-T-A,rs2533285,-1,T,A,66645741,68818,66380315,66773531,265426
7,ENSG00000237310.1,66493659,7-66645741-T-C,rs2533285,1,T,C,66645741,152082,66297051,66690267,348690
7,ENSG00000237310.1,66493659,7-66645741-T-G,rs2533285,1,T,G,66645741,152082,66297051,66690267,348690
7,ENSG00000237310.1,66493659,7-66645741-T-A,rs2533285,1,T,A,66645741,152082,66297051,66690267,348690
7,ENSG00000233297.4,102690469,7-102712182-T-G,rs28715957,-1,T,G,102712182,21713,102493861,102887077,218321
7,ENSG00000225739.1,36818959,7-36980298-T-G,rs28720896,1,T,G,36980298,161339,36622351,37015567,357947
7,ENSG00000223718.2,135660039,7-135816006-G-C,rs2960903,1,G,C,135816006,155967,135463431,135856647,352575
7,ENSG00000214106.3,154928485,7-154999468-A-T,rs306273,1,A,T,154999468,70983,154731877,155125093,267591
7,ENSG00000214106.3,154928485,7-154999468-A-C,rs306273,1,A,C,154999468,70983,154731877,155125093,267591
7,ENSG00000214106.3,154928485,7-154999468-A-G,rs306273,1,A,G,154999468,70983,154731877,155125093,267591
7,ENSG00000233834.2,20217536,7-20218831-C-T,rs3095005,1,C,T,20218831,1295,20020928,20414144,197903
7,ENSG00000225726.1,77072237,7-77252312-T-A,rs3114314,-1,T,A,77252312,180075,76875629,77268845,376683
7,ENSG00000225726.1,77072237,7-77252312-T-C,rs3114314,-1,T,C,77252312,180075,76875629,77268845,376683
7,ENSG00000197085.6,34758234,7-34716363-C-T,rs324377,-1,C,T,34716363,41871,34561626,34954842,154737
7,ENSG00000197085.6,34758234,7-34716363-C-A,rs324377,-1,C,A,34716363,41871,34561626,34954842,154737
7,ENSG00000233523.1,73188736,7-73311890-C-T,rs34014814,-1,C,T,73311890,123154,72992128,73385344,319762
7,ENSG00000227053.1,101017665,7-100992486-G-T,rs34214710,-1,G,T,100992486,25179,100821057,101214273,171429
7,ENSG00000227053.1,101017665,7-100992486-G-A,rs34214710,-1,G,A,100992486,25179,100821057,101214273,171429
7,ENSG00000227053.1,101017665,7-100992486-G-C,rs34214710,-1,G,C,100992486,25179,100821057,101214273,171429
7,ENSG00000232736.1,35768640,7-35738197-A-G,rs345386,-1,A,G,35738197,30443,35572032,35965248,166165
7,ENSG00000232736.1,35768640,7-35738197-A-C,rs345386,-1,A,C,35738197,30443,35572032,35965248,166165
7,ENSG00000232736.1,35768640,7-35738197-A-T,rs345386,-1,A,T,35738197,30443,35572032,35965248,166165
7,ENSG00000233429.4,27096094,7-27171929-C-T,rs34957925,1,C,T,27171929,75835,26899486,27292702,272443
7,ENSG00000211699.2,38359162,7-38532211-T-A,rs3800797,-1,T,A,38532211,173049,38162554,38555770,369657
7,ENSG00000211699.2,38359162,7-38532211-T-C,rs3800797,-1,T,C,38532211,173049,38162554,38555770,369657
7,ENSG00000224448.1,99638767,7-99669165-A-G,rs3800959,-1,A,G,99669165,30398,99442159,99835375,227006
7,ENSG00000078319.7,100335860,7-100428669-G-A,rs3807475,-1,G,A,100428669,92809,100139252,100532468,289417
7,ENSG00000249773.3,55887277,7-55981044-C-T,rs3816089,1,C,T,55981044,93767,55690669,56083885,290375
7,ENSG00000204934.6,149880610,7-149884188-C-A,rs4077894,-1,C,A,149884188,3578,149684002,150077218,200186
7,ENSG00000227968.1,108995029,7-108966627-G-A,rs41427546,-1,G,A,108966627,28402,108798421,109191637,168206
7,ENSG00000224172.1,64736743,7-64863174-C-T,rs41474947,-1,C,T,64863174,126431,64540135,64933351,323039
7,ENSG00000229977.2,143533164,7-143406287-T-C,rs4283960,-1,T,C,143406287,126877,143336556,143729772,69731
7,ENSG00000229977.2,143533164,7-143406287-T-G,rs4283960,-1,T,G,143406287,126877,143336556,143729772,69731
7,ENSG00000229977.2,143533164,7-143406287-T-A,rs4283960,-1,T,A,143406287,126877,143336556,143729772,69731
7,ENSG00000229358.2,32761787,7-32579125-C-T,rs4431500,-1,C,T,32579125,182662,32565179,32958395,13946
7,ENSG00000229358.2,32761787,7-32579125-C-G,rs4431500,-1,C,G,32579125,182662,32565179,32958395,13946
7,ENSG00000237773.1,17299288,7-17468324-A-G,rs4721617,-1,A,G,17468324,169036,17102680,17495896,365644
7,ENSG00000188185.6,39733632,7-39818199-C-T,rs4723910,1,C,T,39818199,84567,39537024,39930240,281175
7,ENSG00000228775.3,141738230,7-141905284-G-C,rs4726479,-1,G,C,141905284,167054,141541622,141934838,363662
7,ENSG00000228775.3,141738230,7-141905284-G-A,rs4726479,-1,G,A,141905284,167054,141541622,141934838,363662
7,ENSG00000232533.1,143381036,7-143404891-C-T,rs4726618,-1,C,T,143404891,23855,143184428,143577644,220463
7,ENSG00000240889.1,140697077,7-140669314-C-G,rs4727011,-1,C,G,140669314,27763,140500469,140893685,168845
7,ENSG00000240889.1,140697077,7-140669314-C-T,rs4727011,-1,C,T,140669314,27763,140500469,140893685,168845
7,ENSG00000232906.1,65355934,7-65237723-G-A,rs580759,1,G,A,65237723,118211,65159326,65552542,78397
7,ENSG00000213650.3,56568858,7-56659271-A-C,rs62463298,-1,A,C,56659271,90413,56372250,56765466,287021
7,ENSG00000213650.3,56568858,7-56659271-A-T,rs62463298,-1,A,T,56659271,90413,56372250,56765466,287021
7,ENSG00000234585.2,65064999,7-65231622-C-T,rs62469333,1,C,T,65231622,166623,64868391,65261607,363231
7,ENSG00000228546.2,102337316,7-102175516-C-T,rs62484928,1,C,T,102175516,161800,102140708,102533924,34808
7,ENSG00000224903.1,156659582,7-156512521-G-A,rs6459686,-1,G,A,156512521,147061,156462974,156856190,49547
7,ENSG00000231556.1,65335668,7-65316784-A-C,rs6460236,-1,A,C,65316784,18884,65139060,65532276,177724
7,ENSG00000231556.1,65335668,7-65316784-A-G,rs6460236,-1,A,G,65316784,18884,65139060,65532276,177724
7,ENSG00000236453.1,94022833,7-94074897-T-C,rs6465402,1,T,C,94074897,52064,93826225,94219441,248672
7,ENSG00000236453.1,94022833,7-94074897-T-G,rs6465402,1,T,G,94074897,52064,93826225,94219441,248672
7,ENSG00000237709.1,88639014,7-88784071-A-T,rs6950169,1,A,T,88784071,145057,88442406,88835622,341665
7,ENSG00000227017.1,30179014,7-30172172-C-T,rs6953710,-1,C,T,30172172,6842,29982406,30375622,189766
7,ENSG00000254270.1,139534240,7-139585224-T-C,rs6959265,1,T,C,139585224,50984,139337632,139730848,247592
7,ENSG00000237729.2,93670077,7-93573300-T-A,rs6965274,-1,T,A,93573300,96777,93473469,93866685,99831
7,ENSG00000237729.2,93670077,7-93573300-T-G,rs6965274,-1,T,G,93573300,96777,93473469,93866685,99831
7,ENSG00000237729.2,93670077,7-93573300-T-C,rs6965274,-1,T,C,93573300,96777,93473469,93866685,99831
7,ENSG00000232445.1,101308270,7-101277494-C-G,rs6968930,1,C,G,101277494,30776,101111662,101504878,165832
7,ENSG00000232445.1,101308270,7-101277494-C-T,rs6968930,1,C,T,101277494,30776,101111662,101504878,165832
7,ENSG00000183444.9,97967074,7-97881674-C-T,rs6969821,-1,C,T,97881674,85400,97770466,98163682,111208
7,ENSG00000183444.9,97967074,7-97881674-C-G,rs6969821,-1,C,G,97881674,85400,97770466,98163682,111208
7,ENSG00000243797.1,106732449,7-106538008-G-C,rs6969980,-1,G,C,106538008,194441,106535841,106929057,2167
7,ENSG00000243797.1,106732449,7-106538008-G-T,rs6969980,-1,G,T,106538008,194441,106535841,106929057,2167
7,ENSG00000228974.4,5560743,7-5456228-T-A,rs6970215,1,T,A,5456228,104515,5364135,5757351,92093
7,ENSG00000228974.4,5560743,7-5456228-T-C,rs6970215,1,T,C,5456228,104515,5364135,5757351,92093
7,ENSG00000230715.2,128652841,7-128675835-A-T,rs6971819,1,A,T,128675835,22994,128456233,128849449,219602
7,ENSG00000229161.2,42794906,7-42773891-A-G,rs6973772,1,A,G,42773891,21015,42598298,42991514,175593
7,ENSG00000211697.2,38350022,7-38394665-C-G,rs720667,-1,C,G,38394665,44643,38153414,38546630,241251
7,ENSG00000211697.2,38350022,7-38394665-C-A,rs720667,-1,C,A,38394665,44643,38153414,38546630,241251
7,ENSG00000211697.2,38350022,7-38394665-C-T,rs720667,-1,C,T,38394665,44643,38153414,38546630,241251
7,ENSG00000219039.2,75835663,7-75805044-A-G,rs73140282,1,A,G,75805044,30619,75639055,76032271,165989
7,ENSG00000226421.1,32471513,7-32380853-A-C,rs73306199,1,A,C,32380853,90660,32274905,32668121,105948
7,ENSG00000232019.1,84940245,7-84970513-A-C,rs74297479,-1,A,C,84970513,30268,84743637,85136853,226876
7,ENSG00000232019.1,84940245,7-84970513-A-G,rs74297479,-1,A,G,84970513,30268,84743637,85136853,226876
7,ENSG00000133624.9,149624565,7-149663903-C-T,rs757742,-1,C,T,149663903,39338,149427957,149821173,235946
7,ENSG00000211698.2,38354517,7-38377213-C-T,rs76283292,-1,C,T,38377213,22696,38157909,38551125,219304
7,ENSG00000233306.2,38363518,7-38377213-C-T,rs76283292,-1,C,T,38377213,13695,38166910,38560126,210303
7,ENSG00000230658.1,23105703,7-23274443-C-T,rs77253147,-1,C,T,23274443,168740,22909095,23302311,365348
7,ENSG00000230658.1,23105703,7-23274443-C-G,rs77253147,-1,C,G,23274443,168740,22909095,23302311,365348
7,ENSG00000219807.2,94833904,7-94787712-C-G,rs7779763,1,C,G,94787712,46192,94637296,95030512,150416
7,ENSG00000219807.2,94833904,7-94787712-C-A,rs7779763,1,C,A,94787712,46192,94637296,95030512,150416
7,ENSG00000219807.2,94833904,7-94787712-C-T,rs7779763,1,C,T,94787712,46192,94637296,95030512,150416
7,ENSG00000228649.1,22854159,7-22786741-C-T,rs7781074,1,C,T,22786741,67418,22657551,23050767,129190
7,ENSG00000228649.1,22854159,7-22786741-C-A,rs7781074,1,C,A,22786741,67418,22657551,23050767,129190
7,ENSG00000224079.1,1074450,7-966937-T-C,rs7792825,1,T,C,966937,107513,877842,1271058,89095
7,ENSG00000231840.1,143286663,7-143332890-T-C,rs7794560,-1,T,C,143332890,46227,143090055,143483271,242835
7,ENSG00000230189.2,66453634,7-66332201-T-C,rs77980817,-1,T,C,66332201,121433,66257026,66650242,75175
7,ENSG00000223886.3,105530209,7-105666109-G-A,rs7799245,1,G,A,105666109,135900,105333601,105726817,332508
7,ENSG00000223459.4,143598039,7-143737056-G-C,rs7803432,1,G,C,143737056,139017,143401431,143794647,335625
7,ENSG00000226816.2,23205787,7-23182251-T-C,rs7808488,1,T,C,23182251,23536,23009179,23402395,173072
7,ENSG00000260997.1,44960909,7-45110732-A-C,rs7810512,-1,A,C,45110732,149823,44764301,45157517,346431
7,ENSG00000186704.8,76978617,7-77121971-C-T,rs78155900,1,C,T,77121971,143354,76782009,77175225,339962
7,ENSG00000235368.1,57424503,7-57243925-G-T,rs78637130,1,G,T,57243925,180578,57227895,57621111,16030
7,ENSG00000254959.1,30752137,7-30850545-G-A,rs78722842,1,G,A,30850545,98408,30555529,30948745,295016
7,ENSG00000231721.2,131107928,7-131297617-G-T,rs79560786,-1,G,T,131297617,189689,130911320,131304536,386297
7,ENSG00000213787.3,26922110,7-27034112-T-C,rs799234,1,T,C,27034112,112002,26725502,27118718,308610
7,ENSG00000182648.7,156640599,7-156620502-T-G,rs849072,-1,T,G,156620502,20097,156443991,156837207,176511
7,ENSG00000182648.7,156640599,7-156620502-T-C,rs849072,-1,T,C,156620502,20097,156443991,156837207,176511
7,ENSG00000214389.2,98386584,7-98534289-C-T,rs900481,-1,C,T,98534289,147705,98189976,98583192,344313
7,ENSG00000214389.2,98386584,7-98534289-C-G,rs900481,-1,C,G,98534289,147705,98189976,98583192,344313
7,ENSG00000236015.1,39570198,7-39398118-T-C,rs917400,-1,T,C,39398118,172080,39373590,39766806,24528
7,ENSG00000214998.2,7910449,7-7963136-T-G,rs929510,-1,T,G,7963136,52687,7713841,8107057,249295
7,ENSG00000224138.1,127350128,7-127499154-T-C,rs954007,1,T,C,127499154,149026,127153520,127546736,345634
7,ENSG00000237181.1,602792,7-637965-T-C,rs9690251,1,T,C,637965,35173,406184,799400,231781
6,ENSG00000228223.1,26521709,6-26453514-A-G,rs10484440,1,A,G,26453514,68195,26325101,26718317,128413
6,ENSG00000228223.1,26521709,6-26453514-A-C,rs10484440,1,A,C,26453514,68195,26325101,26718317,128413
6,ENSG00000203875.4,85678748,6-85678170-G-C,rs1059307,-1,G,C,85678170,578,85482140,85875356,196030
6,ENSG00000203875.4,85678748,6-85678170-G-T,rs1059307,-1,G,T,85678170,578,85482140,85875356,196030
6,ENSG00000231769.1,46129857,6-46174815-A-T,rs10807337,-1,A,T,46174815,44958,45933249,46326465,241566
6,ENSG00000231769.1,46129857,6-46174815-A-G,rs10807337,-1,A,G,46174815,44958,45933249,46326465,241566
6,ENSG00000231769.1,46129857,6-46174815-A-C,rs10807337,-1,A,C,46174815,44958,45933249,46326465,241566
6,ENSG00000212802.3,12514110,6-12709407-T-G,rs10948184,1,T,G,12709407,195297,12317502,12710718,391905
6,ENSG00000212802.3,12514110,6-12709407-T-C,rs10948184,1,T,C,12709407,195297,12317502,12710718,391905
6,ENSG00000219470.1,43539703,6-43523209-T-G,rs11077,-1,T,G,43523209,16494,43343095,43736311,180114
6,ENSG00000219470.1,43539703,6-43523209-T-A,rs11077,-1,T,A,43523209,16494,43343095,43736311,180114
6,ENSG00000227939.1,31280317,6-31345637-A-G,rs111343098,1,A,G,31345637,65320,31083709,31476925,261928
6,ENSG00000234147.1,140898381,6-140888061-A-G,rs11155139,-1,A,G,140888061,10320,140701773,141094989,186288
6,ENSG00000234147.1,140898381,6-140888061-A-T,rs11155139,-1,A,T,140888061,10320,140701773,141094989,186288
6,ENSG00000216819.1,3179764,6-3205200-T-A,rs11242827,-1,T,A,3205200,25436,2983156,3376372,222044
6,ENSG00000216819.1,3179764,6-3205200-T-C,rs11242827,-1,T,C,3205200,25436,2983156,3376372,222044
6,ENSG00000216819.1,3179764,6-3205200-T-G,rs11242827,-1,T,G,3205200,25436,2983156,3376372,222044
6,ENSG00000213880.3,29803991,6-29673737-C-T,rs114591600,-1,C,T,29673737,130254,29607383,30000599,66354
6,ENSG00000213880.3,29803991,6-29673737-C-G,rs114591600,-1,C,G,29673737,130254,29607383,30000599,66354
6,ENSG00000227198.1,31658329,6-31663754-G-A,rs114733011,1,G,A,31663754,5425,31461721,31854937,202033
6,ENSG00000213916.2,28861416,6-28997862-C-T,rs115486666,1,C,T,28997862,136446,28664808,29058024,333054
6,ENSG00000213916.2,28861416,6-28997862-C-A,rs115486666,1,C,A,28997862,136446,28664808,29058024,333054
6,ENSG00000225595.1,28863350,6-28997862-C-T,rs115486666,-1,C,T,28997862,134512,28666742,29059958,331120
6,ENSG00000225595.1,28863350,6-28997862-C-A,rs115486666,-1,C,A,28997862,134512,28666742,29059958,331120
6,ENSG00000231074.2,30327362,6-30272297-T-G,rs1158763,-1,T,G,30272297,55065,30130754,30523970,141543
6,ENSG00000231074.2,30327362,6-30272297-T-C,rs1158763,-1,T,C,30272297,55065,30130754,30523970,141543
6,ENSG00000226309.1,84430802,6-84540033-A-T,rs117533947,-1,A,T,84540033,109231,84234194,84627410,305839
6,ENSG00000235008.1,166702839,6-166748238-T-G,rs11758967,-1,T,G,166748238,45399,166506231,166899447,242007
6,ENSG00000235008.1,166702839,6-166748238-T-C,rs11758967,-1,T,C,166748238,45399,166506231,166899447,242007
6,ENSG00000219257.1,100051236,6-99871698-G-A,rs117801732,-1,G,A,99871698,179538,99854628,100247844,17070
6,ENSG00000186743.2,116038756,6-116114430-C-T,rs118113509,1,C,T,116114430,75674,115842148,116235364,272282
6,ENSG00000226089.2,81534913,6-81624705-C-A,rs118143313,-1,C,A,81624705,89792,81338305,81731521,286400
6,ENSG00000226089.2,81534913,6-81624705-C-T,rs118143313,-1,C,T,81624705,89792,81338305,81731521,286400
6,ENSG00000216316.1,119269714,6-119270142-A-C,rs11962211,-1,A,C,119270142,428,119073106,119466322,197036
6,ENSG00000216316.1,119269714,6-119270142-A-G,rs11962211,-1,A,G,119270142,428,119073106,119466322,197036
6,ENSG00000224328.1,30703067,6-30754156-T-C,rs11964663,1,T,C,30754156,51089,30506459,30899675,247697
6,ENSG00000217385.1,4702463,6-4822997-C-T,rs12197283,1,C,T,4822997,120534,4505855,4899071,317142
6,ENSG00000229921.2,167997077,6-167991179-C-A,rs12203032,-1,C,A,167991179,5898,167800469,168193685,190710
6,ENSG00000213130.3,128580884,6-128528613-T-C,rs12206907,-1,T,C,128528613,52271,128384276,128777492,144337
6,ENSG00000216863.4,6622744,6-6643424-A-G,rs12210481,-1,A,G,6643424,20680,6426136,6819352,217288
6,ENSG00000216863.4,6622744,6-6643424-A-C,rs12210481,-1,A,C,6643424,20680,6426136,6819352,217288
6,ENSG00000229852.2,73263222,6-73276934-T-A,rs12216162,1,T,A,73276934,13712,73066614,73459830,210320
6,ENSG00000229852.2,73263222,6-73276934-T-C,rs12216162,1,T,C,73276934,13712,73066614,73459830,210320
6,ENSG00000224384.1,96785137,6-96800819-T-A,rs12525976,1,T,A,96800819,15682,96588529,96981745,212290
6,ENSG00000224384.1,96785137,6-96800819-T-C,rs12525976,1,T,C,96800819,15682,96588529,96981745,212290
6,ENSG00000213073.4,160093423,6-160081428-A-T,rs13207901,1,A,T,160081428,11995,159896815,160290031,184613
6,ENSG00000213073.4,160093423,6-160081428-A-G,rs13207901,1,A,G,160081428,11995,159896815,160290031,184613
6,ENSG00000255389.1,111599875,6-111601517-A-G,rs13210247,1,A,G,111601517,1642,111403267,111796483,198250
6,ENSG00000260273.1,109382795,6-109365424-C-A,rs13437492,1,C,A,109365424,17371,109186187,109579403,179237
6,ENSG00000213183.3,96649069,6-96669960-G-C,rs1475750,-1,G,C,96669960,20891,96452461,96845677,217499
6,ENSG00000213183.3,96649069,6-96669960-G-A,rs1475750,-1,G,A,96669960,20891,96452461,96845677,217499
6,ENSG00000233916.1,29708547,6-29706871-A-T,rs1476573,-1,A,T,29706871,1676,29511939,29905155,194932
6,ENSG00000233916.1,29708547,6-29706871-A-G,rs1476573,-1,A,G,29706871,1676,29511939,29905155,194932
6,ENSG00000236326.1,116244728,6-116096995-G-T,rs1547030,-1,G,T,116096995,147733,116048120,116441336,48875
6,ENSG00000236326.1,116244728,6-116096995-G-A,rs1547030,-1,G,A,116096995,147733,116048120,116441336,48875
6,ENSG00000225864.1,29723971,6-29707899-C-G,rs1610585,-1,C,G,29707899,16072,29527363,29920579,180536
6,ENSG00000225864.1,29723971,6-29707899-C-A,rs1610585,-1,C,A,29707899,16072,29527363,29920579,180536
6,ENSG00000217648.1,143342246,6-143464348-A-G,rs161070,1,A,G,143464348,122102,143145638,143538854,318710
6,ENSG00000230795.2,29926459,6-29861474-A-T,rs1611713,1,A,T,29861474,64985,29729851,30123067,131623
6,ENSG00000230795.2,29926459,6-29861474-A-C,rs1611713,1,A,C,29861474,64985,29729851,30123067,131623
6,ENSG00000239257.1,29727139,6-29745803-T-C,rs1633088,-1,T,C,29745803,18664,29530531,29923747,215272
6,ENSG00000235174.1,73373263,6-73197316-C-T,rs16883494,-1,C,T,73197316,175947,73176655,73569871,20661
6,ENSG00000234882.1,73291962,6-73266372-T-C,rs16883518,1,T,C,73266372,25590,73095354,73488570,171018
6,ENSG00000239626.1,73290403,6-73300891-A-G,rs16883564,1,A,G,73300891,10488,73093795,73487011,207096
6,ENSG00000181126.8,29792234,6-29853273-G-T,rs16896119,1,G,T,29853273,61039,29595626,29988842,257647
6,ENSG00000181126.8,29792234,6-29853273-G-A,rs16896119,1,G,A,29853273,61039,29595626,29988842,257647
6,ENSG00000204622.6,30006606,6-29954963-A-G,rs16896742,1,A,G,29954963,51643,29809998,30203214,144965
6,ENSG00000249141.1,166956124,6-167032003-C-T,rs16899809,-1,C,T,167032003,75879,166759516,167152732,272487
6,ENSG00000218027.2,1515289,6-1386502-G-T,rs1711970,-1,G,T,1386502,128787,1318681,1711897,67821
6,ENSG00000204387.7,31834608,6-31845428-C-T,rs17201269,1,C,T,31845428,10820,31638000,32031216,207428
6,ENSG00000204387.7,31834608,6-31845428-C-A,rs17201269,1,C,A,31845428,10820,31638000,32031216,207428
6,ENSG00000250535.1,32013270,6-31948236-T-C,rs17201431,1,T,C,31948236,65034,31816662,32209878,131574
6,ENSG00000176933.4,28218634,6-28218776-C-A,rs1736894,-1,C,A,28218776,142,28022026,28415242,196750
6,ENSG00000214922.3,29749049,6-29736623-T-G,rs1736913,-1,T,G,29736623,12426,29552441,29945657,184182
6,ENSG00000214922.3,29749049,6-29736623-T-C,rs1736913,-1,T,C,29736623,12426,29552441,29945657,184182
6,ENSG00000219902.1,105302823,6-105125229-T-C,rs17524448,-1,T,C,105125229,177594,105106215,105499431,19014
6,ENSG00000204110.4,37507348,6-37519268-T-A,rs1757171,1,T,A,37519268,11920,37310740,37703956,208528
6,ENSG00000204110.4,37507348,6-37519268-T-G,rs1757171,1,T,G,37519268,11920,37310740,37703956,208528
6,ENSG00000204110.4,37507348,6-37519268-T-C,rs1757171,1,T,C,37519268,11920,37310740,37703956,208528
6,ENSG00000227920.2,37545145,6-37518534-A-G,rs1757178,1,A,G,37518534,26611,37348537,37741753,169997
6,ENSG00000227920.2,37545145,6-37518534-A-C,rs1757178,1,A,C,37518534,26611,37348537,37741753,169997
6,ENSG00000227920.2,37545145,6-37518534-A-T,rs1757178,1,A,T,37518534,26611,37348537,37741753,169997
6,ENSG00000219703.1,117431591,6-117280315-T-C,rs1760534,1,T,C,117280315,151276,117234983,117628199,45332
6,ENSG00000225339.1,34248535,6-34317832-A-T,rs17629180,1,A,T,34317832,69297,34051927,34445143,265905
6,ENSG00000225339.1,34248535,6-34317832-A-G,rs17629180,1,A,G,34317832,69297,34051927,34445143,265905
6,ENSG00000205653.1,203313,6-209117-A-G,rs17744451,1,A,G,209117,5804,6705,399921,202412
6,ENSG00000213149.3,110858239,6-110858415-T-A,rs1775125,1,T,A,110858415,176,110661631,111054847,196784
6,ENSG00000213149.3,110858239,6-110858415-T-C,rs1775125,1,T,C,110858415,176,110661631,111054847,196784
6,ENSG00000261839.1,28136849,6-28086420-A-G,rs17767294,1,A,G,28086420,50429,27940241,28333457,146179
6,ENSG00000261839.1,28136849,6-28086420-A-T,rs17767294,1,A,T,28086420,50429,27940241,28333457,146179
6,ENSG00000216548.1,140922910,6-140730300-C-T,rs1879505,-1,C,T,140730300,192610,140726302,141119518,3998
6,ENSG00000230943.1,113650090,6-113745925-T-C,rs2030926,-1,T,C,113745925,95835,113453482,113846698,292443
6,ENSG00000224557.3,33112516,6-33105545-A-G,rs2064476,1,A,G,33105545,6971,32915908,33309124,189637
6,ENSG00000204528.3,31177899,6-31272119-T-C,rs2074491,-1,T,C,31272119,94220,30981291,31374507,290828
6,ENSG00000232876.1,135055033,6-135054094-C-G,rs2150681,1,C,G,135054094,939,134858425,135251641,195669
6,ENSG00000232876.1,135055033,6-135054094-C-T,rs2150681,1,C,T,135054094,939,134858425,135251641,195669
6,ENSG00000261366.1,95577450,6-95411361-A-C,rs2246786,-1,A,C,95411361,166089,95380842,95774058,30519
6,ENSG00000261366.1,95577450,6-95411361-A-G,rs2246786,-1,A,G,95411361,166089,95380842,95774058,30519
6,ENSG00000261366.1,95577450,6-95411361-A-T,rs2246786,-1,A,T,95411361,166089,95380842,95774058,30519
6,ENSG00000225793.1,75285014,6-75292847-C-G,rs2250989,1,C,G,75292847,7833,75088406,75481622,204441
6,ENSG00000225793.1,75285014,6-75292847-C-T,rs2250989,1,C,T,75292847,7833,75088406,75481622,204441
6,ENSG00000230438.3,2881407,6-2876347-C-A,rs2252076,-1,C,A,2876347,5060,2684799,3078015,191548
6,ENSG00000230438.3,2881407,6-2876347-C-T,rs2252076,-1,C,T,2876347,5060,2684799,3078015,191548
6,ENSG00000230438.3,2881407,6-2876347-C-G,rs2252076,-1,C,G,2876347,5060,2684799,3078015,191548
6,ENSG00000250903.2,2245736,6-2230827-C-G,rs2295007,1,C,G,2230827,14909,2049128,2442344,181699
6,ENSG00000250903.2,2245736,6-2230827-C-T,rs2295007,1,C,T,2230827,14909,2049128,2442344,181699
6,ENSG00000234484.1,132752675,6-132754858-C-A,rs2300079,1,C,A,132754858,2183,132556067,132949283,198791
6,ENSG00000234484.1,132752675,6-132754858-C-G,rs2300079,1,C,G,132754858,2183,132556067,132949283,198791
6,ENSG00000220848.4,149594084,6-149493626-A-G,rs2341551,1,A,G,149493626,100458,149397476,149790692,96150
6,ENSG00000235781.1,30516266,6-30503743-A-G,rs2429657,1,A,G,30503743,12523,30319658,30712874,184085
6,ENSG00000228789.2,31054330,6-31039813-C-G,rs2517552,1,C,G,31039813,14517,30857722,31250938,182091
6,ENSG00000228789.2,31054330,6-31039813-C-T,rs2517552,1,C,T,31039813,14517,30857722,31250938,182091
6,ENSG00000229142.1,29828364,6-29720724-A-C,rs2517910,-1,A,C,29720724,107640,29631756,30024972,88968
6,ENSG00000230521.1,29888268,6-29720724-A-C,rs2517910,-1,A,C,29720724,167544,29691660,30084876,29064
6,ENSG00000227262.2,29926973,6-29971463-G-C,rs2523966,-1,G,C,29971463,44490,29730365,30123581,241098
6,ENSG00000227262.2,29926973,6-29971463-G-A,rs2523966,-1,G,A,29971463,44490,29730365,30123581,241098
6,ENSG00000233859.1,65838039,6-65804358-C-T,rs2814111,-1,C,T,65804358,33681,65641431,66034647,162927
6,ENSG00000233859.1,65838039,6-65804358-C-G,rs2814111,-1,C,G,65804358,33681,65641431,66034647,162927
6,ENSG00000227766.1,29943067,6-29965662-C-A,rs2844806,-1,C,A,29965662,22595,29746459,30139675,219203
6,ENSG00000227766.1,29943067,6-29965662-C-T,rs2844806,-1,C,T,29965662,22595,29746459,30139675,219203
6,ENSG00000176998.3,29792750,6-29950957-A-G,rs2975043,-1,A,G,29950957,158207,29596142,29989358,354815
6,ENSG00000176998.3,29792750,6-29950957-A-C,rs2975043,-1,A,C,29950957,158207,29596142,29989358,354815
6,ENSG00000166984.7,167172145,6-167140697-A-C,rs3093001,1,A,C,167140697,31448,166975537,167368753,165160
6,ENSG00000166984.7,167172145,6-167140697-A-G,rs3093001,1,A,G,167140697,31448,166975537,167368753,165160
6,ENSG00000166984.7,167172145,6-167140697-A-T,rs3093001,1,A,T,167140697,31448,166975537,167368753,165160
6,ENSG00000233902.1,31463336,6-31572916-G-A,rs3093542,-1,G,A,31572916,109580,31266728,31659944,306188
6,ENSG00000233902.1,31463336,6-31572916-G-C,rs3093542,-1,G,C,31572916,109580,31266728,31659944,306188
6,ENSG00000233902.1,31463336,6-31572916-G-T,rs3093542,-1,G,T,31572916,109580,31266728,31659944,306188
6,ENSG00000219797.2,31520291,6-31579697-G-A,rs3093561,-1,G,A,31579697,59406,31323683,31716899,256014
6,ENSG00000206344.5,31197760,6-31193433-T-C,rs3095238,1,T,C,31193433,4327,31001152,31394368,192281
6,ENSG00000206344.5,31197760,6-31193433-T-G,rs3095238,1,T,G,31193433,4327,31001152,31394368,192281
6,ENSG00000206344.5,31197760,6-31193433-T-A,rs3095238,1,T,A,31193433,4327,31001152,31394368,192281
6,ENSG00000224796.1,33079451,6-33106207-A-G,rs3117234,1,A,G,33106207,26756,32882843,33276059,223364
6,ENSG00000228022.1,30743790,6-30790689-A-G,rs3131043,1,A,G,30790689,46899,30547182,30940398,243507
6,ENSG00000228022.1,30743790,6-30790689-A-T,rs3131043,1,A,T,30790689,46899,30547182,30940398,243507
6,ENSG00000228022.1,30743790,6-30790689-A-C,rs3131043,1,A,C,30790689,46899,30547182,30940398,243507
6,ENSG00000254870.1,31546582,6-31739953-T-C,rs3131382,-1,T,C,31739953,193371,31349974,31743190,389979
6,ENSG00000254870.1,31546582,6-31739953-T-G,rs3131382,-1,T,G,31739953,193371,31349974,31743190,389979
6,ENSG00000254870.1,31546582,6-31739953-T-A,rs3131382,-1,T,A,31739953,193371,31349974,31743190,389979
6,ENSG00000219755.1,99575712,6-99554211-G-A,rs330815,1,G,A,99554211,21501,99379104,99772320,175107
6,ENSG00000229559.2,37547280,6-37564181-A-T,rs34017770,-1,A,T,37564181,16901,37350672,37743888,213509
6,ENSG00000229559.2,37547280,6-37564181-A-G,rs34017770,-1,A,G,37564181,16901,37350672,37743888,213509
6,ENSG00000244041.1,2987967,6-2840548-C-T,rs34249702,1,C,T,2840548,147419,2791359,3184575,49189
6,ENSG00000213131.3,127355756,6-127476229-G-A,rs3734450,1,G,A,127476229,120473,127159148,127552364,317081
6,ENSG00000168405.9,25138081,6-25099112-G-A,rs3792971,-1,G,A,25099112,38969,24941473,25334689,157639
6,ENSG00000228170.1,3153062,6-3150281-C-A,rs3799216,-1,C,A,3150281,2781,2956454,3349670,193827
6,ENSG00000228170.1,3153062,6-3150281-C-T,rs3799216,-1,C,T,3150281,2781,2956454,3349670,193827
6,ENSG00000227627.1,152983719,6-153002671-A-G,rs3818126,1,A,G,153002671,18952,152787111,153180327,215560
6,ENSG00000227627.1,152983719,6-153002671-A-C,rs3818126,1,A,C,153002671,18952,152787111,153180327,215560
6,ENSG00000228078.1,29934101,6-29945191-C-A,rs3823339,1,C,A,29945191,11090,29737493,30130709,207698
6,ENSG00000228078.1,29934101,6-29945191-C-G,rs3823339,1,C,G,29945191,11090,29737493,30130709,207698
6,ENSG00000216854.2,56871191,6-56683561-G-T,rs4073960,1,G,T,56683561,187630,56674583,57067799,8978
6,ENSG00000216854.2,56871191,6-56683561-G-A,rs4073960,1,G,A,56683561,187630,56674583,57067799,8978
6,ENSG00000230913.1,41666906,6-41493657-T-C,rs4711676,1,T,C,41493657,173249,41470298,41863514,23359
6,ENSG00000232702.2,51410537,6-51245950-T-C,rs4711968,-1,T,C,51245950,164587,51213929,51607145,32021
6,ENSG00000226314.3,28161769,6-28071808-G-A,rs4713135,1,G,A,28071808,89961,27965161,28358377,106647
6,ENSG00000219392.1,28115628,6-28169676-G-A,rs4713152,1,G,A,28169676,54048,27919020,28312236,250656
6,ENSG00000235821.1,29751148,6-29742949-A-G,rs4713240,-1,A,G,29742949,8199,29554540,29947756,188409
6,ENSG00000228506.1,99424913,6-99440137-A-T,rs4840044,1,A,T,99440137,15224,99228305,99621521,211832
6,ENSG00000228506.1,99424913,6-99440137-A-C,rs4840044,1,A,C,99440137,15224,99228305,99621521,211832
6,ENSG00000228506.1,99424913,6-99440137-A-G,rs4840044,1,A,G,99440137,15224,99228305,99621521,211832
6,ENSG00000260000.1,100881450,6-100882312-C-G,rs4840159,1,C,G,100882312,862,100684842,101078058,197470
6,ENSG00000260000.1,100881450,6-100882312-C-T,rs4840159,1,C,T,100882312,862,100684842,101078058,197470
6,ENSG00000215190.4,57961345,6-57947706-T-G,rs4928424,-1,T,G,57947706,13639,57764737,58157953,182969
6,ENSG00000215190.4,57961345,6-57947706-T-C,rs4928424,-1,T,C,57947706,13639,57764737,58157953,182969
6,ENSG00000238076.1,10460541,6-10497171-C-T,rs501507,-1,C,T,10497171,36630,10263933,10657149,233238
6,ENSG00000204338.4,32005689,6-31948623-A-T,rs537160,1,A,T,31948623,57066,31809081,32202297,139542
6,ENSG00000204338.4,32005689,6-31948623-A-C,rs537160,1,A,C,31948623,57066,31809081,32202297,139542
6,ENSG00000204338.4,32005689,6-31948623-A-G,rs537160,1,A,G,31948623,57066,31809081,32202297,139542
6,ENSG00000219758.5,113839279,6-113883374-C-T,rs562031,1,C,T,113883374,44095,113642671,114035887,240703
6,ENSG00000168126.3,27937465,6-27892756-C-G,rs58106751,1,C,G,27892756,44709,27740857,28134073,151899
6,ENSG00000168126.3,27937465,6-27892756-C-T,rs58106751,1,C,T,27892756,44709,27740857,28134073,151899
6,ENSG00000168126.3,27937465,6-27892756-C-A,rs58106751,1,C,A,27892756,44709,27740857,28134073,151899
6,ENSG00000213177.3,100136064,6-100145175-G-A,rs59984938,1,G,A,100145175,9111,99939456,100332672,205719
6,ENSG00000217165.1,39110321,6-39096167-G-A,rs60678751,1,G,A,39096167,14154,38913713,39306929,182454
6,ENSG00000218565.2,139338018,6-139473819-G-A,rs62440877,1,G,A,139473819,135801,139141410,139534626,332409
6,ENSG00000218565.2,139338018,6-139473819-G-T,rs62440877,1,G,T,139473819,135801,139141410,139534626,332409
6,ENSG00000226571.1,139271362,6-139270754-T-C,rs62441202,1,T,C,139270754,608,139074754,139467970,196000
6,ENSG00000229931.1,16761724,6-16744034-T-A,rs639621,1,T,A,16744034,17690,16565116,16958332,178918
6,ENSG00000229931.1,16761724,6-16744034-T-G,rs639621,1,T,G,16744034,17690,16565116,16958332,178918
6,ENSG00000214460.3,85427966,6-85368816-C-T,rs6454463,-1,C,T,85368816,59150,85231358,85624574,137458
6,ENSG00000218265.1,13521266,6-13473830-T-G,rs6458848,1,T,G,13473830,47436,13324658,13717874,149172
6,ENSG00000213108.3,137544372,6-137712481-G-A,rs669274,-1,G,A,137712481,168109,137347764,137740980,364717
6,ENSG00000216331.1,26195554,6-26274190-C-T,rs6901096,1,C,T,26274190,78636,25998946,26392162,275244
6,ENSG00000246982.2,36197203,6-36183400-T-C,rs6906612,-1,T,C,36183400,13803,36000595,36393811,182805
6,ENSG00000232699.1,99174744,6-99217670-G-A,rs6908689,1,G,A,99217670,42926,98978136,99371352,239534
6,ENSG00000216775.1,52665274,6-52684524-T-C,rs6923338,1,T,C,52684524,19250,52468666,52861882,215858
6,ENSG00000219747.1,151099529,6-150977830-T-C,rs6940242,1,T,C,150977830,121699,150902921,151296137,74909
6,ENSG00000226445.1,169213254,6-169200949-C-T,rs73041845,1,C,T,169200949,12305,169016646,169409862,184303
6,ENSG00000226445.1,169213254,6-169200949-C-G,rs73041845,1,C,G,169200949,12305,169016646,169409862,184303
6,ENSG00000229502.1,157875210,6-158069365-A-G,rs734882,-1,A,G,158069365,194155,157678602,158071818,390763
6,ENSG00000231162.3,28446973,6-28314027-C-T,rs74967533,1,C,T,28314027,132946,28250365,28643581,63662
6,ENSG00000218226.1,158621636,6-158807984-G-A,rs75124571,-1,G,A,158807984,186348,158425028,158818244,382956
6,ENSG00000260645.1,80466958,6-80417442-G-T,rs75411105,1,G,T,80417442,49516,80270350,80663566,147092
6,ENSG00000260645.1,80466958,6-80417442-G-A,rs75411105,1,G,A,80417442,49516,80270350,80663566,147092
6,ENSG00000227192.1,143042324,6-142951148-T-C,rs75962856,-1,T,C,142951148,91176,142845716,143238932,105432
6,ENSG00000229036.1,143490515,6-143435375-A-G,rs7740441,1,A,G,143435375,55140,143293907,143687123,141468
6,ENSG00000225690.1,41247369,6-41284483-G-A,rs7742256,1,G,A,41284483,37114,41050761,41443977,233722
6,ENSG00000237988.2,29550407,6-29479947-A-G,rs7767061,1,A,G,29479947,70460,29353799,29747015,126148
6,ENSG00000261211.1,6686948,6-6684585-G-A,rs79506447,-1,G,A,6684585,2363,6490340,6883556,194245
6,ENSG00000261211.1,6686948,6-6684585-G-T,rs79506447,-1,G,T,6684585,2363,6490340,6883556,194245
6,ENSG00000228624.2,113969701,6-114030463-G-T,rs915203,1,G,T,114030463,60762,113773093,114166309,257370
6,ENSG00000228624.2,113969701,6-114030463-G-C,rs915203,1,G,C,114030463,60762,113773093,114166309,257370
6,ENSG00000228624.2,113969701,6-114030463-G-A,rs915203,1,G,A,114030463,60762,113773093,114166309,257370
6,ENSG00000215477.2,87122688,6-87318011-A-G,rs926947,-1,A,G,87318011,195323,86926080,87319296,391931
6,ENSG00000181577.10,44000585,6-44014395-C-A,rs926959,1,C,A,44014395,13810,43803977,44197193,210418
6,ENSG00000181577.10,44000585,6-44014395-C-T,rs926959,1,C,T,44014395,13810,43803977,44197193,210418
6,ENSG00000229391.3,32558186,6-32603062-A-C,rs9270856,-1,A,C,32603062,44876,32361578,32754794,241484
6,ENSG00000229391.3,32558186,6-32603062-A-G,rs9270856,-1,A,G,32603062,44876,32361578,32754794,241484
6,ENSG00000223534.1,32659880,6-32660921-C-A,rs9273529,1,C,A,32660921,1041,32463272,32856488,197649
6,ENSG00000223534.1,32659880,6-32660921-C-T,rs9273529,1,C,T,32660921,1041,32463272,32856488,197649
6,ENSG00000203362.2,43591362,6-43594152-C-T,rs9333528,-1,C,T,43594152,2790,43394754,43787970,199398
6,ENSG00000233231.1,166334568,6-166337928-C-G,rs9356478,1,C,G,166337928,3360,166137960,166531176,199968
6,ENSG00000233231.1,166334568,6-166337928-C-T,rs9356478,1,C,T,166337928,3360,166137960,166531176,199968
6,ENSG00000235652.1,145799409,6-145634469-C-T,rs9373467,1,C,T,145634469,164940,145602801,145996017,31668
6,ENSG00000216915.2,27738494,6-27715793-A-G,rs9380010,-1,A,G,27715793,22701,27541886,27935102,173907
6,ENSG00000124593.10,41780946,6-41602612-G-A,rs9381084,1,G,A,41602612,178334,41584338,41977554,18274
6,ENSG00000225914.1,32255328,6-32341131-G-A,rs9469099,1,G,A,32341131,85803,32058720,32451936,282411
6,ENSG00000225914.1,32255328,6-32341131-G-T,rs9469099,1,G,T,32341131,85803,32058720,32451936,282411
6,ENSG00000216813.1,47562622,6-47437719-T-C,rs9473111,1,T,C,47437719,124903,47366014,47759230,71705
6,ENSG00000218857.1,131185486,6-131221397-A-G,rs9483230,-1,A,G,131221397,35911,130988878,131382094,232519
6,ENSG00000185689.10,4087534,6-4255474-A-G,rs9504008,1,A,G,4255474,167940,3890926,4284142,364548
6,ENSG00000217805.2,25181359,6-25070149-G-C,rs950877,1,G,C,25070149,111210,24984751,25377967,85398
6,ENSG00000226068.1,48150005,6-48069750-T-C,rs954807,-1,T,C,48069750,80255,47953397,48346613,116353
6,ENSG00000226068.1,48150005,6-48069750-T-G,rs954807,-1,T,G,48069750,80255,47953397,48346613,116353
6,ENSG00000227502.1,113873351,6-113879127-C-T,rs975257,-1,C,T,113879127,5776,113676743,114069959,202384
6,ENSG00000233967.1,80442649,6-80250195-C-A,rs978814,1,C,A,80250195,192454,80246041,80639257,4154
6,ENSG00000233967.1,80442649,6-80250195-C-G,rs978814,1,C,G,80250195,192454,80246041,80639257,4154
6,ENSG00000216676.2,27652825,6-27495657-T-C,rs10456051,-1,T,C,27495657,157168,27456217,27849433,39440
6,ENSG00000223534.1,32659880,6-32659937-T-C,rs1063355,1,T,C,32659937,57,32463272,32856488,196665
6,ENSG00000223534.1,32659880,6-32659937-T-G,rs1063355,1,T,G,32659937,57,32463272,32856488,196665
6,ENSG00000219257.1,100051236,6-99992082-G-A,rs11155195,-1,G,A,99992082,59154,99854628,100247844,137454
6,ENSG00000219257.1,100051236,6-99992082-G-C,rs11155195,-1,G,C,99992082,59154,99854628,100247844,137454
6,ENSG00000219257.1,100051236,6-99992082-G-T,rs11155195,-1,G,T,99992082,59154,99854628,100247844,137454
6,ENSG00000204110.4,37507348,6-37506245-A-G,rs1150792,1,A,G,37506245,1103,37310740,37703956,195505
6,ENSG00000204110.4,37507348,6-37506245-A-C,rs1150792,1,A,C,37506245,1103,37310740,37703956,195505
6,ENSG00000232702.2,51410537,6-51352857-A-G,rs115684335,-1,A,G,51352857,57680,51213929,51607145,138928
6,ENSG00000235652.1,145799409,6-145792625-C-G,rs117945383,1,C,G,145792625,6784,145602801,145996017,189824
6,ENSG00000225793.1,75285014,6-75430381-C-T,rs118062348,1,C,T,75430381,145367,75088406,75481622,341975
6,ENSG00000218857.1,131185486,6-131204544-A-G,rs1190806,-1,A,G,131204544,19058,130988878,131382094,215666
6,ENSG00000218857.1,131185486,6-131204544-A-C,rs1190806,-1,A,C,131204544,19058,130988878,131382094,215666
6,ENSG00000218857.1,131185486,6-131204544-A-T,rs1190806,-1,A,T,131204544,19058,130988878,131382094,215666
6,ENSG00000205653.1,203313,6-206313-T-C,rs11961507,1,T,C,206313,3000,6705,399921,199608
6,ENSG00000225914.1,32255328,6-32300711-T-G,rs11962040,1,T,G,32300711,45383,32058720,32451936,241991
6,ENSG00000225914.1,32255328,6-32300711-T-A,rs11962040,1,T,A,32300711,45383,32058720,32451936,241991
6,ENSG00000225914.1,32255328,6-32300711-T-C,rs11962040,1,T,C,32300711,45383,32058720,32451936,241991
6,ENSG00000217139.2,121682925,6-121690223-C-T,rs11969322,1,C,T,121690223,7298,121486317,121879533,203906
6,ENSG00000161912.12,41101022,6-41091719-T-G,rs12189627,1,T,G,41091719,9303,40904414,41297630,187305
6,ENSG00000234817.2,4136072,6-4157442-G-T,rs12195496,1,G,T,4157442,21370,3939464,4332680,217978
6,ENSG00000216915.2,27738494,6-27586005-T-C,rs12197514,-1,T,C,27586005,152489,27541886,27935102,44119
6,ENSG00000228506.1,99424913,6-99423134-C-A,rs12198321,1,C,A,99423134,1779,99228305,99621521,194829
6,ENSG00000228506.1,99424913,6-99423134-C-G,rs12198321,1,C,G,99423134,1779,99228305,99621521,194829
6,ENSG00000228506.1,99424913,6-99423134-C-T,rs12198321,1,C,T,99423134,1779,99228305,99621521,194829
6,ENSG00000234484.1,132752675,6-132752034-C-T,rs12209262,1,C,T,132752034,641,132556067,132949283,195967
6,ENSG00000239626.1,73290403,6-73198040-A-G,rs12215980,1,A,G,73198040,92363,73093795,73487011,104245
6,ENSG00000204387.7,31834608,6-31901358-G-A,rs12525922,1,G,A,31901358,66750,31638000,32031216,263358
6,ENSG00000218027.2,1515289,6-1621390-C-T,rs12526605,-1,C,T,1621390,106101,1318681,1711897,302709
6,ENSG00000261211.1,6686948,6-6659981-A-T,rs12529598,-1,A,T,6659981,26967,6490340,6883556,169641
6,ENSG00000261211.1,6686948,6-6659981-A-G,rs12529598,-1,A,G,6659981,26967,6490340,6883556,169641
6,ENSG00000215190.4,57961345,6-57970370-G-A,rs12663198,-1,G,A,57970370,9025,57764737,58157953,205633
6,ENSG00000220563.1,85660606,6-85630519-C-T,rs13202606,-1,C,T,85630519,30087,85463998,85857214,166521
6,ENSG00000229922.1,137945366,6-138021607-C-G,rs13212146,1,C,G,138021607,76241,137748758,138141974,272849
6,ENSG00000229922.1,137945366,6-138021607-C-T,rs13212146,1,C,T,138021607,76241,137748758,138141974,272849
6,ENSG00000224796.1,33079451,6-33079138-T-A,rs1431402,1,T,A,33079138,313,32882843,33276059,196295
6,ENSG00000228078.1,29934101,6-29833547-T-C,rs1610682,1,T,C,29833547,100554,29737493,30130709,96054
6,ENSG00000235821.1,29751148,6-29753978-C-T,rs1611297,-1,C,T,29753978,2830,29554540,29947756,199438
6,ENSG00000227766.1,29943067,6-29861474-A-C,rs1611713,-1,A,C,29861474,81593,29746459,30139675,115015
6,ENSG00000227766.1,29943067,6-29861474-A-T,rs1611713,-1,A,T,29861474,81593,29746459,30139675,115015
6,ENSG00000233916.1,29708547,6-29747985-G-A,rs1633086,-1,G,A,29747985,39438,29511939,29905155,236046
6,ENSG00000203489.3,75319980,6-75143090-T-C,rs16886197,-1,T,C,75143090,176890,75123372,75516588,19718
6,ENSG00000227262.2,29926973,6-29836041-T-G,rs16896051,-1,T,G,29836041,90932,29730365,30123581,105676
6,ENSG00000227262.2,29926973,6-29836041-T-A,rs16896051,-1,T,A,29836041,90932,29730365,30123581,105676
6,ENSG00000245261.1,43223860,6-43223680-T-C,rs16896363,-1,T,C,43223680,180,43027252,43420468,196428
6,ENSG00000225093.1,108005568,6-107818366-C-T,rs17068819,-1,C,T,107818366,187202,107808960,108202176,9406
6,ENSG00000225093.1,108005568,6-107818366-C-A,rs17068819,-1,C,A,107818366,187202,107808960,108202176,9406
6,ENSG00000230433.1,524171,6-476395-A-T,rs17133849,1,A,T,476395,47776,327563,720779,148832
6,ENSG00000230433.1,524171,6-476395-A-G,rs17133849,1,A,G,476395,47776,327563,720779,148832
6,ENSG00000230433.1,524171,6-476395-A-C,rs17133849,1,A,C,476395,47776,327563,720779,148832
6,ENSG00000183239.5,44089696,6-44195887-G-T,rs17567624,-1,G,T,44195887,106191,43893088,44286304,302799
6,ENSG00000183239.5,44089696,6-44195887-G-A,rs17567624,-1,G,A,44195887,106191,43893088,44286304,302799
6,ENSG00000226803.1,57172422,6-57302322-C-T,rs17683594,-1,C,T,57302322,129900,56975814,57369030,326508
6,ENSG00000231889.2,111483512,6-111585943-A-T,rs1883137,1,A,T,111585943,102431,111286904,111680120,299039
6,ENSG00000231889.2,111483512,6-111585943-A-G,rs1883137,1,A,G,111585943,102431,111286904,111680120,299039
6,ENSG00000124593.10,41780946,6-41635456-G-A,rs1973920,1,G,A,41635456,145490,41584338,41977554,51118
6,ENSG00000124593.10,41780946,6-41635456-G-T,rs1973920,1,G,T,41635456,145490,41584338,41977554,51118
6,ENSG00000225339.1,34248535,6-34287699-T-C,rs206942,1,T,C,34287699,39164,34051927,34445143,235772
6,ENSG00000206344.5,31197760,6-31272944-C-T,rs2249742,1,C,T,31272944,75184,31001152,31394368,271792
6,ENSG00000206344.5,31197760,6-31272944-C-G,rs2249742,1,C,G,31272944,75184,31001152,31394368,271792
6,ENSG00000217241.1,116453565,6-116512844-T-C,rs2250263,-1,T,C,116512844,59279,116256957,116650173,255887
6,ENSG00000217241.1,116453565,6-116512844-T-G,rs2250263,-1,T,G,116512844,59279,116256957,116650173,255887
6,ENSG00000217241.1,116453565,6-116512844-T-A,rs2250263,-1,T,A,116512844,59279,116256957,116650173,255887
6,ENSG00000246982.2,36197203,6-36136144-G-A,rs2252430,-1,G,A,36136144,61059,36000595,36393811,135549
6,ENSG00000246982.2,36197203,6-36136144-G-C,rs2252430,-1,G,C,36136144,61059,36000595,36393811,135549
6,ENSG00000225791.1,52577314,6-52532249-T-G,rs2268731,1,T,G,52532249,45065,52380706,52773922,151543
6,ENSG00000225791.1,52577314,6-52532249-T-A,rs2268731,1,T,A,52532249,45065,52380706,52773922,151543
6,ENSG00000225791.1,52577314,6-52532249-T-C,rs2268731,1,T,C,52532249,45065,52380706,52773922,151543
6,ENSG00000217165.1,39110321,6-39117924-T-C,rs228813,1,T,C,39117924,7603,38913713,39306929,204211
6,ENSG00000228022.1,30743790,6-30756653-T-C,rs2394401,1,T,C,30756653,12863,30547182,30940398,209471
6,ENSG00000250264.1,32838822,6-32828908-A-G,rs241448,-1,A,G,32828908,9914,32642214,33035430,186694
6,ENSG00000220583.1,34263673,6-34068269-A-G,rs2499683,-1,A,G,34068269,195404,34067065,34460281,1204
6,ENSG00000231074.2,30327362,6-30264597-G-A,rs2516698,-1,G,A,30264597,62765,30130754,30523970,133843
6,ENSG00000229921.2,167997077,6-168004296-T-C,rs2516808,-1,T,C,168004296,7219,167800469,168193685,203827
6,ENSG00000229921.2,167997077,6-168004296-T-A,rs2516808,-1,T,A,168004296,7219,167800469,168193685,203827
6,ENSG00000244041.1,2987967,6-3005952-G-A,rs28383612,1,G,A,3005952,17985,2791359,3184575,214593
6,ENSG00000203875.4,85678748,6-85593373-G-A,rs2842612,-1,G,A,85593373,85375,85482140,85875356,111233
6,ENSG00000181126.8,29792234,6-29950957-A-G,rs2975043,1,A,G,29950957,158723,29595626,29988842,355331
6,ENSG00000181126.8,29792234,6-29950957-A-C,rs2975043,1,A,C,29950957,158723,29595626,29988842,355331
6,ENSG00000216854.2,56871191,6-56746538-C-T,rs3002005,1,C,T,56746538,124653,56674583,57067799,71955
6,ENSG00000216854.2,56871191,6-56746538-C-A,rs3002005,1,C,A,56746538,124653,56674583,57067799,71955
6,ENSG00000235238.1,29636343,6-29538350-G-A,rs3025671,-1,G,A,29538350,97993,29439735,29832951,98615
6,ENSG00000168405.9,25138081,6-25039790-A-T,rs303901,-1,A,T,25039790,98291,24941473,25334689,98317
6,ENSG00000168405.9,25138081,6-25039790-A-G,rs303901,-1,A,G,25039790,98291,24941473,25334689,98317
6,ENSG00000166984.7,167172145,6-167136287-T-C,rs3093007,1,T,C,167136287,35858,166975537,167368753,160750
6,ENSG00000214922.3,29749049,6-29657224-A-C,rs3130250,-1,A,C,29657224,91825,29552441,29945657,104783
6,ENSG00000214922.3,29749049,6-29657224-A-G,rs3130250,-1,A,G,29657224,91825,29552441,29945657,104783
6,ENSG00000230521.1,29888268,6-29914753-T-G,rs3132689,-1,T,G,29914753,26485,29691660,30084876,223093
6,ENSG00000228624.2,113969701,6-113940688-T-C,rs352068,1,T,C,113940688,29013,113773093,114166309,167595
6,ENSG00000229852.2,73263222,6-73194466-A-C,rs35791353,1,A,C,73194466,68756,73066614,73459830,127852
6,ENSG00000229852.2,73263222,6-73194466-A-T,rs35791353,1,A,T,73194466,68756,73066614,73459830,127852
6,ENSG00000229852.2,73263222,6-73194466-A-G,rs35791353,1,A,G,73194466,68756,73066614,73459830,127852
6,ENSG00000213073.4,160093423,6-160146896-G-T,rs3798167,1,G,T,160146896,53473,159896815,160290031,250081
6,ENSG00000213073.4,160093423,6-160146896-G-A,rs3798167,1,G,A,160146896,53473,159896815,160290031,250081
6,ENSG00000255389.1,111599875,6-111526988-A-T,rs3851228,1,A,T,111526988,72887,111403267,111796483,123721
6,ENSG00000228170.1,3153062,6-3204587-G-A,rs4129373,-1,G,A,3204587,51525,2956454,3349670,248133
6,ENSG00000213117.4,134897874,6-134800158-G-C,rs4895421,1,G,C,134800158,97716,134701266,135094482,98892
6,ENSG00000213117.4,134897874,6-134800158-G-T,rs4895421,1,G,T,134800158,97716,134701266,135094482,98892
6,ENSG00000213117.4,134897874,6-134800158-G-A,rs4895421,1,G,A,134800158,97716,134701266,135094482,98892
6,ENSG00000233138.1,142748443,6-142739853-A-G,rs597493,1,A,G,142739853,8590,142551835,142945051,188018
6,ENSG00000231113.1,42943740,6-43046284-G-T,rs61732148,1,G,T,43046284,102544,42747132,43140348,299152
6,ENSG00000231113.1,42943740,6-43046284-G-A,rs61732148,1,G,A,43046284,102544,42747132,43140348,299152
6,ENSG00000229931.1,16761724,6-16769567-A-G,rs623897,1,A,G,16769567,7843,16565116,16958332,204451
6,ENSG00000229931.1,16761724,6-16769567-A-C,rs623897,1,A,C,16769567,7843,16565116,16958332,204451
6,ENSG00000218565.2,139338018,6-139270754-T-C,rs62441202,1,T,C,139270754,67264,139141410,139534626,129344
6,ENSG00000232876.1,135055033,6-134903615-C-T,rs6569976,1,C,T,134903615,151418,134858425,135251641,45190
6,ENSG00000232876.1,135055033,6-134903615-C-A,rs6569976,1,C,A,134903615,151418,134858425,135251641,45190
6,ENSG00000232876.1,135055033,6-134903615-C-G,rs6569976,1,C,G,134903615,151418,134858425,135251641,45190
6,ENSG00000216863.4,6622744,6-6589244-C-T,rs6597220,-1,C,T,6589244,33500,6426136,6819352,163108
6,ENSG00000238076.1,10460541,6-10269567-T-C,rs6902538,-1,T,C,10269567,190974,10263933,10657149,5634
6,ENSG00000238076.1,10460541,6-10269567-T-A,rs6902538,-1,T,A,10269567,190974,10263933,10657149,5634
6,ENSG00000218226.1,158621636,6-158735622-C-G,rs6906796,-1,C,G,158735622,113986,158425028,158818244,310594
6,ENSG00000218226.1,158621636,6-158735622-C-A,rs6906796,-1,C,A,158735622,113986,158425028,158818244,310594
6,ENSG00000218226.1,158621636,6-158735622-C-T,rs6906796,-1,C,T,158735622,113986,158425028,158818244,310594
6,ENSG00000235381.1,155256724,6-155061959-T-C,rs6908016,-1,T,C,155061959,194765,155060116,155453332,1843
6,ENSG00000260000.1,100881450,6-100854947-A-G,rs6908709,1,A,G,100854947,26503,100684842,101078058,170105
6,ENSG00000260000.1,100881450,6-100854947-A-C,rs6908709,1,A,C,100854947,26503,100684842,101078058,170105
6,ENSG00000260000.1,100881450,6-100854947-A-T,rs6908709,1,A,T,100854947,26503,100684842,101078058,170105
6,ENSG00000216819.1,3179764,6-3143531-T-A,rs6933330,-1,T,A,3143531,36233,2983156,3376372,160375
6,ENSG00000216819.1,3179764,6-3143531-T-G,rs6933330,-1,T,G,3143531,36233,2983156,3376372,160375
6,ENSG00000246350.1,28587378,6-28701538-G-A,rs6939576,1,G,A,28701538,114160,28390770,28783986,310768
6,ENSG00000219986.2,6795402,6-6941447-G-A,rs72811198,-1,G,A,6941447,146045,6598794,6992010,342653
6,ENSG00000249141.1,166956124,6-167112422-C-T,rs73023509,-1,C,T,167112422,156298,166759516,167152732,352906
6,ENSG00000249141.1,166956124,6-167112422-C-G,rs73023509,-1,C,G,167112422,156298,166759516,167152732,352906
6,ENSG00000249141.1,166956124,6-167112422-C-A,rs73023509,-1,C,A,167112422,156298,166759516,167152732,352906
6,ENSG00000219470.1,43539703,6-43709734-C-T,rs735367,-1,C,T,43709734,170031,43343095,43736311,366639
6,ENSG00000233231.1,166334568,6-166302660-A-G,rs74650519,1,A,G,166302660,31908,166137960,166531176,164700
6,ENSG00000217027.1,144200965,6-144178516-C-A,rs76356441,-1,C,A,144178516,22449,144004357,144397573,174159
6,ENSG00000227627.1,152983719,6-152992697-G-T,rs766127,1,G,T,152992697,8978,152787111,153180327,205586
6,ENSG00000227627.1,152983719,6-152992697-G-A,rs766127,1,G,A,152992697,8978,152787111,153180327,205586
6,ENSG00000216613.2,136420425,6-136545109-C-G,rs7740853,-1,C,G,136545109,124684,136223817,136617033,321292
6,ENSG00000261366.1,95577450,6-95401709-C-A,rs7751232,-1,C,A,95401709,175741,95380842,95774058,20867
6,ENSG00000261366.1,95577450,6-95401709-C-T,rs7751232,-1,C,T,95401709,175741,95380842,95774058,20867
6,ENSG00000216901.1,28176188,6-28244711-C-A,rs7757215,1,C,A,28244711,68523,27979580,28372796,265131
6,ENSG00000217227.1,38587323,6-38686529-T-C,rs7761715,1,T,C,38686529,99206,38390715,38783931,295814
6,ENSG00000216775.1,52665274,6-52669280-C-A,rs7762854,1,C,A,52669280,4006,52468666,52861882,200614
6,ENSG00000216775.1,52665274,6-52669280-C-T,rs7762854,1,C,T,52669280,4006,52468666,52861882,200614
6,ENSG00000216775.1,52665274,6-52669280-C-G,rs7762854,1,C,G,52669280,4006,52468666,52861882,200614
6,ENSG00000234956.1,137792835,6-137764228-T-G,rs7773904,-1,T,G,137764228,28607,137596227,137989443,168001
6,ENSG00000234956.1,137792835,6-137764228-T-C,rs7773904,-1,T,C,137764228,28607,137596227,137989443,168001
6,ENSG00000234956.1,137792835,6-137764228-T-A,rs7773904,-1,T,A,137764228,28607,137596227,137989443,168001
6,ENSG00000226445.1,169213254,6-169201218-C-A,rs7775470,1,C,A,169201218,12036,169016646,169409862,184572
6,ENSG00000226445.1,169213254,6-169201218-C-T,rs7775470,1,C,T,169201218,12036,169016646,169409862,184572
6,ENSG00000226445.1,169213254,6-169201218-C-G,rs7775470,1,C,G,169201218,12036,169016646,169409862,184572
6,ENSG00000235559.1,28784004,6-28867475-G-A,rs7775657,-1,G,A,28867475,83471,28587396,28980612,280079
6,ENSG00000235559.1,28784004,6-28867475-G-T,rs7775657,-1,G,T,28867475,83471,28587396,28980612,280079
6,ENSG00000239257.1,29727139,6-29699496-G-A,rs7776082,-1,G,A,29699496,27643,29530531,29923747,168965
6,ENSG00000217414.2,18365423,6-18528168-C-T,rs78366315,-1,C,T,18528168,162745,18168815,18562031,359353
6,ENSG00000217030.1,4979072,6-4913835-A-C,rs78768296,1,A,C,4913835,65237,4782464,5175680,131371
6,ENSG00000220884.2,128929988,6-128863543-G-A,rs78855065,-1,G,A,128863543,66445,128733380,129126596,130163
6,ENSG00000219797.2,31520291,6-31686756-C-T,rs79515906,-1,C,T,31686756,166465,31323683,31716899,363073
6,ENSG00000225864.1,29723971,6-29724557-A-G,rs9258186,-1,A,G,29724557,586,29527363,29920579,197194
6,ENSG00000232757.1,30031713,6-29852333-G-A,rs9258605,1,G,A,29852333,179380,29835105,30228321,17228
6,ENSG00000228789.2,31054330,6-31061678-C-T,rs9262651,1,C,T,31061678,7348,30857722,31250938,203956
6,ENSG00000229391.3,32558186,6-32637412-A-G,rs9272426,-1,A,G,32637412,79226,32361578,32754794,275834
6,ENSG00000229391.3,32558186,6-32637412-A-C,rs9272426,-1,A,C,32637412,79226,32361578,32754794,275834
6,ENSG00000229391.3,32558186,6-32637412-A-T,rs9272426,-1,A,T,32637412,79226,32361578,32754794,275834
6,ENSG00000196301.3,32473500,6-32637674-A-G,rs9272449,-1,A,G,32637674,164174,32276892,32670108,360782
6,ENSG00000234515.1,32879833,6-32777266-T-G,rs9276644,-1,T,G,32777266,102567,32683225,33076441,94041
6,ENSG00000234515.1,32879833,6-32777266-T-C,rs9276644,-1,T,C,32777266,102567,32683225,33076441,94041
6,ENSG00000224557.3,33112516,6-33089236-A-C,rs9277567,1,A,C,33089236,23280,32915908,33309124,173328
6,ENSG00000176933.4,28218634,6-28241324-G-A,rs9295768,-1,G,A,28241324,22690,28022026,28415242,219298
6,ENSG00000218890.1,66094909,6-66147689-T-C,rs9351548,-1,T,C,66147689,52780,65898301,66291517,249388
6,ENSG00000124549.9,26422119,6-26479663-G-C,rs9357008,1,G,C,26479663,57544,26225511,26618727,254152
6,ENSG00000124549.9,26422119,6-26479663-G-T,rs9357008,1,G,T,26479663,57544,26225511,26618727,254152
6,ENSG00000219790.2,56976062,6-56801569-A-G,rs9382665,-1,A,G,56801569,174493,56779454,57172670,22115
6,ENSG00000230943.1,113650090,6-113685409-G-A,rs9384880,-1,G,A,113685409,35319,113453482,113846698,231927
6,ENSG00000230438.3,2881407,6-2869054-C-T,rs9392434,-1,C,T,2869054,12353,2684799,3078015,184255
6,ENSG00000230438.3,2881407,6-2869054-C-A,rs9392434,-1,C,A,2869054,12353,2684799,3078015,184255
6,ENSG00000230438.3,2881407,6-2869054-C-G,rs9392434,-1,C,G,2869054,12353,2684799,3078015,184255
6,ENSG00000216802.1,138650973,6-138509735-T-C,rs9402978,-1,T,C,138509735,141238,138454365,138847581,55370
6,ENSG00000216802.1,138650973,6-138509735-T-A,rs9402978,-1,T,A,138509735,141238,138454365,138847581,55370
6,ENSG00000226453.1,82169391,6-82333035-A-C,rs9449458,-1,A,C,82333035,163644,81972783,82365999,360252
6,ENSG00000226453.1,82169391,6-82333035-A-G,rs9449458,-1,A,G,82333035,163644,81972783,82365999,360252
6,ENSG00000226453.1,82169391,6-82333035-A-T,rs9449458,-1,A,T,82333035,163644,81972783,82365999,360252
6,ENSG00000218350.1,71165076,6-71126166-C-A,rs9455340,1,C,A,71126166,38910,70968468,71361684,157698
6,ENSG00000203711.6,158869867,6-158896480-T-G,rs9457509,1,T,G,158896480,26613,158673259,159066475,223221
6,ENSG00000203711.6,158869867,6-158896480-T-C,rs9457509,1,T,C,158896480,26613,158673259,159066475,223221
6,ENSG00000181524.6,42956765,6-42938646-G-T,rs9471969,-1,G,T,42938646,18119,42760157,43153373,178489
6,ENSG00000260273.1,109382795,6-109358652-T-G,rs9487069,1,T,G,109358652,24143,109186187,109579403,172465
6,ENSG00000260273.1,109382795,6-109358652-T-A,rs9487069,1,T,A,109358652,24143,109186187,109579403,172465
6,ENSG00000227502.1,113873351,6-113761551-A-G,rs954620,-1,A,G,113761551,111800,113676743,114069959,84808
6,ENSG00000227502.1,113873351,6-113761551-A-C,rs954620,-1,A,C,113761551,111800,113676743,114069959,84808
6,ENSG00000227502.1,113873351,6-113761551-A-T,rs954620,-1,A,T,113761551,111800,113676743,114069959,84808
6,ENSG00000227627.1,152983719,6-152950717-C-T,rs10484865,1,C,T,152950717,33002,152787111,153180327,163606
6,ENSG00000229349.2,46204729,6-46060449-T-C,rs10948275,1,T,C,46060449,144280,46008121,46401337,52328
6,ENSG00000205653.1,203313,6-382807-G-T,rs111314763,1,G,T,382807,179494,6705,399921,376102
6,ENSG00000205653.1,203313,6-382807-G-C,rs111314763,1,G,C,382807,179494,6705,399921,376102
6,ENSG00000219790.2,56976062,6-56864576-C-T,rs112485753,-1,C,T,56864576,111486,56779454,57172670,85122
6,ENSG00000214558.3,65301476,6-65437570-A-C,rs115522386,1,A,C,65437570,136094,65104868,65498084,332702
6,ENSG00000228624.2,113969701,6-113821717-A-G,rs117075388,1,A,G,113821717,147984,113773093,114166309,48624
6,ENSG00000225580.2,112617880,6-112468530-G-A,rs117257765,-1,G,A,112468530,149350,112421272,112814488,47258
6,ENSG00000220069.1,86087134,6-86263880-A-C,rs11753535,-1,A,C,86263880,176746,85890526,86283742,373354
6,ENSG00000224936.1,30468882,6-30312130-G-A,rs11757879,1,G,A,30312130,156752,30272274,30665490,39856
6,ENSG00000213204.3,87408012,6-87375228-C-G,rs118119352,1,C,G,87375228,32784,87211404,87604620,163824
6,ENSG00000219755.1,99575712,6-99394250-C-T,rs11964807,1,C,T,99394250,181462,99379104,99772320,15146
6,ENSG00000229921.2,167997077,6-167983028-T-C,rs11964963,-1,T,C,167983028,14049,167800469,168193685,182559
6,ENSG00000237786.1,13486294,6-13630146-G-A,rs11965022,1,G,A,13630146,143852,13289686,13682902,340460
6,ENSG00000213177.3,100136064,6-100191060-T-C,rs11967726,1,T,C,100191060,54996,99939456,100332672,251604
6,ENSG00000216809.1,118454992,6-118603934-G-C,rs12208253,-1,G,C,118603934,148942,118258384,118651600,345550
6,ENSG00000216809.1,118454992,6-118603934-G-A,rs12208253,-1,G,A,118603934,148942,118258384,118651600,345550
6,ENSG00000216809.1,118454992,6-118603934-G-T,rs12208253,-1,G,T,118603934,148942,118258384,118651600,345550
6,ENSG00000239626.1,73290403,6-73276934-T-A,rs12216162,1,T,A,73276934,13469,73093795,73487011,183139
6,ENSG00000239626.1,73290403,6-73276934-T-C,rs12216162,1,T,C,73276934,13469,73093795,73487011,183139
6,ENSG00000219986.2,6795402,6-6659981-A-G,rs12529598,-1,A,G,6659981,135421,6598794,6992010,61187
6,ENSG00000219986.2,6795402,6-6659981-A-T,rs12529598,-1,A,T,6659981,135421,6598794,6992010,61187
6,ENSG00000206344.5,31197760,6-31144298-G-A,rs1265080,1,G,A,31144298,53462,31001152,31394368,143146
6,ENSG00000224843.1,26956932,6-27035704-C-T,rs12661756,1,C,T,27035704,78772,26760324,27153540,275380
6,ENSG00000234484.1,132752675,6-132746594-T-G,rs12663711,1,T,G,132746594,6081,132556067,132949283,190527
6,ENSG00000234484.1,132752675,6-132746594-T-C,rs12663711,1,T,C,132746594,6081,132556067,132949283,190527
6,ENSG00000213133.4,126258355,6-126386382-G-A,rs1338839,-1,G,A,126386382,128027,126061747,126454963,324635
6,ENSG00000213133.4,126258355,6-126386382-G-T,rs1338839,-1,G,T,126386382,128027,126061747,126454963,324635
6,ENSG00000226453.1,82169391,6-82059713-A-G,rs1361682,-1,A,G,82059713,109678,81972783,82365999,86930
6,ENSG00000124549.9,26422119,6-26475927-A-G,rs1407045,1,A,G,26475927,53808,26225511,26618727,250416
6,ENSG00000124549.9,26422119,6-26475927-A-C,rs1407045,1,A,C,26475927,53808,26225511,26618727,250416
6,ENSG00000233967.1,80442649,6-80392608-C-A,rs1436878,1,C,A,80392608,50041,80246041,80639257,146567
6,ENSG00000233967.1,80442649,6-80392608-C-T,rs1436878,1,C,T,80392608,50041,80246041,80639257,146567
6,ENSG00000204261.4,32844086,6-32945469-C-T,rs1480380,1,C,T,32945469,101383,32647478,33040694,297991
6,ENSG00000225914.1,32255328,6-32442176-A-G,rs16822614,1,A,G,32442176,186848,32058720,32451936,383456
6,ENSG00000176998.3,29792750,6-29853273-G-A,rs16896119,-1,G,A,29853273,60523,29596142,29989358,257131
6,ENSG00000176998.3,29792750,6-29853273-G-T,rs16896119,-1,G,T,29853273,60523,29596142,29989358,257131
6,ENSG00000230795.2,29926459,6-29954963-A-G,rs16896742,1,A,G,29954963,28504,29729851,30123067,225112
6,ENSG00000228432.1,31366898,6-31369183-G-A,rs17199474,-1,G,A,31369183,2285,31170290,31563506,198893
6,ENSG00000228432.1,31366898,6-31369183-G-C,rs17199474,-1,G,C,31369183,2285,31170290,31563506,198893
6,ENSG00000234515.1,32879833,6-32818291-A-G,rs17429444,-1,A,G,32818291,61542,32683225,33076441,135066
6,ENSG00000255389.1,111599875,6-111597591-C-T,rs174392,1,C,T,111597591,2284,111403267,111796483,194324
6,ENSG00000255389.1,111599875,6-111597591-C-A,rs174392,1,C,A,111597591,2284,111403267,111796483,194324
6,ENSG00000233558.1,116259115,6-116253953-G-T,rs17524614,-1,G,T,116253953,5162,116062507,116455723,191446
6,ENSG00000233558.1,116259115,6-116253953-G-A,rs17524614,-1,G,A,116253953,5162,116062507,116455723,191446
6,ENSG00000238076.1,10460541,6-10390702-C-T,rs17572948,-1,C,T,10390702,69839,10263933,10657149,126769
6,ENSG00000227192.1,143042324,6-143026603-G-T,rs17590726,-1,G,T,143026603,15721,142845716,143238932,180887
6,ENSG00000261071.1,13615190,6-13517225-A-G,rs17680885,-1,A,G,13517225,97965,13418582,13811798,98643
6,ENSG00000219891.2,28092427,6-28140454-C-T,rs1904840,1,C,T,28140454,48027,27895819,28289035,244635
6,ENSG00000239650.2,57930291,6-58013740-C-T,rs1936268,-1,C,T,58013740,83449,57733683,58126899,280057
6,ENSG00000239650.2,57930291,6-58013740-C-A,rs1936268,-1,C,A,58013740,83449,57733683,58126899,280057
6,ENSG00000216331.1,26195554,6-26091108-T-C,rs2071303,1,T,C,26091108,104446,25998946,26392162,92162
6,ENSG00000232876.1,135055033,6-134932465-G-C,rs2072827,1,G,C,134932465,122568,134858425,135251641,74040
6,ENSG00000232876.1,135055033,6-134932465-G-A,rs2072827,1,G,A,134932465,122568,134858425,135251641,74040
6,ENSG00000227198.1,31658329,6-31572980-A-C,rs2229092,1,A,C,31572980,85349,31461721,31854937,111259
6,ENSG00000219470.1,43539703,6-43672362-A-G,rs2277125,-1,A,G,43672362,132659,43343095,43736311,329267
6,ENSG00000219703.1,117431591,6-117575623-A-T,rs2301424,1,A,T,117575623,144032,117234983,117628199,340640
6,ENSG00000219703.1,117431591,6-117575623-A-G,rs2301424,1,A,G,117575623,144032,117234983,117628199,340640
6,ENSG00000217027.1,144200965,6-144104295-A-T,rs2328544,-1,A,T,144104295,96670,144004357,144397573,99938
6,ENSG00000217027.1,144200965,6-144104295-A-G,rs2328544,-1,A,G,144104295,96670,144004357,144397573,99938
6,ENSG00000230943.1,113650090,6-113547856-A-C,rs2348305,-1,A,C,113547856,102234,113453482,113846698,94374
6,ENSG00000181126.8,29792234,6-29975911-G-A,rs2394251,1,G,A,29975911,183677,29595626,29988842,380285
6,ENSG00000181126.8,29792234,6-29975911-G-C,rs2394251,1,G,C,29975911,183677,29595626,29988842,380285
6,ENSG00000181126.8,29792234,6-29975911-G-T,rs2394251,1,G,T,29975911,183677,29595626,29988842,380285
6,ENSG00000225864.1,29723971,6-29727528-T-A,rs2523405,-1,T,A,29727528,3557,29527363,29920579,200165
6,ENSG00000225864.1,29723971,6-29727528-T-G,rs2523405,-1,T,G,29727528,3557,29527363,29920579,200165
6,ENSG00000225092.2,7183083,6-7250727-G-A,rs2714338,1,G,A,7250727,67644,6986475,7379691,264252
6,ENSG00000216775.1,52665274,6-52618617-G-C,rs2749047,1,G,C,52618617,46657,52468666,52861882,149951
6,ENSG00000216775.1,52665274,6-52618617-G-T,rs2749047,1,G,T,52618617,46657,52468666,52861882,149951
6,ENSG00000216775.1,52665274,6-52618617-G-A,rs2749047,1,G,A,52618617,46657,52468666,52861882,149951
6,ENSG00000224796.1,33079451,6-33078305-C-A,rs2856819,1,C,A,33078305,1146,32882843,33276059,195462
6,ENSG00000224796.1,33079451,6-33078305-C-T,rs2856819,1,C,T,33078305,1146,32882843,33276059,195462
6,ENSG00000223534.1,32659880,6-32604474-T-C,rs2858870,1,T,C,32604474,55406,32463272,32856488,141202
6,ENSG00000223534.1,32659880,6-32604474-T-A,rs2858870,1,T,A,32604474,55406,32463272,32856488,141202
6,ENSG00000168405.9,25138081,6-25035692-G-A,rs303890,-1,G,A,25035692,102389,24941473,25334689,94219
6,ENSG00000204622.6,30006606,6-29868057-G-A,rs3094159,1,G,A,29868057,138549,29809998,30203214,58059
6,ENSG00000228022.1,30743790,6-30759162-A-C,rs3095340,1,A,C,30759162,15372,30547182,30940398,211980
6,ENSG00000228022.1,30743790,6-30759162-A-T,rs3095340,1,A,T,30759162,15372,30547182,30940398,211980
6,ENSG00000206341.6,29887752,6-29867174-T-G,rs3132722,1,T,G,29867174,20578,29691144,30084360,176030
6,ENSG00000206341.6,29887752,6-29867174-T-A,rs3132722,1,T,A,29867174,20578,29691144,30084360,176030
6,ENSG00000206341.6,29887752,6-29867174-T-C,rs3132722,1,T,C,29867174,20578,29691144,30084360,176030
6,ENSG00000237685.1,10514546,6-10460081-C-T,rs34375686,-1,C,T,10460081,54465,10317938,10711154,142143
6,ENSG00000235381.1,155256724,6-155182492-G-A,rs3792966,-1,G,A,155182492,74232,155060116,155453332,122376
6,ENSG00000235381.1,155256724,6-155182492-G-C,rs3792966,-1,G,C,155182492,74232,155060116,155453332,122376
6,ENSG00000235381.1,155256724,6-155182492-G-T,rs3792966,-1,G,T,155182492,74232,155060116,155453332,122376
6,ENSG00000233916.1,29708547,6-29677857-C-T,rs387642,-1,C,T,29677857,30690,29511939,29905155,165918
6,ENSG00000233916.1,29708547,6-29677857-C-A,rs387642,-1,C,A,29677857,30690,29511939,29905155,165918
6,ENSG00000235821.1,29751148,6-29839124-C-G,rs407238,-1,C,G,29839124,87976,29554540,29947756,284584
6,ENSG00000235821.1,29751148,6-29839124-C-T,rs407238,-1,C,T,29839124,87976,29554540,29947756,284584
6,ENSG00000216854.2,56871191,6-56735323-G-C,rs41267675,1,G,C,56735323,135868,56674583,57067799,60740
6,ENSG00000216854.2,56871191,6-56735323-G-A,rs41267675,1,G,A,56735323,135868,56674583,57067799,60740
6,ENSG00000216854.2,56871191,6-56735323-G-T,rs41267675,1,G,T,56735323,135868,56674583,57067799,60740
6,ENSG00000220666.2,56433213,6-56511293-C-T,rs41271864,-1,C,T,56511293,78080,56236605,56629821,274688
6,ENSG00000220666.2,56433213,6-56511293-C-G,rs41271864,-1,C,G,56511293,78080,56236605,56629821,274688
6,ENSG00000224557.3,33112516,6-33035785-T-C,rs423196,1,T,C,33035785,76731,32915908,33309124,119877
6,ENSG00000183239.5,44089696,6-44186588-C-A,rs4711777,-1,C,A,44186588,96892,43893088,44286304,293500
6,ENSG00000183239.5,44089696,6-44186588-C-T,rs4711777,-1,C,T,44186588,96892,43893088,44286304,293500
6,ENSG00000220583.1,34263673,6-34165711-C-G,rs4713751,-1,C,G,34165711,97962,34067065,34460281,98646
6,ENSG00000220583.1,34263673,6-34165711-C-T,rs4713751,-1,C,T,34165711,97962,34067065,34460281,98646
6,ENSG00000250535.1,32013270,6-31970330-A-G,rs474534,1,A,G,31970330,42940,31816662,32209878,153668
6,ENSG00000233330.1,149592663,6-149504128-C-A,rs4895792,-1,C,A,149504128,88535,149396055,149789271,108073
6,ENSG00000233330.1,149592663,6-149504128-C-T,rs4895792,-1,C,T,149504128,88535,149396055,149789271,108073
6,ENSG00000233330.1,149592663,6-149504128-C-G,rs4895792,-1,C,G,149504128,88535,149396055,149789271,108073
6,ENSG00000214460.3,85427966,6-85390371-G-A,rs494688,-1,G,A,85390371,37595,85231358,85624574,159013
6,ENSG00000231889.2,111483512,6-111574525-G-A,rs4947124,1,G,A,111574525,91013,111286904,111680120,287621
6,ENSG00000231889.2,111483512,6-111574525-G-C,rs4947124,1,G,C,111574525,91013,111286904,111680120,287621
6,ENSG00000219582.2,24001824,6-23934415-T-A,rs529398,1,T,A,23934415,67409,23805216,24198432,129199
6,ENSG00000219582.2,24001824,6-23934415-T-G,rs529398,1,T,G,23934415,67409,23805216,24198432,129199
6,ENSG00000236591.1,149032573,6-149082127-C-T,rs56167530,-1,C,T,149082127,49554,148835965,149229181,246162
6,ENSG00000203875.4,85678748,6-85675964-C-G,rs61396151,-1,C,G,85675964,2784,85482140,85875356,193824
6,ENSG00000203875.4,85678748,6-85675964-C-A,rs61396151,-1,C,A,85675964,2784,85482140,85875356,193824
6,ENSG00000204528.3,31177899,6-31079885-A-G,rs62398706,-1,A,G,31079885,98014,30981291,31374507,98594
6,ENSG00000219773.1,112356714,6-112513979-T-A,rs62416178,-1,T,A,112513979,157265,112160106,112553322,353873
6,ENSG00000261584.1,26686241,6-26566576-C-T,rs6456733,1,C,T,26566576,119665,26489633,26882849,76943
6,ENSG00000261584.1,26686241,6-26566576-C-A,rs6456733,1,C,A,26566576,119665,26489633,26882849,76943
6,ENSG00000261584.1,26686241,6-26566576-C-G,rs6456733,1,C,G,26566576,119665,26489633,26882849,76943
6,ENSG00000245261.1,43223860,6-43224531-T-G,rs6458328,-1,T,G,43224531,671,43027252,43420468,197279
6,ENSG00000229931.1,16761724,6-16758114-G-C,rs647750,1,G,C,16758114,3610,16565116,16958332,192998
6,ENSG00000217824.1,148567654,6-148402931-A-T,rs6570848,-1,A,T,148402931,164723,148371046,148764262,31885
6,ENSG00000227920.2,37545145,6-37454342-C-T,rs6904652,1,C,T,37454342,90803,37348537,37741753,105805
6,ENSG00000233231.1,166334568,6-166357604-T-G,rs6918091,1,T,G,166357604,23036,166137960,166531176,219644
6,ENSG00000233231.1,166334568,6-166357604-T-A,rs6918091,1,T,A,166357604,23036,166137960,166531176,219644
6,ENSG00000219395.2,151413945,6-151526669-G-C,rs6922890,-1,G,C,151526669,112724,151217337,151610553,309332
6,ENSG00000219395.2,151413945,6-151526669-G-A,rs6922890,-1,G,A,151526669,112724,151217337,151610553,309332
6,ENSG00000219395.2,151413945,6-151526669-G-T,rs6922890,-1,G,T,151526669,112724,151217337,151610553,309332
6,ENSG00000176933.4,28218634,6-28311281-G-A,rs6932394,-1,G,A,28311281,92647,28022026,28415242,289255
6,ENSG00000176933.4,28218634,6-28311281-G-T,rs6932394,-1,G,T,28311281,92647,28022026,28415242,289255
6,ENSG00000219329.1,110923566,6-111069141-A-C,rs6935864,1,A,C,111069141,145575,110726958,111120174,342183
6,ENSG00000204110.4,37507348,6-37488788-A-G,rs6940323,1,A,G,37488788,18560,37310740,37703956,178048
6,ENSG00000231074.2,30327362,6-30345563-G-C,rs6986,-1,G,C,30345563,18201,30130754,30523970,214809
6,ENSG00000230433.1,524171,6-576902-T-C,rs708038,1,T,C,576902,52731,327563,720779,249339
6,ENSG00000216863.4,6622744,6-6531128-G-T,rs708064,-1,G,T,6531128,91616,6426136,6819352,104992
6,ENSG00000216863.4,6622744,6-6531128-G-C,rs708064,-1,G,C,6531128,91616,6426136,6819352,104992
6,ENSG00000216368.2,10118452,6-10191019-C-A,rs72832298,1,C,A,10191019,72567,9921844,10315060,269175
6,ENSG00000216439.1,85427125,6-85410224-C-T,rs72903478,-1,C,T,85410224,16901,85230517,85623733,179707
6,ENSG00000216439.1,85427125,6-85410224-C-A,rs72903478,-1,C,A,85410224,16901,85230517,85623733,179707
6,ENSG00000233138.1,142748443,6-142686344-G-A,rs72984383,1,G,A,142686344,62099,142551835,142945051,134509
6,ENSG00000218073.1,16160926,6-16175979-C-G,rs74451139,1,C,G,16175979,15053,15964318,16357534,211661
6,ENSG00000226309.1,84430802,6-84325170-A-G,rs76435401,-1,A,G,84325170,105632,84234194,84627410,90976
6,ENSG00000232618.1,142946406,6-143128203-A-G,rs77014062,1,A,G,143128203,181797,142749798,143143014,378405
6,ENSG00000219565.2,108787053,6-108658103-C-T,rs77061140,-1,C,T,108658103,128950,108590445,108983661,67658
6,ENSG00000215477.2,87122688,6-87039925-C-G,rs7738920,-1,C,G,87039925,82763,86926080,87319296,113845
6,ENSG00000215477.2,87122688,6-87039925-C-T,rs7738920,-1,C,T,87039925,82763,86926080,87319296,113845
6,ENSG00000215477.2,87122688,6-87039925-C-A,rs7738920,-1,C,A,87039925,82763,86926080,87319296,113845
6,ENSG00000219023.1,35555873,6-35535799-A-G,rs7743152,1,A,G,35535799,20074,35359265,35752481,176534
6,ENSG00000219023.1,35555873,6-35535799-A-C,rs7743152,1,A,C,35535799,20074,35359265,35752481,176534
6,ENSG00000219023.1,35555873,6-35535799-A-T,rs7743152,1,A,T,35535799,20074,35359265,35752481,176534
6,ENSG00000250264.1,32838822,6-32696555-T-C,rs7745040,-1,T,C,32696555,142267,32642214,33035430,54341
6,ENSG00000250264.1,32838822,6-32696555-T-G,rs7745040,-1,T,G,32696555,142267,32642214,33035430,54341
6,ENSG00000217769.4,86897118,6-87074593-G-T,rs7748510,1,G,T,87074593,177475,86700510,87093726,374083
6,ENSG00000225791.1,52577314,6-52508658-A-T,rs7748569,1,A,T,52508658,68656,52380706,52773922,127952
6,ENSG00000229852.2,73263222,6-73306390-C-T,rs7753960,1,C,T,73306390,43168,73066614,73459830,239776
6,ENSG00000231769.1,46129857,6-46129832-G-A,rs7754915,-1,G,A,46129832,25,45933249,46326465,196583
6,ENSG00000231769.1,46129857,6-46129832-G-T,rs7754915,-1,G,T,46129832,25,45933249,46326465,196583
6,ENSG00000231769.1,46129857,6-46129832-G-C,rs7754915,-1,G,C,46129832,25,45933249,46326465,196583
6,ENSG00000228506.1,99424913,6-99376529-A-T,rs7755791,1,A,T,99376529,48384,99228305,99621521,148224
6,ENSG00000232389.1,70609334,6-70778603-G-A,rs7771348,-1,G,A,70778603,169269,70412726,70805942,365877
6,ENSG00000218565.2,139338018,6-139433650-C-G,rs79324176,1,C,G,139433650,95632,139141410,139534626,292240
6,ENSG00000226571.1,139271362,6-139433650-C-G,rs79324176,1,C,G,139433650,162288,139074754,139467970,358896
6,ENSG00000213073.4,160093423,6-160011241-T-C,rs8191744,1,T,C,160011241,82182,159896815,160290031,114426
6,ENSG00000196301.3,32473500,6-32477883-T-C,rs9269149,-1,T,C,32477883,4383,32276892,32670108,200991
6,ENSG00000229391.3,32558186,6-32615965-G-T,rs9271348,-1,G,T,32615965,57779,32361578,32754794,254387
6,ENSG00000229391.3,32558186,6-32615965-G-A,rs9271348,-1,G,A,32615965,57779,32361578,32754794,254387
6,ENSG00000229391.3,32558186,6-32615965-G-C,rs9271348,-1,G,C,32615965,57779,32361578,32754794,254387
6,ENSG00000216915.2,27738494,6-27816650-A-G,rs9295750,-1,A,G,27816650,78156,27541886,27935102,274764
6,ENSG00000216781.2,10366582,6-10303712-T-C,rs9348442,-1,T,C,10303712,62870,10169974,10563190,133738
6,ENSG00000218350.1,71165076,6-71168986-C-T,rs9354973,1,C,T,71168986,3910,70968468,71361684,200518
6,ENSG00000237686.1,44074655,6-44011672-C-G,rs9357428,-1,C,G,44011672,62983,43878047,44271263,133625
6,ENSG00000219806.1,139615204,6-139652777-A-G,rs9376442,-1,A,G,139652777,37573,139418596,139811812,234181
6,ENSG00000216813.1,47562622,6-47464901-C-A,rs9381563,1,C,A,47464901,97721,47366014,47759230,98887
6,ENSG00000216813.1,47562622,6-47464901-C-G,rs9381563,1,C,G,47464901,97721,47366014,47759230,98887
6,ENSG00000216813.1,47562622,6-47464901-C-T,rs9381563,1,C,T,47464901,97721,47366014,47759230,98887
6,ENSG00000216819.1,3179764,6-3162144-C-A,rs9392465,-1,C,A,3162144,17620,2983156,3376372,178988
6,ENSG00000186743.2,116038756,6-115984950-A-T,rs9400883,1,A,T,115984950,53806,115842148,116235364,142802
6,ENSG00000186743.2,116038756,6-115984950-A-G,rs9400883,1,A,G,115984950,53806,115842148,116235364,142802
6,ENSG00000166984.7,167172145,6-167201569-A-G,rs9459913,1,A,G,167201569,29424,166975537,167368753,226032
6,ENSG00000197251.3,33593338,6-33738702-C-A,rs9469578,-1,C,A,33738702,145364,33396730,33789946,341972
6,ENSG00000197251.3,33593338,6-33738702-C-T,rs9469578,-1,C,T,33738702,145364,33396730,33789946,341972
6,ENSG00000217165.1,39110321,6-39198471-A-G,rs9470997,1,A,G,39198471,88150,38913713,39306929,284758
6,ENSG00000219135.1,121680459,6-121578105-A-G,rs9482177,-1,A,G,121578105,102354,121483851,121877067,94254
6,ENSG00000219135.1,121680459,6-121578105-A-T,rs9482177,-1,A,T,121578105,102354,121483851,121877067,94254
6,ENSG00000213131.3,127355756,6-127503930-T-C,rs9482812,1,T,C,127503930,148174,127159148,127552364,344782
6,ENSG00000227678.1,130146179,6-130169458-T-A,rs9492471,-1,T,A,130169458,23279,129949571,130342787,219887
6,ENSG00000227678.1,130146179,6-130169458-T-C,rs9492471,-1,T,C,130169458,23279,129949571,130342787,219887
6,ENSG00000226445.1,169213254,6-169246656-T-G,rs9505897,1,T,G,169246656,33402,169016646,169409862,230010
5,ENSG00000231185.2,142404201,5-142334726-C-T,rs10037503,1,C,T,142334726,69475,142207593,142600809,127133
5,ENSG00000231185.2,142404201,5-142334726-C-A,rs10037503,1,C,A,142334726,69475,142207593,142600809,127133
5,ENSG00000231185.2,142404201,5-142334726-C-G,rs10037503,1,C,G,142334726,69475,142207593,142600809,127133
5,ENSG00000250155.1,36725173,5-36702762-C-A,rs1025288,-1,C,A,36702762,22411,36528565,36921781,174197
5,ENSG00000250155.1,36725173,5-36702762-C-T,rs1025288,-1,C,T,36702762,22411,36528565,36921781,174197
5,ENSG00000253144.1,179083194,5-179044033-A-G,rs10464078,-1,A,G,179044033,39161,178886586,179279802,157447
5,ENSG00000247199.3,148383869,5-148394045-A-G,rs10476893,-1,A,G,148394045,10176,148187261,148580477,206784
5,ENSG00000247199.3,148383869,5-148394045-A-C,rs10476893,-1,A,C,148394045,10176,148187261,148580477,206784
5,ENSG00000253558.1,78044136,5-78023623-T-A,rs10514134,-1,T,A,78023623,20513,77847528,78240744,176095
5,ENSG00000249183.1,69069200,5-68913502-A-G,rs10940184,-1,A,G,68913502,155698,68872592,69265808,40910
5,ENSG00000247796.2,53109860,5-53113429-A-G,rs10940291,1,A,G,53113429,3569,52913252,53306468,200177
5,ENSG00000248677.1,6707711,5-6796657-A-G,rs114597858,-1,A,G,6796657,88946,6511103,6904319,285554
5,ENSG00000251667.1,176308063,5-176429867-G-A,rs115055783,1,G,A,176429867,121804,176111455,176504671,318412
5,ENSG00000241956.5,164296978,5-164362712-C-T,rs116438820,1,C,T,164362712,65734,164100370,164493586,262342
5,ENSG00000244245.1,108593609,5-108498789-G-A,rs11739798,1,G,A,108498789,94820,108397001,108790217,101788
5,ENSG00000244245.1,108593609,5-108498789-G-C,rs11739798,1,G,C,108498789,94820,108397001,108790217,101788
5,ENSG00000244717.1,69469883,5-69362951-G-C,rs11739902,1,G,C,69362951,106932,69273275,69666491,89676
5,ENSG00000261434.1,195778,5-387761-G-T,rs11742957,1,G,T,387761,191983,-830,392386,388591
5,ENSG00000261434.1,195778,5-387761-G-A,rs11742957,1,G,A,387761,191983,-830,392386,388591
5,ENSG00000248873.1,42468868,5-42504329-T-C,rs11748366,-1,T,C,42504329,35461,42272260,42665476,232069
5,ENSG00000224431.1,132199456,5-132232231-G-A,rs11955347,1,G,A,132232231,32775,132002848,132396064,229383
5,ENSG00000249684.1,177951413,5-177973247-C-T,rs11957941,1,C,T,177973247,21834,177754805,178148021,218442
5,ENSG00000249684.1,177951413,5-177973247-C-G,rs11957941,1,C,G,177973247,21834,177754805,178148021,218442
5,ENSG00000249684.1,177951413,5-177973247-C-A,rs11957941,1,C,A,177973247,21834,177754805,178148021,218442
5,ENSG00000239528.1,116562562,5-116475552-G-T,rs12516652,1,G,T,116475552,87010,116365954,116759170,109598
5,ENSG00000214108.4,31908361,5-31751632-C-A,rs12516878,1,C,A,31751632,156729,31711753,32104969,39879
5,ENSG00000214108.4,31908361,5-31751632-C-T,rs12516878,1,C,T,31751632,156729,31711753,32104969,39879
5,ENSG00000249855.1,43496454,5-43515178-A-C,rs12520489,-1,A,C,43515178,18724,43299846,43693062,215332
5,ENSG00000249855.1,43496454,5-43515178-A-G,rs12520489,-1,A,G,43515178,18724,43299846,43693062,215332
5,ENSG00000249738.2,159553002,5-159521986-C-A,rs12659608,1,C,A,159521986,31016,159356394,159749610,165592
5,ENSG00000249738.2,159553002,5-159521986-C-T,rs12659608,1,C,T,159521986,31016,159356394,159749610,165592
5,ENSG00000253512.1,165783134,5-165610512-G-C,rs13155598,-1,G,C,165610512,172622,165586526,165979742,23986
5,ENSG00000253512.1,165783134,5-165610512-G-A,rs13155598,-1,G,A,165610512,172622,165586526,165979742,23986
5,ENSG00000250526.1,14641018,5-14807628-G-A,rs13164197,-1,G,A,14807628,166610,14444410,14837626,363218
5,ENSG00000250526.1,14641018,5-14807628-G-C,rs13164197,-1,G,C,14807628,166610,14444410,14837626,363218
5,ENSG00000253955.1,173579643,5-173676859-G-C,rs13166404,1,G,C,173676859,97216,173383035,173776251,293824
5,ENSG00000253955.1,173579643,5-173676859-G-A,rs13166404,1,G,A,173676859,97216,173383035,173776251,293824
5,ENSG00000235172.3,170307722,5-170203006-C-T,rs13354784,1,C,T,170203006,104716,170111114,170504330,91892
5,ENSG00000175749.11,103032376,5-102841937-G-A,rs1423136,1,G,A,102841937,190439,102835768,103228984,6169
5,ENSG00000175749.11,103032376,5-102841937-G-C,rs1423136,1,G,C,102841937,190439,102835768,103228984,6169
5,ENSG00000251050.1,80019609,5-79993172-A-G,rs1438739,1,A,G,79993172,26437,79823001,80216217,170171
5,ENSG00000251050.1,80019609,5-79993172-A-C,rs1438739,1,A,C,79993172,26437,79823001,80216217,170171
5,ENSG00000251050.1,80019609,5-79993172-A-T,rs1438739,1,A,T,79993172,26437,79823001,80216217,170171
5,ENSG00000227762.3,99532628,5-99721923-C-T,rs1462411,1,C,T,99721923,189295,99336020,99729236,385903
5,ENSG00000227762.3,99532628,5-99721923-C-A,rs1462411,1,C,A,99721923,189295,99336020,99729236,385903
5,ENSG00000233937.2,181246523,5-181247978-T-G,rs1477278,1,T,G,181247978,1455,181049915,181443131,198063
5,ENSG00000250764.1,32121941,5-31940329-A-G,rs1505019,-1,A,G,31940329,181612,31925333,32318549,14996
5,ENSG00000250764.1,32121941,5-31940329-A-T,rs1505019,-1,A,T,31940329,181612,31925333,32318549,14996
5,ENSG00000185641.5,116052289,5-116160418-G-T,rs1508874,-1,G,T,116160418,108129,115855681,116248897,304737
5,ENSG00000185641.5,116052289,5-116160418-G-A,rs1508874,-1,G,A,116160418,108129,115855681,116248897,304737
5,ENSG00000250081.1,65487048,5-65555585-T-A,rs155062,-1,T,A,65555585,68537,65290440,65683656,265145
5,ENSG00000250081.1,65487048,5-65555585-T-C,rs155062,-1,T,C,65555585,68537,65290440,65683656,265145
5,ENSG00000243806.1,94826694,5-94840820-G-C,rs159601,-1,G,C,94840820,14126,94630086,95023302,210734
5,ENSG00000243806.1,94826694,5-94840820-G-A,rs159601,-1,G,A,94840820,14126,94630086,95023302,210734
5,ENSG00000246214.1,16616158,5-16681953-C-T,rs16868979,1,C,T,16681953,65795,16419550,16812766,262403
5,ENSG00000249092.1,42892817,5-42900811-T-G,rs16872900,-1,T,G,42900811,7994,42696209,43089425,204602
5,ENSG00000249092.1,42892817,5-42900811-T-C,rs16872900,-1,T,C,42900811,7994,42696209,43089425,204602
5,ENSG00000250579.1,5140153,5-5045634-C-T,rs16874621,-1,C,T,5045634,94519,4943545,5336761,102089
5,ENSG00000250786.1,9546193,5-9391525-C-A,rs16882610,1,C,A,9391525,154668,9349585,9742801,41940
5,ENSG00000251548.1,10665113,5-10624693-A-C,rs16885029,-1,A,C,10624693,40420,10468505,10861721,156188
5,ENSG00000213956.4,50633124,5-50766085-G-C,rs16885316,1,G,C,50766085,132961,50436516,50829732,329569
5,ENSG00000253683.1,172656713,5-172695123-C-G,rs17075121,-1,C,G,172695123,38410,172460105,172853321,235018
5,ENSG00000253683.1,172656713,5-172695123-C-T,rs17075121,-1,C,T,172695123,38410,172460105,172853321,235018
5,ENSG00000253683.1,172656713,5-172695123-C-A,rs17075121,-1,C,A,172695123,38410,172460105,172853321,235018
5,ENSG00000249476.1,109326369,5-109324827-G-C,rs17161729,-1,G,C,109324827,1542,109129761,109522977,195066
5,ENSG00000244921.2,134924049,5-134930722-C-A,rs17167694,-1,C,A,134930722,6673,134727441,135120657,203281
5,ENSG00000244921.2,134924049,5-134930722-C-T,rs17167694,-1,C,T,134930722,6673,134727441,135120657,203281
5,ENSG00000215246.4,997308,5-870179-G-T,rs17568832,-1,G,T,870179,127129,800700,1193916,69479
5,ENSG00000215246.4,997308,5-870179-G-A,rs17568832,-1,G,A,870179,127129,800700,1193916,69479
5,ENSG00000245937.2,128083100,5-128021834-C-T,rs17764730,-1,C,T,128021834,61266,127886492,128279708,135342
5,ENSG00000248288.1,65209921,5-65211974-C-T,rs17813448,1,C,T,65211974,2053,65013313,65406529,198661
5,ENSG00000253861.1,168553727,5-168712264-G-A,rs1864951,-1,G,A,168712264,158537,168357119,168750335,355145
5,ENSG00000250444.1,115512077,5-115386902-C-T,rs2166339,1,C,T,115386902,125175,115315469,115708685,71433
5,ENSG00000248610.1,130140031,5-130221253-C-T,rs2188958,1,C,T,130221253,81222,129943423,130336639,277830
5,ENSG00000221990.2,443160,5-438449-T-C,rs2241598,-1,T,C,438449,4711,246552,639768,191897
5,ENSG00000225138.2,473236,5-469972-G-A,rs2278251,1,G,A,469972,3264,276628,669844,193344
5,ENSG00000253522.1,160438594,5-160459613-A-G,rs2431099,1,A,G,160459613,21019,160241986,160635202,217627
5,ENSG00000253522.1,160438594,5-160459613-A-T,rs2431099,1,A,T,160459613,21019,160241986,160635202,217627
5,ENSG00000250705.1,88602780,5-88599367-T-C,rs2431392,1,T,C,88599367,3413,88406172,88799388,193195
5,ENSG00000251018.2,163494034,5-163618898-C-T,rs249600,-1,C,T,163618898,124864,163297426,163690642,321472
5,ENSG00000248275.1,181261222,5-181271412-T-C,rs2545086,1,T,C,181271412,10190,181064614,181457830,206798
5,ENSG00000245317.2,179859013,5-179915679-G-A,rs26076,1,G,A,179915679,56666,179662405,180055621,253274
5,ENSG00000248794.1,81242599,5-81069496-G-A,rs26907,-1,G,A,81069496,173103,81045991,81439207,23505
5,ENSG00000248794.1,81242599,5-81069496-G-T,rs26907,-1,G,T,81069496,173103,81045991,81439207,23505
5,ENSG00000233006.1,132369916,5-132315174-A-G,rs270606,-1,A,G,132315174,54742,132173308,132566524,141866
5,ENSG00000247679.2,177611240,5-177603176-T-A,rs28587776,1,T,A,177603176,8064,177414632,177807848,188544
5,ENSG00000247679.2,177611240,5-177603176-T-G,rs28587776,1,T,G,177603176,8064,177414632,177807848,188544
5,ENSG00000247679.2,177611240,5-177603176-T-C,rs28587776,1,T,C,177603176,8064,177414632,177807848,188544
5,ENSG00000250138.3,69631963,5-69530961-G-A,rs28703202,1,G,A,69530961,101002,69435355,69828571,95606
5,ENSG00000248769.1,69653248,5-69530961-G-A,rs28703202,1,G,A,69530961,122287,69456640,69849856,74321
5,ENSG00000249494.1,119070902,5-119060533-C-T,rs299216,-1,C,T,119060533,10369,118874294,119267510,186239
5,ENSG00000215068.3,43041579,5-42902233-G-A,rs309915,1,G,A,42902233,139346,42844971,43238187,57262
5,ENSG00000177738.3,43067452,5-43096972-G-A,rs316411,-1,G,A,43096972,29520,42870844,43264060,226128
5,ENSG00000250182.1,14653329,5-14574010-A-C,rs32636,-1,A,C,14574010,79319,14456721,14849937,117289
5,ENSG00000251675.1,80128361,5-80192752-T-C,rs34102848,1,T,C,80192752,64391,79931753,80324969,260999
5,ENSG00000251675.1,80128361,5-80192752-T-A,rs34102848,1,T,A,80192752,64391,79931753,80324969,260999
5,ENSG00000233974.3,21484011,5-21424634-G-A,rs34123832,-1,G,A,21424634,59377,21287403,21680619,137231
5,ENSG00000183666.11,21459560,5-21424634-G-A,rs34123832,1,G,A,21424634,34926,21262952,21656168,161682
5,ENSG00000245060.2,180830948,5-180874648-G-A,rs34362037,1,G,A,180874648,43700,180634340,181027556,240308
5,ENSG00000245060.2,180830948,5-180874648-G-T,rs34362037,1,G,T,180874648,43700,180634340,181027556,240308
5,ENSG00000213661.3,121616247,5-121697455-C-T,rs34587653,1,C,T,121697455,81208,121419639,121812855,277816
5,ENSG00000248925.1,271516,5-200714-A-G,rs34629844,-1,A,G,200714,70802,74908,468124,125806
5,ENSG00000249026.1,115392370,5-115337612-C-T,rs34639164,-1,C,T,115337612,54758,115195762,115588978,141850
5,ENSG00000253865.1,149372174,5-149377640-C-T,rs353268,1,C,T,149377640,5466,149175566,149568782,202074
5,ENSG00000250194.1,125074665,5-125145397-C-T,rs35967749,1,C,T,125145397,70732,124878057,125271273,267340
5,ENSG00000247828.2,88268883,5-88218187-G-C,rs371708,1,G,C,88218187,50696,88072275,88465491,145912
5,ENSG00000247828.2,88268883,5-88218187-G-T,rs371708,1,G,T,88218187,50696,88072275,88465491,145912
5,ENSG00000249572.1,33440619,5-33440200-C-A,rs3756663,-1,C,A,33440200,419,33244011,33637227,196189
5,ENSG00000247121.2,96935809,5-96991959-A-G,rs38040,-1,A,G,96991959,56150,96739201,97132417,252758
5,ENSG00000247121.2,96935809,5-96991959-A-C,rs38040,-1,A,C,96991959,56150,96739201,97132417,252758
5,ENSG00000247121.2,96935809,5-96991959-A-T,rs38040,-1,A,T,96991959,56150,96739201,97132417,252758
5,ENSG00000254132.1,94569470,5-94631801-A-G,rs385232,-1,A,G,94631801,62331,94372862,94766078,258939
5,ENSG00000254132.1,94569470,5-94631801-A-C,rs385232,-1,A,C,94631801,62331,94372862,94766078,258939
5,ENSG00000250999.1,179658038,5-179667107-A-T,rs4331859,1,A,T,179667107,9069,179461430,179854646,205677
5,ENSG00000250999.1,179658038,5-179667107-A-C,rs4331859,1,A,C,179667107,9069,179461430,179854646,205677
5,ENSG00000249971.1,138349641,5-138283902-A-C,rs4457069,-1,A,C,138283902,65739,138153033,138546249,130869
5,ENSG00000249971.1,138349641,5-138283902-A-T,rs4457069,-1,A,T,138283902,65739,138153033,138546249,130869
5,ENSG00000249971.1,138349641,5-138283902-A-G,rs4457069,-1,A,G,138283902,65739,138153033,138546249,130869
5,ENSG00000248693.1,18746173,5-18919739-G-A,rs4469198,-1,G,A,18919739,173566,18549565,18942781,370174
5,ENSG00000245556.2,78360414,5-78360947-T-C,rs4634329,-1,T,C,78360947,533,78163806,78557022,197141
5,ENSG00000245556.2,78360414,5-78360947-T-G,rs4634329,-1,T,G,78360947,533,78163806,78557022,197141
5,ENSG00000244945.1,179603741,5-179505034-C-T,rs4701179,-1,C,T,179505034,98707,179407133,179800349,97901
5,ENSG00000261360.1,14664604,5-14750691-G-A,rs4702048,-1,G,A,14750691,86087,14467996,14861212,282695
5,ENSG00000213763.4,77784881,5-77638213-C-T,rs4704437,1,C,T,77638213,146668,77588273,77981489,49940
5,ENSG00000213763.4,77784881,5-77638213-C-A,rs4704437,1,C,A,77638213,146668,77588273,77981489,49940
5,ENSG00000170089.8,177875595,5-177833128-C-G,rs4958955,1,C,G,177833128,42467,177678987,178072203,154141
5,ENSG00000170089.8,177875595,5-177833128-C-T,rs4958955,1,C,T,177833128,42467,177678987,178072203,154141
5,ENSG00000249119.1,134924123,5-135054891-A-G,rs4976242,1,A,G,135054891,130768,134727515,135120731,327376
5,ENSG00000249119.1,134924123,5-135054891-A-C,rs4976242,1,A,C,135054891,130768,134727515,135120731,327376
5,ENSG00000185986.9,1593289,5-1499802-T-C,rs55838022,-1,T,C,1499802,93487,1396681,1789897,103121
5,ENSG00000251235.2,76376675,5-76525905-G-T,rs62361970,1,G,T,76525905,149230,76180067,76573283,345838
5,ENSG00000248092.2,43603138,5-43452150-T-C,rs6451695,-1,T,C,43452150,150988,43406530,43799746,45620
5,ENSG00000248092.2,43603138,5-43452150-T-A,rs6451695,-1,T,A,43452150,150988,43406530,43799746,45620
5,ENSG00000259802.1,10353630,5-10377701-C-T,rs6554581,-1,C,T,10377701,24071,10157022,10550238,220679
5,ENSG00000260686.1,122832356,5-123000340-G-A,rs6866400,1,G,A,123000340,167984,122635748,123028964,364592
5,ENSG00000205464.5,82295449,5-82278363-C-T,rs6880209,1,C,T,82278363,17086,82098841,82492057,179522
5,ENSG00000244192.1,130989897,5-130940023-G-T,rs6887982,1,G,T,130940023,49874,130793289,131186505,146734
5,ENSG00000244192.1,130989897,5-130940023-G-A,rs6887982,1,G,A,130940023,49874,130793289,131186505,146734
5,ENSG00000244192.1,130989897,5-130940023-G-C,rs6887982,1,G,C,130940023,49874,130793289,131186505,146734
5,ENSG00000247572.2,81301472,5-81259508-T-C,rs6893467,-1,T,C,81259508,41964,81104864,81498080,154644
5,ENSG00000241458.1,138473744,5-138583716-C-G,rs72805831,1,C,G,138583716,109972,138277136,138670352,306580
5,ENSG00000241458.1,138473744,5-138583716-C-T,rs72805831,1,C,T,138583716,109972,138277136,138670352,306580
5,ENSG00000250461.1,61375112,5-61237688-A-C,rs7446842,1,A,C,61237688,137424,61178504,61571720,59184
5,ENSG00000250461.1,61375112,5-61237688-A-G,rs7446842,1,A,G,61237688,137424,61178504,61571720,59184
5,ENSG00000250461.1,61375112,5-61237688-A-T,rs7446842,1,A,T,61237688,137424,61178504,61571720,59184
5,ENSG00000250602.1,126509021,5-126448667-C-G,rs75108770,-1,C,G,126448667,60354,126312413,126705629,136254
5,ENSG00000215032.2,60893577,5-60973278-G-A,rs75585870,-1,G,A,60973278,79701,60696969,61090185,276309
5,ENSG00000198868.3,134928326,5-134781363-G-A,rs75589259,-1,G,A,134781363,146963,134731718,135124934,49645
5,ENSG00000249825.1,80082404,5-80165604-T-C,rs75946551,-1,T,C,80165604,83200,79885796,80279012,279808
5,ENSG00000260515.1,10197628,5-10056440-T-C,rs75995538,-1,T,C,10056440,141188,10001020,10394236,55420
5,ENSG00000238035.2,181306502,5-181199242-G-A,rs76492548,1,G,A,181199242,107260,181109894,181503110,89348
5,ENSG00000237714.1,132184876,5-132250265-A-G,rs7701414,1,A,G,132250265,65389,131988268,132381484,261997
5,ENSG00000225230.1,56910714,5-56748808-T-C,rs7708148,-1,T,C,56748808,161906,56714106,57107322,34702
5,ENSG00000250274.1,170312806,5-170182711-G-A,rs77087878,-1,G,A,170182711,130095,170116198,170509414,66513
5,ENSG00000253886.1,154493576,5-154437208-C-A,rs7708861,1,C,A,154437208,56368,154296968,154690184,140240
5,ENSG00000220157.4,80360040,5-80370212-G-T,rs7715187,-1,G,T,80370212,10172,80163432,80556648,206780
5,ENSG00000220157.4,80360040,5-80370212-G-A,rs7715187,-1,G,A,80370212,10172,80163432,80556648,206780
5,ENSG00000253744.1,66144795,5-66303212-C-A,rs7717523,-1,C,A,66303212,158417,65948187,66341403,355025
5,ENSG00000253744.1,66144795,5-66303212-C-G,rs7717523,-1,C,G,66303212,158417,65948187,66341403,355025
5,ENSG00000253744.1,66144795,5-66303212-C-T,rs7717523,-1,C,T,66303212,158417,65948187,66341403,355025
5,ENSG00000250222.1,181191856,5-181226039-G-A,rs7727787,1,G,A,181226039,34183,180995248,181388464,230791
5,ENSG00000250222.1,181191856,5-181226039-G-C,rs7727787,1,G,C,181226039,34183,180995248,181388464,230791
5,ENSG00000188002.6,1633984,5-1593981-A-G,rs7734561,-1,A,G,1593981,40003,1437376,1830592,156605
5,ENSG00000217416.3,62777263,5-62720588-G-T,rs78702228,-1,G,T,62720588,56675,62580655,62973871,139933
5,ENSG00000217416.3,62777263,5-62720588-G-A,rs78702228,-1,G,A,62720588,56675,62580655,62973871,139933
5,ENSG00000254211.1,173807791,5-173801323-C-A,rs791378,-1,C,A,173801323,6468,173611183,174004399,190140
5,ENSG00000254211.1,173807791,5-173801323-C-G,rs791378,-1,C,G,173801323,6468,173611183,174004399,190140
5,ENSG00000254211.1,173807791,5-173801323-C-T,rs791378,-1,C,T,173801323,6468,173611183,174004399,190140
5,ENSG00000247763.2,43233173,5-43207768-A-G,rs79477621,-1,A,G,43207768,25405,43036565,43429781,171203
5,ENSG00000224032.2,112160526,5-112167145-G-A,rs79850882,1,G,A,112167145,6619,111963918,112357134,203227
5,ENSG00000224032.2,112160526,5-112167145-G-T,rs79850882,1,G,T,112167145,6619,111963918,112357134,203227
5,ENSG00000232615.3,1614836,5-1660496-G-C,rs904732,1,G,C,1660496,45660,1418228,1811444,242268
5,ENSG00000232615.3,1614836,5-1660496-G-A,rs904732,1,G,A,1660496,45660,1418228,1811444,242268
5,ENSG00000253520.1,179527513,5-179535917-G-T,rs9885443,-1,G,T,179535917,8404,179330905,179724121,205012
5,ENSG00000253520.1,179527513,5-179535917-G-A,rs9885443,-1,G,A,179535917,8404,179330905,179724121,205012
5,ENSG00000248734.1,96784777,5-96797092-G-T,rs998509,1,G,T,96797092,12315,96588169,96981385,208923
5,ENSG00000248734.1,96784777,5-96797092-G-A,rs998509,1,G,A,96797092,12315,96588169,96981385,208923
5,ENSG00000244945.1,179603741,5-179668757-G-C,rs10040357,-1,G,C,179668757,65016,179407133,179800349,261624
5,ENSG00000244945.1,179603741,5-179668757-G-T,rs10040357,-1,G,T,179668757,65016,179407133,179800349,261624
5,ENSG00000244945.1,179603741,5-179668757-G-A,rs10040357,-1,G,A,179668757,65016,179407133,179800349,261624
5,ENSG00000249494.1,119070902,5-119219547-T-C,rs10052879,-1,T,C,119219547,148645,118874294,119267510,345253
5,ENSG00000250391.1,99949583,5-99886081-G-C,rs10053201,-1,G,C,99886081,63502,99752975,100146191,133106
5,ENSG00000250853.1,55530701,5-55402356-A-G,rs10062279,-1,A,G,55402356,128345,55334093,55727309,68263
5,ENSG00000244245.1,108593609,5-108522150-C-A,rs10069821,1,C,A,108522150,71459,108397001,108790217,125149
5,ENSG00000244245.1,108593609,5-108522150-C-T,rs10069821,1,C,T,108522150,71459,108397001,108790217,125149
5,ENSG00000244245.1,108593609,5-108522150-C-G,rs10069821,1,C,G,108522150,71459,108397001,108790217,125149
5,ENSG00000246214.1,16616158,5-16782540-T-C,rs10073730,1,T,C,16782540,166382,16419550,16812766,362990
5,ENSG00000251675.1,80128361,5-80201596-C-A,rs10075871,1,C,A,80201596,73235,79931753,80324969,269843
5,ENSG00000251675.1,80128361,5-80201596-C-T,rs10075871,1,C,T,80201596,73235,79931753,80324969,269843
5,ENSG00000251675.1,80128361,5-80201596-C-G,rs10075871,1,C,G,80201596,73235,79931753,80324969,269843
5,ENSG00000204758.3,172959377,5-172796042-G-T,rs1010482,-1,G,T,172796042,163335,172762769,173155985,33273
5,ENSG00000213433.5,151766239,5-151632696-C-T,rs1036196,-1,C,T,151632696,133543,151569631,151962847,63065
5,ENSG00000213433.5,151766239,5-151632696-C-A,rs1036196,-1,C,A,151632696,133543,151569631,151962847,63065
5,ENSG00000249042.1,80487939,5-80307889-T-G,rs10805934,-1,T,G,80307889,180050,80291331,80684547,16558
5,ENSG00000249042.1,80487939,5-80307889-T-A,rs10805934,-1,T,A,80307889,180050,80291331,80684547,16558
5,ENSG00000249042.1,80487939,5-80307889-T-C,rs10805934,-1,T,C,80307889,180050,80291331,80684547,16558
5,ENSG00000170089.8,177875595,5-177956781-A-G,rs11249784,1,A,G,177956781,81186,177678987,178072203,277794
5,ENSG00000260774.1,217279,5-215922-G-A,rs114938988,-1,G,A,215922,1357,20671,413887,195251
5,ENSG00000245060.2,180830948,5-180835407-C-T,rs11541202,1,C,T,180835407,4459,180634340,181027556,201067
5,ENSG00000251279.1,61162070,5-61015093-C-T,rs116202687,1,C,T,61015093,146977,60965462,61358678,49631
5,ENSG00000247572.2,81301472,5-81284244-T-C,rs11745275,-1,T,C,81284244,17228,81104864,81498080,179380
5,ENSG00000247572.2,81301472,5-81284244-T-G,rs11745275,-1,T,G,81284244,17228,81104864,81498080,179380
5,ENSG00000245556.2,78360414,5-78514166-T-C,rs11749358,-1,T,C,78514166,153752,78163806,78557022,350360
5,ENSG00000251118.1,115770586,5-115785542-G-C,rs12516736,1,G,C,115785542,14956,115573978,115967194,211564
5,ENSG00000230551.3,149504670,5-149385351-A-G,rs13160429,-1,A,G,149385351,119319,149308062,149701278,77289
5,ENSG00000230551.3,149504670,5-149385351-A-C,rs13160429,-1,A,C,149385351,119319,149308062,149701278,77289
5,ENSG00000241668.2,31053565,5-31123366-T-C,rs13170907,1,T,C,31123366,69801,30856957,31250173,266409
5,ENSG00000249825.1,80082404,5-80069262-A-G,rs1465853,-1,A,G,80069262,13142,79885796,80279012,183466
5,ENSG00000245526.2,88684808,5-88667943-A-G,rs1501672,-1,A,G,88667943,16865,88488200,88881416,179743
5,ENSG00000251131.1,43018429,5-43065587-C-T,rs16873074,1,C,T,43065587,47158,42821821,43215037,243766
5,ENSG00000248794.1,81242599,5-81300403-A-G,rs16878586,-1,A,G,81300403,57804,81045991,81439207,254412
5,ENSG00000226221.1,56505072,5-56470178-T-C,rs16885511,-1,T,C,56470178,34894,56308464,56701680,161714
5,ENSG00000226221.1,56505072,5-56470178-T-A,rs16885511,-1,T,A,56470178,34894,56308464,56701680,161714
5,ENSG00000250332.1,23305143,5-23289064-C-A,rs16892365,-1,C,A,23289064,16079,23108535,23501751,180529
5,ENSG00000250332.1,23305143,5-23289064-C-T,rs16892365,-1,C,T,23289064,16079,23108535,23501751,180529
5,ENSG00000214278.4,404546,5-305480-T-C,rs16900804,-1,T,C,305480,99066,207938,601154,97542
5,ENSG00000251018.2,163494034,5-163595469-G-A,rs17062012,-1,G,A,163595469,101435,163297426,163690642,298043
5,ENSG00000250909.1,176347941,5-176322756-T-A,rs17078090,1,T,A,176322756,25185,176151333,176544549,171423
5,ENSG00000250909.1,176347941,5-176322756-T-C,rs17078090,1,T,C,176322756,25185,176151333,176544549,171423
5,ENSG00000251553.1,98679402,5-98749511-C-T,rs17166344,1,C,T,98749511,70109,98482794,98876010,266717
5,ENSG00000248569.1,80351956,5-80291732-C-T,rs17260885,-1,C,T,80291732,60224,80155348,80548564,136384
5,ENSG00000248569.1,80351956,5-80291732-C-G,rs17260885,-1,C,G,80291732,60224,80155348,80548564,136384
5,ENSG00000241956.5,164296978,5-164344035-G-A,rs17287615,1,G,A,164344035,47057,164100370,164493586,243665
5,ENSG00000241956.5,164296978,5-164344035-G-C,rs17287615,1,G,C,164344035,47057,164100370,164493586,243665
5,ENSG00000250526.1,14641018,5-14780189-C-T,rs17317655,-1,C,T,14780189,139171,14444410,14837626,335779
5,ENSG00000249959.1,107716841,5-107887896-A-G,rs17436077,-1,A,G,107887896,171055,107520233,107913449,367663
5,ENSG00000238160.1,132426714,5-132485305-G-A,rs17622656,-1,G,A,132485305,58591,132230106,132623322,255199
5,ENSG00000238160.1,132426714,5-132485305-G-T,rs17622656,-1,G,T,132485305,58591,132230106,132623322,255199
5,ENSG00000254298.1,151158462,5-151257572-A-G,rs17659728,-1,A,G,151257572,99110,150961854,151355070,295718
5,ENSG00000248610.1,130140031,5-130315853-G-A,rs17713401,1,G,A,130315853,175822,129943423,130336639,372430
5,ENSG00000253439.1,173086210,5-172978894-T-A,rs17718169,-1,T,A,172978894,107316,172889602,173282818,89292
5,ENSG00000253439.1,173086210,5-172978894-T-C,rs17718169,-1,T,C,172978894,107316,172889602,173282818,89292
5,ENSG00000212643.1,112891610,5-112715364-T-C,rs1822163,1,T,C,112715364,176246,112695002,113088218,20362
5,ENSG00000188002.6,1633984,5-1624236-C-T,rs1968011,-1,C,T,1624236,9748,1437376,1830592,186860
5,ENSG00000188002.6,1633984,5-1624236-C-A,rs1968011,-1,C,A,1624236,9748,1437376,1830592,186860
5,ENSG00000254211.1,173807791,5-173793062-A-G,rs2042245,-1,A,G,173793062,14729,173611183,174004399,181879
5,ENSG00000254211.1,173807791,5-173793062-A-C,rs2042245,-1,A,C,173793062,14729,173611183,174004399,181879
5,ENSG00000214485.5,150094302,5-150229830-G-C,rs2053053,1,G,C,150229830,135528,149897694,150290910,332136
5,ENSG00000214485.5,150094302,5-150229830-G-A,rs2053053,1,G,A,150229830,135528,149897694,150290910,332136
5,ENSG00000188242.3,472876,5-480394-A-T,rs2241597,-1,A,T,480394,7518,276268,669484,204126
5,ENSG00000188242.3,472876,5-480394-A-G,rs2241597,-1,A,G,480394,7518,276268,669484,204126
5,ENSG00000225138.2,473236,5-476904-T-C,rs2244223,1,T,C,476904,3668,276628,669844,200276
5,ENSG00000185986.9,1593289,5-1489591-A-G,rs2277003,-1,A,G,1489591,103698,1396681,1789897,92910
5,ENSG00000248275.1,181261222,5-181239276-A-T,rs2287716,1,A,T,181239276,21946,181064614,181457830,174662
5,ENSG00000248275.1,181261222,5-181239276-A-G,rs2287716,1,A,G,181239276,21946,181064614,181457830,174662
5,ENSG00000250848.1,290321,5-432941-G-T,rs2303738,-1,G,T,432941,142620,93713,486929,339228
5,ENSG00000251050.1,80019609,5-80096370-G-T,rs2438632,1,G,T,80096370,76761,79823001,80216217,273369
5,ENSG00000224431.1,132199456,5-132173578-A-G,rs246351,1,A,G,132173578,25878,132002848,132396064,170730
5,ENSG00000233937.2,181246523,5-181192438-G-A,rs254463,1,G,A,181192438,54085,181049915,181443131,142523
5,ENSG00000251467.1,72996920,5-72961353-G-T,rs2548331,1,G,T,72961353,35567,72800312,73193528,161041
5,ENSG00000253744.1,66144795,5-66328731-G-A,rs2561078,-1,G,A,66328731,183936,65948187,66341403,380544
5,ENSG00000249101.1,98025965,5-97997738-A-C,rs257239,1,A,C,97997738,28227,97829357,98222573,168381
5,ENSG00000221990.2,443160,5-356266-C-T,rs2672737,-1,C,T,356266,86894,246552,639768,109714
5,ENSG00000221990.2,443160,5-356266-C-G,rs2672737,-1,C,G,356266,86894,246552,639768,109714
5,ENSG00000248734.1,96784777,5-96778846-G-A,rs27039,1,G,A,96778846,5931,96588169,96981385,190677
5,ENSG00000233006.1,132369916,5-132474927-C-G,rs2706381,-1,C,G,132474927,105011,132173308,132566524,301619
5,ENSG00000233006.1,132369916,5-132474927-C-T,rs2706381,-1,C,T,132474927,105011,132173308,132566524,301619
5,ENSG00000249572.1,33440619,5-33401364-G-A,rs272735,-1,G,A,33401364,39255,33244011,33637227,157353
5,ENSG00000249572.1,33440619,5-33401364-G-T,rs272735,-1,G,T,33401364,39255,33244011,33637227,157353
5,ENSG00000250222.1,181191856,5-181187961-G-T,rs2770991,1,G,T,181187961,3895,180995248,181388464,192713
5,ENSG00000250222.1,181191856,5-181187961-G-A,rs2770991,1,G,A,181187961,3895,180995248,181388464,192713
5,ENSG00000247679.2,177611240,5-177605049-C-T,rs28473516,1,C,T,177605049,6191,177414632,177807848,190417
5,ENSG00000247679.2,177611240,5-177605049-C-G,rs28473516,1,C,G,177605049,6191,177414632,177807848,190417
5,ENSG00000253203.2,69679193,5-69530961-G-A,rs28703202,-1,G,A,69530961,148232,69482585,69875801,48376
5,ENSG00000213701.4,97057358,5-96867636-T-C,rs2911133,-1,T,C,96867636,189722,96860750,97253966,6886
5,ENSG00000249476.1,109326369,5-109432321-T-C,rs2963016,-1,T,C,109432321,105952,109129761,109522977,302560
5,ENSG00000249476.1,109326369,5-109432321-T-G,rs2963016,-1,T,G,109432321,105952,109129761,109522977,302560
5,ENSG00000261434.1,195778,5-190524-C-A,rs29681,1,C,A,190524,5254,-830,392386,191354
5,ENSG00000261434.1,195778,5-190524-C-T,rs29681,1,C,T,190524,5254,-830,392386,191354
5,ENSG00000261434.1,195778,5-190524-C-G,rs29681,1,C,G,190524,5254,-830,392386,191354
5,ENSG00000251405.2,157365501,5-157198268-T-A,rs31223,-1,T,A,157198268,167233,157168893,157562109,29375
5,ENSG00000251405.2,157365501,5-157198268-T-C,rs31223,-1,T,C,157198268,167233,157168893,157562109,29375
5,ENSG00000237714.1,132184876,5-132069334-T-C,rs31474,1,T,C,132069334,115542,131988268,132381484,81066
5,ENSG00000237714.1,132184876,5-132069334-T-G,rs31474,1,T,G,132069334,115542,131988268,132381484,81066
5,ENSG00000247796.2,53109860,5-53071316-C-T,rs3212578,1,C,T,53071316,38544,52913252,53306468,158064
5,ENSG00000247796.2,53109860,5-53071316-C-A,rs3212578,1,C,A,53071316,38544,52913252,53306468,158064
5,ENSG00000245317.2,179859013,5-179893720-C-G,rs32437,1,C,G,179893720,34707,179662405,180055621,231315
5,ENSG00000245317.2,179859013,5-179893720-C-T,rs32437,1,C,T,179893720,34707,179662405,180055621,231315
5,ENSG00000250182.1,14653329,5-14572603-T-C,rs32635,-1,T,C,14572603,80726,14456721,14849937,115882
5,ENSG00000245937.2,128083100,5-128011321-A-G,rs34145453,-1,A,G,128011321,71779,127886492,128279708,124829
5,ENSG00000245937.2,128083100,5-128011321-A-T,rs34145453,-1,A,T,128011321,71779,127886492,128279708,124829
5,ENSG00000248909.1,78644845,5-78654714-T-A,rs341918,-1,T,A,78654714,9869,78448237,78841453,206477
5,ENSG00000250274.1,170312806,5-170309088-C-G,rs35444063,-1,C,G,170309088,3718,170116198,170509414,192890
5,ENSG00000247828.2,88268883,5-88193453-G-C,rs357507,1,G,C,88193453,75430,88072275,88465491,121178
5,ENSG00000247828.2,88268883,5-88193453-G-A,rs357507,1,G,A,88193453,75430,88072275,88465491,121178
5,ENSG00000227908.3,55995167,5-55969461-A-G,rs3729959,1,A,G,55969461,25706,55798559,56191775,170902
5,ENSG00000246334.2,177447699,5-177509818-C-G,rs3749728,-1,C,G,177509818,62119,177251091,177644307,258727
5,ENSG00000246334.2,177447699,5-177509818-C-T,rs3749728,-1,C,T,177509818,62119,177251091,177644307,258727
5,ENSG00000248400.1,82968888,5-83000863-A-T,rs37547,1,A,T,83000863,31975,82772280,83165496,228583
5,ENSG00000248400.1,82968888,5-83000863-A-C,rs37547,1,A,C,83000863,31975,82772280,83165496,228583
5,ENSG00000248400.1,82968888,5-83000863-A-G,rs37547,1,A,G,83000863,31975,82772280,83165496,228583
5,ENSG00000249485.1,14798400,5-14603996-A-G,rs42411,-1,A,G,14603996,194404,14601792,14995008,2204
5,ENSG00000249485.1,14798400,5-14603996-A-T,rs42411,-1,A,T,14603996,194404,14601792,14995008,2204
5,ENSG00000253520.1,179527513,5-179558269-G-A,rs4701132,-1,G,A,179558269,30756,179330905,179724121,227364
5,ENSG00000253520.1,179527513,5-179558269-G-C,rs4701132,-1,G,C,179558269,30756,179330905,179724121,227364
5,ENSG00000253558.1,78044136,5-77955746-C-T,rs4704472,-1,C,T,77955746,88390,77847528,78240744,108218
5,ENSG00000214108.4,31908361,5-31750844-G-C,rs495578,1,G,C,31750844,157517,31711753,32104969,39091
5,ENSG00000214108.4,31908361,5-31750844-G-A,rs495578,1,G,A,31750844,157517,31711753,32104969,39091
5,ENSG00000260515.1,10197628,5-10318343-G-A,rs606490,-1,G,A,10318343,120715,10001020,10394236,317323
5,ENSG00000184188.6,80302847,5-80196479-T-C,rs61341838,-1,T,C,80196479,106368,80106239,80499455,90240
5,ENSG00000249921.1,108784098,5-108615263-A-C,rs62361271,1,A,C,108615263,168835,108587490,108980706,27773
5,ENSG00000249921.1,108784098,5-108615263-A-G,rs62361271,1,A,G,108615263,168835,108587490,108980706,27773
5,ENSG00000248854.1,55840025,5-55750079-A-G,rs62361885,-1,A,G,55750079,89946,55643417,56036633,106662
5,ENSG00000231185.2,142404201,5-142338411-G-A,rs6580243,1,G,A,142338411,65790,142207593,142600809,130818
5,ENSG00000250492.1,39721513,5-39848787-C-T,rs674635,-1,C,T,39848787,127274,39524905,39918121,323882
5,ENSG00000248445.1,116449624,5-116292420-C-A,rs6866938,1,C,A,116292420,157204,116253016,116646232,39404
5,ENSG00000248445.1,116449624,5-116292420-C-G,rs6866938,1,C,G,116292420,157204,116253016,116646232,39404
5,ENSG00000248445.1,116449624,5-116292420-C-T,rs6866938,1,C,T,116292420,157204,116253016,116646232,39404
5,ENSG00000244192.1,130989897,5-131078288-A-G,rs6867265,1,A,G,131078288,88391,130793289,131186505,284999
5,ENSG00000240388.2,91354478,5-91203080-G-A,rs6878501,1,G,A,91203080,151398,91157870,91551086,45210
5,ENSG00000241907.1,150021921,5-149871976-C-T,rs6886532,-1,C,T,149871976,149945,149825313,150218529,46663
5,ENSG00000205464.5,82295449,5-82226286-C-T,rs6895884,1,C,T,82226286,69163,82098841,82492057,127445
5,ENSG00000242858.1,83746989,5-83867735-C-T,rs6897010,-1,C,T,83867735,120746,83550381,83943597,317354
5,ENSG00000242858.1,83746989,5-83867735-C-A,rs6897010,-1,C,A,83867735,120746,83550381,83943597,317354
5,ENSG00000177738.3,43067452,5-43161249-G-A,rs71627581,-1,G,A,43161249,93797,42870844,43264060,290405
5,ENSG00000224186.3,135033280,5-134992878-C-T,rs74291911,1,C,T,134992878,40402,134836672,135229888,156206
5,ENSG00000118990.5,161751768,5-161912125-T-C,rs76098157,-1,T,C,161912125,160357,161555160,161948376,356965
5,ENSG00000236882.3,95838245,5-95718417-C-T,rs76576394,1,C,T,95718417,119828,95641637,96034853,76780
5,ENSG00000236882.3,95838245,5-95718417-C-G,rs76576394,1,C,G,95718417,119828,95641637,96034853,76780
5,ENSG00000236882.3,95838245,5-95718417-C-A,rs76576394,1,C,A,95718417,119828,95641637,96034853,76780
5,ENSG00000242814.2,124809233,5-124747743-G-A,rs76729647,-1,G,A,124747743,61490,124612625,125005841,135118
5,ENSG00000247049.2,181230685,5-181131279-C-T,rs7719816,-1,C,T,181131279,99406,181034077,181427293,97202
5,ENSG00000260686.1,122832356,5-122690046-G-A,rs7720595,1,G,A,122690046,142310,122635748,123028964,54298
5,ENSG00000250441.1,108894628,5-108868462-A-G,rs7725263,-1,A,G,108868462,26166,108698020,109091236,170442
5,ENSG00000229738.1,132988110,5-133154239-T-C,rs7727572,-1,T,C,133154239,166129,132791502,133184718,362737
5,ENSG00000248873.1,42468868,5-42631573-C-T,rs7732333,-1,C,T,42631573,162705,42272260,42665476,359313
5,ENSG00000238035.2,181306502,5-181212322-C-T,rs77507057,1,C,T,181212322,94180,181109894,181503110,102428
5,ENSG00000238035.2,181306502,5-181212322-C-A,rs77507057,1,C,A,181212322,94180,181109894,181503110,102428
5,ENSG00000235253.1,132942932,5-132897875-T-C,rs77554816,1,T,C,132897875,45057,132746324,133139540,151551
5,ENSG00000246859.2,111512226,5-111323014-C-G,rs79904063,1,C,G,111323014,189212,111315618,111708834,7396
5,ENSG00000245812.2,159100483,5-159003516-A-G,rs883540,1,A,G,159003516,96967,158903875,159297091,99641
5,ENSG00000253653.1,157266625,5-157382086-G-A,rs884623,-1,G,A,157382086,115461,157070017,157463233,312069
5,ENSG00000250155.1,36725173,5-36703551-G-A,rs918642,-1,G,A,36703551,21622,36528565,36921781,174986
5,ENSG00000247516.2,8457706,5-8459420-G-T,rs9313239,1,G,T,8459420,1714,8261098,8654314,198322
5,ENSG00000250539.1,123402344,5-123406908-T-A,rs9327295,-1,T,A,123406908,4564,123205736,123598952,201172
5,ENSG00000250539.1,123402344,5-123406908-T-G,rs9327295,-1,T,G,123406908,4564,123205736,123598952,201172
5,ENSG00000249971.1,138349641,5-138238036-G-A,rs10040989,-1,G,A,138238036,111605,138153033,138546249,85003
5,ENSG00000251303.1,60630514,5-60533638-C-T,rs10056275,1,C,T,60533638,96876,60433906,60827122,99732
5,ENSG00000188242.3,472876,5-422637-T-A,rs10072668,-1,T,A,422637,50239,276268,669484,146369
5,ENSG00000188242.3,472876,5-422637-T-C,rs10072668,-1,T,C,422637,50239,276268,669484,146369
5,ENSG00000260686.1,122832356,5-123015798-G-A,rs10080107,1,G,A,123015798,183442,122635748,123028964,380050
5,ENSG00000260686.1,122832356,5-123015798-G-T,rs10080107,1,G,T,123015798,183442,122635748,123028964,380050
5,ENSG00000249215.1,139494256,5-139430153-C-G,rs10463976,1,C,G,139430153,64103,139297648,139690864,132505
5,ENSG00000249444.1,99499070,5-99476914-T-C,rs112031798,1,T,C,99476914,22156,99302462,99695678,174452
5,ENSG00000249921.1,108784098,5-108639673-A-T,rs11240979,1,A,T,108639673,144425,108587490,108980706,52183
5,ENSG00000249921.1,108784098,5-108639673-A-C,rs11240979,1,A,C,108639673,144425,108587490,108980706,52183
5,ENSG00000249921.1,108784098,5-108639673-A-G,rs11240979,1,A,G,108639673,144425,108587490,108980706,52183
5,ENSG00000254298.1,151158462,5-151349717-A-G,rs11737981,-1,A,G,151349717,191255,150961854,151355070,387863
5,ENSG00000221990.2,443160,5-443561-G-C,rs11739543,-1,G,C,443561,401,246552,639768,197009
5,ENSG00000221990.2,443160,5-443561-G-A,rs11739543,-1,G,A,443561,401,246552,639768,197009
5,ENSG00000188002.6,1633984,5-1556230-T-C,rs11742758,-1,T,C,1556230,77754,1437376,1830592,118854
5,ENSG00000188002.6,1633984,5-1556230-T-G,rs11742758,-1,T,G,1556230,77754,1437376,1830592,118854
5,ENSG00000250602.1,126509021,5-126443488-A-C,rs11744511,-1,A,C,126443488,65533,126312413,126705629,131075
5,ENSG00000226040.2,141896689,5-141815812-A-T,rs11750870,-1,A,T,141815812,80877,141700081,142093297,115731
5,ENSG00000226040.2,141896689,5-141815812-A-G,rs11750870,-1,A,G,141815812,80877,141700081,142093297,115731
5,ENSG00000246214.1,16616158,5-16752877-T-G,rs11958235,1,T,G,16752877,136719,16419550,16812766,333327
5,ENSG00000253865.1,149372174,5-149460227-G-A,rs12518020,1,G,A,149460227,88053,149175566,149568782,284661
5,ENSG00000212643.1,112891610,5-112708673-T-G,rs13169017,1,T,G,112708673,182937,112695002,113088218,13671
5,ENSG00000212643.1,112891610,5-112708673-T-C,rs13169017,1,T,C,112708673,182937,112695002,113088218,13671
5,ENSG00000247877.2,100535234,5-100635457-T-G,rs13182963,-1,T,G,100635457,100223,100338626,100731842,296831
5,ENSG00000247877.2,100535234,5-100635457-T-C,rs13182963,-1,T,C,100635457,100223,100338626,100731842,296831
5,ENSG00000217791.4,53859166,5-53944899-A-C,rs13187145,1,A,C,53944899,85733,53662558,54055774,282341
5,ENSG00000250786.1,9546193,5-9379259-T-C,rs13189036,1,T,C,9379259,166934,9349585,9742801,29674
5,ENSG00000249738.2,159553002,5-159395138-A-C,rs1363669,1,A,C,159395138,157864,159356394,159749610,38744
5,ENSG00000249572.1,33440619,5-33421692-G-A,rs1438729,-1,G,A,33421692,18927,33244011,33637227,177681
5,ENSG00000254252.1,166029311,5-165890692-G-T,rs153261,-1,G,T,165890692,138619,165832703,166225919,57989
5,ENSG00000254252.1,166029311,5-165890692-G-C,rs153261,-1,G,C,165890692,138619,165832703,166225919,57989
5,ENSG00000229119.3,166382305,5-166320200-A-C,rs1540718,1,A,C,166320200,62105,166185697,166578913,134503
5,ENSG00000229119.3,166382305,5-166320200-A-G,rs1540718,1,A,G,166320200,62105,166185697,166578913,134503
5,ENSG00000250155.1,36725173,5-36884988-G-T,rs158793,-1,G,T,36884988,159815,36528565,36921781,356423
5,ENSG00000250155.1,36725173,5-36884988-G-A,rs158793,-1,G,A,36884988,159815,36528565,36921781,356423
5,ENSG00000250155.1,36725173,5-36884988-G-C,rs158793,-1,G,C,36884988,159815,36528565,36921781,356423
5,ENSG00000248781.1,56276630,5-56361048-T-C,rs1645483,-1,T,C,56361048,84418,56080022,56473238,281026
5,ENSG00000250346.1,147922179,5-147823470-G-A,rs17107298,1,G,A,147823470,98709,147725571,148118787,97899
5,ENSG00000245526.2,88684808,5-88563765-G-A,rs17422122,-1,G,A,88563765,121043,88488200,88881416,75565
5,ENSG00000213755.3,79510434,5-79562955-T-C,rs17834549,1,T,C,79562955,52521,79313826,79707042,249129
5,ENSG00000241907.1,150021921,5-149947927-T-C,rs2003625,-1,T,C,149947927,73994,149825313,150218529,122614
5,ENSG00000241907.1,150021921,5-149947927-T-A,rs2003625,-1,T,A,149947927,73994,149825313,150218529,122614
5,ENSG00000253144.1,179083194,5-179030433-G-A,rs2132671,-1,G,A,179030433,52761,178886586,179279802,143847
5,ENSG00000223361.5,17354424,5-17236763-T-C,rs2173967,-1,T,C,17236763,117661,17157816,17551032,78947
5,ENSG00000253653.1,157266625,5-157271115-G-A,rs2241417,-1,G,A,157271115,4490,157070017,157463233,201098
5,ENSG00000253653.1,157266625,5-157271115-G-C,rs2241417,-1,G,C,157271115,4490,157070017,157463233,201098
5,ENSG00000245317.2,179859013,5-179950085-T-C,rs248328,1,T,C,179950085,91072,179662405,180055621,287680
5,ENSG00000245317.2,179859013,5-179950085-T-A,rs248328,1,T,A,179950085,91072,179662405,180055621,287680
5,ENSG00000250900.2,181198200,5-181207677-A-G,rs254453,1,A,G,181207677,9477,181001592,181394808,206085
5,ENSG00000248923.1,134926459,5-135109805-C-T,rs254558,-1,C,T,135109805,183346,134729851,135123067,379954
5,ENSG00000250444.1,115512077,5-115452154-A-T,rs2546474,1,A,T,115452154,59923,115315469,115708685,136685
5,ENSG00000250444.1,115512077,5-115452154-A-G,rs2546474,1,A,G,115452154,59923,115315469,115708685,136685
5,ENSG00000250444.1,115512077,5-115452154-A-C,rs2546474,1,A,C,115452154,59923,115315469,115708685,136685
5,ENSG00000225138.2,473236,5-410932-C-T,rs2672744,1,C,T,410932,62304,276628,669844,134304
5,ENSG00000248794.1,81242599,5-81068721-C-T,rs26905,-1,C,T,81068721,173878,81045991,81439207,22730
5,ENSG00000248794.1,81242599,5-81068721-C-G,rs26905,-1,C,G,81068721,173878,81045991,81439207,22730
5,ENSG00000170089.8,177875595,5-177959572-G-A,rs28605160,1,G,A,177959572,83977,177678987,178072203,280585
5,ENSG00000261434.1,195778,5-192727-G-A,rs2864967,1,G,A,192727,3051,-830,392386,193557
5,ENSG00000248684.1,75910565,5-76074483-T-A,rs30191,1,T,A,76074483,163918,75713957,76107173,360526
5,ENSG00000248684.1,75910565,5-76074483-T-C,rs30191,1,T,C,76074483,163918,75713957,76107173,360526
5,ENSG00000248684.1,75910565,5-76074483-T-G,rs30191,1,T,G,76074483,163918,75713957,76107173,360526
5,ENSG00000243806.1,94826694,5-94932761-T-C,rs32909,-1,T,C,94932761,106067,94630086,95023302,302675
5,ENSG00000247679.2,177611240,5-177513383-G-A,rs335438,1,G,A,177513383,97857,177414632,177807848,98751
5,ENSG00000248668.1,41869927,5-41839896-C-T,rs34841703,1,C,T,41839896,30031,41673319,42066535,166577
5,ENSG00000253146.1,154560440,5-154416924-G-A,rs3734085,-1,G,A,154416924,143516,154363832,154757048,53092
5,ENSG00000233006.1,132369916,5-132315568-A-G,rs3792884,-1,A,G,132315568,54348,132173308,132566524,142260
5,ENSG00000248966.1,110950780,5-111069977-A-G,rs3806932,-1,A,G,111069977,119197,110754172,111147388,315805
5,ENSG00000250645.1,418703,5-531110-C-T,rs3853656,1,C,T,531110,112407,222095,615311,309015
5,ENSG00000205644.5,65415353,5-65463848-T-C,rs386188,1,T,C,65463848,48495,65218745,65611961,245103
5,ENSG00000251675.1,80128361,5-80119763-G-C,rs390292,1,G,C,80119763,8598,79931753,80324969,188010
5,ENSG00000249825.1,80082404,5-80117251-G-A,rs452106,-1,G,A,80117251,34847,79885796,80279012,231455
5,ENSG00000242858.1,83746989,5-83811285-T-C,rs4610439,-1,T,C,83811285,64296,83550381,83943597,260904
5,ENSG00000244945.1,179603741,5-179460896-C-T,rs4700823,-1,C,T,179460896,142845,179407133,179800349,53763
5,ENSG00000213661.3,121616247,5-121611346-A-G,rs4895324,1,A,G,121611346,4901,121419639,121812855,191707
5,ENSG00000249779.1,43206709,5-43107445-A-G,rs514567,1,A,G,43107445,99264,43010101,43403317,97344
5,ENSG00000253119.1,154338452,5-154283543-G-A,rs576374,-1,G,A,154283543,54909,154141844,154535060,141699
5,ENSG00000205464.5,82295449,5-82191509-G-C,rs6452448,1,G,C,82191509,103940,82098841,82492057,92668
5,ENSG00000205464.5,82295449,5-82191509-G-A,rs6452448,1,G,A,82191509,103940,82098841,82492057,92668
5,ENSG00000250240.1,95732295,5-95828253-T-C,rs6876015,-1,T,C,95828253,95958,95535687,95928903,292566
5,ENSG00000224282.3,31823136,5-31988283-T-C,rs6878827,-1,T,C,31988283,165147,31626528,32019744,361755
5,ENSG00000224282.3,31823136,5-31988283-T-G,rs6878827,-1,T,G,31988283,165147,31626528,32019744,361755
5,ENSG00000224282.3,31823136,5-31988283-T-A,rs6878827,-1,T,A,31988283,165147,31626528,32019744,361755
5,ENSG00000231579.3,143332605,5-143488712-G-C,rs6879079,1,G,C,143488712,156107,143135997,143529213,352715
5,ENSG00000231579.3,143332605,5-143488712-G-A,rs6879079,1,G,A,143488712,156107,143135997,143529213,352715
5,ENSG00000231579.3,143332605,5-143488712-G-T,rs6879079,1,G,T,143488712,156107,143135997,143529213,352715
5,ENSG00000250274.1,170312806,5-170316768-G-T,rs6885261,-1,G,T,170316768,3962,170116198,170509414,200570
5,ENSG00000250274.1,170312806,5-170316768-G-C,rs6885261,-1,G,C,170316768,3962,170116198,170509414,200570
5,ENSG00000250274.1,170312806,5-170316768-G-A,rs6885261,-1,G,A,170316768,3962,170116198,170509414,200570
5,ENSG00000247572.2,81301472,5-81214117-C-T,rs6893150,-1,C,T,81214117,87355,81104864,81498080,109253
5,ENSG00000231185.2,142404201,5-142341712-G-A,rs6893716,1,G,A,142341712,62489,142207593,142600809,134119
5,ENSG00000249637.1,140401460,5-140574338-C-T,rs702401,-1,C,T,140574338,172878,140204852,140598068,369486
5,ENSG00000250081.1,65487048,5-65526240-G-A,rs72762427,-1,G,A,65526240,39192,65290440,65683656,235800
5,ENSG00000204677.6,178008573,5-177961006-C-T,rs73339896,1,C,T,177961006,47567,177811965,178205181,149041
5,ENSG00000250909.1,176347941,5-176378685-G-A,rs74292755,1,G,A,176378685,30744,176151333,176544549,227352
5,ENSG00000253955.1,173579643,5-173584350-T-C,rs746215,1,T,C,173584350,4707,173383035,173776251,201315
5,ENSG00000240785.1,18049550,5-18192329-A-G,rs74912995,1,A,G,18192329,142779,17852942,18246158,339387
5,ENSG00000235172.3,170307722,5-170501143-C-T,rs75708130,1,C,T,170501143,193421,170111114,170504330,390029
5,ENSG00000253683.1,172656713,5-172564639-C-T,rs76459949,-1,C,T,172564639,92074,172460105,172853321,104534
5,ENSG00000245556.2,78360414,5-78289609-T-C,rs76666349,-1,T,C,78289609,70805,78163806,78557022,125803
5,ENSG00000251018.2,163494034,5-163531305-A-G,rs7700282,-1,A,G,163531305,37271,163297426,163690642,233879
5,ENSG00000248449.1,141426286,5-141342559-A-G,rs7701092,1,A,G,141342559,83727,141229678,141622894,112881
5,ENSG00000248449.1,141426286,5-141342559-A-T,rs7701092,1,A,T,141342559,83727,141229678,141622894,112881
5,ENSG00000237705.1,56862164,5-56748808-T-C,rs7708148,-1,T,C,56748808,113356,56665556,57058772,83252
5,ENSG00000248996.1,177494995,5-177422097-T-C,rs7711038,1,T,C,177422097,72898,177298387,177691603,123710
5,ENSG00000248996.1,177494995,5-177422097-T-A,rs7711038,1,T,A,177422097,72898,177298387,177691603,123710
5,ENSG00000241956.5,164296978,5-164332537-C-A,rs77224916,1,C,A,164332537,35559,164100370,164493586,232167
5,ENSG00000247516.2,8457706,5-8396854-A-G,rs77241885,1,A,G,8396854,60852,8261098,8654314,135756
5,ENSG00000250669.1,67690437,5-67802824-A-G,rs7727776,-1,A,G,67802824,112387,67493829,67887045,308995
5,ENSG00000253439.1,173086210,5-172958924-T-C,rs7732462,-1,T,C,172958924,127286,172889602,173282818,69322
5,ENSG00000253439.1,173086210,5-172958924-T-G,rs7732462,-1,T,G,172958924,127286,172889602,173282818,69322
5,ENSG00000247121.2,96935809,5-96927886-T-G,rs7733301,-1,T,G,96927886,7923,96739201,97132417,188685
5,ENSG00000251118.1,115770586,5-115895960-C-T,rs77691444,1,C,T,115895960,125374,115573978,115967194,321982
5,ENSG00000250337.1,27217714,5-27377481-T-C,rs78164350,1,T,C,27377481,159767,27021106,27414322,356375
5,ENSG00000249494.1,119070902,5-119178181-G-A,rs79460759,-1,G,A,119178181,107279,118874294,119267510,303887
5,ENSG00000253522.1,160438594,5-160260429-C-T,rs79588994,1,C,T,160260429,178165,160241986,160635202,18443
5,ENSG00000248400.1,82968888,5-82856689-C-T,rs79590433,1,C,T,82856689,112199,82772280,83165496,84409
5,ENSG00000248925.1,271516,5-185303-C-T,rs79713827,-1,C,T,185303,86213,74908,468124,110395
5,ENSG00000249541.1,2788549,5-2641486-C-T,rs905229,-1,C,T,2641486,147063,2591941,2985157,49545
5,ENSG00000249541.1,2788549,5-2641486-C-A,rs905229,-1,C,A,2641486,147063,2591941,2985157,49545
5,ENSG00000249541.1,2788549,5-2641486-C-G,rs905229,-1,C,G,2641486,147063,2591941,2985157,49545
4,ENSG00000250896.1,11371975,4-11434817-T-A,rs10012344,1,T,A,11434817,62842,11175367,11568583,259450
4,ENSG00000121089.4,164943290,4-164846476-G-T,rs10014767,1,G,T,164846476,96814,164746682,165139898,99794
4,ENSG00000121089.4,164943290,4-164846476-G-C,rs10014767,1,G,C,164846476,96814,164746682,165139898,99794
4,ENSG00000180712.3,184353971,4-184188736-G-A,rs10016852,-1,G,A,184188736,165235,184157363,184550579,31373
4,ENSG00000250412.1,119334329,4-119460368-C-G,rs10017335,1,C,G,119460368,126039,119137721,119530937,322647
4,ENSG00000245958.2,119457968,4-119470477-C-T,rs10032158,1,C,T,119470477,12509,119261360,119654576,209117
4,ENSG00000245958.2,119457968,4-119470477-C-G,rs10032158,1,C,G,119470477,12509,119261360,119654576,209117
4,ENSG00000259959.1,47844339,4-47950659-A-G,rs1012844,-1,A,G,47950659,106320,47647731,48040947,302928
4,ENSG00000259959.1,47844339,4-47950659-A-T,rs1012844,-1,A,T,47950659,106320,47647731,48040947,302928
4,ENSG00000259959.1,47844339,4-47950659-A-C,rs1012844,-1,A,C,47950659,106320,47647731,48040947,302928
4,ENSG00000249685.1,39133913,4-39126127-G-A,rs1046655,1,G,A,39126127,7786,38937305,39330521,188822
4,ENSG00000232327.3,80388716,4-80266741-A-C,rs1047245,-1,A,C,80266741,121975,80192108,80585324,74633
4,ENSG00000251580.1,6673896,4-6670787-G-A,rs1054909,-1,G,A,6670787,3109,6477288,6870504,193499
4,ENSG00000249700.1,55395842,4-55413708-A-G,rs11133377,-1,A,G,55413708,17866,55199234,55592450,214474
4,ENSG00000250220.1,73259209,4-73138833-T-C,rs112050195,1,T,C,73138833,120376,73062601,73455817,76232
4,ENSG00000242882.1,173420137,4-173576276-G-A,rs115738174,-1,G,A,173576276,156139,173223529,173616745,352747
4,ENSG00000250413.1,10006482,4-10094396-C-G,rs11727087,1,C,G,10094396,87914,9809874,10203090,284522
4,ENSG00000250413.1,10006482,4-10094396-C-T,rs11727087,1,C,T,10094396,87914,9809874,10203090,284522
4,ENSG00000251432.2,128292933,4-128379069-C-G,rs11728521,1,C,G,128379069,86136,128096325,128489541,282744
4,ENSG00000251432.2,128292933,4-128379069-C-T,rs11728521,1,C,T,128379069,86136,128096325,128489541,282744
4,ENSG00000249844.1,4175238,4-4361027-C-A,rs11728835,-1,C,A,4361027,185789,3978630,4371846,382397
4,ENSG00000250050.1,25719745,4-25886457-C-G,rs11735368,-1,C,G,25886457,166712,25523137,25916353,363320
4,ENSG00000248880.1,188389666,4-188326619-G-T,rs11930915,-1,G,T,188326619,63047,188193058,188586274,133561
4,ENSG00000248880.1,188389666,4-188326619-G-A,rs11930915,-1,G,A,188326619,63047,188193058,188586274,133561
4,ENSG00000248122.1,68304939,4-68267260-G-T,rs11933242,-1,G,T,68267260,37679,68108331,68501547,158929
4,ENSG00000248122.1,68304939,4-68267260-G-A,rs11933242,-1,G,A,68267260,37679,68108331,68501547,158929
4,ENSG00000170846.11,6674075,4-6671825-G-A,rs11946525,1,G,A,6671825,2250,6477467,6870683,194358
4,ENSG00000248155.1,2608146,4-2434530-G-A,rs1203766,-1,G,A,2434530,173616,2411538,2804754,22992
4,ENSG00000248155.1,2608146,4-2434530-G-C,rs1203766,-1,G,C,2434530,173616,2411538,2804754,22992
4,ENSG00000248155.1,2608146,4-2434530-G-T,rs1203766,-1,G,T,2434530,173616,2411538,2804754,22992
4,ENSG00000260091.1,119409333,4-119363162-A-T,rs12503082,1,A,T,119363162,46171,119212725,119605941,150437
4,ENSG00000260091.1,119409333,4-119363162-A-G,rs12503082,1,A,G,119363162,46171,119212725,119605941,150437
4,ENSG00000251595.3,427882,4-236448-T-C,rs12503763,-1,T,C,236448,191434,231274,624490,5174
4,ENSG00000248429.1,158170752,4-158173634-T-A,rs12648410,1,T,A,158173634,2882,157974144,158367360,199490
4,ENSG00000248429.1,158170752,4-158173634-T-C,rs12648410,1,T,C,158173634,2882,157974144,158367360,199490
4,ENSG00000248429.1,158170752,4-158173634-T-G,rs12648410,1,T,G,158173634,2882,157974144,158367360,199490
4,ENSG00000248590.2,56593004,4-56647746-C-T,rs12649154,1,C,T,56647746,54742,56396396,56789612,251350
4,ENSG00000248590.2,56593004,4-56647746-C-A,rs12649154,1,C,A,56647746,54742,56396396,56789612,251350
4,ENSG00000205100.2,189472965,4-189301931-G-T,rs13133883,1,G,T,189301931,171034,189276357,189669573,25574
4,ENSG00000205100.2,189472965,4-189301931-G-A,rs13133883,1,G,A,189301931,171034,189276357,189669573,25574
4,ENSG00000205100.2,189472965,4-189301931-G-C,rs13133883,1,G,C,189301931,171034,189276357,189669573,25574
4,ENSG00000248283.1,42562425,4-42563717-A-G,rs13135410,-1,A,G,42563717,1292,42365817,42759033,197900
4,ENSG00000248283.1,42562425,4-42563717-A-T,rs13135410,-1,A,T,42563717,1292,42365817,42759033,197900
4,ENSG00000245954.2,152090459,4-152101223-G-A,rs13140099,1,G,A,152101223,10764,151893851,152287067,207372
4,ENSG00000250768.1,64430909,4-64573111-C-A,rs1425373,1,C,A,64573111,142202,64234301,64627517,338810
4,ENSG00000250768.1,64430909,4-64573111-C-G,rs1425373,1,C,G,64573111,142202,64234301,64627517,338810
4,ENSG00000183199.6,87891843,4-87891867-G-A,rs144232232,1,G,A,87891867,24,87695235,88088451,196632
4,ENSG00000183199.6,87891843,4-87891867-G-C,rs144232232,1,G,C,87891867,24,87695235,88088451,196632
4,ENSG00000249013.1,156006478,4-155862232-C-T,rs1514010,1,C,T,155862232,144246,155809870,156203086,52362
4,ENSG00000244459.2,1580527,4-1726654-G-C,rs1665366,-1,G,C,1726654,146127,1383919,1777135,342735
4,ENSG00000244459.2,1580527,4-1726654-G-A,rs1665366,-1,G,A,1726654,146127,1383919,1777135,342735
4,ENSG00000248254.1,47560259,4-47576954-G-A,rs16851681,-1,G,A,47576954,16695,47363651,47756867,213303
4,ENSG00000248401.1,83247179,4-83228921-C-A,rs17006612,1,C,A,83228921,18258,83050571,83443787,178350
4,ENSG00000248180.1,87207092,4-87082963-C-T,rs17012394,1,C,T,87082963,124129,87010484,87403700,72479
4,ENSG00000248180.1,87207092,4-87082963-C-A,rs17012394,1,C,A,87082963,124129,87010484,87403700,72479
4,ENSG00000246375.2,88284883,4-88282045-T-C,rs17013978,1,T,C,88282045,2838,88088275,88481491,193770
4,ENSG00000236296.2,143559487,4-143559078-C-T,rs17017907,1,C,T,143559078,409,143362879,143756095,196199
4,ENSG00000251254.1,147506091,4-147359722-T-G,rs17023122,1,T,G,147359722,146369,147309483,147702699,50239
4,ENSG00000247950.2,109433814,4-109526007-T-C,rs17040505,-1,T,C,109526007,92193,109237206,109630422,288801
4,ENSG00000260296.1,40166675,4-40098964-T-A,rs1704153,1,T,A,40098964,67711,39970067,40363283,128897
4,ENSG00000260296.1,40166675,4-40098964-T-G,rs1704153,1,T,G,40098964,67711,39970067,40363283,128897
4,ENSG00000260296.1,40166675,4-40098964-T-C,rs1704153,1,T,C,40098964,67711,39970067,40363283,128897
4,ENSG00000231707.3,39973444,4-40055669-C-T,rs1704157,1,C,T,40055669,82225,39776836,40170052,278833
4,ENSG00000231707.3,39973444,4-40055669-C-G,rs1704157,1,C,G,40055669,82225,39776836,40170052,278833
4,ENSG00000231707.3,39973444,4-40055669-C-A,rs1704157,1,C,A,40055669,82225,39776836,40170052,278833
4,ENSG00000250966.1,112564988,4-112585619-G-A,rs17044834,1,G,A,112585619,20631,112368380,112761596,217239
4,ENSG00000246090.2,99088857,4-99089122-C-G,rs17216887,1,C,G,99089122,265,98892249,99285465,196873
4,ENSG00000235043.2,86950113,4-87078331-A-G,rs17668731,-1,A,G,87078331,128218,86753505,87146721,324826
4,ENSG00000248785.1,109673843,4-109504020-T-G,rs1876125,1,T,G,109504020,169823,109477235,109870451,26785
4,ENSG00000248785.1,109673843,4-109504020-T-A,rs1876125,1,T,A,109504020,169823,109477235,109870451,26785
4,ENSG00000248785.1,109673843,4-109504020-T-C,rs1876125,1,T,C,109504020,169823,109477235,109870451,26785
4,ENSG00000205959.3,8482270,4-8501632-A-G,rs1949733,1,A,G,8501632,19362,8285662,8678878,215970
4,ENSG00000205959.3,8482270,4-8501632-A-T,rs1949733,1,A,T,8501632,19362,8285662,8678878,215970
4,ENSG00000236764.3,96902801,4-96842407-T-C,rs2014646,1,T,C,96842407,60394,96706193,97099409,136214
4,ENSG00000236764.3,96902801,4-96842407-T-G,rs2014646,1,T,G,96842407,60394,96706193,97099409,136214
4,ENSG00000223305.1,55540835,4-55407965-G-T,rs2048564,-1,G,T,55407965,132870,55344227,55737443,63738
4,ENSG00000223305.1,55540835,4-55407965-G-A,rs2048564,-1,G,A,55407965,132870,55344227,55737443,63738
4,ENSG00000243280.2,112171215,4-112356901-C-G,rs2074378,1,C,G,112356901,185686,111974607,112367823,382294
4,ENSG00000243280.2,112171215,4-112356901-C-T,rs2074378,1,C,T,112356901,185686,111974607,112367823,382294
4,ENSG00000248394.1,128155389,4-128026720-G-A,rs2169270,1,G,A,128026720,128669,127958781,128351997,67939
4,ENSG00000248394.1,128155389,4-128026720-G-T,rs2169270,1,G,T,128026720,128669,127958781,128351997,67939
4,ENSG00000249096.1,184382416,4-184380916-T-A,rs2185830,-1,T,A,184380916,1500,184185808,184579024,195108
4,ENSG00000249096.1,184382416,4-184380916-T-C,rs2185830,-1,T,C,184380916,1500,184185808,184579024,195108
4,ENSG00000246560.2,102827611,4-102884286-T-C,rs223315,1,T,C,102884286,56675,102631003,103024219,253283
4,ENSG00000246560.2,102827611,4-102884286-T-A,rs223315,1,T,A,102884286,56675,102631003,103024219,253283
4,ENSG00000251288.1,102751401,4-102711806-C-T,rs223508,1,C,T,102711806,39595,102554793,102948009,157013
4,ENSG00000248049.2,67701279,4-67741216-T-C,rs2319658,1,T,C,67741216,39937,67504671,67897887,236545
4,ENSG00000250185.1,108789779,4-108688985-C-G,rs2575635,-1,C,G,108688985,100794,108593171,108986387,95814
4,ENSG00000250185.1,108789779,4-108688985-C-T,rs2575635,-1,C,T,108688985,100794,108593171,108986387,95814
4,ENSG00000250185.1,108789779,4-108688985-C-A,rs2575635,-1,C,A,108688985,100794,108593171,108986387,95814
4,ENSG00000249341.1,53659208,4-53693571-C-T,rs2590783,1,C,T,53693571,34363,53462600,53855816,230971
4,ENSG00000178458.4,139698554,4-139716717-C-A,rs2646062,-1,C,A,139716717,18163,139501946,139895162,214771
4,ENSG00000213448.3,137448087,4-137453783-T-C,rs28560376,1,T,C,137453783,5696,137251479,137644695,202304
4,ENSG00000198155.5,218650,4-207285-T-C,rs28716466,1,T,C,207285,11365,22042,415258,185243
4,ENSG00000196810.3,1249451,4-1250089-C-T,rs2878539,1,C,T,1250089,638,1052843,1446059,197246
4,ENSG00000260519.1,42657496,4-42659954-C-A,rs34460227,1,C,A,42659954,2458,42460888,42854104,199066
4,ENSG00000251615.1,8358338,4-8356009-A-C,rs34893440,-1,A,C,8356009,2329,8161730,8554946,194279
4,ENSG00000251555.1,131975952,4-131917527-T-C,rs349871,-1,T,C,131917527,58425,131779344,132172560,138183
4,ENSG00000251017.1,74086672,4-73931422-T-G,rs352024,-1,T,G,73931422,155250,73890064,74283280,41358
4,ENSG00000249334.1,10685003,4-10689294-C-G,rs35755918,1,C,G,10689294,4291,10488395,10881611,200899
4,ENSG00000249334.1,10685003,4-10689294-C-A,rs35755918,1,C,A,10689294,4291,10488395,10881611,200899
4,ENSG00000250568.1,39973442,4-39818943-G-C,rs421631,-1,G,C,39818943,154499,39776834,40170050,42109
4,ENSG00000250568.1,39973442,4-39818943-G-A,rs421631,-1,G,A,39818943,154499,39776834,40170050,42109
4,ENSG00000245213.2,173169104,4-172998165-G-C,rs4235217,-1,G,C,172998165,170939,172972496,173365712,25669
4,ENSG00000240005.1,26860650,4-26858791-G-A,rs4505809,-1,G,A,26858791,1859,26664042,27057258,194749
4,ENSG00000229894.2,165279704,4-165375112-C-A,rs4691187,-1,C,A,165375112,95408,165083096,165476312,292016
4,ENSG00000229894.2,165279704,4-165375112-C-G,rs4691187,-1,C,G,165375112,95408,165083096,165476312,292016
4,ENSG00000240669.1,152614333,4-152597821-A-T,rs4696137,-1,A,T,152597821,16512,152417725,152810941,180096
4,ENSG00000240669.1,152614333,4-152597821-A-G,rs4696137,-1,A,G,152597821,16512,152417725,152810941,180096
4,ENSG00000243417.1,152552364,4-152638316-T-C,rs4696332,-1,T,C,152638316,85952,152355756,152748972,282560
4,ENSG00000254531.1,101347752,4-101363783-C-G,rs4699209,1,C,G,101363783,16031,101151144,101544360,212639
4,ENSG00000254531.1,101347752,4-101363783-C-T,rs4699209,1,C,T,101363783,16031,101151144,101544360,212639
4,ENSG00000249006.1,2090617,4-2179881-C-T,rs617914,-1,C,T,2179881,89264,1894009,2287225,285872
4,ENSG00000249006.1,2090617,4-2179881-C-G,rs617914,-1,C,G,2179881,89264,1894009,2287225,285872
4,ENSG00000250566.1,68517647,4-68500812-G-T,rs62299466,-1,G,T,68500812,16835,68321039,68714255,179773
4,ENSG00000250566.1,68517647,4-68500812-G-A,rs62299466,-1,G,A,68500812,16835,68321039,68714255,179773
4,ENSG00000247193.2,36244116,4-36126855-C-T,rs6531411,1,C,T,36126855,117261,36047508,36440724,79347
4,ENSG00000247193.2,36244116,4-36126855-C-G,rs6531411,1,C,G,36126855,117261,36047508,36440724,79347
4,ENSG00000249863.1,37868292,4-37857333-C-A,rs6531591,1,C,A,37857333,10959,37671684,38064900,185649
4,ENSG00000249863.1,37868292,4-37857333-C-T,rs6531591,1,C,T,37857333,10959,37671684,38064900,185649
4,ENSG00000237170.3,4507078,4-4374861-C-A,rs6811129,1,C,A,4374861,132217,4310470,4703686,64391
4,ENSG00000237170.3,4507078,4-4374861-C-G,rs6811129,1,C,G,4374861,132217,4310470,4703686,64391
4,ENSG00000260526.1,112231596,4-112410634-G-T,rs6812485,-1,G,T,112410634,179038,112034988,112428204,375646
4,ENSG00000249381.1,138425523,4-138257920-C-T,rs6816398,1,C,T,138257920,167603,138228915,138622131,29005
4,ENSG00000249532.1,112650051,4-112562687-T-G,rs6816676,-1,T,G,112562687,87364,112453443,112846659,109244
4,ENSG00000249532.1,112650051,4-112562687-T-C,rs6816676,-1,T,C,112562687,87364,112453443,112846659,109244
4,ENSG00000249896.1,6227614,4-6210128-T-C,rs6816740,1,T,C,6210128,17486,6031006,6424222,179122
4,ENSG00000249896.1,6227614,4-6210128-T-A,rs6816740,1,T,A,6210128,17486,6031006,6424222,179122
4,ENSG00000249592.1,781849,4-777799-A-G,rs6819857,-1,A,G,777799,4050,585241,978457,192558
4,ENSG00000245685.2,189940733,4-189942587-T-A,rs6820684,-1,T,A,189942587,1854,189744125,190137341,198462
4,ENSG00000249960.1,82571137,4-82656045-G-A,rs6823569,1,G,A,82656045,84908,82374529,82767745,281516
4,ENSG00000249509.1,112515431,4-112622996-T-C,rs6834538,1,T,C,112622996,107565,112318823,112712039,304173
4,ENSG00000249509.1,112515431,4-112622996-T-A,rs6834538,1,T,A,112622996,107565,112318823,112712039,304173
4,ENSG00000249509.1,112515431,4-112622996-T-G,rs6834538,1,T,G,112622996,107565,112318823,112712039,304173
4,ENSG00000251230.1,184855751,4-184852578-T-C,rs6835696,-1,T,C,184852578,3173,184659143,185052359,193435
4,ENSG00000214273.4,190041342,4-189987972-G-T,rs6840847,1,G,T,189987972,53370,189844734,190237950,143238
4,ENSG00000214273.4,190041342,4-189987972-G-C,rs6840847,1,G,C,189987972,53370,189844734,190237950,143238
4,ENSG00000214273.4,190041342,4-189987972-G-A,rs6840847,1,G,A,189987972,53370,189844734,190237950,143238
4,ENSG00000250656.1,67717388,4-67649336-A-G,rs6840867,-1,A,G,67649336,68052,67520780,67913996,128556
4,ENSG00000248375.1,52720831,4-52738420-C-T,rs6840875,-1,C,T,52738420,17589,52524223,52917439,214197
4,ENSG00000213434.2,183483490,4-183391966-T-C,rs72705526,1,T,C,183391966,91524,183286882,183680098,105084
4,ENSG00000248780.1,40786110,4-40960938-G-A,rs73244030,1,G,A,40960938,174828,40589502,40982718,371436
4,ENSG00000250227.1,164915565,4-164977530-C-T,rs74651789,1,C,T,164977530,61965,164718957,165112173,258573
4,ENSG00000239983.1,33968174,4-33921759-A-G,rs75546033,1,A,G,33921759,46415,33771566,34164782,150193
4,ENSG00000250075.1,67468251,4-67472481-G-T,rs7662513,-1,G,T,67472481,4230,67271643,67664859,200838
4,ENSG00000250075.1,67468251,4-67472481-G-C,rs7662513,-1,G,C,67472481,4230,67271643,67664859,200838
4,ENSG00000249741.1,143912053,4-143958036-C-T,rs7662736,-1,C,T,143958036,45983,143715445,144108661,242591
4,ENSG00000249741.1,143912053,4-143958036-C-G,rs7662736,-1,C,G,143958036,45983,143715445,144108661,242591
4,ENSG00000249741.1,143912053,4-143958036-C-A,rs7662736,-1,C,A,143958036,45983,143715445,144108661,242591
4,ENSG00000248645.1,164939990,4-164931619-A-G,rs7663683,-1,A,G,164931619,8371,164743382,165136598,188237
4,ENSG00000248645.1,164939990,4-164931619-A-T,rs7663683,-1,A,T,164931619,8371,164743382,165136598,188237
4,ENSG00000248645.1,164939990,4-164931619-A-C,rs7663683,-1,A,C,164931619,8371,164743382,165136598,188237
4,ENSG00000236941.3,164948079,4-164931619-A-G,rs7663683,1,A,G,164931619,16460,164751471,165144687,180148
4,ENSG00000236941.3,164948079,4-164931619-A-T,rs7663683,1,A,T,164931619,16460,164751471,165144687,180148
4,ENSG00000236941.3,164948079,4-164931619-A-C,rs7663683,1,A,C,164931619,16460,164751471,165144687,180148
4,ENSG00000250326.1,143184861,4-143139311-A-T,rs7666785,-1,A,T,143139311,45550,142988253,143381469,151058
4,ENSG00000250326.1,143184861,4-143139311-A-G,rs7666785,-1,A,G,143139311,45550,142988253,143381469,151058
4,ENSG00000226950.2,52712501,4-52691511-C-A,rs7674000,1,C,A,52691511,20990,52515893,52909109,175618
4,ENSG00000226950.2,52712501,4-52691511-C-G,rs7674000,1,C,G,52691511,20990,52515893,52909109,175618
4,ENSG00000250131.1,177442519,4-177443649-T-A,rs7682705,1,T,A,177443649,1130,177245911,177639127,197738
4,ENSG00000250131.1,177442519,4-177443649-T-C,rs7682705,1,T,C,177443649,1130,177245911,177639127,197738
4,ENSG00000251297.1,189984871,4-190000554-G-C,rs7686607,-1,G,C,190000554,15683,189788263,190181479,212291
4,ENSG00000251297.1,189984871,4-190000554-G-A,rs7686607,-1,G,A,190000554,15683,189788263,190181479,212291
4,ENSG00000251297.1,189984871,4-190000554-G-T,rs7686607,-1,G,T,190000554,15683,189788263,190181479,212291
4,ENSG00000213522.3,107203924,4-107134069-C-G,rs7687506,-1,C,G,107134069,69855,107007316,107400532,126753
4,ENSG00000260303.1,146056762,4-146015695-A-T,rs7688003,-1,A,T,146015695,41067,145860154,146253370,155541
4,ENSG00000260303.1,146056762,4-146015695-A-G,rs7688003,-1,A,G,146015695,41067,145860154,146253370,155541
4,ENSG00000234492.3,108620413,4-108615460-C-T,rs7691236,-1,C,T,108615460,4953,108423805,108817021,191655
4,ENSG00000234492.3,108620413,4-108615460-C-G,rs7691236,-1,C,G,108615460,4953,108423805,108817021,191655
4,ENSG00000234492.3,108620413,4-108615460-C-A,rs7691236,-1,C,A,108615460,4953,108423805,108817021,191655
4,ENSG00000250902.1,145517118,4-145514998-A-C,rs7694086,-1,A,C,145514998,2120,145320510,145713726,194488
4,ENSG00000248208.1,153658572,4-153714474-A-G,rs7695686,1,A,G,153714474,55902,153461964,153855180,252510
4,ENSG00000250892.1,205009,4-118051-T-C,rs77068144,-1,T,C,118051,86958,8401,401617,109650
4,ENSG00000248256.1,48860203,4-49027406-G-A,rs77730715,-1,G,A,49027406,167203,48663595,49056811,363811
4,ENSG00000242358.1,16256555,4-16424312-A-G,rs77796768,-1,A,G,16424312,167757,16059947,16453163,364365
4,ENSG00000166530.6,110252099,4-110370469-C-A,rs77862673,-1,C,A,110370469,118370,110055491,110448707,314978
4,ENSG00000231841.1,152927446,4-153019352-C-T,rs78940344,1,C,T,153019352,91906,152730838,153124054,288514
4,ENSG00000250666.1,189881515,4-189947241-A-G,rs79403633,1,A,G,189947241,65726,189684907,190078123,262334
4,ENSG00000250327.1,186157896,4-186100835-G-C,rs9312343,1,G,C,186100835,57061,185961288,186354504,139547
4,ENSG00000250327.1,186157896,4-186100835-G-A,rs9312343,1,G,A,186100835,57061,185961288,186354504,139547
4,ENSG00000178458.4,139698554,4-139621273-G-T,rs10027416,-1,G,T,139621273,77281,139501946,139895162,119327
4,ENSG00000178458.4,139698554,4-139621273-G-C,rs10027416,-1,G,C,139621273,77281,139501946,139895162,119327
4,ENSG00000178458.4,139698554,4-139621273-G-A,rs10027416,-1,G,A,139621273,77281,139501946,139895162,119327
4,ENSG00000213522.3,107203924,4-107196310-A-T,rs1027253,-1,A,T,107196310,7614,107007316,107400532,188994
4,ENSG00000213522.3,107203924,4-107196310-A-C,rs1027253,-1,A,C,107196310,7614,107007316,107400532,188994
4,ENSG00000213522.3,107203924,4-107196310-A-G,rs1027253,-1,A,G,107196310,7614,107007316,107400532,188994
4,ENSG00000246560.2,102827611,4-103021557-A-C,rs10516497,1,A,C,103021557,193946,102631003,103024219,390554
4,ENSG00000248019.2,88709789,4-88876487-G-A,rs10516823,1,G,A,88876487,166698,88513181,88906397,363306
4,ENSG00000248019.2,88709789,4-88876487-G-T,rs10516823,1,G,T,88876487,166698,88513181,88906397,363306
4,ENSG00000245213.2,173169104,4-173192938-C-T,rs10520255,-1,C,T,173192938,23834,172972496,173365712,220442
4,ENSG00000170846.11,6674075,4-6670787-G-A,rs1054909,1,G,A,6670787,3288,6477467,6870683,193320
4,ENSG00000227765.3,184299640,4-184305068-T-C,rs1087299,-1,T,C,184305068,5428,184103032,184496248,202036
4,ENSG00000227765.3,184299640,4-184305068-T-A,rs1087299,-1,T,A,184305068,5428,184103032,184496248,202036
4,ENSG00000249096.1,184382416,4-184382377-T-A,rs1105754,-1,T,A,184382377,39,184185808,184579024,196569
4,ENSG00000249096.1,184382416,4-184382377-T-G,rs1105754,-1,T,G,184382377,39,184185808,184579024,196569
4,ENSG00000249685.1,39133913,4-39327482-G-A,rs11096992,1,G,A,39327482,193569,38937305,39330521,390177
4,ENSG00000249700.1,55395842,4-55391465-G-C,rs113058073,-1,G,C,55391465,4377,55199234,55592450,192231
4,ENSG00000249700.1,55395842,4-55391465-G-A,rs113058073,-1,G,A,55391465,4377,55199234,55592450,192231
4,ENSG00000249004.1,147459321,4-147366484-C-G,rs113436562,-1,C,G,147366484,92837,147262713,147655929,103771
4,ENSG00000249004.1,147459321,4-147366484-C-T,rs113436562,-1,C,T,147366484,92837,147262713,147655929,103771
4,ENSG00000196810.3,1249451,4-1388010-A-G,rs1137789,1,A,G,1388010,138559,1052843,1446059,335167
4,ENSG00000196810.3,1249451,4-1388010-A-T,rs1137789,1,A,T,1388010,138559,1052843,1446059,335167
4,ENSG00000250384.1,57072683,4-57040128-G-A,rs11573114,1,G,A,57040128,32555,56876075,57269291,164053
4,ENSG00000250384.1,57072683,4-57040128-G-C,rs11573114,1,G,C,57040128,32555,56876075,57269291,164053
4,ENSG00000250075.1,67468251,4-67462403-T-C,rs116024466,-1,T,C,67462403,5848,67271643,67664859,190760
4,ENSG00000248113.1,82581384,4-82775259-G-A,rs11722062,-1,G,A,82775259,193875,82384776,82777992,390483
4,ENSG00000248401.1,83247179,4-83221735-G-A,rs11727365,1,G,A,83221735,25444,83050571,83443787,171164
4,ENSG00000253917.2,3955419,4-3789923-C-T,rs11733817,-1,C,T,3789923,165496,3758811,4152027,31112
4,ENSG00000253917.2,3955419,4-3789923-C-G,rs11733817,-1,C,G,3789923,165496,3758811,4152027,31112
4,ENSG00000250893.1,40426119,4-40522715-A-G,rs11930154,1,A,G,40522715,96596,40229511,40622727,293204
4,ENSG00000248283.1,42562425,4-42572356-G-T,rs12502828,-1,G,T,42572356,9931,42365817,42759033,206539
4,ENSG00000248283.1,42562425,4-42572356-G-A,rs12502828,-1,G,A,42572356,9931,42365817,42759033,206539
4,ENSG00000248283.1,42562425,4-42572356-G-C,rs12502828,-1,G,C,42572356,9931,42365817,42759033,206539
4,ENSG00000249334.1,10685003,4-10784763-A-T,rs12648975,1,A,T,10784763,99760,10488395,10881611,296368
4,ENSG00000249334.1,10685003,4-10784763-A-C,rs12648975,1,A,C,10784763,99760,10488395,10881611,296368
4,ENSG00000249334.1,10685003,4-10784763-A-G,rs12648975,1,A,G,10784763,99760,10488395,10881611,296368
4,ENSG00000249920.1,73939558,4-74075048-G-C,rs12649753,-1,G,C,74075048,135490,73742950,74136166,332098
4,ENSG00000249920.1,73939558,4-74075048-G-A,rs12649753,-1,G,A,74075048,135490,73742950,74136166,332098
4,ENSG00000245958.2,119457968,4-119503425-T-G,rs13107334,1,T,G,119503425,45457,119261360,119654576,242065
4,ENSG00000251615.1,8358338,4-8501554-A-G,rs13111630,-1,A,G,8501554,143216,8161730,8554946,339824
4,ENSG00000213608.4,83477524,4-83648126-G-A,rs13151073,1,G,A,83648126,170602,83280916,83674132,367210
4,ENSG00000250412.1,119334329,4-119309995-G-A,rs1397607,1,G,A,119309995,24334,119137721,119530937,172274
4,ENSG00000250412.1,119334329,4-119309995-G-C,rs1397607,1,G,C,119309995,24334,119137721,119530937,172274
4,ENSG00000249717.1,74970362,4-75072613-C-A,rs1477587,-1,C,A,75072613,102251,74773754,75166970,298859
4,ENSG00000249717.1,74970362,4-75072613-C-T,rs1477587,-1,C,T,75072613,102251,74773754,75166970,298859
4,ENSG00000248049.2,67701279,4-67614500-T-C,rs1548119,1,T,C,67614500,86779,67504671,67897887,109829
4,ENSG00000248049.2,67701279,4-67614500-T-A,rs1548119,1,T,A,67614500,86779,67504671,67897887,109829
4,ENSG00000249673.1,2937266,4-2923849-G-T,rs16843596,1,G,T,2923849,13417,2740658,3133874,183191
4,ENSG00000249673.1,2937266,4-2923849-G-A,rs16843596,1,G,A,2923849,13417,2740658,3133874,183191
4,ENSG00000248180.1,87207092,4-87061964-T-A,rs17012341,1,T,A,87061964,145128,87010484,87403700,51480
4,ENSG00000248180.1,87207092,4-87061964-T-C,rs17012341,1,T,C,87061964,145128,87010484,87403700,51480
4,ENSG00000251600.1,143559457,4-143546652-C-T,rs17017869,1,C,T,143546652,12805,143362849,143756065,183803
4,ENSG00000236296.2,143559487,4-143580053-T-G,rs17017927,1,T,G,143580053,20566,143362879,143756095,217174
4,ENSG00000236296.2,143559487,4-143580053-T-A,rs17017927,1,T,A,143580053,20566,143362879,143756095,217174
4,ENSG00000236764.3,96902801,4-96845809-T-C,rs17025944,1,T,C,96845809,56992,96706193,97099409,139616
4,ENSG00000236764.3,96902801,4-96845809-T-A,rs17025944,1,T,A,96845809,56992,96706193,97099409,139616
4,ENSG00000251288.1,102751401,4-102622692-A-G,rs17032985,1,A,G,102622692,128709,102554793,102948009,67899
4,ENSG00000249311.2,136356336,4-136478891-T-C,rs17048694,-1,T,C,136478891,122555,136159728,136552944,319163
4,ENSG00000249311.2,136356336,4-136478891-T-G,rs17048694,-1,T,G,136478891,122555,136159728,136552944,319163
4,ENSG00000245322.2,100008071,4-100162025-C-T,rs17092,1,C,T,100162025,153954,99811463,100204679,350562
4,ENSG00000251095.1,89410960,4-89511026-C-T,rs17175612,1,C,T,89511026,100066,89214352,89607568,296674
4,ENSG00000250771.1,153678259,4-153668572-T-A,rs17370673,1,T,A,153668572,9687,153481651,153874867,186921
4,ENSG00000250771.1,153678259,4-153668572-T-C,rs17370673,1,T,C,153668572,9687,153481651,153874867,186921
4,ENSG00000250568.1,39973442,4-39903362-A-G,rs17585757,-1,A,G,39903362,70080,39776834,40170050,126528
4,ENSG00000251596.1,165406350,4-165550855-A-G,rs17587638,-1,A,G,165550855,144505,165209742,165602958,341113
4,ENSG00000248327.1,165551060,4-165452729-C-A,rs17687381,-1,C,A,165452729,98331,165354452,165747668,98277
4,ENSG00000249592.1,781849,4-752774-T-C,rs17721913,-1,T,C,752774,29075,585241,978457,167533
4,ENSG00000249592.1,781849,4-752774-T-A,rs17721913,-1,T,A,752774,29075,585241,978457,167533
4,ENSG00000259959.1,47844339,4-47831792-T-C,rs1866688,-1,T,C,47831792,12547,47647731,48040947,184061
4,ENSG00000249509.1,112515431,4-112431743-G-A,rs2074379,1,G,A,112431743,83688,112318823,112712039,112920
4,ENSG00000249509.1,112515431,4-112431743-G-C,rs2074379,1,G,C,112431743,83688,112318823,112712039,112920
4,ENSG00000248971.1,102730171,4-102714026-T-C,rs223504,-1,T,C,102714026,16145,102533563,102926779,180463
4,ENSG00000251229.1,2506279,4-2510327-A-G,rs2282765,-1,A,G,2510327,4048,2309671,2702887,200656
4,ENSG00000249072.1,78008688,4-78180702-G-A,rs2867000,-1,G,A,78180702,172014,77812080,78205296,368622
4,ENSG00000244002.1,80161129,4-79987679-A-C,rs28830602,1,A,C,79987679,173450,79964521,80357737,23158
4,ENSG00000244002.1,80161129,4-79987679-A-G,rs28830602,1,A,G,79987679,173450,79964521,80357737,23158
4,ENSG00000244002.1,80161129,4-79987679-A-T,rs28830602,1,A,T,79987679,173450,79964521,80357737,23158
4,ENSG00000248305.1,138482096,4-138341993-A-T,rs298468,-1,A,T,138341993,140103,138285488,138678704,56505
4,ENSG00000248305.1,138482096,4-138341993-A-G,rs298468,-1,A,G,138341993,140103,138285488,138678704,56505
4,ENSG00000248155.1,2608146,4-2482443-C-G,rs34514346,-1,C,G,2482443,125703,2411538,2804754,70905
4,ENSG00000248155.1,2608146,4-2482443-C-T,rs34514346,-1,C,T,2482443,125703,2411538,2804754,70905
4,ENSG00000236562.3,66094142,4-66233695-G-A,rs35289226,1,G,A,66233695,139553,65897534,66290750,336161
4,ENSG00000250656.1,67717388,4-67604804-T-C,rs354883,-1,T,C,67604804,112584,67520780,67913996,84024
4,ENSG00000250656.1,67717388,4-67604804-T-G,rs354883,-1,T,G,67604804,112584,67520780,67913996,84024
4,ENSG00000249863.1,37868292,4-37838984-G-A,rs3775793,1,G,A,37838984,29308,37671684,38064900,167300
4,ENSG00000248122.1,68304939,4-68319436-A-C,rs3927373,-1,A,C,68319436,14497,68108331,68501547,211105
4,ENSG00000248122.1,68304939,4-68319436-A-T,rs3927373,-1,A,T,68319436,14497,68108331,68501547,211105
4,ENSG00000248122.1,68304939,4-68319436-A-G,rs3927373,-1,A,G,68319436,14497,68108331,68501547,211105
4,ENSG00000187653.10,90839037,4-91016821-A-G,rs41338244,-1,A,G,91016821,177784,90642429,91035645,374392
4,ENSG00000244004.1,9563171,4-9450197-T-C,rs4246697,1,T,C,9450197,112974,9366563,9759779,83634
4,ENSG00000250413.1,10006482,4-9942076-G-A,rs4292327,1,G,A,9942076,64406,9809874,10203090,132202
4,ENSG00000249341.1,53659208,4-53676034-T-G,rs4577639,1,T,G,53676034,16826,53462600,53855816,213434
4,ENSG00000250321.1,342962,4-527691-T-G,rs4624610,-1,T,G,527691,184729,146354,539570,381337
4,ENSG00000250321.1,342962,4-527691-T-C,rs4624610,-1,T,C,527691,184729,146354,539570,381337
4,ENSG00000251580.1,6673896,4-6678850-T-A,rs4689510,-1,T,A,6678850,4954,6477288,6870504,201562
4,ENSG00000251580.1,6673896,4-6678850-T-C,rs4689510,-1,T,C,6678850,4954,6477288,6870504,201562
4,ENSG00000248254.1,47560259,4-47532713-G-C,rs4695243,-1,G,C,47532713,27546,47363651,47756867,169062
4,ENSG00000248254.1,47560259,4-47532713-G-A,rs4695243,-1,G,A,47532713,27546,47363651,47756867,169062
4,ENSG00000213331.4,187970273,4-188109782-C-T,rs4862863,1,C,T,188109782,139509,187773665,188166881,336117
4,ENSG00000186234.7,9692495,4-9813816-C-T,rs56050634,1,C,T,9813816,121321,9495887,9889103,317929
4,ENSG00000214988.4,82491635,4-82597226-T-G,rs56174237,-1,T,G,82597226,105591,82295027,82688243,302199
4,ENSG00000223305.1,55540835,4-55457212-C-T,rs57826934,-1,C,T,55457212,83623,55344227,55737443,112985
4,ENSG00000251669.1,3955419,4-3942147-C-T,rs62289005,-1,C,T,3942147,13272,3758811,4152027,183336
4,ENSG00000243199.1,65573459,4-65688675-T-G,rs62299571,1,T,G,65688675,115216,65376851,65770067,311824
4,ENSG00000241002.1,112738672,4-112696538-A-C,rs6533636,1,A,C,112696538,42134,112542064,112935280,154474
4,ENSG00000241002.1,112738672,4-112696538-A-T,rs6533636,1,A,T,112696538,42134,112542064,112935280,154474
4,ENSG00000241002.1,112738672,4-112696538-A-G,rs6533636,1,A,G,112696538,42134,112542064,112935280,154474
4,ENSG00000248208.1,153658572,4-153609487-A-G,rs6821970,1,A,G,153609487,49085,153461964,153855180,147523
4,ENSG00000250626.2,188818522,4-188963088-C-T,rs6835613,-1,C,T,188963088,144566,188621914,189015130,341174
4,ENSG00000249844.1,4175238,4-4343033-C-T,rs6836570,-1,C,T,4343033,167795,3978630,4371846,364403
4,ENSG00000249844.1,4175238,4-4343033-C-G,rs6836570,-1,C,G,4343033,167795,3978630,4371846,364403
4,ENSG00000226950.2,52712501,4-52761439-A-C,rs6838531,1,A,C,52761439,48938,52515893,52909109,245546
4,ENSG00000227118.3,98740742,4-98577529-T-C,rs6844261,1,T,C,98577529,163213,98544134,98937350,33395
4,ENSG00000227118.3,98740742,4-98577529-T-G,rs6844261,1,T,G,98577529,163213,98544134,98937350,33395
4,ENSG00000227118.3,98740742,4-98577529-T-A,rs6844261,1,T,A,98577529,163213,98544134,98937350,33395
4,ENSG00000250144.1,135045464,4-135066709-C-G,rs6856823,1,C,G,135066709,21245,134848856,135242072,217853
4,ENSG00000250144.1,135045464,4-135066709-C-T,rs6856823,1,C,T,135066709,21245,134848856,135242072,217853
4,ENSG00000250471.1,8174421,4-8272607-T-C,rs73081575,1,T,C,8272607,98186,7977813,8371029,294794
4,ENSG00000248890.1,144661357,4-144564408-C-T,rs74429251,-1,C,T,144564408,96949,144464749,144857965,99659
4,ENSG00000240669.1,152614333,4-152478539-T-A,rs76418725,-1,T,A,152478539,135794,152417725,152810941,60814
4,ENSG00000240669.1,152614333,4-152478539-T-C,rs76418725,-1,T,C,152478539,135794,152417725,152810941,60814
4,ENSG00000246375.2,88284883,4-88275669-A-G,rs7656367,1,A,G,88275669,9214,88088275,88481491,187394
4,ENSG00000260303.1,146056762,4-145972341-G-A,rs7657882,-1,G,A,145972341,84421,145860154,146253370,112187
4,ENSG00000250980.1,152796831,4-152831949-A-G,rs7666442,-1,A,G,152831949,35118,152600223,152993439,231726
4,ENSG00000180015.11,188738373,4-188619218-A-G,rs7675682,1,A,G,188619218,119155,188541765,188934981,77453
4,ENSG00000248571.1,152666368,4-152560583-G-T,rs7679788,1,G,T,152560583,105785,152469760,152862976,90823
4,ENSG00000249381.1,138425523,4-138347353-T-G,rs7687008,1,T,G,138347353,78170,138228915,138622131,118438
4,ENSG00000249381.1,138425523,4-138347353-T-C,rs7687008,1,T,C,138347353,78170,138228915,138622131,118438
4,ENSG00000249381.1,138425523,4-138347353-T-A,rs7687008,1,T,A,138347353,78170,138228915,138622131,118438
4,ENSG00000213370.3,173634371,4-173784891-T-C,rs7693514,-1,T,C,173784891,150520,173437763,173830979,347128
4,ENSG00000236941.3,164948079,4-164981898-G-T,rs7693977,1,G,T,164981898,33819,164751471,165144687,230427
4,ENSG00000236941.3,164948079,4-164981898-G-A,rs7693977,1,G,A,164981898,33819,164751471,165144687,230427
4,ENSG00000250950.1,119456350,4-119554303-C-T,rs7694856,1,C,T,119554303,97953,119259742,119652958,294561
4,ENSG00000250950.1,119456350,4-119554303-C-G,rs7694856,1,C,G,119554303,97953,119259742,119652958,294561
4,ENSG00000250950.1,119456350,4-119554303-C-A,rs7694856,1,C,A,119554303,97953,119259742,119652958,294561
4,ENSG00000250486.1,164956948,4-164949083-C-G,rs7695257,1,C,G,164949083,7865,164760340,165153556,188743
4,ENSG00000249245.1,145626035,4-145799037-G-T,rs77114606,-1,G,T,145799037,173002,145429427,145822643,369610
4,ENSG00000260244.1,155734448,4-155689837-G-A,rs77482346,1,G,A,155689837,44611,155537840,155931056,151997
4,ENSG00000250050.1,25719745,4-25911533-C-T,rs878552,-1,C,T,25911533,191788,25523137,25916353,388396
4,ENSG00000251230.1,184855751,4-184827040-A-G,rs9686055,-1,A,G,184827040,28711,184659143,185052359,167897
4,ENSG00000251230.1,184855751,4-184827040-A-T,rs9686055,-1,A,T,184827040,28711,184659143,185052359,167897
4,ENSG00000250566.1,68517647,4-68476451-G-A,rs983745,-1,G,A,68476451,41196,68321039,68714255,155412
4,ENSG00000250566.1,68517647,4-68476451-G-C,rs983745,-1,G,C,68476451,41196,68321039,68714255,155412
4,ENSG00000242640.1,25678850,4-25718602-C-A,rs9992023,1,C,A,25718602,39752,25482242,25875458,236360
4,ENSG00000242640.1,25678850,4-25718602-C-T,rs9992023,1,C,T,25718602,39752,25482242,25875458,236360
4,ENSG00000251463.1,118194751,4-118011803-T-G,rs9997637,-1,T,G,118011803,182948,117998143,118391359,13660
4,ENSG00000251463.1,118194751,4-118011803-T-C,rs9997637,-1,T,C,118011803,182948,117998143,118391359,13660
4,ENSG00000240005.1,26860650,4-26982131-C-T,rs9998009,-1,C,T,26982131,121481,26664042,27057258,318089
4,ENSG00000249717.1,74970362,4-75085045-C-T,rs10000988,-1,C,T,75085045,114683,74773754,75166970,311291
4,ENSG00000251333.2,145375543,4-145281807-T-A,rs10013431,1,T,A,145281807,93736,145178935,145572151,102872
4,ENSG00000177803.7,163932526,4-163987329-C-T,rs10019875,1,C,T,163987329,54803,163735918,164129134,251411
4,ENSG00000177803.7,163932526,4-163987329-C-A,rs10019875,1,C,A,163987329,54803,163735918,164129134,251411
4,ENSG00000224097.3,39480485,4-39521375-A-G,rs10025178,1,A,G,39521375,40890,39283877,39677093,237498
4,ENSG00000240005.1,26860650,4-26902591-G-A,rs10029307,-1,G,A,26902591,41941,26664042,27057258,238549
4,ENSG00000246375.2,88284883,4-88228090-C-T,rs10516805,1,C,T,88228090,56793,88088275,88481491,139815
4,ENSG00000249239.1,92822918,4-92725350-G-T,rs10516912,-1,G,T,92725350,97568,92626310,93019526,99040
4,ENSG00000260519.1,42657496,4-42617018-T-C,rs10517045,1,T,C,42617018,40478,42460888,42854104,156130
4,ENSG00000250413.1,10006482,4-10115177-T-C,rs10939710,1,T,C,10115177,108695,9809874,10203090,305303
4,ENSG00000227304.3,82495893,4-82592637-T-C,rs11099542,-1,T,C,82592637,96744,82299285,82692501,293352
4,ENSG00000227304.3,82495893,4-82592637-T-A,rs11099542,-1,T,A,82592637,96744,82299285,82692501,293352
4,ENSG00000227304.3,82495893,4-82592637-T-G,rs11099542,-1,T,G,82592637,96744,82299285,82692501,293352
4,ENSG00000242670.1,54221126,4-54228348-C-T,rs1135534,1,C,T,54228348,7222,54024518,54417734,203830
4,ENSG00000242670.1,54221126,4-54228348-C-A,rs1135534,1,C,A,54228348,7222,54024518,54417734,203830
4,ENSG00000241612.1,19813749,4-19623666-T-C,rs114389307,1,T,C,19623666,190083,19617141,20010357,6525
4,ENSG00000248890.1,144661357,4-144671207-T-C,rs114579528,-1,T,C,144671207,9850,144464749,144857965,206458
4,ENSG00000187653.10,90839037,4-90949829-A-G,rs115912636,-1,A,G,90949829,110792,90642429,91035645,307400
4,ENSG00000251464.1,110400511,4-110212797-C-T,rs116052489,-1,C,T,110212797,187714,110203903,110597119,8894
4,ENSG00000224207.2,102734358,4-102624096-C-T,rs11733293,1,C,T,102624096,110262,102537750,102930966,86346
4,ENSG00000180712.3,184353971,4-184353346-C-T,rs11946139,-1,C,T,184353346,625,184157363,184550579,195983
4,ENSG00000249334.1,10685003,4-10593163-C-T,rs12163882,1,C,T,10593163,91840,10488395,10881611,104768
4,ENSG00000241877.1,178286695,4-178414155-C-A,rs12498491,1,C,A,178414155,127460,178090087,178483303,324068
4,ENSG00000241877.1,178286695,4-178414155-C-T,rs12498491,1,C,T,178414155,127460,178090087,178483303,324068
4,ENSG00000251432.2,128292933,4-128421023-A-T,rs12499030,1,A,T,128421023,128090,128096325,128489541,324698
4,ENSG00000251676.1,131727587,4-131619714-C-T,rs13121110,1,C,T,131619714,107873,131530979,131924195,88735
4,ENSG00000251676.1,131727587,4-131619714-C-G,rs13121110,1,C,G,131619714,107873,131530979,131924195,88735
4,ENSG00000248019.2,88709789,4-88818977-G-A,rs13133548,1,G,A,88818977,109188,88513181,88906397,305796
4,ENSG00000248019.2,88709789,4-88818977-G-T,rs13133548,1,G,T,88818977,109188,88513181,88906397,305796
4,ENSG00000234801.2,173616906,4-173734865-A-G,rs13136342,-1,A,G,173734865,117959,173420298,173813514,314567
4,ENSG00000205959.3,8482270,4-8389132-G-A,rs13136987,1,G,A,8389132,93138,8285662,8678878,103470
4,ENSG00000228981.3,143350117,4-143193260-A-G,rs13140326,-1,A,G,143193260,156857,143153509,143546725,39751
4,ENSG00000251230.1,184855751,4-184855462-G-A,rs13144344,-1,G,A,184855462,289,184659143,185052359,196319
4,ENSG00000251429.1,158277758,4-158269138-C-G,rs1328925,1,C,G,158269138,8620,158081150,158474366,187988
4,ENSG00000251429.1,158277758,4-158269138-C-T,rs1328925,1,C,T,158269138,8620,158081150,158474366,187988
4,ENSG00000173966.7,53575713,4-53465539-A-G,rs13435672,1,A,G,53465539,110174,53379105,53772321,86434
4,ENSG00000249700.1,55395842,4-55313716-G-A,rs1399953,-1,G,A,55313716,82126,55199234,55592450,114482
4,ENSG00000249700.1,55395842,4-55313716-G-C,rs1399953,-1,G,C,55313716,82126,55199234,55592450,114482
4,ENSG00000248049.2,67701279,4-67787093-G-A,rs1440736,1,G,A,67787093,85814,67504671,67897887,282422
4,ENSG00000248795.1,138560704,4-138572244-A-G,rs1450439,1,A,G,138572244,11540,138364096,138757312,208148
4,ENSG00000250656.1,67717388,4-67765346-C-T,rs1484185,-1,C,T,67765346,47958,67520780,67913996,244566
4,ENSG00000250656.1,67717388,4-67765346-C-A,rs1484185,-1,C,A,67765346,47958,67520780,67913996,244566
4,ENSG00000248924.1,143555402,4-143634165-A-G,rs1553067,-1,A,G,143634165,78763,143358794,143752010,275371
4,ENSG00000247708.2,4542143,4-4568278-A-G,rs16835906,1,A,G,4568278,26135,4345535,4738751,222743
4,ENSG00000235413.3,17911674,4-18009579-A-G,rs16896261,1,A,G,18009579,97905,17715066,18108282,294513
4,ENSG00000260265.1,75084717,4-75072498-C-T,rs17000202,-1,C,T,75072498,12219,74888109,75281325,184389
4,ENSG00000249072.1,78008688,4-77997421-A-T,rs17002860,-1,A,T,77997421,11267,77812080,78205296,185341
4,ENSG00000251095.1,89410960,4-89560522-C-T,rs17015822,1,C,T,89560522,149562,89214352,89607568,346170
4,ENSG00000250185.1,108789779,4-108959574-A-G,rs17039583,-1,A,G,108959574,169795,108593171,108986387,366403
4,ENSG00000260296.1,40166675,4-40055669-C-A,rs1704157,1,C,A,40055669,111006,39970067,40363283,85602
4,ENSG00000260296.1,40166675,4-40055669-C-G,rs1704157,1,C,G,40055669,111006,39970067,40363283,85602
4,ENSG00000260296.1,40166675,4-40055669-C-T,rs1704157,1,C,T,40055669,111006,39970067,40363283,85602
4,ENSG00000244538.1,22594196,4-22471854-G-A,rs17533645,1,G,A,22471854,122342,22397588,22790804,74266
4,ENSG00000249464.1,123539451,4-123472443-A-G,rs17745658,1,A,G,123472443,67008,123342843,123736059,129600
4,ENSG00000251600.1,143559457,4-143652986-G-T,rs1826927,1,G,T,143652986,93529,143362849,143756065,290137
4,ENSG00000249679.1,185471495,4-185425085-C-A,rs2028701,1,C,A,185425085,46410,185274887,185668103,150198
4,ENSG00000243894.1,4077491,4-4169516-T-C,rs2368853,-1,T,C,4169516,92025,3880883,4274099,288633
4,ENSG00000243894.1,4077491,4-4169516-T-A,rs2368853,-1,T,A,4169516,92025,3880883,4274099,288633
4,ENSG00000249685.1,39133913,4-39051218-T-C,rs2566116,1,T,C,39051218,82695,38937305,39330521,113913
4,ENSG00000249685.1,39133913,4-39051218-T-G,rs2566116,1,T,G,39051218,82695,38937305,39330521,113913
4,ENSG00000249685.1,39133913,4-39051218-T-A,rs2566116,1,T,A,39051218,82695,38937305,39330521,113913
4,ENSG00000248283.1,42562425,4-42655406-T-A,rs2575441,-1,T,A,42655406,92981,42365817,42759033,289589
4,ENSG00000248283.1,42562425,4-42655406-T-C,rs2575441,-1,T,C,42655406,92981,42365817,42759033,289589
4,ENSG00000234492.3,108620413,4-108715192-C-T,rs2575625,-1,C,T,108715192,94779,108423805,108817021,291387
4,ENSG00000251483.1,110945799,4-110754822-T-A,rs2634075,-1,T,A,110754822,190977,110749191,111142407,5631
4,ENSG00000251483.1,110945799,4-110754822-T-G,rs2634075,-1,T,G,110754822,190977,110749191,111142407,5631
4,ENSG00000251483.1,110945799,4-110754822-T-C,rs2634075,-1,T,C,110754822,190977,110749191,111142407,5631
4,ENSG00000249509.1,112515431,4-112631355-T-C,rs28379270,1,T,C,112631355,115924,112318823,112712039,312532
4,ENSG00000250131.1,177442519,4-177392391-C-T,rs28438487,1,C,T,177392391,50128,177245911,177639127,146480
4,ENSG00000226950.2,52712501,4-52890833-G-A,rs2898681,1,G,A,52890833,178332,52515893,52909109,374940
4,ENSG00000243175.1,143425052,4-143362551-A-C,rs300920,1,A,C,143362551,62501,143228444,143621660,134107
4,ENSG00000243175.1,143425052,4-143362551-A-T,rs300920,1,A,T,143362551,62501,143228444,143621660,134107
4,ENSG00000243175.1,143425052,4-143362551-A-G,rs300920,1,A,G,143362551,62501,143228444,143621660,134107
4,ENSG00000250326.1,143184861,4-143251373-A-G,rs300937,-1,A,G,143251373,66512,142988253,143381469,263120
4,ENSG00000248375.1,52720831,4-52588572-A-C,rs346005,-1,A,C,52588572,132259,52524223,52917439,64349
4,ENSG00000248375.1,52720831,4-52588572-A-T,rs346005,-1,A,T,52588572,132259,52524223,52917439,64349
4,ENSG00000249006.1,2090617,4-2057013-T-C,rs35300779,-1,T,C,2057013,33604,1894009,2287225,163004
4,ENSG00000196810.3,1249451,4-1265862-A-G,rs3811733,1,A,G,1265862,16411,1052843,1446059,213019
4,ENSG00000181359.5,170605450,4-170598454-G-A,rs396067,-1,G,A,170598454,6996,170408842,170802058,189612
4,ENSG00000181359.5,170605450,4-170598454-G-T,rs396067,-1,G,T,170598454,6996,170408842,170802058,189612
4,ENSG00000249863.1,37868292,4-37777699-T-C,rs41457545,1,T,C,37777699,90593,37671684,38064900,106015
4,ENSG00000249241.1,40316484,4-40353109-C-T,rs4264869,1,C,T,40353109,36625,40119876,40513092,233233
4,ENSG00000249096.1,184382416,4-184357732-A-T,rs4326049,-1,A,T,184357732,24684,184185808,184579024,171924
4,ENSG00000249096.1,184382416,4-184357732-A-G,rs4326049,-1,A,G,184357732,24684,184185808,184579024,171924
4,ENSG00000242169.1,188350024,4-188167066-C-T,rs4349672,-1,C,T,188167066,182958,188153416,188546632,13650
4,ENSG00000236941.3,164948079,4-164938799-T-C,rs4359860,1,T,C,164938799,9280,164751471,165144687,187328
4,ENSG00000170846.11,6674075,4-6671735-C-T,rs4689506,1,C,T,6671735,2340,6477467,6870683,194268
4,ENSG00000170846.11,6674075,4-6671735-C-A,rs4689506,1,C,A,6671735,2340,6477467,6870683,194268
4,ENSG00000170846.11,6674075,4-6671735-C-G,rs4689506,1,C,G,6671735,2340,6477467,6870683,194268
4,ENSG00000213493.3,116598161,4-116563279-A-G,rs4834561,1,A,G,116563279,34882,116401553,116794769,161726
4,ENSG00000249212.1,42029209,4-42139371-C-T,rs4861164,1,C,T,42139371,110162,41832601,42225817,306770
4,ENSG00000260641.1,98658894,4-98703582-G-A,rs55633696,1,G,A,98703582,44688,98462286,98855502,241296
4,ENSG00000260641.1,98658894,4-98703582-G-T,rs55633696,1,G,T,98703582,44688,98462286,98855502,241296
4,ENSG00000198155.5,218650,4-177880-T-C,rs61794965,1,T,C,177880,40770,22042,415258,155838
4,ENSG00000198155.5,218650,4-177880-T-G,rs61794965,1,T,G,177880,40770,22042,415258,155838
4,ENSG00000249341.1,53659208,4-53642358-T-C,rs62325512,1,T,C,53642358,16850,53462600,53855816,179758
4,ENSG00000249341.1,53659208,4-53642358-T-A,rs62325512,1,T,A,53642358,16850,53462600,53855816,179758
4,ENSG00000243280.2,112171215,4-112001361-T-G,rs6820458,1,T,G,112001361,169854,111974607,112367823,26754
4,ENSG00000243280.2,112171215,4-112001361-T-C,rs6820458,1,T,C,112001361,169854,111974607,112367823,26754
4,ENSG00000249311.2,136356336,4-136418265-G-A,rs6821875,-1,G,A,136418265,61929,136159728,136552944,258537
4,ENSG00000249311.2,136356336,4-136418265-G-T,rs6821875,-1,G,T,136418265,61929,136159728,136552944,258537
4,ENSG00000214980.4,84244003,4-84161085-C-T,rs6824813,1,C,T,84161085,82918,84047395,84440611,113690
4,ENSG00000247193.2,36244116,4-36093897-G-A,rs6833926,1,G,A,36093897,150219,36047508,36440724,46389
4,ENSG00000251442.1,78638780,4-78724177-G-A,rs6858740,1,G,A,78724177,85397,78442172,78835388,282005
4,ENSG00000248785.1,109673843,4-109566920-G-A,rs72674807,1,G,A,109566920,106923,109477235,109870451,89685
4,ENSG00000234125.3,129903010,4-130098646-T-C,rs72678148,1,T,C,130098646,195636,129706402,130099618,392244
4,ENSG00000196951.5,140373384,4-140183275-T-C,rs73857954,-1,T,C,140183275,190109,140176776,140569992,6499
4,ENSG00000250486.1,164956948,4-164977530-C-T,rs74651789,1,C,T,164977530,20582,164760340,165153556,217190
4,ENSG00000248115.1,52945689,4-52869152-G-A,rs76418265,1,G,A,52869152,76537,52749081,53142297,120071
4,ENSG00000214988.4,82491635,4-82578160-C-T,rs7658637,-1,C,T,82578160,86525,82295027,82688243,283133
4,ENSG00000213480.3,121370345,4-121275875-T-G,rs7661816,-1,T,G,121275875,94470,121173737,121566953,102138
4,ENSG00000250902.1,145517118,4-145513528-C-T,rs7662541,-1,C,T,145513528,3590,145320510,145713726,193018
4,ENSG00000248641.1,73098822,4-72910192-G-C,rs7663967,1,G,C,72910192,188630,72902214,73295430,7978
4,ENSG00000248641.1,73098822,4-72910192-G-A,rs7663967,1,G,A,72910192,188630,72902214,73295430,7978
4,ENSG00000236296.2,143559487,4-143572565-G-T,rs7665370,1,G,T,143572565,13078,143362879,143756095,209686
4,ENSG00000236296.2,143559487,4-143572565-G-A,rs7665370,1,G,A,143572565,13078,143362879,143756095,209686
4,ENSG00000248697.1,112455924,4-112592782-T-C,rs7676983,1,T,C,112592782,136858,112259316,112652532,333466
4,ENSG00000260303.1,146056762,4-146075728-C-T,rs7677699,-1,C,T,146075728,18966,145860154,146253370,215574
4,ENSG00000243312.2,86870191,4-86833560-G-T,rs7678571,1,G,T,86833560,36631,86673583,87066799,159977
4,ENSG00000243312.2,86870191,4-86833560-G-A,rs7678571,1,G,A,86833560,36631,86673583,87066799,159977
4,ENSG00000250144.1,135045464,4-135142905-C-T,rs7694466,1,C,T,135142905,97441,134848856,135242072,294049
4,ENSG00000250144.1,135045464,4-135142905-C-G,rs7694466,1,C,G,135142905,97441,134848856,135242072,294049
4,ENSG00000251615.1,8358338,4-8366706-G-A,rs7809,-1,G,A,8366706,8368,8161730,8554946,204976
4,ENSG00000251615.1,8358338,4-8366706-G-T,rs7809,-1,G,T,8366706,8368,8161730,8554946,204976
4,ENSG00000249896.1,6227614,4-6304448-C-T,rs78801088,1,C,T,6304448,76834,6031006,6424222,273442
4,ENSG00000245954.2,152090459,4-152102831-C-T,rs890178,1,C,T,152102831,12372,151893851,152287067,208980
4,ENSG00000245954.2,152090459,4-152102831-C-G,rs890178,1,C,G,152102831,12372,151893851,152287067,208980
4,ENSG00000245954.2,152090459,4-152102831-C-A,rs890178,1,C,A,152102831,12372,151893851,152287067,208980
4,ENSG00000250566.1,68517647,4-68477569-A-G,rs976002,-1,A,G,68477569,40078,68321039,68714255,156530
4,ENSG00000234036.3,76959169,4-76830809-C-G,rs9790694,-1,C,G,76830809,128360,76762561,77155777,68248
4,ENSG00000234036.3,76959169,4-76830809-C-T,rs9790694,-1,C,T,76830809,128360,76762561,77155777,68248
3,ENSG00000239213.1,136862031,3-136846007-T-C,rs10470440,-1,T,C,136846007,16024,136665423,137058639,180584
3,ENSG00000239213.1,136862031,3-136846007-T-A,rs10470440,-1,T,A,136846007,16024,136665423,137058639,180584
3,ENSG00000244675.1,194501503,3-194505847-A-G,rs10933658,-1,A,G,194505847,4344,194304895,194698111,200952
3,ENSG00000244675.1,194501503,3-194505847-A-T,rs10933658,-1,A,T,194505847,4344,194304895,194698111,200952
3,ENSG00000227440.1,172829176,3-172816638-C-T,rs10936738,-1,C,T,172816638,12538,172632568,173025784,184070
3,ENSG00000189366.5,125990537,3-126107216-T-C,rs1127717,-1,T,C,126107216,116679,125793929,126187145,313287
3,ENSG00000243544.1,121654296,3-121788384-A-T,rs1141528,-1,A,T,121788384,134088,121457688,121850904,330696
3,ENSG00000227337.1,32785646,3-32593083-A-G,rs115055348,1,A,G,32593083,192563,32589038,32982254,4045
3,ENSG00000232065.1,196632700,3-196563292-A-G,rs115402043,-1,A,G,196563292,69408,196436092,196829308,127200
3,ENSG00000244026.1,75435110,3-75462213-G-T,rs116564766,-1,G,T,75462213,27103,75238502,75631718,223711
3,ENSG00000224094.1,45160175,3-45268225-C-T,rs11706314,-1,C,T,45268225,108050,44963567,45356783,304658
3,ENSG00000236182.1,188990135,3-189143739-A-G,rs11715904,-1,A,G,189143739,153604,188793527,189186743,350212
3,ENSG00000261488.1,112133423,3-112136804-T-C,rs11719485,1,T,C,112136804,3381,111936815,112330031,199989
3,ENSG00000224962.3,166691187,3-166623829-A-T,rs11916399,1,A,T,166623829,67358,166494579,166887795,129250
3,ENSG00000224962.3,166691187,3-166623829-A-G,rs11916399,1,A,G,166623829,67358,166494579,166887795,129250
3,ENSG00000213450.4,77317598,3-77196373-A-G,rs11918302,-1,A,G,77196373,121225,77120990,77514206,75383
3,ENSG00000229515.1,46143677,3-46122223-C-A,rs12330360,-1,C,A,46122223,21454,45947069,46340285,175154
3,ENSG00000229515.1,46143677,3-46122223-C-T,rs12330360,-1,C,T,46122223,21454,45947069,46340285,175154
3,ENSG00000228252.3,130212823,3-130135147-A-G,rs12496397,1,A,G,130135147,77676,130016215,130409431,118932
3,ENSG00000243339.1,196399911,3-196331924-A-C,rs12497601,1,A,C,196331924,67987,196203303,196596519,128621
3,ENSG00000243339.1,196399911,3-196331924-A-G,rs12497601,1,A,G,196331924,67987,196203303,196596519,128621
3,ENSG00000246082.2,131361930,3-131362037-C-T,rs12632774,1,C,T,131362037,107,131165322,131558538,196715
3,ENSG00000226642.1,12070195,3-11968241-C-A,rs13060219,1,C,A,11968241,101954,11873587,12266803,94654
3,ENSG00000226642.1,12070195,3-11968241-C-T,rs13060219,1,C,T,11968241,101954,11873587,12266803,94654
3,ENSG00000226642.1,12070195,3-11968241-C-G,rs13060219,1,C,G,11968241,101954,11873587,12266803,94654
3,ENSG00000173811.6,42732575,3-42791487-A-G,rs13061576,1,A,G,42791487,58912,42535967,42929183,255520
3,ENSG00000236297.1,193579413,3-193585746-G-A,rs13064790,-1,G,A,193585746,6333,193382805,193776021,202941
3,ENSG00000176243.9,96776945,3-96860471-T-C,rs13070471,1,T,C,96860471,83526,96580337,96973553,280134
3,ENSG00000228008.1,49903987,3-50025445-G-A,rs13071931,1,G,A,50025445,121458,49707379,50100595,318066
3,ENSG00000249786.1,15455940,3-15362062-G-A,rs13080491,-1,G,A,15362062,93878,15259332,15652548,102730
3,ENSG00000230457.3,156810732,3-156627036-G-A,rs13090418,-1,G,A,156627036,183696,156614124,157007340,12912
3,ENSG00000241095.1,82808021,3-82673157-A-G,rs13318849,-1,A,G,82673157,134864,82611413,83004629,61744
3,ENSG00000228242.1,14148402,3-14176076-G-A,rs1350344,1,G,A,14176076,27674,13951794,14345010,224282
3,ENSG00000250562.1,98525274,3-98536548-T-G,rs1350790,-1,T,G,98536548,11274,98328666,98721882,207882
3,ENSG00000250562.1,98525274,3-98536548-T-C,rs1350790,-1,T,C,98536548,11274,98328666,98721882,207882
3,ENSG00000250562.1,98525274,3-98536548-T-A,rs1350790,-1,T,A,98536548,11274,98328666,98721882,207882
3,ENSG00000198590.7,37385604,3-37467060-T-G,rs149815,1,T,G,37467060,81456,37188996,37582212,278064
3,ENSG00000198590.7,37385604,3-37467060-T-C,rs149815,1,T,C,37467060,81456,37188996,37582212,278064
3,ENSG00000240875.1,156817034,3-156789118-A-G,rs1529581,-1,A,G,156789118,27916,156620426,157013642,168692
3,ENSG00000231552.1,32621902,3-32456337-C-G,rs164216,-1,C,G,32456337,165565,32425294,32818510,31043
3,ENSG00000231552.1,32621902,3-32456337-C-A,rs164216,-1,C,A,32456337,165565,32425294,32818510,31043
3,ENSG00000231552.1,32621902,3-32456337-C-T,rs164216,-1,C,T,32456337,165565,32425294,32818510,31043
3,ENSG00000243150.1,158571066,3-158566892-G-C,rs1656376,-1,G,C,158566892,4174,158374458,158767674,192434
3,ENSG00000248839.1,98522570,3-98526788-C-T,rs1675521,1,C,T,98526788,4218,98325962,98719178,200826
3,ENSG00000248839.1,98522570,3-98526788-C-A,rs1675521,1,C,A,98526788,4218,98325962,98719178,200826
3,ENSG00000242052.1,119636150,3-119559693-G-C,rs16829984,-1,G,C,119559693,76457,119439542,119832758,120151
3,ENSG00000240567.1,161426427,3-161402695-C-T,rs16832279,1,C,T,161402695,23732,161229819,161623035,172876
3,ENSG00000250608.1,131381475,3-131359783-T-G,rs16836473,-1,T,G,131359783,21692,131184867,131578083,174916
3,ENSG00000224318.1,196721,3-244100-G-A,rs17012651,-1,G,A,244100,47379,113,393329,243987
3,ENSG00000213509.4,57941818,3-57970449-T-C,rs1718472,1,T,C,57970449,28631,57745210,58138426,225239
3,ENSG00000213509.4,57941818,3-57970449-T-A,rs1718472,1,T,A,57970449,28631,57745210,58138426,225239
3,ENSG00000213509.4,57941818,3-57970449-T-G,rs1718472,1,T,G,57970449,28631,57745210,58138426,225239
3,ENSG00000213157.3,180888075,3-180914186-T-G,rs1805583,-1,T,G,180914186,26111,180691467,181084683,222719
3,ENSG00000226845.1,40597494,3-40467766-A-G,rs185734649,-1,A,G,40467766,129728,40400886,40794102,66880
3,ENSG00000240063.1,182793394,3-182771173-A-G,rs1879986,-1,A,G,182771173,22221,182596786,182990002,174387
3,ENSG00000241472.1,62369356,3-62324026-G-T,rs1881269,-1,G,T,62324026,45330,62172748,62565964,151278
3,ENSG00000241472.1,62369356,3-62324026-G-A,rs1881269,-1,G,A,62324026,45330,62172748,62565964,151278
3,ENSG00000229589.1,38454820,3-38316326-C-T,rs2070492,-1,C,T,38316326,138494,38258212,38651428,58114
3,ENSG00000229589.1,38454820,3-38316326-C-G,rs2070492,-1,C,G,38316326,138494,38258212,38651428,58114
3,ENSG00000231770.1,194583991,3-194587350-A-T,rs2236593,1,A,T,194587350,3359,194387383,194780599,199967
3,ENSG00000231770.1,194583991,3-194587350-A-G,rs2236593,1,A,G,194587350,3359,194387383,194780599,199967
3,ENSG00000231770.1,194583991,3-194587350-A-C,rs2236593,1,A,C,194587350,3359,194387383,194780599,199967
3,ENSG00000241135.1,157089918,3-157099873-C-T,rs2306531,1,C,T,157099873,9955,156893310,157286526,206563
3,ENSG00000231249.1,4493201,3-4491276-T-A,rs2307068,-1,T,A,4491276,1925,4296593,4689809,194683
3,ENSG00000231249.1,4493201,3-4491276-T-C,rs2307068,-1,T,C,4491276,1925,4296593,4689809,194683
3,ENSG00000223387.2,172595607,3-172594475-T-C,rs234049,-1,T,C,172594475,1132,172398999,172792215,195476
3,ENSG00000244380.1,48446632,3-48597999-G-T,rs2633958,-1,G,T,48597999,151367,48250024,48643240,347975
3,ENSG00000244380.1,48446632,3-48597999-G-A,rs2633958,-1,G,A,48597999,151367,48250024,48643240,347975
3,ENSG00000175841.7,101521891,3-101350029-C-T,rs2682386,1,C,T,101350029,171862,101325283,101718499,24746
3,ENSG00000243795.1,113167819,3-113110595-G-T,rs2700201,-1,G,T,113110595,57224,112971211,113364427,139384
3,ENSG00000243795.1,113167819,3-113110595-G-A,rs2700201,-1,G,A,113110595,57224,112971211,113364427,139384
3,ENSG00000206573.4,9396654,3-9350175-G-A,rs2728936,-1,G,A,9350175,46479,9200046,9593262,150129
3,ENSG00000206573.4,9396654,3-9350175-G-T,rs2728936,-1,G,T,9350175,46479,9200046,9593262,150129
3,ENSG00000228168.1,39334979,3-39340332-C-A,rs2853717,1,C,A,39340332,5353,39138371,39531587,201961
3,ENSG00000249274.1,98782188,3-98962468-T-C,rs28637457,1,T,C,98962468,180280,98585580,98978796,376888
3,ENSG00000243176.1,157175269,3-157291124-C-T,rs2874616,1,C,T,157291124,115855,156978661,157371877,312463
3,ENSG00000243176.1,157175269,3-157291124-C-A,rs2874616,1,C,A,157291124,115855,156978661,157371877,312463
3,ENSG00000242992.2,128765018,3-128889498-T-G,rs2929859,-1,T,G,128889498,124480,128568410,128961626,321088
3,ENSG00000242992.2,128765018,3-128889498-T-A,rs2929859,-1,T,A,128889498,124480,128568410,128961626,321088
3,ENSG00000231305.3,128871540,3-128889498-T-G,rs2929859,-1,T,G,128889498,17958,128674932,129068148,214566
3,ENSG00000231305.3,128871540,3-128889498-T-A,rs2929859,-1,T,A,128889498,17958,128674932,129068148,214566
3,ENSG00000261159.1,128860526,3-128889498-T-G,rs2929859,-1,T,G,128889498,28972,128663918,129057134,225580
3,ENSG00000261159.1,128860526,3-128889498-T-A,rs2929859,-1,T,A,128889498,28972,128663918,129057134,225580
3,ENSG00000229178.1,195657927,3-195588069-C-T,rs34605848,-1,C,T,195588069,69858,195461319,195854535,126750
3,ENSG00000223899.1,33033863,3-33008095-A-T,rs35879433,1,A,T,33008095,25768,32837255,33230471,170840
3,ENSG00000231362.1,13053122,3-12995601-C-A,rs360835,-1,C,A,12995601,57521,12856514,13249730,139087
3,ENSG00000180385.4,9987904,3-9987605-A-G,rs3755783,1,A,G,9987605,299,9791296,10184512,196309
3,ENSG00000225733.1,14948424,3-15033517-C-A,rs3773483,-1,C,A,15033517,85093,14751816,15145032,281701
3,ENSG00000225733.1,14948424,3-15033517-C-T,rs3773483,-1,C,T,15033517,85093,14751816,15145032,281701
3,ENSG00000239653.1,64004022,3-63958308-A-G,rs3774718,1,A,G,63958308,45714,63807414,64200630,150894
3,ENSG00000239653.1,64004022,3-63958308-A-T,rs3774718,1,A,T,63958308,45714,63807414,64200630,150894
3,ENSG00000243224.1,52239256,3-52240726-A-C,rs4082828,1,A,C,52240726,1470,52042648,52435864,198078
3,ENSG00000243224.1,52239256,3-52240726-A-G,rs4082828,1,A,G,52240726,1470,52042648,52435864,198078
3,ENSG00000236062.1,12258460,3-12429164-G-A,rs4135361,-1,G,A,12429164,170704,12061852,12455068,367312
3,ENSG00000174912.6,156714928,3-156771933-C-T,rs41366145,-1,C,T,156771933,57005,156518320,156911536,253613
3,ENSG00000231443.2,195937243,3-195915283-G-A,rs4485751,1,G,A,195915283,21960,195740635,196133851,174648
3,ENSG00000229863.1,57134142,3-57152007-A-C,rs4535195,1,A,C,57152007,17865,56937534,57330750,214473
3,ENSG00000229863.1,57134142,3-57152007-A-T,rs4535195,1,A,T,57152007,17865,56937534,57330750,214473
3,ENSG00000240048.1,154354799,3-154454441-T-C,rs4679735,-1,T,C,154454441,99642,154158191,154551407,296250
3,ENSG00000251474.2,129397109,3-129590420-T-C,rs4688807,-1,T,C,129590420,193311,129200501,129593717,389919
3,ENSG00000235897.1,196318350,3-196275196-A-C,rs4916421,1,A,C,196275196,43154,196121742,196514958,153454
3,ENSG00000235897.1,196318350,3-196275196-A-G,rs4916421,1,A,G,196275196,43154,196121742,196514958,153454
3,ENSG00000235897.1,196318350,3-196275196-A-T,rs4916421,1,A,T,196275196,43154,196121742,196514958,153454
3,ENSG00000234287.1,40761545,3-40755254-G-A,rs4973910,1,G,A,40755254,6291,40564937,40958153,190317
3,ENSG00000234287.1,40761545,3-40755254-G-C,rs4973910,1,G,C,40755254,6291,40564937,40958153,190317
3,ENSG00000244515.1,157163932,3-157161331-T-A,rs5003893,-1,T,A,157161331,2601,156967324,157360540,194007
3,ENSG00000244515.1,157163932,3-157161331-T-G,rs5003893,-1,T,G,157161331,2601,156967324,157360540,194007
3,ENSG00000240024.1,183451741,3-183489766-T-C,rs55681827,1,T,C,183489766,38025,183255133,183648349,234633
3,ENSG00000224660.1,15254184,3-15362621-T-C,rs58163887,1,T,C,15362621,108437,15057576,15450792,305045
3,ENSG00000224660.1,15254184,3-15362621-T-A,rs58163887,1,T,A,15362621,108437,15057576,15450792,305045
3,ENSG00000229217.1,10058287,3-9884326-G-A,rs62247505,-1,G,A,9884326,173961,9861679,10254895,22647
3,ENSG00000243701.1,107240718,3-107182031-G-A,rs62322851,1,G,A,107182031,58687,107044110,107437326,137921
3,ENSG00000214301.4,133490824,3-133500935-G-T,rs6439416,1,G,T,133500935,10111,133294216,133687432,206719
3,ENSG00000214301.4,133490824,3-133500935-G-A,rs6439416,1,G,A,133500935,10111,133294216,133687432,206719
3,ENSG00000224614.1,195908076,3-195870678-G-A,rs6583266,1,G,A,195870678,37398,195711468,196104684,159210
3,ENSG00000224614.1,195908076,3-195870678-G-C,rs6583266,1,G,C,195870678,37398,195711468,196104684,159210
3,ENSG00000243276.1,118557668,3-118606867-C-A,rs6765182,-1,C,A,118606867,49199,118361060,118754276,245807
3,ENSG00000243276.1,118557668,3-118606867-C-G,rs6765182,-1,C,G,118606867,49199,118361060,118754276,245807
3,ENSG00000225770.1,196536532,3-196648269-T-G,rs6766451,1,T,G,196648269,111737,196339924,196733140,308345
3,ENSG00000232535.1,98306752,3-98213209-C-T,rs6771271,1,C,T,98213209,93543,98110144,98503360,103065
3,ENSG00000241679.2,143123362,3-143219661-T-G,rs6775385,1,T,G,143219661,96299,142926754,143319970,292907
3,ENSG00000224406.1,186493661,3-186478163-C-T,rs6776648,-1,C,T,186478163,15498,186297053,186690269,181110
3,ENSG00000224406.1,186493661,3-186478163-C-A,rs6776648,-1,C,A,186478163,15498,186297053,186690269,181110
3,ENSG00000224406.1,186493661,3-186478163-C-G,rs6776648,-1,C,G,186478163,15498,186297053,186690269,181110
3,ENSG00000243977.1,179650200,3-179588878-A-G,rs6784464,-1,A,G,179588878,61322,179453592,179846808,135286
3,ENSG00000230266.1,195147764,3-195106000-G-T,rs6785310,1,G,T,195106000,41764,194951156,195344372,154844
3,ENSG00000230266.1,195147764,3-195106000-G-C,rs6785310,1,G,C,195106000,41764,194951156,195344372,154844
3,ENSG00000230266.1,195147764,3-195106000-G-A,rs6785310,1,G,A,195106000,41764,194951156,195344372,154844
3,ENSG00000213964.3,11234582,3-11364453-T-G,rs6785396,-1,T,G,11364453,129871,11037974,11431190,326479
3,ENSG00000241155.1,119322760,3-119313513-C-G,rs6786522,-1,C,G,119313513,9247,119126152,119519368,187361
3,ENSG00000241155.1,119322760,3-119313513-C-T,rs6786522,-1,C,T,119313513,9247,119126152,119519368,187361
3,ENSG00000229759.1,48256938,3-48156124-A-C,rs6797587,-1,A,C,48156124,100814,48060330,48453546,95794
3,ENSG00000229759.1,48256938,3-48156124-A-G,rs6797587,-1,A,G,48156124,100814,48060330,48453546,95794
3,ENSG00000229759.1,48256938,3-48156124-A-T,rs6797587,-1,A,T,48156124,100814,48060330,48453546,95794
3,ENSG00000223797.1,40453186,3-40451727-G-T,rs6801859,-1,G,T,40451727,1459,40256578,40649794,195149
3,ENSG00000260743.1,179340322,3-179340714-A-G,rs6805876,1,A,G,179340714,392,179143714,179536930,197000
3,ENSG00000260743.1,179340322,3-179340714-A-T,rs6805876,1,A,T,179340714,392,179143714,179536930,197000
3,ENSG00000243547.1,96349554,3-96526951-T-C,rs691307,1,T,C,96526951,177397,96152946,96546162,374005
3,ENSG00000243547.1,96349554,3-96526951-T-A,rs691307,1,T,A,96526951,177397,96152946,96546162,374005
3,ENSG00000243410.1,64011964,3-64121009-G-A,rs704381,1,G,A,64121009,109045,63815356,64208572,305653
3,ENSG00000243410.1,64011964,3-64121009-G-C,rs704381,1,G,C,64121009,109045,63815356,64208572,305653
3,ENSG00000243410.1,64011964,3-64121009-G-T,rs704381,1,G,T,64121009,109045,63815356,64208572,305653
3,ENSG00000241810.1,153067278,3-153200740-C-T,rs72616700,1,C,T,153200740,133462,152870670,153263886,330070
3,ENSG00000241810.1,153067278,3-153200740-C-G,rs72616700,1,C,G,153200740,133462,152870670,153263886,330070
3,ENSG00000241810.1,153067278,3-153200740-C-A,rs72616700,1,C,A,153200740,133462,152870670,153263886,330070
3,ENSG00000241544.1,157081738,3-157089639-G-A,rs73170828,1,G,A,157089639,7901,156885130,157278346,204509
3,ENSG00000243629.1,157128595,3-157089639-G-A,rs73170828,-1,G,A,157089639,38956,156931987,157325203,157652
3,ENSG00000226779.1,175271096,3-175276724-A-G,rs73184717,-1,A,G,175276724,5628,175074488,175467704,202236
3,ENSG00000249846.1,130112547,3-130123032-G-A,rs73210765,1,G,A,130123032,10485,129915939,130309155,207093
3,ENSG00000214135.4,197627848,3-197608945-C-T,rs73891640,-1,C,T,197608945,18903,197431240,197824456,177705
3,ENSG00000243422.1,75625153,3-75787707-A-G,rs7427663,-1,A,G,75787707,162554,75428545,75821761,359162
3,ENSG00000243635.1,104502700,3-104557500-T-C,rs74670539,1,T,C,104557500,54800,104306092,104699308,251408
3,ENSG00000213178.3,169484080,3-169641564-A-G,rs74756127,-1,A,G,169641564,157484,169287472,169680688,354092
3,ENSG00000213178.3,169484080,3-169641564-A-T,rs74756127,-1,A,T,169641564,157484,169287472,169680688,354092
3,ENSG00000237433.1,32190747,3-32107224-G-T,rs748607,1,G,T,32107224,83523,31994139,32387355,113085
3,ENSG00000215837.6,195658096,3-195592384-G-A,rs75041105,1,G,A,195592384,65712,195461488,195854704,130896
3,ENSG00000215837.6,195658096,3-195592384-G-C,rs75041105,1,G,C,195592384,65712,195461488,195854704,130896
3,ENSG00000214280.3,139583593,3-139673526-T-C,rs7639511,-1,T,C,139673526,89933,139386985,139780201,286541
3,ENSG00000214280.3,139583593,3-139673526-T-A,rs7639511,-1,T,A,139673526,89933,139386985,139780201,286541
3,ENSG00000233597.3,142044198,3-141979030-C-T,rs7642874,-1,C,T,141979030,65168,141847590,142240806,131440
3,ENSG00000241537.1,72772539,3-72928689-A-G,rs7643262,1,A,G,72928689,156150,72575931,72969147,352758
3,ENSG00000244161.1,58170636,3-58115042-C-T,rs7653042,-1,C,T,58115042,55594,57974028,58367244,141014
3,ENSG00000180438.10,14064203,3-13978795-A-G,rs76732393,1,A,G,13978795,85408,13867595,14260811,111200
3,ENSG00000180438.10,14064203,3-13978795-A-T,rs76732393,1,A,T,13978795,85408,13867595,14260811,111200
3,ENSG00000241280.1,101960358,3-102100163-T-C,rs78082945,1,T,C,102100163,139805,101763750,102156966,336413
3,ENSG00000239351.1,149939799,3-150067426-A-G,rs79469600,-1,A,G,150067426,127627,149743191,150136407,324235
3,ENSG00000238278.3,75415070,3-75329768-T-C,rs79540395,1,T,C,75329768,85302,75218462,75611678,111306
3,ENSG00000260261.1,195954485,3-195910763-T-C,rs80090804,-1,T,C,195910763,43722,195757877,196151093,152886
3,ENSG00000239445.1,98732757,3-98756235-G-T,rs893831,-1,G,T,98756235,23478,98536149,98929365,220086
3,ENSG00000248243.1,130094304,3-129995529-C-T,rs9289349,-1,C,T,129995529,98775,129897696,130290912,97833
3,ENSG00000253540.1,130111472,3-130225286-C-T,rs9289367,-1,C,T,130225286,113814,129914864,130308080,310422
3,ENSG00000243926.1,156674446,3-156672158-T-G,rs9289971,-1,T,G,156672158,2288,156477838,156871054,194320
3,ENSG00000243926.1,156674446,3-156672158-T-C,rs9289971,-1,T,C,156672158,2288,156477838,156871054,194320
3,ENSG00000213431.4,100912175,3-100804515-G-A,rs9290224,-1,G,A,100804515,107660,100715567,101108783,88948
3,ENSG00000181260.8,179464346,3-179288845-T-C,rs9290675,1,T,C,179288845,175501,179267738,179660954,21107
3,ENSG00000181260.8,179464346,3-179288845-T-G,rs9290675,1,T,G,179288845,175501,179267738,179660954,21107
3,ENSG00000241163.1,72279503,3-72167677-T-C,rs9310237,-1,T,C,72167677,111826,72082895,72476111,84782
3,ENSG00000224769.1,195614947,3-195595052-T-A,rs9330981,1,T,A,195595052,19895,195418339,195811555,176713
3,ENSG00000224769.1,195614947,3-195595052-T-G,rs9330981,1,T,G,195595052,19895,195418339,195811555,176713
3,ENSG00000224769.1,195614947,3-195595052-T-C,rs9330981,1,T,C,195595052,19895,195418339,195811555,176713
3,ENSG00000178631.7,139493809,3-139650925-T-A,rs9814679,1,T,A,139650925,157116,139297201,139690417,353724
3,ENSG00000228638.1,48291375,3-48278068-C-T,rs9819094,-1,C,T,48278068,13307,48094767,48487983,183301
3,ENSG00000171084.11,125916624,3-125902007-G-C,rs9821905,1,G,C,125902007,14617,125720016,126113232,181991
3,ENSG00000171084.11,125916624,3-125902007-G-A,rs9821905,1,G,A,125902007,14617,125720016,126113232,181991
3,ENSG00000261758.1,136752630,3-136695479-C-A,rs9836231,1,C,A,136695479,57151,136556022,136949238,139457
3,ENSG00000261758.1,136752630,3-136695479-C-T,rs9836231,1,C,T,136695479,57151,136556022,136949238,139457
3,ENSG00000261758.1,136752630,3-136695479-C-G,rs9836231,1,C,G,136695479,57151,136556022,136949238,139457
3,ENSG00000239219.1,169966240,3-169966645-G-A,rs9836316,-1,G,A,169966645,405,169769632,170162848,197013
3,ENSG00000244193.1,169946754,3-169964847-T-C,rs9845868,-1,T,C,169964847,18093,169750146,170143362,214701
3,ENSG00000189229.10,6490512,3-6404581-G-C,rs9847933,1,G,C,6404581,85931,6293904,6687120,110677
3,ENSG00000241316.2,67654758,3-67590798-G-A,rs9856689,1,G,A,67590798,63960,67458150,67851366,132648
3,ENSG00000241472.1,62369356,3-62220565-T-C,rs10510873,-1,T,C,62220565,148791,62172748,62565964,47817
3,ENSG00000223387.2,172595607,3-172654731-C-T,rs10513704,-1,C,T,172654731,59124,172398999,172792215,255732
3,ENSG00000241532.1,75654773,3-75471929-T-C,rs111237405,-1,T,C,75471929,182844,75458165,75851381,13764
3,ENSG00000241095.1,82808021,3-82642668-T-C,rs11127782,-1,T,C,82642668,165353,82611413,83004629,31255
3,ENSG00000233544.1,24555834,3-24691402-C-A,rs11129160,1,C,A,24691402,135568,24359226,24752442,332176
3,ENSG00000233544.1,24555834,3-24691402-C-G,rs11129160,1,C,G,24691402,135568,24359226,24752442,332176
3,ENSG00000233544.1,24555834,3-24691402-C-T,rs11129160,1,C,T,24691402,135568,24359226,24752442,332176
3,ENSG00000241634.1,108543875,3-108455039-T-G,rs113861932,-1,T,G,108455039,88836,108347267,108740483,107772
3,ENSG00000240057.1,113019468,3-112890034-T-G,rs114316866,1,T,G,112890034,129434,112822860,113216076,67174
3,ENSG00000235947.1,4751590,3-4591709-A-G,rs114517240,-1,A,G,4591709,159881,4554982,4948198,36727
3,ENSG00000221883.2,48918823,3-49114756-A-G,rs114570156,-1,A,G,49114756,195933,48722215,49115431,392541
3,ENSG00000242086.2,195708183,3-195576862-C-G,rs114682124,1,C,G,195576862,131321,195511575,195904791,65287
3,ENSG00000240207.1,158732327,3-158584757-A-G,rs116650534,1,A,G,158584757,147570,158535719,158928935,49038
3,ENSG00000236833.1,197665757,3-197577055-G-A,rs11712069,-1,G,A,197577055,88702,197469149,197862365,107906
3,ENSG00000224318.1,196721,3-216440-A-G,rs11714407,-1,A,G,216440,19719,113,393329,216327
3,ENSG00000224318.1,196721,3-216440-A-T,rs11714407,-1,A,T,216440,19719,113,393329,216327
3,ENSG00000249474.1,101824998,3-101794838-G-A,rs11714444,-1,G,A,101794838,30160,101628390,102021606,166448
3,ENSG00000249474.1,101824998,3-101794838-G-T,rs11714444,-1,G,T,101794838,30160,101628390,102021606,166448
3,ENSG00000239797.1,145824739,3-145643569-A-G,rs11714523,-1,A,G,145643569,181170,145628131,146021347,15438
3,ENSG00000256628.1,101676424,3-101833709-G-C,rs11718446,1,G,C,101833709,157285,101479816,101873032,353893
3,ENSG00000256628.1,101676424,3-101833709-G-A,rs11718446,1,G,A,101833709,157285,101479816,101873032,353893
3,ENSG00000250983.1,133546272,3-133386793-C-T,rs1197299,-1,C,T,133386793,159479,133349664,133742880,37129
3,ENSG00000241280.1,101960358,3-101951056-T-G,rs12630403,1,T,G,101951056,9302,101763750,102156966,187306
3,ENSG00000242609.1,72086888,3-71986686-T-G,rs13058906,1,T,G,71986686,100202,71890280,72283496,96406
3,ENSG00000228168.1,39334979,3-39276422-T-C,rs13062158,1,T,C,39276422,58557,39138371,39531587,138051
3,ENSG00000228168.1,39334979,3-39276422-T-A,rs13062158,1,T,A,39276422,58557,39138371,39531587,138051
3,ENSG00000228168.1,39334979,3-39276422-T-G,rs13062158,1,T,G,39276422,58557,39138371,39531587,138051
3,ENSG00000171658.4,185960039,3-186125184-T-C,rs13068514,1,T,C,186125184,165145,185763431,186156647,361753
3,ENSG00000240137.1,150704962,3-150711344-C-G,rs13074670,1,C,G,150711344,6382,150508354,150901570,202990
3,ENSG00000240137.1,150704962,3-150711344-C-A,rs13074670,1,C,A,150711344,6382,150508354,150901570,202990
3,ENSG00000240890.2,132386522,3-132291101-C-T,rs13077557,1,C,T,132291101,95421,132189914,132583130,101187
3,ENSG00000240890.2,132386522,3-132291101-C-A,rs13077557,1,C,A,132291101,95421,132189914,132583130,101187
3,ENSG00000240890.2,132386522,3-132291101-C-G,rs13077557,1,C,G,132291101,95421,132189914,132583130,101187
3,ENSG00000225733.1,14948424,3-14958114-G-A,rs13097792,-1,G,A,14958114,9690,14751816,15145032,206298
3,ENSG00000224831.2,149983308,3-150126389-G-A,rs1386288,-1,G,A,150126389,143081,149786700,150179916,339689
3,ENSG00000228252.3,130212823,3-130290494-A-G,rs1453238,1,A,G,130290494,77671,130016215,130409431,274279
3,ENSG00000228252.3,130212823,3-130290494-A-T,rs1453238,1,A,T,130290494,77671,130016215,130409431,274279
3,ENSG00000228252.3,130212823,3-130290494-A-C,rs1453238,1,A,C,130290494,77671,130016215,130409431,274279
3,ENSG00000261488.1,112133423,3-112122499-T-C,rs1492488,1,T,C,112122499,10924,111936815,112330031,185684
3,ENSG00000261488.1,112133423,3-112122499-T-G,rs1492488,1,T,G,112122499,10924,111936815,112330031,185684
3,ENSG00000241490.1,114214391,3-114254744-A-G,rs1503671,1,A,G,114254744,40353,114017783,114410999,236961
3,ENSG00000243926.1,156674446,3-156582935-C-T,rs1510272,-1,C,T,156582935,91511,156477838,156871054,105097
3,ENSG00000243926.1,156674446,3-156582935-C-G,rs1510272,-1,C,G,156582935,91511,156477838,156871054,105097
3,ENSG00000175841.7,101521891,3-101557058-A-C,rs1609159,1,A,C,101557058,35167,101325283,101718499,231775
3,ENSG00000182921.9,73183291,3-73247297-G-A,rs17010662,-1,G,A,73247297,64006,72986683,73379899,260614
3,ENSG00000213300.4,75214631,3-75315279-T-C,rs17028130,1,T,C,75315279,100648,75018023,75411239,297256
3,ENSG00000214041.3,9348443,3-9513739-T-C,rs17050417,1,T,C,9513739,165296,9151835,9545051,361904
3,ENSG00000225873.1,44421811,3-44460092-T-C,rs17076745,-1,T,C,44460092,38281,44225203,44618419,234889
3,ENSG00000203644.2,129847957,3-129952001-A-T,rs1708891,-1,A,T,129952001,104044,129651349,130044565,300652
3,ENSG00000227578.1,15141380,3-15240721-T-G,rs17480974,1,T,G,15240721,99341,14944772,15337988,295949
3,ENSG00000234661.1,385795,3-329404-G-A,rs17526472,-1,G,A,329404,56391,189187,582403,140217
3,ENSG00000224426.1,172604006,3-172528874-A-G,rs17601592,-1,A,G,172528874,75132,172407398,172800614,121476
3,ENSG00000229863.1,57134142,3-57124220-A-G,rs1817691,1,A,G,57124220,9922,56937534,57330750,186686
3,ENSG00000229863.1,57134142,3-57124220-A-C,rs1817691,1,A,C,57124220,9922,56937534,57330750,186686
3,ENSG00000249274.1,98782188,3-98800637-G-A,rs1822017,1,G,A,98800637,18449,98585580,98978796,215057
3,ENSG00000237433.1,32190747,3-32123843-C-T,rs1839778,1,C,T,32123843,66904,31994139,32387355,129704
3,ENSG00000243176.1,157175269,3-157197861-C-A,rs2133952,1,C,A,157197861,22592,156978661,157371877,219200
3,ENSG00000243176.1,157175269,3-157197861-C-T,rs2133952,1,C,T,157197861,22592,156978661,157371877,219200
3,ENSG00000243176.1,157175269,3-157197861-C-G,rs2133952,1,C,G,157197861,22592,156978661,157371877,219200
3,ENSG00000260261.1,195954485,3-195801355-C-T,rs2641773,-1,C,T,195801355,153130,195757877,196151093,43478
3,ENSG00000260261.1,195954485,3-195801355-C-G,rs2641773,-1,C,G,195801355,153130,195757877,196151093,43478
3,ENSG00000260261.1,195954485,3-195801355-C-A,rs2641773,-1,C,A,195801355,153130,195757877,196151093,43478
3,ENSG00000253540.1,130111472,3-129993136-C-A,rs2670905,-1,C,A,129993136,118336,129914864,130308080,78272
3,ENSG00000206573.4,9396654,3-9347893-G-T,rs2728939,-1,G,T,9347893,48761,9200046,9593262,147847
3,ENSG00000206573.4,9396654,3-9347893-G-A,rs2728939,-1,G,A,9347893,48761,9200046,9593262,147847
3,ENSG00000206573.4,9396654,3-9347893-G-C,rs2728939,-1,G,C,9347893,48761,9200046,9593262,147847
3,ENSG00000249846.1,130112547,3-129989351-A-T,rs2896588,1,A,T,129989351,123196,129915939,130309155,73412
3,ENSG00000243276.1,118557668,3-118500126-T-C,rs2946820,-1,T,C,118500126,57542,118361060,118754276,139066
3,ENSG00000238278.3,75415070,3-75456899-G-T,rs2976084,1,G,T,75456899,41829,75218462,75611678,238437
3,ENSG00000238278.3,75415070,3-75456899-G-A,rs2976084,1,G,A,75456899,41829,75218462,75611678,238437
3,ENSG00000198590.7,37385604,3-37248331-C-T,rs336597,1,C,T,37248331,137273,37188996,37582212,59335
3,ENSG00000198590.7,37385604,3-37248331-C-G,rs336597,1,C,G,37248331,137273,37188996,37582212,59335
3,ENSG00000236409.1,47011542,3-47101633-T-C,rs34173174,1,T,C,47101633,90091,46814934,47208150,286699
3,ENSG00000236409.1,47011542,3-47101633-T-G,rs34173174,1,T,G,47101633,90091,46814934,47208150,286699
3,ENSG00000240875.1,156817034,3-156788335-A-C,rs34354387,-1,A,C,156788335,28699,156620426,157013642,167909
3,ENSG00000233912.1,5187329,3-5221678-A-T,rs3889536,-1,A,T,5221678,34349,4990721,5383937,230957
3,ENSG00000233912.1,5187329,3-5221678-A-G,rs3889536,-1,A,G,5221678,34349,4990721,5383937,230957
3,ENSG00000173811.6,42732575,3-42735029-C-T,rs3907218,1,C,T,42735029,2454,42535967,42929183,199062
3,ENSG00000173811.6,42732575,3-42735029-C-G,rs3907218,1,C,G,42735029,2454,42535967,42929183,199062
3,ENSG00000261167.1,131458598,3-131535588-T-G,rs4241351,-1,T,G,131535588,76990,131261990,131655206,273598
3,ENSG00000261167.1,131458598,3-131535588-T-C,rs4241351,-1,T,C,131535588,76990,131261990,131655206,273598
3,ENSG00000261167.1,131458598,3-131535588-T-A,rs4241351,-1,T,A,131535588,76990,131261990,131655206,273598
3,ENSG00000226779.1,175271096,3-175233966-T-C,rs4371530,-1,T,C,175233966,37130,175074488,175467704,159478
3,ENSG00000226779.1,175271096,3-175233966-T-A,rs4371530,-1,T,A,175233966,37130,175074488,175467704,159478
3,ENSG00000233597.3,142044198,3-142202017-G-A,rs4630960,-1,G,A,142202017,157819,141847590,142240806,354427
3,ENSG00000233597.3,142044198,3-142202017-G-C,rs4630960,-1,G,C,142202017,157819,141847590,142240806,354427
3,ENSG00000244026.1,75435110,3-75347667-T-A,rs4677001,-1,T,A,75347667,87443,75238502,75631718,109165
3,ENSG00000244026.1,75435110,3-75347667-T-C,rs4677001,-1,T,C,75347667,87443,75238502,75631718,109165
3,ENSG00000244026.1,75435110,3-75347667-T-G,rs4677001,-1,T,G,75347667,87443,75238502,75631718,109165
3,ENSG00000230266.1,195147764,3-195153563-T-C,rs4677662,1,T,C,195153563,5799,194951156,195344372,202407
3,ENSG00000171084.11,125916624,3-125910985-A-C,rs4679199,1,A,C,125910985,5639,125720016,126113232,190969
3,ENSG00000171084.11,125916624,3-125910985-A-G,rs4679199,1,A,G,125910985,5639,125720016,126113232,190969
3,ENSG00000250562.1,98525274,3-98553117-T-C,rs4857401,-1,T,C,98553117,27843,98328666,98721882,224451
3,ENSG00000239445.1,98732757,3-98713715-C-A,rs4857414,-1,C,A,98713715,19042,98536149,98929365,177566
3,ENSG00000239445.1,98732757,3-98713715-C-T,rs4857414,-1,C,T,98713715,19042,98536149,98929365,177566
3,ENSG00000239445.1,98732757,3-98713715-C-G,rs4857414,-1,C,G,98713715,19042,98536149,98929365,177566
3,ENSG00000213431.4,100912175,3-100766607-A-G,rs544500,-1,A,G,100766607,145568,100715567,101108783,51040
3,ENSG00000248243.1,130094304,3-129976871-T-C,rs5660,-1,T,C,129976871,117433,129897696,130290912,79175
3,ENSG00000232953.1,19943310,3-19774465-T-A,rs57024137,-1,T,A,19774465,168845,19746702,20139918,27763
3,ENSG00000214135.4,197627848,3-197443250-G-T,rs58339845,-1,G,T,197443250,184598,197431240,197824456,12010
3,ENSG00000218754.4,96619304,3-96812115-T-C,rs61138285,1,T,C,96812115,192811,96422696,96815912,389419
3,ENSG00000243795.1,113167819,3-113175492-T-C,rs62264196,-1,T,C,113175492,7673,112971211,113364427,204281
3,ENSG00000227440.1,172829176,3-172700394-T-A,rs645253,-1,T,A,172700394,128782,172632568,173025784,67826
3,ENSG00000227440.1,172829176,3-172700394-T-G,rs645253,-1,T,G,172700394,128782,172632568,173025784,67826
3,ENSG00000239653.1,64004022,3-64034771-C-T,rs6764606,1,C,T,64034771,30749,63807414,64200630,227357
3,ENSG00000243544.1,121654296,3-121846142-G-A,rs6767409,-1,G,A,121846142,191846,121457688,121850904,388454
3,ENSG00000184100.5,160100850,3-160113125-A-T,rs6770541,1,A,T,160113125,12275,159904242,160297458,208883
3,ENSG00000230530.1,45689179,3-45779015-C-G,rs6771661,-1,C,G,45779015,89836,45492571,45885787,286444
3,ENSG00000230530.1,45689179,3-45779015-C-T,rs6771661,-1,C,T,45779015,89836,45492571,45885787,286444
3,ENSG00000230454.1,50260303,3-50278688-T-C,rs6776145,1,T,C,50278688,18385,50063695,50456911,214993
3,ENSG00000224728.1,15878047,3-16020301-A-G,rs6777375,1,A,G,16020301,142254,15681439,16074655,338862
3,ENSG00000224728.1,15878047,3-16020301-A-C,rs6777375,1,A,C,16020301,142254,15681439,16074655,338862
3,ENSG00000250608.1,131381475,3-131362327-T-C,rs6779782,-1,T,C,131362327,19148,131184867,131578083,177460
3,ENSG00000189366.5,125990537,3-126079070-G-A,rs6796610,-1,G,A,126079070,88533,125793929,126187145,285141
3,ENSG00000236768.1,48121215,3-48132720-A-G,rs6800730,-1,A,G,48132720,11505,47924607,48317823,208113
3,ENSG00000224080.1,37143958,3-37269358-T-G,rs6800932,-1,T,G,37269358,125400,36947350,37340566,322008
3,ENSG00000241810.1,153067278,3-152898574-T-C,rs6808965,1,T,C,152898574,168704,152870670,153263886,27904
3,ENSG00000206120.6,168249941,3-168323059-G-T,rs71304676,1,G,T,168323059,73118,168053333,168446549,269726
3,ENSG00000243150.1,158571066,3-158540873-A-G,rs73154331,-1,A,G,158540873,30193,158374458,158767674,166415
3,ENSG00000224094.1,45160175,3-45249267-T-C,rs731610,-1,T,C,45249267,89092,44963567,45356783,285700
3,ENSG00000233885.1,183809515,3-183924553-C-T,rs73179625,-1,C,T,183924553,115038,183612907,184006123,311646
3,ENSG00000215837.6,195658096,3-195588458-G-T,rs73212260,1,G,T,195588458,69638,195461488,195854704,126970
3,ENSG00000215837.6,195658096,3-195588458-G-A,rs73212260,1,G,A,195588458,69638,195461488,195854704,126970
3,ENSG00000243629.1,157128595,3-157103560-G-T,rs74563697,-1,G,T,157103560,25035,156931987,157325203,171573
3,ENSG00000231305.3,128871540,3-128720336-C-T,rs75198802,-1,C,T,128720336,151204,128674932,129068148,45404
3,ENSG00000242759.1,107240663,3-107275222-C-T,rs75357977,-1,C,T,107275222,34559,107044055,107437271,231167
3,ENSG00000259970.1,49684983,3-49703017-C-T,rs76100153,-1,C,T,49703017,18034,49488375,49881591,214642
3,ENSG00000224660.1,15254184,3-15353512-T-C,rs7614350,1,T,C,15353512,99328,15057576,15450792,295936
3,ENSG00000206549.7,46812574,3-46726984-C-T,rs7626129,-1,C,T,46726984,85590,46615966,47009182,111018
3,ENSG00000230077.1,189969861,3-189900707-G-T,rs7628595,-1,G,T,189900707,69154,189773253,190166469,127454
3,ENSG00000230077.1,189969861,3-189900707-G-A,rs7628595,-1,G,A,189900707,69154,189773253,190166469,127454
3,ENSG00000236357.1,176068908,3-175877905-G-C,rs7630143,-1,G,C,175877905,191003,175872300,176265516,5605
3,ENSG00000236357.1,176068908,3-175877905-G-A,rs7630143,-1,G,A,175877905,191003,175872300,176265516,5605
3,ENSG00000260572.1,160755142,3-160926617-G-T,rs7633319,-1,G,T,160926617,171475,160558534,160951750,368083
3,ENSG00000227110.2,8501672,3-8486745-A-G,rs7647092,-1,A,G,8486745,14927,8305064,8698280,181681
3,ENSG00000227110.2,8501672,3-8486745-A-T,rs7647092,-1,A,T,8486745,14927,8305064,8698280,181681
3,ENSG00000236297.1,193579413,3-193706317-C-A,rs7650095,-1,C,A,193706317,126904,193382805,193776021,323512
3,ENSG00000236297.1,193579413,3-193706317-C-T,rs7650095,-1,C,T,193706317,126904,193382805,193776021,323512
3,ENSG00000243547.1,96349554,3-96199527-G-A,rs7650647,1,G,A,96199527,150027,96152946,96546162,46581
3,ENSG00000229704.1,185246441,3-185408583-A-G,rs78358809,-1,A,G,185408583,162142,185049833,185443049,358750
3,ENSG00000251178.1,130035539,3-129934839-G-A,rs784734,-1,G,A,129934839,100700,129838931,130232147,95908
3,ENSG00000251178.1,130035539,3-129934839-G-T,rs784734,-1,G,T,129934839,100700,129838931,130232147,95908
3,ENSG00000251178.1,130035539,3-129934839-G-C,rs784734,-1,G,C,129934839,100700,129838931,130232147,95908
3,ENSG00000235831.2,4980414,3-5000306-C-A,rs78704849,-1,C,A,5000306,19892,4783806,5177022,216500
3,ENSG00000187900.4,98238352,3-98392143-G-C,rs79116017,1,G,C,98392143,153791,98041744,98434960,350399
3,ENSG00000243635.1,104502700,3-104645012-A-G,rs796589,1,A,G,104645012,142312,104306092,104699308,338920
3,ENSG00000243635.1,104502700,3-104645012-A-T,rs796589,1,A,T,104645012,142312,104306092,104699308,338920
3,ENSG00000224769.1,195614947,3-195614166-G-A,rs869984,1,G,A,195614166,781,195418339,195811555,195827
3,ENSG00000224769.1,195614947,3-195614166-G-C,rs869984,1,G,C,195614166,781,195418339,195811555,195827
3,ENSG00000235897.1,196318350,3-196237427-A-T,rs884534,1,A,T,196237427,80923,196121742,196514958,115685
3,ENSG00000235897.1,196318350,3-196237427-A-G,rs884534,1,A,G,196237427,80923,196121742,196514958,115685
3,ENSG00000235897.1,196318350,3-196237427-A-C,rs884534,1,A,C,196237427,80923,196121742,196514958,115685
3,ENSG00000249786.1,15455940,3-15629519-C-T,rs9310479,-1,C,T,15629519,173579,15259332,15652548,370187
3,ENSG00000233308.1,191234605,3-191400078-C-T,rs9812544,-1,C,T,191400078,165473,191037997,191431213,362081
3,ENSG00000223797.1,40453186,3-40515105-G-A,rs9820580,-1,G,A,40515105,61919,40256578,40649794,258527
3,ENSG00000244226.1,65687301,3-65857340-T-C,rs9820754,1,T,C,65857340,170039,65490693,65883909,366647
3,ENSG00000244515.1,157163932,3-157165352-T-C,rs9827476,-1,T,C,157165352,1420,156967324,157360540,198028
3,ENSG00000244515.1,157163932,3-157165352-T-G,rs9827476,-1,T,G,157165352,1420,156967324,157360540,198028
3,ENSG00000232535.1,98306752,3-98265098-A-T,rs9853906,1,A,T,98265098,41654,98110144,98503360,154954
3,ENSG00000232535.1,98306752,3-98265098-A-G,rs9853906,1,A,G,98265098,41654,98110144,98503360,154954
3,ENSG00000241135.1,157089918,3-157097432-T-C,rs9860743,1,T,C,157097432,7514,156893310,157286526,204122
3,ENSG00000231770.1,194583991,3-194589630-G-A,rs999941,1,G,A,194589630,5639,194387383,194780599,202247
3,ENSG00000231770.1,194583991,3-194589630-G-C,rs999941,1,G,C,194589630,5639,194387383,194780599,202247
3,ENSG00000250562.1,98525274,3-98573022-G-T,rs10511168,-1,G,T,98573022,47748,98328666,98721882,244356
3,ENSG00000236297.1,193579413,3-193717542-A-T,rs10937599,-1,A,T,193717542,138129,193382805,193776021,334737
3,ENSG00000224318.1,196721,3-224829-G-T,rs1112886,-1,G,T,224829,28108,113,393329,224716
3,ENSG00000224318.1,196721,3-224829-G-A,rs1112886,-1,G,A,224829,28108,113,393329,224716
3,ENSG00000223916.1,43485880,3-43616656-G-A,rs11130007,-1,G,A,43616656,130776,43289272,43682488,327384
3,ENSG00000223916.1,43485880,3-43616656-G-C,rs11130007,-1,G,C,43616656,130776,43289272,43682488,327384
3,ENSG00000223916.1,43485880,3-43616656-G-T,rs11130007,-1,G,T,43616656,130776,43289272,43682488,327384
3,ENSG00000232375.1,43037121,3-42843986-T-C,rs112494177,1,T,C,42843986,193135,42840513,43233729,3473
3,ENSG00000223899.1,33033863,3-33007660-C-T,rs1133253,1,C,T,33007660,26203,32837255,33230471,170405
3,ENSG00000205955.3,184115352,3-183975306-G-A,rs114229290,1,G,A,183975306,140046,183918744,184311960,56562
3,ENSG00000240471.1,119791829,3-119944933-G-A,rs114872182,1,G,A,119944933,153104,119595221,119988437,349712
3,ENSG00000243176.1,157175269,3-157106337-G-T,rs114923591,1,G,T,157106337,68932,156978661,157371877,127676
3,ENSG00000243176.1,157175269,3-157106337-G-A,rs114923591,1,G,A,157106337,68932,156978661,157371877,127676
3,ENSG00000250939.1,12850659,3-12744330-G-A,rs115718559,1,G,A,12744330,106329,12654051,13047267,90279
3,ENSG00000224426.1,172604006,3-172635588-G-A,rs115858343,-1,G,A,172635588,31582,172407398,172800614,228190
3,ENSG00000259970.1,49684983,3-49831810-C-T,rs116222707,-1,C,T,49831810,146827,49488375,49881591,343435
3,ENSG00000235947.1,4751590,3-4765673-T-C,rs11713227,-1,T,C,4765673,14083,4554982,4948198,210691
3,ENSG00000234661.1,385795,3-216440-A-G,rs11714407,-1,A,G,216440,169355,189187,582403,27253
3,ENSG00000234661.1,385795,3-216440-A-T,rs11714407,-1,A,T,216440,169355,189187,582403,27253
3,ENSG00000232874.1,194131201,3-194236863-A-C,rs11716938,-1,A,C,194236863,105662,193934593,194327809,302270
3,ENSG00000232874.1,194131201,3-194236863-A-G,rs11716938,-1,A,G,194236863,105662,193934593,194327809,302270
3,ENSG00000232829.3,130827659,3-130771244-C-T,rs11918709,1,C,T,130771244,56415,130631051,131024267,140193
3,ENSG00000198590.7,37385604,3-37473850-C-G,rs12019224,1,C,G,37473850,88246,37188996,37582212,284854
3,ENSG00000198590.7,37385604,3-37473850-C-A,rs12019224,1,C,A,37473850,88246,37188996,37582212,284854
3,ENSG00000198590.7,37385604,3-37473850-C-T,rs12019224,1,C,T,37473850,88246,37188996,37582212,284854
3,ENSG00000239227.1,166861944,3-166720832-T-A,rs12107672,1,T,A,166720832,141112,166665336,167058552,55496
3,ENSG00000239227.1,166861944,3-166720832-T-G,rs12107672,1,T,G,166720832,141112,166665336,167058552,55496
3,ENSG00000184423.5,1596245,3-1454309-T-G,rs12489351,-1,T,G,1454309,141936,1399637,1792853,54672
3,ENSG00000213178.3,169484080,3-169522689-T-A,rs12493300,-1,T,A,169522689,38609,169287472,169680688,235217
3,ENSG00000242516.1,75672300,3-75766728-A-G,rs12496434,1,A,G,75766728,94428,75475692,75868908,291036
3,ENSG00000223791.1,23806905,3-23766059-C-T,rs12497066,-1,C,T,23766059,40846,23610297,24003513,155762
3,ENSG00000246082.2,131361930,3-131353911-G-A,rs12630298,1,G,A,131353911,8019,131165322,131558538,188589
3,ENSG00000235805.1,44710886,3-44876243-A-G,rs12632450,-1,A,G,44876243,165357,44514278,44907494,361965
3,ENSG00000235805.1,44710886,3-44876243-A-T,rs12632450,-1,A,T,44876243,165357,44514278,44907494,361965
3,ENSG00000235805.1,44710886,3-44876243-A-C,rs12632450,-1,A,C,44876243,165357,44514278,44907494,361965
3,ENSG00000243368.1,183016255,3-183044649-G-C,rs12637471,1,G,C,183044649,28394,182819647,183212863,225002
3,ENSG00000243368.1,183016255,3-183044649-G-A,rs12637471,1,G,A,183044649,28394,182819647,183212863,225002
3,ENSG00000239653.1,64004022,3-63841705-G-T,rs13059603,1,G,T,63841705,162317,63807414,64200630,34291
3,ENSG00000239653.1,64004022,3-63841705-G-A,rs13059603,1,G,A,63841705,162317,63807414,64200630,34291
3,ENSG00000239653.1,64004022,3-63841705-G-C,rs13059603,1,G,C,63841705,162317,63807414,64200630,34291
3,ENSG00000260743.1,179340322,3-179274163-C-T,rs13076233,1,C,T,179274163,66159,179143714,179536930,130449
3,ENSG00000260743.1,179340322,3-179274163-C-G,rs13076233,1,C,G,179274163,66159,179143714,179536930,130449
3,ENSG00000243339.1,196399911,3-196475455-T-C,rs13090871,1,T,C,196475455,75544,196203303,196596519,272152
3,ENSG00000224769.1,195614947,3-195788723-C-G,rs13095016,1,C,G,195788723,173776,195418339,195811555,370384
3,ENSG00000224769.1,195614947,3-195788723-C-T,rs13095016,1,C,T,195788723,173776,195418339,195811555,370384
3,ENSG00000224769.1,195614947,3-195788723-C-A,rs13095016,1,C,A,195788723,173776,195418339,195811555,370384
3,ENSG00000230530.1,45689179,3-45549900-T-C,rs13323026,-1,T,C,45549900,139279,45492571,45885787,57329
3,ENSG00000244722.1,110683154,3-110694089-T-C,rs1462318,-1,T,C,110694089,10935,110486546,110879762,207543
3,ENSG00000230732.1,196912646,3-196727148-C-T,rs1463628,1,C,T,196727148,185498,196716038,197109254,11110
3,ENSG00000261159.1,128860526,3-129053371-A-G,rs1482410,-1,A,G,129053371,192845,128663918,129057134,389453
3,ENSG00000213452.4,74135959,3-73962000-T-C,rs1526734,1,T,C,73962000,173959,73939351,74332567,22649
3,ENSG00000213452.4,74135959,3-73962000-T-A,rs1526734,1,T,A,73962000,173959,73939351,74332567,22649
3,ENSG00000240024.1,183451741,3-183489509-G-T,rs1553693,1,G,T,183489509,37768,183255133,183648349,234376
3,ENSG00000240024.1,183451741,3-183489509-G-A,rs1553693,1,G,A,183489509,37768,183255133,183648349,234376
3,ENSG00000175841.7,101521891,3-101575099-C-T,rs16844073,1,C,T,101575099,53208,101325283,101718499,249816
3,ENSG00000239445.1,98732757,3-98777624-A-G,rs16846347,-1,A,G,98777624,44867,98536149,98929365,241475
3,ENSG00000239445.1,98732757,3-98777624-A-C,rs16846347,-1,A,C,98777624,44867,98536149,98929365,241475
3,ENSG00000243635.1,104502700,3-104629865-G-C,rs16850153,1,G,C,104629865,127165,104306092,104699308,323773
3,ENSG00000243635.1,104502700,3-104629865-G-A,rs16850153,1,G,A,104629865,127165,104306092,104699308,323773
3,ENSG00000243635.1,104502700,3-104629865-G-T,rs16850153,1,G,T,104629865,127165,104306092,104699308,323773
3,ENSG00000244171.3,143176327,3-143137717-A-T,rs16853038,1,A,T,143137717,38610,142979719,143372935,157998
3,ENSG00000223358.1,185162901,3-185171002-A-G,rs16859726,1,A,G,185171002,8101,184966293,185359509,204709
3,ENSG00000239699.1,80216261,3-80391706-T-G,rs17017916,1,T,G,80391706,175445,80019653,80412869,372053
3,ENSG00000236152.1,6773343,3-6827479-G-A,rs17046139,-1,G,A,6827479,54136,6576735,6969951,250744
3,ENSG00000244513.1,69014164,3-68874628-A-G,rs17048089,1,A,G,68874628,139536,68817556,69210772,57072
3,ENSG00000244513.1,69014164,3-68874628-A-C,rs17048089,1,A,C,68874628,139536,68817556,69210772,57072
3,ENSG00000214280.3,139583593,3-139649764-C-T,rs17393045,-1,C,T,139649764,66171,139386985,139780201,262779
3,ENSG00000214280.3,139583593,3-139649764-C-G,rs17393045,-1,C,G,139649764,66171,139386985,139780201,262779
3,ENSG00000240875.1,156817034,3-156929677-T-C,rs17442066,-1,T,C,156929677,112643,156620426,157013642,309251
3,ENSG00000241473.1,180820544,3-180914186-T-G,rs1805583,1,T,G,180914186,93642,180623936,181017152,290250
3,ENSG00000242759.1,107240663,3-107207051-A-G,rs1881309,-1,A,G,107207051,33612,107044055,107437271,162996
3,ENSG00000240288.1,10285754,3-10270255-C-G,rs2075352,1,C,G,10270255,15499,10089146,10482362,181109
3,ENSG00000240288.1,10285754,3-10270255-C-T,rs2075352,1,C,T,10270255,15499,10089146,10482362,181109
3,ENSG00000243926.1,156674446,3-156625060-G-A,rs2102506,-1,G,A,156625060,49386,156477838,156871054,147222
3,ENSG00000243926.1,156674446,3-156625060-G-T,rs2102506,-1,G,T,156625060,49386,156477838,156871054,147222
3,ENSG00000251474.2,129397109,3-129583316-G-A,rs2285369,-1,G,A,129583316,186207,129200501,129593717,382815
3,ENSG00000248839.1,98522570,3-98511645-T-C,rs2316131,1,T,C,98511645,10925,98325962,98719178,185683
3,ENSG00000229759.1,48256938,3-48358338-C-T,rs2362451,-1,C,T,48358338,101400,48060330,48453546,298008
3,ENSG00000231249.1,4493201,3-4471781-C-T,rs2633846,-1,C,T,4471781,21420,4296593,4689809,175188
3,ENSG00000231249.1,4493201,3-4471781-C-A,rs2633846,-1,C,A,4471781,21420,4296593,4689809,175188
3,ENSG00000214135.4,197627848,3-197479277-T-C,rs2686036,-1,T,C,197479277,148571,197431240,197824456,48037
3,ENSG00000241319.1,81612805,3-81434273-G-C,rs276119,-1,G,C,81434273,178532,81416197,81809413,18076
3,ENSG00000241319.1,81612805,3-81434273-G-T,rs276119,-1,G,T,81434273,178532,81416197,81809413,18076
3,ENSG00000189366.5,125990537,3-125874759-C-A,rs2947646,-1,C,A,125874759,115778,125793929,126187145,80830
3,ENSG00000189366.5,125990537,3-125874759-C-T,rs2947646,-1,C,T,125874759,115778,125793929,126187145,80830
3,ENSG00000242086.2,195708183,3-195769921-T-G,rs3096333,1,T,G,195769921,61738,195511575,195904791,258346
3,ENSG00000242086.2,195708183,3-195769921-T-C,rs3096333,1,T,C,195769921,61738,195511575,195904791,258346
3,ENSG00000242086.2,195708183,3-195769921-T-A,rs3096333,1,T,A,195769921,61738,195511575,195904791,258346
3,ENSG00000228638.1,48291375,3-48184019-T-C,rs3731503,-1,T,C,48184019,107356,48094767,48487983,89252
3,ENSG00000214145.2,194322841,3-194401478-G-A,rs3755617,-1,G,A,194401478,78637,194126233,194519449,275245
3,ENSG00000240950.1,142827728,3-142848188-T-C,rs3816690,-1,T,C,142848188,20460,142631120,143024336,217068
3,ENSG00000233912.1,5187329,3-5140742-C-T,rs3821790,-1,C,T,5140742,46587,4990721,5383937,150021
3,ENSG00000233912.1,5187329,3-5140742-C-A,rs3821790,-1,C,A,5140742,46587,4990721,5383937,150021
3,ENSG00000234629.1,94938024,3-95121761-C-T,rs3843866,-1,C,T,95121761,183737,94741416,95134632,380345
3,ENSG00000237433.1,32190747,3-32364858-C-A,rs3844588,1,C,A,32364858,174111,31994139,32387355,370719
3,ENSG00000237433.1,32190747,3-32364858-C-G,rs3844588,1,C,G,32364858,174111,31994139,32387355,370719
3,ENSG00000237433.1,32190747,3-32364858-C-T,rs3844588,1,C,T,32364858,174111,31994139,32387355,370719
3,ENSG00000243795.1,113167819,3-113021298-C-T,rs3872610,-1,C,T,113021298,146521,112971211,113364427,50087
3,ENSG00000198406.6,116646727,3-116833757-T-C,rs4075379,-1,T,C,116833757,187030,116450119,116843335,383638
3,ENSG00000198406.6,116646727,3-116833757-T-G,rs4075379,-1,T,G,116833757,187030,116450119,116843335,383638
3,ENSG00000236062.1,12258460,3-12367451-G-T,rs4135317,-1,G,T,12367451,108991,12061852,12455068,305599
3,ENSG00000230067.2,36768799,3-36896689-C-T,rs4328757,-1,C,T,36896689,127890,36572191,36965407,324498
3,ENSG00000231552.1,32621902,3-32579556-C-T,rs4384987,-1,C,T,32579556,42346,32425294,32818510,154262
3,ENSG00000231552.1,32621902,3-32579556-C-A,rs4384987,-1,C,A,32579556,42346,32425294,32818510,154262
3,ENSG00000231552.1,32621902,3-32579556-C-G,rs4384987,-1,C,G,32579556,42346,32425294,32818510,154262
3,ENSG00000231464.1,195996738,3-195915283-G-A,rs4485751,1,G,A,195915283,81455,195800130,196193346,115153
3,ENSG00000239443.1,155309807,3-155424000-C-T,rs4680176,-1,C,T,155424000,114193,155113199,155506415,310801
3,ENSG00000174912.6,156714928,3-156639050-T-C,rs4680294,-1,T,C,156639050,75878,156518320,156911536,120730
3,ENSG00000261786.1,44117299,3-44203663-T-C,rs4682949,1,T,C,44203663,86364,43920691,44313907,282972
3,ENSG00000261786.1,44117299,3-44203663-T-G,rs4682949,1,T,G,44203663,86364,43920691,44313907,282972
3,ENSG00000261786.1,44117299,3-44203663-T-A,rs4682949,1,T,A,44203663,86364,43920691,44313907,282972
3,ENSG00000249274.1,98782188,3-98713715-C-G,rs4857414,1,C,G,98713715,68473,98585580,98978796,128135
3,ENSG00000249274.1,98782188,3-98713715-C-A,rs4857414,1,C,A,98713715,68473,98585580,98978796,128135
3,ENSG00000249274.1,98782188,3-98713715-C-T,rs4857414,1,C,T,98713715,68473,98585580,98978796,128135
3,ENSG00000224424.6,48847851,3-48687378-C-G,rs4858828,1,C,G,48687378,160473,48651243,49044459,36135
3,ENSG00000224424.6,48847851,3-48687378-C-A,rs4858828,1,C,A,48687378,160473,48651243,49044459,36135
3,ENSG00000224424.6,48847851,3-48687378-C-T,rs4858828,1,C,T,48687378,160473,48651243,49044459,36135
3,ENSG00000260236.1,47381519,3-47438867-A-G,rs4858889,-1,A,G,47438867,57348,47184911,47578127,253956
3,ENSG00000248916.1,129325426,3-129260165-C-A,rs4927943,-1,C,A,129260165,65261,129128818,129522034,131347
3,ENSG00000248916.1,129325426,3-129260165-C-T,rs4927943,-1,C,T,129260165,65261,129128818,129522034,131347
3,ENSG00000260261.1,195954485,3-196101157-C-T,rs55940238,-1,C,T,196101157,146672,195757877,196151093,343280
3,ENSG00000260261.1,195954485,3-196101157-C-A,rs55940238,-1,C,A,196101157,146672,195757877,196151093,343280
3,ENSG00000250608.1,131381475,3-131418414-C-A,rs56132287,-1,C,A,131418414,36939,131184867,131578083,233547
3,ENSG00000229178.1,195657927,3-195788697-C-T,rs62282504,-1,C,T,195788697,130770,195461319,195854535,327378
3,ENSG00000229178.1,195657927,3-195788697-C-A,rs62282504,-1,C,A,195788697,130770,195461319,195854535,327378
3,ENSG00000229178.1,195657927,3-195788697-C-G,rs62282504,-1,C,G,195788697,130770,195461319,195854535,327378
3,ENSG00000171084.11,125916624,3-126068283-C-T,rs6438966,1,C,T,126068283,151659,125720016,126113232,348267
3,ENSG00000171084.11,125916624,3-126068283-C-A,rs6438966,1,C,A,126068283,151659,125720016,126113232,348267
3,ENSG00000145075.7,180870933,3-180803836-A-T,rs6443721,-1,A,T,180803836,67097,180674325,181067541,129511
3,ENSG00000145075.7,180870933,3-180803836-A-G,rs6443721,-1,A,G,180803836,67097,180674325,181067541,129511
3,ENSG00000132967.9,22381819,3-22520529-C-G,rs6550695,1,C,G,22520529,138710,22185211,22578427,335318
3,ENSG00000224614.1,195908076,3-195850647-G-A,rs6583240,1,G,A,195850647,57429,195711468,196104684,139179
3,ENSG00000232439.1,38527325,3-38697226-G-A,rs6599240,-1,G,A,38697226,169901,38330717,38723933,366509
3,ENSG00000243276.1,118557668,3-118388495-A-G,rs6765710,-1,A,G,118388495,169173,118361060,118754276,27435
3,ENSG00000260572.1,160755142,3-160827096-C-T,rs6768578,-1,C,T,160827096,71954,160558534,160951750,268562
3,ENSG00000240207.1,158732327,3-158629776-T-C,rs6768636,1,T,C,158629776,102551,158535719,158928935,94057
3,ENSG00000189229.10,6490512,3-6499547-C-T,rs6773773,1,C,T,6499547,9035,6293904,6687120,205643
3,ENSG00000189229.10,6490512,3-6499547-C-G,rs6773773,1,C,G,6499547,9035,6293904,6687120,205643
3,ENSG00000223387.2,172595607,3-172650911-G-A,rs6778941,-1,G,A,172650911,55304,172398999,172792215,251912
3,ENSG00000224406.1,186493661,3-186646257-G-A,rs6785067,-1,G,A,186646257,152596,186297053,186690269,349204
3,ENSG00000214301.4,133490824,3-133302219-G-T,rs6792283,1,G,T,133302219,188605,133294216,133687432,8003
3,ENSG00000214301.4,133490824,3-133302219-G-A,rs6792283,1,G,A,133302219,188605,133294216,133687432,8003
3,ENSG00000240695.1,136737229,3-136573437-C-T,rs6794351,-1,C,T,136573437,163792,136540621,136933837,32816
3,ENSG00000230266.1,195147764,3-195129930-A-G,rs6797160,1,A,G,195129930,17834,194951156,195344372,178774
3,ENSG00000230266.1,195147764,3-195129930-A-T,rs6797160,1,A,T,195129930,17834,194951156,195344372,178774
3,ENSG00000213872.3,25749488,3-25731515-C-A,rs6797573,1,C,A,25731515,17973,25552880,25946096,178635
3,ENSG00000244124.1,141919021,3-141919068-T-C,rs72988236,-1,T,C,141919068,47,141722413,142115629,196655
3,ENSG00000244124.1,141919021,3-141919068-T-A,rs72988236,-1,T,A,141919068,47,141722413,142115629,196655
3,ENSG00000225026.1,12328003,3-12459594-A-G,rs73029213,1,A,G,12459594,131591,12131395,12524611,328199
3,ENSG00000228252.3,130212823,3-130123032-G-A,rs73210765,1,G,A,130123032,89791,130016215,130409431,106817
3,ENSG00000253540.1,130111472,3-130123032-G-A,rs73210765,-1,G,A,130123032,11560,129914864,130308080,208168
3,ENSG00000185485.10,195990258,3-195862919-C-T,rs73891159,-1,C,T,195862919,127339,195793650,196186866,69269
3,ENSG00000185485.10,195990258,3-195862919-C-G,rs73891159,-1,C,G,195862919,127339,195793650,196186866,69269
3,ENSG00000244026.1,75435110,3-75342299-G-A,rs74783618,-1,G,A,75342299,92811,75238502,75631718,103797
3,ENSG00000240375.1,113919222,3-114103553-C-A,rs74814856,1,C,A,114103553,184331,113722614,114115830,380939
3,ENSG00000227440.1,172829176,3-172785751-C-T,rs75489499,-1,C,T,172785751,43425,172632568,173025784,153183
3,ENSG00000223797.1,40453186,3-40396629-C-T,rs75965075,-1,C,T,40396629,56557,40256578,40649794,140051
3,ENSG00000230457.3,156810732,3-156863245-G-A,rs7616633,-1,G,A,156863245,52513,156614124,157007340,249121
3,ENSG00000181260.8,179464346,3-179426951-C-T,rs7618348,1,C,T,179426951,37395,179267738,179660954,159213
3,ENSG00000248530.1,131526447,3-131521798-A-T,rs7618892,1,A,T,131521798,4649,131329839,131723055,191959
3,ENSG00000248530.1,131526447,3-131521798-A-G,rs7618892,1,A,G,131521798,4649,131329839,131723055,191959
3,ENSG00000228242.1,14148402,3-14222201-A-G,rs7626307,1,A,G,14222201,73799,13951794,14345010,270407
3,ENSG00000236844.1,195554610,3-195577923-C-A,rs7627129,1,C,A,195577923,23313,195358002,195751218,219921
3,ENSG00000236844.1,195554610,3-195577923-C-T,rs7627129,1,C,T,195577923,23313,195358002,195751218,219921
3,ENSG00000236844.1,195554610,3-195577923-C-G,rs7627129,1,C,G,195577923,23313,195358002,195751218,219921
3,ENSG00000231770.1,194583991,3-194581640-G-A,rs7652066,1,G,A,194581640,2351,194387383,194780599,194257
3,ENSG00000231770.1,194583991,3-194581640-G-T,rs7652066,1,G,T,194581640,2351,194387383,194780599,194257
3,ENSG00000256628.1,101676424,3-101833035-T-G,rs77121775,1,T,G,101833035,156611,101479816,101873032,353219
3,ENSG00000256628.1,101676424,3-101833035-T-C,rs77121775,1,T,C,101833035,156611,101479816,101873032,353219
3,ENSG00000256628.1,101676424,3-101833035-T-A,rs77121775,1,T,A,101833035,156611,101479816,101873032,353219
3,ENSG00000244193.1,169946754,3-169826510-T-G,rs77879098,-1,T,G,169826510,120244,169750146,170143362,76364
3,ENSG00000233308.1,191234605,3-191430307-A-G,rs78315556,-1,A,G,191430307,195702,191037997,191431213,392310
3,ENSG00000232535.1,98306752,3-98392143-G-C,rs79116017,1,G,C,98392143,85391,98110144,98503360,281999
3,ENSG00000233565.1,186922753,3-186849847-A-C,rs80033799,-1,A,C,186849847,72906,186726145,187119361,123702
3,ENSG00000229155.1,193844009,3-194032774-G-A,rs882212,-1,G,A,194032774,188765,193647401,194040617,385373
3,ENSG00000229155.1,193844009,3-194032774-G-T,rs882212,-1,G,T,194032774,188765,193647401,194040617,385373
3,ENSG00000248243.1,130094304,3-130225286-C-T,rs9289367,-1,C,T,130225286,130982,129897696,130290912,327590
3,ENSG00000228168.1,39334979,3-39385413-C-G,rs9809888,1,C,G,39385413,50434,39138371,39531587,247042
3,ENSG00000249626.1,197634315,3-197783156-G-A,rs9829434,1,G,A,197783156,148841,197437707,197830923,345449
3,ENSG00000250983.1,133546272,3-133714626-G-C,rs9830001,-1,G,C,133714626,168354,133349664,133742880,364962
3,ENSG00000250983.1,133546272,3-133714626-G-T,rs9830001,-1,G,T,133714626,168354,133349664,133742880,364962
3,ENSG00000250983.1,133546272,3-133714626-G-A,rs9830001,-1,G,A,133714626,168354,133349664,133742880,364962
3,ENSG00000227578.1,15141380,3-15301343-T-A,rs9831807,1,T,A,15301343,159963,14944772,15337988,356571
3,ENSG00000227578.1,15141380,3-15301343-T-C,rs9831807,1,T,C,15301343,159963,14944772,15337988,356571
3,ENSG00000233487.6,196987558,3-197124626-C-G,rs9850339,-1,C,G,197124626,137068,196790950,197184166,333676
3,ENSG00000233487.6,196987558,3-197124626-C-A,rs9850339,-1,C,A,197124626,137068,196790950,197184166,333676
3,ENSG00000233487.6,196987558,3-197124626-C-T,rs9850339,-1,C,T,197124626,137068,196790950,197184166,333676
3,ENSG00000244048.1,95171920,3-95307933-A-G,rs9853603,1,A,G,95307933,136013,94975312,95368528,332621
3,ENSG00000244048.1,95171920,3-95307933-A-C,rs9853603,1,A,C,95307933,136013,94975312,95368528,332621
3,ENSG00000242539.1,179396961,3-179278838-G-A,rs9856476,1,G,A,179278838,118123,179200353,179593569,78485
3,ENSG00000241544.1,157081738,3-157097432-T-C,rs9860743,1,T,C,157097432,15694,156885130,157278346,212302
3,ENSG00000173811.6,42732575,3-42838998-A-G,rs9861236,1,A,G,42838998,106423,42535967,42929183,303031
3,ENSG00000243759.1,143518229,3-143636295-A-C,rs9862274,-1,A,C,143636295,118066,143321621,143714837,314674
3,ENSG00000243759.1,143518229,3-143636295-A-T,rs9862274,-1,A,T,143636295,118066,143321621,143714837,314674
3,ENSG00000244161.1,58170636,3-58116834-G-A,rs9880603,-1,G,A,58116834,53802,57974028,58367244,142806
3,ENSG00000244161.1,58170636,3-58116834-G-T,rs9880603,-1,G,T,58116834,53802,57974028,58367244,142806
2,ENSG00000225439.2,74148079,2-74230591-A-T,rs10177833,1,A,T,74230591,82512,73951471,74344687,279120
2,ENSG00000225439.2,74148079,2-74230591-A-C,rs10177833,1,A,C,74230591,82512,73951471,74344687,279120
2,ENSG00000213963.2,177392674,2-177332141-C-G,rs10179735,-1,C,G,177332141,60533,177196066,177589282,136075
2,ENSG00000213963.2,177392674,2-177332141-C-T,rs10179735,-1,C,T,177332141,60533,177196066,177589282,136075
2,ENSG00000234559.1,129940217,2-129987975-A-G,rs10181949,-1,A,G,129987975,47758,129743609,130136825,244366
2,ENSG00000213594.4,38285410,2-38416161-C-T,rs10191584,1,C,T,38416161,130751,38088802,38482018,327359
2,ENSG00000225963.1,230121370,2-230046220-C-T,rs10199878,1,C,T,230046220,75150,229924762,230317978,121458
2,ENSG00000223824.1,189917758,2-190107532-G-T,rs10206154,-1,G,T,190107532,189774,189721150,190114366,386382
2,ENSG00000223824.1,189917758,2-190107532-G-A,rs10206154,-1,G,A,190107532,189774,189721150,190114366,386382
2,ENSG00000232788.1,172466022,2-172336476-C-T,rs10209443,-1,C,T,172336476,129546,172269414,172662630,67062
2,ENSG00000179997.7,174501952,2-174695766-T-C,rs10210290,1,T,C,174695766,193814,174305344,174698560,390422
2,ENSG00000225889.2,64143239,2-64251926-G-C,rs1025209,1,G,C,64251926,108687,63946631,64339847,305295
2,ENSG00000225889.2,64143239,2-64251926-G-A,rs1025209,1,G,A,64251926,108687,63946631,64339847,305295
2,ENSG00000237951.1,26162056,2-26162980-G-A,rs1025542,1,G,A,26162980,924,25965448,26358664,197532
2,ENSG00000237951.1,26162056,2-26162980-G-C,rs1025542,1,G,C,26162980,924,25965448,26358664,197532
2,ENSG00000260101.1,64524110,2-64544141-C-G,rs1030130,-1,C,G,64544141,20031,64327502,64720718,216639
2,ENSG00000260101.1,64524110,2-64544141-C-T,rs1030130,-1,C,T,64544141,20031,64327502,64720718,216639
2,ENSG00000227692.1,186364598,2-186393110-T-C,rs10432501,1,T,C,186393110,28512,186167990,186561206,225120
2,ENSG00000227692.1,186364598,2-186393110-T-A,rs10432501,1,T,A,186393110,28512,186167990,186561206,225120
2,ENSG00000246575.2,85315041,2-85328154-G-A,rs10460586,1,G,A,85328154,13113,85118433,85511649,209721
2,ENSG00000246575.2,85315041,2-85328154-G-T,rs10460586,1,G,T,85328154,13113,85118433,85511649,209721
2,ENSG00000227403.1,161244720,2-161326996-T-C,rs10469684,1,T,C,161326996,82276,161048112,161441328,278884
2,ENSG00000227403.1,161244720,2-161326996-T-G,rs10469684,1,T,G,161326996,82276,161048112,161441328,278884
2,ENSG00000225964.1,6840430,2-6849889-C-T,rs10495545,-1,C,T,6849889,9459,6643822,7037038,206067
2,ENSG00000228446.1,224500100,2-224471814-C-A,rs10498160,-1,C,A,224471814,28286,224303492,224696708,168322
2,ENSG00000225787.1,85102694,2-85148068-T-G,rs10520405,-1,T,G,85148068,45374,84906086,85299302,241982
2,ENSG00000238062.1,230996031,2-230987679-G-A,rs1060780,-1,G,A,230987679,8352,230799423,231192639,188256
2,ENSG00000225449.1,129968380,2-129909438-C-T,rs10803608,-1,C,T,129909438,58942,129771772,130164988,137666
2,ENSG00000224287.1,233868230,2-233850773-C-G,rs10929310,-1,C,G,233850773,17457,233671622,234064838,179151
2,ENSG00000234793.1,241755740,2-241771520-G-A,rs10933568,-1,G,A,241771520,15780,241559132,241952348,212388
2,ENSG00000234793.1,241755740,2-241771520-G-C,rs10933568,-1,G,C,241771520,15780,241559132,241952348,212388
2,ENSG00000213301.2,104771282,2-104749707-T-G,rs1110143,1,T,G,104749707,21575,104574674,104967890,175033
2,ENSG00000189223.7,113235536,2-113226726-T-C,rs11123172,1,T,C,113226726,8810,113038928,113432144,187798
2,ENSG00000235522.1,105855240,2-105759776-T-C,rs1114475,-1,T,C,105759776,95464,105658632,106051848,101144
2,ENSG00000235522.1,105855240,2-105759776-T-G,rs1114475,-1,T,G,105759776,95464,105658632,106051848,101144
2,ENSG00000235522.1,105855240,2-105759776-T-A,rs1114475,-1,T,A,105759776,95464,105658632,106051848,101144
2,ENSG00000231672.2,217756593,2-217790880-G-C,rs111533869,-1,G,C,217790880,34287,217559985,217953201,230895
2,ENSG00000231672.2,217756593,2-217790880-G-T,rs111533869,-1,G,T,217790880,34287,217559985,217953201,230895
2,ENSG00000236969.1,91775944,2-91874755-A-G,rs111864931,1,A,G,91874755,98811,91579336,91972552,295419
2,ENSG00000236969.1,91775944,2-91874755-A-C,rs111864931,1,A,C,91874755,98811,91579336,91972552,295419
2,ENSG00000223703.1,91736726,2-91874755-A-G,rs111864931,1,A,G,91874755,138029,91540118,91933334,334637
2,ENSG00000223703.1,91736726,2-91874755-A-C,rs111864931,1,A,C,91874755,138029,91540118,91933334,334637
2,ENSG00000230572.1,91714745,2-91874755-A-G,rs111864931,-1,A,G,91874755,160010,91518137,91911353,356618
2,ENSG00000230572.1,91714745,2-91874755-A-C,rs111864931,-1,A,C,91874755,160010,91518137,91911353,356618
2,ENSG00000204581.2,111114185,2-110956544-T-A,rs115273210,-1,T,A,110956544,157641,110917577,111310793,38967
2,ENSG00000231259.2,87052992,2-87148758-T-C,rs115552442,-1,T,C,87148758,95766,86856384,87249600,292374
2,ENSG00000224607.3,89968867,2-90108556-C-T,rs116171884,1,C,T,90108556,139689,89772259,90165475,336297
2,ENSG00000224607.3,89968867,2-90108556-C-G,rs116171884,1,C,G,90108556,139689,89772259,90165475,336297
2,ENSG00000224607.3,89968867,2-90108556-C-A,rs116171884,1,C,A,90108556,139689,89772259,90165475,336297
2,ENSG00000239571.1,89936859,2-90108556-C-T,rs116171884,1,C,T,90108556,171697,89740251,90133467,368305
2,ENSG00000239571.1,89936859,2-90108556-C-G,rs116171884,1,C,G,90108556,171697,89740251,90133467,368305
2,ENSG00000239571.1,89936859,2-90108556-C-A,rs116171884,1,C,A,90108556,171697,89740251,90133467,368305
2,ENSG00000242766.1,90082635,2-90025334-C-T,rs116727807,1,C,T,90025334,57301,89886027,90279243,139307
2,ENSG00000231747.1,112622167,2-112665171-C-T,rs11683520,-1,C,T,112665171,43004,112425559,112818775,239612
2,ENSG00000231747.1,112622167,2-112665171-C-G,rs11683520,-1,C,G,112665171,43004,112425559,112818775,239612
2,ENSG00000229867.1,119270714,2-119280688-C-T,rs11686984,-1,C,T,119280688,9974,119074106,119467322,206582
2,ENSG00000229867.1,119270714,2-119280688-C-A,rs11686984,-1,C,A,119280688,9974,119074106,119467322,206582
2,ENSG00000229867.1,119270714,2-119280688-C-G,rs11686984,-1,C,G,119280688,9974,119074106,119467322,206582
2,ENSG00000226080.1,11102142,2-10994010-T-C,rs11888040,1,T,C,10994010,108132,10905534,11298750,88476
2,ENSG00000234350.1,170813670,2-170719161-A-T,rs11895153,-1,A,T,170719161,94509,170617062,171010278,102099
2,ENSG00000234350.1,170813670,2-170719161-A-G,rs11895153,-1,A,G,170719161,94509,170617062,171010278,102099
2,ENSG00000234350.1,170813670,2-170719161-A-C,rs11895153,-1,A,C,170719161,94509,170617062,171010278,102099
2,ENSG00000259848.1,94892756,2-94774607-T-C,rs11897891,-1,T,C,94774607,118149,94696148,95089364,78459
2,ENSG00000178162.4,130431363,2-130377276-A-G,rs12151738,-1,A,G,130377276,54087,130234755,130627971,142521
2,ENSG00000224184.1,12007128,2-12082153-C-A,rs12465663,1,C,A,12082153,75025,11810520,12203736,271633
2,ENSG00000224184.1,12007128,2-12082153-C-T,rs12465663,1,C,T,12082153,75025,11810520,12203736,271633
2,ENSG00000224184.1,12007128,2-12082153-C-G,rs12465663,1,C,G,12082153,75025,11810520,12203736,271633
2,ENSG00000224875.2,42170231,2-42034731-A-T,rs12473667,-1,A,T,42034731,135500,41973623,42366839,61108
2,ENSG00000224875.2,42170231,2-42034731-A-G,rs12473667,-1,A,G,42034731,135500,41973623,42366839,61108
2,ENSG00000229647.1,207166120,2-206980105-A-G,rs12477676,1,A,G,206980105,186015,206969512,207362728,10593
2,ENSG00000231908.1,208255214,2-208255534-G-T,rs12478635,1,G,T,208255534,320,208058606,208451822,196928
2,ENSG00000231908.1,208255214,2-208255534-G-A,rs12478635,1,G,A,208255534,320,208058606,208451822,196928
2,ENSG00000231908.1,208255214,2-208255534-G-C,rs12478635,1,G,C,208255534,320,208058606,208451822,196928
2,ENSG00000236682.1,127388202,2-127328778-C-T,rs12613413,1,C,T,127328778,59424,127191594,127584810,137184
2,ENSG00000226491.1,42798712,2-42786632-C-A,rs12617051,-1,C,A,42786632,12080,42602104,42995320,184528
2,ENSG00000226491.1,42798712,2-42786632-C-T,rs12617051,-1,C,T,42786632,12080,42602104,42995320,184528
2,ENSG00000227359.1,113704078,2-113735683-A-G,rs12624301,-1,A,G,113735683,31605,113507470,113900686,228213
2,ENSG00000253559.1,189762704,2-189664505-T-C,rs12693551,1,T,C,189664505,98199,189566096,189959312,98409
2,ENSG00000253559.1,189762704,2-189664505-T-A,rs12693551,1,T,A,189664505,98199,189566096,189959312,98409
2,ENSG00000225402.1,37816915,2-37830485-C-T,rs12712554,1,C,T,37830485,13570,37620307,38013523,210178
2,ENSG00000239819.1,90220727,2-90189822-A-G,rs12986609,1,A,G,90189822,30905,90024119,90417335,165703
2,ENSG00000239819.1,90220727,2-90189822-A-C,rs12986609,1,A,C,90189822,30905,90024119,90417335,165703
2,ENSG00000236259.1,68125265,2-68186216-G-T,rs12994570,1,G,T,68186216,60951,67928657,68321873,257559
2,ENSG00000236259.1,68125265,2-68186216-G-C,rs12994570,1,G,C,68186216,60951,67928657,68321873,257559
2,ENSG00000231609.1,63047656,2-63026921-A-C,rs13004408,-1,A,C,63026921,20735,62851048,63244264,175873
2,ENSG00000231609.1,63047656,2-63026921-A-T,rs13004408,-1,A,T,63026921,20735,62851048,63244264,175873
2,ENSG00000231609.1,63047656,2-63026921-A-G,rs13004408,-1,A,G,63026921,20735,62851048,63244264,175873
2,ENSG00000224331.2,164687596,2-164716684-C-T,rs13024606,-1,C,T,164716684,29088,164490988,164884204,225696
2,ENSG00000224331.2,164687596,2-164716684-C-A,rs13024606,-1,C,A,164716684,29088,164490988,164884204,225696
2,ENSG00000229781.1,142854095,2-142844934-T-C,rs13027801,1,T,C,142844934,9161,142657487,143050703,187447
2,ENSG00000229781.1,142854095,2-142844934-T-G,rs13027801,1,T,G,142844934,9161,142657487,143050703,187447
2,ENSG00000228236.1,149068910,2-148908504-C-T,rs13032506,-1,C,T,148908504,160406,148872302,149265518,36202
2,ENSG00000229750.1,175167904,2-175007869-T-A,rs1320876,1,T,A,175007869,160035,174971296,175364512,36573
2,ENSG00000229750.1,175167904,2-175007869-T-G,rs1320876,1,T,G,175007869,160035,174971296,175364512,36573
2,ENSG00000226125.1,230700340,2-230730929-C-T,rs13396097,-1,C,T,230730929,30589,230503732,230896948,227197
2,ENSG00000173209.16,61177539,2-61252282-C-T,rs13398770,1,C,T,61252282,74743,60980931,61374147,271351
2,ENSG00000173209.16,61177539,2-61252282-C-G,rs13398770,1,C,G,61252282,74743,60980931,61374147,271351
2,ENSG00000230562.3,157380414,2-157305619-G-A,rs13414809,-1,G,A,157305619,74795,157183806,157577022,121813
2,ENSG00000230562.3,157380414,2-157305619-G-T,rs13414809,-1,G,T,157305619,74795,157183806,157577022,121813
2,ENSG00000213729.3,20156057,2-20121430-C-T,rs13415910,-1,C,T,20121430,34627,19959449,20352665,161981
2,ENSG00000215692.2,241735498,2-241620926-T-C,rs13419983,-1,T,C,241620926,114572,241538890,241932106,82036
2,ENSG00000241114.1,54080280,2-53968616-T-C,rs13432266,-1,T,C,53968616,111664,53883672,54276888,84944
2,ENSG00000241114.1,54080280,2-53968616-T-G,rs13432266,-1,T,G,53968616,111664,53883672,54276888,84944
2,ENSG00000228802.1,223967706,2-223957952-T-C,rs1347818,-1,T,C,223957952,9754,223771098,224164314,186854
2,ENSG00000228802.1,223967706,2-223957952-T-A,rs1347818,-1,T,A,223957952,9754,223771098,224164314,186854
2,ENSG00000205086.5,41956806,2-41877189-T-G,rs13639,-1,T,G,41877189,79617,41760198,42153414,116991
2,ENSG00000229670.2,209178966,2-209098230-C-G,rs1371435,1,C,G,209098230,80736,208982358,209375574,115872
2,ENSG00000229670.2,209178966,2-209098230-C-T,rs1371435,1,C,T,209098230,80736,208982358,209375574,115872
2,ENSG00000172965.6,111495070,2-111566252-C-A,rs139586558,-1,C,A,111566252,71182,111298462,111691678,267790
2,ENSG00000172965.6,111495070,2-111566252-C-T,rs139586558,-1,C,T,111566252,71182,111298462,111691678,267790
2,ENSG00000231621.1,197197927,2-197297706-G-C,rs1429414,1,G,C,197297706,99779,197001319,197394535,296387
2,ENSG00000231621.1,197197927,2-197297706-G-A,rs1429414,1,G,A,197297706,99779,197001319,197394535,296387
2,ENSG00000259863.1,109128930,2-109219138-G-T,rs1560386,-1,G,T,109219138,90208,108932322,109325538,286816
2,ENSG00000259863.1,109128930,2-109219138-G-A,rs1560386,-1,G,A,109219138,90208,108932322,109325538,286816
2,ENSG00000236397.2,113601261,2-113690640-G-C,rs1597245,-1,G,C,113690640,89379,113404653,113797869,285987
2,ENSG00000236397.2,113601261,2-113690640-G-T,rs1597245,-1,G,T,113690640,89379,113404653,113797869,285987
2,ENSG00000236397.2,113601261,2-113690640-G-A,rs1597245,-1,G,A,113690640,89379,113404653,113797869,285987
2,ENSG00000228509.1,190841864,2-190704982-G-C,rs16832848,-1,G,C,190704982,136882,190645256,191038472,59726
2,ENSG00000228509.1,190841864,2-190704982-G-A,rs16832848,-1,G,A,190704982,136882,190645256,191038472,59726
2,ENSG00000183308.6,200963263,2-201015225-A-G,rs16836568,1,A,G,201015225,51962,200766655,201159871,248570
2,ENSG00000223466.1,195532945,2-195518785-T-C,rs16836823,1,T,C,195518785,14160,195336337,195729553,182448
2,ENSG00000236449.1,174547141,2-174569003-G-A,rs16862722,1,G,A,174569003,21862,174350533,174743749,218470
2,ENSG00000226539.1,223704621,2-223697943-C-A,rs16865100,1,C,A,223697943,6678,223508013,223901229,189930
2,ENSG00000213962.2,177998770,2-177843429-C-T,rs16865825,-1,C,T,177843429,155341,177802162,178195378,41267
2,ENSG00000235267.1,27455156,2-27389375-G-A,rs17006049,1,G,A,27389375,65781,27258548,27651764,130827
2,ENSG00000235267.1,27455156,2-27389375-G-C,rs17006049,1,G,C,27389375,65781,27258548,27651764,130827
2,ENSG00000237883.1,73981441,2-73992908-G-T,rs17009553,-1,G,T,73992908,11467,73784833,74178049,208075
2,ENSG00000237883.1,73981441,2-73992908-G-A,rs17009553,-1,G,A,73992908,11467,73784833,74178049,208075
2,ENSG00000227259.1,100591324,2-100764261-C-T,rs17024707,-1,C,T,100764261,172937,100394716,100787932,369545
2,ENSG00000227259.1,100591324,2-100764261-C-A,rs17024707,-1,C,A,100764261,172937,100394716,100787932,369545
2,ENSG00000226508.1,105144142,2-104996243-G-A,rs17030487,1,G,A,104996243,147899,104947534,105340750,48709
2,ENSG00000236124.1,112981434,2-113173287-A-G,rs17043031,-1,A,G,113173287,191853,112784826,113178042,388461
2,ENSG00000203327.2,55216126,2-55232237-T-C,rs17046778,-1,T,C,55232237,16111,55019518,55412734,212719
2,ENSG00000203327.2,55216126,2-55232237-T-G,rs17046778,-1,T,G,55232237,16111,55019518,55412734,212719
2,ENSG00000203327.2,55216126,2-55232237-T-A,rs17046778,-1,T,A,55232237,16111,55019518,55412734,212719
2,ENSG00000223725.1,207529795,2-207390794-A-T,rs17203016,-1,A,T,207390794,139001,207333187,207726403,57607
2,ENSG00000223725.1,207529795,2-207390794-A-G,rs17203016,-1,A,G,207390794,139001,207333187,207726403,57607
2,ENSG00000196096.3,213284205,2-213290603-G-A,rs17364234,-1,G,A,213290603,6398,213087597,213480813,203006
2,ENSG00000231312.2,39437433,2-39508321-C-A,rs17467001,1,C,A,39508321,70888,39240825,39634041,267496
2,ENSG00000231312.2,39437433,2-39508321-C-G,rs17467001,1,C,G,39508321,70888,39240825,39634041,267496
2,ENSG00000231312.2,39437433,2-39508321-C-T,rs17467001,1,C,T,39508321,70888,39240825,39634041,267496
2,ENSG00000224376.1,231388976,2-231394665-G-A,rs17513198,1,G,A,231394665,5689,231192368,231585584,202297
2,ENSG00000224839.1,208057745,2-208010631-C-T,rs17537823,-1,C,T,208010631,47114,207861137,208254353,149494
2,ENSG00000229056.1,196260024,2-196260096-A-G,rs17827837,1,A,G,196260096,72,196063416,196456632,196680
2,ENSG00000242580.1,90209873,2-90050455-G-A,rs17842625,1,G,A,90050455,159418,90013265,90406481,37190
2,ENSG00000233266.1,54051334,2-54140877-A-G,rs1877908,1,A,G,54140877,89543,53854726,54247942,286151
2,ENSG00000217643.1,25822469,2-25700492-A-T,rs2033174,1,A,T,25700492,121977,25625861,26019077,74631
2,ENSG00000260804.1,216217045,2-216179219-A-G,rs207941,1,A,G,216179219,37826,216020437,216413653,158782
2,ENSG00000257800.1,74120680,2-74131774-C-T,rs2122290,1,C,T,74131774,11094,73924072,74317288,207702
2,ENSG00000217702.1,74123965,2-74131774-C-T,rs2122290,1,C,T,74131774,7809,73927357,74320573,204417
2,ENSG00000204792.2,74918148,2-74956130-G-A,rs2129604,1,G,A,74956130,37982,74721540,75114756,234590
2,ENSG00000244563.1,127847084,2-127862798-T-A,rs2261682,-1,T,A,127862798,15714,127650476,128043692,212322
2,ENSG00000244563.1,127847084,2-127862798-T-C,rs2261682,-1,T,C,127862798,15714,127650476,128043692,212322
2,ENSG00000233870.1,71178587,2-71067924-A-C,rs2287329,1,A,C,71067924,110663,70981979,71375195,85945
2,ENSG00000233870.1,71178587,2-71067924-A-T,rs2287329,1,A,T,71067924,110663,70981979,71375195,85945
2,ENSG00000235833.1,97524976,2-97657198-A-C,rs2290124,-1,A,C,97657198,132222,97328368,97721584,328830
2,ENSG00000235833.1,97524976,2-97657198-A-G,rs2290124,-1,A,G,97657198,132222,97328368,97721584,328830
2,ENSG00000186235.6,238231585,2-238273263-A-G,rs2304674,-1,A,G,238273263,41678,238034977,238428193,238286
2,ENSG00000224891.1,37148530,2-37149171-G-C,rs2307466,1,G,C,37149171,641,36951922,37345138,197249
2,ENSG00000233654.1,190534855,2-190423345-G-T,rs2354877,1,G,T,190423345,111510,190338247,190731463,85098
2,ENSG00000261338.1,218255319,2-218286495-A-T,rs2382817,1,A,T,218286495,31176,218058711,218451927,227784
2,ENSG00000261338.1,218255319,2-218286495-A-C,rs2382817,1,A,C,218286495,31176,218058711,218451927,227784
2,ENSG00000261338.1,218255319,2-218286495-A-G,rs2382817,1,A,G,218286495,31176,218058711,218451927,227784
2,ENSG00000228590.1,60439828,2-60338433-T-G,rs243091,-1,T,G,60338433,101395,60243220,60636436,95213
2,ENSG00000228590.1,60439828,2-60338433-T-C,rs243091,-1,T,C,60338433,101395,60243220,60636436,95213
2,ENSG00000227799.1,55224280,2-55246545-A-C,rs2589081,1,A,C,55246545,22265,55027672,55420888,218873
2,ENSG00000227799.1,55224280,2-55246545-A-G,rs2589081,1,A,G,55246545,22265,55027672,55420888,218873
2,ENSG00000212978.4,61144950,2-61178660-G-C,rs2600665,-1,G,C,61178660,33710,60948342,61341558,230318
2,ENSG00000212978.4,61144950,2-61178660-G-T,rs2600665,-1,G,T,61178660,33710,60948342,61341558,230318
2,ENSG00000235770.1,215843536,2-215661288-A-C,rs2678286,-1,A,C,215661288,182248,215646928,216040144,14360
2,ENSG00000235770.1,215843536,2-215661288-A-T,rs2678286,-1,A,T,215661288,182248,215646928,216040144,14360
2,ENSG00000235770.1,215843536,2-215661288-A-G,rs2678286,-1,A,G,215661288,182248,215646928,216040144,14360
2,ENSG00000232713.1,60938604,2-61041157-T-C,rs2698189,-1,T,C,61041157,102553,60741996,61135212,299161
2,ENSG00000230406.1,221592441,2-221606293-T-C,rs2710525,1,T,C,221606293,13852,221395833,221789049,210460
2,ENSG00000230406.1,221592441,2-221606293-T-A,rs2710525,1,T,A,221606293,13852,221395833,221789049,210460
2,ENSG00000230406.1,221592441,2-221606293-T-G,rs2710525,1,T,G,221606293,13852,221395833,221789049,210460
2,ENSG00000225523.2,90021567,2-90190754-A-G,rs2847976,1,A,G,90190754,169187,89824959,90218175,365795
2,ENSG00000230799.1,201762737,2-201808220-A-G,rs2882322,1,A,G,201808220,45483,201566129,201959345,242091
2,ENSG00000260942.1,240586699,2-240579572-A-G,rs2975748,-1,A,G,240579572,7127,240390091,240783307,189481
2,ENSG00000260942.1,240586699,2-240579572-A-C,rs2975748,-1,A,C,240579572,7127,240390091,240783307,189481
2,ENSG00000231890.1,135985124,2-135931179-G-A,rs309161,1,G,A,135931179,53945,135788516,136181732,142663
2,ENSG00000233296.1,680081,2-677295-C-T,rs3210390,1,C,T,677295,2786,483473,876689,193822
2,ENSG00000227270.1,107903964,2-107995735-A-G,rs333214,1,A,G,107995735,91771,107707356,108100572,288379
2,ENSG00000234028.2,88627539,2-88728129-C-T,rs335115,1,C,T,88728129,100590,88430931,88824147,297198
2,ENSG00000236255.1,117833937,2-117835502-C-T,rs34156522,1,C,T,117835502,1565,117637329,118030545,198173
2,ENSG00000236502.1,44941916,2-44758772-A-C,rs343945,-1,A,C,44758772,183144,44745308,45138524,13464
2,ENSG00000226266.1,159712430,2-159840794-C-A,rs34702313,-1,C,A,159840794,128364,159515822,159909038,324972
2,ENSG00000235235.4,91817771,2-91863464-A-C,rs35614371,1,A,C,91863464,45693,91621163,92014379,242301
2,ENSG00000237510.2,95792220,2-95700142-T-C,rs35711624,1,T,C,95700142,92078,95595612,95988828,104530
2,ENSG00000234174.1,113175337,2-113179986-A-G,rs3762494,-1,A,G,113179986,4649,112978729,113371945,201257
2,ENSG00000224152.1,159615292,2-159774411-C-T,rs3771720,1,C,T,159774411,159119,159418684,159811900,355727
2,ENSG00000224137.1,207662376,2-207659476-A-T,rs3845812,1,A,T,207659476,2900,207465768,207858984,193708
2,ENSG00000224137.1,207662376,2-207659476-A-G,rs3845812,1,A,G,207659476,2900,207465768,207858984,193708
2,ENSG00000180152.3,112853328,2-112828892-A-T,rs3917365,1,A,T,112828892,24436,112656720,113049936,172172
2,ENSG00000180152.3,112853328,2-112828892-A-G,rs3917365,1,A,G,112828892,24436,112656720,113049936,172172
2,ENSG00000223816.3,92035000,2-92003556-A-C,rs4116423,-1,A,C,92003556,31444,91838392,92231608,165164
2,ENSG00000224043.3,134918670,2-134918197-T-C,rs41449851,-1,T,C,134918197,473,134722062,135115278,196135
2,ENSG00000230002.1,73456764,2-73314705-G-A,rs41451449,1,G,A,73314705,142059,73260156,73653372,54549
2,ENSG00000227368.1,112932625,2-113116294-G-A,rs4251955,1,G,A,113116294,183669,112736017,113129233,380277
2,ENSG00000227368.1,112932625,2-113116294-G-C,rs4251955,1,G,C,113116294,183669,112736017,113129233,380277
2,ENSG00000237732.4,222318275,2-222446088-T-C,rs4380225,1,T,C,222446088,127813,222121667,222514883,324421
2,ENSG00000237732.4,222318275,2-222446088-T-G,rs4380225,1,T,G,222446088,127813,222121667,222514883,324421
2,ENSG00000237732.4,222318275,2-222446088-T-A,rs4380225,1,T,A,222446088,127813,222121667,222514883,324421
2,ENSG00000260077.1,10040663,2-10053051-C-A,rs4444493,-1,C,A,10053051,12388,9844055,10237271,208996
2,ENSG00000234171.1,3558439,2-3561166-T-C,rs4583476,1,T,C,3561166,2727,3361831,3755047,199335
2,ENSG00000234171.1,3558439,2-3561166-T-A,rs4583476,1,T,A,3561166,2727,3361831,3755047,199335
2,ENSG00000225234.1,3482409,2-3478086-G-A,rs4641971,-1,G,A,3478086,4323,3285801,3679017,192285
2,ENSG00000225234.1,3482409,2-3478086-G-T,rs4641971,-1,G,T,3478086,4323,3285801,3679017,192285
2,ENSG00000214821.3,170602228,2-170569344-C-T,rs4668278,-1,C,T,170569344,32884,170405620,170798836,163724
2,ENSG00000214821.3,170602228,2-170569344-C-A,rs4668278,-1,C,A,170569344,32884,170405620,170798836,163724
2,ENSG00000214821.3,170602228,2-170569344-C-G,rs4668278,-1,C,G,170569344,32884,170405620,170798836,163724
2,ENSG00000238029.1,100425348,2-100388683-C-A,rs4850931,1,C,A,100388683,36665,100228740,100621956,159943
2,ENSG00000238029.1,100425348,2-100388683-C-T,rs4850931,1,C,T,100388683,36665,100228740,100621956,159943
2,ENSG00000236431.1,95536495,2-95718829-C-A,rs4907275,-1,C,A,95718829,182334,95339887,95733103,378942
2,ENSG00000236431.1,95536495,2-95718829-C-G,rs4907275,-1,C,G,95718829,182334,95339887,95733103,378942
2,ENSG00000226806.1,135820191,2-135814412-T-A,rs4954445,1,T,A,135814412,5779,135623583,136016799,190829
2,ENSG00000226806.1,135820191,2-135814412-T-C,rs4954445,1,T,C,135814412,5779,135623583,136016799,190829
2,ENSG00000172799.5,231434426,2-231489536-C-A,rs4973422,-1,C,A,231489536,55110,231237818,231631034,251718
2,ENSG00000181798.2,231514396,2-231513882-C-T,rs4973431,-1,C,T,231513882,514,231317788,231711004,196094
2,ENSG00000181798.2,231514396,2-231513882-C-G,rs4973431,-1,C,G,231513882,514,231317788,231711004,196094
2,ENSG00000181798.2,231514396,2-231513882-C-A,rs4973431,-1,C,A,231513882,514,231317788,231711004,196094
2,ENSG00000261186.1,242088457,2-242078572-G-A,rs4973686,-1,G,A,242078572,9885,241891849,242285065,186723
2,ENSG00000261186.1,242088457,2-242078572-G-T,rs4973686,-1,G,T,242078572,9885,241891849,242285065,186723
2,ENSG00000231414.1,70254010,2-70079228-A-C,rs56126702,-1,A,C,70079228,174782,70057402,70450618,21826
2,ENSG00000236790.1,8324630,2-8268050-A-G,rs56129208,-1,A,G,8268050,56580,8128022,8521238,140028
2,ENSG00000214329.2,91931714,2-91748437-G-A,rs58198317,-1,G,A,91748437,183277,91735106,92128322,13331
2,ENSG00000214329.2,91931714,2-91748437-G-C,rs58198317,-1,G,C,91748437,183277,91735106,92128322,13331
2,ENSG00000232992.2,138902747,2-138783495-C-T,rs60663874,-1,C,T,138783495,119252,138706139,139099355,77356
2,ENSG00000231739.2,187415552,2-187314268-C-T,rs62174473,1,C,T,187314268,101284,187218944,187612160,95324
2,ENSG00000229267.1,214810209,2-214807822-G-A,rs6435862,1,G,A,214807822,2387,214613601,215006817,194221
2,ENSG00000229267.1,214810209,2-214807822-G-C,rs6435862,1,G,C,214807822,2387,214613601,215006817,194221
2,ENSG00000229267.1,214810209,2-214807822-G-T,rs6435862,1,G,T,214807822,2387,214613601,215006817,194221
2,ENSG00000241962.3,99141485,2-99208502-G-T,rs6542873,1,G,T,99208502,67017,98944877,99338093,263625
2,ENSG00000241962.3,99141485,2-99208502-G-A,rs6542873,1,G,A,99208502,67017,98944877,99338093,263625
2,ENSG00000233806.2,241881366,2-241943048-A-G,rs6605261,1,A,G,241943048,61682,241684758,242077974,258290
2,ENSG00000233806.2,241881366,2-241943048-A-T,rs6605261,1,A,T,241943048,61682,241684758,242077974,258290
2,ENSG00000233806.2,241881366,2-241943048-A-C,rs6605261,1,A,C,241943048,61682,241684758,242077974,258290
2,ENSG00000235151.1,241844380,2-241796572-G-A,rs66492541,1,G,A,241796572,47808,241647772,242040988,148800
2,ENSG00000235151.1,241844380,2-241796572-G-C,rs66492541,1,G,C,241796572,47808,241647772,242040988,148800
2,ENSG00000232485.2,216498761,2-216427610-C-T,rs6711638,-1,C,T,216427610,71151,216302153,216695369,125457
2,ENSG00000237940.2,241970683,2-241987082-T-G,rs6712567,1,T,G,241987082,16399,241774075,242167291,213007
2,ENSG00000237940.2,241970683,2-241987082-T-A,rs6712567,1,T,A,241987082,16399,241774075,242167291,213007
2,ENSG00000237940.2,241970683,2-241987082-T-C,rs6712567,1,T,C,241987082,16399,241774075,242167291,213007
2,ENSG00000230408.3,200812170,2-200625113-C-T,rs6720189,-1,C,T,200625113,187057,200615562,201008778,9551
2,ENSG00000186825.3,131796178,2-131682500-G-A,rs6720375,-1,G,A,131682500,113678,131599570,131992786,82930
2,ENSG00000186825.3,131796178,2-131682500-G-C,rs6720375,-1,G,C,131682500,113678,131599570,131992786,82930
2,ENSG00000197927.7,131722417,2-131682500-G-A,rs6720375,1,G,A,131682500,39917,131525809,131919025,156691
2,ENSG00000197927.7,131722417,2-131682500-G-C,rs6720375,1,G,C,131682500,39917,131525809,131919025,156691
2,ENSG00000228043.1,138501698,2-138511232-A-C,rs6720716,-1,A,C,138511232,9534,138305090,138698306,206142
2,ENSG00000228043.1,138501698,2-138511232-A-G,rs6720716,-1,A,G,138511232,9534,138305090,138698306,206142
2,ENSG00000228043.1,138501698,2-138511232-A-T,rs6720716,-1,A,T,138511232,9534,138305090,138698306,206142
2,ENSG00000228925.1,46899275,2-46899331-G-C,rs6727958,1,G,C,46899331,56,46702667,47095883,196664
2,ENSG00000243650.1,230507101,2-230501847-C-T,rs6751402,1,C,T,230501847,5254,230310493,230703709,191354
2,ENSG00000243650.1,230507101,2-230501847-C-A,rs6751402,1,C,A,230501847,5254,230310493,230703709,191354
2,ENSG00000214184.3,108534196,2-108539819-G-A,rs6754683,-1,G,A,108539819,5623,108337588,108730804,202231
2,ENSG00000214184.3,108534196,2-108539819-G-C,rs6754683,-1,G,C,108539819,5623,108337588,108730804,202231
2,ENSG00000214184.3,108534196,2-108539819-G-T,rs6754683,-1,G,T,108539819,5623,108337588,108730804,202231
2,ENSG00000237753.1,112645720,2-112663757-G-T,rs6793,-1,G,T,112663757,18037,112449112,112842328,214645
2,ENSG00000237753.1,112645720,2-112663757-G-C,rs6793,-1,G,C,112663757,18037,112449112,112842328,214645
2,ENSG00000237753.1,112645720,2-112663757-G-A,rs6793,-1,G,A,112663757,18037,112449112,112842328,214645
2,ENSG00000224272.2,241810637,2-241759875-C-T,rs71430382,-1,C,T,241759875,50762,241614029,242007245,145846
2,ENSG00000226833.1,28751600,2-28663138-G-A,rs72782257,-1,G,A,28663138,88462,28554992,28948208,108146
2,ENSG00000235013.1,230957593,2-230948320-T-C,rs73095543,1,T,C,230948320,9273,230760985,231154201,187335
2,ENSG00000235013.1,230957593,2-230948320-T-A,rs73095543,1,T,A,230948320,9273,230760985,231154201,187335
2,ENSG00000226853.1,174487387,2-174503602-C-T,rs73975139,1,C,T,174503602,16215,174290779,174683995,212823
2,ENSG00000226853.1,174487387,2-174503602-C-A,rs73975139,1,C,A,174503602,16215,174290779,174683995,212823
2,ENSG00000234572.1,64863626,2-64905574-T-C,rs7423214,-1,T,C,64905574,41948,64667018,65060234,238556
2,ENSG00000237638.1,65056168,2-64905574-T-C,rs7423214,-1,T,C,64905574,150594,64859560,65252776,46014
2,ENSG00000213055.3,232730198,2-232576992-A-C,rs74453786,-1,A,C,232576992,153206,232533590,232926806,43402
2,ENSG00000231536.1,110610916,2-110648647-G-A,rs75153234,1,G,A,110648647,37731,110414308,110807524,234339
2,ENSG00000180178.5,130040560,2-129891576-G-T,rs75407243,-1,G,T,129891576,148984,129843952,130237168,47624
2,ENSG00000227497.1,91877969,2-91737435-T-C,rs7559391,1,T,C,91737435,140534,91681361,92074577,56074
2,ENSG00000227497.1,91877969,2-91737435-T-A,rs7559391,1,T,A,91737435,140534,91681361,92074577,56074
2,ENSG00000232613.1,65030747,2-65050889-C-T,rs7559813,1,C,T,65050889,20142,64834139,65227355,216750
2,ENSG00000229127.1,210030733,2-210033207-C-T,rs7560910,1,C,T,210033207,2474,209834125,210227341,199082
2,ENSG00000229127.1,210030733,2-210033207-C-G,rs7560910,1,C,G,210033207,2474,209834125,210227341,199082
2,ENSG00000228551.1,109251422,2-109440847-G-T,rs7568486,1,G,T,109440847,189425,109054814,109448030,386033
2,ENSG00000228551.1,109251422,2-109440847-G-A,rs7568486,1,G,A,109440847,189425,109054814,109448030,386033
2,ENSG00000230385.1,230908852,2-230949488-G-T,rs7569545,1,G,T,230949488,40636,230712244,231105460,237244
2,ENSG00000231546.1,236409077,2-236321004-C-G,rs75812139,-1,C,G,236321004,88073,236212469,236605685,108535
2,ENSG00000231546.1,236409077,2-236321004-C-T,rs75812139,-1,C,T,236321004,88073,236212469,236605685,108535
2,ENSG00000188765.6,3617757,2-3524018-A-G,rs75827652,-1,A,G,3524018,93739,3421149,3814365,102869
2,ENSG00000203387.2,228353215,2-228540749-G-A,rs7590961,-1,G,A,228540749,187534,228156607,228549823,384142
2,ENSG00000217950.3,131444587,2-131350804-A-C,rs7596865,-1,A,C,131350804,93783,131247979,131641195,102825
2,ENSG00000217950.3,131444587,2-131350804-A-G,rs7596865,-1,A,G,131350804,93783,131247979,131641195,102825
2,ENSG00000237877.1,186486005,2-186577105-G-T,rs76405227,-1,G,T,186577105,91100,186289397,186682613,287708
2,ENSG00000237877.1,186486005,2-186577105-G-A,rs76405227,-1,G,A,186577105,91100,186289397,186682613,287708
2,ENSG00000228203.1,6918709,2-6920498-C-T,rs771274,-1,C,T,6920498,1789,6722101,7115317,198397
2,ENSG00000224041.2,90114838,2-89941045-C-A,rs77673705,1,C,A,89941045,173793,89918230,90311446,22815
2,ENSG00000236432.2,227325164,2-227325204-C-T,rs77737296,-1,C,T,227325204,40,227128556,227521772,196648
2,ENSG00000227252.1,237085768,2-236899459-T-G,rs77928552,-1,T,G,236899459,186309,236889160,237282376,10299
2,ENSG00000228507.1,171491422,2-171586155-T-G,rs78221949,1,T,G,171586155,94733,171294814,171688030,291341
2,ENSG00000227617.2,168786429,2-168736637-G-A,rs78837218,-1,G,A,168736637,49792,168589821,168983037,146816
2,ENSG00000224220.1,25421117,2-25468623-C-T,rs78853597,1,C,T,25468623,47506,25224509,25617725,244114
2,ENSG00000232970.1,216156811,2-216345074-C-A,rs79248360,-1,C,A,216345074,188263,215960203,216353419,384871
2,ENSG00000232970.1,216156811,2-216345074-C-T,rs79248360,-1,C,T,216345074,188263,215960203,216353419,384871
2,ENSG00000214657.2,15869939,2-15931401-G-C,rs79631687,1,G,C,15931401,61462,15673331,16066547,258070
2,ENSG00000214657.2,15869939,2-15931401-G-A,rs79631687,1,G,A,15931401,61462,15673331,16066547,258070
2,ENSG00000229689.1,95525345,2-95665873-C-A,rs79726494,1,C,A,95665873,140528,95328737,95721953,337136
2,ENSG00000227653.1,128519177,2-128527313-C-A,rs841082,-1,C,A,128527313,8136,128322569,128715785,204744
2,ENSG00000227653.1,128519177,2-128527313-C-T,rs841082,-1,C,T,128527313,8136,128322569,128715785,204744
2,ENSG00000237522.1,60938049,2-60909363-A-C,rs842616,-1,A,C,60909363,28686,60741441,61134657,167922
2,ENSG00000231969.1,149587673,2-149695876-C-A,rs848223,1,C,A,149695876,108203,149391065,149784281,304811
2,ENSG00000236148.3,64347741,2-64410368-G-A,rs868986,-1,G,A,64410368,62627,64151133,64544349,259235
2,ENSG00000237641.1,231789887,2-231862453-G-C,rs878444,-1,G,C,231862453,72566,231593279,231986495,269174
2,ENSG00000230395.1,87120980,2-87314821-A-T,rs908770,-1,A,T,87314821,193841,86924372,87317588,390449
2,ENSG00000230395.1,87120980,2-87314821-A-C,rs908770,-1,A,C,87314821,193841,86924372,87317588,390449
2,ENSG00000234936.1,43229573,2-43222999-G-A,rs9170,1,G,A,43222999,6574,43032965,43426181,190034
2,ENSG00000234936.1,43229573,2-43222999-G-T,rs9170,1,G,T,43222999,6574,43032965,43426181,190034
2,ENSG00000214330.4,91840601,2-91742466-T-A,rs9653606,1,T,A,91742466,98135,91643993,92037209,98473
2,ENSG00000214330.4,91840601,2-91742466-T-G,rs9653606,1,T,G,91742466,98135,91643993,92037209,98473
2,ENSG00000224184.1,12007128,2-11988366-T-G,rs10166800,1,T,G,11988366,18762,11810520,12203736,177846
2,ENSG00000226928.1,111296046,2-111177400-C-T,rs10169613,-1,C,T,111177400,118646,111099438,111492654,77962
2,ENSG00000235128.1,126679622,2-126697294-G-T,rs10174588,1,G,T,126697294,17672,126483014,126876230,214280
2,ENSG00000235128.1,126679622,2-126697294-G-A,rs10174588,1,G,A,126697294,17672,126483014,126876230,214280
2,ENSG00000235128.1,126679622,2-126697294-G-C,rs10174588,1,G,C,126697294,17672,126483014,126876230,214280
2,ENSG00000226491.1,42798712,2-42797402-G-A,rs10186492,-1,G,A,42797402,1310,42602104,42995320,195298
2,ENSG00000225234.1,3482409,2-3476188-T-C,rs10188054,-1,T,C,3476188,6221,3285801,3679017,190387
2,ENSG00000228551.1,109251422,2-109268953-G-C,rs10195035,1,G,C,109268953,17531,109054814,109448030,214139
2,ENSG00000228551.1,109251422,2-109268953-G-A,rs10195035,1,G,A,109268953,17531,109054814,109448030,214139
2,ENSG00000214329.2,91931714,2-91893614-G-T,rs10200611,-1,G,T,91893614,38100,91735106,92128322,158508
2,ENSG00000214329.2,91931714,2-91893614-G-A,rs10200611,-1,G,A,91893614,38100,91735106,92128322,158508
2,ENSG00000214329.2,91931714,2-91893614-G-C,rs10200611,-1,G,C,91893614,38100,91735106,92128322,158508
2,ENSG00000231969.1,149587673,2-149567238-G-T,rs10204262,1,G,T,149567238,20435,149391065,149784281,176173
2,ENSG00000231969.1,149587673,2-149567238-G-C,rs10204262,1,G,C,149567238,20435,149391065,149784281,176173
2,ENSG00000231969.1,149587673,2-149567238-G-A,rs10204262,1,G,A,149567238,20435,149391065,149784281,176173
2,ENSG00000244063.1,113831119,2-113843665-T-C,rs1028246,-1,T,C,113843665,12546,113634511,114027727,209154
2,ENSG00000226266.1,159712430,2-159548987-C-T,rs10489997,-1,C,T,159548987,163443,159515822,159909038,33165
2,ENSG00000237442.2,41156598,2-41048432-A-G,rs10490373,1,A,G,41048432,108166,40959990,41353206,88442
2,ENSG00000259915.1,186356773,2-186349003-T-C,rs10497668,-1,T,C,186349003,7770,186160165,186553381,188838
2,ENSG00000259915.1,186356773,2-186349003-T-A,rs10497668,-1,T,A,186349003,7770,186160165,186553381,188838
2,ENSG00000231312.2,39437433,2-39485235-T-C,rs1060691,1,T,C,39485235,47802,39240825,39634041,244410
2,ENSG00000231312.2,39437433,2-39485235-T-A,rs1060691,1,T,A,39485235,47802,39240825,39634041,244410
2,ENSG00000260059.1,138602426,2-138671498-G-A,rs10803570,-1,G,A,138671498,69072,138405818,138799034,265680
2,ENSG00000234350.1,170813670,2-170724831-G-A,rs10930437,-1,G,A,170724831,88839,170617062,171010278,107769
2,ENSG00000234350.1,170813670,2-170724831-G-C,rs10930437,-1,G,C,170724831,88839,170617062,171010278,107769
2,ENSG00000234793.1,241755740,2-241751260-G-A,rs1106639,-1,G,A,241751260,4480,241559132,241952348,192128
2,ENSG00000189223.7,113235536,2-113236840-G-A,rs1110839,1,G,A,113236840,1304,113038928,113432144,197912
2,ENSG00000189223.7,113235536,2-113236840-G-T,rs1110839,1,G,T,113236840,1304,113038928,113432144,197912
2,ENSG00000189223.7,113235536,2-113236840-G-C,rs1110839,1,G,C,113236840,1304,113038928,113432144,197912
2,ENSG00000180178.5,130040560,2-130159332-G-C,rs112307532,-1,G,C,130159332,118772,129843952,130237168,315380
2,ENSG00000180178.5,130040560,2-130159332-G-T,rs112307532,-1,G,T,130159332,118772,129843952,130237168,315380
2,ENSG00000224891.1,37148530,2-37005187-C-G,rs1123648,1,C,G,37005187,143343,36951922,37345138,53265
2,ENSG00000224891.1,37148530,2-37005187-C-T,rs1123648,1,C,T,37005187,143343,36951922,37345138,53265
2,ENSG00000260942.1,240586699,2-240602394-C-T,rs114966520,-1,C,T,240602394,15695,240390091,240783307,212303
2,ENSG00000260942.1,240586699,2-240602394-C-A,rs114966520,-1,C,A,240602394,15695,240390091,240783307,212303
2,ENSG00000260942.1,240586699,2-240602394-C-G,rs114966520,-1,C,G,240602394,15695,240390091,240783307,212303
2,ENSG00000228802.1,223967706,2-223959900-A-G,rs11546405,-1,A,G,223959900,7806,223771098,224164314,188802
2,ENSG00000224041.2,90114838,2-90176529-A-C,rs115899805,1,A,C,90176529,61691,89918230,90311446,258299
2,ENSG00000224041.2,90114838,2-90176529-A-T,rs115899805,1,A,T,90176529,61691,89918230,90311446,258299
2,ENSG00000260804.1,216217045,2-216088971-C-A,rs116018538,1,C,A,216088971,128074,216020437,216413653,68534
2,ENSG00000260804.1,216217045,2-216088971-C-T,rs116018538,1,C,T,216088971,128074,216020437,216413653,68534
2,ENSG00000211632.2,90172802,2-90108556-C-T,rs116171884,1,C,T,90108556,64246,89976194,90369410,132362
2,ENSG00000211632.2,90172802,2-90108556-C-A,rs116171884,1,C,A,90108556,64246,89976194,90369410,132362
2,ENSG00000211632.2,90172802,2-90108556-C-G,rs116171884,1,C,G,90108556,64246,89976194,90369410,132362
2,ENSG00000243264.1,89947512,2-90108556-C-T,rs116171884,1,C,T,90108556,161044,89750904,90144120,357652
2,ENSG00000243264.1,89947512,2-90108556-C-A,rs116171884,1,C,A,90108556,161044,89750904,90144120,357652
2,ENSG00000243264.1,89947512,2-90108556-C-G,rs116171884,1,C,G,90108556,161044,89750904,90144120,357652
2,ENSG00000196096.3,213284205,2-213443898-A-T,rs11677794,-1,A,T,213443898,159693,213087597,213480813,356301
2,ENSG00000196096.3,213284205,2-213443898-A-G,rs11677794,-1,A,G,213443898,159693,213087597,213480813,356301
2,ENSG00000213126.2,179814251,2-179817141-C-A,rs11680455,1,C,A,179817141,2890,179617643,180010859,199498
2,ENSG00000213126.2,179814251,2-179817141-C-T,rs11680455,1,C,T,179817141,2890,179617643,180010859,199498
2,ENSG00000235997.2,30346623,2-30336950-A-G,rs11680937,1,A,G,30336950,9673,30150015,30543231,186935
2,ENSG00000225889.2,64143239,2-64211945-C-G,rs11690638,1,C,G,64211945,68706,63946631,64339847,265314
2,ENSG00000225889.2,64143239,2-64211945-C-T,rs11690638,1,C,T,64211945,68706,63946631,64339847,265314
2,ENSG00000242076.1,89268506,2-89203631-G-A,rs11690913,-1,G,A,89203631,64875,89071898,89465114,131733
2,ENSG00000234028.2,88627539,2-88483278-G-T,rs11690974,1,G,T,88483278,144261,88430931,88824147,52347
2,ENSG00000234028.2,88627539,2-88483278-G-C,rs11690974,1,G,C,88483278,144261,88430931,88824147,52347
2,ENSG00000229503.1,62533059,2-62460245-A-G,rs11693346,-1,A,G,62460245,72814,62336451,62729667,123794
2,ENSG00000223816.3,92035000,2-91974615-C-T,rs117534047,-1,C,T,91974615,60385,91838392,92231608,136223
2,ENSG00000223816.3,92035000,2-91974615-C-A,rs117534047,-1,C,A,91974615,60385,91838392,92231608,136223
2,ENSG00000223816.3,92035000,2-91974615-C-G,rs117534047,-1,C,G,91974615,60385,91838392,92231608,136223
2,ENSG00000232713.1,60938604,2-60848054-C-T,rs1177206,-1,C,T,60848054,90550,60741996,61135212,106058
2,ENSG00000227497.1,91877969,2-91920044-A-T,rs118061427,1,A,T,91920044,42075,91681361,92074577,238683
2,ENSG00000227497.1,91877969,2-91920044-A-C,rs118061427,1,A,C,91920044,42075,91681361,92074577,238683
2,ENSG00000227497.1,91877969,2-91920044-A-G,rs118061427,1,A,G,91920044,42075,91681361,92074577,238683
2,ENSG00000228203.1,6918709,2-6918805-A-G,rs118107744,-1,A,G,6918805,96,6722101,7115317,196704
2,ENSG00000257702.1,74502552,2-74429248-G-A,rs11897853,1,G,A,74429248,73304,74305944,74699160,123304
2,ENSG00000177855.8,183608119,2-183563274-C-A,rs11900788,-1,C,A,183563274,44845,183411511,183804727,151763
2,ENSG00000177855.8,183608119,2-183563274-C-T,rs11900788,-1,C,T,183563274,44845,183411511,183804727,151763
2,ENSG00000204253.3,189923336,2-189741488-T-C,rs1225102,1,T,C,189741488,181848,189726728,190119944,14760
2,ENSG00000253559.1,189762704,2-189769812-A-C,rs1225107,1,A,C,189769812,7108,189566096,189959312,203716
2,ENSG00000253559.1,189762704,2-189769812-A-T,rs1225107,1,A,T,189769812,7108,189566096,189959312,203716
2,ENSG00000253559.1,189762704,2-189769812-A-G,rs1225107,1,A,G,189769812,7108,189566096,189959312,203716
2,ENSG00000237758.1,230725403,2-230699911-T-C,rs12476589,-1,T,C,230699911,25492,230528795,230922011,171116
2,ENSG00000237758.1,230725403,2-230699911-T-G,rs12476589,-1,T,G,230699911,25492,230528795,230922011,171116
2,ENSG00000233862.1,30140666,2-30266456-A-G,rs12479214,-1,A,G,30266456,125790,29944058,30337274,322398
2,ENSG00000233862.1,30140666,2-30266456-A-T,rs12479214,-1,A,T,30266456,125790,29944058,30337274,322398
2,ENSG00000229839.2,62146881,2-62215750-T-A,rs12620847,-1,T,A,62215750,68869,61950273,62343489,265477
2,ENSG00000229839.2,62146881,2-62215750-T-C,rs12620847,-1,T,C,62215750,68869,61950273,62343489,265477
2,ENSG00000229781.1,142854095,2-142862456-A-G,rs12691663,1,A,G,142862456,8361,142657487,143050703,204969
2,ENSG00000230385.1,230908852,2-231010571-T-G,rs12694884,1,T,G,231010571,101719,230712244,231105460,298327
2,ENSG00000230385.1,230908852,2-231010571-T-C,rs12694884,1,T,C,231010571,101719,230712244,231105460,298327
2,ENSG00000230385.1,230908852,2-231010571-T-A,rs12694884,1,T,A,231010571,101719,230712244,231105460,298327
2,ENSG00000227368.1,112932625,2-113072132-G-A,rs12711749,1,G,A,113072132,139507,112736017,113129233,336115
2,ENSG00000234171.1,3558439,2-3557878-A-C,rs12711976,1,A,C,3557878,561,3361831,3755047,196047
2,ENSG00000234171.1,3558439,2-3557878-A-G,rs12711976,1,A,G,3557878,561,3361831,3755047,196047
2,ENSG00000246575.2,85315041,2-85304684-C-G,rs12714139,1,C,G,85304684,10357,85118433,85511649,186251
2,ENSG00000246575.2,85315041,2-85304684-C-A,rs12714139,1,C,A,85304684,10357,85118433,85511649,186251
2,ENSG00000241244.1,90100236,2-90189822-A-C,rs12986609,1,A,C,90189822,89586,89903628,90296844,286194
2,ENSG00000241244.1,90100236,2-90189822-A-G,rs12986609,1,A,G,90189822,89586,89903628,90296844,286194
2,ENSG00000237753.1,112645720,2-112622404-C-G,rs12999361,-1,C,G,112622404,23316,112449112,112842328,173292
2,ENSG00000240286.1,209178804,2-209147975-A-C,rs12999691,1,A,C,209147975,30829,208982196,209375412,165779
2,ENSG00000235064.1,33840678,2-33667696-C-T,rs13035680,-1,C,T,33667696,172982,33644070,34037286,23626
2,ENSG00000186825.3,131796178,2-131710381-T-A,rs13391470,-1,T,A,131710381,85797,131599570,131992786,110811
2,ENSG00000186825.3,131796178,2-131710381-T-C,rs13391470,-1,T,C,131710381,85797,131599570,131992786,110811
2,ENSG00000230006.3,88782712,2-88767809-T-C,rs13393582,1,T,C,88767809,14903,88586104,88979320,181705
2,ENSG00000259848.1,94892756,2-94985024-G-A,rs13412957,-1,G,A,94985024,92268,94696148,95089364,288876
2,ENSG00000226666.1,221961737,2-222031137-T-C,rs13419328,1,T,C,222031137,69400,221765129,222158345,266008
2,ENSG00000234253.1,49878623,2-49858827-A-G,rs1363047,1,A,G,49858827,19796,49682015,50075231,176812
2,ENSG00000214199.3,106698676,2-106630131-T-A,rs1398130,-1,T,A,106630131,68545,106502068,106895284,128063
2,ENSG00000163016.5,73671030,2-73511677-A-G,rs1589576,1,A,G,73511677,159353,73474422,73867638,37255
2,ENSG00000163016.5,73671030,2-73511677-A-C,rs1589576,1,A,C,73511677,159353,73474422,73867638,37255
2,ENSG00000237641.1,231789887,2-231896307-A-G,rs16828492,-1,A,G,231896307,106420,231593279,231986495,303028
2,ENSG00000235042.1,216412696,2-216592048-T-C,rs16856407,-1,T,C,216592048,179352,216216088,216609304,375960
2,ENSG00000228446.1,224500100,2-224462855-C-T,rs16865992,-1,C,T,224462855,37245,224303492,224696708,159363
2,ENSG00000217702.1,74123965,2-73992908-G-T,rs17009553,1,G,T,73992908,131057,73927357,74320573,65551
2,ENSG00000217702.1,74123965,2-73992908-G-A,rs17009553,1,G,A,73992908,131057,73927357,74320573,65551
2,ENSG00000182814.6,84290777,2-84183118-G-A,rs17024623,1,G,A,84183118,107659,84094169,84487385,88949
2,ENSG00000229695.1,43681622,2-43572528-C-G,rs17031064,-1,C,G,43572528,109094,43485014,43878230,87514
2,ENSG00000229695.1,43681622,2-43572528-C-A,rs17031064,-1,C,A,43572528,109094,43485014,43878230,87514
2,ENSG00000229695.1,43681622,2-43572528-C-T,rs17031064,-1,C,T,43572528,109094,43485014,43878230,87514
2,ENSG00000235325.1,107921248,2-108077131-C-T,rs17035639,-1,C,T,108077131,155883,107724640,108117856,352491
2,ENSG00000212978.4,61144950,2-61077136-A-G,rs1729659,-1,A,G,61077136,67814,60948342,61341558,128794
2,ENSG00000236348.1,17385091,2-17251051-G-C,rs17477667,1,G,C,17251051,134040,17188483,17581699,62568
2,ENSG00000236348.1,17385091,2-17251051-G-A,rs17477667,1,G,A,17251051,134040,17188483,17581699,62568
2,ENSG00000185078.3,208031953,2-207985508-C-T,rs17640594,-1,C,T,207985508,46445,207835345,208228561,150163
2,ENSG00000185078.3,208031953,2-207985508-C-A,rs17640594,-1,C,A,207985508,46445,207835345,208228561,150163
2,ENSG00000173209.16,61177539,2-61186588-A-C,rs1809028,1,A,C,61186588,9049,60980931,61374147,205657
2,ENSG00000173209.16,61177539,2-61186588-A-G,rs1809028,1,A,G,61186588,9049,60980931,61374147,205657
2,ENSG00000173209.16,61177539,2-61186588-A-T,rs1809028,1,A,T,61186588,9049,60980931,61374147,205657
2,ENSG00000233870.1,71178587,2-71002603-A-T,rs1861074,1,A,T,71002603,175984,70981979,71375195,20624
2,ENSG00000233870.1,71178587,2-71002603-A-G,rs1861074,1,A,G,71002603,175984,70981979,71375195,20624
2,ENSG00000231158.1,158065545,2-158135013-T-G,rs2074954,1,T,G,158135013,69468,157868937,158262153,266076
2,ENSG00000229267.1,214810209,2-214845614-C-T,rs2121283,1,C,T,214845614,35405,214613601,215006817,232013
2,ENSG00000238018.1,54680045,2-54644382-C-A,rs2271323,-1,C,A,54644382,35663,54483437,54876653,160945
2,ENSG00000238018.1,54680045,2-54644382-C-T,rs2271323,-1,C,T,54644382,35663,54483437,54876653,160945
2,ENSG00000205086.5,41956806,2-41932038-G-A,rs2276697,-1,G,A,41932038,24768,41760198,42153414,171840
2,ENSG00000205086.5,41956806,2-41932038-G-T,rs2276697,-1,G,T,41932038,24768,41760198,42153414,171840
2,ENSG00000231890.1,135985124,2-135919622-T-C,rs2322725,1,T,C,135919622,65502,135788516,136181732,131106
2,ENSG00000228509.1,190841864,2-190739696-G-A,rs2356121,-1,G,A,190739696,102168,190645256,191038472,94440
2,ENSG00000237298.1,178523221,2-178702907-T-C,rs2366753,1,T,C,178702907,179686,178326613,178719829,376294
2,ENSG00000224490.1,165933857,2-165960027-T-A,rs2390317,1,T,A,165960027,26170,165737249,166130465,222778
2,ENSG00000224490.1,165933857,2-165960027-T-C,rs2390317,1,T,C,165960027,26170,165737249,166130465,222778
2,ENSG00000250207.1,129993105,2-129901142-T-A,rs2407072,-1,T,A,129901142,91963,129796497,130189713,104645
2,ENSG00000250207.1,129993105,2-129901142-T-C,rs2407072,-1,T,C,129901142,91963,129796497,130189713,104645
2,ENSG00000234572.1,64863626,2-64901564-T-G,rs2422354,-1,T,G,64901564,37938,64667018,65060234,234546
2,ENSG00000234572.1,64863626,2-64901564-T-C,rs2422354,-1,T,C,64901564,37938,64667018,65060234,234546
2,ENSG00000234572.1,64863626,2-64901564-T-A,rs2422354,-1,T,A,64901564,37938,64667018,65060234,234546
2,ENSG00000228325.2,90234812,2-90067648-A-T,rs2693240,1,A,T,90067648,167164,90038204,90431420,29444
2,ENSG00000228325.2,90234812,2-90067648-A-C,rs2693240,1,A,C,90067648,167164,90038204,90431420,29444
2,ENSG00000237522.1,60938049,2-60767303-A-G,rs28459296,-1,A,G,60767303,170746,60741441,61134657,25862
2,ENSG00000237522.1,60938049,2-60767303-A-T,rs28459296,-1,A,T,60767303,170746,60741441,61134657,25862
2,ENSG00000242766.1,90082635,2-89968860-G-A,rs2847917,1,G,A,89968860,113775,89886027,90279243,82833
2,ENSG00000242766.1,90082635,2-89968860-G-T,rs2847917,1,G,T,89968860,113775,89886027,90279243,82833
2,ENSG00000228380.1,208269957,2-208147143-T-G,rs2854711,-1,T,G,208147143,122814,208073349,208466565,73794
2,ENSG00000231848.1,44996413,2-45054453-C-A,rs2922017,1,C,A,45054453,58040,44799805,45193021,254648
2,ENSG00000231848.1,44996413,2-45054453-C-T,rs2922017,1,C,T,45054453,58040,44799805,45193021,254648
2,ENSG00000231351.2,86930754,2-86787254-C-T,rs2944254,-1,C,T,86787254,143500,86734146,87127362,53108
2,ENSG00000224839.1,208057745,2-208243593-C-T,rs34218846,-1,C,T,208243593,185848,207861137,208254353,382456
2,ENSG00000233806.2,241881366,2-241822779-T-G,rs34346880,1,T,G,241822779,58587,241684758,242077974,138021
2,ENSG00000233806.2,241881366,2-241822779-T-C,rs34346880,1,T,C,241822779,58587,241684758,242077974,138021
2,ENSG00000225057.2,238231684,2-238189953-T-C,rs34371548,1,T,C,238189953,41731,238035076,238428292,154877
2,ENSG00000230992.2,132352722,2-132161850-C-G,rs34528085,1,C,G,132161850,190872,132156114,132549330,5736
2,ENSG00000214465.3,26149204,2-25956020-C-T,rs34960191,1,C,T,25956020,193184,25952596,26345812,3424
2,ENSG00000214330.4,91840601,2-91863464-A-C,rs35614371,1,A,C,91863464,22863,91643993,92037209,219471
2,ENSG00000228857.2,113890937,2-113917679-C-T,rs35680405,-1,C,T,113917679,26742,113694329,114087545,223350
2,ENSG00000232760.1,131836532,2-131652488-C-T,rs35927124,-1,C,T,131652488,184044,131639924,132033140,12564
2,ENSG00000232760.1,131836532,2-131652488-C-A,rs35927124,-1,C,A,131652488,184044,131639924,132033140,12564
2,ENSG00000232760.1,131836532,2-131652488-C-G,rs35927124,-1,C,G,131652488,184044,131639924,132033140,12564
2,ENSG00000224165.1,24972072,2-25146354-T-A,rs3731634,1,T,A,25146354,174282,24775464,25168680,370890
2,ENSG00000224165.1,24972072,2-25146354-T-G,rs3731634,1,T,G,25146354,174282,24775464,25168680,370890
2,ENSG00000224165.1,24972072,2-25146354-T-C,rs3731634,1,T,C,25146354,174282,24775464,25168680,370890
2,ENSG00000260101.1,64524110,2-64587631-A-G,rs3770725,-1,A,G,64587631,63521,64327502,64720718,260129
2,ENSG00000235013.1,230957593,2-230813650-C-T,rs3792065,1,C,T,230813650,143943,230760985,231154201,52665
2,ENSG00000235013.1,230957593,2-230813650-C-A,rs3792065,1,C,A,230813650,143943,230760985,231154201,52665
2,ENSG00000236124.1,112981434,2-112822289-T-C,rs3917386,-1,T,C,112822289,159145,112784826,113178042,37463
2,ENSG00000237784.1,234329483,2-234503932-G-A,rs3935712,1,G,A,234503932,174449,234132875,234526091,371057
2,ENSG00000235235.4,91817771,2-92003556-A-C,rs4116423,1,A,C,92003556,185785,91621163,92014379,382393
2,ENSG00000235616.1,187825341,2-187706547-C-A,rs41348044,1,C,A,187706547,118794,187628733,188021949,77814
2,ENSG00000235616.1,187825341,2-187706547-C-G,rs41348044,1,C,G,187706547,118794,187628733,188021949,77814
2,ENSG00000235616.1,187825341,2-187706547-C-T,rs41348044,1,C,T,187706547,118794,187628733,188021949,77814
2,ENSG00000236397.2,113601261,2-113761733-A-G,rs41439449,-1,A,G,113761733,160472,113404653,113797869,357080
2,ENSG00000236682.1,127388202,2-127292055-T-C,rs4150407,1,T,C,127292055,96147,127191594,127584810,100461
2,ENSG00000231851.1,105102968,2-105171090-C-T,rs4241219,-1,C,T,105171090,68122,104906360,105299576,264730
2,ENSG00000197927.7,131722417,2-131804157-C-T,rs4270398,1,C,T,131804157,81740,131525809,131919025,278348
2,ENSG00000237638.1,65056168,2-64919060-G-A,rs4383321,-1,G,A,64919060,137108,64859560,65252776,59500
2,ENSG00000236432.2,227325164,2-227340213-C-T,rs4420693,-1,C,T,227340213,15049,227128556,227521772,211657
2,ENSG00000236432.2,227325164,2-227340213-C-A,rs4420693,-1,C,A,227340213,15049,227128556,227521772,211657
2,ENSG00000236432.2,227325164,2-227340213-C-G,rs4420693,-1,C,G,227340213,15049,227128556,227521772,211657
2,ENSG00000188765.6,3617757,2-3488858-T-C,rs4508632,-1,T,C,3488858,128899,3421149,3814365,67709
2,ENSG00000188765.6,3617757,2-3488858-T-G,rs4508632,-1,T,G,3488858,128899,3421149,3814365,67709
2,ENSG00000188765.6,3617757,2-3488858-T-A,rs4508632,-1,T,A,3488858,128899,3421149,3814365,67709
2,ENSG00000231908.1,208255214,2-208370648-G-A,rs4673402,1,G,A,208370648,115434,208058606,208451822,312042
2,ENSG00000224137.1,207662376,2-207643083-C-T,rs4675690,1,C,T,207643083,19293,207465768,207858984,177315
2,ENSG00000238029.1,100425348,2-100272924-T-C,rs4851282,1,T,C,100272924,152424,100228740,100621956,44184
2,ENSG00000237883.1,73981441,2-73975451-T-C,rs4852324,-1,T,C,73975451,5990,73784833,74178049,190618
2,ENSG00000224043.3,134918670,2-134904674-G-A,rs4954197,-1,G,A,134904674,13996,134722062,135115278,182612
2,ENSG00000224043.3,134918670,2-134904674-G-C,rs4954197,-1,G,C,134904674,13996,134722062,135115278,182612
2,ENSG00000181798.2,231514396,2-231489536-C-A,rs4973422,-1,C,A,231489536,24860,231317788,231711004,171748
2,ENSG00000261186.1,242088457,2-242092368-G-A,rs4973649,-1,G,A,242092368,3911,241891849,242285065,200519
2,ENSG00000261186.1,242088457,2-242092368-G-T,rs4973649,-1,G,T,242092368,3911,241891849,242285065,200519
2,ENSG00000261186.1,242088457,2-242092368-G-C,rs4973649,-1,G,C,242092368,3911,241891849,242285065,200519
2,ENSG00000237745.1,107914948,2-107939345-A-G,rs62148672,1,A,G,107939345,24397,107718340,108111556,221005
2,ENSG00000228251.1,112590796,2-112550173-G-A,rs62158587,1,G,A,112550173,40623,112394188,112787404,155985
2,ENSG00000235411.1,20241046,2-20177631-C-A,rs6419087,-1,C,A,20177631,63415,20044438,20437654,133193
2,ENSG00000213962.2,177998770,2-178046291-G-A,rs6433709,-1,G,A,178046291,47521,177802162,178195378,244129
2,ENSG00000213962.2,177998770,2-178046291-G-C,rs6433709,-1,G,C,178046291,47521,177802162,178195378,244129
2,ENSG00000235770.1,215843536,2-215812189-G-A,rs6435922,-1,G,A,215812189,31347,215646928,216040144,165261
2,ENSG00000237732.4,222318275,2-222285884-T-A,rs6436309,1,T,A,222285884,32391,222121667,222514883,164217
2,ENSG00000237732.4,222318275,2-222285884-T-G,rs6436309,1,T,G,222285884,32391,222121667,222514883,164217
2,ENSG00000237732.4,222318275,2-222285884-T-C,rs6436309,1,T,C,222285884,32391,222121667,222514883,164217
2,ENSG00000225963.1,230121370,2-230130610-G-C,rs6436907,1,G,C,230130610,9240,229924762,230317978,205848
2,ENSG00000225963.1,230121370,2-230130610-G-A,rs6436907,1,G,A,230130610,9240,229924762,230317978,205848
2,ENSG00000231635.1,98206151,2-98157041-C-T,rs6543330,1,C,T,98157041,49110,98009543,98402759,147498
2,ENSG00000237940.2,241970683,2-241943048-A-T,rs6605261,1,A,T,241943048,27635,241774075,242167291,168973
2,ENSG00000237940.2,241970683,2-241943048-A-G,rs6605261,1,A,G,241943048,27635,241774075,242167291,168973
2,ENSG00000237940.2,241970683,2-241943048-A-C,rs6605261,1,A,C,241943048,27635,241774075,242167291,168973
2,ENSG00000225787.1,85102694,2-85291151-C-T,rs6706073,-1,C,T,85291151,188457,84906086,85299302,385065
2,ENSG00000222017.1,197693106,2-197848507-G-A,rs6707521,1,G,A,197848507,155401,197496498,197889714,352009
2,ENSG00000227653.1,128519177,2-128670448-A-G,rs6708257,-1,A,G,128670448,151271,128322569,128715785,347879
2,ENSG00000227653.1,128519177,2-128670448-A-C,rs6708257,-1,A,C,128670448,151271,128322569,128715785,347879
2,ENSG00000214657.2,15869939,2-15997718-A-G,rs6709176,1,A,G,15997718,127779,15673331,16066547,324387
2,ENSG00000214657.2,15869939,2-15997718-A-T,rs6709176,1,A,T,15997718,127779,15673331,16066547,324387
2,ENSG00000228590.1,60439828,2-60500494-G-A,rs6709302,-1,G,A,60500494,60666,60243220,60636436,257274
2,ENSG00000235688.1,951502,2-883512-G-A,rs6709435,-1,G,A,883512,67990,754894,1148110,128618
2,ENSG00000226856.1,118186386,2-118224458-A-G,rs6715039,-1,A,G,118224458,38072,117989778,118382994,234680
2,ENSG00000232973.3,38075700,2-37947821-A-G,rs6716296,1,A,G,37947821,127879,37879092,38272308,68729
2,ENSG00000232973.3,38075700,2-37947821-A-T,rs6716296,1,A,T,37947821,127879,37879092,38272308,68729
2,ENSG00000233045.1,138278574,2-138253203-T-G,rs6734558,1,T,G,138253203,25371,138081966,138475182,171237
2,ENSG00000235151.1,241844380,2-241768747-C-T,rs6746151,1,C,T,241768747,75633,241647772,242040988,120975
2,ENSG00000226080.1,11102142,2-11118941-A-T,rs6750442,1,A,T,11118941,16799,10905534,11298750,213407
2,ENSG00000226080.1,11102142,2-11118941-A-G,rs6750442,1,A,G,11118941,16799,10905534,11298750,213407
2,ENSG00000226080.1,11102142,2-11118941-A-C,rs6750442,1,A,C,11118941,16799,10905534,11298750,213407
2,ENSG00000232613.1,65030747,2-64923736-C-T,rs6751300,1,C,T,64923736,107011,64834139,65227355,89597
2,ENSG00000233131.1,175184215,2-175334031-A-T,rs6757526,1,A,T,175334031,149816,174987607,175380823,346424
2,ENSG00000233131.1,175184215,2-175334031-A-G,rs6757526,1,A,G,175334031,149816,174987607,175380823,346424
2,ENSG00000232228.1,69595058,2-69405488-T-C,rs6759021,-1,T,C,69405488,189570,69398450,69791666,7038
2,ENSG00000224159.1,218200434,2-218131830-C-T,rs6761387,1,C,T,218131830,68604,218003826,218397042,128004
2,ENSG00000215692.2,241735498,2-241737769-G-A,rs71351115,-1,G,A,241737769,2271,241538890,241932106,198879
2,ENSG00000213148.3,173431812,2-173442997-C-T,rs72625245,-1,C,T,173442997,11185,173235204,173628420,207793
2,ENSG00000213148.3,173431812,2-173442997-C-G,rs72625245,-1,C,G,173442997,11185,173235204,173628420,207793
2,ENSG00000213148.3,173431812,2-173442997-C-A,rs72625245,-1,C,A,173442997,11185,173235204,173628420,207793
2,ENSG00000162997.10,55282329,2-55454325-T-C,rs72801530,1,T,C,55454325,171996,55085721,55478937,368604
2,ENSG00000236431.1,95536495,2-95727132-A-G,rs72948081,-1,A,G,95727132,190637,95339887,95733103,387245
2,ENSG00000236431.1,95536495,2-95727132-A-T,rs72948081,-1,A,T,95727132,190637,95339887,95733103,387245
2,ENSG00000227403.1,161244720,2-161236129-G-A,rs7309,1,G,A,161236129,8591,161048112,161441328,188017
2,ENSG00000224272.2,241810637,2-241804528-G-T,rs741776,-1,G,T,241804528,6109,241614029,242007245,190499
2,ENSG00000261338.1,218255319,2-218101592-C-G,rs7426289,1,C,G,218101592,153727,218058711,218451927,42881
2,ENSG00000261338.1,218255319,2-218101592-C-T,rs7426289,1,C,T,218101592,153727,218058711,218451927,42881
2,ENSG00000236790.1,8324630,2-8212814-C-T,rs74457339,-1,C,T,8212814,111816,8128022,8521238,84792
2,ENSG00000236790.1,8324630,2-8212814-C-A,rs74457339,-1,C,A,8212814,111816,8128022,8521238,84792
2,ENSG00000239819.1,90220727,2-90065136-C-T,rs74875650,1,C,T,90065136,155591,90024119,90417335,41017
2,ENSG00000260077.1,10040663,2-10128199-T-C,rs75249934,-1,T,C,10128199,87536,9844055,10237271,284144
2,ENSG00000234174.1,113175337,2-113215368-A-G,rs752590,-1,A,G,113215368,40031,112978729,113371945,236639
2,ENSG00000243819.1,10690344,2-10847969-C-A,rs75379303,1,C,A,10847969,157625,10493736,10886952,354233
2,ENSG00000243819.1,10690344,2-10847969-C-G,rs75379303,1,C,G,10847969,157625,10493736,10886952,354233
2,ENSG00000243819.1,10690344,2-10847969-C-T,rs75379303,1,C,T,10847969,157625,10493736,10886952,354233
2,ENSG00000233654.1,190534855,2-190533277-C-T,rs7556716,1,C,T,190533277,1578,190338247,190731463,195030
2,ENSG00000231043.2,58462032,2-58517535-C-A,rs7557639,-1,C,A,58517535,55503,58265424,58658640,252111
2,ENSG00000231043.2,58462032,2-58517535-C-G,rs7557639,-1,C,G,58517535,55503,58265424,58658640,252111
2,ENSG00000231043.2,58462032,2-58517535-C-T,rs7557639,-1,C,T,58517535,55503,58265424,58658640,252111
2,ENSG00000237877.1,186486005,2-186354992-T-C,rs7565452,-1,T,C,186354992,131013,186289397,186682613,65595
2,ENSG00000224646.2,74754819,2-74916540-G-A,rs7566005,-1,G,A,74916540,161721,74558211,74951427,358329
2,ENSG00000231672.2,217756593,2-217784764-T-G,rs7577167,-1,T,G,217784764,28171,217559985,217953201,224779
2,ENSG00000224220.1,25421117,2-25390277-T-C,rs7577599,1,T,C,25390277,30840,25224509,25617725,165768
2,ENSG00000228925.1,46899275,2-46901815-G-T,rs7586004,1,G,T,46901815,2540,46702667,47095883,199148
2,ENSG00000236969.1,91775944,2-91885541-C-T,rs7597312,1,C,T,91885541,109597,91579336,91972552,306205
2,ENSG00000223703.1,91736726,2-91885541-C-T,rs7597312,1,C,T,91885541,148815,91540118,91933334,345423
2,ENSG00000235522.1,105855240,2-105754451-G-C,rs7604409,-1,G,C,105754451,100789,105658632,106051848,95819
2,ENSG00000235522.1,105855240,2-105754451-G-A,rs7604409,-1,G,A,105754451,100789,105658632,106051848,95819
2,ENSG00000223935.1,64453798,2-64415419-T-C,rs7609154,-1,T,C,64415419,38379,64257190,64650406,158229
2,ENSG00000226340.1,148872797,2-148772380-G-C,rs76918096,-1,G,C,148772380,100417,148676189,149069405,96191
2,ENSG00000186235.6,238231585,2-238254093-C-T,rs77248397,-1,C,T,238254093,22508,238034977,238428193,219116
2,ENSG00000236330.1,110967834,2-110805298-C-T,rs77331476,1,C,T,110805298,162536,110771226,111164442,34072
2,ENSG00000233747.1,24334512,2-24342108-G-A,rs77524462,1,G,A,24342108,7596,24137904,24531120,204204
2,ENSG00000222041.5,87455506,2-87480209-T-G,rs78050112,1,T,G,87480209,24703,87258898,87652114,221311
2,ENSG00000222041.5,87455506,2-87480209-T-A,rs78050112,1,T,A,87480209,24703,87258898,87652114,221311
2,ENSG00000204792.2,74918148,2-74969604-A-G,rs7881,1,A,G,74969604,51456,74721540,75114756,248064
2,ENSG00000233296.1,680081,2-715112-A-G,rs79040397,1,A,G,715112,35031,483473,876689,231639
2,ENSG00000224152.1,159615292,2-159631428-G-A,rs79408443,1,G,A,159631428,16136,159418684,159811900,212744
2,ENSG00000257135.1,10448689,2-10455444-C-G,rs79632819,1,C,G,10455444,6755,10252081,10645297,203363
2,ENSG00000229089.1,94857282,2-95052450-C-T,rs79641586,-1,C,T,95052450,195168,94660674,95053890,391776
2,ENSG00000220804.4,242094894,2-241972899-C-T,rs79903379,1,C,T,241972899,121995,241898286,242291502,74613
2,ENSG00000214184.3,108534196,2-108684618-C-A,rs826590,-1,C,A,108684618,150422,108337588,108730804,347030
2,ENSG00000257800.1,74120680,2-74128117-G-T,rs828842,1,G,T,74128117,7437,73924072,74317288,204045
2,ENSG00000257800.1,74120680,2-74128117-G-A,rs828842,1,G,A,74128117,7437,73924072,74317288,204045
2,ENSG00000257800.1,74120680,2-74128117-G-C,rs828842,1,G,C,74128117,7437,73924072,74317288,204045
2,ENSG00000228784.1,19868874,2-19881090-A-G,rs893400,1,A,G,19881090,12216,19672266,20065482,208824
2,ENSG00000222020.2,239401703,2-239340592-T-A,rs908265,1,T,A,239340592,61111,239205095,239598311,135497
2,ENSG00000222020.2,239401703,2-239340592-T-C,rs908265,1,T,C,239340592,61111,239205095,239598311,135497
2,ENSG00000225439.2,74148079,2-74168944-A-G,rs9677593,1,A,G,74168944,20865,73951471,74344687,217473
2,ENSG00000223725.1,207529795,2-207484534-A-C,rs981901,-1,A,C,207484534,45261,207333187,207726403,151347
2,ENSG00000234936.1,43229573,2-43421037-A-G,rs10176241,1,A,G,43421037,191464,43032965,43426181,388072
2,ENSG00000230006.3,88782712,2-88702138-C-T,rs10179529,1,C,T,88702138,80574,88586104,88979320,116034
2,ENSG00000223816.3,92035000,2-91930984-T-C,rs10207094,-1,T,C,91930984,104016,91838392,92231608,92592
2,ENSG00000235235.4,91817771,2-91930984-T-C,rs10207094,1,T,C,91930984,113213,91621163,92014379,309821
2,ENSG00000233747.1,24334512,2-24458079-A-G,rs1031091,1,A,G,24458079,123567,24137904,24531120,320175
2,ENSG00000241772.1,138569090,2-138596928-A-G,rs10496798,1,A,G,138596928,27838,138372482,138765698,224446
2,ENSG00000179997.7,174501952,2-174398335-G-A,rs10497410,1,G,A,174398335,103617,174305344,174698560,92991
2,ENSG00000179997.7,174501952,2-174398335-G-C,rs10497410,1,G,C,174398335,103617,174305344,174698560,92991
2,ENSG00000229689.1,95525345,2-95668649-G-T,rs10515920,1,G,T,95668649,143304,95328737,95721953,339912
2,ENSG00000236397.2,113601261,2-113689607-A-G,rs11123205,-1,A,G,113689607,88346,113404653,113797869,284954
2,ENSG00000234488.1,63684305,2-63796060-A-G,rs111742389,1,A,G,63796060,111755,63487697,63880913,308363
2,ENSG00000229127.1,210030733,2-209839258-A-G,rs112831177,1,A,G,209839258,191475,209834125,210227341,5133
2,ENSG00000236859.1,121649320,2-121835828-G-A,rs112852500,1,G,A,121835828,186508,121452712,121845928,383116
2,ENSG00000211611.2,89160366,2-89186851-G-T,rs112901007,-1,G,T,89186851,26485,88963758,89356974,223093
2,ENSG00000240350.1,111491556,2-111621136-T-C,rs113835349,1,T,C,111621136,129580,111294948,111688164,326188
2,ENSG00000239855.1,88966767,2-88809128-C-T,rs115789219,-1,C,T,88809128,157639,88770159,89163375,38969
2,ENSG00000239819.1,90220727,2-90176529-A-C,rs115899805,1,A,C,90176529,44198,90024119,90417335,152410
2,ENSG00000239819.1,90220727,2-90176529-A-T,rs115899805,1,A,T,90176529,44198,90024119,90417335,152410
2,ENSG00000217289.3,129992889,2-129908321-G-A,rs116055140,1,G,A,129908321,84568,129796281,130189497,112040
2,ENSG00000217289.3,129992889,2-129908321-G-T,rs116055140,1,G,T,129908321,84568,129796281,130189497,112040
2,ENSG00000241244.1,90100236,2-90108556-C-A,rs116171884,1,C,A,90108556,8320,89903628,90296844,204928
2,ENSG00000241244.1,90100236,2-90108556-C-T,rs116171884,1,C,T,90108556,8320,89903628,90296844,204928
2,ENSG00000241244.1,90100236,2-90108556-C-G,rs116171884,1,C,G,90108556,8320,89903628,90296844,204928
2,ENSG00000228784.1,19868874,2-20004137-C-T,rs11677637,1,C,T,20004137,135263,19672266,20065482,331871
2,ENSG00000259863.1,109128930,2-109208334-T-A,rs11678150,-1,T,A,109208334,79404,108932322,109325538,276012
2,ENSG00000172965.6,111495070,2-111585100-C-T,rs116806727,-1,C,T,111585100,90030,111298462,111691678,286638
2,ENSG00000231969.1,149587673,2-149449189-G-A,rs11681264,1,G,A,149449189,138484,149391065,149784281,58124
2,ENSG00000246575.2,85315041,2-85441865-A-G,rs11682343,1,A,G,85441865,126824,85118433,85511649,323432
2,ENSG00000233296.1,680081,2-623259-T-G,rs11688230,1,T,G,623259,56822,483473,876689,139786
2,ENSG00000233296.1,680081,2-623259-T-A,rs11688230,1,T,A,623259,56822,483473,876689,139786
2,ENSG00000214330.4,91840601,2-91920044-A-C,rs118061427,1,A,C,91920044,79443,91643993,92037209,276051
2,ENSG00000214330.4,91840601,2-91920044-A-T,rs118061427,1,A,T,91920044,79443,91643993,92037209,276051
2,ENSG00000214330.4,91840601,2-91920044-A-G,rs118061427,1,A,G,91920044,79443,91643993,92037209,276051
2,ENSG00000230482.1,197263111,2-197206063-A-G,rs11885072,1,A,G,197206063,57048,197066503,197459719,139560
2,ENSG00000223935.1,64453798,2-64486877-A-G,rs11894104,-1,A,G,64486877,33079,64257190,64650406,229687
2,ENSG00000223935.1,64453798,2-64486877-A-C,rs11894104,-1,A,C,64486877,33079,64257190,64650406,229687
2,ENSG00000240253.1,130690133,2-130872059-C-T,rs11899956,1,C,T,130872059,181926,130493525,130886741,378534
2,ENSG00000237126.1,232611971,2-232551268-T-C,rs11899983,-1,T,C,232551268,60703,232415363,232808579,135905
2,ENSG00000260101.1,64524110,2-64600031-A-G,rs1206979,-1,A,G,64600031,75921,64327502,64720718,272529
2,ENSG00000260101.1,64524110,2-64600031-A-T,rs1206979,-1,A,T,64600031,75921,64327502,64720718,272529
2,ENSG00000237039.1,231256097,2-231368990-A-G,rs12468313,1,A,G,231368990,112893,231059489,231452705,309501
2,ENSG00000237039.1,231256097,2-231368990-A-C,rs12468313,1,A,C,231368990,112893,231059489,231452705,309501
2,ENSG00000261338.1,218255319,2-218337761-G-A,rs12471773,1,G,A,218337761,82442,218058711,218451927,279050
2,ENSG00000230595.1,62561423,2-62463991-C-A,rs12619762,-1,C,A,62463991,97432,62364815,62758031,99176
2,ENSG00000230595.1,62561423,2-62463991-C-G,rs12619762,-1,C,G,62463991,97432,62364815,62758031,99176
2,ENSG00000225523.2,90021567,2-90189822-A-C,rs12986609,1,A,C,90189822,168255,89824959,90218175,364863
2,ENSG00000225523.2,90021567,2-90189822-A-G,rs12986609,1,A,G,90189822,168255,89824959,90218175,364863
2,ENSG00000237784.1,234329483,2-234337886-A-G,rs12992235,1,A,G,234337886,8403,234132875,234526091,205011
2,ENSG00000234559.1,129940217,2-130034640-T-C,rs13022989,-1,T,C,130034640,94423,129743609,130136825,291031
2,ENSG00000234559.1,129940217,2-130034640-T-G,rs13022989,-1,T,G,130034640,94423,129743609,130136825,291031
2,ENSG00000229692.1,38993836,2-39003705-C-T,rs13024751,-1,C,T,39003705,9869,38797228,39190444,206477
2,ENSG00000213236.3,126558162,2-126439679-C-T,rs13031986,-1,C,T,126439679,118483,126361554,126754770,78125
2,ENSG00000213963.2,177392674,2-177334037-C-A,rs13032354,-1,C,A,177334037,58637,177196066,177589282,137971
2,ENSG00000223977.1,83219105,2-83316874-T-C,rs13383174,-1,T,C,83316874,97769,83022497,83415713,294377
2,ENSG00000223977.1,83219105,2-83316874-T-G,rs13383174,-1,T,G,83316874,97769,83022497,83415713,294377
2,ENSG00000197927.7,131722417,2-131710381-T-C,rs13391470,1,T,C,131710381,12036,131525809,131919025,184572
2,ENSG00000197927.7,131722417,2-131710381-T-A,rs13391470,1,T,A,131710381,12036,131525809,131919025,184572
2,ENSG00000237877.1,186486005,2-186529002-C-T,rs13397032,-1,C,T,186529002,42997,186289397,186682613,239605
2,ENSG00000237877.1,186486005,2-186529002-C-A,rs13397032,-1,C,A,186529002,42997,186289397,186682613,239605
2,ENSG00000228925.1,46899275,2-46884323-T-C,rs13410702,1,T,C,46884323,14952,46702667,47095883,181656
2,ENSG00000213189.3,159003975,2-158855385-C-G,rs13413317,1,C,G,158855385,148590,158807367,159200583,48018
2,ENSG00000213189.3,159003975,2-158855385-C-T,rs13413317,1,C,T,158855385,148590,158807367,159200583,48018
2,ENSG00000213189.3,159003975,2-158855385-C-A,rs13413317,1,C,A,158855385,148590,158807367,159200583,48018
2,ENSG00000213553.3,38481851,2-38495907-G-A,rs13424546,1,G,A,38495907,14056,38285243,38678459,210664
2,ENSG00000213553.3,38481851,2-38495907-G-C,rs13424546,1,G,C,38495907,14056,38285243,38678459,210664
2,ENSG00000241114.1,54080280,2-54048054-A-G,rs13426329,-1,A,G,54048054,32226,53883672,54276888,164382
2,ENSG00000241114.1,54080280,2-54048054-A-T,rs13426329,-1,A,T,54048054,32226,53883672,54276888,164382
2,ENSG00000241114.1,54080280,2-54048054-A-C,rs13426329,-1,A,C,54048054,32226,53883672,54276888,164382
2,ENSG00000226125.1,230700340,2-230672520-T-C,rs13431849,-1,T,C,230672520,27820,230503732,230896948,168788
2,ENSG00000204993.3,52570648,2-52380174-C-G,rs1424809,1,C,G,52380174,190474,52374040,52767256,6134
2,ENSG00000231621.1,197197927,2-197279278-A-G,rs1429411,1,A,G,197279278,81351,197001319,197394535,277959
2,ENSG00000231621.1,197197927,2-197279278-A-C,rs1429411,1,A,C,197279278,81351,197001319,197394535,277959
2,ENSG00000234028.2,88627539,2-88444260-G-C,rs1438903,1,G,C,88444260,183279,88430931,88824147,13329
2,ENSG00000234028.2,88627539,2-88444260-G-A,rs1438903,1,G,A,88444260,183279,88430931,88824147,13329
2,ENSG00000250116.2,46580238,2-46600160-C-A,rs1456018,-1,C,A,46600160,19922,46383630,46776846,216530
2,ENSG00000237745.1,107914948,2-108058237-T-C,rs1486176,1,T,C,108058237,143289,107718340,108111556,339897
2,ENSG00000237745.1,107914948,2-108058237-T-A,rs1486176,1,T,A,108058237,143289,107718340,108111556,339897
2,ENSG00000231848.1,44996413,2-45119527-A-T,rs1517024,1,A,T,45119527,123114,44799805,45193021,319722
2,ENSG00000231848.1,44996413,2-45119527-A-C,rs1517024,1,A,C,45119527,123114,44799805,45193021,319722
2,ENSG00000231848.1,44996413,2-45119527-A-G,rs1517024,1,A,G,45119527,123114,44799805,45193021,319722
2,ENSG00000228446.1,224500100,2-224638384-A-G,rs1565074,-1,A,G,224638384,138284,224303492,224696708,334892
2,ENSG00000260331.1,18548204,2-18688730-A-G,rs16985431,-1,A,G,18688730,140526,18351596,18744812,337134
2,ENSG00000217702.1,74123965,2-74143485-T-G,rs17009668,1,T,G,74143485,19520,73927357,74320573,216128
2,ENSG00000217702.1,74123965,2-74143485-T-C,rs17009668,1,T,C,74143485,19520,73927357,74320573,216128
2,ENSG00000236213.1,37562486,2-37636926-G-T,rs17021160,1,G,T,37636926,74440,37365878,37759094,271048
2,ENSG00000236913.1,42469817,2-42641314-A-T,rs17029811,1,A,T,42641314,171497,42273209,42666425,368105
2,ENSG00000236913.1,42469817,2-42641314-A-G,rs17029811,1,A,G,42641314,171497,42273209,42666425,368105
2,ENSG00000231043.2,58462032,2-58552554-A-G,rs17269098,-1,A,G,58552554,90522,58265424,58658640,287130
2,ENSG00000231043.2,58462032,2-58552554-A-C,rs17269098,-1,A,C,58552554,90522,58265424,58658640,287130
2,ENSG00000236790.1,8324630,2-8143879-T-C,rs17389729,-1,T,C,8143879,180751,8128022,8521238,15857
2,ENSG00000236790.1,8324630,2-8143879-T-A,rs17389729,-1,T,A,8143879,180751,8128022,8521238,15857
2,ENSG00000213925.3,203773502,2-203590437-T-G,rs17419111,-1,T,G,203590437,183065,203576894,203970110,13543
2,ENSG00000213925.3,203773502,2-203590437-T-A,rs17419111,-1,T,A,203590437,183065,203576894,203970110,13543
2,ENSG00000236878.1,120211054,2-120332155-T-C,rs17625845,1,T,C,120332155,121101,120014446,120407662,317709
2,ENSG00000236878.1,120211054,2-120332155-T-A,rs17625845,1,T,A,120332155,121101,120014446,120407662,317709
2,ENSG00000238133.2,173271620,2-173173274-T-C,rs17710437,-1,T,C,173173274,98346,173075012,173468228,98262
2,ENSG00000228325.2,90234812,2-90050455-G-A,rs17842625,1,G,A,90050455,184357,90038204,90431420,12251
2,ENSG00000181798.2,231514396,2-231559046-G-A,rs1797393,-1,G,A,231559046,44650,231317788,231711004,241258
2,ENSG00000259848.1,94892756,2-94698771-C-G,rs1830717,-1,C,G,94698771,193985,94696148,95089364,2623
2,ENSG00000259848.1,94892756,2-94698771-C-T,rs1830717,-1,C,T,94698771,193985,94696148,95089364,2623
2,ENSG00000232713.1,60938604,2-60975034-C-T,rs1864268,-1,C,T,60975034,36430,60741996,61135212,233038
2,ENSG00000232713.1,60938604,2-60975034-C-G,rs1864268,-1,C,G,60975034,36430,60741996,61135212,233038
2,ENSG00000233654.1,190534855,2-190371175-A-T,rs1882891,1,A,T,190371175,163680,190338247,190731463,32928
2,ENSG00000233654.1,190534855,2-190371175-A-C,rs1882891,1,A,C,190371175,163680,190338247,190731463,32928
2,ENSG00000232931.1,95833963,2-95719987-A-G,rs1989620,-1,A,G,95719987,113976,95637355,96030571,82632
2,ENSG00000237638.1,65056168,2-64905406-C-T,rs2008831,-1,C,T,64905406,150762,64859560,65252776,45846
2,ENSG00000185078.3,208031953,2-207843774-C-A,rs2022148,-1,C,A,207843774,188179,207835345,208228561,8429
2,ENSG00000224152.1,159615292,2-159672015-T-C,rs2042777,1,T,C,159672015,56723,159418684,159811900,253331
2,ENSG00000236348.1,17385091,2-17196756-A-G,rs2063164,1,A,G,17196756,188335,17188483,17581699,8273
2,ENSG00000234485.4,71037685,2-71046337-A-G,rs2111608,1,A,G,71046337,8652,70841077,71234293,205260
2,ENSG00000234485.4,71037685,2-71046337-A-T,rs2111608,1,A,T,71046337,8652,70841077,71234293,205260
2,ENSG00000233849.1,70301451,2-70301469-T-C,rs2279158,1,T,C,70301469,18,70104843,70498059,196626
2,ENSG00000205086.5,41956806,2-41901721-C-G,rs2374338,-1,C,G,41901721,55085,41760198,42153414,141523
2,ENSG00000205086.5,41956806,2-41901721-C-T,rs2374338,-1,C,T,41901721,55085,41760198,42153414,141523
2,ENSG00000205086.5,41956806,2-41901721-C-A,rs2374338,-1,C,A,41901721,55085,41760198,42153414,141523
2,ENSG00000163016.5,73671030,2-73758998-G-C,rs2567603,1,G,C,73758998,87968,73474422,73867638,284576
2,ENSG00000163016.5,73671030,2-73758998-G-T,rs2567603,1,G,T,73758998,87968,73474422,73867638,284576
2,ENSG00000240401.2,55282350,2-55245226-G-T,rs2589082,1,G,T,55245226,37124,55085742,55478958,159484
2,ENSG00000240401.2,55282350,2-55245226-G-A,rs2589082,1,G,A,55245226,37124,55085742,55478958,159484
2,ENSG00000240401.2,55282350,2-55245226-G-C,rs2589082,1,G,C,55245226,37124,55085742,55478958,159484
2,ENSG00000237522.1,60938049,2-61064039-C-G,rs2698195,-1,C,G,61064039,125990,60741441,61134657,322598
2,ENSG00000237522.1,60938049,2-61064039-C-T,rs2698195,-1,C,T,61064039,125990,60741441,61134657,322598
2,ENSG00000241409.1,232767949,2-232779513-A-G,rs283486,-1,A,G,232779513,11564,232571341,232964557,208172
2,ENSG00000257135.1,10448689,2-10440401-C-T,rs28362418,1,C,T,10440401,8288,10252081,10645297,188320
2,ENSG00000257135.1,10448689,2-10440401-C-G,rs28362418,1,C,G,10440401,8288,10252081,10645297,188320
2,ENSG00000235351.1,241725693,2-241720283-C-T,rs34016185,-1,C,T,241720283,5410,241529085,241922301,191198
2,ENSG00000229267.1,214810209,2-214754934-T-C,rs34136362,1,T,C,214754934,55275,214613601,215006817,141333
2,ENSG00000229750.1,175167904,2-174996492-A-G,rs34464761,1,A,G,174996492,171412,174971296,175364512,25196
2,ENSG00000229750.1,175167904,2-174996492-A-C,rs34464761,1,A,C,174996492,171412,174971296,175364512,25196
2,ENSG00000204581.2,111114185,2-111240679-A-C,rs35718992,-1,A,C,111240679,126494,110917577,111310793,323102
2,ENSG00000229867.1,119270714,2-119208364-C-T,rs35741883,-1,C,T,119208364,62350,119074106,119467322,134258
2,ENSG00000178162.4,130431363,2-130373952-C-T,rs3739122,-1,C,T,130373952,57411,130234755,130627971,139197
2,ENSG00000226806.1,135820191,2-135828613-C-T,rs3769008,1,C,T,135828613,8422,135623583,136016799,205030
2,ENSG00000226806.1,135820191,2-135828613-C-G,rs3769008,1,C,G,135828613,8422,135623583,136016799,205030
2,ENSG00000227403.1,161244720,2-161420790-G-A,rs3769956,1,G,A,161420790,176070,161048112,161441328,372678
2,ENSG00000227403.1,161244720,2-161420790-G-T,rs3769956,1,G,T,161420790,176070,161048112,161441328,372678
2,ENSG00000214329.2,91931714,2-92003556-A-C,rs4116423,-1,A,C,92003556,71842,91735106,92128322,268450
2,ENSG00000230572.1,91714745,2-91777149-G-A,rs41369949,-1,G,A,91777149,62404,91518137,91911353,259012
2,ENSG00000146556.8,113588550,2-113761753-G-T,rs41377545,1,G,T,113761753,173203,113391942,113785158,369811
2,ENSG00000146556.8,113588550,2-113761753-G-A,rs41377545,1,G,A,113761753,173203,113391942,113785158,369811
2,ENSG00000226491.1,42798712,2-42851530-C-T,rs4277572,-1,C,T,42851530,52818,42602104,42995320,249426
2,ENSG00000226491.1,42798712,2-42851530-C-G,rs4277572,-1,C,G,42851530,52818,42602104,42995320,249426
2,ENSG00000236432.2,227325164,2-227406818-A-G,rs4372894,-1,A,G,227406818,81654,227128556,227521772,278262
2,ENSG00000233673.2,86871301,2-86842308-C-A,rs4514875,1,C,A,86842308,28993,86674693,87067909,167615
2,ENSG00000233673.2,86871301,2-86842308-C-T,rs4514875,1,C,T,86842308,28993,86674693,87067909,167615
2,ENSG00000257800.1,74120680,2-74169564-G-T,rs4527231,1,G,T,74169564,48884,73924072,74317288,245492
2,ENSG00000257800.1,74120680,2-74169564-G-C,rs4527231,1,G,C,74169564,48884,73924072,74317288,245492
2,ENSG00000257800.1,74120680,2-74169564-G-A,rs4527231,1,G,A,74169564,48884,73924072,74317288,245492
2,ENSG00000237077.1,77792821,2-77750136-T-C,rs4538235,1,T,C,77750136,42685,77596213,77989429,153923
2,ENSG00000186235.6,238231585,2-238237319-T-C,rs4663865,-1,T,C,238237319,5734,238034977,238428193,202342
2,ENSG00000214821.3,170602228,2-170504866-A-C,rs4668269,-1,A,C,170504866,97362,170405620,170798836,99246
2,ENSG00000214821.3,170602228,2-170504866-A-G,rs4668269,-1,A,G,170504866,97362,170405620,170798836,99246
2,ENSG00000236008.1,8592903,2-8458778-G-A,rs4669277,-1,G,A,8458778,134125,8396295,8789511,62483
2,ENSG00000234572.1,64863626,2-64908236-T-C,rs4671628,-1,T,C,64908236,44610,64667018,65060234,241218
2,ENSG00000224137.1,207662376,2-207480416-T-C,rs4675679,1,T,C,207480416,181960,207465768,207858984,14648
2,ENSG00000224137.1,207662376,2-207480416-T-A,rs4675679,1,T,A,207480416,181960,207465768,207858984,14648
2,ENSG00000240356.2,113612247,2-113692451-G-A,rs4849261,-1,G,A,113692451,80204,113415639,113808855,276812
2,ENSG00000234171.1,3558439,2-3582979-A-G,rs4850031,1,A,G,3582979,24540,3361831,3755047,221148
2,ENSG00000229056.1,196260024,2-196271082-T-C,rs4850693,1,T,C,196271082,11058,196063416,196456632,207666
2,ENSG00000229056.1,196260024,2-196271082-T-G,rs4850693,1,T,G,196271082,11058,196063416,196456632,207666
2,ENSG00000229056.1,196260024,2-196271082-T-A,rs4850693,1,T,A,196271082,11058,196063416,196456632,207666
2,ENSG00000241962.3,99141485,2-99028009-C-A,rs4850895,1,C,A,99028009,113476,98944877,99338093,83132
2,ENSG00000241962.3,99141485,2-99028009-C-T,rs4850895,1,C,T,99028009,113476,98944877,99338093,83132
2,ENSG00000241962.3,99141485,2-99028009-C-G,rs4850895,1,C,G,99028009,113476,98944877,99338093,83132
2,ENSG00000237510.2,95792220,2-95718829-C-A,rs4907275,1,C,A,95718829,73391,95595612,95988828,123217
2,ENSG00000237510.2,95792220,2-95718829-C-G,rs4907275,1,C,G,95718829,73391,95595612,95988828,123217
2,ENSG00000237655.1,177603089,2-177685896-A-G,rs61260452,1,A,G,177685896,82807,177406481,177799697,279415
2,ENSG00000226553.1,187003377,2-187001000-C-T,rs62173501,-1,C,T,187001000,2377,186806769,187199985,194231
2,ENSG00000215043.2,194130266,2-194172579-C-A,rs6434675,-1,C,A,194172579,42313,193933658,194326874,238921
2,ENSG00000215043.2,194130266,2-194172579-C-T,rs6434675,-1,C,T,194172579,42313,193933658,194326874,238921
2,ENSG00000215043.2,194130266,2-194172579-C-G,rs6434675,-1,C,G,194172579,42313,193933658,194326874,238921
2,ENSG00000237753.1,112645720,2-112673515-C-T,rs6705487,-1,C,T,112673515,27795,112449112,112842328,224403
2,ENSG00000230385.1,230908852,2-230887148-G-A,rs6710419,1,G,A,230887148,21704,230712244,231105460,174904
2,ENSG00000235042.1,216412696,2-216427610-C-T,rs6711638,-1,C,T,216427610,14914,216216088,216609304,211522
2,ENSG00000233806.2,241881366,2-241987082-T-C,rs6712567,1,T,C,241987082,105716,241684758,242077974,302324
2,ENSG00000233806.2,241881366,2-241987082-T-G,rs6712567,1,T,G,241987082,105716,241684758,242077974,302324
2,ENSG00000233806.2,241881366,2-241987082-T-A,rs6712567,1,T,A,241987082,105716,241684758,242077974,302324
2,ENSG00000233870.1,71178587,2-71078326-C-T,rs6713,1,C,T,71078326,100261,70981979,71375195,96347
2,ENSG00000233870.1,71178587,2-71078326-C-A,rs6713,1,C,A,71078326,100261,70981979,71375195,96347
2,ENSG00000233870.1,71178587,2-71078326-C-G,rs6713,1,C,G,71078326,100261,70981979,71375195,96347
2,ENSG00000226247.1,75651627,2-75594376-A-T,rs6715544,-1,A,T,75594376,57251,75455019,75848235,139357
2,ENSG00000226247.1,75651627,2-75594376-A-G,rs6715544,-1,A,G,75594376,57251,75455019,75848235,139357
2,ENSG00000259439.1,44939199,2-44999443-G-A,rs6724823,-1,G,A,44999443,60244,44742591,45135807,256852
2,ENSG00000230756.1,130213490,2-130241393-T-C,rs6728903,-1,T,C,130241393,27903,130016882,130410098,224511
2,ENSG00000236090.2,41819747,2-41911954-C-G,rs6741942,1,C,G,41911954,92207,41623139,42016355,288815
2,ENSG00000236090.2,41819747,2-41911954-C-T,rs6741942,1,C,T,41911954,92207,41623139,42016355,288815
2,ENSG00000226928.1,111296046,2-111230439-G-A,rs6749633,-1,G,A,111230439,65607,111099438,111492654,131001
2,ENSG00000226928.1,111296046,2-111230439-G-T,rs6749633,-1,G,T,111230439,65607,111099438,111492654,131001
2,ENSG00000235013.1,230957593,2-230932834-C-T,rs6750171,1,C,T,230932834,24759,230760985,231154201,171849
2,ENSG00000224839.1,208057745,2-208146290-G-C,rs6750890,-1,G,C,208146290,88545,207861137,208254353,285153
2,ENSG00000224839.1,208057745,2-208146290-G-T,rs6750890,-1,G,T,208146290,88545,207861137,208254353,285153
2,ENSG00000236255.1,117833937,2-117755524-G-A,rs6754333,1,G,A,117755524,78413,117637329,118030545,118195
2,ENSG00000238062.1,230996031,2-230822591-A-C,rs6760721,-1,A,C,230822591,173440,230799423,231192639,23168
2,ENSG00000238062.1,230996031,2-230822591-A-G,rs6760721,-1,A,G,230822591,173440,230799423,231192639,23168
2,ENSG00000238062.1,230996031,2-230822591-A-T,rs6760721,-1,A,T,230822591,173440,230799423,231192639,23168
2,ENSG00000232508.1,88365608,2-88435492-C-G,rs67975102,-1,C,G,88435492,69884,88169000,88562216,266492
2,ENSG00000232508.1,88365608,2-88435492-C-T,rs67975102,-1,C,T,88435492,69884,88169000,88562216,266492
2,ENSG00000232508.1,88365608,2-88435492-C-A,rs67975102,-1,C,A,88435492,69884,88169000,88562216,266492
2,ENSG00000234793.1,241755740,2-241737769-G-A,rs71351115,-1,G,A,241737769,17971,241559132,241952348,178637
2,ENSG00000228590.1,60439828,2-60351997-G-C,rs726591,-1,G,C,60351997,87831,60243220,60636436,108777
2,ENSG00000228590.1,60439828,2-60351997-G-A,rs726591,-1,G,A,60351997,87831,60243220,60636436,108777
2,ENSG00000224891.1,37148530,2-37191478-C-T,rs72792810,1,C,T,37191478,42948,36951922,37345138,239556
2,ENSG00000213115.2,188227189,2-188049919-A-C,rs72903895,1,A,C,188049919,177270,188030581,188423797,19338
2,ENSG00000231546.1,236409077,2-236359974-G-A,rs72982610,-1,G,A,236359974,49103,236212469,236605685,147505
2,ENSG00000213055.3,232730198,2-232907590-C-G,rs7355380,-1,C,G,232907590,177392,232533590,232926806,374000
2,ENSG00000213055.3,232730198,2-232907590-C-T,rs7355380,-1,C,T,232907590,177392,232533590,232926806,374000
2,ENSG00000225889.2,64143239,2-64261922-A-T,rs73934421,1,A,T,64261922,118683,63946631,64339847,315291
2,ENSG00000236695.1,194187379,2-194302318-G-A,rs7419322,1,G,A,194302318,114939,193990771,194383987,311547
2,ENSG00000227799.1,55224280,2-55222276-C-T,rs74785222,1,C,T,55222276,2004,55027672,55420888,194604
2,ENSG00000227799.1,55224280,2-55222276-C-G,rs74785222,1,C,G,55222276,2004,55027672,55420888,194604
2,ENSG00000227799.1,55224280,2-55222276-C-A,rs74785222,1,C,A,55222276,2004,55027672,55420888,194604
2,ENSG00000232613.1,65030747,2-64870478-C-T,rs75109710,1,C,T,64870478,160269,64834139,65227355,36339
2,ENSG00000231536.1,110610916,2-110655928-G-A,rs75153987,1,G,A,110655928,45012,110414308,110807524,241620
2,ENSG00000224061.1,106253717,2-106065144-C-T,rs755651,-1,C,T,106065144,188573,106057109,106450325,8035
2,ENSG00000143429.4,91659961,2-91737435-T-C,rs7559391,-1,T,C,91737435,77474,91463353,91856569,274082
2,ENSG00000143429.4,91659961,2-91737435-T-A,rs7559391,-1,T,A,91737435,77474,91463353,91856569,274082
2,ENSG00000236969.1,91775944,2-91737435-T-C,rs7559391,1,T,C,91737435,38509,91579336,91972552,158099
2,ENSG00000236969.1,91775944,2-91737435-T-A,rs7559391,1,T,A,91737435,38509,91579336,91972552,158099
2,ENSG00000226915.1,130293822,2-130329691-T-C,rs75596159,1,T,C,130329691,35869,130097214,130490430,232477
2,ENSG00000226915.1,130293822,2-130329691-T-A,rs75596159,1,T,A,130329691,35869,130097214,130490430,232477
2,ENSG00000230799.1,201762737,2-201770881-T-A,rs7561592,1,T,A,201770881,8144,201566129,201959345,204752
2,ENSG00000230799.1,201762737,2-201770881-T-C,rs7561592,1,T,C,201770881,8144,201566129,201959345,204752
2,ENSG00000259793.1,233353416,2-233370649-G-A,rs7566221,-1,G,A,233370649,17233,233156808,233550024,213841
2,ENSG00000259793.1,233353416,2-233370649-G-C,rs7566221,-1,G,C,233370649,17233,233156808,233550024,213841
2,ENSG00000233266.1,54051334,2-53989842-C-A,rs7569954,1,C,A,53989842,61492,53854726,54247942,135116
2,ENSG00000242282.2,3536873,2-3618353-T-C,rs7571039,-1,T,C,3618353,81480,3340265,3733481,278088
2,ENSG00000180152.3,112853328,2-113001286-G-C,rs7571656,1,G,C,113001286,147958,112656720,113049936,344566
2,ENSG00000180152.3,112853328,2-113001286-G-T,rs7571656,1,G,T,113001286,147958,112656720,113049936,344566
2,ENSG00000180152.3,112853328,2-113001286-G-A,rs7571656,1,G,A,113001286,147958,112656720,113049936,344566
2,ENSG00000228802.1,223967706,2-223798177-A-G,rs7572834,-1,A,G,223798177,169529,223771098,224164314,27079
2,ENSG00000228802.1,223967706,2-223798177-A-T,rs7572834,-1,A,T,223798177,169529,223771098,224164314,27079
2,ENSG00000231890.1,135985124,2-136028118-G-C,rs7585965,1,G,C,136028118,42994,135788516,136181732,239602
2,ENSG00000231890.1,135985124,2-136028118-G-T,rs7585965,1,G,T,136028118,42994,135788516,136181732,239602
2,ENSG00000231890.1,135985124,2-136028118-G-A,rs7585965,1,G,A,136028118,42994,135788516,136181732,239602
2,ENSG00000260077.1,10040663,2-10094450-A-C,rs7587529,-1,A,C,10094450,53787,9844055,10237271,250395
2,ENSG00000260077.1,10040663,2-10094450-A-G,rs7587529,-1,A,G,10094450,53787,9844055,10237271,250395
2,ENSG00000260077.1,10040663,2-10094450-A-T,rs7587529,-1,A,T,10094450,53787,9844055,10237271,250395
2,ENSG00000231672.2,217756593,2-217767387-G-A,rs7590461,-1,G,A,217767387,10794,217559985,217953201,207402
2,ENSG00000231672.2,217756593,2-217767387-G-T,rs7590461,-1,G,T,217767387,10794,217559985,217953201,207402
2,ENSG00000232238.1,148595158,2-148515007-T-C,rs7592968,1,T,C,148515007,80151,148398550,148791766,116457
2,ENSG00000204792.2,74918148,2-74952544-A-T,rs7594760,1,A,T,74952544,34396,74721540,75114756,231004
2,ENSG00000204792.2,74918148,2-74952544-A-C,rs7594760,1,A,C,74952544,34396,74721540,75114756,231004
2,ENSG00000204792.2,74918148,2-74952544-A-G,rs7594760,1,A,G,74952544,34396,74721540,75114756,231004
2,ENSG00000227497.1,91877969,2-91885541-C-T,rs7597312,1,C,T,91885541,7572,91681361,92074577,204180
2,ENSG00000225695.1,201063089,2-200977287-G-A,rs7597440,1,G,A,200977287,85802,200866481,201259697,110806
2,ENSG00000232625.1,218841599,2-218801240-G-A,rs7600248,1,G,A,218801240,40359,218644991,219038207,156249
2,ENSG00000228509.1,190841864,2-190784913-A-G,rs7601608,-1,A,G,190784913,56951,190645256,191038472,139657
2,ENSG00000223466.1,195532945,2-195392675-C-T,rs7605057,1,C,T,195392675,140270,195336337,195729553,56338
2,ENSG00000223466.1,195532945,2-195392675-C-A,rs7605057,1,C,A,195392675,140270,195336337,195729553,56338
2,ENSG00000228043.1,138501698,2-138644520-G-A,rs76070861,-1,G,A,138644520,142822,138305090,138698306,339430
2,ENSG00000213222.3,131724279,2-131565153-A-C,rs7607806,-1,A,C,131565153,159126,131527671,131920887,37482
2,ENSG00000225808.1,177229506,2-177357261-C-T,rs76238691,-1,C,T,177357261,127755,177032898,177426114,324363
2,ENSG00000225808.1,177229506,2-177357261-C-A,rs76238691,-1,C,A,177357261,127755,177032898,177426114,324363
2,ENSG00000213938.3,199659551,2-199841705-C-A,rs769964,1,C,A,199841705,182154,199462943,199856159,378762
2,ENSG00000213938.3,199659551,2-199841705-C-T,rs769964,1,C,T,199841705,182154,199462943,199856159,378762
2,ENSG00000260942.1,240586699,2-240497919-A-C,rs78557056,-1,A,C,240497919,88780,240390091,240783307,107828
2,ENSG00000260942.1,240586699,2-240497919-A-G,rs78557056,-1,A,G,240497919,88780,240390091,240783307,107828
2,ENSG00000233862.1,30140666,2-30023656-C-G,rs78840594,-1,C,G,30023656,117010,29944058,30337274,79598
2,ENSG00000233862.1,30140666,2-30023656-C-A,rs78840594,-1,C,A,30023656,117010,29944058,30337274,79598
2,ENSG00000237940.2,241970683,2-241932078-C-A,rs79326616,1,C,A,241932078,38605,241774075,242167291,158003
2,ENSG00000237940.2,241970683,2-241932078-C-T,rs79326616,1,C,T,241932078,38605,241774075,242167291,158003
2,ENSG00000222020.2,239401703,2-239397395-C-G,rs843461,1,C,G,239397395,4308,239205095,239598311,192300
2,ENSG00000222020.2,239401703,2-239397395-C-T,rs843461,1,C,T,239397395,4308,239205095,239598311,192300
2,ENSG00000189223.7,113235536,2-113261552-G-T,rs877202,1,G,T,113261552,26016,113038928,113432144,222624
2,ENSG00000228551.1,109251422,2-109325750-A-G,rs891415,1,A,G,109325750,74328,109054814,109448030,270936
2,ENSG00000227692.1,186364598,2-186438149-C-A,rs9288129,1,C,A,186438149,73551,186167990,186561206,270159
2,ENSG00000227738.1,123762171,2-123679832-G-A,rs9308647,1,G,A,123679832,82339,123565563,123958779,114269
2,ENSG00000227738.1,123762171,2-123679832-G-C,rs9308647,1,G,C,123679832,82339,123565563,123958779,114269
2,ENSG00000227738.1,123762171,2-123679832-G-T,rs9308647,1,G,T,123679832,82339,123565563,123958779,114269
2,ENSG00000232485.2,216498761,2-216656925-C-T,rs9341191,-1,C,T,216656925,158164,216302153,216695369,354772
2,ENSG00000232531.2,91748986,2-91742466-T-A,rs9653606,-1,T,A,91742466,6520,91552378,91945594,190088
2,ENSG00000232531.2,91748986,2-91742466-T-G,rs9653606,-1,T,G,91742466,6520,91552378,91945594,190088
2,ENSG00000225234.1,3482409,2-3493265-G-A,rs9678647,-1,G,A,3493265,10856,3285801,3679017,207464
2,ENSG00000227347.1,136200503,2-136150010-A-G,rs9941506,-1,A,G,136150010,50493,136003895,136397111,146115
1,ENSG00000228852.1,95278940,1-95149010-A-C,rs10157254,-1,A,C,95149010,129930,95082332,95475548,66678
1,ENSG00000239670.1,32986952,1-33077451-A-G,rs10429857,1,A,G,33077451,90499,32790344,33183560,287107
1,ENSG00000227217.1,157691762,1-157699878-G-A,rs10489678,1,G,A,157699878,8116,157495154,157888370,204724
1,ENSG00000227217.1,157691762,1-157699878-G-T,rs10489678,1,G,T,157699878,8116,157495154,157888370,204724
1,ENSG00000227217.1,157691762,1-157699878-G-C,rs10489678,1,G,C,157699878,8116,157495154,157888370,204724
1,ENSG00000236888.1,57606206,1-57521581-G-T,rs10493228,-1,G,T,57521581,84625,57409598,57802814,111983
1,ENSG00000236888.1,57606206,1-57521581-G-A,rs10493228,-1,G,A,57521581,84625,57409598,57802814,111983
1,ENSG00000227811.2,111739579,1-111584677-G-A,rs10494137,1,G,A,111584677,154902,111542971,111936187,41706
1,ENSG00000232022.1,46432129,1-46569971-T-A,rs1054743,1,T,A,46569971,137842,46235521,46628737,334450
1,ENSG00000232022.1,46432129,1-46569971-T-C,rs1054743,1,T,C,46569971,137842,46235521,46628737,334450
1,ENSG00000241720.1,109725820,1-109739319-G-T,rs10735234,1,G,T,109739319,13499,109529212,109922428,210107
1,ENSG00000241720.1,109725820,1-109739319-G-A,rs10735234,1,G,A,109739319,13499,109529212,109922428,210107
1,ENSG00000235363.1,205351247,1-205349193-T-C,rs10751435,1,T,C,205349193,2054,205154639,205547855,194554
1,ENSG00000237520.1,234957231,1-234942249-T-A,rs10797571,1,T,A,234942249,14982,234760623,235153839,181626
1,ENSG00000237520.1,234957231,1-234942249-T-C,rs10797571,1,T,C,234942249,14982,234760623,235153839,181626
1,ENSG00000215833.2,168451211,1-168325965-T-C,rs10800353,-1,T,C,168325965,125246,168254603,168647819,71362
1,ENSG00000215833.2,168451211,1-168325965-T-A,rs10800353,-1,T,A,168325965,125246,168254603,168647819,71362
1,ENSG00000215833.2,168451211,1-168325965-T-G,rs10800353,-1,T,G,168325965,125246,168254603,168647819,71362
1,ENSG00000223694.1,240170155,1-240366158-G-C,rs10802865,1,G,C,240366158,196003,239973547,240366763,392611
1,ENSG00000223694.1,240170155,1-240366158-G-A,rs10802865,1,G,A,240366158,196003,239973547,240366763,392611
1,ENSG00000223694.1,240170155,1-240366158-G-T,rs10802865,1,G,T,240366158,196003,239973547,240366763,392611
1,ENSG00000229820.1,28453541,1-28614821-G-A,rs10915181,1,G,A,28614821,161280,28256933,28650149,357888
1,ENSG00000231105.1,21293290,1-21305170-G-A,rs10916959,1,G,A,21305170,11880,21096682,21489898,208488
1,ENSG00000235449.1,202767418,1-202939708-A-G,rs10920531,-1,A,G,202939708,172290,202570810,202964026,368898
1,ENSG00000235449.1,202767418,1-202939708-A-C,rs10920531,-1,A,C,202939708,172290,202570810,202964026,368898
1,ENSG00000235449.1,202767418,1-202939708-A-T,rs10920531,-1,A,T,202939708,172290,202570810,202964026,368898
1,ENSG00000237301.1,15603626,1-15530639-A-G,rs10927796,-1,A,G,15530639,72987,15407018,15800234,123621
1,ENSG00000244716.2,108992282,1-108808209-G-C,rs11102473,1,G,C,108808209,184073,108795674,109188890,12535
1,ENSG00000244716.2,108992282,1-108808209-G-A,rs11102473,1,G,A,108808209,184073,108795674,109188890,12535
1,ENSG00000237278.1,113126883,1-113136262-A-T,rs11102590,-1,A,T,113136262,9379,112930275,113323491,205987
1,ENSG00000232883.1,220317599,1-220300682-A-G,rs11118515,-1,A,G,220300682,16917,220120991,220514207,179691
1,ENSG00000232883.1,220317599,1-220300682-A-T,rs11118515,-1,A,T,220300682,16917,220120991,220514207,179691
1,ENSG00000224616.1,100266179,1-100190938-A-G,rs11166413,-1,A,G,100190938,75241,100069571,100462787,121367
1,ENSG00000224616.1,100266179,1-100190938-A-T,rs11166413,-1,A,T,100190938,75241,100069571,100462787,121367
1,ENSG00000116652.4,63547082,1-63391221-C-T,rs11208204,1,C,T,63391221,155861,63350474,63743690,40747
1,ENSG00000244256.1,63655743,1-63659401-T-C,rs11208264,1,T,C,63659401,3658,63459135,63852351,200266
1,ENSG00000244256.1,63655743,1-63659401-T-A,rs11208264,1,T,A,63659401,3658,63459135,63852351,200266
1,ENSG00000238186.1,40517174,1-40515059-G-C,rs11208299,-1,G,C,40515059,2115,40320566,40713782,194493
1,ENSG00000238186.1,40517174,1-40515059-G-T,rs11208299,-1,G,T,40515059,2115,40320566,40713782,194493
1,ENSG00000225506.2,47179271,1-47153042-G-A,rs11211471,-1,G,A,47153042,26229,46982663,47375879,170379
1,ENSG00000180867.9,147178113,1-147296227-G-A,rs11239968,1,G,A,147296227,118114,146981505,147374721,314722
1,ENSG00000180867.9,147178113,1-147296227-G-T,rs11239968,1,G,T,147296227,118114,146981505,147374721,314722
1,ENSG00000215859.4,148009592,1-147868183-G-T,rs11240142,-1,G,T,147868183,141409,147812984,148206200,55199
1,ENSG00000215859.4,148009592,1-147868183-G-C,rs11240142,-1,G,C,147868183,141409,147812984,148206200,55199
1,ENSG00000236528.1,25859613,1-25883673-C-T,rs11247824,1,C,T,25883673,24060,25663005,26056221,220668
1,ENSG00000225710.1,16552531,1-16421984-C-T,rs112564075,-1,C,T,16421984,130547,16355923,16749139,66061
1,ENSG00000226457.1,16369530,1-16385239-T-C,rs11260740,-1,T,C,16385239,15709,16172922,16566138,212317
1,ENSG00000239636.1,35577779,1-35476333-G-C,rs11264160,-1,G,C,35476333,101446,35381171,35774387,95162
1,ENSG00000239636.1,35577779,1-35476333-G-T,rs11264160,-1,G,T,35476333,101446,35381171,35774387,95162
1,ENSG00000239636.1,35577779,1-35476333-G-A,rs11264160,-1,G,A,35476333,101446,35381171,35774387,95162
1,ENSG00000232093.1,155046118,1-155047234-A-C,rs11264300,-1,A,C,155047234,1116,154849510,155242726,197724
1,ENSG00000228013.1,154406564,1-154391664-G-A,rs11265608,-1,G,A,154391664,14900,154209956,154603172,181708
1,ENSG00000230415.1,1275223,1-1134155-G-A,rs113355263,1,G,A,1134155,141068,1078615,1471831,55540
1,ENSG00000234419.1,222468094,1-222437868-C-T,rs11485175,1,C,T,222437868,30226,222271486,222664702,166382
1,ENSG00000234419.1,222468094,1-222437868-C-A,rs11485175,1,C,A,222437868,30226,222271486,222664702,166382
1,ENSG00000234419.1,222468094,1-222437868-C-G,rs11485175,1,C,G,222437868,30226,222271486,222664702,166382
1,ENSG00000236360.1,52993702,1-53103558-T-A,rs114930372,-1,T,A,53103558,109856,52797094,53190310,306464
1,ENSG00000181201.2,228464594,1-228285899-A-G,rs1150907,-1,A,G,228285899,178695,228267986,228661202,17913
1,ENSG00000227775.1,1735817,1-1671797-G-C,rs11523819,1,G,C,1671797,64020,1539209,1932425,132588
1,ENSG00000227775.1,1735817,1-1671797-G-T,rs11523819,1,G,T,1671797,64020,1539209,1932425,132588
1,ENSG00000227775.1,1735817,1-1671797-G-A,rs11523819,1,G,A,1671797,64020,1539209,1932425,132588
1,ENSG00000172746.6,26980165,1-26863833-C-T,rs11542704,1,C,T,26863833,116332,26783557,27176773,80276
1,ENSG00000223583.1,26455187,1-26477915-G-A,rs11576300,-1,G,A,26477915,22728,26258579,26651795,219336
1,ENSG00000223583.1,26455187,1-26477915-G-C,rs11576300,-1,G,C,26477915,22728,26258579,26651795,219336
1,ENSG00000260360.1,179954705,1-179786448-C-T,rs11583659,-1,C,T,179786448,168257,179758097,180151313,28351
1,ENSG00000260360.1,179954705,1-179786448-C-G,rs11583659,-1,C,G,179786448,168257,179758097,180151313,28351
1,ENSG00000203288.3,151790824,1-151808252-A-T,rs11588258,1,A,T,151808252,17428,151594216,151987432,214036
1,ENSG00000203288.3,151790824,1-151808252-A-C,rs11588258,1,A,C,151808252,17428,151594216,151987432,214036
1,ENSG00000238145.1,46891639,1-46998060-T-G,rs11589889,1,T,G,46998060,106421,46695031,47088247,303029
1,ENSG00000229376.1,722092,1-831716-A-G,rs115991721,1,A,G,831716,109624,525484,918700,306232
1,ENSG00000231752.1,121519345,1-121452963-C-G,rs118046298,1,C,G,121452963,66382,121322737,121715953,130226
1,ENSG00000233706.1,226992140,1-227120715-T-C,rs11806633,1,T,C,227120715,128575,226795532,227188748,325183
1,ENSG00000224699.1,110347116,1-110431867-A-G,rs12048154,1,A,G,110431867,84751,110150508,110543724,281359
1,ENSG00000218510.3,22024558,1-22024054-C-T,rs12061255,1,C,T,22024054,504,21827950,22221166,196104
1,ENSG00000227671.2,247209493,1-247190481-T-G,rs12071728,-1,T,G,247190481,19012,247012885,247406101,177596
1,ENSG00000227671.2,247209493,1-247190481-T-C,rs12071728,-1,T,C,247190481,19012,247012885,247406101,177596
1,ENSG00000238015.1,78666272,1-78566913-A-G,rs12080077,1,A,G,78566913,99359,78469664,78862880,97249
1,ENSG00000227777.1,168542737,1-168686483-A-G,rs12090370,1,A,G,168686483,143746,168346129,168739345,340354
1,ENSG00000235501.1,94927478,1-94961692-T-C,rs12092678,1,T,C,94961692,34214,94730870,95124086,230822
1,ENSG00000229815.1,44958557,1-44833972-C-T,rs12095412,1,C,T,44833972,124585,44761949,45155165,72023
1,ENSG00000236646.1,62038842,1-62051633-T-G,rs12117302,1,T,G,62051633,12791,61842234,62235450,209399
1,ENSG00000255835.1,225924278,1-226058772-A-C,rs12126865,-1,A,C,226058772,134494,225727670,226120886,331102
1,ENSG00000227408.1,103713723,1-103570536-C-T,rs12132911,1,C,T,103570536,143187,103517115,103910331,53421
1,ENSG00000229840.1,229042171,1-229045530-G-A,rs12138859,1,G,A,229045530,3359,228845563,229238779,199967
1,ENSG00000229840.1,229042171,1-229045530-G-T,rs12138859,1,G,T,229045530,3359,228845563,229238779,199967
1,ENSG00000260941.1,119599271,1-119588974-G-C,rs12139088,-1,G,C,119588974,10297,119402663,119795879,186311
1,ENSG00000260941.1,119599271,1-119588974-G-A,rs12139088,-1,G,A,119588974,10297,119402663,119795879,186311
1,ENSG00000228818.1,240145389,1-240177019-T-C,rs12145620,-1,T,C,240177019,31630,239948781,240341997,228238
1,ENSG00000215795.2,247185482,1-247229840-T-C,rs12145632,-1,T,C,247229840,44358,246988874,247382090,240966
1,ENSG00000225880.4,827539,1-818725-C-T,rs12184325,-1,C,T,818725,8814,630931,1024147,187794
1,ENSG00000228327.2,774280,1-818725-C-T,rs12184325,-1,C,T,818725,44445,577672,970888,241053
1,ENSG00000177757.1,817371,1-818725-C-T,rs12184325,1,C,T,818725,1354,620763,1013979,197962
1,ENSG00000243323.1,202168051,1-202174384-A-G,rs12401678,1,A,G,202174384,6333,201971443,202364659,202941
1,ENSG00000173810.8,101271363,1-101216494-T-C,rs12404070,-1,T,C,101216494,54869,101074755,101467971,141739
1,ENSG00000261654.1,110942353,1-110906029-G-A,rs12564752,-1,G,A,110906029,36324,110745745,111138961,160284
1,ENSG00000231789.1,9687583,1-9674229-G-A,rs12568084,-1,G,A,9674229,13354,9490975,9884191,183254
1,ENSG00000260948.1,111433068,1-111449473-C-T,rs1264899,-1,C,T,111449473,16405,111236460,111629676,213013
1,ENSG00000260948.1,111433068,1-111449473-C-G,rs1264899,-1,C,G,111449473,16405,111236460,111629676,213013
1,ENSG00000237033.1,70661265,1-70691978-A-C,rs12731606,-1,A,C,70691978,30713,70464657,70857873,227321
1,ENSG00000237033.1,70661265,1-70691978-A-G,rs12731606,-1,A,G,70691978,30713,70464657,70857873,227321
1,ENSG00000233196.1,186581191,1-186765480-G-A,rs12734919,-1,G,A,186765480,184289,186384583,186777799,380897
1,ENSG00000233196.1,186581191,1-186765480-G-T,rs12734919,-1,G,T,186765480,184289,186384583,186777799,380897
1,ENSG00000260063.1,26694131,1-26701730-A-G,rs12743862,-1,A,G,26701730,7599,26497523,26890739,204207
1,ENSG00000232995.2,163321792,1-163308255-T-C,rs12746009,-1,T,C,163308255,13537,163125184,163518400,183071
1,ENSG00000218283.2,220253570,1-220418676-G-A,rs12750820,1,G,A,220418676,165106,220056962,220450178,361714
1,ENSG00000239494.1,169859756,1-169691640-A-G,rs12938,1,A,G,169691640,168116,169663148,170056364,28492
1,ENSG00000234614.1,151841877,1-151707120-G-C,rs1308153,1,G,C,151707120,134757,151645269,152038485,61851
1,ENSG00000234614.1,151841877,1-151707120-G-A,rs1308153,1,G,A,151707120,134757,151645269,152038485,61851
1,ENSG00000231365.1,119140730,1-119041345-T-A,rs1325939,1,T,A,119041345,99385,118944122,119337338,97223
1,ENSG00000231365.1,119140730,1-119041345-T-G,rs1325939,1,T,G,119041345,99385,118944122,119337338,97223
1,ENSG00000231365.1,119140730,1-119041345-T-C,rs1325939,1,T,C,119041345,99385,118944122,119337338,97223
1,ENSG00000203739.3,173489407,1-173474134-G-C,rs13376447,-1,G,C,173474134,15273,173292799,173686015,181335
1,ENSG00000203739.3,173489407,1-173474134-G-A,rs13376447,-1,G,A,173474134,15273,173292799,173686015,181335
1,ENSG00000243155.1,180976482,1-180993146-A-C,rs1411478,-1,A,C,180993146,16664,180779874,181173090,213272
1,ENSG00000243155.1,180976482,1-180993146-A-G,rs1411478,-1,A,G,180993146,16664,180779874,181173090,213272
1,ENSG00000229989.2,198937421,1-199041592-C-T,rs1434282,-1,C,T,199041592,104171,198740813,199134029,300779
1,ENSG00000237842.1,157060762,1-157095382-G-A,rs1467662,-1,G,A,157095382,34620,156864154,157257370,231228
1,ENSG00000225338.1,212309518,1-212177977-T-C,rs1472224,-1,T,C,212177977,131541,212112910,212506126,65067
1,ENSG00000260805.1,212559731,1-212539378-T-C,rs1512847,-1,T,C,212539378,20353,212363123,212756339,176255
1,ENSG00000224805.2,47179250,1-47027121-T-G,rs1553390,1,T,G,47027121,152129,46982642,47375858,44479
1,ENSG00000224805.2,47179250,1-47027121-T-C,rs1553390,1,T,C,47027121,152129,46982642,47375858,44479
1,ENSG00000224805.2,47179250,1-47027121-T-A,rs1553390,1,T,A,47027121,152129,46982642,47375858,44479
1,ENSG00000227001.2,21427967,1-21440170-G-C,rs1566523,-1,G,C,21440170,12203,21231359,21624575,208811
1,ENSG00000227001.2,21427967,1-21440170-G-T,rs1566523,-1,G,T,21440170,12203,21231359,21624575,208811
1,ENSG00000228192.2,42846414,1-42880055-C-G,rs1601238,-1,C,G,42880055,33641,42649806,43043022,230249
1,ENSG00000228192.2,42846414,1-42880055-C-T,rs1601238,-1,C,T,42880055,33641,42649806,43043022,230249
1,ENSG00000228192.2,42846414,1-42880055-C-A,rs1601238,-1,C,A,42880055,33641,42649806,43043022,230249
1,ENSG00000233593.1,90851528,1-90814756-T-C,rs1663708,-1,T,C,90814756,36772,90654920,91048136,159836
1,ENSG00000231050.1,1891223,1-1886690-A-C,rs16824526,1,A,C,1886690,4533,1694615,2087831,192075
1,ENSG00000231050.1,1891223,1-1886690-A-G,rs16824526,1,A,G,1886690,4533,1694615,2087831,192075
1,ENSG00000234222.1,145927236,1-145997002-C-T,rs16827243,1,C,T,145997002,69766,145730628,146123844,266374
1,ENSG00000261716.1,149850772,1-149995204-G-A,rs16832989,-1,G,A,149995204,144432,149654164,150047380,341040
1,ENSG00000229991.1,224574434,1-224545276-G-A,rs16849419,1,G,A,224545276,29158,224377826,224771042,167450
1,ENSG00000235060.1,180434800,1-180257493-C-T,rs16855609,1,C,T,180257493,177307,180238192,180631408,19301
1,ENSG00000223489.1,116742609,1-116572507-G-A,rs17036001,-1,G,A,116572507,170102,116546001,116939217,26506
1,ENSG00000181227.2,75744776,1-75750501-C-G,rs17097429,-1,C,G,75750501,5725,75548168,75941384,202333
1,ENSG00000181227.2,75744776,1-75750501-C-T,rs17097429,-1,C,T,75750501,5725,75548168,75941384,202333
1,ENSG00000181227.2,75744776,1-75750501-C-A,rs17097429,-1,C,A,75750501,5725,75548168,75941384,202333
1,ENSG00000197568.9,70354844,1-70355119-G-A,rs17131261,1,G,A,70355119,275,70158236,70551452,196883
1,ENSG00000229635.1,93384998,1-93195181-T-G,rs17131710,-1,T,G,93195181,189817,93188390,93581606,6791
1,ENSG00000225712.1,209268223,1-209210262-T-A,rs17188016,-1,T,A,209210262,57961,209071615,209464831,138647
1,ENSG00000225712.1,209268223,1-209210262-T-C,rs17188016,-1,T,C,209210262,57961,209071615,209464831,138647
1,ENSG00000228217.1,117778506,1-117733913-G-C,rs17257575,-1,G,C,117733913,44593,117581898,117975114,152015
1,ENSG00000228217.1,117778506,1-117733913-G-A,rs17257575,-1,G,A,117733913,44593,117581898,117975114,152015
1,ENSG00000238198.1,113073113,1-113022022-C-T,rs1728232,-1,C,T,113022022,51091,112876505,113269721,145517
1,ENSG00000238198.1,113073113,1-113022022-C-A,rs1728232,-1,C,A,113022022,51091,112876505,113269721,145517
1,ENSG00000223804.1,120341839,1-120381544-G-C,rs17346661,-1,G,C,120381544,39705,120145231,120538447,236313
1,ENSG00000223804.1,120341839,1-120381544-G-A,rs17346661,-1,G,A,120381544,39705,120145231,120538447,236313
1,ENSG00000227741.1,160208869,1-160176786-A-C,rs17368598,-1,A,C,160176786,32083,160012261,160405477,164525
1,ENSG00000227741.1,160208869,1-160176786-A-G,rs17368598,-1,A,G,160176786,32083,160012261,160405477,164525
1,ENSG00000227533.1,42959078,1-42950462-T-C,rs17387775,1,T,C,42950462,8616,42762470,43155686,187992
1,ENSG00000228502.1,96446930,1-96389789-T-C,rs17425106,1,T,C,96389789,57141,96250322,96643538,139467
1,ENSG00000226167.1,113856635,1-113901277-G-A,rs17464525,1,G,A,113901277,44642,113660027,114053243,241250
1,ENSG00000226029.1,16460948,1-16460141-G-C,rs1746722,1,G,C,16460141,807,16264340,16657556,195801
1,ENSG00000233461.1,231528604,1-231520672-G-A,rs1765794,-1,G,A,231520672,7932,231331996,231725212,188676
1,ENSG00000226754.1,53238580,1-53071594-G-A,rs1769316,1,G,A,53071594,166986,53041972,53435188,29622
1,ENSG00000219133.2,204347258,1-204375825-G-A,rs1980052,-1,G,A,204375825,28567,204150650,204543866,225175
1,ENSG00000219133.2,204347258,1-204375825-G-C,rs1980052,-1,G,C,204375825,28567,204150650,204543866,225175
1,ENSG00000233203.2,54887563,1-54705766-A-G,rs1981583,1,A,G,54705766,181797,54690955,55084171,14811
1,ENSG00000233203.2,54887563,1-54705766-A-C,rs1981583,1,A,C,54705766,181797,54690955,55084171,14811
1,ENSG00000233203.2,54887563,1-54705766-A-T,rs1981583,1,A,T,54705766,181797,54690955,55084171,14811
1,ENSG00000223396.2,201520056,1-201507672-G-T,rs1998920,1,G,T,201507672,12384,201323448,201716664,184224
1,ENSG00000223396.2,201520056,1-201507672-G-A,rs1998920,1,G,A,201507672,12384,201323448,201716664,184224
1,ENSG00000228477.1,39962680,1-39822379-G-A,rs1999574,1,G,A,39822379,140301,39766072,40159288,56307
1,ENSG00000230138.1,53368245,1-53364057-T-C,rs1999897,-1,T,C,53364057,4188,53171637,53564853,192420
1,ENSG00000235371.1,236110061,1-236012039-T-C,rs2031487,1,T,C,236012039,98022,235913453,236306669,98586
1,ENSG00000235371.1,236110061,1-236012039-T-A,rs2031487,1,T,A,236012039,98022,235913453,236306669,98586
1,ENSG00000235371.1,236110061,1-236012039-T-G,rs2031487,1,T,G,236012039,98022,235913453,236306669,98586
1,ENSG00000236675.1,155230975,1-155202588-A-G,rs2066981,1,A,G,155202588,28387,155034367,155427583,168221
1,ENSG00000236675.1,155230975,1-155202588-A-C,rs2066981,1,A,C,155202588,28387,155034367,155427583,168221
1,ENSG00000228172.1,25819772,1-25804530-T-C,rs2072749,-1,T,C,25804530,15242,25623164,26016380,181366
1,ENSG00000238142.1,16889672,1-17010896-G-C,rs2076600,-1,G,C,17010896,121224,16693064,17086280,317832
1,ENSG00000238142.1,16889672,1-17010896-G-A,rs2076600,-1,G,A,17010896,121224,16693064,17086280,317832
1,ENSG00000261798.1,39788976,1-39777257-A-G,rs2138686,1,A,G,39777257,11719,39592368,39985584,184889
1,ENSG00000237276.3,16228027,1-16210794-T-C,rs221063,-1,T,C,16210794,17233,16031419,16424635,179375
1,ENSG00000237276.3,16228027,1-16210794-T-A,rs221063,-1,T,A,16210794,17233,16031419,16424635,179375
1,ENSG00000237276.3,16228027,1-16210794-T-G,rs221063,-1,T,G,16210794,17233,16031419,16424635,179375
1,ENSG00000211454.8,19274194,1-19311815-A-G,rs2227295,-1,A,G,19311815,37621,19077586,19470802,234229
1,ENSG00000211454.8,19274194,1-19311815-A-T,rs2227295,-1,A,T,19311815,37621,19077586,19470802,234229
1,ENSG00000236872.1,45415020,1-45566639-A-G,rs2229540,1,A,G,45566639,151619,45218412,45611628,348227
1,ENSG00000236872.1,45415020,1-45566639-A-C,rs2229540,1,A,C,45566639,151619,45218412,45611628,348227
1,ENSG00000242861.1,225846522,1-225838705-A-G,rs2234922,-1,A,G,225838705,7817,225649914,226043130,188791
1,ENSG00000242861.1,225846522,1-225838705-A-T,rs2234922,-1,A,T,225838705,7817,225649914,226043130,188791
1,ENSG00000251520.1,180964511,1-181049100-A-G,rs2236410,1,A,G,181049100,84589,180767903,181161119,281197
1,ENSG00000238063.1,38474882,1-38475432-A-G,rs2244181,1,A,G,38475432,550,38278274,38671490,197158
1,ENSG00000238063.1,38474882,1-38475432-A-T,rs2244181,1,A,T,38475432,550,38278274,38671490,197158
1,ENSG00000238063.1,38474882,1-38475432-A-C,rs2244181,1,A,C,38475432,550,38278274,38671490,197158
1,ENSG00000228288.2,202810850,1-202812036-G-A,rs2246083,1,G,A,202812036,1186,202614242,203007458,197794
1,ENSG00000228288.2,202810850,1-202812036-G-T,rs2246083,1,G,T,202812036,1186,202614242,203007458,197794
1,ENSG00000228056.2,63843685,1-63652242-A-C,rs2269237,-1,A,C,63652242,191443,63647077,64040293,5165
1,ENSG00000228056.2,63843685,1-63652242-A-T,rs2269237,-1,A,T,63652242,191443,63647077,64040293,5165
1,ENSG00000228056.2,63843685,1-63652242-A-G,rs2269237,-1,A,G,63652242,191443,63647077,64040293,5165
1,ENSG00000236423.1,3900403,1-3829920-T-C,rs2275829,1,T,C,3829920,70483,3703795,4097011,126125
1,ENSG00000198468.2,212858125,1-212857192-C-A,rs2279692,-1,C,A,212857192,933,212661517,213054733,195675
1,ENSG00000198468.2,212858125,1-212857192-C-T,rs2279692,-1,C,T,212857192,933,212661517,213054733,195675
1,ENSG00000236266.1,7827342,1-7820652-G-A,rs228692,-1,G,A,7820652,6690,7630734,8023950,189918
1,ENSG00000235101.1,160670148,1-160647341-T-G,rs2295614,1,T,G,160647341,22807,160473540,160866756,173801
1,ENSG00000235101.1,160670148,1-160647341-T-A,rs2295614,1,T,A,160647341,22807,160473540,160866756,173801
1,ENSG00000185495.6,223995895,1-224010652-A-G,rs2404851,1,A,G,224010652,14757,223799287,224192503,211365
1,ENSG00000233621.1,37474386,1-37473572-T-C,rs2492301,-1,T,C,37473572,814,37277778,37670994,195794
1,ENSG00000231767.2,192716183,1-192833321-C-A,rs2746074,1,C,A,192833321,117138,192519575,192912791,313746
1,ENSG00000231767.2,192716183,1-192833321-C-T,rs2746074,1,C,T,192833321,117138,192519575,192912791,313746
1,ENSG00000230325.1,236550280,1-236548510-A-T,rs2758997,-1,A,T,236548510,1770,236353672,236746888,194838
1,ENSG00000230325.1,236550280,1-236548510-A-G,rs2758997,-1,A,G,236548510,1770,236353672,236746888,194838
1,ENSG00000230325.1,236550280,1-236548510-A-C,rs2758997,-1,A,C,236548510,1770,236353672,236746888,194838
1,ENSG00000224645.1,151340648,1-151371674-C-A,rs2769265,1,C,A,151371674,31026,151144040,151537256,227634
1,ENSG00000198857.3,119601340,1-119780338-G-C,rs2843016,1,G,C,119780338,178998,119404732,119797948,375606
1,ENSG00000198857.3,119601340,1-119780338-G-A,rs2843016,1,G,A,119780338,178998,119404732,119797948,375606
1,ENSG00000230955.1,37860697,1-37901235-T-C,rs28739509,1,T,C,37901235,40538,37664089,38057305,237146
1,ENSG00000225265.1,222589928,1-222590319-T-A,rs2936040,1,T,A,222590319,391,222393320,222786536,196999
1,ENSG00000231551.2,148415258,1-148351648-A-C,rs2999614,1,A,C,148351648,63610,148218650,148611866,132998
1,ENSG00000234329.1,45651826,1-45624580-A-G,rs3014237,-1,A,G,45624580,27246,45455218,45848434,169362
1,ENSG00000234329.1,45651826,1-45624580-A-T,rs3014237,-1,A,T,45624580,27246,45455218,45848434,169362
1,ENSG00000232912.1,8424645,1-8428505-A-G,rs301798,1,A,G,8428505,3860,8228037,8621253,200468
1,ENSG00000185031.5,64986087,1-64891080-A-G,rs310248,-1,A,G,64891080,95007,64789479,65182695,101601
1,ENSG00000213262.3,117641639,1-117741268-G-A,rs319486,-1,G,A,117741268,99629,117445031,117838247,296237
1,ENSG00000213262.3,117641639,1-117741268-G-T,rs319486,-1,G,T,117741268,99629,117445031,117838247,296237
1,ENSG00000258634.1,110058340,1-109897014-C-T,rs333961,1,C,T,109897014,161326,109861732,110254948,35282
1,ENSG00000228863.1,160676371,1-160712046-C-G,rs352685,1,C,G,160712046,35675,160479763,160872979,232283
1,ENSG00000228863.1,160676371,1-160712046-C-T,rs352685,1,C,T,160712046,35675,160479763,160872979,232283
1,ENSG00000234711.1,873292,1-946538-G-C,rs35471880,1,G,C,946538,73246,676684,1069900,269854
1,ENSG00000234711.1,873292,1-946538-G-A,rs35471880,1,G,A,946538,73246,676684,1069900,269854
1,ENSG00000231029.1,167591392,1-167495229-A-G,rs35506338,1,A,G,167495229,96163,167394784,167788000,100445
1,ENSG00000236263.1,155213819,1-155070410-T-G,rs35902694,-1,T,G,155070410,143409,155017211,155410427,53199
1,ENSG00000236263.1,155213819,1-155070410-T-A,rs35902694,-1,T,A,155070410,143409,155017211,155410427,53199
1,ENSG00000217801.4,1063079,1-1004823-G-A,rs35940137,1,G,A,1004823,58256,866471,1259687,138352
1,ENSG00000215914.3,1699942,1-1689421-G-A,rs3737622,1,G,A,1689421,10521,1503334,1896550,186087
1,ENSG00000232450.1,113699631,1-113699500-T-C,rs3752954,-1,T,C,113699500,131,113503023,113896239,196477
1,ENSG00000213028.3,229689904,1-229602423-T-G,rs3753886,-1,T,G,229602423,87481,229493296,229886512,109127
1,ENSG00000213028.3,229689904,1-229602423-T-A,rs3753886,-1,T,A,229602423,87481,229493296,229886512,109127
1,ENSG00000220323.2,149843041,1-149943855-G-A,rs3754041,1,G,A,149943855,100814,149646433,150039649,297422
1,ENSG00000238249.1,8893409,1-8961939-T-G,rs3765965,1,T,G,8961939,68530,8696801,9090017,265138
1,ENSG00000238249.1,8893409,1-8961939-T-C,rs3765965,1,T,C,8961939,68530,8696801,9090017,265138
1,ENSG00000260179.1,1251334,1-1082207-C-T,rs3766191,-1,C,T,1082207,169127,1054726,1447942,27481
1,ENSG00000237950.1,43940781,1-43832001-T-C,rs3791073,-1,T,C,43832001,108780,43744173,44137389,87828
1,ENSG00000220785.3,32241592,1-32240217-G-A,rs3795427,-1,G,A,32240217,1375,32044984,32438200,195233
1,ENSG00000135747.7,247078736,1-247078730-C-A,rs3806269,-1,C,A,247078730,6,246882128,247275344,196602
1,ENSG00000135747.7,247078736,1-247078730-C-G,rs3806269,-1,C,G,247078730,6,246882128,247275344,196602
1,ENSG00000135747.7,247078736,1-247078730-C-T,rs3806269,-1,C,T,247078730,6,246882128,247275344,196602
1,ENSG00000260088.1,200669507,1-200670555-G-C,rs3806358,1,G,C,200670555,1048,200472899,200866115,197656
1,ENSG00000260088.1,200669507,1-200670555-G-T,rs3806358,1,G,T,200670555,1048,200472899,200866115,197656
1,ENSG00000228044.2,234656052,1-234746308-T-A,rs3850720,1,T,A,234746308,90256,234459444,234852660,286864
1,ENSG00000228044.2,234656052,1-234746308-T-C,rs3850720,1,T,C,234746308,90256,234459444,234852660,286864
1,ENSG00000261000.1,206503948,1-206502998-G-A,rs3860295,1,G,A,206502998,950,206307340,206700556,195658
1,ENSG00000224609.1,59296491,1-59121465-G-C,rs3898691,-1,G,C,59121465,175026,59099883,59493099,21582
1,ENSG00000236809.2,211417025,1-211358094-C-G,rs41303049,1,C,G,211358094,58931,211220417,211613633,137677
1,ENSG00000260855.1,246772301,1-246756170-C-T,rs4130317,1,C,T,246756170,16131,246575693,246968909,180477
1,ENSG00000231507.1,203273221,1-203291372-T-C,rs4543864,1,T,C,203291372,18151,203076613,203469829,214759
1,ENSG00000224358.1,165768929,1-165763424-C-T,rs4657476,1,C,T,165763424,5505,165572321,165965537,191103
1,ENSG00000224358.1,165768929,1-165763424-C-A,rs4657476,1,C,A,165763424,5505,165572321,165965537,191103
1,ENSG00000229953.1,156661424,1-156664847-A-G,rs4661210,-1,A,G,156664847,3423,156464816,156858032,200031
1,ENSG00000229953.1,156661424,1-156664847-A-T,rs4661210,-1,A,T,156664847,3423,156464816,156858032,200031
1,ENSG00000179743.2,15848147,1-15836236-C-T,rs4661667,-1,C,T,15836236,11911,15651539,16044755,184697
1,ENSG00000224818.1,201465146,1-201461308-A-C,rs481298,-1,A,C,201461308,3838,201268538,201661754,192770
1,ENSG00000224818.1,201465146,1-201461308-A-G,rs481298,-1,A,G,201461308,3838,201268538,201661754,192770
1,ENSG00000224818.1,201465146,1-201461308-A-T,rs481298,-1,A,T,201461308,3838,201268538,201661754,192770
1,ENSG00000223653.1,85277672,1-85258645-C-T,rs4949926,1,C,T,85258645,19027,85081064,85474280,177581
1,ENSG00000231346.1,111608318,1-111612005-G-A,rs500714,-1,G,A,111612005,3687,111411710,111804926,200295
1,ENSG00000231346.1,111608318,1-111612005-G-T,rs500714,-1,G,T,111612005,3687,111411710,111804926,200295
1,ENSG00000233708.1,42888767,1-42940483-C-T,rs5031048,-1,C,T,42940483,51716,42692159,43085375,248324
1,ENSG00000233708.1,42888767,1-42940483-C-G,rs5031048,-1,C,G,42940483,51716,42692159,43085375,248324
1,ENSG00000232273.1,37544763,1-37681494-T-C,rs510208,1,T,C,37681494,136731,37348155,37741371,333339
1,ENSG00000231999.2,89632979,1-89757841-C-A,rs519989,-1,C,A,89757841,124862,89436371,89829587,321470
1,ENSG00000226088.1,70360437,1-70512990-G-T,rs55734633,-1,G,T,70512990,152553,70163829,70557045,349161
1,ENSG00000260246.1,109693742,1-109670892-A-T,rs574344,-1,A,T,109670892,22850,109497134,109890350,173758
1,ENSG00000260246.1,109693742,1-109670892-A-C,rs574344,-1,A,C,109670892,22850,109497134,109890350,173758
1,ENSG00000260246.1,109693742,1-109670892-A-G,rs574344,-1,A,G,109670892,22850,109497134,109890350,173758
1,ENSG00000236810.1,23778283,1-23729228-G-A,rs586173,-1,G,A,23729228,49055,23581675,23974891,147553
1,ENSG00000177173.5,116534092,1-116488683-C-A,rs58830348,-1,C,A,116488683,45409,116337484,116730700,151199
1,ENSG00000177173.5,116534092,1-116488683-C-T,rs58830348,-1,C,T,116488683,45409,116337484,116730700,151199
1,ENSG00000237861.1,197222222,1-197050728-A-C,rs6000,1,A,C,197050728,171494,197025614,197418830,25114
1,ENSG00000198711.4,54236440,1-54251150-A-T,rs608386,1,A,T,54251150,14710,54039832,54433048,211318
1,ENSG00000261135.1,16514645,1-16449087-C-A,rs61769455,1,C,A,16449087,65558,16318037,16711253,131050
1,ENSG00000261135.1,16514645,1-16449087-C-T,rs61769455,1,C,T,16449087,65558,16318037,16711253,131050
1,ENSG00000243970.1,39558707,1-39476625-C-G,rs61779310,-1,C,G,39476625,82082,39362099,39755315,114526
1,ENSG00000244682.3,161581340,1-161710728-T-A,rs61801161,1,T,A,161710728,129388,161384732,161777948,325996
1,ENSG00000224521.1,248548756,1-248732006-C-T,rs61840341,1,C,T,248732006,183250,248352148,248745364,379858
1,ENSG00000230628.1,234696153,1-234682676-T-A,rs620462,-1,T,A,234682676,13477,234499545,234892761,183131
1,ENSG00000224520.1,157073257,1-157097158-T-C,rs6427351,1,T,C,157097158,23901,156876649,157269865,220509
1,ENSG00000214796.4,202859099,1-202891611-G-A,rs6427976,-1,G,A,202891611,32512,202662491,203055707,229120
1,ENSG00000214796.4,202859099,1-202891611-G-T,rs6427976,-1,G,T,202891611,32512,202662491,203055707,229120
1,ENSG00000224727.1,243268119,1-243265307-T-C,rs6429416,-1,T,C,243265307,2812,243071511,243464727,193796
1,ENSG00000238287.1,40508661,1-40474348-A-T,rs6600339,-1,A,T,40474348,34313,40312053,40705269,162295
1,ENSG00000238287.1,40508661,1-40474348-A-G,rs6600339,-1,A,G,40474348,34313,40312053,40705269,162295
1,ENSG00000230699.2,911435,1-915400-C-T,rs6657440,1,C,T,915400,3965,714827,1108043,200573
1,ENSG00000230699.2,911435,1-915400-C-G,rs6657440,1,C,G,915400,3965,714827,1108043,200573
1,ENSG00000162888.4,206497728,1-206535392-T-C,rs6666087,-1,T,C,206535392,37664,206301120,206694336,234272
1,ENSG00000162888.4,206497728,1-206535392-T-G,rs6666087,-1,T,G,206535392,37664,206301120,206694336,234272
1,ENSG00000260879.1,108199926,1-108157108-T-A,rs6677101,1,T,A,108157108,42818,108003318,108396534,153790
1,ENSG00000260879.1,108199926,1-108157108-T-G,rs6677101,1,T,G,108157108,42818,108003318,108396534,153790
1,ENSG00000260879.1,108199926,1-108157108-T-C,rs6677101,1,T,C,108157108,42818,108003318,108396534,153790
1,ENSG00000227740.1,175921057,1-175905698-C-T,rs6687954,-1,C,T,175905698,15359,175724449,176117665,181249
1,ENSG00000231671.1,101323837,1-101371523-G-T,rs6688602,1,G,T,101371523,47686,101127229,101520445,244294
1,ENSG00000228844.1,240637052,1-240639870-A-G,rs6691111,-1,A,G,240639870,2818,240440444,240833660,199426
1,ENSG00000225171.1,166868748,1-166858437-T-A,rs6691431,1,T,A,166858437,10311,166672140,167065356,186297
1,ENSG00000225171.1,166868748,1-166858437-T-C,rs6691431,1,T,C,166858437,10311,166672140,167065356,186297
1,ENSG00000225171.1,166868748,1-166858437-T-G,rs6691431,1,T,G,166858437,10311,166672140,167065356,186297
1,ENSG00000230787.1,79056055,1-79020326-T-A,rs6693037,-1,T,A,79020326,35729,78859447,79252663,160879
1,ENSG00000230787.1,79056055,1-79020326-T-C,rs6693037,-1,T,C,79020326,35729,78859447,79252663,160879
1,ENSG00000230787.1,79056055,1-79020326-T-G,rs6693037,-1,T,G,79020326,35729,78859447,79252663,160879
1,ENSG00000231663.1,234373664,1-234367623-G-A,rs6693224,-1,G,A,234367623,6041,234177056,234570272,190567
1,ENSG00000231663.1,234373664,1-234367623-G-C,rs6693224,-1,G,C,234367623,6041,234177056,234570272,190567
1,ENSG00000230163.1,34850694,1-34850136-C-T,rs6703979,1,C,T,34850136,558,34654086,35047302,196050
1,ENSG00000230163.1,34850694,1-34850136-C-G,rs6703979,1,C,G,34850136,558,34654086,35047302,196050
1,ENSG00000228665.1,109030067,1-109161739-A-G,rs679224,1,A,G,109161739,131672,108833459,109226675,328280
1,ENSG00000228452.1,42776790,1-42746440-C-T,rs6882,-1,C,T,42746440,30350,42580182,42973398,166258
1,ENSG00000228126.1,150515757,1-150415909-A-G,rs698916,1,A,G,150415909,99848,150319149,150712365,96760
1,ENSG00000225099.1,42903232,1-42949675-G-T,rs710220,1,G,T,42949675,46443,42706624,43099840,243051
1,ENSG00000225099.1,42903232,1-42949675-G-A,rs710220,1,G,A,42949675,46443,42706624,43099840,243051
1,ENSG00000237188.1,147173362,1-147197315-T-G,rs718369,1,T,G,147197315,23953,146976754,147369970,220561
1,ENSG00000237188.1,147173362,1-147197315-T-C,rs718369,1,T,C,147197315,23953,146976754,147369970,220561
1,ENSG00000227751.1,17406760,1-17407068-T-G,rs7191,1,T,G,17407068,308,17210152,17603368,196916
1,ENSG00000217644.3,32979947,1-32929123-T-C,rs72654069,1,T,C,32929123,50824,32783339,33176555,145784
1,ENSG00000261349.1,25267136,1-25257119-C-G,rs72660908,-1,C,G,25257119,10017,25070528,25463744,186591
1,ENSG00000236137.1,117059490,1-117045526-A-G,rs72699145,-1,A,G,117045526,13964,116862882,117256098,182644
1,ENSG00000236137.1,117059490,1-117045526-A-T,rs72699145,-1,A,T,117045526,13964,116862882,117256098,182644
1,ENSG00000231407.1,170532647,1-170493886-C-T,rs72709770,-1,C,T,170493886,38761,170336039,170729255,157847
1,ENSG00000225568.1,87045875,1-87221727-T-C,rs72725826,1,T,C,87221727,175852,86849267,87242483,372460
1,ENSG00000224939.1,234629311,1-234520957-G-A,rs72767206,1,G,A,234520957,108354,234432703,234825919,88254
1,ENSG00000237292.1,181174484,1-181161258-T-G,rs73044273,1,T,G,181161258,13226,180977876,181371092,183382
1,ENSG00000234546.1,9182004,1-9200882-G-C,rs737261,1,G,C,9200882,18878,8985396,9378612,215486
1,ENSG00000234546.1,9182004,1-9200882-G-T,rs737261,1,G,T,9200882,18878,8985396,9378612,215486
1,ENSG00000226723.1,192247487,1-192256849-T-C,rs7517414,-1,T,C,192256849,9362,192050879,192444095,205970
1,ENSG00000236792.1,192247505,1-192256849-T-C,rs7517414,1,T,C,192256849,9344,192050897,192444113,205952
1,ENSG00000179840.5,9654586,1-9651429-T-C,rs7518793,-1,T,C,9651429,3157,9457978,9851194,193451
1,ENSG00000213036.3,214483387,1-214292448-C-A,rs7519743,-1,C,A,214292448,190939,214286779,214679995,5669
1,ENSG00000215790.2,1739557,1-1683909-A-C,rs7520934,-1,A,C,1683909,55648,1542949,1936165,140960
1,ENSG00000215790.2,1739557,1-1683909-A-G,rs7520934,-1,A,G,1683909,55648,1542949,1936165,140960
1,ENSG00000215790.2,1739557,1-1683909-A-T,rs7520934,-1,A,T,1683909,55648,1542949,1936165,140960
1,ENSG00000234264.1,68496676,1-68532433-A-C,rs7528818,1,A,C,68532433,35757,68300068,68693284,232365
1,ENSG00000227278.1,40515057,1-40482997-C-A,rs7534068,-1,C,A,40482997,32060,40318449,40711665,164548
1,ENSG00000227278.1,40515057,1-40482997-C-T,rs7534068,-1,C,T,40482997,32060,40318449,40711665,164548
1,ENSG00000235795.1,100995473,1-100970322-C-T,rs7537601,1,C,T,100970322,25151,100798865,101192081,171457
1,ENSG00000235795.1,100995473,1-100970322-C-A,rs7537601,1,C,A,100970322,25151,100798865,101192081,171457
1,ENSG00000183298.4,101787219,1-101938894-T-C,rs75427469,-1,T,C,101938894,151675,101590611,101983827,348283
1,ENSG00000259865.1,247188526,1-247200531-T-A,rs7546908,-1,T,A,247200531,12005,246991918,247385134,208613
1,ENSG00000233396.1,146052594,1-146030310-G-A,rs7552087,1,G,A,146030310,22284,145855986,146249202,174324
1,ENSG00000233791.1,203305309,1-203325492-A-G,rs75733035,-1,A,G,203325492,20183,203108701,203501917,216791
1,ENSG00000233791.1,203305309,1-203325492-A-T,rs75733035,-1,A,T,203325492,20183,203108701,203501917,216791
1,ENSG00000224950.1,116499212,1-116539188-A-T,rs758518,-1,A,T,116539188,39976,116302604,116695820,236584
1,ENSG00000224950.1,116499212,1-116539188-A-G,rs758518,-1,A,G,116539188,39976,116302604,116695820,236584
1,ENSG00000228397.1,22026048,1-22031562-T-A,rs760922,-1,T,A,22031562,5514,21829440,22222656,202122
1,ENSG00000228397.1,22026048,1-22031562-T-C,rs760922,-1,T,C,22031562,5514,21829440,22222656,202122
1,ENSG00000228397.1,22026048,1-22031562-T-G,rs760922,-1,T,G,22031562,5514,21829440,22222656,202122
1,ENSG00000232347.1,247241823,1-247374638-A-G,rs76356095,-1,A,G,247374638,132815,247045215,247438431,329423
1,ENSG00000230849.2,173142350,1-173054058-A-G,rs76520075,-1,A,G,173054058,88292,172945742,173338958,108316
1,ENSG00000223745.1,93345831,1-93366150-G-A,rs771452,-1,G,A,93366150,20319,93149223,93542439,216927
1,ENSG00000223745.1,93345831,1-93366150-G-C,rs771452,-1,G,C,93366150,20319,93149223,93542439,216927
1,ENSG00000223745.1,93345831,1-93366150-G-T,rs771452,-1,G,T,93366150,20319,93149223,93542439,216927
1,ENSG00000237568.1,89260582,1-89434663-C-T,rs77250947,1,C,T,89434663,174081,89063974,89457190,370689
1,ENSG00000237568.1,89260582,1-89434663-C-A,rs77250947,1,C,A,89434663,174081,89063974,89457190,370689
1,ENSG00000229020.3,112923423,1-112999179-G-T,rs773433,1,G,T,112999179,75756,112726815,113120031,272364
1,ENSG00000229020.3,112923423,1-112999179-G-A,rs773433,1,G,A,112999179,75756,112726815,113120031,272364
1,ENSG00000229020.3,112923423,1-112999179-G-C,rs773433,1,G,C,112999179,75756,112726815,113120031,272364
1,ENSG00000182873.4,2183875,1-2254676-G-A,rs77797313,-1,G,A,2254676,70801,1987267,2380483,267409
1,ENSG00000224837.1,168056422,1-168159956-T-C,rs78267760,-1,T,C,168159956,103534,167859814,168253030,300142
1,ENSG00000206585.1,148038916,1-147846731-C-T,rs78318689,-1,C,T,147846731,192185,147842308,148235524,4423
1,ENSG00000225217.1,161606291,1-161763917-G-T,rs78349639,1,G,T,161763917,157626,161409683,161802899,354234
1,ENSG00000225217.1,161606291,1-161763917-G-A,rs78349639,1,G,A,161763917,157626,161409683,161802899,354234
1,ENSG00000177788.5,229271145,1-229090576-G-A,rs78658121,-1,G,A,229090576,180569,229074537,229467753,16039
1,ENSG00000227205.3,119853316,1-119877637-C-A,rs79460646,1,C,A,119877637,24321,119656708,120049924,220929
1,ENSG00000223776.4,236524508,1-236635981-A-G,rs819648,-1,A,G,236635981,111473,236327900,236721116,308081
1,ENSG00000223776.4,236524508,1-236635981-A-T,rs819648,-1,A,T,236635981,111473,236327900,236721116,308081
1,ENSG00000203865.4,116418607,1-116389941-T-A,rs850609,-1,T,A,116389941,28666,116221999,116615215,167942
1,ENSG00000236782.1,26171832,1-26170849-A-G,rs8768,-1,A,G,26170849,983,25975224,26368440,195625
1,ENSG00000236782.1,26171832,1-26170849-A-C,rs8768,-1,A,C,26170849,983,25975224,26368440,195625
1,ENSG00000236782.1,26171832,1-26170849-A-T,rs8768,-1,A,T,26170849,983,25975224,26368440,195625
1,ENSG00000228830.1,234607008,1-234604395-G-A,rs8823,1,G,A,234604395,2613,234410400,234803616,193995
1,ENSG00000225077.2,6234692,1-6236178-T-G,rs9970334,1,T,G,6236178,1486,6038084,6431300,198094
1,ENSG00000225077.2,6234692,1-6236178-T-C,rs9970334,1,T,C,6236178,1486,6038084,6431300,198094
1,ENSG00000229255.1,248485484,1-248524651-T-C,rs10158713,-1,T,C,248524651,39167,248288876,248682092,235775
1,ENSG00000229255.1,248485484,1-248524651-T-A,rs10158713,-1,T,A,248524651,39167,248288876,248682092,235775
1,ENSG00000223653.1,85277672,1-85215595-A-T,rs10218661,1,A,T,85215595,62077,85081064,85474280,134531
1,ENSG00000223653.1,85277672,1-85215595-A-G,rs10218661,1,A,G,85215595,62077,85081064,85474280,134531
1,ENSG00000223653.1,85277672,1-85215595-A-C,rs10218661,1,A,C,85215595,62077,85081064,85474280,134531
1,ENSG00000236876.2,42500339,1-42442548-A-T,rs10437062,-1,A,T,42442548,57791,42303731,42696947,138817
1,ENSG00000236876.2,42500339,1-42442548-A-G,rs10437062,-1,A,G,42442548,57791,42303731,42696947,138817
1,ENSG00000177757.1,817371,1-825532-C-A,rs1048488,1,C,A,825532,8161,620763,1013979,204769
1,ENSG00000177757.1,817371,1-825532-C-T,rs1048488,1,C,T,825532,8161,620763,1013979,204769
1,ENSG00000230163.1,34850694,1-34765777-A-G,rs10489656,1,A,G,34765777,84917,34654086,35047302,111691
1,ENSG00000226419.1,112956824,1-113126295-A-C,rs10494151,1,A,C,113126295,169471,112760216,113153432,366079
1,ENSG00000197880.4,23581495,1-23558170-G-T,rs1050096,1,G,T,23558170,23325,23384887,23778103,173283
1,ENSG00000197880.4,23581495,1-23558170-G-A,rs1050096,1,G,A,23558170,23325,23384887,23778103,173283
1,ENSG00000259865.1,247188526,1-247189319-T-C,rs10754538,-1,T,C,247189319,793,246991918,247385134,197401
1,ENSG00000234222.1,145927236,1-146040040-G-C,rs10797649,1,G,C,146040040,112804,145730628,146123844,309412
1,ENSG00000234222.1,145927236,1-146040040-G-T,rs10797649,1,G,T,146040040,112804,145730628,146123844,309412
1,ENSG00000251520.1,180964511,1-181049663-A-C,rs10797666,1,A,C,181049663,85152,180767903,181161119,281760
1,ENSG00000236782.1,26171832,1-26340318-A-G,rs10902741,-1,A,G,26340318,168486,25975224,26368440,365094
1,ENSG00000233621.1,37474386,1-37436730-G-A,rs10908350,-1,G,A,37436730,37656,37277778,37670994,158952
1,ENSG00000233057.1,194188967,1-194103143-C-A,rs10921498,1,C,A,194103143,85824,193992359,194385575,110784
1,ENSG00000231365.1,119140730,1-119126017-T-C,rs10923754,1,T,C,119126017,14713,118944122,119337338,181895
1,ENSG00000231365.1,119140730,1-119126017-T-A,rs10923754,1,T,A,119126017,14713,118944122,119337338,181895
1,ENSG00000260941.1,119599271,1-119608326-T-C,rs10923875,-1,T,C,119608326,9055,119402663,119795879,205663
1,ENSG00000260941.1,119599271,1-119608326-T-A,rs10923875,-1,T,A,119608326,9055,119402663,119795879,205663
1,ENSG00000233485.1,15343876,1-15265433-T-A,rs10927753,-1,T,A,15265433,78443,15147268,15540484,118165
1,ENSG00000233485.1,15343876,1-15265433-T-G,rs10927753,-1,T,G,15265433,78443,15147268,15540484,118165
1,ENSG00000233485.1,15343876,1-15265433-T-C,rs10927753,-1,T,C,15265433,78443,15147268,15540484,118165
1,ENSG00000232134.1,220144351,1-220300682-A-G,rs11118515,-1,A,G,220300682,156331,219947743,220340959,352939
1,ENSG00000232134.1,220144351,1-220300682-A-T,rs11118515,-1,A,T,220300682,156331,219947743,220340959,352939
1,ENSG00000227591.1,209724125,1-209736164-T-C,rs111488558,-1,T,C,209736164,12039,209527517,209920733,208647
1,ENSG00000181227.2,75744776,1-75744604-C-T,rs11161510,-1,C,T,75744604,172,75548168,75941384,196436
1,ENSG00000261716.1,149850772,1-149920979-A-G,rs11205277,-1,A,G,149920979,70207,149654164,150047380,266815
1,ENSG00000261716.1,149850772,1-149920979-A-T,rs11205277,-1,A,T,149920979,70207,149654164,150047380,266815
1,ENSG00000261716.1,149850772,1-149920979-A-C,rs11205277,-1,A,C,149920979,70207,149654164,150047380,266815
1,ENSG00000227070.1,51518289,1-51339003-T-C,rs11205835,1,T,C,51339003,179286,51321681,51714897,17322
1,ENSG00000243970.1,39558707,1-39583512-G-A,rs11206378,-1,G,A,39583512,24805,39362099,39755315,221413
1,ENSG00000261798.1,39788976,1-39750562-A-G,rs11206754,1,A,G,39750562,38414,39592368,39985584,158194
1,ENSG00000228121.1,58999676,1-58920595-T-C,rs11207332,1,T,C,58920595,79081,58803068,59196284,117527
1,ENSG00000180867.9,147178113,1-147267177-A-G,rs11239962,1,A,G,147267177,89064,146981505,147374721,285672
1,ENSG00000230832.3,147083578,1-147035072-T-C,rs11240099,-1,T,C,147035072,48506,146886970,147280186,148102
1,ENSG00000233728.1,37800879,1-37734325-G-C,rs11264095,-1,G,C,37734325,66554,37604271,37997487,130054
1,ENSG00000242396.1,54886812,1-54935654-T-C,rs114147529,1,T,C,54935654,48842,54690204,55083420,245450
1,ENSG00000236468.1,199387141,1-199500908-T-C,rs114193139,1,T,C,199500908,113767,199190533,199583749,310375
1,ENSG00000260360.1,179954705,1-179767140-C-T,rs114406182,-1,C,T,179767140,187565,179758097,180151313,9043
1,ENSG00000232450.1,113699631,1-113652315-G-A,rs1146181,-1,G,A,113652315,47316,113503023,113896239,149292
1,ENSG00000224520.1,157073257,1-157173882-C-T,rs115704940,1,C,T,157173882,100625,156876649,157269865,297233
1,ENSG00000225171.1,166868748,1-166909227-G-C,rs11576904,1,G,C,166909227,40479,166672140,167065356,237087
1,ENSG00000261000.1,206503948,1-206445529-G-T,rs11579993,1,G,T,206445529,58419,206307340,206700556,138189
1,ENSG00000261000.1,206503948,1-206445529-G-A,rs11579993,1,G,A,206445529,58419,206307340,206700556,138189
1,ENSG00000177173.5,116534092,1-116529902-T-C,rs11588376,-1,T,C,116529902,4190,116337484,116730700,192418
1,ENSG00000236888.1,57606206,1-57632215-G-T,rs11589769,-1,G,T,57632215,26009,57409598,57802814,222617
1,ENSG00000236888.1,57606206,1-57632215-G-A,rs11589769,-1,G,A,57632215,26009,57409598,57802814,222617
1,ENSG00000243155.1,180976482,1-180962814-T-C,rs11590602,-1,T,C,180962814,13668,180779874,181173090,182940
1,ENSG00000243155.1,180976482,1-180962814-T-A,rs11590602,-1,T,A,180962814,13668,180779874,181173090,182940
1,ENSG00000243155.1,180976482,1-180962814-T-G,rs11590602,-1,T,G,180962814,13668,180779874,181173090,182940
1,ENSG00000228794.2,827598,1-831716-A-G,rs115991721,1,A,G,831716,4118,630990,1024206,200726
1,ENSG00000215873.2,91328369,1-91460916-G-C,rs116235557,1,G,C,91460916,132547,91131761,91524977,329155
1,ENSG00000215873.2,91328369,1-91460916-G-A,rs116235557,1,G,A,91460916,132547,91131761,91524977,329155
1,ENSG00000229106.1,23902737,1-23856496-T-G,rs116456835,-1,T,G,23856496,46241,23706129,24099345,150367
1,ENSG00000260246.1,109693742,1-109718120-T-C,rs11807,-1,T,C,109718120,24378,109497134,109890350,220986
1,ENSG00000233184.1,101025846,1-100884750-C-T,rs11809572,1,C,T,100884750,141096,100829238,101222454,55512
1,ENSG00000236804.1,119127291,1-118964609-T-C,rs12021544,-1,T,C,118964609,162682,118930683,119323899,33926
1,ENSG00000236804.1,119127291,1-118964609-T-G,rs12021544,-1,T,G,118964609,162682,118930683,119323899,33926
1,ENSG00000236804.1,119127291,1-118964609-T-A,rs12021544,-1,T,A,118964609,162682,118930683,119323899,33926
1,ENSG00000223575.1,119085954,1-118964609-T-C,rs12021544,-1,T,C,118964609,121345,118889346,119282562,75263
1,ENSG00000223575.1,119085954,1-118964609-T-G,rs12021544,-1,T,G,118964609,121345,118889346,119282562,75263
1,ENSG00000223575.1,119085954,1-118964609-T-A,rs12021544,-1,T,A,118964609,121345,118889346,119282562,75263
1,ENSG00000223776.4,236524508,1-236521494-C-T,rs12041958,-1,C,T,236521494,3014,236327900,236721116,193594
1,ENSG00000198468.2,212858125,1-212915152-T-C,rs12042181,-1,T,C,212915152,57027,212661517,213054733,253635
1,ENSG00000237278.1,113126883,1-112962375-A-G,rs12066409,-1,A,G,112962375,164508,112930275,113323491,32100
1,ENSG00000229388.1,28643228,1-28608390-A-G,rs12077489,1,A,G,28608390,34838,28446620,28839836,161770
1,ENSG00000229388.1,28643228,1-28608390-A-T,rs12077489,1,A,T,28608390,34838,28446620,28839836,161770
1,ENSG00000232093.1,155046118,1-155050384-G-C,rs12085572,-1,G,C,155050384,4266,154849510,155242726,200874
1,ENSG00000232093.1,155046118,1-155050384-G-A,rs12085572,-1,G,A,155050384,4266,154849510,155242726,200874
1,ENSG00000229757.1,168579439,1-168686483-A-G,rs12090370,-1,A,G,168686483,107044,168382831,168776047,303652
1,ENSG00000228288.2,202810850,1-202829373-A-G,rs12092568,1,A,G,202829373,18523,202614242,203007458,215131
1,ENSG00000237276.3,16228027,1-16226277-A-G,rs12119764,-1,A,G,16226277,1750,16031419,16424635,194858
1,ENSG00000230337.1,11099430,1-11057594-C-T,rs12122160,1,C,T,11057594,41836,10902822,11296038,154772
1,ENSG00000233839.1,113168994,1-113049966-C-T,rs12122331,1,C,T,113049966,119028,112972386,113365602,77580
1,ENSG00000232393.1,91023919,1-91098666-A-G,rs12124789,1,A,G,91098666,74747,90827311,91220527,271355
1,ENSG00000236423.1,3900403,1-3877709-C-T,rs12132240,1,C,T,3877709,22694,3703795,4097011,173914
1,ENSG00000224592.1,38047425,1-38171040-G-A,rs12138920,1,G,A,38171040,123615,37850817,38244033,320223
1,ENSG00000225506.2,47179271,1-47052288-G-T,rs12140581,-1,G,T,47052288,126983,46982663,47375879,69625
1,ENSG00000225506.2,47179271,1-47052288-G-C,rs12140581,-1,G,C,47052288,126983,46982663,47375879,69625
1,ENSG00000225506.2,47179271,1-47052288-G-A,rs12140581,-1,G,A,47052288,126983,46982663,47375879,69625
1,ENSG00000228175.2,89994321,1-89900719-G-T,rs12403051,-1,G,T,89900719,93602,89797713,90190929,103006
1,ENSG00000228175.2,89994321,1-89900719-G-A,rs12403051,-1,G,A,89900719,93602,89797713,90190929,103006
1,ENSG00000226084.4,77129114,1-77215427-G-C,rs12403340,1,G,C,77215427,86313,76932506,77325722,282921
1,ENSG00000226084.4,77129114,1-77215427-G-A,rs12403340,1,G,A,77215427,86313,76932506,77325722,282921
1,ENSG00000229570.1,119496841,1-119471954-G-A,rs12407458,-1,G,A,119471954,24887,119300233,119693449,171721
1,ENSG00000232811.1,110943467,1-110906029-G-A,rs12564752,1,G,A,110906029,37438,110746859,111140075,159170
1,ENSG00000260948.1,111433068,1-111432313-A-G,rs1264913,-1,A,G,111432313,755,111236460,111629676,195853
1,ENSG00000223583.1,26455187,1-26420316-G-A,rs12728900,-1,G,A,26420316,34871,26258579,26651795,161737
1,ENSG00000223583.1,26455187,1-26420316-G-T,rs12728900,-1,G,T,26420316,34871,26258579,26651795,161737
1,ENSG00000227777.1,168542737,1-168720364-C-T,rs12733054,1,C,T,168720364,177627,168346129,168739345,374235
1,ENSG00000227217.1,157691762,1-157668178-A-G,rs12737968,1,A,G,157668178,23584,157495154,157888370,173024
1,ENSG00000230955.1,37860697,1-37853257-T-C,rs12743834,1,T,C,37853257,7440,37664089,38057305,189168
1,ENSG00000259943.1,40257971,1-40179262-G-T,rs12744808,-1,G,T,40179262,78709,40061363,40454579,117899
1,ENSG00000224818.1,201465146,1-201460297-T-C,rs12753908,-1,T,C,201460297,4849,201268538,201661754,191759
1,ENSG00000224818.1,201465146,1-201460297-T-A,rs12753908,-1,T,A,201460297,4849,201268538,201661754,191759
1,ENSG00000261654.1,110942353,1-110914197-G-A,rs1282018,-1,G,A,110914197,28156,110745745,111138961,168452
1,ENSG00000261654.1,110942353,1-110914197-G-C,rs1282018,-1,G,C,110914197,28156,110745745,111138961,168452
1,ENSG00000261654.1,110942353,1-110914197-G-T,rs1282018,-1,G,T,110914197,28156,110745745,111138961,168452
1,ENSG00000243781.1,237926831,1-237762517-G-A,rs1357150,1,G,A,237762517,164314,237730223,238123439,32294
1,ENSG00000213735.2,52253621,1-52123017-G-A,rs145686077,1,G,A,52123017,130604,52057013,52450229,66004
1,ENSG00000233427.1,28877336,1-28877395-T-A,rs157198,-1,T,A,28877395,59,28680728,29073944,196667
1,ENSG00000233427.1,28877336,1-28877395-T-C,rs157198,-1,T,C,28877395,59,28680728,29073944,196667
1,ENSG00000228549.1,16872281,1-16971088-T-C,rs16830783,1,T,C,16971088,98807,16675673,17068889,295415
1,ENSG00000228549.1,16872281,1-16971088-T-G,rs16830783,1,T,G,16971088,98807,16675673,17068889,295415
1,ENSG00000235082.1,160317403,1-160125835-A-G,rs16831388,1,A,G,160125835,191568,160120795,160514011,5040
1,ENSG00000220785.3,32241592,1-32136930-A-C,rs16834895,-1,A,C,32136930,104662,32044984,32438200,91946
1,ENSG00000231615.1,173363733,1-173393145-A-G,rs16845819,-1,A,G,173393145,29412,173167125,173560341,226020
1,ENSG00000231615.1,173363733,1-173393145-A-T,rs16845819,-1,A,T,173393145,29412,173167125,173560341,226020
1,ENSG00000231615.1,173363733,1-173393145-A-C,rs16845819,-1,A,C,173393145,29412,173167125,173560341,226020
1,ENSG00000238003.1,201978642,1-202137669-A-G,rs16849710,1,A,G,202137669,159027,201782034,202175250,355635
1,ENSG00000235449.1,202767418,1-202650204-G-A,rs16850187,-1,G,A,202650204,117214,202570810,202964026,79394
1,ENSG00000227417.2,203806263,1-203619183-A-G,rs16851939,-1,A,G,203619183,187080,203609655,204002871,9528
1,ENSG00000231684.2,182336001,1-182152463-G-A,rs1689804,1,G,A,182152463,183538,182139393,182532609,13070
1,ENSG00000228217.1,117778506,1-117846979-T-C,rs17037680,-1,T,C,117846979,68473,117581898,117975114,265081
1,ENSG00000228187.1,77194825,1-77295277-C-T,rs17100224,1,C,T,77295277,100452,76998217,77391433,297060
1,ENSG00000213559.3,80452004,1-80315916-C-T,rs17104640,-1,C,T,80315916,136088,80255396,80648612,60520
1,ENSG00000213559.3,80452004,1-80315916-C-G,rs17104640,-1,C,G,80315916,136088,80255396,80648612,60520
1,ENSG00000232185.1,115564601,1-115371217-C-G,rs17163852,1,C,G,115371217,193384,115367993,115761209,3224
1,ENSG00000232185.1,115564601,1-115371217-C-T,rs17163852,1,C,T,115371217,193384,115367993,115761209,3224
1,ENSG00000231940.1,233289447,1-233412585-C-G,rs17205291,-1,C,G,233412585,123138,233092839,233486055,319746
1,ENSG00000231940.1,233289447,1-233412585-C-T,rs17205291,-1,C,T,233412585,123138,233092839,233486055,319746
1,ENSG00000234975.4,228687415,1-228808056-G-A,rs17353018,1,G,A,228808056,120641,228490807,228884023,317249
1,ENSG00000224680.3,52368677,1-52280008-C-G,rs17364143,1,C,G,52280008,88669,52172069,52565285,107939
1,ENSG00000224680.3,52368677,1-52280008-C-T,rs17364143,1,C,T,52280008,88669,52172069,52565285,107939
1,ENSG00000237424.1,47434641,1-47407639-C-T,rs17370669,-1,C,T,47407639,27002,47238033,47631249,169606
1,ENSG00000227001.2,21427967,1-21467568-C-T,rs17420195,-1,C,T,21467568,39601,21231359,21624575,236209
1,ENSG00000227311.1,40333557,1-40299877-C-T,rs17462950,-1,C,T,40299877,33680,40136949,40530165,162928
1,ENSG00000236065.2,32987075,1-33134514-A-G,rs17542433,1,A,G,33134514,147439,32790467,33183683,344047
1,ENSG00000258082.1,234980804,1-234987549-G-A,rs17600585,-1,G,A,234987549,6745,234784196,235177412,203353
1,ENSG00000238122.1,108273689,1-108118652-C-T,rs1777448,-1,C,T,108118652,155037,108077081,108470297,41571
1,ENSG00000175147.7,15152464,1-15151369-G-T,rs1883761,-1,G,T,15151369,1095,14955856,15349072,195513
1,ENSG00000175147.7,15152464,1-15151369-G-A,rs1883761,-1,G,A,15151369,1095,14955856,15349072,195513
1,ENSG00000175147.7,15152464,1-15151369-G-C,rs1883761,-1,G,C,15151369,1095,14955856,15349072,195513
1,ENSG00000224358.1,165768929,1-165726489-T-C,rs1913846,1,T,C,165726489,42440,165572321,165965537,154168
1,ENSG00000224358.1,165768929,1-165726489-T-G,rs1913846,1,T,G,165726489,42440,165572321,165965537,154168
1,ENSG00000211451.6,145919344,1-145849473-A-C,rs199809125,1,A,C,145849473,69871,145722736,146115952,126737
1,ENSG00000160766.10,155218874,1-155225189-T-C,rs2049805,-1,T,C,155225189,6315,155022266,155415482,202923
1,ENSG00000160766.10,155218874,1-155225189-T-A,rs2049805,-1,T,A,155225189,6315,155022266,155415482,202923
1,ENSG00000160766.10,155218874,1-155225189-T-G,rs2049805,-1,T,G,155225189,6315,155022266,155415482,202923
1,ENSG00000227408.1,103713723,1-103560435-T-C,rs2050592,1,T,C,103560435,153288,103517115,103910331,43320
1,ENSG00000218510.3,22024558,1-22082601-T-G,rs2056974,1,T,G,22082601,58043,21827950,22221166,254651
1,ENSG00000218510.3,22024558,1-22082601-T-A,rs2056974,1,T,A,22082601,58043,21827950,22221166,254651
1,ENSG00000218510.3,22024558,1-22082601-T-C,rs2056974,1,T,C,22082601,58043,21827950,22221166,254651
1,ENSG00000231050.1,1891223,1-1755504-T-C,rs2072929,1,T,C,1755504,135719,1694615,2087831,60889
1,ENSG00000238186.1,40517174,1-40450731-G-A,rs2076493,-1,G,A,40450731,66443,40320566,40713782,130165
1,ENSG00000229133.1,68243055,1-68196068-A-G,rs2116047,-1,A,G,68196068,46987,68046447,68439663,149621
1,ENSG00000229133.1,68243055,1-68196068-A-T,rs2116047,-1,A,T,68196068,46987,68046447,68439663,149621
1,ENSG00000234264.1,68496676,1-68548999-C-T,rs2181862,1,C,T,68548999,52323,68300068,68693284,248931
1,ENSG00000241720.1,109725820,1-109714968-T-A,rs2229059,1,T,A,109714968,10852,109529212,109922428,185756
1,ENSG00000241720.1,109725820,1-109714968-T-C,rs2229059,1,T,C,109714968,10852,109529212,109922428,185756
1,ENSG00000135747.7,247078736,1-247104366-G-T,rs2270616,-1,G,T,247104366,25630,246882128,247275344,222238
1,ENSG00000135747.7,247078736,1-247104366-G-C,rs2270616,-1,G,C,247104366,25630,246882128,247275344,222238
1,ENSG00000135747.7,247078736,1-247104366-G-A,rs2270616,-1,G,A,247104366,25630,246882128,247275344,222238
1,ENSG00000225886.1,27669490,1-27725146-A-T,rs2272796,1,A,T,27725146,55656,27472882,27866098,252264
1,ENSG00000225886.1,27669490,1-27725146-A-G,rs2272796,1,A,G,27725146,55656,27472882,27866098,252264
1,ENSG00000233012.1,220625740,1-220761739-G-A,rs2275575,1,G,A,220761739,135999,220429132,220822348,332607
1,ENSG00000237749.2,37556247,1-37455082-G-C,rs2282256,1,G,C,37455082,101165,37359639,37752855,95443
1,ENSG00000230415.1,1275223,1-1129599-C-T,rs2298217,1,C,T,1129599,145624,1078615,1471831,50984
1,ENSG00000230415.1,1275223,1-1129599-C-G,rs2298217,1,C,G,1129599,145624,1078615,1471831,50984
1,ENSG00000231702.1,1008229,1-1129599-C-T,rs2298217,-1,C,T,1129599,121370,811621,1204837,317978
1,ENSG00000231702.1,1008229,1-1129599-C-G,rs2298217,-1,C,G,1129599,121370,811621,1204837,317978
1,ENSG00000233712.1,157642751,1-157528262-A-C,rs2317051,-1,A,C,157528262,114489,157446143,157839359,82119
1,ENSG00000233712.1,157642751,1-157528262-A-G,rs2317051,-1,A,G,157528262,114489,157446143,157839359,82119
1,ENSG00000233712.1,157642751,1-157528262-A-T,rs2317051,-1,A,T,157528262,114489,157446143,157839359,82119
1,ENSG00000229162.1,24961345,1-24867808-A-G,rs2361150,1,A,G,24867808,93537,24764737,25157953,103071
1,ENSG00000228665.1,109030067,1-109186355-A-T,rs2477363,1,A,T,109186355,156288,108833459,109226675,352896
1,ENSG00000228665.1,109030067,1-109186355-A-G,rs2477363,1,A,G,109186355,156288,108833459,109226675,352896
1,ENSG00000228665.1,109030067,1-109186355-A-C,rs2477363,1,A,C,109186355,156288,108833459,109226675,352896
1,ENSG00000258634.1,110058340,1-110216833-G-A,rs2603594,1,G,A,110216833,158493,109861732,110254948,355101
1,ENSG00000232864.1,227411319,1-227533384-G-A,rs2644142,-1,G,A,227533384,122065,227214711,227607927,318673
1,ENSG00000261135.1,16514645,1-16413412-A-C,rs2670494,1,A,C,16413412,101233,16318037,16711253,95375
1,ENSG00000261135.1,16514645,1-16413412-A-T,rs2670494,1,A,T,16413412,101233,16318037,16711253,95375
1,ENSG00000261135.1,16514645,1-16413412-A-G,rs2670494,1,A,G,16413412,101233,16318037,16711253,95375
1,ENSG00000226029.1,16460948,1-16413412-A-C,rs2670494,1,A,C,16413412,47536,16264340,16657556,149072
1,ENSG00000226029.1,16460948,1-16413412-A-T,rs2670494,1,A,T,16413412,47536,16264340,16657556,149072
1,ENSG00000226029.1,16460948,1-16413412-A-G,rs2670494,1,A,G,16413412,47536,16264340,16657556,149072
1,ENSG00000238005.1,234970062,1-234957196-T-A,rs2674001,-1,T,A,234957196,12866,234773454,235166670,183742
1,ENSG00000238005.1,234970062,1-234957196-T-C,rs2674001,-1,T,C,234957196,12866,234773454,235166670,183742
1,ENSG00000237520.1,234957231,1-234957196-T-A,rs2674001,1,T,A,234957196,35,234760623,235153839,196573
1,ENSG00000237520.1,234957231,1-234957196-T-C,rs2674001,1,T,C,234957196,35,234760623,235153839,196573
1,ENSG00000238015.1,78666272,1-78614351-T-C,rs273236,1,T,C,78614351,51921,78469664,78862880,144687
1,ENSG00000238015.1,78666272,1-78614351-T-G,rs273236,1,T,G,78614351,51921,78469664,78862880,144687
1,ENSG00000238015.1,78666272,1-78614351-T-A,rs273236,1,T,A,78614351,51921,78469664,78862880,144687
1,ENSG00000235400.1,78749073,1-78620785-A-C,rs273241,1,A,C,78620785,128288,78552465,78945681,68320
1,ENSG00000235527.2,113929495,1-114118082-C-G,rs2774311,-1,C,G,114118082,188587,113732887,114126103,385195
1,ENSG00000235527.2,113929495,1-114118082-C-T,rs2774311,-1,C,T,114118082,188587,113732887,114126103,385195
1,ENSG00000235527.2,113929495,1-114118082-C-A,rs2774311,-1,C,A,114118082,188587,113732887,114126103,385195
1,ENSG00000223396.2,201520056,1-201534604-T-C,rs2782581,1,T,C,201534604,14548,201323448,201716664,211156
1,ENSG00000232883.1,220317599,1-220159210-C-T,rs2789792,-1,C,T,220159210,158389,220120991,220514207,38219
1,ENSG00000238198.1,113073113,1-113036481-C-T,rs2798691,-1,C,T,113036481,36632,112876505,113269721,159976
1,ENSG00000238198.1,113073113,1-113036481-C-G,rs2798691,-1,C,G,113036481,36632,112876505,113269721,159976
1,ENSG00000228452.1,42776790,1-42764888-C-G,rs2816594,-1,C,G,42764888,11902,42580182,42973398,184706
1,ENSG00000228452.1,42776790,1-42764888-C-T,rs2816594,-1,C,T,42764888,11902,42580182,42973398,184706
1,ENSG00000243960.1,111441364,1-111257850-T-A,rs2820082,-1,T,A,111257850,183514,111244756,111637972,13094
1,ENSG00000243960.1,111441364,1-111257850-T-G,rs2820082,-1,T,G,111257850,183514,111244756,111637972,13094
1,ENSG00000243960.1,111441364,1-111257850-T-C,rs2820082,-1,T,C,111257850,183514,111244756,111637972,13094
1,ENSG00000229022.1,241831935,1-241947377-G-A,rs28459756,1,G,A,241947377,115442,241635327,242028543,312050
1,ENSG00000237352.1,58933643,1-59019982-G-C,rs2985887,1,G,C,59019982,86339,58737035,59130251,282947
1,ENSG00000237352.1,58933643,1-59019982-G-T,rs2985887,1,G,T,59019982,86339,58737035,59130251,282947
1,ENSG00000224609.1,59296491,1-59104157-C-G,rs3010325,-1,C,G,59104157,192334,59099883,59493099,4274
1,ENSG00000224609.1,59296491,1-59104157-C-T,rs3010325,-1,C,T,59104157,192334,59099883,59493099,4274
1,ENSG00000236546.1,39897745,1-39921012-A-G,rs3117091,1,A,G,39921012,23267,39701137,40094353,219875
1,ENSG00000232273.1,37544763,1-37430454-C-T,rs34442203,1,C,T,37430454,114309,37348155,37741371,82299
1,ENSG00000197568.9,70354844,1-70347903-C-G,rs34495920,1,C,G,70347903,6941,70158236,70551452,189667
1,ENSG00000197568.9,70354844,1-70347903-C-T,rs34495920,1,C,T,70347903,6941,70158236,70551452,189667
1,ENSG00000234441.1,103668268,1-103771190-G-A,rs34848656,-1,G,A,103771190,102922,103471660,103864876,299530
1,ENSG00000229985.2,27176751,1-27003177-C-T,rs35308549,1,C,T,27003177,173574,26980143,27373359,23034
1,ENSG00000225294.1,26986340,1-27076911-C-G,rs35327731,-1,C,G,27076911,90571,26789732,27182948,287179
1,ENSG00000237090.1,42892430,1-42933316-C-T,rs3768029,-1,C,T,42933316,40886,42695822,43089038,237494
1,ENSG00000237090.1,42892430,1-42933316-C-G,rs3768029,-1,C,G,42933316,40886,42695822,43089038,237494
1,ENSG00000228054.1,109046828,1-109091891-A-G,rs3768500,1,A,G,109091891,45063,108850220,109243436,241671
1,ENSG00000228054.1,109046828,1-109091891-A-C,rs3768500,1,A,C,109091891,45063,108850220,109243436,241671
1,ENSG00000235101.1,160670148,1-160673321-A-C,rs3795324,1,A,C,160673321,3173,160473540,160866756,199781
1,ENSG00000215867.3,111649544,1-111536389-T-A,rs3849169,-1,T,A,111536389,113155,111452936,111846152,83453
1,ENSG00000215867.3,111649544,1-111536389-T-C,rs3849169,-1,T,C,111536389,113155,111452936,111846152,83453
1,ENSG00000225154.1,47075979,1-47164829-A-G,rs3862275,-1,A,G,47164829,88850,46879371,47272587,285458
1,ENSG00000223452.2,155148544,1-155192276-C-T,rs4072037,1,C,T,155192276,43732,154951936,155345152,240340
1,ENSG00000223452.2,155148544,1-155192276-C-G,rs4072037,1,C,G,155192276,43732,154951936,155345152,240340
1,ENSG00000223452.2,155148544,1-155192276-C-A,rs4072037,1,C,A,155192276,43732,154951936,155345152,240340
1,ENSG00000215914.3,1699942,1-1680672-C-G,rs4074197,1,C,G,1680672,19270,1503334,1896550,177338
1,ENSG00000215914.3,1699942,1-1680672-C-T,rs4074197,1,C,T,1680672,19270,1503334,1896550,177338
1,ENSG00000241014.1,34977395,1-35010638-T-C,rs41266437,-1,T,C,35010638,33243,34780787,35174003,229851
1,ENSG00000231789.1,9687583,1-9687712-C-G,rs41278008,-1,C,G,9687712,129,9490975,9884191,196737
1,ENSG00000231789.1,9687583,1-9687712-C-T,rs41278008,-1,C,T,9687712,129,9490975,9884191,196737
1,ENSG00000238287.1,40508661,1-40494947-G-A,rs41301076,-1,G,A,40494947,13714,40312053,40705269,182894
1,ENSG00000231999.2,89632979,1-89763028-C-G,rs41305844,-1,C,G,89763028,130049,89436371,89829587,326657
1,ENSG00000227056.1,119220096,1-119157601-C-T,rs4130748,-1,C,T,119157601,62495,119023488,119416704,134113
1,ENSG00000230623.2,200333193,1-200180367-C-G,rs41415747,1,C,G,200180367,152826,200136585,200529801,43782
1,ENSG00000203865.4,116418607,1-116449285-G-A,rs41439745,-1,G,A,116449285,30678,116221999,116615215,227286
1,ENSG00000228863.1,160676371,1-160674942-A-T,rs41440146,1,A,T,160674942,1429,160479763,160872979,195179
1,ENSG00000237491.2,778747,1-900119-A-G,rs4422948,1,A,G,900119,121372,582139,975355,317980
1,ENSG00000230699.2,911435,1-900119-A-G,rs4422948,1,A,G,900119,11316,714827,1108043,185292
1,ENSG00000260063.1,26694131,1-26693521-C-T,rs4466675,-1,C,T,26693521,610,26497523,26890739,195998
1,ENSG00000182873.4,2183875,1-2017366-T-A,rs4481796,-1,T,A,2017366,166509,1987267,2380483,30099
1,ENSG00000182873.4,2183875,1-2017366-T-C,rs4481796,-1,T,C,2017366,166509,1987267,2380483,30099
1,ENSG00000244703.3,207645234,1-207703232-C-A,rs4562622,1,C,A,207703232,57998,207448626,207841842,254606
1,ENSG00000244703.3,207645234,1-207703232-C-G,rs4562622,1,C,G,207703232,57998,207448626,207841842,254606
1,ENSG00000251484.2,109104766,1-109240583-G-T,rs4623734,-1,G,T,109240583,135817,108908158,109301374,332425
1,ENSG00000251484.2,109104766,1-109240583-G-C,rs4623734,-1,G,C,109240583,135817,108908158,109301374,332425
1,ENSG00000237568.1,89260582,1-89335435-C-A,rs4658310,1,C,A,89335435,74853,89063974,89457190,271461
1,ENSG00000237568.1,89260582,1-89335435-C-G,rs4658310,1,C,G,89335435,74853,89063974,89457190,271461
1,ENSG00000237568.1,89260582,1-89335435-C-T,rs4658310,1,C,T,89335435,74853,89063974,89457190,271461
1,ENSG00000225265.1,222589928,1-222547946-C-G,rs4846382,1,C,G,222547946,41982,222393320,222786536,154626
1,ENSG00000225265.1,222589928,1-222547946-C-T,rs4846382,1,C,T,222547946,41982,222393320,222786536,154626
1,ENSG00000225265.1,222589928,1-222547946-C-A,rs4846382,1,C,A,222547946,41982,222393320,222786536,154626
1,ENSG00000225938.1,101236624,1-101345005-T-C,rs4907936,-1,T,C,101345005,108381,101040016,101433232,304989
1,ENSG00000231671.1,101323837,1-101366282-A-T,rs4908135,1,A,T,101366282,42445,101127229,101520445,239053
1,ENSG00000231671.1,101323837,1-101366282-A-C,rs4908135,1,A,C,101366282,42445,101127229,101520445,239053
1,ENSG00000236266.1,7827342,1-7657582-C-A,rs4908666,-1,C,A,7657582,169760,7630734,8023950,26848
1,ENSG00000236266.1,7827342,1-7657582-C-G,rs4908666,-1,C,G,7657582,169760,7630734,8023950,26848
1,ENSG00000211454.8,19274194,1-19311596-G-C,rs4911983,-1,G,C,19311596,37402,19077586,19470802,234010
1,ENSG00000211454.8,19274194,1-19311596-G-A,rs4911983,-1,G,A,19311596,37402,19077586,19470802,234010
1,ENSG00000232824.1,198198186,1-198239792-T-C,rs4915272,-1,T,C,198239792,41606,198001578,198394794,238214
1,ENSG00000232824.1,198198186,1-198239792-T-G,rs4915272,-1,T,G,198239792,41606,198001578,198394794,238214
1,ENSG00000229191.1,201023961,1-201060303-T-C,rs4915475,1,T,C,201060303,36342,200827353,201220569,232950
1,ENSG00000229191.1,201023961,1-201060303-T-A,rs4915475,1,T,A,201060303,36342,200827353,201220569,232950
1,ENSG00000233626.1,211936249,1-212062815-G-C,rs4951436,1,G,C,212062815,126566,211739641,212132857,323174
1,ENSG00000233626.1,211936249,1-212062815-G-A,rs4951436,1,G,A,212062815,126566,211739641,212132857,323174
1,ENSG00000233626.1,211936249,1-212062815-G-T,rs4951436,1,G,T,212062815,126566,211739641,212132857,323174
1,ENSG00000230092.2,810161,1-905373-T-C,rs4970382,-1,T,C,905373,95212,613553,1006769,291820
1,ENSG00000230092.2,810161,1-905373-T-A,rs4970382,-1,T,A,905373,95212,613553,1006769,291820
1,ENSG00000224939.1,234629311,1-234629179-G-A,rs530596,1,G,A,234629179,132,234432703,234825919,196476
1,ENSG00000224939.1,234629311,1-234629179-G-C,rs530596,1,G,C,234629179,132,234432703,234825919,196476
1,ENSG00000231871.1,201829559,1-201676532-G-T,rs531606,-1,G,T,201676532,153027,201632951,202026167,43581
1,ENSG00000231871.1,201829559,1-201676532-G-C,rs531606,-1,G,C,201676532,153027,201632951,202026167,43581
1,ENSG00000228126.1,150515757,1-150467803-T-C,rs55816515,1,T,C,150467803,47954,150319149,150712365,148654
1,ENSG00000230679.1,8878835,1-8883291-C-G,rs56379806,1,C,G,8883291,4456,8682227,9075443,201064
1,ENSG00000230679.1,8878835,1-8883291-C-T,rs56379806,1,C,T,8883291,4456,8682227,9075443,201064
1,ENSG00000233337.1,111437514,1-111631061-C-G,rs566142,1,C,G,111631061,193547,111240906,111634122,390155
1,ENSG00000233337.1,111437514,1-111631061-C-T,rs566142,1,C,T,111631061,193547,111240906,111634122,390155
1,ENSG00000223416.3,58056480,1-58240737-T-G,rs577005,-1,T,G,58240737,184257,57859872,58253088,380865
1,ENSG00000223416.3,58056480,1-58240737-T-C,rs577005,-1,T,C,58240737,184257,57859872,58253088,380865
1,ENSG00000187952.7,21428303,1-21598419-A-G,rs61775974,1,A,G,21598419,170116,21231695,21624911,366724
1,ENSG00000224950.1,116499212,1-116472759-C-A,rs61789219,-1,C,A,116472759,26453,116302604,116695820,170155
1,ENSG00000260805.1,212559731,1-212636753-C-T,rs61830700,-1,C,T,212636753,77022,212363123,212756339,273630
1,ENSG00000228013.1,154406564,1-154408010-G-A,rs6427641,-1,G,A,154408010,1446,154209956,154603172,198054
1,ENSG00000228013.1,154406564,1-154408010-G-C,rs6427641,-1,G,C,154408010,1446,154209956,154603172,198054
1,ENSG00000228013.1,154406564,1-154408010-G-T,rs6427641,-1,G,T,154408010,1446,154209956,154603172,198054
1,ENSG00000260088.1,200669507,1-200671753-G-T,rs6427837,1,G,T,200671753,2246,200472899,200866115,198854
1,ENSG00000260088.1,200669507,1-200671753-G-A,rs6427837,1,G,A,200671753,2246,200472899,200866115,198854
1,ENSG00000260088.1,200669507,1-200671753-G-C,rs6427837,1,G,C,200671753,2246,200472899,200866115,198854
1,ENSG00000153363.8,211382775,1-211320231-A-G,rs6540681,1,A,G,211320231,62544,211186167,211579383,134064
1,ENSG00000153363.8,211382775,1-211320231-A-T,rs6540681,1,A,T,211320231,62544,211186167,211579383,134064
1,ENSG00000153363.8,211382775,1-211320231-A-C,rs6540681,1,A,C,211320231,62544,211186167,211579383,134064
1,ENSG00000231663.1,234373664,1-234372231-C-T,rs6586384,-1,C,T,234372231,1433,234177056,234570272,195175
1,ENSG00000230138.1,53368245,1-53371515-A-G,rs6588477,-1,A,G,53371515,3270,53171637,53564853,199878
1,ENSG00000230138.1,53368245,1-53371515-A-T,rs6588477,-1,A,T,53371515,3270,53171637,53564853,199878
1,ENSG00000224699.1,110347116,1-110407098-C-T,rs6671673,1,C,T,110407098,59982,110150508,110543724,256590
1,ENSG00000231507.1,203273221,1-203232128-G-A,rs6672661,1,G,A,203232128,41093,203076613,203469829,155515
1,ENSG00000213478.2,51158471,1-51173694-A-C,rs6675413,-1,A,C,51173694,15223,50961863,51355079,211831
1,ENSG00000213478.2,51158471,1-51173694-A-G,rs6675413,-1,A,G,51173694,15223,50961863,51355079,211831
1,ENSG00000260855.1,246772301,1-246790995-G-A,rs6680122,1,G,A,246790995,18694,246575693,246968909,215302
1,ENSG00000260855.1,246772301,1-246790995-G-C,rs6680122,1,G,C,246790995,18694,246575693,246968909,215302
1,ENSG00000227533.1,42959078,1-42947982-A-G,rs710222,1,A,G,42947982,11096,42762470,43155686,185512
1,ENSG00000227533.1,42959078,1-42947982-A-C,rs710222,1,A,C,42947982,11096,42762470,43155686,185512
1,ENSG00000236528.1,25859613,1-25790489-C-G,rs710830,1,C,G,25790489,69124,25663005,26056221,127484
1,ENSG00000236528.1,25859613,1-25790489-C-T,rs710830,1,C,T,25790489,69124,25663005,26056221,127484
1,ENSG00000217801.4,1063079,1-1237527-C-G,rs715643,1,C,G,1237527,174448,866471,1259687,371056
1,ENSG00000217801.4,1063079,1-1237527-C-T,rs715643,1,C,T,1237527,174448,866471,1259687,371056
1,ENSG00000227409.1,35366077,1-35189460-T-C,rs72657982,-1,T,C,35189460,176617,35169469,35562685,19991
1,ENSG00000227409.1,35366077,1-35189460-T-A,rs72657982,-1,T,A,35189460,176617,35169469,35562685,19991
1,ENSG00000228589.2,28096422,1-28037730-T-C,rs72658313,-1,T,C,28037730,58692,27899814,28293030,137916
1,ENSG00000228589.2,28096422,1-28037730-T-G,rs72658313,-1,T,G,28037730,58692,27899814,28293030,137916
1,ENSG00000229020.3,112923423,1-113085259-A-G,rs72683492,1,A,G,113085259,161836,112726815,113120031,358444
1,ENSG00000236675.1,155230975,1-155088859-G-T,rs72702276,1,G,T,155088859,142116,155034367,155427583,54492
1,ENSG00000236675.1,155230975,1-155088859-G-A,rs72702276,1,G,A,155088859,142116,155034367,155427583,54492
1,ENSG00000233827.1,200213678,1-200303717-A-G,rs72743029,1,A,G,200303717,90039,200017070,200410286,286647
1,ENSG00000229431.1,43385113,1-43520774-C-T,rs72887223,1,C,T,43520774,135661,43188505,43581721,332269
1,ENSG00000229431.1,43385113,1-43520774-C-A,rs72887223,1,C,A,43520774,135661,43188505,43581721,332269
1,ENSG00000235501.1,94927478,1-95074006-C-T,rs74103646,1,C,T,95074006,146528,94730870,95124086,343136
1,ENSG00000228060.1,39565052,1-39496921-G-A,rs74645539,1,G,A,39496921,68131,39368444,39761660,128477
1,ENSG00000238142.1,16889672,1-16972001-A-T,rs7513616,-1,A,T,16972001,82329,16693064,17086280,278937
1,ENSG00000238142.1,16889672,1-16972001-A-G,rs7513616,-1,A,G,16972001,82329,16693064,17086280,278937
1,ENSG00000244371.1,146957659,1-147083843-A-T,rs7514402,-1,A,T,147083843,126184,146761051,147154267,322792
1,ENSG00000244371.1,146957659,1-147083843-A-C,rs7514402,-1,A,C,147083843,126184,146761051,147154267,322792
1,ENSG00000244371.1,146957659,1-147083843-A-G,rs7514402,-1,A,G,147083843,126184,146761051,147154267,322792
1,ENSG00000224616.1,100266179,1-100224689-G-C,rs7526860,-1,G,C,100224689,41490,100069571,100462787,155118
1,ENSG00000224616.1,100266179,1-100224689-G-T,rs7526860,-1,G,T,100224689,41490,100069571,100462787,155118
1,ENSG00000224616.1,100266179,1-100224689-G-A,rs7526860,-1,G,A,100224689,41490,100069571,100462787,155118
1,ENSG00000228063.1,219173768,1-219144286-T-A,rs7527419,-1,T,A,219144286,29482,218977160,219370376,167126
1,ENSG00000228063.1,219173768,1-219144286-T-C,rs7527419,-1,T,C,219144286,29482,218977160,219370376,167126
1,ENSG00000230628.1,234696153,1-234593897-T-C,rs7532095,-1,T,C,234593897,102256,234499545,234892761,94352
1,ENSG00000230628.1,234696153,1-234593897-T-G,rs7532095,-1,T,G,234593897,102256,234499545,234892761,94352
1,ENSG00000233432.1,121502344,1-121430980-T-G,rs7532615,1,T,G,121430980,71364,121305736,121698952,125244
1,ENSG00000233432.1,121502344,1-121430980-T-A,rs7532615,1,T,A,121430980,71364,121305736,121698952,125244
1,ENSG00000238140.1,51461721,1-51351869-T-C,rs7538988,1,T,C,51351869,109852,51265113,51658329,86756
1,ENSG00000228397.1,22026048,1-22128649-G-A,rs7544210,-1,G,A,22128649,102601,21829440,22222656,299209
1,ENSG00000215795.2,247185482,1-247197066-T-C,rs7551512,-1,T,C,247197066,11584,246988874,247382090,208192
1,ENSG00000235605.1,234357141,1-234517602-G-A,rs75627953,-1,G,A,234517602,160461,234160533,234553749,357069
1,ENSG00000249087.3,23368949,1-23180067-C-A,rs76065586,1,C,A,23180067,188882,23172341,23565557,7726
1,ENSG00000227278.1,40515057,1-40651577-G-A,rs77060218,-1,G,A,40651577,136520,40318449,40711665,333128
1,ENSG00000228348.1,35122022,1-35083420-C-T,rs77438111,1,C,T,35083420,38602,34925414,35318630,158006
1,ENSG00000228348.1,35122022,1-35083420-C-G,rs77438111,1,C,G,35083420,38602,34925414,35318630,158006
1,ENSG00000225217.1,161606291,1-161589930-G-A,rs78603008,1,G,A,161589930,16361,161409683,161802899,180247
1,ENSG00000259818.1,53220663,1-53305216-C-T,rs78850699,1,C,T,53305216,84553,53024055,53417271,281161
1,ENSG00000225077.2,6234692,1-6219310-G-A,rs846111,1,G,A,6219310,15382,6038084,6431300,181226
1,ENSG00000225077.2,6234692,1-6219310-G-C,rs846111,1,G,C,6219310,15382,6038084,6431300,181226
1,ENSG00000203914.2,91642516,1-91684501-G-A,rs913060,1,G,A,91684501,41985,91445908,91839124,238593
1,ENSG00000232453.1,58931897,1-58903275-G-C,rs927743,-1,G,C,58903275,28622,58735289,59128505,167986
1,ENSG00000232453.1,58931897,1-58903275-G-A,rs927743,-1,G,A,58903275,28622,58735289,59128505,167986
1,ENSG00000232453.1,58931897,1-58903275-G-T,rs927743,-1,G,T,58903275,28622,58735289,59128505,167986
1,ENSG00000224521.1,248548756,1-248522418-A-T,rs9330305,1,A,T,248522418,26338,248352148,248745364,170270
1,ENSG00000228852.1,95278940,1-95206673-C-G,rs933107,-1,C,G,95206673,72267,95082332,95475548,124341
1,ENSG00000228852.1,95278940,1-95206673-C-T,rs933107,-1,C,T,95206673,72267,95082332,95475548,124341
1,ENSG00000228852.1,95278940,1-95206673-C-A,rs933107,-1,C,A,95206673,72267,95082332,95475548,124341
1,ENSG00000179840.5,9654586,1-9679377-T-C,rs9430636,-1,T,C,9679377,24791,9457978,9851194,221399
1,ENSG00000179840.5,9654586,1-9679377-T-A,rs9430636,-1,T,A,9679377,24791,9457978,9851194,221399
1,ENSG00000215790.2,1739557,1-1688328-C-T,rs9442411,-1,C,T,1688328,51229,1542949,1936165,145379
1,ENSG00000213041.3,205202191,1-205058262-C-T,rs9787172,1,C,T,205058262,143929,205005583,205398799,52679
1,ENSG00000258634.1,110058340,1-110077495-C-T,rs10127539,1,C,T,110077495,19155,109861732,110254948,215763
1,ENSG00000258634.1,110058340,1-110077495-C-G,rs10127539,1,C,G,110077495,19155,109861732,110254948,215763
1,ENSG00000233396.1,146052594,1-146018957-G-A,rs10218795,1,G,A,146018957,33637,145855986,146249202,162971
1,ENSG00000232912.1,8424645,1-8347227-C-G,rs10399665,1,C,G,8347227,77418,8228037,8621253,119190
1,ENSG00000232912.1,8424645,1-8347227-C-T,rs10399665,1,C,T,8347227,77418,8228037,8621253,119190
1,ENSG00000236439.2,202472117,1-202591284-T-G,rs1040010,-1,T,G,202591284,119167,202275509,202668725,315775
1,ENSG00000236439.2,202472117,1-202591284-T-C,rs1040010,-1,T,C,202591284,119167,202275509,202668725,315775
1,ENSG00000236439.2,202472117,1-202591284-T-A,rs1040010,-1,T,A,202591284,119167,202275509,202668725,315775
1,ENSG00000229106.1,23902737,1-23787334-T-C,rs1046924,-1,T,C,23787334,115403,23706129,24099345,81205
1,ENSG00000227311.1,40333557,1-40456390-T-C,rs10489434,-1,T,C,40456390,122833,40136949,40530165,319441
1,ENSG00000236468.1,199387141,1-199192634-T-A,rs10494785,1,T,A,199192634,194507,199190533,199583749,2101
1,ENSG00000236468.1,199387141,1-199192634-T-C,rs10494785,1,T,C,199192634,194507,199190533,199583749,2101
1,ENSG00000231064.1,155194997,1-155290559-A-T,rs1052177,1,A,T,155290559,95562,154998389,155391605,292170
1,ENSG00000231064.1,155194997,1-155290559-A-C,rs1052177,1,A,C,155290559,95562,154998389,155391605,292170
1,ENSG00000231064.1,155194997,1-155290559-A-G,rs1052177,1,A,G,155290559,95562,154998389,155391605,292170
1,ENSG00000198857.3,119601340,1-119620908-T-A,rs10754416,1,T,A,119620908,19568,119404732,119797948,216176
1,ENSG00000198857.3,119601340,1-119620908-T-C,rs10754416,1,T,C,119620908,19568,119404732,119797948,216176
1,ENSG00000260941.1,119599271,1-119573031-G-A,rs10802114,-1,G,A,119573031,26240,119402663,119795879,170368
1,ENSG00000260941.1,119599271,1-119573031-G-C,rs10802114,-1,G,C,119573031,26240,119402663,119795879,170368
1,ENSG00000225938.1,101236624,1-101222201-G-A,rs10875362,-1,G,A,101222201,14423,101040016,101433232,182185
1,ENSG00000215908.4,16657232,1-16679211-G-C,rs10907262,-1,G,C,16679211,21979,16460624,16853840,218587
1,ENSG00000215908.4,16657232,1-16679211-G-A,rs10907262,-1,G,A,16679211,21979,16460624,16853840,218587
1,ENSG00000233621.1,37474386,1-37569685-G-A,rs10908355,-1,G,A,37569685,95299,37277778,37670994,291907
1,ENSG00000233621.1,37474386,1-37569685-G-C,rs10908355,-1,G,C,37569685,95299,37277778,37670994,291907
1,ENSG00000233621.1,37474386,1-37569685-G-T,rs10908355,-1,G,T,37569685,95299,37277778,37670994,291907
1,ENSG00000238164.2,2557031,1-2589991-C-T,rs10910097,-1,C,T,2589991,32960,2360423,2753639,229568
1,ENSG00000230364.1,171684438,1-171537557-A-G,rs10913197,-1,A,G,171537557,146881,171487830,171881046,49727
1,ENSG00000215790.2,1739557,1-1760882-T-C,rs1107910,-1,T,C,1760882,21325,1542949,1936165,217933
1,ENSG00000153363.8,211382775,1-211471233-G-A,rs11119744,1,G,A,211471233,88458,211186167,211579383,285066
1,ENSG00000224616.1,100266179,1-100195270-G-A,rs11166414,-1,G,A,100195270,70909,100069571,100462787,125699
1,ENSG00000233084.2,248936581,1-248928251-T-A,rs11205400,1,T,A,248928251,8330,248739973,249133189,188278
1,ENSG00000233084.2,248936581,1-248928251-T-C,rs11205400,1,T,C,248928251,8330,248739973,249133189,188278
1,ENSG00000185031.5,64986087,1-65068808-A-C,rs11208579,-1,A,C,65068808,82721,64789479,65182695,279329
1,ENSG00000185031.5,64986087,1-65068808-A-G,rs11208579,-1,A,G,65068808,82721,64789479,65182695,279329
1,ENSG00000185031.5,64986087,1-65068808-A-T,rs11208579,-1,A,T,65068808,82721,64789479,65182695,279329
1,ENSG00000240731.1,1318689,1-1229930-G-A,rs11260562,-1,G,A,1229930,88759,1122081,1515297,107849
1,ENSG00000080947.9,16491307,1-16326804-C-T,rs11260727,-1,C,T,16326804,164503,16294699,16687915,32105
1,ENSG00000227741.1,160208869,1-160404167-C-A,rs11265386,-1,C,A,160404167,195298,160012261,160405477,391906
1,ENSG00000227741.1,160208869,1-160404167-C-T,rs11265386,-1,C,T,160404167,195298,160012261,160405477,391906
1,ENSG00000260246.1,109693742,1-109707875-G-T,rs112697537,-1,G,T,109707875,14133,109497134,109890350,210741
1,ENSG00000260246.1,109693742,1-109707875-G-C,rs112697537,-1,G,C,109707875,14133,109497134,109890350,210741
1,ENSG00000260246.1,109693742,1-109707875-G-A,rs112697537,-1,G,A,109707875,14133,109497134,109890350,210741
1,ENSG00000224870.3,1399515,1-1206007-C-T,rs11466681,1,C,T,1206007,193508,1202907,1596123,3100
1,ENSG00000213690.2,242377432,1-242424544-T-G,rs114677102,-1,T,G,242424544,47112,242180824,242574040,243720
1,ENSG00000213690.2,242377432,1-242424544-T-C,rs114677102,-1,T,C,242424544,47112,242180824,242574040,243720
1,ENSG00000213690.2,242377432,1-242424544-T-A,rs114677102,-1,T,A,242424544,47112,242180824,242574040,243720
1,ENSG00000228818.1,240145389,1-240099836-T-C,rs114737396,-1,T,C,240099836,45553,239948781,240341997,151055
1,ENSG00000213062.3,169486076,1-169306094-T-C,rs115023192,1,T,C,169306094,179982,169289468,169682684,16626
1,ENSG00000261716.1,149850772,1-149926400-A-G,rs115070660,-1,A,G,149926400,75628,149654164,150047380,272236
1,ENSG00000229965.1,226438564,1-226506921-A-C,rs1151816,1,A,C,226506921,68357,226241956,226635172,264965
1,ENSG00000229965.1,226438564,1-226506921-A-G,rs1151816,1,A,G,226506921,68357,226241956,226635172,264965
1,ENSG00000241666.1,167630674,1-167455220-T-C,rs115647472,-1,T,C,167455220,175454,167434066,167827282,21154
1,ENSG00000260805.1,212559731,1-212613683-T-C,rs11571537,-1,T,C,212613683,53952,212363123,212756339,250560
1,ENSG00000233406.3,51251472,1-51174641-G-C,rs11580368,-1,G,C,51174641,76831,51054864,51448080,119777
1,ENSG00000233406.3,51251472,1-51174641-G-T,rs11580368,-1,G,T,51174641,76831,51054864,51448080,119777
1,ENSG00000224261.1,160267225,1-160450246-C-T,rs11585691,-1,C,T,160450246,183021,160070617,160463833,379629
1,ENSG00000236216.4,21397987,1-21224848-C-T,rs11590928,1,C,T,21224848,173139,21201379,21594595,23469
1,ENSG00000236216.4,21397987,1-21224848-C-A,rs11590928,1,C,A,21224848,173139,21201379,21594595,23469
1,ENSG00000213028.3,229689904,1-229579145-G-A,rs116265206,-1,G,A,229579145,110759,229493296,229886512,85849
1,ENSG00000225871.1,148435105,1-148290114-G-A,rs116459505,1,G,A,148290114,144991,148238497,148631713,51617
1,ENSG00000242757.1,227430526,1-227455445-C-A,rs118000395,1,C,A,227455445,24919,227233918,227627134,221527
1,ENSG00000242757.1,227430526,1-227455445-C-T,rs118000395,1,C,T,227455445,24919,227233918,227627134,221527
1,ENSG00000235912.1,27649419,1-27462712-T-C,rs11802615,1,T,C,27462712,186707,27452811,27846027,9901
1,ENSG00000229191.1,201023961,1-201021631-T-C,rs11804082,1,T,C,201021631,2330,200827353,201220569,194278
1,ENSG00000236779.1,204529692,1-204341396-A-G,rs12023102,-1,A,G,204341396,188296,204333084,204726300,8312
1,ENSG00000233461.1,231528604,1-231469633-G-A,rs12030600,-1,G,A,231469633,58971,231331996,231725212,137637
1,ENSG00000225506.2,47179271,1-47172327-G-T,rs12034515,-1,G,T,47172327,6944,46982663,47375879,189664
1,ENSG00000225506.2,47179271,1-47172327-G-C,rs12034515,-1,G,C,47172327,6944,46982663,47375879,189664
1,ENSG00000230318.1,220315565,1-220207477-A-T,rs12035921,-1,A,T,220207477,108088,220118957,220512173,88520
1,ENSG00000230318.1,220315565,1-220207477-A-G,rs12035921,-1,A,G,220207477,108088,220118957,220512173,88520
1,ENSG00000230318.1,220315565,1-220207477-A-C,rs12035921,-1,A,C,220207477,108088,220118957,220512173,88520
1,ENSG00000227205.3,119853316,1-119737931-C-G,rs12070041,1,C,G,119737931,115385,119656708,120049924,81223
1,ENSG00000227205.3,119853316,1-119737931-C-T,rs12070041,1,C,T,119737931,115385,119656708,120049924,81223
1,ENSG00000215864.3,119844514,1-119893148-C-T,rs12075536,-1,C,T,119893148,48634,119647906,120041122,245242
1,ENSG00000241014.1,34977395,1-34921714-T-C,rs12078977,-1,T,C,34921714,55681,34780787,35174003,140927
1,ENSG00000227373.1,174159334,1-174291870-C-T,rs12081444,-1,C,T,174291870,132536,173962726,174355942,329144
1,ENSG00000231615.1,173363733,1-173439178-C-T,rs12085083,-1,C,T,173439178,75445,173167125,173560341,272053
1,ENSG00000233290.1,82848205,1-82826071-A-G,rs12118797,-1,A,G,82826071,22134,82651597,83044813,174474
1,ENSG00000236674.1,63361179,1-63333854-G-A,rs12123368,-1,G,A,63333854,27325,63164571,63557787,169283
1,ENSG00000225154.1,47075979,1-47052288-G-T,rs12140581,-1,G,T,47052288,23691,46879371,47272587,172917
1,ENSG00000225154.1,47075979,1-47052288-G-A,rs12140581,-1,G,A,47052288,23691,46879371,47272587,172917
1,ENSG00000225154.1,47075979,1-47052288-G-C,rs12140581,-1,G,C,47052288,23691,46879371,47272587,172917
1,ENSG00000244256.1,63655743,1-63699819-A-G,rs12145639,1,A,G,63699819,44076,63459135,63852351,240684
1,ENSG00000227815.1,176272483,1-176165842-C-T,rs12145703,1,C,T,176165842,106641,176075875,176469091,89967
1,ENSG00000227815.1,176272483,1-176165842-C-G,rs12145703,1,C,G,176165842,106641,176075875,176469091,89967
1,ENSG00000228452.1,42776790,1-42679786-A-T,rs12145783,-1,A,T,42679786,97004,42580182,42973398,99604
1,ENSG00000228452.1,42776790,1-42679786-A-G,rs12145783,-1,A,G,42679786,97004,42580182,42973398,99604
1,ENSG00000238198.1,113073113,1-113174848-A-G,rs1216870,-1,A,G,113174848,101735,112876505,113269721,298343
1,ENSG00000238249.1,8893409,1-9086233-G-A,rs12402657,1,G,A,9086233,192824,8696801,9090017,389432
1,ENSG00000238249.1,8893409,1-9086233-G-C,rs12402657,1,G,C,9086233,192824,8696801,9090017,389432
1,ENSG00000218510.3,22024558,1-22167331-C-T,rs12405138,1,C,T,22167331,142773,21827950,22221166,339381
1,ENSG00000242352.2,143766540,1-143716839-T-C,rs12409037,1,T,C,143716839,49701,143569932,143963148,146907
1,ENSG00000232883.1,220317599,1-220485362-C-T,rs12563560,-1,C,T,220485362,167763,220120991,220514207,364371
1,ENSG00000232883.1,220317599,1-220485362-C-A,rs12563560,-1,C,A,220485362,167763,220120991,220514207,364371
1,ENSG00000228126.1,150515757,1-150508095-G-A,rs12724450,1,G,A,150508095,7662,150319149,150712365,188946
1,ENSG00000229757.1,168579439,1-168720364-C-T,rs12733054,-1,C,T,168720364,140925,168382831,168776047,337533
1,ENSG00000236137.1,117059490,1-117049970-A-T,rs12734658,-1,A,T,117049970,9520,116862882,117256098,187088
1,ENSG00000236137.1,117059490,1-117049970-A-C,rs12734658,-1,A,C,117049970,9520,116862882,117256098,187088
1,ENSG00000238005.1,234970062,1-234953983-C-T,rs12754888,-1,C,T,234953983,16079,234773454,235166670,180529
1,ENSG00000238005.1,234970062,1-234953983-C-A,rs12754888,-1,C,A,234953983,16079,234773454,235166670,180529
1,ENSG00000238005.1,234970062,1-234953983-C-G,rs12754888,-1,C,G,234953983,16079,234773454,235166670,180529
1,ENSG00000211454.8,19274194,1-19466068-A-G,rs12755497,-1,A,G,19466068,191874,19077586,19470802,388482
1,ENSG00000211454.8,19274194,1-19466068-A-T,rs12755497,-1,A,T,19466068,191874,19077586,19470802,388482
1,ENSG00000224114.1,206696269,1-206537285-C-G,rs12756098,-1,C,G,206537285,158984,206499661,206892877,37624
1,ENSG00000224114.1,206696269,1-206537285-C-T,rs12756098,-1,C,T,206537285,158984,206499661,206892877,37624
1,ENSG00000227854.1,239052903,1-239092790-A-G,rs13374713,-1,A,G,239092790,39887,238856295,239249511,236495
1,ENSG00000215381.3,23244765,1-23359753-C-G,rs13523,1,C,G,23359753,114988,23048157,23441373,311596
1,ENSG00000215381.3,23244765,1-23359753-C-A,rs13523,1,C,A,23359753,114988,23048157,23441373,311596
1,ENSG00000215381.3,23244765,1-23359753-C-T,rs13523,1,C,T,23359753,114988,23048157,23441373,311596
1,ENSG00000223949.1,64171297,1-64365709-T-C,rs1390484,-1,T,C,64365709,194412,63974689,64367905,391020
1,ENSG00000223949.1,64171297,1-64365709-T-A,rs1390484,-1,T,A,64365709,194412,63974689,64367905,391020
1,ENSG00000223949.1,64171297,1-64365709-T-G,rs1390484,-1,T,G,64365709,194412,63974689,64367905,391020
1,ENSG00000231344.1,27739091,1-27884892-A-G,rs1467465,1,A,G,27884892,145801,27542483,27935699,342409
1,ENSG00000234478.1,226148003,1-226066335-T-G,rs1533114,1,T,G,226066335,81668,225951395,226344611,114940
1,ENSG00000234478.1,226148003,1-226066335-T-C,rs1533114,1,T,C,226066335,81668,225951395,226344611,114940
1,ENSG00000234478.1,226148003,1-226066335-T-A,rs1533114,1,T,A,226066335,81668,225951395,226344611,114940
1,ENSG00000228852.1,95278940,1-95208785-C-A,rs1556742,-1,C,A,95208785,70155,95082332,95475548,126453
1,ENSG00000228852.1,95278940,1-95208785-C-G,rs1556742,-1,C,G,95208785,70155,95082332,95475548,126453
1,ENSG00000236876.2,42500339,1-42442040-C-T,rs16829526,-1,C,T,42442040,58299,42303731,42696947,138309
1,ENSG00000236876.2,42500339,1-42442040-C-A,rs16829526,-1,C,A,42442040,58299,42303731,42696947,138309
1,ENSG00000224308.1,152949210,1-152952844-T-C,rs16834772,-1,T,C,152952844,3634,152752602,153145818,200242
1,ENSG00000235363.1,205351247,1-205347342-C-A,rs16855414,1,C,A,205347342,3905,205154639,205547855,192703
1,ENSG00000235363.1,205351247,1-205347342-C-T,rs16855414,1,C,T,205347342,3905,205154639,205547855,192703
1,ENSG00000237292.1,181174484,1-181288963-C-T,rs16857062,1,C,T,181288963,114479,180977876,181371092,311087
1,ENSG00000223575.1,119085954,1-118931349-A-G,rs17022808,-1,A,G,118931349,154605,118889346,119282562,42003
1,ENSG00000225113.1,109596225,1-109414229-A-T,rs17037726,1,A,T,109414229,181996,109399617,109792833,14612
1,ENSG00000225113.1,109596225,1-109414229-A-C,rs17037726,1,A,C,109414229,181996,109399617,109792833,14612
1,ENSG00000228121.1,58999676,1-58927109-C-G,rs17118414,1,C,G,58927109,72567,58803068,59196284,124041
1,ENSG00000238081.1,89290337,1-89394709-G-C,rs17130801,-1,G,C,89394709,104372,89093729,89486945,300980
1,ENSG00000238081.1,89290337,1-89394709-G-A,rs17130801,-1,G,A,89394709,104372,89093729,89486945,300980
1,ENSG00000243155.1,180976482,1-180936127-C-T,rs17302207,-1,C,T,180936127,40355,180779874,181173090,156253
1,ENSG00000243155.1,180976482,1-180936127-C-G,rs17302207,-1,C,G,180936127,40355,180779874,181173090,156253
1,ENSG00000225265.1,222589928,1-222588786-A-C,rs17464836,1,A,C,222588786,1142,222393320,222786536,195466
1,ENSG00000236723.1,53213472,1-53123080-G-A,rs1769304,-1,G,A,53123080,90392,53016864,53410080,106216
1,ENSG00000180867.9,147178113,1-147085274-T-C,rs1867142,1,T,C,147085274,92839,146981505,147374721,103769
1,ENSG00000180867.9,147178113,1-147085274-T-G,rs1867142,1,T,G,147085274,92839,146981505,147374721,103769
1,ENSG00000227712.1,119327216,1-119312119-G-C,rs1891224,-1,G,C,119312119,15097,119130608,119523824,181511
1,ENSG00000227712.1,119327216,1-119312119-G-A,rs1891224,-1,G,A,119312119,15097,119130608,119523824,181511
1,ENSG00000227712.1,119327216,1-119312119-G-T,rs1891224,-1,G,T,119312119,15097,119130608,119523824,181511
1,ENSG00000229255.1,248485484,1-248681796-C-G,rs2000390,-1,C,G,248681796,196312,248288876,248682092,392920
1,ENSG00000229255.1,248485484,1-248681796-C-T,rs2000390,-1,C,T,248681796,196312,248288876,248682092,392920
1,ENSG00000224521.1,248548756,1-248681796-C-G,rs2000390,1,C,G,248681796,133040,248352148,248745364,329648
1,ENSG00000224521.1,248548756,1-248681796-C-T,rs2000390,1,C,T,248681796,133040,248352148,248745364,329648
1,ENSG00000224407.1,230281893,1-230097043-G-T,rs2057233,-1,G,T,230097043,184850,230085285,230478501,11758
1,ENSG00000224407.1,230281893,1-230097043-G-A,rs2057233,-1,G,A,230097043,184850,230085285,230478501,11758
1,ENSG00000228863.1,160676371,1-160712073-G-C,rs2070931,1,G,C,160712073,35702,160479763,160872979,232310
1,ENSG00000228863.1,160676371,1-160712073-G-T,rs2070931,1,G,T,160712073,35702,160479763,160872979,232310
1,ENSG00000261000.1,206503948,1-206507650-A-C,rs2095124,1,A,C,206507650,3702,206307340,206700556,200310
1,ENSG00000261000.1,206503948,1-206507650-A-T,rs2095124,1,A,T,206507650,3702,206307340,206700556,200310
1,ENSG00000224986.1,48326123,1-48341908-C-T,rs2175862,-1,C,T,48341908,15785,48129515,48522731,212393
1,ENSG00000227217.1,157691762,1-157699203-C-T,rs2210913,1,C,T,157699203,7441,157495154,157888370,204049
1,ENSG00000231700.2,157709086,1-157699203-C-T,rs2210913,1,C,T,157699203,9883,157512478,157905694,186725
1,ENSG00000227591.1,209724125,1-209625860-A-G,rs2229465,-1,A,G,209625860,98265,209527517,209920733,98343
1,ENSG00000214796.4,202859099,1-202812036-G-A,rs2246083,-1,G,A,202812036,47063,202662491,203055707,149545
1,ENSG00000214796.4,202859099,1-202812036-G-T,rs2246083,-1,G,T,202812036,47063,202662491,203055707,149545
1,ENSG00000223776.4,236524508,1-236556839-T-A,rs2250966,-1,T,A,236556839,32331,236327900,236721116,228939
1,ENSG00000223776.4,236524508,1-236556839-T-C,rs2250966,-1,T,C,236556839,32331,236327900,236721116,228939
1,ENSG00000215833.2,168451211,1-168399780-T-G,rs2268545,-1,T,G,168399780,51431,168254603,168647819,145177
1,ENSG00000215833.2,168451211,1-168399780-T-C,rs2268545,-1,T,C,168399780,51431,168254603,168647819,145177
1,ENSG00000215833.2,168451211,1-168399780-T-A,rs2268545,-1,T,A,168399780,51431,168254603,168647819,145177
1,ENSG00000241720.1,109725820,1-109751955-A-G,rs2274536,1,A,G,109751955,26135,109529212,109922428,222743
1,ENSG00000224520.1,157073257,1-157187061-T-C,rs2275447,1,T,C,157187061,113804,156876649,157269865,310412
1,ENSG00000198711.4,54236440,1-54224364-C-T,rs2282332,1,C,T,54224364,12076,54039832,54433048,184532
1,ENSG00000259943.1,40257971,1-40274534-A-G,rs2284446,-1,A,G,40274534,16563,40061363,40454579,213171
1,ENSG00000259943.1,40257971,1-40274534-A-T,rs2284446,-1,A,T,40274534,16563,40061363,40454579,213171
1,ENSG00000181101.7,175045648,1-175162943-T-C,rs2285218,-1,T,C,175162943,117295,174849040,175242256,313903
1,ENSG00000225077.2,6234692,1-6197796-G-A,rs2294713,1,G,A,6197796,36896,6038084,6431300,159712
1,ENSG00000225077.2,6234692,1-6197796-G-T,rs2294713,1,G,T,6197796,36896,6038084,6431300,159712
1,ENSG00000230325.1,236550280,1-236546688-A-G,rs2298098,-1,A,G,236546688,3592,236353672,236746888,193016
1,ENSG00000260948.1,111433068,1-111449894-C-T,rs2298188,-1,C,T,111449894,16826,111236460,111629676,213434
1,ENSG00000261798.1,39788976,1-39801680-T-A,rs230301,1,T,A,39801680,12704,39592368,39985584,209312
1,ENSG00000261798.1,39788976,1-39801680-T-C,rs230301,1,T,C,39801680,12704,39592368,39985584,209312
1,ENSG00000223653.1,85277672,1-85306326-G-A,rs233100,1,G,A,85306326,28654,85081064,85474280,225262
1,ENSG00000223653.1,85277672,1-85306326-G-C,rs233100,1,G,C,85306326,28654,85081064,85474280,225262
1,ENSG00000223653.1,85277672,1-85306326-G-T,rs233100,1,G,T,85306326,28654,85081064,85474280,225262
1,ENSG00000232093.1,155046118,1-154870871-C-T,rs2335407,-1,C,T,154870871,175247,154849510,155242726,21361
1,ENSG00000232093.1,155046118,1-154870871-C-A,rs2335407,-1,C,A,154870871,175247,154849510,155242726,21361
1,ENSG00000228140.1,15409433,1-15401793-T-C,rs2473344,-1,T,C,15401793,7640,15212825,15606041,188968
1,ENSG00000228196.1,178747754,1-178717112-A-G,rs2811280,-1,A,G,178717112,30642,178551146,178944362,165966
1,ENSG00000234383.1,68163090,1-68136109-G-A,rs2820487,-1,G,A,68136109,26981,67966482,68359698,169627
1,ENSG00000177757.1,817371,1-969248-G-A,rs28562326,1,G,A,969248,151877,620763,1013979,348485
1,ENSG00000177757.1,817371,1-969248-G-T,rs28562326,1,G,T,969248,151877,620763,1013979,348485
1,ENSG00000236035.1,203657760,1-203518547-A-G,rs28579051,-1,A,G,203518547,139213,203461152,203854368,57395
1,ENSG00000236035.1,203657760,1-203518547-A-C,rs28579051,-1,A,C,203518547,139213,203461152,203854368,57395
1,ENSG00000228794.2,827598,1-1024129-T-G,rs28591569,1,T,G,1024129,196531,630990,1024206,393139
1,ENSG00000223390.1,52033391,1-51887777-A-T,rs3001778,1,A,T,51887777,145614,51836783,52229999,50994
1,ENSG00000223390.1,52033391,1-51887777-A-G,rs3001778,1,A,G,51887777,145614,51836783,52229999,50994
1,ENSG00000223390.1,52033391,1-51887777-A-C,rs3001778,1,A,C,51887777,145614,51836783,52229999,50994
1,ENSG00000234264.1,68496676,1-68405059-C-G,rs3118391,1,C,G,68405059,91617,68300068,68693284,104991
1,ENSG00000234264.1,68496676,1-68405059-C-T,rs3118391,1,C,T,68405059,91617,68300068,68693284,104991
1,ENSG00000234264.1,68496676,1-68405059-C-A,rs3118391,1,C,A,68405059,91617,68300068,68693284,104991
1,ENSG00000213478.2,51158471,1-51201660-C-T,rs35831872,-1,C,T,51201660,43189,50961863,51355079,239797
1,ENSG00000237352.1,58933643,1-58754458-G-A,rs36061347,1,G,A,58754458,179185,58737035,59130251,17423
1,ENSG00000260179.1,1251334,1-1086035-A-G,rs3737728,-1,A,G,1086035,165299,1054726,1447942,31309
1,ENSG00000260179.1,1251334,1-1086035-A-T,rs3737728,-1,A,T,1086035,165299,1054726,1447942,31309
1,ENSG00000260179.1,1251334,1-1086035-A-C,rs3737728,-1,A,C,1086035,165299,1054726,1447942,31309
1,ENSG00000228217.1,117778506,1-117864416-G-A,rs3738419,-1,G,A,117864416,85910,117581898,117975114,282518
1,ENSG00000227533.1,42959078,1-42974530-C-G,rs3738516,1,C,G,42974530,15452,42762470,43155686,212060
1,ENSG00000227533.1,42959078,1-42974530-C-A,rs3738516,1,C,A,42974530,15452,42762470,43155686,212060
1,ENSG00000237301.1,15603626,1-15482377-G-A,rs3766160,-1,G,A,15482377,121249,15407018,15800234,75359
1,ENSG00000236782.1,26171832,1-26158522-T-C,rs3806382,-1,T,C,26158522,13310,25975224,26368440,183298
1,ENSG00000236782.1,26171832,1-26158522-T-G,rs3806382,-1,T,G,26158522,13310,25975224,26368440,183298
1,ENSG00000236782.1,26171832,1-26158522-T-A,rs3806382,-1,T,A,26158522,13310,25975224,26368440,183298
1,ENSG00000235308.1,88923370,1-88962424-A-T,rs3820242,1,A,T,88962424,39054,88726762,89119978,235662
1,ENSG00000235308.1,88923370,1-88962424-A-C,rs3820242,1,A,C,88962424,39054,88726762,89119978,235662
1,ENSG00000235308.1,88923370,1-88962424-A-G,rs3820242,1,A,G,88962424,39054,88726762,89119978,235662
1,ENSG00000226970.2,84244334,1-84065434-C-T,rs3861699,1,C,T,84065434,178900,84047726,84440942,17708
1,ENSG00000259357.1,150965249,1-151060221-G-T,rs41266624,1,G,T,151060221,94972,150768641,151161857,291580
1,ENSG00000227953.2,246776013,1-246789499-G-A,rs4472790,1,G,A,246789499,13486,246579405,246972621,210094
1,ENSG00000227953.2,246776013,1-246789499-G-T,rs4472790,1,G,T,246789499,13486,246579405,246972621,210094
1,ENSG00000227953.2,246776013,1-246789499-G-C,rs4472790,1,G,C,246789499,13486,246579405,246972621,210094
1,ENSG00000183298.4,101787219,1-101874669-A-G,rs4483430,-1,A,G,101874669,87450,101590611,101983827,284058
1,ENSG00000183298.4,101787219,1-101874669-A-C,rs4483430,-1,A,C,101874669,87450,101590611,101983827,284058
1,ENSG00000260088.1,200669507,1-200588639-C-A,rs4504918,1,C,A,200588639,80868,200472899,200866115,115740
1,ENSG00000260088.1,200669507,1-200588639-C-G,rs4504918,1,C,G,200588639,80868,200472899,200866115,115740
1,ENSG00000260088.1,200669507,1-200588639-C-T,rs4504918,1,C,T,200588639,80868,200472899,200866115,115740
1,ENSG00000233791.1,203305309,1-203289557-G-C,rs4615902,-1,G,C,203289557,15752,203108701,203501917,180856
1,ENSG00000234329.1,45651826,1-45470679-G-A,rs4660858,-1,G,A,45470679,181147,45455218,45848434,15461
1,ENSG00000226029.1,16460948,1-16409637-T-C,rs4661746,1,T,C,16409637,51311,16264340,16657556,145297
1,ENSG00000228086.1,100485997,1-100414469-G-A,rs473072,-1,G,A,100414469,71528,100289389,100682605,125080
1,ENSG00000234419.1,222468094,1-222386797-A-G,rs4846748,1,A,G,222386797,81297,222271486,222664702,115311
1,ENSG00000236266.1,7827342,1-7655716-T-G,rs4908665,-1,T,G,7655716,171626,7630734,8023950,24982
1,ENSG00000236266.1,7827342,1-7655716-T-C,rs4908665,-1,T,C,7655716,171626,7630734,8023950,24982
1,ENSG00000236266.1,7827342,1-7655716-T-A,rs4908665,-1,T,A,7655716,171626,7630734,8023950,24982
1,ENSG00000234546.1,9182004,1-9206568-G-A,rs4908826,1,G,A,9206568,24564,8985396,9378612,221172
1,ENSG00000234546.1,9182004,1-9206568-G-C,rs4908826,1,G,C,9206568,24564,8985396,9378612,221172
1,ENSG00000259818.1,53220663,1-53385828-T-A,rs4926990,1,T,A,53385828,165165,53024055,53417271,361773
1,ENSG00000259818.1,53220663,1-53385828-T-C,rs4926990,1,T,C,53385828,165165,53024055,53417271,361773
1,ENSG00000241318.2,91535593,1-91502825-T-A,rs494244,-1,T,A,91502825,32768,91338985,91732201,163840
1,ENSG00000241318.2,91535593,1-91502825-T-G,rs494244,-1,T,G,91502825,32768,91338985,91732201,163840
1,ENSG00000241318.2,91535593,1-91502825-T-C,rs494244,-1,T,C,91502825,32768,91338985,91732201,163840
1,ENSG00000198468.2,212858125,1-212706302-C-A,rs4951458,-1,C,A,212706302,151823,212661517,213054733,44785
1,ENSG00000198468.2,212858125,1-212706302-C-T,rs4951458,-1,C,T,212706302,151823,212661517,213054733,44785
1,ENSG00000198468.2,212858125,1-212706302-C-G,rs4951458,-1,C,G,212706302,151823,212661517,213054733,44785
1,ENSG00000237491.2,778747,1-905373-T-A,rs4970382,1,T,A,905373,126626,582139,975355,323234
1,ENSG00000237491.2,778747,1-905373-T-C,rs4970382,1,T,C,905373,126626,582139,975355,323234
1,ENSG00000239494.1,169859756,1-169689445-A-T,rs4987388,1,A,T,169689445,170311,169663148,170056364,26297
1,ENSG00000239494.1,169859756,1-169689445-A-G,rs4987388,1,A,G,169689445,170311,169663148,170056364,26297
1,ENSG00000239494.1,169859756,1-169689445-A-C,rs4987388,1,A,C,169689445,170311,169663148,170056364,26297
1,ENSG00000238142.1,16889672,1-17000045-G-A,rs56290406,-1,G,A,17000045,110373,16693064,17086280,306981
1,ENSG00000228044.2,234656052,1-234497877-C-T,rs57078448,1,C,T,234497877,158175,234459444,234852660,38433
1,ENSG00000228044.2,234656052,1-234497877-C-A,rs57078448,1,C,A,234497877,158175,234459444,234852660,38433
1,ENSG00000230628.1,234696153,1-234703958-T-G,rs599129,-1,T,G,234703958,7805,234499545,234892761,204413
1,ENSG00000230628.1,234696153,1-234703958-T-C,rs599129,-1,T,C,234703958,7805,234499545,234892761,204413
1,ENSG00000231434.1,158523672,1-158356101-T-C,rs61734679,1,T,C,158356101,167571,158327064,158720280,29037
1,ENSG00000237276.3,16228027,1-16154871-C-T,rs61769950,-1,C,T,16154871,73156,16031419,16424635,123452
1,ENSG00000237276.3,16228027,1-16154871-C-G,rs61769950,-1,C,G,16154871,73156,16031419,16424635,123452
1,ENSG00000236546.1,39897745,1-39717570-G-C,rs61779765,1,G,C,39717570,180175,39701137,40094353,16433
1,ENSG00000236546.1,39897745,1-39717570-G-A,rs61779765,1,G,A,39717570,180175,39701137,40094353,16433
1,ENSG00000197989.8,28582986,1-28392819-A-G,rs61783808,-1,A,G,28392819,190167,28386378,28779594,6441
1,ENSG00000223989.1,9848318,1-9811167-G-A,rs61785191,1,G,A,9811167,37151,9651710,10044926,159457
1,ENSG00000243323.1,202168051,1-202174507-G-T,rs61823694,1,G,T,202174507,6456,201971443,202364659,203064
1,ENSG00000226986.2,211207239,1-211183493-T-C,rs61848649,1,T,C,211183493,23746,211010631,211403847,172862
1,ENSG00000232908.2,247827486,1-247878845-A-T,rs61855716,1,A,T,247878845,51359,247630878,248024094,247967
1,ENSG00000232908.2,247827486,1-247878845-A-G,rs61855716,1,A,G,247878845,51359,247630878,248024094,247967
1,ENSG00000234996.2,202873294,1-202891611-G-A,rs6427976,1,G,A,202891611,18317,202676686,203069902,214925
1,ENSG00000234996.2,202873294,1-202891611-G-T,rs6427976,1,G,T,202891611,18317,202676686,203069902,214925
1,ENSG00000217801.4,1063079,1-1022260-C-T,rs6657048,1,C,T,1022260,40819,866471,1259687,155789
1,ENSG00000203739.3,173489407,1-173469260-C-A,rs6660804,-1,C,A,173469260,20147,173292799,173686015,176461
1,ENSG00000224358.1,165768929,1-165842492-C-T,rs6677965,1,C,T,165842492,73563,165572321,165965537,270171
1,ENSG00000223861.1,151557446,1-151384857-T-C,rs6684085,1,T,C,151384857,172589,151360838,151754054,24019
1,ENSG00000223861.1,151557446,1-151384857-T-A,rs6684085,1,T,A,151384857,172589,151360838,151754054,24019
1,ENSG00000259865.1,247188526,1-247230353-T-C,rs6693807,-1,T,C,247230353,41827,246991918,247385134,238435
1,ENSG00000227934.1,231021611,1-231062282-C-T,rs6696857,1,C,T,231062282,40671,230825003,231218219,237279
1,ENSG00000227934.1,231021611,1-231062282-C-G,rs6696857,1,C,G,231062282,40671,230825003,231218219,237279
1,ENSG00000227934.1,231021611,1-231062282-C-A,rs6696857,1,C,A,231062282,40671,230825003,231218219,237279
1,ENSG00000231767.2,192716183,1-192628742-C-A,rs6698245,1,C,A,192628742,87441,192519575,192912791,109167
1,ENSG00000135747.7,247078736,1-247035979-C-T,rs6698643,-1,C,T,247035979,42757,246882128,247275344,153851
1,ENSG00000225712.1,209268223,1-209345701-A-G,rs6700119,-1,A,G,209345701,77478,209071615,209464831,274086
1,ENSG00000197880.4,23581495,1-23443489-G-T,rs6701079,1,G,T,23443489,138006,23384887,23778103,58602
1,ENSG00000235101.1,160670148,1-160653304-G-A,rs68035082,1,G,A,160653304,16844,160473540,160866756,179764
1,ENSG00000228665.1,109030067,1-109144345-C-T,rs72701021,1,C,T,109144345,114278,108833459,109226675,310886
1,ENSG00000185495.6,223995895,1-223871789-T-C,rs72749597,1,T,C,223871789,124106,223799287,224192503,72502
1,ENSG00000231663.1,234373664,1-234520957-G-A,rs72767206,-1,G,A,234520957,147293,234177056,234570272,343901
1,ENSG00000260920.1,40464319,1-40465331-A-G,rs736861,1,A,G,40465331,1012,40267711,40660927,197620
1,ENSG00000215914.3,1699942,1-1753033-C-G,rs7407,1,C,G,1753033,53091,1503334,1896550,249699
1,ENSG00000215914.3,1699942,1-1753033-C-T,rs7407,1,C,T,1753033,53091,1503334,1896550,249699
1,ENSG00000230699.2,911435,1-1053522-C-T,rs74223856,1,C,T,1053522,142087,714827,1108043,338695
1,ENSG00000230699.2,911435,1-1053522-C-A,rs74223856,1,C,A,1053522,142087,714827,1108043,338695
1,ENSG00000215895.3,38708931,1-38748395-C-T,rs75066253,1,C,T,38748395,39464,38512323,38905539,236072
1,ENSG00000238186.1,40517174,1-40500511-C-A,rs7512061,-1,C,A,40500511,16663,40320566,40713782,179945
1,ENSG00000238186.1,40517174,1-40500511-C-T,rs7512061,-1,C,T,40500511,16663,40320566,40713782,179945
1,ENSG00000219133.2,204347258,1-204483119-C-A,rs7518788,-1,C,A,204483119,135861,204150650,204543866,332469
1,ENSG00000219133.2,204347258,1-204483119-C-T,rs7518788,-1,C,T,204483119,135861,204150650,204543866,332469
1,ENSG00000203288.3,151790824,1-151803929-A-C,rs7534811,1,A,C,151803929,13105,151594216,151987432,209713
1,ENSG00000231671.1,101323837,1-101368199-A-T,rs7538660,1,A,T,101368199,44362,101127229,101520445,240970
1,ENSG00000225217.1,161606291,1-161542941-G-A,rs7539036,1,G,A,161542941,63350,161409683,161802899,133258
1,ENSG00000173810.8,101271363,1-101282606-A-G,rs7550774,-1,A,G,101282606,11243,101074755,101467971,207851
1,ENSG00000173810.8,101271363,1-101282606-A-T,rs7550774,-1,A,T,101282606,11243,101074755,101467971,207851
1,ENSG00000173810.8,101271363,1-101282606-A-C,rs7550774,-1,A,C,101282606,11243,101074755,101467971,207851
1,ENSG00000228060.1,39565052,1-39463568-T-C,rs7554206,1,T,C,39463568,101484,39368444,39761660,95124
1,ENSG00000228060.1,39565052,1-39463568-T-A,rs7554206,1,T,A,39463568,101484,39368444,39761660,95124
1,ENSG00000232134.1,220144351,1-220325042-C-T,rs75902550,-1,C,T,220325042,180691,219947743,220340959,377299
1,ENSG00000228192.2,42846414,1-43001414-T-C,rs76794017,-1,T,C,43001414,155000,42649806,43043022,351608
1,ENSG00000261654.1,110942353,1-110851497-C-T,rs76929317,-1,C,T,110851497,90856,110745745,111138961,105752
1,ENSG00000226167.1,113856635,1-114003357-A-G,rs77637424,1,A,G,114003357,146722,113660027,114053243,343330
1,ENSG00000224609.1,59296491,1-59267916-G-A,rs78373455,-1,G,A,59267916,28575,59099883,59493099,168033
1,ENSG00000227671.2,247209493,1-247197236-A-G,rs78663796,-1,A,G,247197236,12257,247012885,247406101,184351
1,ENSG00000227056.1,119220096,1-119291050-C-G,rs79709077,-1,C,G,119291050,70954,119023488,119416704,267562
1,ENSG00000232185.1,115564601,1-115621184-C-T,rs80143118,1,C,T,115621184,56583,115367993,115761209,253191
1,ENSG00000238015.1,78666272,1-78747309-C-T,rs80309829,1,C,T,78747309,81037,78469664,78862880,277645
1,ENSG00000238015.1,78666272,1-78747309-C-G,rs80309829,1,C,G,78747309,81037,78469664,78862880,277645
1,ENSG00000227207.1,72301472,1-72490354-C-T,rs812462,1,C,T,72490354,188882,72104864,72498080,385490
1,ENSG00000232751.1,173351689,1-173240951-A-G,rs844645,1,A,G,173240951,110738,173155081,173548297,85870
1,ENSG00000203865.4,116418607,1-116364217-G-T,rs850617,-1,G,T,116364217,54390,116221999,116615215,142218
1,ENSG00000203865.4,116418607,1-116364217-G-A,rs850617,-1,G,A,116364217,54390,116221999,116615215,142218
1,ENSG00000227001.2,21427967,1-21489167-C-T,rs904927,-1,C,T,21489167,61200,21231359,21624575,257808
1,ENSG00000236905.1,212824027,1-212685455-T-C,rs906363,1,T,C,212685455,138572,212627419,213020635,58036
1,ENSG00000187952.7,21428303,1-21606852-G-A,rs922899,1,G,A,21606852,178549,21231695,21624911,375157
1,ENSG00000177788.5,229271145,1-229326135-A-C,rs9435840,-1,A,C,229326135,54990,229074537,229467753,251598
1,ENSG00000238287.1,40508661,1-40552283-G-A,rs945745,-1,G,A,40552283,43622,40312053,40705269,240230
1,ENSG00000238287.1,40508661,1-40552283-G-C,rs945745,-1,G,C,40552283,43622,40312053,40705269,240230
1,ENSG00000227278.1,40515057,1-40552283-G-A,rs945745,-1,G,A,40552283,37226,40318449,40711665,233834
1,ENSG00000227278.1,40515057,1-40552283-G-C,rs945745,-1,G,C,40552283,37226,40318449,40711665,233834
1,ENSG00000231050.1,1891223,1-1866508-A-G,rs9660106,1,A,G,1866508,24715,1694615,2087831,171893
