Chromosome,GENE,Transcription start site (TSS),Variant,rsID,Strand,REF,ALT,PHYSICAL,distance_from_TSS,enformer_start,enformer_end,variant_pos_in_window
22,ENSG00000099974.7,23966888,22-23971817-G-T,rs1006771,1,G,T,23971817,4929,23770280,24163496,201537
22,ENSG00000159496.9,23691013,22-23696660-T-A,rs1007298,1,T,A,23696660,5647,23494405,23887621,202255
22,ENSG00000159496.9,23691013,22-23696660-T-C,rs1007298,1,T,C,23696660,5647,23494405,23887621,202255
22,ENSG00000099937.6,20774113,22-20707880-C-T,rs1058552,1,C,T,20707880,66233,20577505,20970721,130375
22,ENSG00000244486.2,20437825,22-20552080-G-A,rs1075339,-1,G,A,20552080,114255,20241217,20634433,310863
22,ENSG00000250479.3,23767972,22-23754596-T-C,rs1076123,-1,T,C,23754596,13376,23571364,23964580,183232
22,ENSG00000184164.10,49918634,22-49926381-G-T,rs10854860,1,G,T,49926381,7747,49722026,50115242,204355
22,ENSG00000184164.10,49918634,22-49926381-G-A,rs10854860,1,G,A,49926381,7747,49722026,50115242,204355
22,ENSG00000215012.4,19854874,22-19841917-G-A,rs11089314,-1,G,A,19841917,12957,19658266,20051482,183651
22,ENSG00000215012.4,19854874,22-19841917-G-C,rs11089314,-1,G,C,19841917,12957,19658266,20051482,183651
22,ENSG00000100209.5,28742039,22-28608582-G-A,rs111623460,1,G,A,28608582,133457,28545431,28938647,63151
22,ENSG00000100209.5,28742039,22-28608582-G-T,rs111623460,1,G,T,28608582,133457,28545431,28938647,63151
22,ENSG00000100209.5,28742039,22-28608582-G-C,rs111623460,1,G,C,28608582,133457,28545431,28938647,63151
22,ENSG00000100288.15,50582849,22-50410214-G-T,rs112430043,-1,G,T,50410214,172635,50386241,50779457,23973
22,ENSG00000100379.13,37051742,22-36881659-G-A,rs113133371,1,G,A,36881659,170083,36855134,37248350,26525
22,ENSG00000183762.8,29073035,22-29107146-A-G,rs114239625,1,A,G,29107146,34111,28876427,29269643,230719
22,ENSG00000187792.3,23751112,22-23579651-G-A,rs115163180,-1,G,A,23579651,171461,23554504,23947720,25147
22,ENSG00000100281.9,35257493,22-35447806-C-T,rs116859443,1,C,T,35447806,190313,35060885,35454101,386921
22,ENSG00000175329.7,35066158,22-35143904-G-A,rs11703514,1,G,A,35143904,77746,34869550,35262766,274354
22,ENSG00000100324.8,39399780,22-39372075-G-T,rs11704158,1,G,T,39372075,27705,39203172,39596388,168903
22,ENSG00000128283.6,37560480,22-37416456-C-T,rs11705648,1,C,T,37416456,144024,37363872,37757088,52584
22,ENSG00000099957.11,21015165,22-21044065-C-T,rs117468585,1,C,T,21044065,28900,20818557,21211773,225508
22,ENSG00000099957.11,21015165,22-21044065-C-G,rs117468585,1,C,G,21044065,28900,20818557,21211773,225508
22,ENSG00000100298.11,39097244,22-39122372-A-G,rs117620225,1,A,G,39122372,25128,38900636,39293852,221736
22,ENSG00000075218.13,46296870,22-46186175-T-C,rs118147297,1,T,C,46186175,110695,46100262,46493478,85913
22,ENSG00000235568.2,42432403,22-42469005-C-A,rs11912326,-1,C,A,42469005,36602,42235795,42629011,233210
22,ENSG00000177989.8,50532498,22-50523779-T-A,rs12148,-1,T,A,50523779,8719,50335890,50729106,187889
22,ENSG00000177989.8,50532498,22-50523779-T-C,rs12148,-1,T,C,50523779,8719,50335890,50729106,187889
22,ENSG00000177989.8,50532498,22-50523779-T-G,rs12148,-1,T,G,50523779,8719,50335890,50729106,187889
22,ENSG00000073150.8,50170731,22-50099472-C-T,rs12169319,1,C,T,50099472,71259,49974123,50367339,125349
22,ENSG00000099954.13,17369460,22-17425883-A-T,rs12628073,1,A,T,17425883,56423,17172852,17566068,253031
22,ENSG00000128383.8,38957609,22-38962032-A-G,rs12628403,1,A,G,38962032,4423,38761001,39154217,201031
22,ENSG00000128383.8,38957609,22-38962032-A-C,rs12628403,1,A,C,38962032,4423,38761001,39154217,201031
22,ENSG00000179750.11,38982347,22-38962032-A-G,rs12628403,1,A,G,38962032,20315,38785739,39178955,176293
22,ENSG00000179750.11,38982347,22-38962032-A-C,rs12628403,1,A,C,38962032,20315,38785739,39178955,176293
22,ENSG00000128394.12,39040864,22-38962032-A-G,rs12628403,1,A,G,38962032,78832,38844256,39237472,117776
22,ENSG00000128394.12,39040864,22-38962032-A-C,rs12628403,1,A,C,38962032,78832,38844256,39237472,117776
22,ENSG00000198832.6,31107568,22-31107574-C-T,rs13053829,-1,C,T,31107574,6,30910960,31304176,196614
22,ENSG00000073169.9,50201011,22-50182839-A-C,rs13053855,1,A,C,50182839,18172,50004403,50397619,178436
22,ENSG00000073169.9,50201011,22-50182839-A-G,rs13053855,1,A,G,50182839,18172,50004403,50397619,178436
22,ENSG00000167065.9,30667875,22-30703940-C-G,rs13053993,-1,C,G,30703940,36065,30471267,30864483,232673
22,ENSG00000167065.9,30667875,22-30703940-C-T,rs13053993,-1,C,T,30703940,36065,30471267,30864483,232673
22,ENSG00000130487.4,50545899,22-50549764-A-C,rs131779,1,A,C,50549764,3865,50349291,50742507,200473
22,ENSG00000130487.4,50545899,22-50549764-A-G,rs131779,1,A,G,50549764,3865,50349291,50742507,200473
22,ENSG00000130487.4,50545899,22-50549764-A-T,rs131779,1,A,T,50549764,3865,50349291,50742507,200473
22,ENSG00000025708.8,50530012,22-50525111-G-A,rs131807,-1,G,A,50525111,4901,50333404,50726620,191707
22,ENSG00000025708.8,50530012,22-50525111-G-C,rs131807,-1,G,C,50525111,4901,50333404,50726620,191707
22,ENSG00000025708.8,50530012,22-50525111-G-T,rs131807,-1,G,T,50525111,4901,50333404,50726620,191707
22,ENSG00000198951.6,42070812,22-42020052-A-G,rs133335,-1,A,G,42020052,50760,41874204,42267420,145848
22,ENSG00000198951.6,42070812,22-42020052-A-T,rs133335,-1,A,T,42020052,50760,41874204,42267420,145848
22,ENSG00000198951.6,42070812,22-42020052-A-C,rs133335,-1,A,C,42020052,50760,41874204,42267420,145848
22,ENSG00000183172.6,42079700,22-42067810-C-T,rs133369,1,C,T,42067810,11890,41883092,42276308,184718
22,ENSG00000183172.6,42079700,22-42067810-C-A,rs133369,1,C,A,42067810,11890,41883092,42276308,184718
22,ENSG00000183172.6,42079700,22-42067810-C-G,rs133369,1,C,G,42067810,11890,41883092,42276308,184718
22,ENSG00000188636.3,44498233,22-44446255-G-T,rs133796,-1,G,T,44446255,51978,44301625,44694841,144630
22,ENSG00000188636.3,44498233,22-44446255-G-C,rs133796,-1,G,C,44446255,51978,44301625,44694841,144630
22,ENSG00000188636.3,44498233,22-44446255-G-A,rs133796,-1,G,A,44446255,51978,44301625,44694841,144630
22,ENSG00000213923.5,38317433,22-38260679-A-G,rs135710,-1,A,G,38260679,56754,38120825,38514041,139854
22,ENSG00000183569.12,42553956,22-42585161-G-C,rs137086,1,G,C,42585161,31205,42357348,42750564,227813
22,ENSG00000183569.12,42553956,22-42585161-G-A,rs137086,1,G,A,42585161,31205,42357348,42750564,227813
22,ENSG00000172404.4,40862113,22-40876139-T-C,rs138354,-1,T,C,40876139,14026,40665505,41058721,210634
22,ENSG00000100304.10,43187134,22-43188275-T-G,rs138958,-1,T,G,43188275,1141,42990526,43383742,197749
22,ENSG00000138964.10,44180925,22-44170346-C-A,rs139099,1,C,A,44170346,10579,43984317,44377533,186029
22,ENSG00000239713.3,39077275,22-39111882-A-G,rs139347,1,A,G,39111882,34607,38880667,39273883,231215
22,ENSG00000239713.3,39077275,22-39111882-A-T,rs139347,1,A,T,39111882,34607,38880667,39273883,231215
22,ENSG00000100372.10,40819346,22-40844831-G-A,rs1573745,-1,G,A,40844831,25485,40622738,41015954,222093
22,ENSG00000183597.11,20021110,22-19969500-C-T,rs165728,1,C,T,19969500,51610,19824502,20217718,144998
22,ENSG00000183597.11,20021110,22-19969500-C-A,rs165728,1,C,A,19969500,51610,19824502,20217718,144998
22,ENSG00000183597.11,20021110,22-19969500-C-G,rs165728,1,C,G,19969500,51610,19824502,20217718,144998
22,ENSG00000183765.14,28741820,22-28599706-A-G,rs16986544,-1,A,G,28599706,142114,28545212,28938428,54494
22,ENSG00000100284.13,35299894,22-35325857-A-T,rs16995584,1,A,T,35325857,25963,35103286,35496502,222571
22,ENSG00000128298.11,38110684,22-38268439-T-G,rs16998865,-1,T,G,38268439,157755,37914076,38307292,354363
22,ENSG00000128298.11,38110684,22-38268439-T-C,rs16998865,-1,T,C,38268439,157755,37914076,38307292,354363
22,ENSG00000100221.6,38700943,22-38586026-C-A,rs16999109,-1,C,A,38586026,114917,38504335,38897551,81691
22,ENSG00000100226.11,38705944,22-38638781-C-T,rs16999173,1,C,T,38638781,67163,38509336,38902552,129445
22,ENSG00000239900.4,40346500,22-40363304-A-G,rs17001863,1,A,G,40363304,16804,40149892,40543108,213412
22,ENSG00000167074.9,41381942,22-41517840-A-G,rs17367716,1,A,G,41517840,135898,41185334,41578550,332506
22,ENSG00000100147.8,41800679,22-41756984-A-C,rs17377643,1,A,C,41756984,43695,41604071,41997287,152913
22,ENSG00000180957.12,27919256,22-27888497-T-C,rs17480369,-1,T,C,27888497,30759,27722648,28115864,165849
22,ENSG00000186654.15,44702204,22-44791799-G-A,rs17532423,1,G,A,44791799,89595,44505596,44898812,286203
22,ENSG00000186654.15,44702204,22-44791799-G-T,rs17532423,1,G,T,44791799,89595,44505596,44898812,286203
22,ENSG00000100124.7,37844334,22-37886890-C-T,rs17752670,-1,C,T,37886890,42556,37647726,38040942,239164
22,ENSG00000099949.13,20982297,22-20997892-T-C,rs178296,1,T,C,20997892,15595,20785689,21178905,212203
22,ENSG00000099949.13,20982297,22-20997892-T-A,rs178296,1,T,A,20997892,15595,20785689,21178905,212203
22,ENSG00000100151.11,38057404,22-38077805-T-G,rs2012867,1,T,G,38077805,20401,37860796,38254012,217009
22,ENSG00000100151.11,38057404,22-38077805-T-A,rs2012867,1,T,A,38077805,20401,37860796,38254012,217009
22,ENSG00000100321.10,39349991,22-39351775-G-C,rs2069235,1,G,C,39351775,1784,39153383,39546599,198392
22,ENSG00000100321.10,39349991,22-39351775-G-T,rs2069235,1,G,T,39351775,1784,39153383,39546599,198392
22,ENSG00000100321.10,39349991,22-39351775-G-A,rs2069235,1,G,A,39351775,1784,39153383,39546599,198392
22,ENSG00000128218.7,23754425,22-23754487-A-C,rs2070454,-1,A,C,23754487,62,23557817,23951033,196670
22,ENSG00000185022.7,38201994,22-38121398-T-C,rs2076116,1,T,C,38121398,80596,38005386,38398602,116012
22,ENSG00000093000.13,45163925,22-45188017-A-C,rs226515,1,A,C,45188017,24092,44967317,45360533,220700
22,ENSG00000093000.13,45163925,22-45188017-A-T,rs226515,1,A,T,45188017,24092,44967317,45360533,220700
22,ENSG00000093000.13,45163925,22-45188017-A-G,rs226515,1,A,G,45188017,24092,44967317,45360533,220700
22,ENSG00000099956.12,23786966,22-23775729-A-G,rs2267029,1,A,G,23775729,11237,23590358,23983574,185371
22,ENSG00000099956.12,23786966,22-23775729-A-T,rs2267029,1,A,T,23775729,11237,23590358,23983574,185371
22,ENSG00000185339.4,30607174,22-30615570-T-G,rs2267163,1,T,G,30615570,8396,30410566,30803782,205004
22,ENSG00000185339.4,30607174,22-30615570-T-C,rs2267163,1,T,C,30615570,8396,30410566,30803782,205004
22,ENSG00000100345.14,36387967,22-36580463-G-T,rs2267340,-1,G,T,36580463,192496,36191359,36584575,389104
22,ENSG00000159958.3,41926806,22-41905010-A-G,rs2269662,-1,A,G,41905010,21796,41730198,42123414,174812
22,ENSG00000077935.12,45413599,22-45413743-C-T,rs2272804,-1,C,T,45413743,144,45216991,45610207,196752
22,ENSG00000077935.12,45413599,22-45413743-C-G,rs2272804,-1,C,G,45413743,144,45216991,45610207,196752
22,ENSG00000077935.12,45413599,22-45413743-C-A,rs2272804,-1,C,A,45413743,144,45216991,45610207,196752
22,ENSG00000128408.7,45413693,22-45413743-C-T,rs2272804,1,C,T,45413743,50,45217085,45610301,196658
22,ENSG00000128408.7,45413693,22-45413743-C-G,rs2272804,1,C,G,45413743,50,45217085,45610301,196658
22,ENSG00000128408.7,45413693,22-45413743-C-A,rs2272804,1,C,A,45413743,50,45217085,45610301,196658
22,ENSG00000100427.11,50085426,22-50144197-A-C,rs2272837,-1,A,C,50144197,58771,49888818,50282034,255379
22,ENSG00000100427.11,50085426,22-50144197-A-G,rs2272837,-1,A,G,50144197,58771,49888818,50282034,255379
22,ENSG00000100225.13,32474811,22-32326976-C-G,rs2281032,1,C,G,32326976,147835,32278203,32671419,48773
22,ENSG00000100225.13,32474811,22-32326976-C-A,rs2281032,1,C,A,32326976,147835,32278203,32671419,48773
22,ENSG00000128253.9,32205073,22-32386141-A-T,rs2281034,-1,A,T,32386141,181068,32008465,32401681,377676
22,ENSG00000128253.9,32205073,22-32386141-A-C,rs2281034,-1,A,C,32386141,181068,32008465,32401681,377676
22,ENSG00000100116.11,37807934,22-37809982-T-C,rs2285178,1,T,C,37809982,2048,37611326,38004542,198656
22,ENSG00000100116.11,37807934,22-37809982-T-A,rs2285178,1,T,A,37809982,2048,37611326,38004542,198656
22,ENSG00000079974.13,50783636,22-50739662-G-A,rs2285395,-1,G,A,50739662,43974,50587028,50980244,152634
22,ENSG00000100385.8,37149916,22-37158799-C-G,rs229484,-1,C,G,37158799,8883,36953308,37346524,205491
22,ENSG00000100385.8,37149916,22-37158799-C-A,rs229484,-1,C,A,37158799,8883,36953308,37346524,205491
22,ENSG00000161133.12,20377251,22-20451082-T-G,rs2329356,-1,T,G,20451082,73831,20180643,20573859,270439
22,ENSG00000161133.12,20377251,22-20451082-T-A,rs2329356,-1,T,A,20451082,73831,20180643,20573859,270439
22,ENSG00000100038.14,21982787,22-21912468-G-A,rs240055,-1,G,A,21912468,70319,21786179,22179395,126289
22,ENSG00000186575.12,29603633,22-29708920-C-T,rs2530683,1,C,T,29708920,105287,29407025,29800241,301895
22,ENSG00000186575.12,29603633,22-29708920-C-A,rs2530683,1,C,A,29708920,105287,29407025,29800241,301895
22,ENSG00000128340.10,37244269,22-37092941-A-G,rs2543515,-1,A,G,37092941,151328,37047661,37440877,45280
22,ENSG00000100167.15,41969443,22-42134634-G-A,rs28641480,1,G,A,42134634,165191,41772835,42166051,361799
22,ENSG00000187045.12,37109713,22-37149253-C-T,rs3218344,-1,C,T,37149253,39540,36913105,37306321,236148
22,ENSG00000243811.2,39021127,22-39024596-T-C,rs34074269,1,T,C,39024596,3469,38824519,39217735,200077
22,ENSG00000239282.3,30289505,22-30341782-G-T,rs34244534,-1,G,T,30341782,52277,30092897,30486113,248885
22,ENSG00000239282.3,30289505,22-30341782-G-A,rs34244534,-1,G,A,30341782,52277,30092897,30486113,248885
22,ENSG00000239282.3,30289505,22-30341782-G-C,rs34244534,-1,G,C,30341782,52277,30092897,30486113,248885
22,ENSG00000128309.11,37019742,22-37018427-T-G,rs35156365,1,T,G,37018427,1315,36823134,37216350,195293
22,ENSG00000128311.8,37019447,22-37018427-T-G,rs35156365,-1,T,G,37018427,1020,36822839,37216055,195588
22,ENSG00000130943.5,46263343,22-46259882-G-A,rs36125344,-1,G,A,46259882,3461,46066735,46459951,193147
22,ENSG00000130943.5,46263343,22-46259882-G-C,rs36125344,-1,G,C,46259882,3461,46066735,46459951,193147
22,ENSG00000100075.5,19178736,22-19275329-T-G,rs362148,-1,T,G,19275329,96593,18982128,19375344,293201
22,ENSG00000100075.5,19178736,22-19275329-T-C,rs362148,-1,T,C,19275329,96593,18982128,19375344,293201
22,ENSG00000100129.11,37849419,22-37762734-A-C,rs3788530,1,A,C,37762734,86685,37652811,38046027,109923
22,ENSG00000100129.11,37849419,22-37762734-A-G,rs3788530,1,A,G,37762734,86685,37652811,38046027,109923
22,ENSG00000100211.6,38656638,22-38668801-A-C,rs3827356,1,A,C,38668801,12163,38460030,38853246,208771
22,ENSG00000015475.14,17774469,22-17805596-C-T,rs390041,-1,C,T,17805596,31127,17577861,17971077,227735
22,ENSG00000183773.10,20967255,22-21031696-C-T,rs402931,1,C,T,21031696,64441,20770647,21163863,261049
22,ENSG00000217442.3,50562919,22-50550768-C-T,rs41281529,-1,C,T,50550768,12151,50366311,50759527,184457
22,ENSG00000100360.10,36776119,22-36754958-G-C,rs41466945,-1,G,C,36754958,21161,36579511,36972727,175447
22,ENSG00000100360.10,36776119,22-36754958-G-A,rs41466945,-1,G,A,36754958,21161,36579511,36972727,175447
22,ENSG00000183741.7,38872216,22-38885631-A-G,rs4361209,-1,A,G,38885631,13415,38675608,39068824,210023
22,ENSG00000183741.7,38872216,22-38885631-A-T,rs4361209,-1,A,T,38885631,13415,38675608,39068824,210023
22,ENSG00000100300.12,43151559,22-43166823-G-T,rs47340,1,G,T,43166823,15264,42954951,43348167,211872
22,ENSG00000100300.12,43151559,22-43166823-G-C,rs47340,1,G,C,43166823,15264,42954951,43348167,211872
22,ENSG00000243156.2,18024561,22-18000622-A-C,rs4819654,-1,A,C,18000622,23939,17827953,18221169,172669
22,ENSG00000243156.2,18024561,22-18000622-A-G,rs4819654,-1,A,G,18000622,23939,17827953,18221169,172669
22,ENSG00000243156.2,18024561,22-18000622-A-T,rs4819654,-1,A,T,18000622,23939,17827953,18221169,172669
22,ENSG00000215193.5,18077990,22-18072368-A-G,rs4819666,1,A,G,18072368,5622,17881382,18274598,190986
22,ENSG00000215193.5,18077990,22-18072368-A-T,rs4819666,1,A,T,18072368,5622,17881382,18274598,190986
22,ENSG00000099977.9,23974441,22-23900786-A-G,rs4820571,-1,A,G,23900786,73655,23777833,24171049,122953
22,ENSG00000099977.9,23974441,22-23900786-A-T,rs4820571,-1,A,T,23900786,73655,23777833,24171049,122953
22,ENSG00000100365.10,36861006,22-36856876-C-T,rs4821542,1,C,T,36856876,4130,36664398,37057614,192478
22,ENSG00000100365.10,36861006,22-36856876-C-A,rs4821542,1,C,A,36856876,4130,36664398,37057614,192478
22,ENSG00000133466.9,37188247,22-37213254-A-G,rs4821603,-1,A,G,37213254,25007,36991639,37384855,221615
22,ENSG00000133466.9,37188247,22-37213254-A-T,rs4821603,-1,A,T,37213254,25007,36991639,37384855,221615
22,ENSG00000133466.9,37188247,22-37213254-A-C,rs4821603,-1,A,C,37213254,25007,36991639,37384855,221615
22,ENSG00000184983.4,42090772,22-42263958-G-A,rs4822099,-1,G,A,42263958,173186,41894164,42287380,369794
22,ENSG00000188677.9,44024302,22-44161183-G-A,rs4823197,1,G,A,44161183,136881,43827694,44220910,333489
22,ENSG00000188130.8,50261683,22-50430496-A-T,rs4824127,-1,A,T,50430496,168813,50065075,50458291,365421
22,ENSG00000188130.8,50261683,22-50430496-A-C,rs4824127,-1,A,C,50430496,168813,50065075,50458291,365421
22,ENSG00000170638.5,50185913,22-50217680-A-C,rs55955211,1,A,C,50217680,31767,49989305,50382521,228375
22,ENSG00000189306.6,42519796,22-42510673-C-G,rs56211179,-1,C,G,42510673,9123,42323188,42716404,187485
22,ENSG00000093010.7,19941772,22-19939623-A-T,rs5748489,1,A,T,19939623,2149,19745164,20138380,194459
22,ENSG00000093010.7,19941772,22-19939623-A-C,rs5748489,1,A,C,19939623,2149,19745164,20138380,194459
22,ENSG00000093072.10,17219435,22-17216891-A-G,rs5748952,-1,A,G,17216891,2544,17022827,17416043,194064
22,ENSG00000093072.10,17219435,22-17216891-A-C,rs5748952,-1,A,C,17216891,2544,17022827,17416043,194064
22,ENSG00000128276.6,32357867,22-32407302-A-C,rs5749429,1,A,C,32407302,49435,32161259,32554475,246043
22,ENSG00000128272.10,39520562,22-39541264-A-G,rs5750848,1,A,G,39541264,20702,39323954,39717170,217310
22,ENSG00000128272.10,39520562,22-39541264-A-T,rs5750848,1,A,T,39541264,20702,39323954,39717170,217310
22,ENSG00000172346.9,41561010,22-41619761-C-G,rs5751129,1,C,G,41619761,58751,41364402,41757618,255359
22,ENSG00000172346.9,41561010,22-41619761-C-T,rs5751129,1,C,T,41619761,58751,41364402,41757618,255359
22,ENSG00000100197.15,42130810,22-42037797-C-T,rs5751204,-1,C,T,42037797,93013,41934202,42327418,103595
22,ENSG00000100197.15,42130810,22-42037797-C-G,rs5751204,-1,C,G,42037797,93013,41934202,42327418,103595
22,ENSG00000100031.14,24603193,22-24596299-T-C,rs5751901,1,T,C,24596299,6894,24406585,24799801,189714
22,ENSG00000178026.8,24593073,22-24604262-A-T,rs5751904,-1,A,T,24604262,11189,24396465,24789681,207797
22,ENSG00000178026.8,24593073,22-24604262-A-G,rs5751904,-1,A,G,24604262,11189,24396465,24789681,207797
22,ENSG00000100122.5,26618027,22-26747282-G-A,rs5752402,-1,G,A,26747282,129255,26421419,26814635,325863
22,ENSG00000100314.3,29720003,22-29657974-A-G,rs5752949,1,A,G,29657974,62029,29523395,29916611,134579
22,ENSG00000166897.9,37427479,22-37460237-C-A,rs5756683,-1,C,A,37460237,32758,37230871,37624087,229366
22,ENSG00000166897.9,37427479,22-37460237-C-T,rs5756683,-1,C,T,37460237,32758,37230871,37624087,229366
22,ENSG00000128268.11,39457012,22-39454169-G-A,rs5757683,1,G,A,39454169,2843,39260404,39653620,193765
22,ENSG00000128268.11,39457012,22-39454169-G-T,rs5757683,1,G,T,39454169,2843,39260404,39653620,193765
22,ENSG00000128268.11,39457012,22-39454169-G-C,rs5757683,1,G,C,39454169,2843,39260404,39653620,193765
22,ENSG00000100266.11,43015149,22-43013983-G-A,rs5759093,-1,G,A,43013983,1166,42818541,43211757,195442
22,ENSG00000100266.11,43015149,22-43013983-G-C,rs5759093,-1,G,C,43013983,1166,42818541,43211757,195442
22,ENSG00000100271.11,43089391,22-43058449-A-G,rs5759124,-1,A,G,43058449,30942,42892783,43285999,165666
22,ENSG00000186716.14,23180509,22-23176859-G-A,rs5759631,1,G,A,23176859,3650,22983901,23377117,192958
22,ENSG00000186716.14,23180509,22-23176859-G-T,rs5759631,1,G,T,23176859,3650,22983901,23377117,192958
22,ENSG00000099998.12,24245082,22-24240854-T-G,rs5760273,-1,T,G,24240854,4228,24048474,24441690,192380
22,ENSG00000099998.12,24245082,22-24240854-T-C,rs5760273,-1,T,C,24240854,4228,24048474,24441690,192380
22,ENSG00000100239.10,50343327,22-50464322-C-T,rs5771041,1,C,T,50464322,120995,50146719,50539935,317603
22,ENSG00000128165.7,50481543,22-50464322-C-T,rs5771041,1,C,T,50464322,17221,50284935,50678151,179387
22,ENSG00000099968.13,17638757,22-17696633-C-T,rs5992095,1,C,T,17696633,57876,17442149,17835365,254484
22,ENSG00000182902.8,17563498,22-17619861-A-C,rs5992761,1,A,C,17619861,56363,17366890,17760106,252971
22,ENSG00000182902.8,17563498,22-17619861-A-G,rs5992761,1,A,G,17619861,56363,17366890,17760106,252971
22,ENSG00000161180.5,21632760,22-21591562-G-A,rs5998619,1,G,A,21591562,41198,21436152,21829368,155410
22,ENSG00000100336.13,36201809,22-36204795-A-G,rs6000190,-1,A,G,36204795,2986,36005201,36398417,199594
22,ENSG00000100243.15,42649392,22-42645831-A-C,rs6002851,-1,A,C,42645831,3561,42452784,42846000,193047
22,ENSG00000100243.15,42649392,22-42645831-A-T,rs6002851,-1,A,T,42645831,3561,42452784,42846000,193047
22,ENSG00000100364.13,45240894,22-45247026-T-C,rs6006956,-1,T,C,45247026,6132,45044286,45437502,202740
22,ENSG00000100364.13,45240894,22-45247026-T-G,rs6006956,-1,T,G,45247026,6132,45044286,45437502,202740
22,ENSG00000075234.12,46268008,22-46292311-C-A,rs6008552,1,C,A,46292311,24303,46071400,46464616,220911
22,ENSG00000075234.12,46268008,22-46292311-C-T,rs6008552,1,C,T,46292311,24303,46071400,46464616,220911
22,ENSG00000075234.12,46268008,22-46292311-C-G,rs6008552,1,C,G,46292311,24303,46071400,46464616,220911
22,ENSG00000100299.12,50628152,22-50625049-T-C,rs6151429,-1,T,C,50625049,3103,50431544,50824760,193505
22,ENSG00000198792.7,38273010,22-38283399-T-G,rs62230172,-1,T,G,38283399,10389,38076402,38469618,206997
22,ENSG00000100401.14,41286187,22-41325340-C-A,rs62238179,-1,C,A,41325340,39153,41089579,41482795,235761
22,ENSG00000205593.5,50327012,22-50320444-C-G,rs62241237,-1,C,G,50320444,6568,50130404,50523620,190040
22,ENSG00000205593.5,50327012,22-50320444-C-T,rs62241237,-1,C,T,50320444,6568,50130404,50523620,190040
22,ENSG00000183307.3,17121360,22-17107085-G-A,rs6518661,-1,G,A,17107085,14275,16924752,17317968,182333
22,ENSG00000100290.2,43110750,22-43120016-C-T,rs6519362,1,C,T,43120016,9266,42914142,43307358,205874
22,ENSG00000100290.2,43110750,22-43120016-C-A,rs6519362,1,C,A,43120016,9266,42914142,43307358,205874
22,ENSG00000100294.7,43143398,22-43162966-G-A,rs6972,-1,G,A,43162966,19568,42946790,43340006,216176
22,ENSG00000070371.11,19291719,22-19209218-A-G,rs712954,-1,A,G,19209218,82501,19095111,19488327,114107
22,ENSG00000100097.7,37675636,22-37668643-C-T,rs713835,1,C,T,37668643,6993,37479028,37872244,189615
22,ENSG00000100376.7,45309934,22-45330464-A-G,rs7285172,1,A,G,45330464,20530,45113326,45506542,217138
22,ENSG00000128245.9,31944535,22-31945971-A-G,rs7291050,1,A,G,31945971,1436,31747927,32141143,198044
22,ENSG00000128245.9,31944535,22-31945971-A-C,rs7291050,1,A,C,31945971,1436,31747927,32141143,198044
22,ENSG00000133460.13,23857875,22-23764499-C-T,rs7291060,1,C,T,23764499,93376,23661267,24054483,103232
22,ENSG00000133460.13,23857875,22-23764499-C-A,rs7291060,1,C,A,23764499,93376,23661267,24054483,103232
22,ENSG00000169314.9,23762990,22-23764499-C-T,rs7291060,1,C,T,23764499,1509,23566382,23959598,198117
22,ENSG00000169314.9,23762990,22-23764499-C-A,rs7291060,1,C,A,23764499,1509,23566382,23959598,198117
22,ENSG00000184117.7,29581113,22-29683224-T-C,rs7291645,-1,T,C,29683224,102111,29384505,29777721,298719
22,ENSG00000184117.7,29581113,22-29683224-T-A,rs7291645,-1,T,A,29683224,102111,29384505,29777721,298719
22,ENSG00000100418.7,41621043,22-41642253-C-A,rs7291732,-1,C,A,41642253,21210,41424435,41817651,217818
22,ENSG00000100023.12,21666012,22-21635036-C-T,rs730882,1,C,T,21635036,30976,21469404,21862620,165632
22,ENSG00000197077.7,24952716,22-24969861-A-C,rs73157953,1,A,C,24969861,17145,24756108,25149324,213753
22,ENSG00000185721.6,31399604,22-31423133-A-G,rs73160619,1,A,G,31423133,23529,31202996,31596212,220137
22,ENSG00000185721.6,31399604,22-31423133-A-C,rs73160619,1,A,C,31423133,23529,31202996,31596212,220137
22,ENSG00000099940.6,20859007,22-20909065-G-T,rs73162872,1,G,T,20909065,50058,20662399,21055615,246666
22,ENSG00000099940.6,20859007,22-20909065-G-A,rs73162872,1,G,A,20909065,50058,20662399,21055615,246666
22,ENSG00000100348.5,36481640,22-36493069-C-A,rs73169658,-1,C,A,36493069,11429,36285032,36678248,208037
22,ENSG00000100056.7,19144651,22-19144812-A-G,rs737923,-1,A,G,19144812,161,18948043,19341259,196769
22,ENSG00000100056.7,19144651,22-19144812-A-T,rs737923,-1,A,T,19144812,161,18948043,19341259,196769
22,ENSG00000128274.10,42720870,22-42716469-C-G,rs738526,-1,C,G,42716469,4401,42524262,42917478,192207
22,ENSG00000128274.10,42720870,22-42716469-C-T,rs738526,-1,C,T,42716469,4401,42524262,42917478,192207
22,ENSG00000100417.7,41589840,22-41693619-T-C,rs739134,-1,T,C,41693619,103779,41393232,41786448,300387
22,ENSG00000167077.7,41699503,22-41704271-A-G,rs739136,1,A,G,41704271,4768,41502895,41896111,201376
22,ENSG00000167077.7,41699503,22-41704271-A-T,rs739136,1,A,T,41704271,4768,41502895,41896111,201376
22,ENSG00000100220.7,32412247,22-32584551-T-C,rs77940880,-1,T,C,32584551,172304,32215639,32608855,368912
22,ENSG00000186998.11,29205896,22-29160757-C-G,rs79434685,1,C,G,29160757,45139,29009288,29402504,151469
22,ENSG00000128159.7,50245023,22-50052506-T-C,rs79814761,-1,T,C,50052506,192517,50048415,50441631,4091
22,ENSG00000069998.8,17159277,22-17158947-A-G,rs79822985,-1,A,G,17158947,330,16962669,17355885,196278
22,ENSG00000025770.13,50508224,22-50587778-T-C,rs8137073,1,T,C,50587778,79554,50311616,50704832,276162
22,ENSG00000025770.13,50508224,22-50587778-T-G,rs8137073,1,T,G,50587778,79554,50311616,50704832,276162
22,ENSG00000099994.10,24181487,22-24029959-C-T,rs8137455,1,C,T,24029959,151528,23984879,24378095,45080
22,ENSG00000100285.8,29480218,22-29446153-C-G,rs8141113,1,C,G,29446153,34065,29283610,29676826,162543
22,ENSG00000100285.8,29480218,22-29446153-C-T,rs8141113,1,C,T,29446153,34065,29283610,29676826,162543
22,ENSG00000100285.8,29480218,22-29446153-C-A,rs8141113,1,C,A,29446153,34065,29283610,29676826,162543
22,ENSG00000040608.9,20268318,22-20226155-A-T,rs854962,-1,A,T,20226155,42163,20071710,20464926,154445
22,ENSG00000040608.9,20268318,22-20226155-A-C,rs854962,-1,A,C,20226155,42163,20071710,20464926,154445
22,ENSG00000040608.9,20268318,22-20226155-A-G,rs854962,-1,A,G,20226155,42163,20071710,20464926,154445
22,ENSG00000128203.6,26429260,22-26431369-T-G,rs880421,1,T,G,26431369,2109,26232652,26625868,198717
22,ENSG00000100368.8,36913628,22-36864559-A-T,rs909484,1,A,T,36864559,49069,36717020,37110236,147539
22,ENSG00000100368.8,36913628,22-36864559-A-G,rs909484,1,A,G,36864559,49069,36717020,37110236,147539
22,ENSG00000100368.8,36913628,22-36864559-A-C,rs909484,1,A,C,36864559,49069,36717020,37110236,147539
22,ENSG00000099904.11,20131804,22-19955462-C-T,rs9332348,1,C,T,19955462,176342,19935196,20328412,20266
22,ENSG00000099904.11,20131804,22-19955462-C-A,rs9332348,1,C,A,19955462,176342,19935196,20328412,20266
22,ENSG00000100036.11,30635781,22-30610873-A-G,rs9606756,1,A,G,30610873,24908,30439173,30832389,171700
22,ENSG00000100413.12,41544470,22-41371482-T-C,rs9611565,-1,T,C,41371482,172988,41347862,41741078,23620
22,ENSG00000099953.5,23772849,22-23832323-G-A,rs9612481,1,G,A,23832323,59474,23576241,23969457,256082
22,ENSG00000100296.9,29553757,22-29727040-G-A,rs9614041,-1,G,A,29727040,173283,29357149,29750365,369891
22,ENSG00000100296.9,29553757,22-29727040-G-C,rs9614041,-1,G,C,29727040,173283,29357149,29750365,369891
22,ENSG00000128185.5,20320060,22-20343221-C-T,rs9617876,-1,C,T,20343221,23161,20123452,20516668,219769
22,ENSG00000128185.5,20320060,22-20343221-C-A,rs9617876,-1,C,A,20343221,23161,20123452,20516668,219769
22,ENSG00000100351.11,39901084,22-40006544-C-G,rs9623106,1,C,G,40006544,105460,39704476,40097692,302068
22,ENSG00000133433.6,23961195,22-23969285-G-A,rs9624364,-1,G,A,23969285,8090,23764587,24157803,204698
22,ENSG00000100311.12,39244982,22-39274846-G-T,rs968451,-1,G,T,39274846,29864,39048374,39441590,226472
22,ENSG00000100311.12,39244982,22-39274846-G-C,rs968451,-1,G,C,39274846,29864,39048374,39441590,226472
22,ENSG00000234965.1,41915074,22-41843344-G-C,rs1009544,-1,G,C,41843344,71730,41718466,42111682,124878
22,ENSG00000100122.5,26618027,22-26753090-C-T,rs1015067,-1,C,T,26753090,135063,26421419,26814635,331671
22,ENSG00000185838.9,19854874,22-19832054-G-T,rs10427769,-1,G,T,19832054,22820,19658266,20051482,173788
22,ENSG00000128242.8,30574665,22-30555239-C-G,rs112976399,-1,C,G,30555239,19426,30378057,30771273,177182
22,ENSG00000128242.8,30574665,22-30555239-C-T,rs112976399,-1,C,T,30555239,19426,30378057,30771273,177182
22,ENSG00000188636.3,44498233,22-44430681-G-T,rs115020852,-1,G,T,44430681,67552,44301625,44694841,129056
22,ENSG00000188636.3,44498233,22-44430681-G-A,rs115020852,-1,G,A,44430681,67552,44301625,44694841,129056
22,ENSG00000188636.3,44498233,22-44430681-G-C,rs115020852,-1,G,C,44430681,67552,44301625,44694841,129056
22,ENSG00000138942.9,31160182,22-31248628-C-T,rs11556237,1,C,T,31248628,88446,30963574,31356790,285054
22,ENSG00000184381.11,38181830,22-38122615-A-G,rs11570734,-1,A,G,38122615,59215,37985222,38378438,137393
22,ENSG00000184381.11,38181830,22-38122615-A-T,rs11570734,-1,A,T,38122615,59215,37985222,38378438,137393
22,ENSG00000100258.12,50507702,22-50512918-A-G,rs115920265,-1,A,G,50512918,5216,50311094,50704310,201824
22,ENSG00000198089.9,31496536,22-31400577-C-T,rs11704156,1,C,T,31400577,95959,31299928,31693144,100649
22,ENSG00000099968.13,17638757,22-17678777-G-A,rs11704288,1,G,A,17678777,40020,17442149,17835365,236628
22,ENSG00000128408.7,45413693,22-45446523-G-T,rs11704569,1,G,T,45446523,32830,45217085,45610301,229438
22,ENSG00000100395.10,41205312,22-41361766-C-A,rs117079136,1,C,A,41361766,156454,41008704,41401920,353062
22,ENSG00000184702.12,19714503,22-19630697-C-T,rs117299378,1,C,T,19630697,83806,19517895,19911111,112802
22,ENSG00000184702.12,19714503,22-19630697-C-A,rs117299378,1,C,A,19630697,83806,19517895,19911111,112802
22,ENSG00000100387.8,40951378,22-40799078-G-A,rs117487309,1,G,A,40799078,152300,40754770,41147986,44308
22,ENSG00000100387.8,40951378,22-40799078-G-T,rs117487309,1,G,T,40799078,152300,40754770,41147986,44308
22,ENSG00000100401.14,41286187,22-41149619-G-T,rs117597170,-1,G,T,41149619,136568,41089579,41482795,60040
22,ENSG00000100401.14,41286187,22-41149619-G-A,rs117597170,-1,G,A,41149619,136568,41089579,41482795,60040
22,ENSG00000099956.12,23786966,22-23805408-T-C,rs11912715,1,T,C,23805408,18442,23590358,23983574,215050
22,ENSG00000167065.9,30667875,22-30667845-G-A,rs11912792,-1,G,A,30667845,30,30471267,30864483,196578
22,ENSG00000167065.9,30667875,22-30667845-G-C,rs11912792,-1,G,C,30667845,30,30471267,30864483,196578
22,ENSG00000184792.11,30694874,22-30889149-T-C,rs12166521,1,T,C,30889149,194275,30498266,30891482,390883
22,ENSG00000184792.11,30694874,22-30889149-T-G,rs12166521,1,T,G,30889149,194275,30498266,30891482,390883
22,ENSG00000100228.7,23145477,22-23302238-A-G,rs12168342,1,A,G,23302238,156761,22948869,23342085,353369
22,ENSG00000100219.10,28800524,22-28806075-A-G,rs12168849,-1,A,G,28806075,5551,28603916,28997132,202159
22,ENSG00000100243.15,42649392,22-42665476-G-C,rs130328,-1,G,C,42665476,16084,42452784,42846000,212692
22,ENSG00000100243.15,42649392,22-42665476-G-A,rs130328,-1,G,A,42665476,16084,42452784,42846000,212692
22,ENSG00000100243.15,42649392,22-42665476-G-T,rs130328,-1,G,T,42665476,16084,42452784,42846000,212692
22,ENSG00000177989.8,50532498,22-50517109-A-G,rs131817,-1,A,G,50517109,15389,50335890,50729106,181219
22,ENSG00000177989.8,50532498,22-50517109-A-C,rs131817,-1,A,C,50517109,15389,50335890,50729106,181219
22,ENSG00000100413.12,41544470,22-41401820-G-A,rs132903,-1,G,A,41401820,142650,41347862,41741078,53958
22,ENSG00000100413.12,41544470,22-41401820-G-C,rs132903,-1,G,C,41401820,142650,41347862,41741078,53958
22,ENSG00000172404.4,40862113,22-40679691-C-T,rs133073,-1,C,T,40679691,182422,40665505,41058721,14186
22,ENSG00000198951.6,42070812,22-41988121-A-G,rs133295,-1,A,G,41988121,82691,41874204,42267420,113917
22,ENSG00000198951.6,42070812,22-41988121-A-C,rs133295,-1,A,C,41988121,82691,41874204,42267420,113917
22,ENSG00000198951.6,42070812,22-41988121-A-T,rs133295,-1,A,T,41988121,82691,41874204,42267420,113917
22,ENSG00000100197.15,42130810,22-42285854-T-C,rs134897,-1,T,C,42285854,155044,41934202,42327418,351652
22,ENSG00000100197.15,42130810,22-42285854-T-G,rs134897,-1,T,G,42285854,155044,41934202,42327418,351652
22,ENSG00000100197.15,42130810,22-42285854-T-A,rs134897,-1,T,A,42285854,155044,41934202,42327418,351652
22,ENSG00000198792.7,38273010,22-38260679-A-G,rs135710,-1,A,G,38260679,12331,38076402,38469618,184277
22,ENSG00000213923.5,38317433,22-38267850-G-A,rs135721,-1,G,A,38267850,49583,38120825,38514041,147025
22,ENSG00000213923.5,38317433,22-38267850-G-T,rs135721,-1,G,T,38267850,49583,38120825,38514041,147025
22,ENSG00000100351.11,39901084,22-39966942-A-G,rs138006,1,A,G,39966942,65858,39704476,40097692,262466
22,ENSG00000100351.11,39901084,22-39966942-A-T,rs138006,1,A,T,39966942,65858,39704476,40097692,262466
22,ENSG00000100351.11,39901084,22-39966942-A-C,rs138006,1,A,C,39966942,65858,39704476,40097692,262466
22,ENSG00000100304.10,43187134,22-43197126-C-T,rs138973,-1,C,T,43197126,9992,42990526,43383742,206600
22,ENSG00000100304.10,43187134,22-43197126-C-G,rs138973,-1,C,G,43197126,9992,42990526,43383742,206600
22,ENSG00000100304.10,43187134,22-43197126-C-A,rs138973,-1,C,A,43197126,9992,42990526,43383742,206600
22,ENSG00000100298.11,39097244,22-39111882-A-T,rs139347,1,A,T,39111882,14638,38900636,39293852,211246
22,ENSG00000100298.11,39097244,22-39111882-A-G,rs139347,1,A,G,39111882,14638,38900636,39293852,211246
22,ENSG00000243811.2,39021127,22-39151196-G-A,rs139404,1,G,A,39151196,130069,38824519,39217735,326677
22,ENSG00000243811.2,39021127,22-39151196-G-C,rs139404,1,G,C,39151196,130069,38824519,39217735,326677
22,ENSG00000239713.3,39077275,22-39157767-A-G,rs139413,1,A,G,39157767,80492,38880667,39273883,277100
22,ENSG00000100276.8,29315697,22-29296498-G-T,rs140065,-1,G,T,29296498,19199,29119089,29512305,177409
22,ENSG00000025708.8,50530012,22-50539595-C-A,rs140521,-1,C,A,50539595,9583,50333404,50726620,206191
22,ENSG00000025708.8,50530012,22-50539595-C-G,rs140521,-1,C,G,50539595,9583,50333404,50726620,206191
22,ENSG00000185339.4,30607174,22-30644418-G-T,rs16988925,1,G,T,30644418,37244,30410566,30803782,233852
22,ENSG00000075275.12,46537620,22-46393383-C-T,rs16995177,-1,C,T,46393383,144237,46341012,46734228,52371
22,ENSG00000100320.16,35840587,22-35651093-G-A,rs16995908,-1,G,A,35651093,189494,35643979,36037195,7114
22,ENSG00000128250.5,29438583,22-29382463-G-A,rs174773,1,G,A,29382463,56120,29241975,29635191,140488
22,ENSG00000128250.5,29438583,22-29382463-G-T,rs174773,1,G,T,29382463,56120,29241975,29635191,140488
22,ENSG00000128250.5,29438583,22-29382463-G-C,rs174773,1,G,C,29382463,56120,29241975,29635191,140488
22,ENSG00000186998.11,29205896,22-29102568-A-G,rs17522248,1,A,G,29102568,103328,29009288,29402504,93280
22,ENSG00000128271.12,24427599,22-24562148-C-T,rs17574411,1,C,T,24562148,134549,24230991,24624207,331157
22,ENSG00000128271.12,24427599,22-24562148-C-A,rs17574411,1,C,A,24562148,134549,24230991,24624207,331157
22,ENSG00000184436.7,21002118,22-20996591-T-C,rs178295,-1,T,C,20996591,5527,20805510,21198726,191081
22,ENSG00000100292.12,35381096,22-35383230-T-C,rs17885925,1,T,C,35383230,2134,35184488,35577704,198742
22,ENSG00000100292.12,35381096,22-35383230-T-A,rs17885925,1,T,A,35383230,2134,35184488,35577704,198742
22,ENSG00000128159.7,50245023,22-50064634-G-T,rs181700711,-1,G,T,50064634,180389,50048415,50441631,16219
22,ENSG00000128159.7,50245023,22-50064634-G-A,rs181700711,-1,G,A,50064634,180389,50048415,50441631,16219
22,ENSG00000099889.9,20016823,22-20009306-G-A,rs1989843,-1,G,A,20009306,7517,19820215,20213431,189091
22,ENSG00000239900.4,40346500,22-40420745-G-A,rs2072856,1,G,A,40420745,74245,40149892,40543108,270853
22,ENSG00000100321.10,39349991,22-39315346-A-G,rs2076125,1,A,G,39315346,34645,39153383,39546599,161963
22,ENSG00000100321.10,39349991,22-39315346-A-T,rs2076125,1,A,T,39315346,34645,39153383,39546599,161963
22,ENSG00000179750.11,38982347,22-38996385-C-T,rs2179233,1,C,T,38996385,14038,38785739,39178955,210646
22,ENSG00000179750.11,38982347,22-38996385-C-G,rs2179233,1,C,G,38996385,14038,38785739,39178955,210646
22,ENSG00000128383.8,38957609,22-38996385-C-T,rs2179233,1,C,T,38996385,38776,38761001,39154217,235384
22,ENSG00000128383.8,38957609,22-38996385-C-G,rs2179233,1,C,G,38996385,38776,38761001,39154217,235384
22,ENSG00000182902.8,17563498,22-17431799-T-G,rs2189077,1,T,G,17431799,131699,17366890,17760106,64909
22,ENSG00000182902.8,17563498,22-17431799-T-C,rs2189077,1,T,C,17431799,131699,17366890,17760106,64909
22,ENSG00000128276.6,32357867,22-32397282-G-A,rs2294311,1,G,A,32397282,39415,32161259,32554475,236023
22,ENSG00000100034.8,21952848,22-21768900-A-T,rs2298432,-1,A,T,21768900,183948,21756240,22149456,12660
22,ENSG00000100034.8,21952848,22-21768900-A-C,rs2298432,-1,A,C,21768900,183948,21756240,22149456,12660
22,ENSG00000182944.13,29268268,22-29299939-T-G,rs2518683,1,T,G,29299939,31671,29071660,29464876,228279
22,ENSG00000182944.13,29268268,22-29299939-T-A,rs2518683,1,T,A,29299939,31671,29071660,29464876,228279
22,ENSG00000100075.5,19178736,22-19180574-G-C,rs2800974,-1,G,C,19180574,1838,18982128,19375344,198446
22,ENSG00000100075.5,19178736,22-19180574-G-T,rs2800974,-1,G,T,19180574,1838,18982128,19375344,198446
22,ENSG00000100075.5,19178736,22-19180574-G-A,rs2800974,-1,G,A,19180574,1838,18982128,19375344,198446
22,ENSG00000217442.3,50562919,22-50500185-T-C,rs28375115,-1,T,C,50500185,62734,50366311,50759527,133874
22,ENSG00000235568.2,42432403,22-42421786-T-C,rs28405495,-1,T,C,42421786,10617,42235795,42629011,185991
22,ENSG00000189306.6,42519796,22-42614811-G-T,rs28627172,-1,G,T,42614811,95015,42323188,42716404,291623
22,ENSG00000189306.6,42519796,22-42614811-G-A,rs28627172,-1,G,A,42614811,95015,42323188,42716404,291623
22,ENSG00000099901.11,20116104,22-20245708-C-T,rs34909867,1,C,T,20245708,129604,19919496,20312712,326212
22,ENSG00000100368.8,36913628,22-36873465-T-A,rs3788523,1,T,A,36873465,40163,36717020,37110236,156445
22,ENSG00000100368.8,36913628,22-36873465-T-C,rs3788523,1,T,C,36873465,40163,36717020,37110236,156445
22,ENSG00000100368.8,36913628,22-36873465-T-G,rs3788523,1,T,G,36873465,40163,36717020,37110236,156445
22,ENSG00000099917.12,20507610,22-20565159-G-A,rs3791192,1,G,A,20565159,57549,20311002,20704218,254157
22,ENSG00000185252.13,20394151,22-20565159-G-A,rs3791192,1,G,A,20565159,171008,20197543,20590759,367616
22,ENSG00000100280.12,29388570,22-29485479-G-A,rs3815335,-1,G,A,29485479,96909,29191962,29585178,293517
22,ENSG00000100280.12,29388570,22-29485479-G-T,rs3815335,-1,G,T,29485479,96909,29191962,29585178,293517
22,ENSG00000169184.5,27801756,22-27750289-G-C,rs41277851,-1,G,C,27750289,51467,27605148,27998364,145141
22,ENSG00000169184.5,27801756,22-27750289-G-T,rs41277851,-1,G,T,27750289,51467,27605148,27998364,145141
22,ENSG00000169184.5,27801756,22-27750289-G-A,rs41277851,-1,G,A,27750289,51467,27605148,27998364,145141
22,ENSG00000183172.6,42079700,22-42145327-G-C,rs4467371,1,G,C,42145327,65627,41883092,42276308,262235
22,ENSG00000183172.6,42079700,22-42145327-G-A,rs4467371,1,G,A,42145327,65627,41883092,42276308,262235
22,ENSG00000215193.5,18077990,22-18099884-A-T,rs467998,1,A,T,18099884,21894,17881382,18274598,218502
22,ENSG00000215193.5,18077990,22-18099884-A-C,rs467998,1,A,C,18099884,21894,17881382,18274598,218502
22,ENSG00000205560.8,50578427,22-50571524-C-T,rs470117,-1,C,T,50571524,6903,50381819,50775035,189705
22,ENSG00000167074.9,41381942,22-41365286-T-C,rs4820437,1,T,C,41365286,16656,41185334,41578550,179952
22,ENSG00000185721.6,31399604,22-31440392-G-T,rs4820972,1,G,T,31440392,40788,31202996,31596212,237396
22,ENSG00000185721.6,31399604,22-31440392-G-C,rs4820972,1,G,C,31440392,40788,31202996,31596212,237396
22,ENSG00000185721.6,31399604,22-31440392-G-A,rs4820972,1,G,A,31440392,40788,31202996,31596212,237396
22,ENSG00000133466.9,37188247,22-37204523-C-G,rs4821599,-1,C,G,37204523,16276,36991639,37384855,212884
22,ENSG00000133466.9,37188247,22-37204523-C-A,rs4821599,-1,C,A,37204523,16276,36991639,37384855,212884
22,ENSG00000128322.6,23580290,22-23387511-G-C,rs4822392,-1,G,C,23387511,192779,23383682,23776898,3829
22,ENSG00000128322.6,23580290,22-23387511-G-A,rs4822392,-1,G,A,23387511,192779,23383682,23776898,3829
22,ENSG00000128322.6,23580290,22-23387511-G-T,rs4822392,-1,G,T,23387511,192779,23383682,23776898,3829
22,ENSG00000133433.6,23961195,22-23913109-C-G,rs4822455,-1,C,G,23913109,48086,23764587,24157803,148522
22,ENSG00000133433.6,23961195,22-23913109-C-T,rs4822455,-1,C,T,23913109,48086,23764587,24157803,148522
22,ENSG00000240972.1,23894383,22-24028666-G-C,rs4822469,1,G,C,24028666,134283,23697775,24090991,330891
22,ENSG00000100376.7,45309934,22-45297997-A-C,rs4823459,1,A,C,45297997,11937,45113326,45506542,184671
22,ENSG00000100376.7,45309934,22-45297997-A-T,rs4823459,1,A,T,45297997,11937,45113326,45506542,184671
22,ENSG00000100376.7,45309934,22-45297997-A-G,rs4823459,1,A,G,45297997,11937,45113326,45506542,184671
22,ENSG00000128165.7,50481543,22-50458349-G-C,rs4824149,1,G,C,50458349,23194,50284935,50678151,173414
22,ENSG00000128165.7,50481543,22-50458349-G-A,rs4824149,1,G,A,50458349,23194,50284935,50678151,173414
22,ENSG00000205593.5,50327012,22-50247079-A-G,rs4838866,-1,A,G,50247079,79933,50130404,50523620,116675
22,ENSG00000100354.14,40177925,22-40051298-C-T,rs55754970,1,C,T,40051298,126627,39981317,40374533,69981
22,ENSG00000100354.14,40177925,22-40051298-C-G,rs55754970,1,C,G,40051298,126627,39981317,40374533,69981
22,ENSG00000100426.5,49853844,22-50044449-A-G,rs56263616,1,A,G,50044449,190605,49657236,50050452,387213
22,ENSG00000073169.9,50201011,22-50044449-A-G,rs56263616,1,A,G,50044449,156562,50004403,50397619,40046
22,ENSG00000128268.11,39457012,22-39541264-A-T,rs5750848,1,A,T,39541264,84252,39260404,39653620,280860
22,ENSG00000128268.11,39457012,22-39541264-A-G,rs5750848,1,A,G,39541264,84252,39260404,39653620,280860
22,ENSG00000100218.7,23141990,22-23146855-G-A,rs5751591,-1,G,A,23146855,4865,22945382,23338598,201473
22,ENSG00000100319.11,29767007,22-29657974-A-G,rs5752949,-1,A,G,29657974,109033,29570399,29963615,87575
22,ENSG00000187051.4,39532748,22-39545149-A-T,rs5757715,-1,A,T,39545149,12401,39336140,39729356,209009
22,ENSG00000187051.4,39532748,22-39545149-A-G,rs5757715,-1,A,G,39545149,12401,39336140,39729356,209009
22,ENSG00000100412.10,41469117,22-41435263-A-C,rs5758350,1,A,C,41435263,33854,41272509,41665725,162754
22,ENSG00000183569.12,42553956,22-42543702-A-T,rs5758798,1,A,T,42543702,10254,42357348,42750564,186354
22,ENSG00000183569.12,42553956,22-42543702-A-G,rs5758798,1,A,G,42543702,10254,42357348,42750564,186354
22,ENSG00000100294.7,43143398,22-43077428-T-C,rs5759142,-1,T,C,43077428,65970,42946790,43340006,130638
22,ENSG00000128218.7,23754425,22-23813427-G-T,rs5760045,-1,G,T,23813427,59002,23557817,23951033,255610
22,ENSG00000128218.7,23754425,22-23813427-G-A,rs5760045,-1,G,A,23813427,59002,23557817,23951033,255610
22,ENSG00000128218.7,23754425,22-23813427-G-C,rs5760045,-1,G,C,23813427,59002,23557817,23951033,255610
22,ENSG00000100154.10,28679840,22-28692135-T-C,rs5762746,-1,T,C,28692135,12295,28483232,28876448,208903
22,ENSG00000100347.10,43955442,22-43889189-G-A,rs5764386,1,G,A,43889189,66253,43758834,44152050,130355
22,ENSG00000100347.10,43955442,22-43889189-G-C,rs5764386,1,G,C,43889189,66253,43758834,44152050,130355
22,ENSG00000093000.13,45163925,22-45065901-G-A,rs5766388,1,G,A,45065901,98024,44967317,45360533,98584
22,ENSG00000093000.13,45163925,22-45065901-G-T,rs5766388,1,G,T,45065901,98024,44967317,45360533,98584
22,ENSG00000130487.4,50545899,22-50539833-G-A,rs5770871,1,G,A,50539833,6066,50349291,50742507,190542
22,ENSG00000130487.4,50545899,22-50539833-G-T,rs5770871,1,G,T,50539833,6066,50349291,50742507,190542
22,ENSG00000170638.5,50185913,22-50189275-G-T,rs5771217,1,G,T,50189275,3362,49989305,50382521,199970
22,ENSG00000170638.5,50185913,22-50189275-G-A,rs5771217,1,G,A,50189275,3362,49989305,50382521,199970
22,ENSG00000170638.5,50185913,22-50189275-G-C,rs5771217,1,G,C,50189275,3362,49989305,50382521,199970
22,ENSG00000100364.13,45240894,22-45223007-C-T,rs58112670,-1,C,T,45223007,17887,45044286,45437502,178721
22,ENSG00000183864.4,41446801,22-41335492-C-T,rs5996020,-1,C,T,41335492,111309,41250193,41643409,85299
22,ENSG00000198125.7,35617329,22-35733656-T-G,rs5999988,-1,T,G,35733656,116327,35420721,35813937,312935
22,ENSG00000128285.4,40679484,22-40507417-A-T,rs6001946,1,A,T,40507417,172067,40482876,40876092,24541
22,ENSG00000128285.4,40679484,22-40507417-A-G,rs6001946,1,A,G,40507417,172067,40482876,40876092,24541
22,ENSG00000099957.11,21015165,22-21042318-C-T,rs6005347,1,C,T,21042318,27153,20818557,21211773,223761
22,ENSG00000075240.12,46620386,22-46641962-G-A,rs6008938,1,G,A,46641962,21576,46423778,46816994,218184
22,ENSG00000166897.9,37427479,22-37451429-G-A,rs6519064,-1,G,A,37451429,23950,37230871,37624087,220558
22,ENSG00000100300.12,43151559,22-43163131-G-T,rs6973,1,G,T,43163131,11572,42954951,43348167,208180
22,ENSG00000100220.7,32412247,22-32383937-A-T,rs7287726,-1,A,T,32383937,28310,32215639,32608855,168298
22,ENSG00000100220.7,32412247,22-32383937-A-G,rs7287726,-1,A,G,32383937,28310,32215639,32608855,168298
22,ENSG00000183785.9,18110809,22-18114442-C-T,rs7290794,1,C,T,18114442,3633,17914201,18307417,200241
22,ENSG00000054611.9,46762650,22-46749059-G-T,rs73182605,1,G,T,46749059,13591,46566042,46959258,183017
22,ENSG00000100129.11,37849419,22-37780263-C-T,rs73411546,1,C,T,37780263,69156,37652811,38046027,127452
22,ENSG00000100336.13,36201809,22-36206137-G-T,rs7364143,-1,G,T,36206137,4328,36005201,36398417,200936
22,ENSG00000100336.13,36201809,22-36206137-G-A,rs7364143,-1,G,A,36206137,4328,36005201,36398417,200936
22,ENSG00000100290.2,43110750,22-43114213-A-G,rs738276,1,A,G,43114213,3463,42914142,43307358,200071
22,ENSG00000100342.15,36253133,22-36109722-C-G,rs739206,1,C,G,36109722,143411,36056525,36449741,53197
22,ENSG00000100342.15,36253133,22-36109722-C-T,rs739206,1,C,T,36109722,143411,36056525,36449741,53197
22,ENSG00000128340.10,37244269,22-37155711-C-T,rs743778,-1,C,T,37155711,88558,37047661,37440877,108050
22,ENSG00000128245.9,31944535,22-31987432-T-G,rs74534759,1,T,G,31987432,42897,31747927,32141143,239505
22,ENSG00000188130.8,50261683,22-50132326-G-T,rs75570992,-1,G,T,50132326,129357,50065075,50458291,67251
22,ENSG00000188130.8,50261683,22-50132326-G-C,rs75570992,-1,G,C,50132326,129357,50065075,50458291,67251
22,ENSG00000186716.14,23180509,22-23120996-A-G,rs756631,1,A,G,23120996,59513,22983901,23377117,137095
22,ENSG00000100365.10,36861006,22-36867664-C-G,rs760519,1,C,G,36867664,6658,36664398,37057614,203266
22,ENSG00000100365.10,36861006,22-36867664-C-T,rs760519,1,C,T,36867664,6658,36664398,37057614,203266
22,ENSG00000196576.9,50307646,22-50445299-G-A,rs761744,-1,G,A,50445299,137653,50111038,50504254,334261
22,ENSG00000196576.9,50307646,22-50445299-G-C,rs761744,-1,G,C,50445299,137653,50111038,50504254,334261
22,ENSG00000100299.12,50628152,22-50628562-C-T,rs762668,-1,C,T,50628562,410,50431544,50824760,197018
22,ENSG00000185022.7,38201994,22-38240789-G-C,rs76599369,1,G,C,38240789,38795,38005386,38398602,235403
22,ENSG00000185022.7,38201994,22-38240789-G-A,rs76599369,1,G,A,38240789,38795,38005386,38398602,235403
22,ENSG00000077935.12,45413599,22-45481572-T-C,rs76935916,-1,T,C,45481572,67973,45216991,45610207,264581
22,ENSG00000188064.5,45977162,22-46100176-G-A,rs77251783,-1,G,A,46100176,123014,45780554,46173770,319622
22,ENSG00000183597.11,20021110,22-20177186-T-C,rs78908,1,T,C,20177186,156076,19824502,20217718,352684
22,ENSG00000183597.11,20021110,22-20177186-T-G,rs78908,1,T,G,20177186,156076,19824502,20217718,352684
22,ENSG00000183597.11,20021110,22-20177186-T-A,rs78908,1,T,A,20177186,156076,19824502,20217718,352684
22,ENSG00000198911.6,41833105,22-41695009-A-C,rs79249497,1,A,C,41695009,138096,41636497,42029713,58512
22,ENSG00000100311.12,39244982,22-39289827-G-C,rs79290,-1,G,C,39289827,44845,39048374,39441590,241453
22,ENSG00000100311.12,39244982,22-39289827-G-A,rs79290,-1,G,A,39289827,44845,39048374,39441590,241453
22,ENSG00000184164.10,49918634,22-49919039-C-T,rs79431035,1,C,T,49919039,405,49722026,50115242,197013
22,ENSG00000100036.11,30635781,22-30612806-G-A,rs79711084,1,G,A,30612806,22975,30439173,30832389,173633
22,ENSG00000075234.12,46268008,22-46323157-T-C,rs8135305,1,T,C,46323157,55149,46071400,46464616,251757
22,ENSG00000128346.6,37953601,22-38136281-T-C,rs8135937,-1,T,C,38136281,182680,37756993,38150209,379288
22,ENSG00000130943.5,46263343,22-46195855-A-G,rs8138102,-1,A,G,46195855,67488,46066735,46459951,129120
22,ENSG00000099974.7,23966888,22-23891811-G-A,rs875643,1,G,A,23891811,75077,23770280,24163496,121531
22,ENSG00000099974.7,23966888,22-23891811-G-T,rs875643,1,G,T,23891811,75077,23770280,24163496,121531
22,ENSG00000040608.9,20268318,22-20247294-C-G,rs887765,-1,C,G,20247294,21024,20071710,20464926,175584
22,ENSG00000040608.9,20268318,22-20247294-C-T,rs887765,-1,C,T,20247294,21024,20071710,20464926,175584
22,ENSG00000241878.4,31662215,22-31625190-C-T,rs910549,-1,C,T,31625190,37025,31465607,31858823,159583
22,ENSG00000198832.6,31107568,22-31097139-G-T,rs917208,-1,G,T,31097139,10429,30910960,31304176,186179
22,ENSG00000198832.6,31107568,22-31097139-G-A,rs917208,-1,G,A,31097139,10429,30910960,31304176,186179
22,ENSG00000069998.8,17159277,22-17178262-T-C,rs9306251,-1,T,C,17178262,18985,16962669,17355885,215593
22,ENSG00000138964.10,44180925,22-44181270-G-A,rs9306473,1,G,A,44181270,345,43984317,44377533,196953
22,ENSG00000138964.10,44180925,22-44181270-G-T,rs9306473,1,G,T,44181270,345,43984317,44377533,196953
22,ENSG00000186951.11,46150526,22-45968281-G-C,rs9330813,1,G,C,45968281,182245,45953918,46347134,14363
22,ENSG00000186951.11,46150526,22-45968281-G-A,rs9330813,1,G,A,45968281,182245,45953918,46347134,14363
22,ENSG00000100106.14,37697048,22-37690567-C-A,rs9610834,1,C,A,37690567,6481,37500440,37893656,190127
22,ENSG00000100106.14,37697048,22-37690567-C-T,rs9610834,1,C,T,37690567,6481,37500440,37893656,190127
22,ENSG00000100226.11,38705944,22-38834879-C-T,rs9611034,1,C,T,38834879,128935,38509336,38902552,325543
22,ENSG00000100167.15,41969443,22-41937798-G-A,rs9611693,1,G,A,41937798,31645,41772835,42166051,164963
22,ENSG00000100266.11,43015149,22-42904004-C-A,rs9611959,-1,C,A,42904004,111145,42818541,43211757,85463
22,ENSG00000100266.11,43015149,22-42904004-C-T,rs9611959,-1,C,T,42904004,111145,42818541,43211757,85463
22,ENSG00000184117.7,29581113,22-29585255-G-C,rs9613971,-1,G,C,29585255,4142,29384505,29777721,200750
22,ENSG00000184117.7,29581113,22-29585255-G-A,rs9613971,-1,G,A,29585255,4142,29384505,29777721,200750
22,ENSG00000169314.9,23762990,22-23582882-A-G,rs9620291,1,A,G,23582882,180108,23566382,23959598,16500
22,ENSG00000100196.6,38468096,22-38636343-C-T,rs11089893,1,C,T,38636343,168247,38271488,38664704,364855
22,ENSG00000100299.12,50628152,22-50542911-C-T,rs113637408,-1,C,T,50542911,85241,50431544,50824760,111367
22,ENSG00000100299.12,50628152,22-50542911-C-G,rs113637408,-1,C,G,50542911,85241,50431544,50824760,111367
22,ENSG00000075234.12,46268008,22-46352584-T-C,rs114058457,1,T,C,46352584,84576,46071400,46464616,281184
22,ENSG00000159496.9,23691013,22-23570690-C-T,rs115415403,1,C,T,23570690,120323,23494405,23887621,76285
22,ENSG00000100258.12,50507702,22-50313829-G-A,rs115446109,-1,G,A,50313829,193873,50311094,50704310,2735
22,ENSG00000100258.12,50507702,22-50313829-G-C,rs115446109,-1,G,C,50313829,193873,50311094,50704310,2735
22,ENSG00000099949.13,20982297,22-20888591-A-T,rs116984278,1,A,T,20888591,93706,20785689,21178905,102902
22,ENSG00000099949.13,20982297,22-20888591-A-G,rs116984278,1,A,G,20888591,93706,20785689,21178905,102902
22,ENSG00000077935.12,45413599,22-45446523-G-T,rs11704569,-1,G,T,45446523,32924,45216991,45610207,229532
22,ENSG00000093000.13,45163925,22-45030339-A-G,rs117680337,1,A,G,45030339,133586,44967317,45360533,63022
22,ENSG00000100129.11,37849419,22-37859192-A-G,rs11913731,1,A,G,37859192,9773,37652811,38046027,206381
22,ENSG00000100129.11,37849419,22-37859192-A-C,rs11913731,1,A,C,37859192,9773,37652811,38046027,206381
22,ENSG00000205560.8,50578427,22-50387186-G-A,rs12159089,-1,G,A,50387186,191241,50381819,50775035,5367
22,ENSG00000100347.10,43955442,22-44005991-C-T,rs12160094,1,C,T,44005991,50549,43758834,44152050,247157
22,ENSG00000099994.10,24181487,22-24083240-C-G,rs12166151,1,C,G,24083240,98247,23984879,24378095,98361
22,ENSG00000099994.10,24181487,22-24083240-C-T,rs12166151,1,C,T,24083240,98247,23984879,24378095,98361
22,ENSG00000100124.7,37844334,22-37986297-G-C,rs12170378,-1,G,C,37986297,141963,37647726,38040942,338571
22,ENSG00000100124.7,37844334,22-37986297-G-A,rs12170378,-1,G,A,37986297,141963,37647726,38040942,338571
22,ENSG00000182541.12,31212298,22-31040508-C-T,rs12484974,1,C,T,31040508,171790,31015690,31408906,24818
22,ENSG00000185608.4,19432545,22-19523349-C-T,rs12628900,1,C,T,19523349,90804,19235937,19629153,287412
22,ENSG00000100243.15,42649392,22-42695348-C-T,rs130395,-1,C,T,42695348,45956,42452784,42846000,242564
22,ENSG00000188636.3,44498233,22-44496255-A-G,rs131163,-1,A,G,44496255,1978,44301625,44694841,194630
22,ENSG00000184076.9,29767369,22-29773447-G-A,rs131291,1,G,A,29773447,6078,29570761,29963977,202686
22,ENSG00000025708.8,50530012,22-50586408-G-A,rs131748,-1,G,A,50586408,56396,50333404,50726620,253004
22,ENSG00000025708.8,50530012,22-50586408-G-C,rs131748,-1,G,C,50586408,56396,50333404,50726620,253004
22,ENSG00000185022.7,38201994,22-38165555-T-C,rs132966,1,T,C,38165555,36439,38005386,38398602,160169
22,ENSG00000100321.10,39349991,22-39298220-A-C,rs137603,1,A,C,39298220,51771,39153383,39546599,144837
22,ENSG00000100321.10,39349991,22-39298220-A-G,rs137603,1,A,G,39298220,51771,39153383,39546599,144837
22,ENSG00000100321.10,39349991,22-39298220-A-T,rs137603,1,A,T,39298220,51771,39153383,39546599,144837
22,ENSG00000182858.7,49918438,22-50028113-T-A,rs137890,-1,T,A,50028113,109675,49721830,50115046,306283
22,ENSG00000182858.7,49918438,22-50028113-T-C,rs137890,-1,T,C,50028113,109675,49721830,50115046,306283
22,ENSG00000186976.10,43812305,22-43899544-A-C,rs138141,-1,A,C,43899544,87239,43615697,44008913,283847
22,ENSG00000186976.10,43812305,22-43899544-A-G,rs138141,-1,A,G,43899544,87239,43615697,44008913,283847
22,ENSG00000186976.10,43812305,22-43899544-A-T,rs138141,-1,A,T,43899544,87239,43615697,44008913,283847
22,ENSG00000172404.4,40862113,22-40866848-C-T,rs138351,-1,C,T,40866848,4735,40665505,41058721,201343
22,ENSG00000100380.7,40856639,22-40866848-C-T,rs138351,-1,C,T,40866848,10209,40660031,41053247,206817
22,ENSG00000100304.10,43187134,22-43189842-C-T,rs138963,-1,C,T,43189842,2708,42990526,43383742,199316
22,ENSG00000138964.10,44180925,22-44180205-A-G,rs139123,1,A,G,44180205,720,43984317,44377533,195888
22,ENSG00000138964.10,44180925,22-44180205-A-T,rs139123,1,A,T,44180205,720,43984317,44377533,195888
22,ENSG00000243811.2,39021127,22-39111882-A-T,rs139347,1,A,T,39111882,90755,38824519,39217735,287363
22,ENSG00000243811.2,39021127,22-39111882-A-G,rs139347,1,A,G,39111882,90755,38824519,39217735,287363
22,ENSG00000244509.2,39014257,22-39131904-G-A,rs139383,1,G,A,39131904,117647,38817649,39210865,314255
22,ENSG00000244509.2,39014257,22-39131904-G-T,rs139383,1,G,T,39131904,117647,38817649,39210865,314255
22,ENSG00000100298.11,39097244,22-39164661-G-A,rs139426,1,G,A,39164661,67417,38900636,39293852,264025
22,ENSG00000100147.8,41800679,22-41814981-T-G,rs139568,1,T,G,41814981,14302,41604071,41997287,210910
22,ENSG00000100147.8,41800679,22-41814981-T-C,rs139568,1,T,C,41814981,14302,41604071,41997287,210910
22,ENSG00000184164.10,49918634,22-49758581-T-C,rs139836,1,T,C,49758581,160053,49722026,50115242,36555
22,ENSG00000185838.9,19854874,22-19827686-T-G,rs1468090,-1,T,G,19827686,27188,19658266,20051482,169420
22,ENSG00000100311.12,39244982,22-39373813-T-G,rs1569499,-1,T,G,39373813,128831,39048374,39441590,325439
22,ENSG00000100311.12,39244982,22-39373813-T-C,rs1569499,-1,T,C,39373813,128831,39048374,39441590,325439
22,ENSG00000100311.12,39244982,22-39373813-T-A,rs1569499,-1,T,A,39373813,128831,39048374,39441590,325439
22,ENSG00000185686.13,22559265,22-22604355-G-A,rs16989599,-1,G,A,22604355,45090,22362657,22755873,241698
22,ENSG00000128408.7,45413693,22-45337318-T-C,rs16993867,1,T,C,45337318,76375,45217085,45610301,120233
22,ENSG00000128408.7,45413693,22-45337318-T-A,rs16993867,1,T,A,45337318,76375,45217085,45610301,120233
22,ENSG00000100410.3,41468692,22-41571569-G-A,rs17002501,-1,G,A,41571569,102877,41272084,41665300,299485
22,ENSG00000183172.6,42079700,22-41886008-C-T,rs17002737,1,C,T,41886008,193692,41883092,42276308,2916
22,ENSG00000133433.6,23961195,22-23908648-A-G,rs17004053,-1,A,G,23908648,52547,23764587,24157803,144061
22,ENSG00000183765.14,28741820,22-28740245-C-G,rs17881056,-1,C,G,28740245,1575,28545212,28938428,195033
22,ENSG00000183765.14,28741820,22-28740245-C-T,rs17881056,-1,C,T,28740245,1575,28545212,28938428,195033
22,ENSG00000099956.12,23786966,22-23754487-A-C,rs2070454,1,A,C,23754487,32479,23590358,23983574,164129
22,ENSG00000100226.11,38705944,22-38668204-G-T,rs2072795,1,G,T,38668204,37740,38509336,38902552,158868
22,ENSG00000100226.11,38705944,22-38668204-G-A,rs2072795,1,G,A,38668204,37740,38509336,38902552,158868
22,ENSG00000128253.9,32205073,22-32394411-G-T,rs2072816,-1,G,T,32394411,189338,32008465,32401681,385946
22,ENSG00000128394.12,39040864,22-38891114-G-A,rs2142836,1,G,A,38891114,149750,38844256,39237472,46858
22,ENSG00000133424.14,33920476,22-33900105-A-C,rs2157153,-1,A,C,33900105,20371,33723868,34117084,176237
22,ENSG00000133424.14,33920476,22-33900105-A-T,rs2157153,-1,A,T,33900105,20371,33723868,34117084,176237
22,ENSG00000133424.14,33920476,22-33900105-A-G,rs2157153,-1,A,G,33900105,20371,33723868,34117084,176237
22,ENSG00000183597.11,20021110,22-19995491-G-A,rs2238790,1,G,A,19995491,25619,19824502,20217718,170989
22,ENSG00000100342.15,36253133,22-36265284-G-C,rs2239785,1,G,C,36265284,12151,36056525,36449741,208759
22,ENSG00000100342.15,36253133,22-36265284-G-A,rs2239785,1,G,A,36265284,12151,36056525,36449741,208759
22,ENSG00000093072.10,17219435,22-17207512-G-A,rs2240617,-1,G,A,17207512,11923,17022827,17416043,184685
22,ENSG00000093072.10,17219435,22-17207512-G-C,rs2240617,-1,G,C,17207512,11923,17022827,17416043,184685
22,ENSG00000128294.10,26590132,22-26578776-G-A,rs2267097,-1,G,A,26578776,11356,26393524,26786740,185252
22,ENSG00000100372.10,40819346,22-40861873-T-C,rs2269619,-1,T,C,40861873,42527,40622738,41015954,239135
22,ENSG00000100372.10,40819346,22-40861873-T-G,rs2269619,-1,T,G,40861873,42527,40622738,41015954,239135
22,ENSG00000177096.4,42074248,22-41905010-A-G,rs2269662,1,A,G,41905010,169238,41877640,42270856,27370
22,ENSG00000205593.5,50327012,22-50435189-A-G,rs2273257,-1,A,G,50435189,108177,50130404,50523620,304785
22,ENSG00000205593.5,50327012,22-50435189-A-T,rs2273257,-1,A,T,50435189,108177,50130404,50523620,304785
22,ENSG00000069998.8,17159277,22-17118970-A-C,rs2277830,-1,A,C,17118970,40307,16962669,17355885,156301
22,ENSG00000069998.8,17159277,22-17118970-A-T,rs2277830,-1,A,T,17118970,40307,16962669,17355885,156301
22,ENSG00000100292.12,35381096,22-35393270-A-T,rs2285112,1,A,T,35393270,12174,35184488,35577704,208782
22,ENSG00000100292.12,35381096,22-35393270-A-G,rs2285112,1,A,G,35393270,12174,35184488,35577704,208782
22,ENSG00000100034.8,21952848,22-21994691-C-T,rs238775,-1,C,T,21994691,41843,21756240,22149456,238451
22,ENSG00000100034.8,21952848,22-21994691-C-G,rs238775,-1,C,G,21994691,41843,21756240,22149456,238451
22,ENSG00000100034.8,21952848,22-21994691-C-A,rs238775,-1,C,A,21994691,41843,21756240,22149456,238451
22,ENSG00000100038.14,21982787,22-21985092-G-A,rs238780,-1,G,A,21985092,2305,21786179,22179395,198913
22,ENSG00000100038.14,21982787,22-21985092-G-T,rs238780,-1,G,T,21985092,2305,21786179,22179395,198913
22,ENSG00000183569.12,42553956,22-42500468-T-C,rs2413692,1,T,C,42500468,53488,42357348,42750564,143120
22,ENSG00000183569.12,42553956,22-42500468-T-G,rs2413692,1,T,G,42500468,53488,42357348,42750564,143120
22,ENSG00000183569.12,42553956,22-42500468-T-A,rs2413692,1,T,A,42500468,53488,42357348,42750564,143120
22,ENSG00000128165.7,50481543,22-50296461-C-A,rs28611014,1,C,A,50296461,185082,50284935,50678151,11526
22,ENSG00000128165.7,50481543,22-50296461-C-T,rs28611014,1,C,T,50296461,185082,50284935,50678151,11526
22,ENSG00000198951.6,42070812,22-42134634-G-A,rs28641480,-1,G,A,42134634,63822,41874204,42267420,260430
22,ENSG00000130487.4,50545899,22-50577245-C-T,rs3213446,1,C,T,50577245,31346,50349291,50742507,227954
22,ENSG00000130487.4,50545899,22-50577245-C-A,rs3213446,1,C,A,50577245,31346,50349291,50742507,227954
22,ENSG00000100360.10,36776119,22-36761196-C-G,rs3827351,-1,C,G,36761196,14923,36579511,36972727,181685
22,ENSG00000100360.10,36776119,22-36761196-C-A,rs3827351,-1,C,A,36761196,14923,36579511,36972727,181685
22,ENSG00000099957.11,21015165,22-21065510-C-A,rs410356,1,C,A,21065510,50345,20818557,21211773,246953
22,ENSG00000099957.11,21015165,22-21065510-C-T,rs410356,1,C,T,21065510,50345,20818557,21211773,246953
22,ENSG00000130943.5,46263343,22-46233582-A-G,rs4253776,-1,A,G,46233582,29761,46066735,46459951,166847
22,ENSG00000241973.6,20858811,22-21004233-C-G,rs430305,-1,C,G,21004233,145422,20662203,21055419,342030
22,ENSG00000241973.6,20858811,22-21004233-C-T,rs430305,-1,C,T,21004233,145422,20662203,21055419,342030
22,ENSG00000128274.10,42720870,22-42755757-G-T,rs4820478,-1,G,T,42755757,34887,42524262,42917478,231495
22,ENSG00000128274.10,42720870,22-42755757-G-C,rs4820478,-1,G,C,42755757,34887,42524262,42917478,231495
22,ENSG00000128274.10,42720870,22-42755757-G-A,rs4820478,-1,G,A,42755757,34887,42524262,42917478,231495
22,ENSG00000100263.9,29267981,22-29273659-G-T,rs4820803,-1,G,T,29273659,5678,29071373,29464589,202286
22,ENSG00000100263.9,29267981,22-29273659-G-A,rs4820803,-1,G,A,29273659,5678,29071373,29464589,202286
22,ENSG00000100263.9,29267981,22-29273659-G-C,rs4820803,-1,G,C,29273659,5678,29071373,29464589,202286
22,ENSG00000100116.11,37807934,22-37750578-C-T,rs4821704,1,C,T,37750578,57356,37611326,38004542,139252
22,ENSG00000128272.10,39520562,22-39695542-A-T,rs4821914,1,A,T,39695542,174980,39323954,39717170,371588
22,ENSG00000128272.10,39520562,22-39695542-A-G,rs4821914,1,A,G,39695542,174980,39323954,39717170,371588
22,ENSG00000128272.10,39520562,22-39695542-A-C,rs4821914,1,A,C,39695542,174980,39323954,39717170,371588
22,ENSG00000100218.7,23141990,22-23233455-A-G,rs4822375,-1,A,G,23233455,91465,22945382,23338598,288073
22,ENSG00000100364.13,45240894,22-45131964-C-T,rs547698,-1,C,T,45131964,108930,45044286,45437502,87678
22,ENSG00000100336.13,36201809,22-36238540-A-T,rs55880164,-1,A,T,36238540,36731,36005201,36398417,233339
22,ENSG00000100336.13,36201809,22-36238540-A-C,rs55880164,-1,A,C,36238540,36731,36005201,36398417,233339
22,ENSG00000073169.9,50201011,22-50091421-T-C,rs56144269,1,T,C,50091421,109590,50004403,50397619,87018
22,ENSG00000239713.3,39077275,22-39250417-A-G,rs56229619,1,A,G,39250417,173142,38880667,39273883,369750
22,ENSG00000099968.13,17638757,22-17452446-A-G,rs5747167,1,A,G,17452446,186311,17442149,17835365,10297
22,ENSG00000099953.5,23772849,22-23842663-A-G,rs5751749,1,A,G,23842663,69814,23576241,23969457,266422
22,ENSG00000128218.7,23754425,22-23842663-A-G,rs5751749,-1,A,G,23842663,88238,23557817,23951033,284846
22,ENSG00000244486.2,20437825,22-20470902-A-T,rs5754388,-1,A,T,20470902,33077,20241217,20634433,229685
22,ENSG00000244486.2,20437825,22-20470902-A-G,rs5754388,-1,A,G,20470902,33077,20241217,20634433,229685
22,ENSG00000100365.10,36861006,22-36886051-T-A,rs5756384,1,T,A,36886051,25045,36664398,37057614,221653
22,ENSG00000100365.10,36861006,22-36886051-T-C,rs5756384,1,T,C,36886051,25045,36664398,37057614,221653
22,ENSG00000100368.8,36913628,22-36920217-T-G,rs5756407,1,T,G,36920217,6589,36717020,37110236,203197
22,ENSG00000100368.8,36913628,22-36920217-T-A,rs5756407,1,T,A,36920217,6589,36717020,37110236,203197
22,ENSG00000100368.8,36913628,22-36920217-T-C,rs5756407,1,T,C,36920217,6589,36717020,37110236,203197
22,ENSG00000133466.9,37188247,22-37195621-C-T,rs5756552,-1,C,T,37195621,7374,36991639,37384855,203982
22,ENSG00000183741.7,38872216,22-38910075-T-A,rs5757362,-1,T,A,38910075,37859,38675608,39068824,234467
22,ENSG00000183741.7,38872216,22-38910075-T-C,rs5757362,-1,T,C,38910075,37859,38675608,39068824,234467
22,ENSG00000183741.7,38872216,22-38910075-T-G,rs5757362,-1,T,G,38910075,37859,38675608,39068824,234467
22,ENSG00000100242.11,38755998,22-38951773-A-G,rs5757399,-1,A,G,38951773,195775,38559390,38952606,392383
22,ENSG00000189306.6,42519796,22-42543702-A-T,rs5758798,-1,A,T,42543702,23906,42323188,42716404,220514
22,ENSG00000189306.6,42519796,22-42543702-A-G,rs5758798,-1,A,G,42543702,23906,42323188,42716404,220514
22,ENSG00000184436.7,21002118,22-21054729-C-T,rs5762105,-1,C,T,21054729,52611,20805510,21198726,249219
22,ENSG00000100376.7,45309934,22-45430153-A-G,rs5764726,1,A,G,45430153,120219,45113326,45506542,316827
22,ENSG00000188064.5,45977162,22-46138166-A-G,rs5768939,-1,A,G,46138166,161004,45780554,46173770,357612
22,ENSG00000100350.10,36507040,22-36621199-C-T,rs58301447,-1,C,T,36621199,114159,36310432,36703648,310767
22,ENSG00000100350.10,36507040,22-36621199-C-G,rs58301447,-1,C,G,36621199,114159,36310432,36703648,310767
22,ENSG00000167065.9,30667875,22-30671256-C-T,rs5994332,-1,C,T,30671256,3381,30471267,30864483,199989
22,ENSG00000167065.9,30667875,22-30671256-C-A,rs5994332,-1,C,A,30671256,3381,30471267,30864483,199989
22,ENSG00000100029.12,30591910,22-30718358-C-A,rs5997740,-1,C,A,30718358,126448,30395302,30788518,323056
22,ENSG00000221963.4,35648446,22-35733656-T-G,rs5999988,1,T,G,35733656,85210,35451838,35845054,281818
22,ENSG00000179750.11,38982347,22-39011394-T-G,rs6001376,1,T,G,39011394,29047,38785739,39178955,225655
22,ENSG00000179750.11,38982347,22-39011394-T-C,rs6001376,1,T,C,39011394,29047,38785739,39178955,225655
22,ENSG00000100395.10,41205312,22-41106918-A-T,rs6002260,1,A,T,41106918,98394,41008704,41401920,98214
22,ENSG00000100395.10,41205312,22-41106918-A-G,rs6002260,1,A,G,41106918,98394,41008704,41401920,98214
22,ENSG00000128203.6,26429260,22-26369201-G-A,rs6005031,1,G,A,26369201,60059,26232652,26625868,136549
22,ENSG00000128203.6,26429260,22-26369201-G-C,rs6005031,1,G,C,26369201,60059,26232652,26625868,136549
22,ENSG00000250479.3,23767972,22-23765421-G-A,rs61160578,-1,G,A,23765421,2551,23571364,23964580,194057
22,ENSG00000177989.8,50532498,22-50626933-C-A,rs6151415,-1,C,A,50626933,94435,50335890,50729106,291043
22,ENSG00000100399.11,41240931,22-41325340-C-A,rs62238179,-1,C,A,41325340,84409,41044323,41437539,281017
22,ENSG00000128266.6,23070519,22-23100835-C-A,rs71316787,1,C,A,23100835,30316,22873911,23267127,226924
22,ENSG00000128266.6,23070519,22-23100835-C-G,rs71316787,1,C,G,23100835,30316,22873911,23267127,226924
22,ENSG00000099937.6,20774113,22-20867517-A-G,rs715579,1,A,G,20867517,93404,20577505,20970721,290012
22,ENSG00000184117.7,29581113,22-29581240-G-A,rs71640299,-1,G,A,29581240,127,29384505,29777721,196735
22,ENSG00000100197.15,42130810,22-42085845-G-C,rs7245,-1,G,C,42085845,44965,41934202,42327418,151643
22,ENSG00000100197.15,42130810,22-42085845-G-A,rs7245,-1,G,A,42085845,44965,41934202,42327418,151643
22,ENSG00000182902.8,17563498,22-17727794-T-G,rs725769,1,T,G,17727794,164296,17366890,17760106,360904
22,ENSG00000183307.3,17121360,22-17116878-A-G,rs7289082,-1,A,G,17116878,4482,16924752,17317968,192126
22,ENSG00000185339.4,30607174,22-30608201-G-C,rs7289549,1,G,C,30608201,1027,30410566,30803782,197635
22,ENSG00000128276.6,32357867,22-32408464-T-C,rs7289656,1,T,C,32408464,50597,32161259,32554475,247205
22,ENSG00000185651.10,21567714,22-21724874-C-T,rs7292106,1,C,T,21724874,157160,21371106,21764322,353768
22,ENSG00000099904.11,20131804,22-20214431-C-T,rs730669,1,C,T,20214431,82627,19935196,20328412,279235
22,ENSG00000099904.11,20131804,22-20214431-C-A,rs730669,1,C,A,20214431,82627,19935196,20328412,279235
22,ENSG00000170638.5,50185913,22-50242600-T-C,rs7364173,1,T,C,50242600,56687,49989305,50382521,253295
22,ENSG00000170638.5,50185913,22-50242600-T-G,rs7364173,1,T,G,50242600,56687,49989305,50382521,253295
22,ENSG00000099954.13,17369460,22-17221986-G-T,rs737966,1,G,T,17221986,147474,17172852,17566068,49134
22,ENSG00000099954.13,17369460,22-17221986-G-A,rs737966,1,G,A,17221986,147474,17172852,17566068,49134
22,ENSG00000186998.11,29205896,22-29225139-C-G,rs743920,1,C,G,29225139,19243,29009288,29402504,215851
22,ENSG00000186998.11,29205896,22-29225139-C-T,rs743920,1,C,T,29225139,19243,29009288,29402504,215851
22,ENSG00000128185.5,20320060,22-20168535-C-A,rs74670780,-1,C,A,20168535,151525,20123452,20516668,45083
22,ENSG00000128185.5,20320060,22-20168535-C-T,rs74670780,-1,C,T,20168535,151525,20123452,20516668,45083
22,ENSG00000217442.3,50562919,22-50628562-C-T,rs762668,-1,C,T,50628562,65643,50366311,50759527,262251
22,ENSG00000100276.8,29315697,22-29479783-T-C,rs76393761,-1,T,C,29479783,164086,29119089,29512305,360694
22,ENSG00000131100.8,17628749,22-17583078-A-G,rs78134013,-1,A,G,17583078,45671,17432141,17825357,150937
22,ENSG00000128242.8,30574665,22-30493363-C-A,rs78296405,-1,C,A,30493363,81302,30378057,30771273,115306
22,ENSG00000128242.8,30574665,22-30493363-C-T,rs78296405,-1,C,T,30493363,81302,30378057,30771273,115306
22,ENSG00000099889.9,20016823,22-19931200-G-A,rs79960807,-1,G,A,19931200,85623,19820215,20213431,110985
22,ENSG00000070371.11,19291719,22-19170603-G-A,rs807673,-1,G,A,19170603,121116,19095111,19488327,75492
22,ENSG00000070371.11,19291719,22-19170603-G-C,rs807673,-1,G,C,19170603,121116,19095111,19488327,75492
22,ENSG00000100412.10,41469117,22-41396278-G-T,rs8136493,1,G,T,41396278,72839,41272509,41665725,123769
22,ENSG00000100412.10,41469117,22-41396278-G-A,rs8136493,1,G,A,41396278,72839,41272509,41665725,123769
22,ENSG00000133454.11,25742188,22-25762481-C-T,rs8138918,1,C,T,25762481,20293,25545580,25938796,216901
22,ENSG00000100106.14,37697048,22-37755509-G-A,rs8139381,1,G,A,37755509,58461,37500440,37893656,255069
22,ENSG00000100106.14,37697048,22-37755509-G-C,rs8139381,1,G,C,37755509,58461,37500440,37893656,255069
22,ENSG00000040608.9,20268318,22-20234321-C-G,rs855072,-1,C,G,20234321,33997,20071710,20464926,162611
22,ENSG00000040608.9,20268318,22-20234321-C-A,rs855072,-1,C,A,20234321,33997,20071710,20464926,162611
22,ENSG00000100300.12,43151559,22-43134694-G-C,rs872841,1,G,C,43134694,16865,42954951,43348167,179743
22,ENSG00000100300.12,43151559,22-43134694-G-A,rs872841,1,G,A,43134694,16865,42954951,43348167,179743
22,ENSG00000169314.9,23762990,22-23891275-C-T,rs915591,1,C,T,23891275,128285,23566382,23959598,324893
22,ENSG00000100211.6,38656638,22-38719668-C-T,rs9611012,1,C,T,38719668,63030,38460030,38853246,259638
22,ENSG00000100211.6,38656638,22-38719668-C-A,rs9611012,1,C,A,38719668,63030,38460030,38853246,259638
22,ENSG00000100319.11,29767007,22-29585255-G-A,rs9613971,-1,G,A,29585255,181752,29570399,29963615,14856
22,ENSG00000100319.11,29767007,22-29585255-G-C,rs9613971,-1,G,C,29585255,181752,29570399,29963615,14856
22,ENSG00000188677.9,44024302,22-44170554-G-A,rs9614359,1,G,A,44170554,146252,43827694,44220910,342860
22,ENSG00000188677.9,44024302,22-44170554-G-T,rs9614359,1,G,T,44170554,146252,43827694,44220910,342860
22,ENSG00000100307.8,39152680,22-38997429-C-T,rs9622902,-1,C,T,38997429,155251,38956072,39349288,41357
22,ENSG00000100307.8,39152680,22-38997429-C-A,rs9622902,-1,C,A,38997429,155251,38956072,39349288,41357
21,ENSG00000159267.9,36966669,21-36971999-T-A,rs10084553,-1,T,A,36971999,5330,36770061,37163277,201938
21,ENSG00000159267.9,36966669,21-36971999-T-G,rs10084553,-1,T,G,36971999,5330,36770061,37163277,201938
21,ENSG00000159261.6,36480122,21-36547598-C-T,rs10483034,-1,C,T,36547598,67476,36283514,36676730,264084
21,ENSG00000159261.6,36480122,21-36547598-C-G,rs10483034,-1,C,G,36547598,67476,36283514,36676730,264084
21,ENSG00000182670.9,37073271,21-37153056-T-C,rs1053808,1,T,C,37153056,79785,36876663,37269879,276393
21,ENSG00000160185.9,42403902,21-42416077-G-A,rs11203203,1,G,A,42416077,12175,42207294,42600510,208783
21,ENSG00000170262.8,32298855,21-32262196-C-T,rs112565244,1,C,T,32262196,36659,32102247,32495463,159949
21,ENSG00000234289.3,43565182,21-43372243-G-A,rs117001852,1,G,A,43372243,192939,43368574,43761790,3669
21,ENSG00000184221.8,33070141,21-32985229-C-T,rs11908914,1,C,T,32985229,84912,32873533,33266749,111696
21,ENSG00000184221.8,33070141,21-32985229-C-G,rs11908914,1,C,G,32985229,84912,32873533,33266749,111696
21,ENSG00000184221.8,33070141,21-32985229-C-A,rs11908914,1,C,A,32985229,84912,32873533,33266749,111696
21,ENSG00000157557.7,38805929,21-38783137-C-T,rs1209918,1,C,T,38783137,22792,38609321,39002537,173816
21,ENSG00000157557.7,38805929,21-38783137-C-G,rs1209918,1,C,G,38783137,22792,38609321,39002537,173816
21,ENSG00000185272.9,14216157,21-14095383-T-C,rs12151976,1,T,C,14095383,120774,14019549,14412765,75834
21,ENSG00000185272.9,14216157,21-14095383-T-G,rs12151976,1,T,G,14095383,120774,14019549,14412765,75834
21,ENSG00000177398.12,42071317,21-41979806-T-G,rs12627125,1,T,G,41979806,91511,41874709,42267925,105097
21,ENSG00000157617.12,41954018,21-41781218-A-G,rs12627460,-1,A,G,41781218,172800,41757410,42150626,23808
21,ENSG00000157617.12,41954018,21-41781218-A-C,rs12627460,-1,A,C,41781218,172800,41757410,42150626,23808
21,ENSG00000182093.8,39380326,21-39370990-G-C,rs1554933,1,G,C,39370990,9336,39183718,39576934,187272
21,ENSG00000182093.8,39380326,21-39370990-G-A,rs1554933,1,G,A,39370990,9336,39183718,39576934,187272
21,ENSG00000142173.10,46098112,21-46151261-C-G,rs17292975,1,C,G,46151261,53149,45901504,46294720,249757
21,ENSG00000142173.10,46098112,21-46151261-C-T,rs17292975,1,C,T,46151261,53149,45901504,46294720,249757
21,ENSG00000154719.9,25607481,21-25548682-A-T,rs1740081,-1,A,T,25548682,58799,25410873,25804089,137809
21,ENSG00000154719.9,25607481,21-25548682-A-C,rs1740081,-1,A,C,25548682,58799,25410873,25804089,137809
21,ENSG00000154719.9,25607481,21-25548682-A-G,rs1740081,-1,A,G,25548682,58799,25410873,25804089,137809
21,ENSG00000185437.9,39451970,21-39576934-T-C,rs17751811,1,T,C,39576934,124964,39255362,39648578,321572
21,ENSG00000159131.11,33542117,21-33430303-C-T,rs17879705,-1,C,T,33430303,111814,33345509,33738725,84794
21,ENSG00000141956.8,41879344,21-41767035-C-T,rs199825512,-1,C,T,41767035,112309,41682736,42075952,84299
21,ENSG00000160188.5,42496224,21-42502887-T-C,rs2051329,-1,T,C,42502887,6663,42299616,42692832,203271
21,ENSG00000160188.5,42496224,21-42502887-T-A,rs2051329,-1,T,A,42502887,6663,42299616,42692832,203271
21,ENSG00000156261.7,29073648,21-29073627-G-A,rs2070610,-1,G,A,29073627,21,28877040,29270256,196587
21,ENSG00000160298.13,46323870,21-46461396-A-T,rs2078203,-1,A,T,46461396,137526,46127262,46520478,334134
21,ENSG00000160298.13,46323870,21-46461396-A-G,rs2078203,-1,A,G,46461396,137526,46127262,46520478,334134
21,ENSG00000243646.3,33266367,21-33266554-G-A,rs2239573,1,G,A,33266554,187,33069759,33462975,196795
21,ENSG00000243646.3,33266367,21-33266554-G-C,rs2239573,1,G,C,33266554,187,33069759,33462975,196795
21,ENSG00000182362.9,46286342,21-46194529-A-G,rs2254522,1,A,G,46194529,91813,46089734,46482950,104795
21,ENSG00000159110.14,33229938,21-33259936-C-A,rs2300371,1,C,A,33259936,29998,33033330,33426546,226606
21,ENSG00000159110.14,33229938,21-33259936-C-T,rs2300371,1,C,T,33259936,29998,33033330,33426546,226606
21,ENSG00000183255.7,44873690,21-44855132-A-T,rs235317,-1,A,T,44855132,18558,44677082,45070298,178050
21,ENSG00000183255.7,44873690,21-44855132-A-G,rs235317,-1,A,G,44855132,18558,44677082,45070298,178050
21,ENSG00000183255.7,44873690,21-44855132-A-C,rs235317,-1,A,C,44855132,18558,44677082,45070298,178050
21,ENSG00000155307.13,14546315,21-14525718-T-C,rs2822733,-1,T,C,14525718,20597,14349707,14742923,176011
21,ENSG00000155313.11,15729982,21-15773154-A-G,rs2823484,1,A,G,15773154,43172,15533374,15926590,239780
21,ENSG00000155313.11,15729982,21-15773154-A-T,rs2823484,1,A,T,15773154,43172,15533374,15926590,239780
21,ENSG00000156253.2,29019349,21-29210411-A-G,rs2832258,-1,A,G,29210411,191062,28822741,29215957,387670
21,ENSG00000159055.3,32279049,21-32184240-G-A,rs2833699,-1,G,A,32184240,94809,32082441,32475657,101799
21,ENSG00000142207.5,32393012,21-32321947-A-G,rs2833765,-1,A,G,32321947,71065,32196404,32589620,125543
21,ENSG00000142207.5,32393012,21-32321947-A-T,rs2833765,-1,A,T,32321947,71065,32196404,32589620,125543
21,ENSG00000159128.9,33403413,21-33414268-G-A,rs2834210,1,G,A,33414268,10855,33206805,33600021,207463
21,ENSG00000160207.4,43659488,21-43656562-A-G,rs2838341,-1,A,G,43656562,2926,43462880,43856096,193682
21,ENSG00000160209.12,43719129,21-43794700-G-C,rs2838367,1,G,C,43794700,75571,43522521,43915737,272179
21,ENSG00000160209.12,43719129,21-43794700-G-A,rs2838367,1,G,A,43794700,75571,43522521,43915737,272179
21,ENSG00000160213.5,43776308,21-43794700-G-C,rs2838367,-1,G,C,43794700,18392,43579700,43972916,215000
21,ENSG00000160213.5,43776308,21-43794700-G-A,rs2838367,-1,G,A,43794700,18392,43579700,43972916,215000
21,ENSG00000160285.9,46228774,21-46269820-G-A,rs2839185,-1,G,A,46269820,41046,46032166,46425382,237654
21,ENSG00000160285.9,46228774,21-46269820-G-C,rs2839185,-1,G,C,46269820,41046,46032166,46425382,237654
21,ENSG00000160190.8,42513852,21-42447734-G-T,rs2839519,1,G,T,42447734,66118,42317244,42710460,130490
21,ENSG00000160190.8,42513852,21-42447734-G-A,rs2839519,1,G,A,42447734,66118,42317244,42710460,130490
21,ENSG00000142156.9,45981770,21-45953498-C-T,rs364984,1,C,T,45953498,28272,45785162,46178378,168336
21,ENSG00000160223.12,44240945,21-44245722-G-A,rs3737435,-1,G,A,44245722,4777,44044337,44437553,201385
21,ENSG00000160208.11,43659560,21-43778474-T-G,rs3761385,1,T,G,43778474,118914,43462952,43856168,315522
21,ENSG00000157601.9,41426239,21-41423100-G-C,rs459498,1,G,C,41423100,3139,41229631,41622847,193469
21,ENSG00000157601.9,41426239,21-41423100-G-A,rs459498,1,G,A,41423100,3139,41229631,41622847,193469
21,ENSG00000160216.12,43865223,21-43941214-C-G,rs4819352,1,C,G,43941214,75991,43668615,44061831,272599
21,ENSG00000160216.12,43865223,21-43941214-C-T,rs4819352,1,C,T,43941214,75991,43668615,44061831,272599
21,ENSG00000159212.8,34668994,21-34640365-G-A,rs61419297,1,G,A,34640365,28629,34472386,34865602,167979
21,ENSG00000197381.10,45074580,21-45115223-G-C,rs62216599,1,G,C,45115223,40643,44877972,45271188,237251
21,ENSG00000188992.6,14210955,21-14091635-T-C,rs6516610,-1,T,C,14091635,119320,14014347,14407563,77288
21,ENSG00000142149.4,31873020,21-31779449-C-T,rs67415148,1,C,T,31779449,93571,31676412,32069628,103037
21,ENSG00000160183.8,42396052,21-42386373-C-T,rs71320521,-1,C,T,42386373,9679,42199444,42592660,186929
21,ENSG00000156239.7,28885367,21-28768403-A-C,rs714036,-1,A,C,28768403,116964,28688759,29081975,79644
21,ENSG00000142166.8,33324970,21-33297267-G-T,rs7281762,1,G,T,33297267,27703,33128362,33521578,168905
21,ENSG00000142166.8,33324970,21-33297267-G-C,rs7281762,1,G,C,33297267,27703,33128362,33521578,168905
21,ENSG00000142166.8,33324970,21-33297267-G-A,rs7281762,1,G,A,33297267,27703,33128362,33521578,168905
21,ENSG00000159228.8,36070024,21-36066591-A-G,rs73370485,1,A,G,36066591,3433,35873416,36266632,193175
21,ENSG00000159259.5,36385392,21-36499706-A-G,rs743425,1,A,G,36499706,114314,36188784,36582000,310922
21,ENSG00000160233.5,44455510,21-44345083-C-T,rs75292526,1,C,T,44345083,110427,44258902,44652118,86181
21,ENSG00000241945.2,44107399,21-43988289-A-C,rs76426094,1,A,C,43988289,119110,43910791,44304007,77498
21,ENSG00000241945.2,44107399,21-43988289-A-G,rs76426094,1,A,G,43988289,119110,43910791,44304007,77498
21,ENSG00000160310.11,46635674,21-46661303-A-G,rs76674087,1,A,G,46661303,25629,46439066,46832282,222237
21,ENSG00000142168.9,31659693,21-31850150-C-T,rs77305211,1,C,T,31850150,190457,31463085,31856301,387065
21,ENSG00000159197.2,34364006,21-34263554-A-G,rs78574613,1,A,G,34263554,100452,34167398,34560614,96156
21,ENSG00000159197.2,34364006,21-34263554-A-C,rs78574613,1,A,C,34263554,100452,34167398,34560614,96156
21,ENSG00000141959.11,44300053,21-44304505-G-C,rs8129937,1,G,C,44304505,4452,44103445,44496661,201060
21,ENSG00000141959.11,44300053,21-44304505-G-A,rs8129937,1,G,A,44304505,4452,44103445,44496661,201060
21,ENSG00000159086.10,32771755,21-32936805-T-A,rs8134589,-1,T,A,32936805,165050,32575147,32968363,361658
21,ENSG00000159086.10,32771755,21-32936805-T-G,rs8134589,-1,T,G,32936805,165050,32575147,32968363,361658
21,ENSG00000160284.10,46184459,21-46229888-G-A,rs915804,-1,G,A,46229888,45429,45987851,46381067,242037
21,ENSG00000160284.10,46184459,21-46229888-G-T,rs915804,-1,G,T,46229888,45429,45987851,46381067,242037
21,ENSG00000160284.10,46184459,21-46229888-G-C,rs915804,-1,G,C,46229888,45429,45987851,46381067,242037
21,ENSG00000160193.7,42879539,21-42896893-T-G,rs9974287,-1,T,G,42896893,17354,42682931,43076147,213962
21,ENSG00000160193.7,42879539,21-42896893-T-C,rs9974287,-1,T,C,42896893,17354,42682931,43076147,213962
21,ENSG00000160282.9,46155579,21-46099112-G-T,rs9978055,-1,G,T,46099112,56467,45958971,46352187,140141
21,ENSG00000160183.8,42396052,21-42321320-G-C,rs10084557,-1,G,C,42321320,74732,42199444,42592660,121876
21,ENSG00000160183.8,42396052,21-42321320-G-A,rs10084557,-1,G,A,42321320,74732,42199444,42592660,121876
21,ENSG00000156253.2,29019349,21-29059824-T-A,rs1064019,-1,T,A,29059824,40475,28822741,29215957,237083
21,ENSG00000156253.2,29019349,21-29059824-T-G,rs1064019,-1,T,G,29059824,40475,28822741,29215957,237083
21,ENSG00000160200.12,43075835,21-43071315-C-T,rs11701048,-1,C,T,43071315,4520,42879227,43272443,192088
21,ENSG00000154723.8,25734904,21-25795788-C-G,rs11909849,-1,C,G,25795788,60884,25538296,25931512,257492
21,ENSG00000159197.2,34364006,21-34441944-G-A,rs12483462,1,G,A,34441944,77938,34167398,34560614,274546
21,ENSG00000177692.7,33491716,21-33516397-A-G,rs12626309,-1,A,G,33516397,24681,33295108,33688324,221289
21,ENSG00000177692.7,33491716,21-33516397-A-T,rs12626309,-1,A,T,33516397,24681,33295108,33688324,221289
21,ENSG00000141956.8,41879344,21-41883166-T-A,rs13047344,-1,T,A,41883166,3822,41682736,42075952,200430
21,ENSG00000141956.8,41879344,21-41883166-T-G,rs13047344,-1,T,G,41883166,3822,41682736,42075952,200430
21,ENSG00000160285.9,46228774,21-46313656-T-C,rs13047780,-1,T,C,46313656,84882,46032166,46425382,281490
21,ENSG00000160285.9,46228774,21-46313656-T-A,rs13047780,-1,T,A,46313656,84882,46032166,46425382,281490
21,ENSG00000142178.7,43427131,21-43470597-C-T,rs17004561,-1,C,T,43470597,43466,43230523,43623739,240074
21,ENSG00000160216.12,43865223,21-43879965-G-A,rs17004613,1,G,A,43879965,14742,43668615,44061831,211350
21,ENSG00000142156.9,45981770,21-46072023-G-T,rs17272021,1,G,T,46072023,90253,45785162,46178378,286861
21,ENSG00000188992.6,14210955,21-14122133-C-A,rs1970046,-1,C,A,14122133,88822,14014347,14407563,107786
21,ENSG00000159212.8,34668994,21-34656726-C-G,rs2000436,1,C,G,34656726,12268,34472386,34865602,184340
21,ENSG00000159212.8,34668994,21-34656726-C-T,rs2000436,1,C,T,34656726,12268,34472386,34865602,184340
21,ENSG00000160213.5,43776308,21-43797575-G-A,rs2070537,-1,G,A,43797575,21267,43579700,43972916,217875
21,ENSG00000173276.9,42010360,21-42014253-C-T,rs220196,-1,C,T,42014253,3893,41813752,42206968,200501
21,ENSG00000160193.7,42879539,21-42873634-C-G,rs2248490,-1,C,G,42873634,5905,42682931,43076147,190703
21,ENSG00000159228.8,36070024,21-35969239-A-G,rs2256004,1,A,G,35969239,100785,35873416,36266632,95823
21,ENSG00000183421.6,41767052,21-41653781-G-A,rs2402161,-1,G,A,41653781,113271,41570444,41963660,83337
21,ENSG00000159055.3,32279049,21-32272564-G-A,rs2833753,-1,G,A,32272564,6485,32082441,32475657,190123
21,ENSG00000157557.7,38805929,21-38849241-G-C,rs2836711,1,G,C,38849241,43312,38609321,39002537,239920
21,ENSG00000157557.7,38805929,21-38849241-G-A,rs2836711,1,G,A,38849241,43312,38609321,39002537,239920
21,ENSG00000157557.7,38805929,21-38849241-G-T,rs2836711,1,G,T,38849241,43312,38609321,39002537,239920
21,ENSG00000182240.9,41168160,21-41230161-A-G,rs2837973,1,A,G,41230161,62001,40971552,41364768,258609
21,ENSG00000182240.9,41168160,21-41230161-A-T,rs2837973,1,A,T,41230161,62001,40971552,41364768,258609
21,ENSG00000160284.10,46184459,21-46171242-G-A,rs2839131,-1,G,A,46171242,13217,45987851,46381067,183391
21,ENSG00000160298.13,46323870,21-46236798-T-C,rs2839166,-1,T,C,46236798,87072,46127262,46520478,109536
21,ENSG00000160298.13,46323870,21-46236798-T-A,rs2839166,-1,T,A,46236798,87072,46127262,46520478,109536
21,ENSG00000182362.9,46286342,21-46357307-A-G,rs2839224,1,A,G,46357307,70965,46089734,46482950,267573
21,ENSG00000243646.3,33266367,21-33276503-C-G,rs2849997,1,C,G,33276503,10136,33069759,33462975,206744
21,ENSG00000243646.3,33266367,21-33276503-C-T,rs2849997,1,C,T,33276503,10136,33069759,33462975,206744
21,ENSG00000141959.11,44300053,21-44278679-T-A,rs2850161,1,T,A,44278679,21374,44103445,44496661,175234
21,ENSG00000141959.11,44300053,21-44278679-T-G,rs2850161,1,T,G,44278679,21374,44103445,44496661,175234
21,ENSG00000155307.13,14546315,21-14369803-C-A,rs28699022,-1,C,A,14369803,176512,14349707,14742923,20096
21,ENSG00000155307.13,14546315,21-14369803-C-T,rs28699022,-1,C,T,14369803,176512,14349707,14742923,20096
21,ENSG00000160209.12,43719129,21-43757374-C-T,rs3746954,1,C,T,43757374,38245,43522521,43915737,234853
21,ENSG00000160209.12,43719129,21-43757374-C-A,rs3746954,1,C,A,43757374,38245,43522521,43915737,234853
21,ENSG00000160209.12,43719129,21-43757374-C-G,rs3746954,1,C,G,43757374,38245,43522521,43915737,234853
21,ENSG00000157601.9,41426239,21-41425679-G-C,rs462903,1,G,C,41425679,560,41229631,41622847,196048
21,ENSG00000157601.9,41426239,21-41425679-G-A,rs462903,1,G,A,41425679,560,41229631,41622847,196048
21,ENSG00000157601.9,41426239,21-41425679-G-T,rs462903,1,G,T,41425679,560,41229631,41622847,196048
21,ENSG00000160256.8,44940029,21-45010877-A-C,rs4819012,1,A,C,45010877,70848,44743421,45136637,267456
21,ENSG00000160256.8,44940029,21-45010877-A-G,rs4819012,1,A,G,45010877,70848,44743421,45136637,267456
21,ENSG00000160233.5,44455510,21-44338005-G-A,rs56212056,1,G,A,44338005,117505,44258902,44652118,79103
21,ENSG00000159200.12,34615113,21-34640365-G-A,rs61419297,-1,G,A,34640365,25252,34418505,34811721,221860
21,ENSG00000160188.5,42496224,21-42496947-T-C,rs61747218,-1,T,C,42496947,723,42299616,42692832,197331
21,ENSG00000160190.8,42513852,21-42667621-G-A,rs62215378,1,G,A,42667621,153769,42317244,42710460,350377
21,ENSG00000160185.9,42403902,21-42405366-T-A,rs7282058,1,T,A,42405366,1464,42207294,42600510,198072
21,ENSG00000160185.9,42403902,21-42405366-T-G,rs7282058,1,T,G,42405366,1464,42207294,42600510,198072
21,ENSG00000160185.9,42403902,21-42405366-T-C,rs7282058,1,T,C,42405366,1464,42207294,42600510,198072
21,ENSG00000184012.7,41508158,21-41395858-C-T,rs74688837,-1,C,T,41395858,112300,41311550,41704766,84308
21,ENSG00000154719.9,25607481,21-25618611-A-G,rs762203,-1,A,G,25618611,11130,25410873,25804089,207738
21,ENSG00000160310.11,46635674,21-46607487-T-C,rs76306381,1,T,C,46607487,28187,46439066,46832282,168421
21,ENSG00000159231.5,36135079,21-36101015-G-A,rs79624889,1,G,A,36101015,34064,35938471,36331687,162544
21,ENSG00000183145.4,37006702,21-37070182-T-G,rs8127496,1,T,G,37070182,63480,36810094,37203310,260088
21,ENSG00000183145.4,37006702,21-37070182-T-C,rs8127496,1,T,C,37070182,63480,36810094,37203310,260088
21,ENSG00000182670.9,37073271,21-37075084-A-T,rs8133274,1,A,T,37075084,1813,36876663,37269879,198421
21,ENSG00000182670.9,37073271,21-37075084-A-C,rs8133274,1,A,C,37075084,1813,36876663,37269879,198421
21,ENSG00000182670.9,37073271,21-37075084-A-G,rs8133274,1,A,G,37075084,1813,36876663,37269879,198421
21,ENSG00000184900.10,44818062,21-44806651-T-C,rs8645,-1,T,C,44806651,11411,44621454,45014670,185197
21,ENSG00000184900.10,44818062,21-44806651-T-G,rs8645,-1,T,G,44806651,11411,44621454,45014670,185197
21,ENSG00000160282.9,46155579,21-46149227-G-A,rs9974320,-1,G,A,46149227,6352,45958971,46352187,190256
21,ENSG00000160208.11,43659560,21-43665948-G-A,rs9977076,1,G,A,43665948,6388,43462952,43856168,202996
21,ENSG00000160208.11,43659560,21-43665948-G-T,rs9977076,1,G,T,43665948,6388,43462952,43856168,202996
21,ENSG00000160208.11,43659560,21-43665948-G-C,rs9977076,1,G,C,43665948,6388,43462952,43856168,202996
21,ENSG00000159261.6,36480122,21-36291697-C-T,rs9977444,-1,C,T,36291697,188425,36283514,36676730,8183
21,ENSG00000156273.10,29298922,21-29458073-T-G,rs9981313,1,T,G,29458073,159151,29102314,29495530,355759
21,ENSG00000156273.10,29298922,21-29458073-T-A,rs9981313,1,T,A,29458073,159151,29102314,29495530,355759
21,ENSG00000156239.7,28885367,21-28840396-T-G,rs9981922,-1,T,G,28840396,44971,28688759,29081975,151637
21,ENSG00000156239.7,28885367,21-28840396-T-A,rs9981922,-1,T,A,28840396,44971,28688759,29081975,151637
21,ENSG00000156239.7,28885367,21-28840396-T-C,rs9981922,-1,T,C,28840396,44971,28688759,29081975,151637
21,ENSG00000160194.11,42893309,21-42787179-G-T,rs1001542,1,G,T,42787179,106130,42696701,43089917,90478
21,ENSG00000160194.11,42893309,21-42787179-G-A,rs1001542,1,G,A,42787179,106130,42696701,43089917,90478
21,ENSG00000160194.11,42893309,21-42787179-G-C,rs1001542,1,G,C,42787179,106130,42696701,43089917,90478
21,ENSG00000142166.8,33324970,21-33354946-T-C,rs1041867,1,T,C,33354946,29976,33128362,33521578,226584
21,ENSG00000142166.8,33324970,21-33354946-T-G,rs1041867,1,T,G,33354946,29976,33128362,33521578,226584
21,ENSG00000142207.5,32393012,21-32542835-C-T,rs11088225,-1,C,T,32542835,149823,32196404,32589620,346431
21,ENSG00000142207.5,32393012,21-32542835-C-A,rs11088225,-1,C,A,32542835,149823,32196404,32589620,346431
21,ENSG00000160285.9,46228774,21-46342011-G-A,rs116242815,-1,G,A,46342011,113237,46032166,46425382,309845
21,ENSG00000160310.11,46635674,21-46666657-G-A,rs11700505,1,G,A,46666657,30983,46439066,46832282,227591
21,ENSG00000159055.3,32279049,21-32165541-C-T,rs11700761,-1,C,T,32165541,113508,32082441,32475657,83100
21,ENSG00000156273.10,29298922,21-29402473-G-A,rs11702825,1,G,A,29402473,103551,29102314,29495530,300159
21,ENSG00000185437.9,39451970,21-39488579-C-G,rs117545257,1,C,G,39488579,36609,39255362,39648578,233217
21,ENSG00000185437.9,39451970,21-39488579-C-T,rs117545257,1,C,T,39488579,36609,39255362,39648578,233217
21,ENSG00000160299.11,46324156,21-46328033-C-A,rs11911663,1,C,A,46328033,3877,46127548,46520764,200485
21,ENSG00000160299.11,46324156,21-46328033-C-T,rs11911663,1,C,T,46328033,3877,46127548,46520764,200485
21,ENSG00000160284.10,46184459,21-46313656-T-C,rs13047780,-1,T,C,46313656,129197,45987851,46381067,325805
21,ENSG00000160284.10,46184459,21-46313656-T-A,rs13047780,-1,T,A,46313656,129197,45987851,46381067,325805
21,ENSG00000154645.8,18244833,21-18055170-A-G,rs150056,1,A,G,18055170,189663,18048225,18441441,6945
21,ENSG00000154645.8,18244833,21-18055170-A-C,rs150056,1,A,C,18055170,189663,18048225,18441441,6945
21,ENSG00000155307.13,14546315,21-14569387-C-T,rs1556281,-1,C,T,14569387,23072,14349707,14742923,219680
21,ENSG00000155307.13,14546315,21-14569387-C-A,rs1556281,-1,C,A,14569387,23072,14349707,14742923,219680
21,ENSG00000159140.13,33543038,21-33430303-C-T,rs17879705,1,C,T,33430303,112735,33346430,33739646,83873
21,ENSG00000157601.9,41426239,21-41449186-T-C,rs2070229,1,T,C,41449186,22947,41229631,41622847,219555
21,ENSG00000243646.3,33266367,21-33259936-C-A,rs2300371,1,C,A,33259936,6431,33069759,33462975,190177
21,ENSG00000243646.3,33266367,21-33259936-C-T,rs2300371,1,C,T,33259936,6431,33069759,33462975,190177
21,ENSG00000159228.8,36070024,21-35955356-T-A,rs2776271,1,T,A,35955356,114668,35873416,36266632,81940
21,ENSG00000159228.8,36070024,21-35955356-T-C,rs2776271,1,T,C,35955356,114668,35873416,36266632,81940
21,ENSG00000185272.9,14216157,21-14244308-C-G,rs2822503,1,C,G,14244308,28151,14019549,14412765,224759
21,ENSG00000185272.9,14216157,21-14244308-C-A,rs2822503,1,C,A,14244308,28151,14019549,14412765,224759
21,ENSG00000154727.6,25734972,21-25680563-C-G,rs2829861,1,C,G,25680563,54409,25538364,25931580,142199
21,ENSG00000154719.9,25607481,21-25795738-T-C,rs2829910,-1,T,C,25795738,188257,25410873,25804089,384865
21,ENSG00000154719.9,25607481,21-25795738-T-G,rs2829910,-1,T,G,25795738,188257,25410873,25804089,384865
21,ENSG00000205929.5,32813703,21-33005286-A-G,rs2834063,-1,A,G,33005286,191583,32617095,33010311,388191
21,ENSG00000205929.5,32813703,21-33005286-A-T,rs2834063,-1,A,T,33005286,191583,32617095,33010311,388191
21,ENSG00000205929.5,32813703,21-33005286-A-C,rs2834063,-1,A,C,33005286,191583,32617095,33010311,388191
21,ENSG00000222018.1,34401072,21-34253450-A-T,rs2834424,-1,A,T,34253450,147622,34204464,34597680,48986
21,ENSG00000160213.5,43776308,21-43832957-T-G,rs2838416,-1,T,G,43832957,56649,43579700,43972916,253257
21,ENSG00000160213.5,43776308,21-43832957-T-C,rs2838416,-1,T,C,43832957,56649,43579700,43972916,253257
21,ENSG00000160188.5,42496224,21-42485217-C-T,rs2839535,-1,C,T,42485217,11007,42299616,42692832,185601
21,ENSG00000157557.7,38805929,21-38805129-T-G,rs28420538,1,T,G,38805129,800,38609321,39002537,195808
21,ENSG00000157557.7,38805929,21-38805129-T-C,rs28420538,1,T,C,38805129,800,38609321,39002537,195808
21,ENSG00000183844.12,41316801,21-41280019-T-C,rs3746889,1,T,C,41280019,36782,41120193,41513409,159826
21,ENSG00000182871.9,45405165,21-45504871-C-A,rs3753019,1,C,A,45504871,99706,45208557,45601773,296314
21,ENSG00000182871.9,45405165,21-45504871-C-T,rs3753019,1,C,T,45504871,99706,45208557,45601773,296314
21,ENSG00000182871.9,45405165,21-45504871-C-G,rs3753019,1,C,G,45504871,99706,45208557,45601773,296314
21,ENSG00000159131.11,33542117,21-33491977-T-G,rs3761347,-1,T,G,33491977,50140,33345509,33738725,146468
21,ENSG00000159131.11,33542117,21-33491977-T-C,rs3761347,-1,T,C,33491977,50140,33345509,33738725,146468
21,ENSG00000160223.12,44240945,21-44241460-C-A,rs378299,-1,C,A,44241460,515,44044337,44437553,197123
21,ENSG00000160223.12,44240945,21-44241460-C-T,rs378299,-1,C,T,44241460,515,44044337,44437553,197123
21,ENSG00000160233.5,44455510,21-44434857-C-T,rs45593631,1,C,T,44434857,20653,44258902,44652118,175955
21,ENSG00000159128.9,33403413,21-33542291-G-A,rs4817580,1,G,A,33542291,138878,33206805,33600021,335486
21,ENSG00000182362.9,46286342,21-46250719-C-G,rs4818829,1,C,G,46250719,35623,46089734,46482950,160985
21,ENSG00000182362.9,46286342,21-46250719-C-T,rs4818829,1,C,T,46250719,35623,46089734,46482950,160985
21,ENSG00000160209.12,43719129,21-43729252-T-C,rs6518318,1,T,C,43729252,10123,43522521,43915737,206731
21,ENSG00000159212.8,34668994,21-34628463-C-T,rs66632134,1,C,T,34628463,40531,34472386,34865602,156077
21,ENSG00000142185.11,44353621,21-44508296-C-G,rs7275190,1,C,G,44508296,154675,44157013,44550229,351283
21,ENSG00000142185.11,44353621,21-44508296-C-T,rs7275190,1,C,T,44508296,154675,44157013,44550229,351283
21,ENSG00000154723.8,25734904,21-25881907-C-G,rs7278223,-1,C,G,25881907,147003,25538296,25931512,343611
21,ENSG00000154723.8,25734904,21-25881907-C-T,rs7278223,-1,C,T,25881907,147003,25538296,25931512,343611
21,ENSG00000185808.8,37073071,21-36891330-A-C,rs73214730,-1,A,C,36891330,181741,36876463,37269679,14867
21,ENSG00000185808.8,37073071,21-36891330-A-G,rs73214730,-1,A,G,36891330,181741,36876463,37269679,14867
21,ENSG00000184012.7,41508158,21-41607213-G-A,rs73903452,-1,G,A,41607213,99055,41311550,41704766,295663
21,ENSG00000188992.6,14210955,21-14022450-G-C,rs74532836,-1,G,C,14022450,188505,14014347,14407563,8103
21,ENSG00000170262.8,32298855,21-32123823-G-A,rs76899288,1,G,A,32123823,175032,32102247,32495463,21576
21,ENSG00000170262.8,32298855,21-32123823-G-C,rs76899288,1,G,C,32123823,175032,32102247,32495463,21576
21,ENSG00000183527.6,39183451,21-39140867-A-G,rs8127987,-1,A,G,39140867,42584,38986843,39380059,154024
21,ENSG00000183527.6,39183451,21-39140867-A-C,rs8127987,-1,A,C,39140867,42584,38986843,39380059,154024
21,ENSG00000183527.6,39183451,21-39140867-A-T,rs8127987,-1,A,T,39140867,42584,38986843,39380059,154024
21,ENSG00000159267.9,36966669,21-37000429-G-A,rs8131913,-1,G,A,37000429,33760,36770061,37163277,230368
21,ENSG00000159216.12,35049302,21-35015234-C-T,rs881386,-1,C,T,35015234,34068,34852694,35245910,162540
21,ENSG00000183570.9,45643725,21-45612418-C-A,rs9977111,1,C,A,45612418,31307,45447117,45840333,165301
21,ENSG00000183570.9,45643725,21-45612418-C-T,rs9977111,1,C,T,45612418,31307,45447117,45840333,165301
21,ENSG00000177398.12,42071317,21-41977002-G-A,rs9977968,1,G,A,41977002,94315,41874709,42267925,102293
20,ENSG00000089199.5,5911510,20-5789907-A-C,rs1008493,1,A,C,5789907,121603,5714902,6108118,75005
20,ENSG00000089199.5,5911510,20-5789907-A-G,rs1008493,1,A,G,5789907,121603,5714902,6108118,75005
20,ENSG00000089199.5,5911510,20-5789907-A-T,rs1008493,1,A,T,5789907,121603,5714902,6108118,75005
20,ENSG00000168734.9,44582579,20-44709292-T-G,rs1022923,1,T,G,44709292,126713,44385971,44779187,323321
20,ENSG00000168734.9,44582579,20-44709292-T-A,rs1022923,1,T,A,44709292,126713,44385971,44779187,323321
20,ENSG00000168734.9,44582579,20-44709292-T-C,rs1022923,1,T,C,44709292,126713,44385971,44779187,323321
20,ENSG00000125845.5,6767686,20-6880248-G-A,rs1028394,1,G,A,6880248,112562,6571078,6964294,309170
20,ENSG00000149488.11,2536573,20-2619294-C-A,rs1028442,1,C,A,2619294,82721,2339965,2733181,279329
20,ENSG00000149488.11,2536573,20-2619294-C-T,rs1028442,1,C,T,2619294,82721,2339965,2733181,279329
20,ENSG00000064601.11,45891335,20-46079999-A-G,rs10485438,1,A,G,46079999,188664,45694727,46087943,385272
20,ENSG00000198547.3,32673941,20-32626095-G-C,rs10485499,-1,G,C,32626095,47846,32477333,32870549,148762
20,ENSG00000198547.3,32673941,20-32626095-G-A,rs10485499,-1,G,A,32626095,47846,32477333,32870549,148762
20,ENSG00000124143.6,38601809,20-38614424-A-G,rs10485648,1,A,G,38614424,12615,38405201,38798417,209223
20,ENSG00000166619.7,37527876,20-37435163-T-C,rs11086214,-1,T,C,37435163,92713,37331268,37724484,103895
20,ENSG00000177732.6,325552,20-275844-A-C,rs111450572,1,A,C,275844,49708,128944,522160,146900
20,ENSG00000101146.8,57351255,20-57356538-C-T,rs1138386,1,C,T,57356538,5283,57154647,57547863,201891
20,ENSG00000101146.8,57351255,20-57356538-C-A,rs1138386,1,C,A,57356538,5283,57154647,57547863,201891
20,ENSG00000125531.5,63554159,20-63399750-G-A,rs116844172,1,G,A,63399750,154409,63357551,63750767,42199
20,ENSG00000125531.5,63554159,20-63399750-G-T,rs116844172,1,G,T,63399750,154409,63357551,63750767,42199
20,ENSG00000053438.7,37521250,20-37477926-A-G,rs116949243,1,A,G,37477926,43324,37324642,37717858,153284
20,ENSG00000197457.5,63653424,20-63757025-G-A,rs11697497,-1,G,A,63757025,103601,63456816,63850032,300209
20,ENSG00000171858.11,62387103,20-62392885-C-T,rs11698818,1,C,T,62392885,5782,62190495,62583711,202390
20,ENSG00000101307.11,1620009,20-1619759-C-A,rs117803469,-1,C,A,1619759,250,1423401,1816617,196358
20,ENSG00000101187.10,62642503,20-62561745-C-G,rs11906462,1,C,G,62561745,80758,62445895,62839111,115850
20,ENSG00000101187.10,62642503,20-62561745-C-T,rs11906462,1,C,T,62561745,80758,62445895,62839111,115850
20,ENSG00000101216.6,63627101,20-63769761-C-T,rs12480190,-1,C,T,63769761,142660,63430493,63823709,339268
20,ENSG00000101216.6,63627101,20-63769761-C-G,rs12480190,-1,C,G,63769761,142660,63430493,63823709,339268
20,ENSG00000101470.5,45827312,20-45675532-T-C,rs12481168,-1,T,C,45675532,151780,45630704,46023920,44828
20,ENSG00000101191.11,62926505,20-62917850-A-C,rs13040088,-1,A,C,62917850,8655,62729897,63123113,187953
20,ENSG00000101191.11,62926505,20-62917850-A-G,rs13040088,-1,A,G,62917850,8655,62729897,63123113,187953
20,ENSG00000101191.11,62926505,20-62917850-A-T,rs13040088,-1,A,T,62917850,8655,62729897,63123113,187953
20,ENSG00000089006.11,17968794,20-17968394-T-C,rs146288789,-1,T,C,17968394,400,17772186,18165402,196208
20,ENSG00000197496.4,46709649,20-46794930-C-T,rs1473678,1,C,T,46794930,85281,46513041,46906257,281889
20,ENSG00000089048.9,13784919,20-13721935-T-A,rs1541059,-1,T,A,13721935,62984,13588311,13981527,133624
20,ENSG00000089048.9,13784919,20-13721935-T-C,rs1541059,-1,T,C,13721935,62984,13588311,13981527,133624
20,ENSG00000101365.13,2664216,20-2603685-T-C,rs16987508,-1,T,C,2603685,60531,2467608,2860824,136077
20,ENSG00000101365.13,2664216,20-2603685-T-G,rs16987508,-1,T,G,2603685,60531,2467608,2860824,136077
20,ENSG00000101361.9,2652632,20-2649639-A-C,rs16987862,1,A,C,2649639,2993,2456024,2849240,193615
20,ENSG00000101361.9,2652632,20-2649639-A-G,rs16987862,1,A,G,2649639,2993,2456024,2849240,193615
20,ENSG00000166913.8,44885705,20-45048966-A-G,rs16989628,1,A,G,45048966,163261,44689097,45082313,359869
20,ENSG00000101443.13,45469753,20-45465910-A-C,rs16990209,1,A,C,45465910,3843,45273145,45666361,192765
20,ENSG00000101346.6,32207880,20-32237905-T-C,rs17123088,1,T,C,32237905,30025,32011272,32404488,226633
20,ENSG00000061656.5,35615829,20-35479165-C-T,rs17332774,1,C,T,35479165,136664,35419221,35812437,59944
20,ENSG00000101363.8,37289655,20-37316771-G-T,rs1806940,1,G,T,37316771,27116,37093047,37486263,223724
20,ENSG00000101363.8,37289655,20-37316771-G-A,rs1806940,1,G,A,37316771,27116,37093047,37486263,223724
20,ENSG00000124257.6,45891208,20-45859560-T-G,rs1967656,-1,T,G,45859560,31648,45694600,46087816,164960
20,ENSG00000124257.6,45891208,20-45859560-T-C,rs1967656,-1,T,C,45859560,31648,45694600,46087816,164960
20,ENSG00000124257.6,45891208,20-45859560-T-A,rs1967656,-1,T,A,45859560,31648,45694600,46087816,164960
20,ENSG00000196839.8,44651699,20-44647479-T-A,rs2007515,-1,T,A,44647479,4220,44455091,44848307,192388
20,ENSG00000196839.8,44651699,20-44647479-T-G,rs2007515,-1,T,G,44647479,4220,44455091,44848307,192388
20,ENSG00000196839.8,44651699,20-44647479-T-C,rs2007515,-1,T,C,44647479,4220,44455091,44848307,192388
20,ENSG00000101353.10,37158904,20-37210188-T-C,rs2050091,-1,T,C,37210188,51284,36962296,37355512,247892
20,ENSG00000124171.4,50731580,20-50746645-G-T,rs2064278,1,G,T,50746645,15065,50534972,50928188,211673
20,ENSG00000124171.4,50731580,20-50746645-G-C,rs2064278,1,G,C,50746645,15065,50534972,50928188,211673
20,ENSG00000124243.11,50795061,20-50693178-G-A,rs2065405,1,G,A,50693178,101883,50598453,50991669,94725
20,ENSG00000197586.7,25195712,20-25213313-G-A,rs2076561,1,G,A,25213313,17601,24999104,25392320,214209
20,ENSG00000101266.10,543790,20-349198-T-C,rs2092473,-1,T,C,349198,194592,347182,740398,2016
20,ENSG00000132823.5,44210771,20-44209910-A-T,rs2143606,-1,A,T,44209910,861,44014163,44407379,195747
20,ENSG00000132823.5,44210771,20-44209910-A-G,rs2143606,-1,A,G,44209910,861,44014163,44407379,195747
20,ENSG00000101019.16,35411973,20-35317523-C-T,rs2145082,-1,C,T,35317523,94450,35215365,35608581,102158
20,ENSG00000088882.6,2800627,20-2781082-C-G,rs215525,-1,C,G,2781082,19545,2604019,2997235,177063
20,ENSG00000088882.6,2800627,20-2781082-C-T,rs215525,-1,C,T,2781082,19545,2604019,2997235,177063
20,ENSG00000101181.12,62183028,20-62201219-A-T,rs2184161,1,A,T,62201219,18191,61986420,62379636,214799
20,ENSG00000101181.12,62183028,20-62201219-A-G,rs2184161,1,A,G,62201219,18191,61986420,62379636,214799
20,ENSG00000124145.5,45348424,20-45348351-A-G,rs2228384,-1,A,G,45348351,73,45151816,45545032,196535
20,ENSG00000025772.7,44960397,20-44960400-G-A,rs2234197,-1,G,A,44960400,3,44763789,45157005,196611
20,ENSG00000025772.7,44960397,20-44960400-G-C,rs2234197,-1,G,C,44960400,3,44763789,45157005,196611
20,ENSG00000088854.11,3407669,20-3279722-G-C,rs2236094,-1,G,C,3279722,127947,3211061,3604277,68661
20,ENSG00000101438.3,38724486,20-38767477-A-T,rs2245231,1,A,T,38767477,42991,38527878,38921094,239599
20,ENSG00000101438.3,38724486,20-38767477-A-G,rs2245231,1,A,G,38767477,42991,38527878,38921094,239599
20,ENSG00000242372.2,35284772,20-35280121-G-A,rs2250205,-1,G,A,35280121,4651,35088164,35481380,191957
20,ENSG00000100997.12,25390835,20-25275630-G-T,rs2260997,-1,G,T,25275630,115205,25194227,25587443,81403
20,ENSG00000100997.12,25390835,20-25275630-G-C,rs2260997,-1,G,C,25275630,115205,25194227,25587443,81403
20,ENSG00000088881.13,2693574,20-2839847-C-A,rs2274670,1,C,A,2839847,146273,2496966,2890182,342881
20,ENSG00000088881.13,2693574,20-2839847-C-T,rs2274670,1,C,T,2839847,146273,2496966,2890182,342881
20,ENSG00000101190.8,62861822,20-62857433-T-C,rs2294996,-1,T,C,62857433,4389,62665214,63058430,192219
20,ENSG00000101190.8,62861822,20-62857433-T-A,rs2294996,-1,T,A,62857433,4389,62665214,63058430,192219
20,ENSG00000101246.12,63707976,20-63662662-C-G,rs2297434,-1,C,G,63662662,45314,63511368,63904584,151294
20,ENSG00000101246.12,63707976,20-63662662-C-T,rs2297434,-1,C,T,63662662,45314,63511368,63904584,151294
20,ENSG00000089091.10,18467185,20-18378200-C-T,rs2300808,-1,C,T,18378200,88985,18270577,18663793,107623
20,ENSG00000089091.10,18467185,20-18378200-C-G,rs2300808,-1,C,G,18378200,88985,18270577,18663793,107623
20,ENSG00000089091.10,18467185,20-18378200-C-A,rs2300808,-1,C,A,18378200,88985,18270577,18663793,107623
20,ENSG00000125534.4,63520765,20-63517559-C-T,rs2314639,1,C,T,63517559,3206,63324157,63717373,193402
20,ENSG00000125534.4,63520765,20-63517559-C-G,rs2314639,1,C,G,63517559,3206,63324157,63717373,193402
20,ENSG00000203880.6,64255748,20-64225081-C-T,rs2320358,1,C,T,64225081,30667,64059140,64452356,165941
20,ENSG00000203880.6,64255748,20-64225081-C-A,rs2320358,1,C,A,64225081,30667,64059140,64452356,165941
20,ENSG00000158470.5,49713878,20-49630591-A-G,rs235029,-1,A,G,49630591,83287,49517270,49910486,113321
20,ENSG00000158470.5,49713878,20-49630591-A-T,rs235029,-1,A,T,49630591,83287,49517270,49910486,113321
20,ENSG00000125885.8,5950652,20-5952889-A-G,rs236111,1,A,G,5952889,2237,5754044,6147260,198845
20,ENSG00000125885.8,5950652,20-5952889-A-C,rs236111,1,A,C,5952889,2237,5754044,6147260,198845
20,ENSG00000125966.7,35226690,20-35281932-C-T,rs2425044,1,C,T,35281932,55242,35030082,35423298,251850
20,ENSG00000101161.6,63981132,20-64009856-G-A,rs2427587,1,G,A,64009856,28724,63784524,64177740,225332
20,ENSG00000130590.9,63979642,20-64009856-G-A,rs2427587,-1,G,A,64009856,30214,63783034,64176250,226822
20,ENSG00000101417.7,33720310,20-33789224-G-A,rs2626549,-1,G,A,33789224,68914,33523702,33916918,265522
20,ENSG00000158296.9,46651459,20-46476793-T-C,rs279716,-1,T,C,46476793,174666,46454851,46848067,21942
20,ENSG00000101057.11,43667114,20-43668004-A-C,rs285205,1,A,C,43668004,890,43470506,43863722,197498
20,ENSG00000126001.11,35455598,20-35444024-T-C,rs2889882,1,T,C,35444024,11574,35258990,35652206,185034
20,ENSG00000064787.7,54070594,20-54070647-A-T,rs290391,-1,A,T,54070647,53,53873986,54267202,196661
20,ENSG00000064787.7,54070594,20-54070647-A-G,rs290391,-1,A,G,54070647,53,53873986,54267202,196661
20,ENSG00000131061.9,33731996,20-33676869-C-T,rs3213176,1,C,T,33676869,55127,33535388,33928604,141481
20,ENSG00000197296.5,44311202,20-44337223-C-T,rs3746570,-1,C,T,44337223,26021,44114594,44507810,222629
20,ENSG00000171222.6,35954502,20-35949238-G-T,rs3829829,-1,G,T,35949238,5264,35757894,36151110,191344
20,ENSG00000171222.6,35954502,20-35949238-G-A,rs3829829,-1,G,A,35949238,5264,35757894,36151110,191344
20,ENSG00000198026.5,45972203,20-46011752-C-T,rs3918254,-1,C,T,46011752,39549,45775595,46168811,236157
20,ENSG00000088832.10,1393054,20-1378594-G-C,rs395071,-1,G,C,1378594,14460,1196446,1589662,182148
20,ENSG00000088832.10,1393054,20-1378594-G-A,rs395071,-1,G,A,1378594,14460,1196446,1589662,182148
20,ENSG00000196421.3,64036182,20-63963478-G-A,rs41278228,1,G,A,63963478,72704,63839574,64232790,123904
20,ENSG00000171700.9,64079518,20-63963478-G-A,rs41278228,-1,G,A,63963478,116040,63882910,64276126,80568
20,ENSG00000101052.8,43590937,20-43636013-G-A,rs41296223,1,G,A,43636013,45076,43394329,43787545,241684
20,ENSG00000087586.13,56392215,20-56546532-A-G,rs4257444,-1,A,G,56546532,154317,56195607,56588823,350925
20,ENSG00000100979.10,45912155,20-45910853-G-T,rs441346,-1,G,T,45910853,1302,45715547,46108763,195306
20,ENSG00000100979.10,45912155,20-45910853-G-A,rs441346,-1,G,A,45910853,1302,45715547,46108763,195306
20,ENSG00000100979.10,45912155,20-45910853-G-C,rs441346,-1,G,C,45910853,1302,45715547,46108763,195306
20,ENSG00000125871.9,17969018,20-17967003-G-A,rs4519603,1,G,A,17967003,2015,17772410,18165626,194593
20,ENSG00000125871.9,17969018,20-17967003-G-T,rs4519603,1,G,T,17967003,2015,17772410,18165626,194593
20,ENSG00000101204.10,63361349,20-63352549-G-A,rs45461993,-1,G,A,63352549,8800,63164741,63557957,187808
20,ENSG00000132622.6,3732685,20-3753520-T-C,rs45495794,1,T,C,3753520,20835,3536077,3929293,217443
20,ENSG00000132622.6,3732685,20-3753520-T-G,rs45495794,1,T,G,3753520,20835,3536077,3929293,217443
20,ENSG00000101220.11,3767753,20-3753520-T-C,rs45495794,-1,T,C,3753520,14233,3571145,3964361,182375
20,ENSG00000101220.11,3767753,20-3753520-T-G,rs45495794,-1,T,G,3753520,14233,3571145,3964361,182375
20,ENSG00000131069.13,34876612,20-34875039-A-G,rs45606744,1,A,G,34875039,1573,34680004,35073220,195035
20,ENSG00000183260.5,63861498,20-63882383-C-A,rs4809378,1,C,A,63882383,20885,63664890,64058106,217493
20,ENSG00000183260.5,63861498,20-63882383-C-T,rs4809378,1,C,T,63882383,20885,63664890,64058106,217493
20,ENSG00000244274.3,45408289,20-45397052-T-C,rs4812896,1,T,C,45397052,11237,45211681,45604897,185371
20,ENSG00000101384.6,10673999,20-10789229-T-C,rs4813944,-1,T,C,10789229,115230,10477391,10870607,311838
20,ENSG00000125848.8,14337612,20-14492355-C-G,rs4814308,-1,C,G,14492355,154743,14141004,14534220,351351
20,ENSG00000130684.8,25696853,20-25625733-A-G,rs4815438,-1,A,G,25625733,71120,25500245,25893461,125488
20,ENSG00000101391.14,33401519,20-33225328-C-T,rs4911305,-1,C,T,33225328,176191,33204911,33598127,20417
20,ENSG00000125898.7,833715,20-813863-G-A,rs500066,1,G,A,813863,19852,637107,1030323,176756
20,ENSG00000158480.6,49915529,20-49974428-G-A,rs55700732,-1,G,A,49974428,58899,49718921,50112137,255507
20,ENSG00000158480.6,49915529,20-49974428-G-C,rs55700732,-1,G,C,49974428,58899,49718921,50112137,255507
20,ENSG00000132635.10,2840655,20-2737434-G-A,rs56254520,-1,G,A,2737434,103221,2644047,3037263,93387
20,ENSG00000130702.9,62367312,20-62323188-A-G,rs57627107,-1,A,G,62323188,44124,62170704,62563920,152484
20,ENSG00000196132.7,64164452,20-64097614-C-T,rs6011293,1,C,T,64097614,66838,63967844,64361060,129770
20,ENSG00000125510.11,64080082,20-64097614-C-T,rs6011293,1,C,T,64097614,17532,63883474,64276690,214140
20,ENSG00000132792.14,37694030,20-37677076-G-C,rs6012775,1,G,C,37677076,16954,37497422,37890638,179654
20,ENSG00000124164.11,58389229,20-58433235-T-G,rs6015272,1,T,G,58433235,44006,58192621,58585837,240614
20,ENSG00000124203.5,59163821,20-59172851-C-T,rs6026752,1,C,T,59172851,9030,58967213,59360429,205638
20,ENSG00000101447.8,38926417,20-38869044-A-G,rs6028172,1,A,G,38869044,57373,38729809,39123025,139235
20,ENSG00000198900.5,41028822,20-40996350-G-T,rs6029508,1,G,T,40996350,32472,40832214,41225430,164136
20,ENSG00000149654.5,46308498,20-46311311-A-G,rs6032772,-1,A,G,46311311,2813,46111890,46505106,199421
20,ENSG00000149654.5,46308498,20-46311311-A-T,rs6032772,-1,A,T,46311311,2813,46111890,46505106,199421
20,ENSG00000149654.5,46308498,20-46311311-A-C,rs6032772,-1,A,C,46311311,2813,46111890,46505106,199421
20,ENSG00000125821.7,18588054,20-18592306-A-G,rs6035086,1,A,G,18592306,4252,18391446,18784662,200860
20,ENSG00000198171.7,3204682,20-3210559-G-T,rs6037501,-1,G,T,3210559,5877,3008074,3401290,202485
20,ENSG00000198171.7,3204682,20-3210559-G-A,rs6037501,-1,G,A,3210559,5877,3008074,3401290,202485
20,ENSG00000101265.10,4823608,20-4750376-C-A,rs6037950,-1,C,A,4750376,73232,4627000,5020216,123376
20,ENSG00000101265.10,4823608,20-4750376-C-T,rs6037950,-1,C,T,4750376,73232,4627000,5020216,123376
20,ENSG00000101265.10,4823608,20-4750376-C-G,rs6037950,-1,C,G,4750376,73232,4627000,5020216,123376
20,ENSG00000089063.10,5113076,20-5093191-G-T,rs6038069,-1,G,T,5093191,19885,4916468,5309684,176723
20,ENSG00000089063.10,5113076,20-5093191-G-C,rs6038069,-1,G,C,5093191,19885,4916468,5309684,176723
20,ENSG00000089063.10,5113076,20-5093191-G-A,rs6038069,-1,G,A,5093191,19885,4916468,5309684,176723
20,ENSG00000149346.10,10435305,20-10326437-A-G,rs6039851,1,A,G,10326437,108868,10238697,10631913,87740
20,ENSG00000149346.10,10435305,20-10326437-A-T,rs6039851,1,A,T,10326437,108868,10238697,10631913,87740
20,ENSG00000132640.10,11917893,20-11880667-T-A,rs6040955,1,T,A,11880667,37226,11721285,12114501,159382
20,ENSG00000132640.10,11917893,20-11880667-T-C,rs6040955,1,T,C,11880667,37226,11721285,12114501,159382
20,ENSG00000125868.10,17570075,20-17688541-G-C,rs6044953,1,G,C,17688541,118466,17373467,17766683,315074
20,ENSG00000125868.10,17570075,20-17688541-G-A,rs6044953,1,G,A,17688541,118466,17373467,17766683,315074
20,ENSG00000088970.10,21126082,20-21135350-G-A,rs6047267,1,G,A,21135350,9268,20929474,21322690,205876
20,ENSG00000101003.8,25407673,20-25347907-A-G,rs6050555,1,A,G,25347907,59766,25211065,25604281,136842
20,ENSG00000101236.11,4015558,20-3905270-T-C,rs6052162,-1,T,C,3905270,110288,3818950,4212166,86320
20,ENSG00000101236.11,4015558,20-3905270-T-A,rs6052162,-1,T,A,3905270,110288,3818950,4212166,86320
20,ENSG00000171984.9,5750401,20-5780959-A-G,rs6053676,1,A,G,5780959,30558,5553793,5947009,227166
20,ENSG00000132623.10,10034987,20-10035559-C-T,rs6057110,1,C,T,10035559,572,9838379,10231595,197180
20,ENSG00000132623.10,10034987,20-10035559-C-G,rs6057110,1,C,G,10035559,572,9838379,10231595,197180
20,ENSG00000088305.12,32762385,20-32676281-A-G,rs6057618,1,A,G,32676281,86104,32565777,32958993,110504
20,ENSG00000101000.3,35172072,20-35006423-G-A,rs6060151,1,G,A,35006423,165649,34975464,35368680,30959
20,ENSG00000101000.3,35172072,20-35006423-G-C,rs6060151,1,G,C,35006423,165649,34975464,35368680,30959
20,ENSG00000101000.3,35172072,20-35006423-G-T,rs6060151,1,G,T,35006423,165649,34975464,35368680,30959
20,ENSG00000131044.11,31870634,20-31944240-A-G,rs6061045,1,A,G,31944240,73606,31674026,32067242,270214
20,ENSG00000101306.6,31819356,20-32004423-A-T,rs6061087,1,A,T,32004423,185067,31622748,32015964,381675
20,ENSG00000101306.6,31819356,20-32004423-A-G,rs6061087,1,A,G,32004423,185067,31622748,32015964,381675
20,ENSG00000203896.5,63736664,20-63688889-G-A,rs6062492,1,G,A,63688889,47775,63540056,63933272,148833
20,ENSG00000130584.5,63831264,20-63817967-C-T,rs6062541,-1,C,T,63817967,13297,63634656,64027872,183311
20,ENSG00000130584.5,63831264,20-63817967-C-A,rs6062541,-1,C,A,63817967,13297,63634656,64027872,183311
20,ENSG00000149636.9,36773763,20-36693605-C-A,rs6065197,-1,C,A,36693605,80158,36577155,36970371,116450
20,ENSG00000101158.7,58981256,20-58988006-C-T,rs6070684,1,C,T,58988006,6750,58784648,59177864,203358
20,ENSG00000101442.8,38748460,20-38815578-G-T,rs6071589,1,G,T,38815578,67118,38551852,38945068,263726
20,ENSG00000101442.8,38748460,20-38815578-G-C,rs6071589,1,G,C,38815578,67118,38551852,38945068,263726
20,ENSG00000101442.8,38748460,20-38815578-G-A,rs6071589,1,G,A,38815578,67118,38551852,38945068,263726
20,ENSG00000124116.14,45791883,20-45773476-A-C,rs6073905,-1,A,C,45773476,18407,45595275,45988491,178201
20,ENSG00000124116.14,45791883,20-45773476-A-T,rs6073905,-1,A,T,45773476,18407,45595275,45988491,178201
20,ENSG00000178726.5,23049672,20-23040960-T-C,rs6076013,-1,T,C,23040960,8712,22853064,23246280,187896
20,ENSG00000154930.9,25058139,20-25084882-G-A,rs6076315,-1,G,A,25084882,26743,24861531,25254747,223351
20,ENSG00000101298.9,1266294,20-1175210-T-C,rs6078022,1,T,C,1175210,91084,1069686,1462902,105524
20,ENSG00000196476.7,290750,20-274210-G-T,rs6081660,-1,G,T,274210,16540,94142,487358,180068
20,ENSG00000196476.7,290750,20-274210-G-C,rs6081660,-1,G,C,274210,16540,94142,487358,180068
20,ENSG00000196476.7,290750,20-274210-G-A,rs6081660,-1,G,A,274210,16540,94142,487358,180068
20,ENSG00000125834.8,2101827,20-2098177-G-C,rs6081944,1,G,C,2098177,3650,1905219,2298435,192958
20,ENSG00000125834.8,2101827,20-2098177-G-A,rs6081944,1,G,A,2098177,3650,1905219,2298435,192958
20,ENSG00000124151.11,47501887,20-47633848-G-A,rs6094754,1,G,A,47633848,131961,47305279,47698495,328569
20,ENSG00000124151.11,47501887,20-47633848-G-C,rs6094754,1,G,C,47633848,131961,47305279,47698495,328569
20,ENSG00000149596.6,44187188,20-44198070-C-T,rs6103674,-1,C,T,44198070,10882,43990580,44383796,207490
20,ENSG00000175121.7,45115162,20-45279657-T-C,rs6104093,-1,T,C,45279657,164495,44918554,45311770,361103
20,ENSG00000101457.8,45791954,20-45747557-T-C,rs6104325,1,T,C,45747557,44397,45595346,45988562,152211
20,ENSG00000101457.8,45791954,20-45747557-T-G,rs6104325,1,T,G,45747557,44397,45595346,45988562,152211
20,ENSG00000125827.4,8019761,20-8022945-A-T,rs6108092,-1,A,T,8022945,3184,7823153,8216369,199792
20,ENSG00000125875.8,462533,20-628723-G-A,rs6116853,-1,G,A,628723,166190,265925,659141,362798
20,ENSG00000101367.8,32819954,20-32861043-G-C,rs6120005,1,G,C,32861043,41089,32623346,33016562,237697
20,ENSG00000101367.8,32819954,20-32861043-G-A,rs6120005,1,G,A,32861043,41089,32623346,33016562,237697
20,ENSG00000100983.5,34955806,20-34900968-C-T,rs6120757,-1,C,T,34900968,54838,34759198,35152414,141770
20,ENSG00000100983.5,34955806,20-34900968-C-G,rs6120757,-1,C,G,34900968,54838,34759198,35152414,141770
20,ENSG00000130589.11,63572455,20-63755534-C-G,rs6122161,-1,C,G,63755534,183079,63375847,63769063,379687
20,ENSG00000130589.11,63572455,20-63755534-C-A,rs6122161,-1,C,A,63755534,183079,63375847,63769063,379687
20,ENSG00000132819.12,57391396,20-57260984-G-A,rs6123685,1,G,A,57260984,130412,57194788,57588004,66196
20,ENSG00000124226.6,49936397,20-50124635-A-G,rs6125909,1,A,G,50124635,188238,49739789,50133005,384846
20,ENSG00000089177.12,16573448,20-16564714-T-C,rs6135798,-1,T,C,16564714,8734,16376840,16770056,187874
20,ENSG00000089177.12,16573448,20-16564714-T-A,rs6135798,-1,T,A,16564714,8734,16376840,16770056,187874
20,ENSG00000089177.12,16573448,20-16564714-T-G,rs6135798,-1,T,G,16564714,8734,16376840,16770056,187874
20,ENSG00000132661.3,23350791,20-23408490-C-G,rs6137938,1,C,G,23408490,57699,23154183,23547399,254307
20,ENSG00000132661.3,23350791,20-23408490-C-T,rs6137938,1,C,T,23408490,57699,23154183,23547399,254307
20,ENSG00000125901.5,3046052,20-3039907-A-G,rs6138988,1,A,G,3039907,6145,2849444,3242660,190463
20,ENSG00000089057.10,5001510,20-4996819-A-T,rs6139606,-1,A,T,4996819,4691,4804902,5198118,191917
20,ENSG00000089057.10,5001510,20-4996819-A-G,rs6139606,-1,A,G,4996819,4691,4804902,5198118,191917
20,ENSG00000171940.8,53593839,20-53570298-G-A,rs61744628,-1,G,A,53570298,23541,53397231,53790447,173067
20,ENSG00000132825.5,59940305,20-60102366-G-A,rs622705,-1,G,A,60102366,162061,59743697,60136913,358669
20,ENSG00000125818.10,1118602,20-1136156-G-A,rs6514115,1,G,A,1136156,17554,921994,1315210,214162
20,ENSG00000092758.10,62817050,20-62831150-G-C,rs66658258,1,G,C,62831150,14100,62620442,63013658,210708
20,ENSG00000092758.10,62817050,20-62831150-G-T,rs66658258,1,G,T,62831150,14100,62620442,63013658,210708
20,ENSG00000088888.12,3846834,20-3862380-C-T,rs7262903,1,C,T,3862380,15546,3650226,4043442,212154
20,ENSG00000088888.12,3846834,20-3862380-C-A,rs7262903,1,C,A,3862380,15546,3650226,4043442,212154
20,ENSG00000077984.4,24949269,20-25039866-C-T,rs7268879,1,C,T,25039866,90597,24752661,25145877,287205
20,ENSG00000077984.4,24949269,20-25039866-C-A,rs7268879,1,C,A,25039866,90597,24752661,25145877,287205
20,ENSG00000088766.6,6006123,20-5809945-A-G,rs73073217,1,A,G,5809945,196178,5809515,6202731,430
20,ENSG00000149599.10,31870527,20-31916432-C-T,rs73102622,-1,C,T,31916432,45905,31673919,32067135,242513
20,ENSG00000149599.10,31870527,20-31916432-C-G,rs73102622,-1,C,G,31916432,45905,31673919,32067135,242513
20,ENSG00000149474.7,18137863,20-18018768-C-T,rs74504750,1,C,T,18018768,119095,17941255,18334471,77513
20,ENSG00000020256.14,52191779,20-52076402-G-A,rs74835713,-1,G,A,52076402,115377,51995171,52388387,81231
20,ENSG00000020256.14,52191779,20-52076402-G-C,rs74835713,-1,G,C,52076402,115377,51995171,52388387,81231
20,ENSG00000101400.5,33443763,20-33297333-C-T,rs75456555,-1,C,T,33297333,146430,33247155,33640371,50178
20,ENSG00000171867.11,4686456,20-4612395-G-A,rs77505740,1,G,A,4612395,74061,4489848,4883064,122547
20,ENSG00000132669.8,19758258,20-19665058-A-G,rs78829187,1,A,G,19665058,93200,19561650,19954866,103408
20,ENSG00000259399.1,36574553,20-36387975-C-T,rs80117149,1,C,T,36387975,186578,36377945,36771161,10030
20,ENSG00000132821.7,37903127,20-37947622-T-G,rs8122593,1,T,G,37947622,44495,37706519,38099735,241103
20,ENSG00000101439.4,23637955,20-23652139-T-C,rs8122922,-1,T,C,23652139,14184,23441347,23834563,210792
20,ENSG00000171703.12,64063198,20-64050264-G-C,rs8125759,1,G,C,64050264,12934,63866590,64259806,183674
20,ENSG00000171703.12,64063198,20-64050264-G-A,rs8125759,1,G,A,64050264,12934,63866590,64259806,183674
20,ENSG00000196700.3,63969930,20-63966341-T-G,rs817329,-1,T,G,63966341,3589,63773322,64166538,193019
20,ENSG00000125877.6,3209498,20-3213332-G-A,rs8362,1,G,A,3213332,3834,3012890,3406106,200442
20,ENSG00000198185.6,46513559,20-46513194-T-C,rs847052,-1,T,C,46513194,365,46316951,46710167,196243
20,ENSG00000124194.10,44247308,20-44117885-C-T,rs875669,1,C,T,44117885,129423,44050700,44443916,67185
20,ENSG00000124194.10,44247308,20-44117885-C-A,rs875669,1,C,A,44117885,129423,44050700,44443916,67185
20,ENSG00000124194.10,44247308,20-44117885-C-G,rs875669,1,C,G,44117885,129423,44050700,44443916,67185
20,ENSG00000149679.6,62407285,20-62387999-T-C,rs911077,-1,T,C,62387999,19286,62210677,62603893,177322
20,ENSG00000149679.6,62407285,20-62387999-T-G,rs911077,-1,T,G,62387999,19286,62210677,62603893,177322
20,ENSG00000089050.9,18497225,20-18444182-T-A,rs932580,-1,T,A,18444182,53043,18300617,18693833,143565
20,ENSG00000089050.9,18497225,20-18444182-T-C,rs932580,-1,T,C,18444182,53043,18300617,18693833,143565
20,ENSG00000124143.6,38601809,20-38603366-A-G,rs1005611,1,A,G,38603366,1557,38405201,38798417,198165
20,ENSG00000124143.6,38601809,20-38603366-A-C,rs1005611,1,A,C,38603366,1557,38405201,38798417,198165
20,ENSG00000124143.6,38601809,20-38603366-A-T,rs1005611,1,A,T,38603366,1557,38405201,38798417,198165
20,ENSG00000124226.6,49936397,20-49794892-A-T,rs11086294,1,A,T,49794892,141505,49739789,50133005,55103
20,ENSG00000124226.6,49936397,20-49794892-A-G,rs11086294,1,A,G,49794892,141505,49739789,50133005,55103
20,ENSG00000101079.15,36746090,20-36860602-A-G,rs1146264,-1,A,G,36860602,114512,36549482,36942698,311120
20,ENSG00000259399.1,36574553,20-36548138-G-C,rs11553089,1,G,C,36548138,26415,36377945,36771161,170193
20,ENSG00000259399.1,36574553,20-36548138-G-A,rs11553089,1,G,A,36548138,26415,36377945,36771161,170193
20,ENSG00000101191.11,62926505,20-63094999-G-T,rs115905170,-1,G,T,63094999,168494,62729897,63123113,365102
20,ENSG00000101191.11,62926505,20-63094999-G-A,rs115905170,-1,G,A,63094999,168494,62729897,63123113,365102
20,ENSG00000125877.6,3209498,20-3203925-T-C,rs11697114,1,T,C,3203925,5573,3012890,3406106,191035
20,ENSG00000100997.12,25390835,20-25275962-A-G,rs11697384,-1,A,G,25275962,114873,25194227,25587443,81735
20,ENSG00000100997.12,25390835,20-25275962-A-T,rs11697384,-1,A,T,25275962,114873,25194227,25587443,81735
20,ENSG00000100997.12,25390835,20-25275962-A-C,rs11697384,-1,A,C,25275962,114873,25194227,25587443,81735
20,ENSG00000124198.7,48921711,20-48743066-G-A,rs11698214,1,G,A,48743066,178645,48725103,49118319,17963
20,ENSG00000080189.9,46364425,20-46338630-C-T,rs117340525,-1,C,T,46338630,25795,46167817,46561033,170813
20,ENSG00000080189.9,46364425,20-46338630-C-A,rs117340525,-1,C,A,46338630,25795,46167817,46561033,170813
20,ENSG00000158470.5,49713878,20-49621804-C-T,rs11905762,-1,C,T,49621804,92074,49517270,49910486,104534
20,ENSG00000182463.7,52972358,20-53168163-G-C,rs1293395,1,G,C,53168163,195805,52775750,53168966,392413
20,ENSG00000182463.7,52972358,20-53168163-G-T,rs1293395,1,G,T,53168163,195805,52775750,53168966,392413
20,ENSG00000172264.12,13995516,20-13898653-T-C,rs13039593,1,T,C,13898653,96863,13798908,14192124,99745
20,ENSG00000124225.11,57710015,20-57677900-C-T,rs157093,-1,C,T,57677900,32115,57513407,57906623,164493
20,ENSG00000087589.12,56412260,20-56403979-G-A,rs16979884,1,G,A,56403979,8281,56215652,56608868,188327
20,ENSG00000132661.3,23350791,20-23377301-C-T,rs16985298,1,C,T,23377301,26510,23154183,23547399,223118
20,ENSG00000132793.6,41340821,20-41340348-A-G,rs16985665,1,A,G,41340348,473,41144213,41537429,196135
20,ENSG00000101452.8,38962344,20-38996372-A-C,rs16987738,1,A,C,38996372,34028,38765736,39158952,230636
20,ENSG00000101443.13,45469753,20-45447684-C-T,rs16990157,1,C,T,45447684,22069,45273145,45666361,174539
20,ENSG00000124217.3,50958818,20-51121367-A-G,rs16995757,1,A,G,51121367,162549,50762210,51155426,359157
20,ENSG00000075043.12,63472655,20-63500615-A-G,rs1741614,-1,A,G,63500615,27960,63276047,63669263,224568
20,ENSG00000075043.12,63472655,20-63500615-A-T,rs1741614,-1,A,T,63500615,27960,63276047,63669263,224568
20,ENSG00000075043.12,63472655,20-63500615-A-C,rs1741614,-1,A,C,63500615,27960,63276047,63669263,224568
20,ENSG00000100985.6,46008908,20-46011586-A-T,rs17576,1,A,T,46011586,2678,45812300,46205516,199286
20,ENSG00000100985.6,46008908,20-46011586-A-C,rs17576,1,A,C,46011586,2678,45812300,46205516,199286
20,ENSG00000100985.6,46008908,20-46011586-A-G,rs17576,1,A,G,46011586,2678,45812300,46205516,199286
20,ENSG00000132664.7,18467390,20-18635720-T-G,rs17735473,1,T,G,18635720,168330,18270782,18663998,364938
20,ENSG00000101000.3,35172072,20-35171469-C-A,rs2069940,1,C,A,35171469,603,34975464,35368680,196005
20,ENSG00000101000.3,35172072,20-35171469-C-G,rs2069940,1,C,G,35171469,603,34975464,35368680,196005
20,ENSG00000124145.5,45348424,20-45330210-A-T,rs2070639,-1,A,T,45330210,18214,45151816,45545032,178394
20,ENSG00000124145.5,45348424,20-45330210-A-C,rs2070639,-1,A,C,45330210,18214,45151816,45545032,178394
20,ENSG00000088970.10,21126082,20-21195965-C-T,rs2144782,1,C,T,21195965,69883,20929474,21322690,266491
20,ENSG00000088970.10,21126082,20-21195965-C-G,rs2144782,1,C,G,21195965,69883,20929474,21322690,266491
20,ENSG00000124155.11,45416141,20-45375150-G-T,rs2231622,1,G,T,45375150,40991,45219533,45612749,155617
20,ENSG00000126001.11,35455598,20-35514360-T-C,rs2236159,1,T,C,35514360,58762,35258990,35652206,255370
20,ENSG00000126001.11,35455598,20-35514360-T-A,rs2236159,1,T,A,35514360,58762,35258990,35652206,255370
20,ENSG00000203883.5,64049639,20-64200172-T-C,rs2253857,-1,T,C,64200172,150533,63853031,64246247,347141
20,ENSG00000203883.5,64049639,20-64200172-T-A,rs2253857,-1,T,A,64200172,150533,63853031,64246247,347141
20,ENSG00000198171.7,3204682,20-3195048-G-C,rs2295550,-1,G,C,3195048,9634,3008074,3401290,186974
20,ENSG00000198171.7,3204682,20-3195048-G-A,rs2295550,-1,G,A,3195048,9634,3008074,3401290,186974
20,ENSG00000175121.7,45115162,20-44998672-G-T,rs2299973,-1,G,T,44998672,116490,44918554,45311770,80118
20,ENSG00000175121.7,45115162,20-44998672-G-A,rs2299973,-1,G,A,44998672,116490,44918554,45311770,80118
20,ENSG00000203880.6,64255748,20-64221417-G-A,rs23602,1,G,A,64221417,34331,64059140,64452356,162277
20,ENSG00000203880.6,64255748,20-64221417-G-T,rs23602,1,G,T,64221417,34331,64059140,64452356,162277
20,ENSG00000171858.11,62387103,20-62429751-G-A,rs2427336,1,G,A,62429751,42648,62190495,62583711,239256
20,ENSG00000244274.3,45408289,20-45424429-T-A,rs2741566,1,T,A,45424429,16140,45211681,45604897,212748
20,ENSG00000244274.3,45408289,20-45424429-T-C,rs2741566,1,T,C,45424429,16140,45211681,45604897,212748
20,ENSG00000124256.9,57620426,20-57566235-T-C,rs28359554,-1,T,C,57566235,54191,57423818,57817034,142417
20,ENSG00000149657.13,62122475,20-61999289-G-A,rs28382112,1,G,A,61999289,123186,61925867,62319083,73422
20,ENSG00000088305.12,32762385,20-32686035-G-A,rs28581854,1,G,A,32686035,76350,32565777,32958993,120258
20,ENSG00000124253.8,57561110,20-57486798-C-T,rs2865382,1,C,T,57486798,74312,57364502,57757718,122296
20,ENSG00000064787.7,54070594,20-53905181-A-C,rs2904376,-1,A,C,53905181,165413,53873986,54267202,31195
20,ENSG00000064787.7,54070594,20-53905181-A-G,rs2904376,-1,A,G,53905181,165413,53873986,54267202,31195
20,ENSG00000064787.7,54070594,20-53905181-A-T,rs2904376,-1,A,T,53905181,165413,53873986,54267202,31195
20,ENSG00000101132.5,54208087,20-54068702-C-T,rs290448,1,C,T,54068702,139385,54011479,54404695,57223
20,ENSG00000125870.6,16730026,20-16742280-T-C,rs3171297,1,T,C,16742280,12254,16533418,16926634,208862
20,ENSG00000125870.6,16730026,20-16742280-T-G,rs3171297,1,T,G,16742280,12254,16533418,16926634,208862
20,ENSG00000125967.11,33674428,20-33678328-C-T,rs35385772,-1,C,T,33678328,3900,33477820,33871036,200508
20,ENSG00000101082.9,36646196,20-36794533-G-A,rs35707272,-1,G,A,36794533,148337,36449588,36842804,344945
20,ENSG00000101082.9,36646196,20-36794533-G-T,rs35707272,-1,G,T,36794533,148337,36449588,36842804,344945
20,ENSG00000100979.10,45912155,20-45963725-C-T,rs3746511,-1,C,T,45963725,51570,45715547,46108763,248178
20,ENSG00000124160.7,46089962,20-45965589-G-A,rs3746513,-1,G,A,45965589,124373,45893354,46286570,72235
20,ENSG00000185019.12,3159865,20-3234173-T-C,rs3827075,-1,T,C,3234173,74308,2963257,3356473,270916
20,ENSG00000185019.12,3159865,20-3234173-T-G,rs3827075,-1,T,G,3234173,74308,2963257,3356473,270916
20,ENSG00000185019.12,3159865,20-3234173-T-A,rs3827075,-1,T,A,3234173,74308,2963257,3356473,270916
20,ENSG00000196421.3,64036182,20-64036665-C-T,rs3829704,1,C,T,64036665,483,63839574,64232790,197091
20,ENSG00000101473.11,45857392,20-45704234-G-A,rs386196,-1,G,A,45704234,153158,45660784,46054000,43450
20,ENSG00000125868.10,17570075,20-17642031-C-T,rs41276398,1,C,T,17642031,71956,17373467,17766683,268564
20,ENSG00000101161.6,63981132,20-63963478-G-A,rs41278228,1,G,A,63963478,17654,63784524,64177740,178954
20,ENSG00000130590.9,63979642,20-63963478-G-A,rs41278228,-1,G,A,63963478,16164,63783034,64176250,180444
20,ENSG00000125991.12,35542078,20-35603048-C-T,rs41293082,1,C,T,35603048,60970,35345470,35738686,257578
20,ENSG00000158480.6,49915529,20-49896699-C-G,rs471054,-1,C,G,49896699,18830,49718921,50112137,177778
20,ENSG00000158480.6,49915529,20-49896699-C-T,rs471054,-1,C,T,49896699,18830,49718921,50112137,177778
20,ENSG00000197457.5,63653424,20-63829952-C-T,rs4809367,-1,C,T,63829952,176528,63456816,63850032,373136
20,ENSG00000197457.5,63653424,20-63829952-C-A,rs4809367,-1,C,A,63829952,176528,63456816,63850032,373136
20,ENSG00000101407.8,38033456,20-37874901-C-T,rs4809875,-1,C,T,37874901,158555,37836848,38230064,38053
20,ENSG00000101407.8,38033456,20-37874901-C-A,rs4809875,-1,C,A,37874901,158555,37836848,38230064,38053
20,ENSG00000101407.8,38033456,20-37874901-C-G,rs4809875,-1,C,G,37874901,158555,37836848,38230064,38053
20,ENSG00000132792.14,37694030,20-37874901-C-T,rs4809875,1,C,T,37874901,180871,37497422,37890638,377479
20,ENSG00000132792.14,37694030,20-37874901-C-A,rs4809875,1,C,A,37874901,180871,37497422,37890638,377479
20,ENSG00000132792.14,37694030,20-37874901-C-G,rs4809875,1,C,G,37874901,180871,37497422,37890638,377479
20,ENSG00000125818.10,1118602,20-1117104-T-A,rs4813031,1,T,A,1117104,1498,921994,1315210,195110
20,ENSG00000125818.10,1118602,20-1117104-T-G,rs4813031,1,T,G,1117104,1498,921994,1315210,195110
20,ENSG00000089177.12,16573448,20-16622951-A-G,rs4813231,-1,A,G,16622951,49503,16376840,16770056,246111
20,ENSG00000125843.6,3820547,20-3846641-T-C,rs4813647,1,T,C,3846641,26094,3623939,4017155,222702
20,ENSG00000088826.12,4148828,20-4112605-C-T,rs4813670,1,C,T,4112605,36223,3952220,4345436,160385
20,ENSG00000088876.7,2508915,20-2493435-T-A,rs4815270,-1,T,A,2493435,15480,2312307,2705523,181128
20,ENSG00000088876.7,2508915,20-2493435-T-C,rs4815270,-1,T,C,2493435,15480,2312307,2705523,181128
20,ENSG00000154930.9,25058139,20-25055075-G-T,rs4815364,-1,G,T,25055075,3064,24861531,25254747,193544
20,ENSG00000154930.9,25058139,20-25055075-G-A,rs4815364,-1,G,A,25055075,3064,24861531,25254747,193544
20,ENSG00000125841.7,347111,20-409340-C-T,rs4815586,1,C,T,409340,62229,150503,543719,258837
20,ENSG00000125841.7,347111,20-409340-C-A,rs4815586,1,C,A,409340,62229,150503,543719,258837
20,ENSG00000101265.10,4823608,20-4807525-A-G,rs4815745,-1,A,G,4807525,16083,4627000,5020216,180525
20,ENSG00000149600.6,32743467,20-32787505-A-G,rs4911108,-1,A,G,32787505,44038,32546859,32940075,240646
20,ENSG00000149600.6,32743467,20-32787505-A-C,rs4911108,-1,A,C,32787505,44038,32546859,32940075,240646
20,ENSG00000149600.6,32743467,20-32787505-A-T,rs4911108,-1,A,T,32787505,44038,32546859,32940075,240646
20,ENSG00000101181.12,62183028,20-62197527-G-C,rs4925354,1,G,C,62197527,14499,61986420,62379636,211107
20,ENSG00000101181.12,62183028,20-62197527-G-T,rs4925354,1,G,T,62197527,14499,61986420,62379636,211107
20,ENSG00000101181.12,62183028,20-62197527-G-A,rs4925354,1,G,A,62197527,14499,61986420,62379636,211107
20,ENSG00000101474.7,24992751,20-24855142-G-A,rs56232101,-1,G,A,24855142,137609,24796143,25189359,58999
20,ENSG00000101474.7,24992751,20-24855142-G-T,rs56232101,-1,G,T,24855142,137609,24796143,25189359,58999
20,ENSG00000101104.6,44910060,20-44899880-G-A,rs6017444,1,G,A,44899880,10180,44713452,45106668,186428
20,ENSG00000101363.8,37289655,20-37349094-C-T,rs6017943,1,C,T,37349094,59439,37093047,37486263,256047
20,ENSG00000124228.9,49219416,20-49221331-G-A,rs6019695,1,G,A,49221331,1915,49022808,49416024,198523
20,ENSG00000124098.9,56358974,20-56243950-A-C,rs6024728,1,A,C,56243950,115024,56162366,56555582,81584
20,ENSG00000124098.9,56358974,20-56243950-A-T,rs6024728,1,A,T,56243950,115024,56162366,56555582,81584
20,ENSG00000196476.7,290750,20-278757-A-C,rs6035515,-1,A,C,278757,11993,94142,487358,184615
20,ENSG00000196476.7,290750,20-278757-A-T,rs6035515,-1,A,T,278757,11993,94142,487358,184615
20,ENSG00000196476.7,290750,20-278757-A-G,rs6035515,-1,A,G,278757,11993,94142,487358,184615
20,ENSG00000132640.10,11917893,20-12008201-G-T,rs6041030,1,G,T,12008201,90308,11721285,12114501,286916
20,ENSG00000132640.10,11917893,20-12008201-G-C,rs6041030,1,G,C,12008201,90308,11721285,12114501,286916
20,ENSG00000132640.10,11917893,20-12008201-G-A,rs6041030,1,G,A,12008201,90308,11721285,12114501,286916
20,ENSG00000172296.8,13008972,20-12855739-G-C,rs6041669,1,G,C,12855739,153233,12812364,13205580,43375
20,ENSG00000172296.8,13008972,20-12855739-G-A,rs6041669,1,G,A,12855739,153233,12812364,13205580,43375
20,ENSG00000089006.11,17968794,20-18037494-T-A,rs6045156,-1,T,A,18037494,68700,17772186,18165402,265308
20,ENSG00000089006.11,17968794,20-18037494-T-C,rs6045156,-1,T,C,18037494,68700,17772186,18165402,265308
20,ENSG00000089006.11,17968794,20-18037494-T-G,rs6045156,-1,T,G,18037494,68700,17772186,18165402,265308
20,ENSG00000100994.7,25248085,20-25197284-A-T,rs6050422,1,A,T,25197284,50801,25051477,25444693,145807
20,ENSG00000100994.7,25248085,20-25197284-A-G,rs6050422,1,A,G,25197284,50801,25051477,25444693,145807
20,ENSG00000197586.7,25195712,20-25200438-T-G,rs6050427,1,T,G,25200438,4726,24999104,25392320,201334
20,ENSG00000197586.7,25195712,20-25200438-T-A,rs6050427,1,T,A,25200438,4726,24999104,25392320,201334
20,ENSG00000197586.7,25195712,20-25200438-T-C,rs6050427,1,T,C,25200438,4726,24999104,25392320,201334
20,ENSG00000125885.8,5950652,20-5989792-G-C,rs6053815,1,G,C,5989792,39140,5754044,6147260,235748
20,ENSG00000125845.5,6767686,20-6696076-A-G,rs6054474,1,A,G,6696076,71610,6571078,6964294,124998
20,ENSG00000198547.3,32673941,20-32653587-T-C,rs6057610,-1,T,C,32653587,20354,32477333,32870549,176254
20,ENSG00000198547.3,32673941,20-32653587-T-A,rs6057610,-1,T,A,32653587,20354,32477333,32870549,176254
20,ENSG00000125966.7,35226690,20-35212274-C-A,rs6058205,1,C,A,35212274,14416,35030082,35423298,182192
20,ENSG00000125966.7,35226690,20-35212274-C-T,rs6058205,1,C,T,35212274,14416,35030082,35423298,182192
20,ENSG00000131044.11,31870634,20-31923305-G-A,rs6061032,1,G,A,31923305,52671,31674026,32067242,249279
20,ENSG00000171940.8,53593839,20-53557198-G-A,rs6068579,-1,G,A,53557198,36641,53397231,53790447,159967
20,ENSG00000171940.8,53593839,20-53557198-G-T,rs6068579,-1,G,T,53557198,36641,53397231,53790447,159967
20,ENSG00000171940.8,53593839,20-53557198-G-C,rs6068579,-1,G,C,53557198,36641,53397231,53790447,159967
20,ENSG00000101162.3,59019429,20-59046400-T-C,rs6070701,1,T,C,59046400,26971,58822821,59216037,223579
20,ENSG00000101003.8,25407673,20-25382606-C-T,rs6076340,1,C,T,25382606,25067,25211065,25604281,171541
20,ENSG00000101230.4,13221274,20-13333299-G-C,rs6079001,1,G,C,13333299,112025,13024666,13417882,308633
20,ENSG00000089048.9,13784919,20-13751166-A-G,rs6079161,-1,A,G,13751166,33753,13588311,13981527,162855
20,ENSG00000101337.10,32109714,20-32282123-A-G,rs6087861,1,A,G,32282123,172409,31913106,32306322,369017
20,ENSG00000078814.11,34955868,20-34882711-T-C,rs6088638,1,T,C,34882711,73157,34759260,35152476,123451
20,ENSG00000078814.11,34955868,20-34882711-T-G,rs6088638,1,T,G,34882711,73157,34759260,35152476,123451
20,ENSG00000101057.11,43667114,20-43586834-G-A,rs6093858,1,G,A,43586834,80280,43470506,43863722,116328
20,ENSG00000101057.11,43667114,20-43586834-G-C,rs6093858,1,G,C,43586834,80280,43470506,43863722,116328
20,ENSG00000198185.6,46513559,20-46497315-G-A,rs6094356,-1,G,A,46497315,16244,46316951,46710167,180364
20,ENSG00000132819.12,57391396,20-57482763-G-A,rs6099647,1,G,A,57482763,91367,57194788,57588004,287975
20,ENSG00000132819.12,57391396,20-57482763-G-T,rs6099647,1,G,T,57482763,91367,57194788,57588004,287975
20,ENSG00000132819.12,57391396,20-57482763-G-C,rs6099647,1,G,C,57482763,91367,57194788,57588004,287975
20,ENSG00000196839.8,44651699,20-44657535-C-T,rs6103806,-1,C,T,44657535,5836,44455091,44848307,202444
20,ENSG00000101361.9,2652632,20-2543474-A-G,rs6114849,1,A,G,2543474,109158,2456024,2849240,87450
20,ENSG00000170191.4,25624014,20-25585849-A-G,rs6115218,-1,A,G,25585849,38165,25427406,25820622,158443
20,ENSG00000149488.11,2536573,20-2661730-C-G,rs6115381,1,C,G,2661730,125157,2339965,2733181,321765
20,ENSG00000149488.11,2536573,20-2661730-C-T,rs6115381,1,C,T,2661730,125157,2339965,2733181,321765
20,ENSG00000101255.6,380760,20-396582-C-T,rs6115830,1,C,T,396582,15822,184152,577368,212430
20,ENSG00000101255.6,380760,20-396582-C-G,rs6115830,1,C,G,396582,15822,184152,577368,212430
20,ENSG00000089063.10,5113076,20-5131352-A-T,rs6116658,-1,A,T,5131352,18276,4916468,5309684,214884
20,ENSG00000089063.10,5113076,20-5131352-A-C,rs6116658,-1,A,C,5131352,18276,4916468,5309684,214884
20,ENSG00000101266.10,543790,20-628723-G-A,rs6116853,-1,G,A,628723,84933,347182,740398,281541
20,ENSG00000149679.6,62407285,20-62386309-T-C,rs6121558,-1,T,C,62386309,20976,62210677,62603893,175632
20,ENSG00000171984.9,5750401,20-5810420-C-A,rs6133267,1,C,A,5810420,60019,5553793,5947009,256627
20,ENSG00000171984.9,5750401,20-5810420-C-T,rs6133267,1,C,T,5810420,60019,5553793,5947009,256627
20,ENSG00000171867.11,4686456,20-4837899-G-A,rs6139563,1,G,A,4837899,151443,4489848,4883064,348051
20,ENSG00000125898.7,833715,20-763126-C-T,rs6140113,1,C,T,763126,70589,637107,1030323,126019
20,ENSG00000171222.6,35954502,20-36023958-C-T,rs6142483,-1,C,T,36023958,69456,35757894,36151110,266064
20,ENSG00000171222.6,35954502,20-36023958-C-G,rs6142483,-1,C,G,36023958,69456,35757894,36151110,266064
20,ENSG00000088812.12,3471018,20-3390214-T-C,rs6515810,1,T,C,3390214,80804,3274410,3667626,115804
20,ENSG00000173418.7,20017362,20-19964163-T-C,rs680364,1,T,C,19964163,53199,19820754,20213970,143409
20,ENSG00000089195.10,5950533,20-6073108-C-T,rs71338522,-1,C,T,6073108,122575,5753925,6147141,319183
20,ENSG00000125968.7,31605289,20-31615679-T-C,rs7263476,1,T,C,31615679,10390,31408681,31801897,206998
20,ENSG00000198276.8,63956416,20-63922080-C-T,rs7264220,-1,C,T,63922080,34336,63759808,64153024,162272
20,ENSG00000125531.5,63554159,20-63368149-G-A,rs7265179,1,G,A,63368149,186010,63357551,63750767,10598
20,ENSG00000198959.6,38165270,20-38313615-G-A,rs73110446,-1,G,A,38313615,148345,37968662,38361878,344953
20,ENSG00000198959.6,38165270,20-38313615-G-C,rs73110446,-1,G,C,38313615,148345,37968662,38361878,344953
20,ENSG00000215440.7,58692800,20-58686290-T-G,rs73124350,1,T,G,58686290,6510,58496192,58889408,190098
20,ENSG00000101417.7,33720310,20-33893855-T-C,rs733803,-1,T,C,33893855,173545,33523702,33916918,370153
20,ENSG00000101052.8,43590937,20-43703206-C-T,rs7347231,1,C,T,43703206,112269,43394329,43787545,308877
20,ENSG00000101421.3,33811348,20-33894826-A-G,rs742614,1,A,G,33894826,83478,33614740,34007956,280086
20,ENSG00000101421.3,33811348,20-33894826-A-T,rs742614,1,A,T,33894826,83478,33614740,34007956,280086
20,ENSG00000240849.6,50153723,20-50114067-A-C,rs75084165,-1,A,C,50114067,39656,49957115,50350331,156952
20,ENSG00000092758.10,62817050,20-62832170-C-A,rs751557,1,C,A,62832170,15120,62620442,63013658,211728
20,ENSG00000092758.10,62817050,20-62832170-C-G,rs751557,1,C,G,62832170,15120,62620442,63013658,211728
20,ENSG00000088832.10,1393054,20-1324628-C-A,rs754363,-1,C,A,1324628,68426,1196446,1589662,128182
20,ENSG00000101189.5,62796473,20-62795326-G-A,rs75817908,1,G,A,62795326,1147,62599865,62993081,195461
20,ENSG00000101189.5,62796473,20-62795326-G-T,rs75817908,1,G,T,62795326,1147,62599865,62993081,195461
20,ENSG00000124140.7,46029215,20-46087893-C-T,rs77202366,1,C,T,46087893,58678,45832607,46225823,255286
20,ENSG00000101197.8,63235905,20-63249722-C-T,rs78618692,1,C,T,63249722,13817,63039297,63432513,210425
20,ENSG00000101247.12,13785028,20-13775443-T-C,rs78633569,1,T,C,13775443,9585,13588420,13981636,187023
20,ENSG00000101445.4,38805697,20-38924283-C-G,rs79424561,1,C,G,38924283,118586,38609089,39002305,315194
20,ENSG00000101445.4,38805697,20-38924283-C-A,rs79424561,1,C,A,38924283,118586,38609089,39002305,315194
20,ENSG00000101445.4,38805697,20-38924283-C-T,rs79424561,1,C,T,38924283,118586,38609089,39002305,315194
20,ENSG00000101158.7,58981256,20-59049586-G-A,rs79954987,1,G,A,59049586,68330,58784648,59177864,264938
20,ENSG00000125834.8,2101827,20-1971909-A-G,rs80214359,1,A,G,1971909,129918,1905219,2298435,66690
20,ENSG00000196227.6,59940389,20-59963807-C-T,rs8115115,1,C,T,59963807,23418,59743781,60136997,220026
20,ENSG00000196227.6,59940389,20-59963807-C-G,rs8115115,1,C,G,59963807,23418,59743781,60136997,220026
20,ENSG00000125871.9,17969018,20-17972928-C-T,rs8121408,1,C,T,17972928,3910,17772410,18165626,200518
20,ENSG00000125821.7,18588054,20-18781393-G-A,rs8182677,1,G,A,18781393,193339,18391446,18784662,389947
20,ENSG00000101220.11,3767753,20-3740054-C-T,rs862832,-1,C,T,3740054,27699,3571145,3964361,168909
20,ENSG00000132622.6,3732685,20-3740054-C-T,rs862832,1,C,T,3740054,7369,3536077,3929293,203977
20,ENSG00000101246.12,63707976,20-63742354-G-T,rs8957,-1,G,T,63742354,34378,63511368,63904584,230986
20,ENSG00000101216.6,63627101,20-63639577-C-G,rs909334,-1,C,G,63639577,12476,63430493,63823709,209084
20,ENSG00000101216.6,63627101,20-63639577-C-A,rs909334,-1,C,A,63639577,12476,63430493,63823709,209084
20,ENSG00000101216.6,63627101,20-63639577-C-T,rs909334,-1,C,T,63639577,12476,63430493,63823709,209084
20,ENSG00000125775.10,1329139,20-1325077-A-C,rs912118,-1,A,C,1325077,4062,1132531,1525747,192546
20,ENSG00000125775.10,1329139,20-1325077-A-G,rs912118,-1,A,G,1325077,4062,1132531,1525747,192546
20,ENSG00000132623.10,10034987,20-10022710-A-C,rs926982,1,A,C,10022710,12277,9838379,10231595,184331
20,ENSG00000132623.10,10034987,20-10022710-A-G,rs926982,1,A,G,10022710,12277,9838379,10231595,184331
20,ENSG00000124164.11,58389229,20-58420884-A-G,rs9679935,1,A,G,58420884,31655,58192621,58585837,228263
20,ENSG00000132823.5,44210771,20-44196847-T-A,rs9875,-1,T,A,44196847,13924,44014163,44407379,182684
20,ENSG00000132823.5,44210771,20-44196847-T-C,rs9875,-1,T,C,44196847,13924,44014163,44407379,182684
20,ENSG00000101391.14,33401519,20-33289759-C-T,rs1078944,-1,C,T,33289759,111760,33204911,33598127,84848
20,ENSG00000124140.7,46029215,20-46195813-C-T,rs111733230,1,C,T,46195813,166598,45832607,46225823,363206
20,ENSG00000124164.11,58389229,20-58463392-G-C,rs112698857,1,G,C,58463392,74163,58192621,58585837,270771
20,ENSG00000124164.11,58389229,20-58463392-G-A,rs112698857,1,G,A,58463392,74163,58192621,58585837,270771
20,ENSG00000170471.9,38472843,20-38349233-G-A,rs11536940,1,G,A,38349233,123610,38276235,38669451,72998
20,ENSG00000125871.9,17969018,20-17969902-A-T,rs11551768,1,A,T,17969902,884,17772410,18165626,197492
20,ENSG00000124253.8,57561110,20-57563592-G-A,rs11552145,1,G,A,57563592,2482,57364502,57757718,199090
20,ENSG00000125520.8,63739776,20-63843323-G-A,rs115622739,1,G,A,63843323,103547,63543168,63936384,300155
20,ENSG00000101132.5,54208087,20-54050346-T-C,rs11698014,1,T,C,54050346,157741,54011479,54404695,38867
20,ENSG00000101004.9,25585531,20-25741538-G-A,rs11698267,-1,G,A,25741538,156007,25388923,25782139,352615
20,ENSG00000101230.4,13221274,20-13308146-C-T,rs11699846,1,C,T,13308146,86872,13024666,13417882,283480
20,ENSG00000101204.10,63361349,20-63331544-C-T,rs117413284,-1,C,T,63331544,29805,63164741,63557957,166803
20,ENSG00000101126.9,50931437,20-50785726-C-T,rs117655020,-1,C,T,50785726,145711,50734829,51128045,50897
20,ENSG00000089012.9,1657779,20-1619759-C-A,rs117803469,-1,C,A,1619759,38020,1461171,1854387,158588
20,ENSG00000124256.9,57620426,20-57720513-C-T,rs117941195,-1,C,T,57720513,100087,57423818,57817034,296695
20,ENSG00000089006.11,17968794,20-18144797-G-A,rs1205218,-1,G,A,18144797,176003,17772186,18165402,372611
20,ENSG00000089006.11,17968794,20-18144797-G-C,rs1205218,-1,G,C,18144797,176003,17772186,18165402,372611
20,ENSG00000124116.14,45791883,20-45798779-A-G,rs12480887,-1,A,G,45798779,6896,45595275,45988491,203504
20,ENSG00000124134.4,45101127,20-45183405-G-A,rs12625505,-1,G,A,45183405,82278,44904519,45297735,278886
20,ENSG00000124177.10,41618377,20-41463529-T-C,rs12625845,-1,T,C,41463529,154848,41421769,41814985,41760
20,ENSG00000101353.10,37158904,20-37176382-C-T,rs1291081,-1,C,T,37176382,17478,36962296,37355512,214086
20,ENSG00000064601.11,45891335,20-46004472-C-G,rs13040272,1,C,G,46004472,113137,45694727,46087943,309745
20,ENSG00000064601.11,45891335,20-46004472-C-T,rs13040272,1,C,T,46004472,113137,45694727,46087943,309745
20,ENSG00000158470.5,49713878,20-49589815-G-A,rs13044693,-1,G,A,49589815,124063,49517270,49910486,72545
20,ENSG00000171984.9,5750401,20-5801913-G-A,rs1555141,1,G,A,5801913,51512,5553793,5947009,248120
20,ENSG00000149679.6,62407285,20-62411193-T-C,rs1570023,-1,T,C,62411193,3908,62210677,62603893,200516
20,ENSG00000101160.9,59007254,20-59003453-T-C,rs163800,-1,T,C,59003453,3801,58810646,59203862,192807
20,ENSG00000125534.4,63520765,20-63500615-A-C,rs1741614,1,A,C,63500615,20150,63324157,63717373,176458
20,ENSG00000125534.4,63520765,20-63500615-A-G,rs1741614,1,A,G,63500615,20150,63324157,63717373,176458
20,ENSG00000125534.4,63520765,20-63500615-A-T,rs1741614,1,A,T,63500615,20150,63324157,63717373,176458
20,ENSG00000125869.4,9514590,20-9445053-T-A,rs17482999,1,T,A,9445053,69537,9317982,9711198,127071
20,ENSG00000125869.4,9514590,20-9445053-T-C,rs17482999,1,T,C,9445053,69537,9317982,9711198,127071
20,ENSG00000172264.12,13995516,20-14007022-C-T,rs17812574,1,C,T,14007022,11506,13798908,14192124,208114
20,ENSG00000101447.8,38926417,20-38961938-C-T,rs17829669,1,C,T,38961938,35521,38729809,39123025,232129
20,ENSG00000173418.7,20017362,20-19957325-A-C,rs199559,1,A,C,19957325,60037,19820754,20213970,136571
20,ENSG00000131051.15,35742260,20-35555321-G-A,rs224419,-1,G,A,35555321,186939,35545652,35938868,9669
20,ENSG00000101197.8,63235905,20-63238474-C-T,rs2273487,1,C,T,63238474,2569,63039297,63432513,199177
20,ENSG00000101197.8,63235905,20-63238474-C-G,rs2273487,1,C,G,63238474,2569,63039297,63432513,199177
20,ENSG00000126005.10,35278122,20-35269741-C-G,rs2275274,-1,C,G,35269741,8381,35081514,35474730,188227
20,ENSG00000126005.10,35278122,20-35269741-C-T,rs2275274,-1,C,T,35269741,8381,35081514,35474730,188227
20,ENSG00000126005.10,35278122,20-35269741-C-A,rs2275274,-1,C,A,35269741,8381,35081514,35474730,188227
20,ENSG00000124226.6,49936397,20-49942850-G-T,rs2294600,1,G,T,49942850,6453,49739789,50133005,203061
20,ENSG00000124226.6,49936397,20-49942850-G-A,rs2294600,1,G,A,49942850,6453,49739789,50133005,203061
20,ENSG00000088826.12,4148828,20-4175021-C-T,rs2295483,1,C,T,4175021,26193,3952220,4345436,222801
20,ENSG00000088826.12,4148828,20-4175021-C-A,rs2295483,1,C,A,4175021,26193,3952220,4345436,222801
20,ENSG00000197457.5,63653424,20-63662107-T-C,rs2297433,-1,T,C,63662107,8683,63456816,63850032,205291
20,ENSG00000101162.3,59019429,20-58970710-G-A,rs235195,1,G,A,58970710,48719,58822821,59216037,147889
20,ENSG00000101439.4,23637955,20-23642243-G-A,rs2405367,-1,G,A,23642243,4288,23441347,23834563,200896
20,ENSG00000196700.3,63969930,20-64009856-G-A,rs2427587,-1,G,A,64009856,39926,63773322,64166538,236534
20,ENSG00000125510.11,64080082,20-64263071-C-T,rs2427636,1,C,T,64263071,182989,63883474,64276690,379597
20,ENSG00000240849.6,50153723,20-50289452-A-T,rs2904263,-1,A,T,50289452,135729,49957115,50350331,332337
20,ENSG00000240849.6,50153723,20-50289452-A-G,rs2904263,-1,A,G,50289452,135729,49957115,50350331,332337
20,ENSG00000240849.6,50153723,20-50289452-A-C,rs2904263,-1,A,C,50289452,135729,49957115,50350331,332337
20,ENSG00000101057.11,43667114,20-43728655-C-G,rs3127065,1,C,G,43728655,61541,43470506,43863722,258149
20,ENSG00000101057.11,43667114,20-43728655-C-A,rs3127065,1,C,A,43728655,61541,43470506,43863722,258149
20,ENSG00000101052.8,43590937,20-43739553-T-A,rs3127068,1,T,A,43739553,148616,43394329,43787545,345224
20,ENSG00000101052.8,43590937,20-43739553-T-C,rs3127068,1,T,C,43739553,148616,43394329,43787545,345224
20,ENSG00000198185.6,46513559,20-46512761-A-C,rs366860,-1,A,C,46512761,798,46316951,46710167,195810
20,ENSG00000198185.6,46513559,20-46512761-A-T,rs366860,-1,A,T,46512761,798,46316951,46710167,195810
20,ENSG00000124257.6,45891208,20-45957397-G-A,rs3746506,-1,G,A,45957397,66189,45694600,46087816,262797
20,ENSG00000101224.13,3796310,20-3795528-C-G,rs3761218,1,C,G,3795528,782,3599702,3992918,195826
20,ENSG00000101224.13,3796310,20-3795528-C-T,rs3761218,1,C,T,3795528,782,3599702,3992918,195826
20,ENSG00000125877.6,3209498,20-3227173-T-C,rs3810560,1,T,C,3227173,17675,3012890,3406106,214283
20,ENSG00000149635.2,46550654,20-46551651-C-T,rs3848682,-1,C,T,46551651,997,46354046,46747262,197605
20,ENSG00000149654.5,46308498,20-46314580-G-A,rs4072977,-1,G,A,46314580,6082,46111890,46505106,202690
20,ENSG00000149654.5,46308498,20-46314580-G-C,rs4072977,-1,G,C,46314580,6082,46111890,46505106,202690
20,ENSG00000132823.5,44210771,20-44210980-A-G,rs4142441,-1,A,G,44210980,209,44014163,44407379,196817
20,ENSG00000089063.10,5113076,20-5133938-G-A,rs4239761,-1,G,A,5133938,20862,4916468,5309684,217470
20,ENSG00000101473.11,45857392,20-45746167-G-T,rs426384,-1,G,T,45746167,111225,45660784,46054000,85383
20,ENSG00000101473.11,45857392,20-45746167-G-C,rs426384,-1,G,C,45746167,111225,45660784,46054000,85383
20,ENSG00000149488.11,2536573,20-2650546-A-G,rs4365537,1,A,G,2650546,113973,2339965,2733181,310581
20,ENSG00000149346.10,10435305,20-10331019-A-G,rs47512,1,A,G,10331019,104286,10238697,10631913,92322
20,ENSG00000183260.5,63861498,20-63849296-T-C,rs4809238,1,T,C,63849296,12202,63664890,64058106,184406
20,ENSG00000075043.12,63472655,20-63454625-T-C,rs4809565,-1,T,C,63454625,18030,63276047,63669263,178578
20,ENSG00000075043.12,63472655,20-63454625-T-A,rs4809565,-1,T,A,63454625,18030,63276047,63669263,178578
20,ENSG00000172315.5,46689444,20-46552040-C-A,rs4810512,-1,C,A,46552040,137404,46492836,46886052,59204
20,ENSG00000172315.5,46689444,20-46552040-C-T,rs4810512,-1,C,T,46552040,137404,46492836,46886052,59204
20,ENSG00000132819.12,57391396,20-57300912-G-A,rs4811835,1,G,A,57300912,90484,57194788,57588004,106124
20,ENSG00000125834.8,2101827,20-2094276-G-A,rs4814966,1,G,A,2094276,7551,1905219,2298435,189057
20,ENSG00000125898.7,833715,20-946302-G-A,rs529058,1,G,A,946302,112587,637107,1030323,309195
20,ENSG00000125898.7,833715,20-946302-G-C,rs529058,1,G,C,946302,112587,637107,1030323,309195
20,ENSG00000124243.11,50795061,20-50695367-G-A,rs55855021,1,G,A,50695367,99694,50598453,50991669,96914
20,ENSG00000124215.12,59958423,20-59793018-G-C,rs56144357,1,G,C,59793018,165405,59761815,60155031,31203
20,ENSG00000124215.12,59958423,20-59793018-G-A,rs56144357,1,G,A,59793018,165405,59761815,60155031,31203
20,ENSG00000101363.8,37289655,20-37288563-A-C,rs56151005,1,A,C,37288563,1092,37093047,37486263,195516
20,ENSG00000149596.6,44187188,20-44073017-G-C,rs56385624,-1,G,C,44073017,114171,43990580,44383796,82437
20,ENSG00000132622.6,3732685,20-3731217-A-C,rs580502,1,A,C,3731217,1468,3536077,3929293,195140
20,ENSG00000166619.7,37527876,20-37411490-A-G,rs58728038,-1,A,G,37411490,116386,37331268,37724484,80222
20,ENSG00000101190.8,62861822,20-62862873-G-A,rs6010770,-1,G,A,62862873,1051,62665214,63058430,197659
20,ENSG00000101190.8,62861822,20-62862873-G-T,rs6010770,-1,G,T,62862873,1051,62665214,63058430,197659
20,ENSG00000101194.12,62952709,20-63010496-G-T,rs6011530,1,G,T,63010496,57787,62756101,63149317,254395
20,ENSG00000101194.12,62952709,20-63010496-G-A,rs6011530,1,G,A,63010496,57787,62756101,63149317,254395
20,ENSG00000182463.7,52972358,20-52782795-A-G,rs6013523,1,A,G,52782795,189563,52775750,53168966,7045
20,ENSG00000132825.5,59940305,20-60124692-C-G,rs6015655,-1,C,G,60124692,184387,59743697,60136913,380995
20,ENSG00000132825.5,59940305,20-60124692-C-T,rs6015655,-1,C,T,60124692,184387,59743697,60136913,380995
20,ENSG00000101096.13,51542719,20-51588501-T-A,rs6021301,-1,T,A,51588501,45782,51346111,51739327,242390
20,ENSG00000101096.13,51542719,20-51588501-T-C,rs6021301,-1,T,C,51588501,45782,51346111,51739327,242390
20,ENSG00000196227.6,59940389,20-59789542-A-G,rs6027111,1,A,G,59789542,150847,59743781,60136997,45761
20,ENSG00000089177.12,16573448,20-16572319-C-A,rs6034535,-1,C,A,16572319,1129,16376840,16770056,195479
20,ENSG00000149474.7,18137863,20-18138763-C-T,rs6034985,1,C,T,18138763,900,17941255,18334471,197508
20,ENSG00000149474.7,18137863,20-18138763-C-G,rs6034985,1,C,G,18138763,900,17941255,18334471,197508
20,ENSG00000101365.13,2664216,20-2563158-G-C,rs6036974,-1,G,C,2563158,101058,2467608,2860824,95550
20,ENSG00000101365.13,2664216,20-2563158-G-A,rs6036974,-1,G,A,2563158,101058,2467608,2860824,95550
20,ENSG00000198171.7,3204682,20-3219123-T-C,rs6037506,-1,T,C,3219123,14441,3008074,3401290,211049
20,ENSG00000198171.7,3204682,20-3219123-T-A,rs6037506,-1,T,A,3219123,14441,3008074,3401290,211049
20,ENSG00000198171.7,3204682,20-3219123-T-G,rs6037506,-1,T,G,3219123,14441,3008074,3401290,211049
20,ENSG00000125826.14,408299,20-402232-T-G,rs6037542,1,T,G,402232,6067,211691,604907,190541
20,ENSG00000125843.6,3820547,20-3826961-T-C,rs6037671,1,T,C,3826961,6414,3623939,4017155,203022
20,ENSG00000089091.10,18467185,20-18350391-T-C,rs6045356,-1,T,C,18350391,116794,18270577,18663793,79814
20,ENSG00000125841.7,347111,20-437623-G-A,rs6052008,1,G,A,437623,90512,150503,543719,287120
20,ENSG00000125841.7,347111,20-437623-G-T,rs6052008,1,G,T,437623,90512,150503,543719,287120
20,ENSG00000125841.7,347111,20-437623-G-C,rs6052008,1,G,C,437623,90512,150503,543719,287120
20,ENSG00000242372.2,35284772,20-35430353-G-C,rs6060414,-1,G,C,35430353,145581,35088164,35481380,342189
20,ENSG00000242372.2,35284772,20-35430353-G-A,rs6060414,-1,G,A,35430353,145581,35088164,35481380,342189
20,ENSG00000101181.12,62183028,20-62190366-C-T,rs6062130,1,C,T,62190366,7338,61986420,62379636,203946
20,ENSG00000171858.11,62387103,20-62548390-A-G,rs6062277,1,A,G,62548390,161287,62190495,62583711,357895
20,ENSG00000171858.11,62387103,20-62548390-A-T,rs6062277,1,A,T,62548390,161287,62190495,62583711,357895
20,ENSG00000197114.6,63708039,20-63858436-G-C,rs6062551,1,G,C,63858436,150397,63511431,63904647,347005
20,ENSG00000197114.6,63708039,20-63858436-G-A,rs6062551,1,G,A,63858436,150397,63511431,63904647,347005
20,ENSG00000171700.9,64079518,20-64120459-A-T,rs6062634,-1,A,T,64120459,40941,63882910,64276126,237549
20,ENSG00000171700.9,64079518,20-64120459-A-C,rs6062634,-1,A,C,64120459,40941,63882910,64276126,237549
20,ENSG00000054793.9,51768390,20-51778744-T-A,rs6067931,-1,T,A,51778744,10354,51571782,51964998,206962
20,ENSG00000054793.9,51768390,20-51778744-T-C,rs6067931,-1,T,C,51778744,10354,51571782,51964998,206962
20,ENSG00000168734.9,44582579,20-44662429-G-C,rs6073500,1,G,C,44662429,79850,44385971,44779187,276458
20,ENSG00000168734.9,44582579,20-44662429-G-A,rs6073500,1,G,A,44662429,79850,44385971,44779187,276458
20,ENSG00000196476.7,290750,20-291796-G-T,rs6075791,-1,G,T,291796,1046,94142,487358,197654
20,ENSG00000196476.7,290750,20-291796-G-C,rs6075791,-1,G,C,291796,1046,94142,487358,197654
20,ENSG00000196476.7,290750,20-291796-G-A,rs6075791,-1,G,A,291796,1046,94142,487358,197654
20,ENSG00000132640.10,11917893,20-11879643-G-T,rs6078372,1,G,T,11879643,38250,11721285,12114501,158358
20,ENSG00000132640.10,11917893,20-11879643-G-A,rs6078372,1,G,A,11879643,38250,11721285,12114501,158358
20,ENSG00000101417.7,33720310,20-33871514-G-T,rs6088329,-1,G,T,33871514,151204,33523702,33916918,347812
20,ENSG00000101417.7,33720310,20-33871514-G-A,rs6088329,-1,G,A,33871514,151204,33523702,33916918,347812
20,ENSG00000101417.7,33720310,20-33871514-G-C,rs6088329,-1,G,C,33871514,151204,33523702,33916918,347812
20,ENSG00000100983.5,34955806,20-35118208-A-C,rs6088721,-1,A,C,35118208,162402,34759198,35152414,359010
20,ENSG00000100983.5,34955806,20-35118208-A-T,rs6088721,-1,A,T,35118208,162402,34759198,35152414,359010
20,ENSG00000126001.11,35455598,20-35583402-G-A,rs6088887,1,G,A,35583402,127804,35258990,35652206,324412
20,ENSG00000131044.11,31870634,20-31934129-A-G,rs6089122,1,A,G,31934129,63495,31674026,32067242,260103
20,ENSG00000101150.11,63865270,20-63677001-C-T,rs6089763,1,C,T,63677001,188269,63668662,64061878,8339
20,ENSG00000101150.11,63865270,20-63677001-C-G,rs6089763,1,C,G,63677001,188269,63668662,64061878,8339
20,ENSG00000000419.7,50958532,20-50873476-C-A,rs6096139,-1,C,A,50873476,85056,50761924,51155140,111552
20,ENSG00000000419.7,50958532,20-50873476-C-T,rs6096139,-1,C,T,50873476,85056,50761924,51155140,111552
20,ENSG00000124217.3,50958818,20-51122131-T-A,rs6096269,1,T,A,51122131,163313,50762210,51155426,359921
20,ENSG00000124217.3,50958818,20-51122131-T-C,rs6096269,1,T,C,51122131,163313,50762210,51155426,359921
20,ENSG00000101158.7,58981256,20-59064531-G-T,rs6100323,1,G,T,59064531,83275,58784648,59177864,279883
20,ENSG00000101158.7,58981256,20-59064531-G-A,rs6100323,1,G,A,59064531,83275,58784648,59177864,279883
20,ENSG00000101158.7,58981256,20-59064531-G-C,rs6100323,1,G,C,59064531,83275,58784648,59177864,279883
20,ENSG00000100997.12,25390835,20-25213213-C-A,rs6115089,-1,C,A,25213213,177622,25194227,25587443,18986
20,ENSG00000125818.10,1118602,20-932392-G-T,rs6118267,1,G,T,932392,186210,921994,1315210,10398
20,ENSG00000101294.11,31514442,20-31332596-C-T,rs6119844,1,C,T,31332596,181846,31317834,31711050,14762
20,ENSG00000101294.11,31514442,20-31332596-C-A,rs6119844,1,C,A,31332596,181846,31317834,31711050,14762
20,ENSG00000131043.7,36236478,20-36149115-T-G,rs6121163,1,T,G,36149115,87363,36039870,36433086,109245
20,ENSG00000101191.11,62926505,20-63115991-G-A,rs6122093,-1,G,A,63115991,189486,62729897,63123113,386094
20,ENSG00000101191.11,62926505,20-63115991-G-T,rs6122093,-1,G,T,63115991,189486,62729897,63123113,386094
20,ENSG00000101017.8,46118314,20-46151525-G-C,rs6124768,1,G,C,46151525,33211,45921706,46314922,229819
20,ENSG00000101017.8,46118314,20-46151525-G-A,rs6124768,1,G,A,46151525,33211,45921706,46314922,229819
20,ENSG00000124098.9,56358974,20-56248360-G-A,rs6127698,1,G,A,56248360,110614,56162366,56555582,85994
20,ENSG00000124098.9,56358974,20-56248360-G-T,rs6127698,1,G,T,56248360,110614,56162366,56555582,85994
20,ENSG00000101438.3,38724486,20-38786294-T-G,rs6129020,1,T,G,38786294,61808,38527878,38921094,258416
20,ENSG00000125821.7,18588054,20-18678893-C-T,rs6136466,1,C,T,18678893,90839,18391446,18784662,287447
20,ENSG00000197183.7,32585333,20-32641590-G-A,rs6141768,-1,G,A,32641590,56257,32388725,32781941,252865
20,ENSG00000124092.7,57525140,20-57659912-G-C,rs62204302,-1,G,C,57659912,134772,57328532,57721748,331380
20,ENSG00000171703.12,64063198,20-64114028-T-G,rs62218129,1,T,G,64114028,50830,63866590,64259806,247438
20,ENSG00000171703.12,64063198,20-64114028-T-C,rs62218129,1,T,C,64114028,50830,63866590,64259806,247438
20,ENSG00000131069.13,34876612,20-34692141-T-G,rs6579185,1,T,G,34692141,184471,34680004,35073220,12137
20,ENSG00000064787.7,54070594,20-53900209-G-A,rs66914754,-1,G,A,53900209,170385,53873986,54267202,26223
20,ENSG00000101443.13,45469753,20-45425709-T-G,rs707577,1,T,G,45425709,44044,45273145,45666361,152564
20,ENSG00000101443.13,45469753,20-45425709-T-C,rs707577,1,T,C,45425709,44044,45273145,45666361,152564
20,ENSG00000196839.8,44651699,20-44688014-A-G,rs7262172,-1,A,G,44688014,36315,44455091,44848307,232923
20,ENSG00000089057.10,5001510,20-4971940-C-T,rs7263163,-1,C,T,4971940,29570,4804902,5198118,167038
20,ENSG00000061656.5,35615829,20-35726803-C-T,rs7263640,1,C,T,35726803,110974,35419221,35812437,307582
20,ENSG00000101265.10,4823608,20-4790929-G-A,rs73058472,-1,G,A,4790929,32679,4627000,5020216,163929
20,ENSG00000101265.10,4823608,20-4790929-G-T,rs73058472,-1,G,T,4790929,32679,4627000,5020216,163929
20,ENSG00000172296.8,13008972,20-12913325-C-T,rs73075991,1,C,T,12913325,95647,12812364,13205580,100961
20,ENSG00000100979.10,45912155,20-45788954-C-A,rs73122754,-1,C,A,45788954,123201,45715547,46108763,73407
20,ENSG00000100979.10,45912155,20-45788954-C-T,rs73122754,-1,C,T,45788954,123201,45715547,46108763,73407
20,ENSG00000198276.8,63956416,20-64044057-G-A,rs73153160,-1,G,A,64044057,87641,63759808,64153024,284249
20,ENSG00000130684.8,25696853,20-25620732-C-T,rs73339379,-1,C,T,25620732,76121,25500245,25893461,120487
20,ENSG00000101220.11,3767753,20-3679309-C-T,rs7354032,-1,C,T,3679309,88444,3571145,3964361,108164
20,ENSG00000198900.5,41028822,20-40945134-G-A,rs7361183,1,G,A,40945134,83688,40832214,41225430,112920
20,ENSG00000198900.5,41028822,20-40945134-G-T,rs7361183,1,G,T,40945134,83688,40832214,41225430,112920
20,ENSG00000101413.7,38033746,20-38199903-G-A,rs742415,1,G,A,38199903,166157,37837138,38230354,362765
20,ENSG00000088854.11,3407669,20-3392922-T-C,rs74338704,-1,T,C,3392922,14747,3211061,3604277,181861
20,ENSG00000196421.3,64036182,20-63980551-C-G,rs75097987,1,C,G,63980551,55631,63839574,64232790,140977
20,ENSG00000196421.3,64036182,20-63980551-C-T,rs75097987,1,C,T,63980551,55631,63839574,64232790,140977
20,ENSG00000020256.14,52191779,20-52060146-C-A,rs761852,-1,C,A,52060146,131633,51995171,52388387,64975
20,ENSG00000020256.14,52191779,20-52060146-C-G,rs761852,-1,C,G,52060146,131633,51995171,52388387,64975
20,ENSG00000132623.10,10034987,20-9971915-G-A,rs76748950,1,G,A,9971915,63072,9838379,10231595,133536
20,ENSG00000197296.5,44311202,20-44222832-T-C,rs76935057,-1,T,C,44222832,88370,44114594,44507810,108238
20,ENSG00000197296.5,44311202,20-44222832-T-G,rs76935057,-1,T,G,44222832,88370,44114594,44507810,108238
20,ENSG00000158296.9,46651459,20-46587492-A-G,rs78298864,-1,A,G,46587492,63967,46454851,46848067,132641
20,ENSG00000125885.8,5950652,20-5970619-A-G,rs78651512,1,A,G,5970619,19967,5754044,6147260,216575
20,ENSG00000125885.8,5950652,20-5970619-A-C,rs78651512,1,A,C,5970619,19967,5754044,6147260,216575
20,ENSG00000060491.10,62804835,20-62821996-T-G,rs8114983,1,T,G,62821996,17161,62608227,63001443,213769
20,ENSG00000125967.11,33674428,20-33501435-A-G,rs8119925,-1,A,G,33501435,172993,33477820,33871036,23615
20,ENSG00000125967.11,33674428,20-33501435-A-C,rs8119925,-1,A,C,33501435,172993,33477820,33871036,23615
20,ENSG00000100994.7,25248085,20-25082079-C-A,rs8123716,1,C,A,25082079,166006,25051477,25444693,30602
20,ENSG00000101161.6,63981132,20-64044656-A-C,rs816943,1,A,C,64044656,63524,63784524,64177740,260132
20,ENSG00000101161.6,63981132,20-64044656-A-G,rs816943,1,A,G,64044656,63524,63784524,64177740,260132
20,ENSG00000203883.5,64049639,20-63949375-A-G,rs817311,-1,A,G,63949375,100264,63853031,64246247,96344
20,ENSG00000130590.9,63979642,20-63954909-T-C,rs817318,-1,T,C,63954909,24733,63783034,64176250,171875
20,ENSG00000178726.5,23049672,20-23098359-C-A,rs844813,-1,C,A,23098359,48687,22853064,23246280,245295
20,ENSG00000178726.5,23049672,20-23098359-C-T,rs844813,-1,C,T,23098359,48687,22853064,23246280,245295
20,ENSG00000185019.12,3159865,20-3144371-C-T,rs857253,-1,C,T,3144371,15494,2963257,3356473,181114
20,ENSG00000185019.12,3159865,20-3144371-C-G,rs857253,-1,C,G,3144371,15494,2963257,3356473,181114
20,ENSG00000185019.12,3159865,20-3144371-C-A,rs857253,-1,C,A,3144371,15494,2963257,3356473,181114
20,ENSG00000092758.10,62817050,20-62814660-G-A,rs910151,1,G,A,62814660,2390,62620442,63013658,194218
20,ENSG00000101445.4,38805697,20-38732861-T-A,rs997848,1,T,A,38732861,72836,38609089,39002305,123772
20,ENSG00000101445.4,38805697,20-38732861-T-C,rs997848,1,T,C,38732861,72836,38609089,39002305,123772
19,ENSG00000187994.6,38878275,19-38876471-T-G,rs1001413,-1,T,G,38876471,1804,38681667,39074883,194804
19,ENSG00000187994.6,38878275,19-38876471-T-C,rs1001413,-1,T,C,38876471,1804,38681667,39074883,194804
19,ENSG00000104979.3,13774456,19-13774670-A-G,rs10104,1,A,G,13774670,214,13577848,13971064,196822
19,ENSG00000104979.3,13774456,19-13774670-A-C,rs10104,1,A,C,13774670,214,13577848,13971064,196822
19,ENSG00000129932.2,3500674,19-3491370-A-T,rs10126,-1,A,T,3491370,9304,3304066,3697282,187304
19,ENSG00000129932.2,3500674,19-3491370-A-C,rs10126,-1,A,C,3491370,9304,3304066,3697282,187304
19,ENSG00000129932.2,3500674,19-3491370-A-G,rs10126,-1,A,G,3491370,9304,3304066,3697282,187304
19,ENSG00000117877.5,45406644,19-45400148-C-A,rs10401973,1,C,A,45400148,6496,45210036,45603252,190112
19,ENSG00000117877.5,45406644,19-45400148-C-T,rs10401973,1,C,T,45400148,6496,45210036,45603252,190112
19,ENSG00000117877.5,45406644,19-45400148-C-G,rs10401973,1,C,G,45400148,6496,45210036,45603252,190112
19,ENSG00000198482.5,52527668,19-52344460-C-T,rs10402784,1,C,T,52344460,183208,52331060,52724276,13400
19,ENSG00000198482.5,52527668,19-52344460-C-A,rs10402784,1,C,A,52344460,183208,52331060,52724276,13400
19,ENSG00000104973.8,49818289,19-49838854-G-A,rs10403127,1,G,A,49838854,20565,49621681,50014897,217173
19,ENSG00000008441.10,12995475,19-13160907-C-G,rs10403956,1,C,G,13160907,165432,12798867,13192083,362040
19,ENSG00000008441.10,12995475,19-13160907-C-T,rs10403956,1,C,T,13160907,165432,12798867,13192083,362040
19,ENSG00000189190.6,52786807,19-52780882-C-T,rs10404486,-1,C,T,52780882,5925,52590199,52983415,190683
19,ENSG00000189190.6,52786807,19-52780882-C-G,rs10404486,-1,C,G,52780882,5925,52590199,52983415,190683
19,ENSG00000180855.10,12441021,19-12450058-G-C,rs10404932,-1,G,C,12450058,9037,12244413,12637629,205645
19,ENSG00000180855.10,12441021,19-12450058-G-A,rs10404932,-1,G,A,12450058,9037,12244413,12637629,205645
19,ENSG00000198453.7,36916332,19-36997153-T-G,rs10405238,1,T,G,36997153,80821,36719724,37112940,277429
19,ENSG00000198453.7,36916332,19-36997153-T-C,rs10405238,1,T,C,36997153,80821,36719724,37112940,277429
19,ENSG00000196967.4,37172695,19-36997153-T-G,rs10405238,-1,T,G,36997153,175542,36976087,37369303,21066
19,ENSG00000196967.4,37172695,19-36997153-T-C,rs10405238,-1,T,C,36997153,175542,36976087,37369303,21066
19,ENSG00000028277.12,42132446,19-42045782-C-T,rs10407506,-1,C,T,42045782,86664,41935838,42329054,109944
19,ENSG00000105426.8,5340812,19-5290052-T-C,rs10408836,-1,T,C,5290052,50760,5144204,5537420,145848
19,ENSG00000197841.7,34734243,19-34782445-C-A,rs10409480,1,C,A,34782445,48202,34537635,34930851,244810
19,ENSG00000197841.7,34734243,19-34782445-C-T,rs10409480,1,C,T,34782445,48202,34537635,34930851,244810
19,ENSG00000160007.11,46860997,19-47002869-C-A,rs10410262,1,C,A,47002869,141872,46664389,47057605,338480
19,ENSG00000076650.1,33081181,19-33125350-T-G,rs10411529,1,T,G,33125350,44169,32884573,33277789,240777
19,ENSG00000076650.1,33081181,19-33125350-T-A,rs10411529,1,T,A,33125350,44169,32884573,33277789,240777
19,ENSG00000076650.1,33081181,19-33125350-T-C,rs10411529,1,T,C,33125350,44169,32884573,33277789,240777
19,ENSG00000105695.8,35292161,19-35309759-G-A,rs10411704,1,G,A,35309759,17598,35095553,35488769,214206
19,ENSG00000105695.8,35292161,19-35309759-G-T,rs10411704,1,G,T,35309759,17598,35095553,35488769,214206
19,ENSG00000105695.8,35292161,19-35309759-G-C,rs10411704,1,G,C,35309759,17598,35095553,35488769,214206
19,ENSG00000186272.7,57411161,19-57434452-A-G,rs10411904,1,A,G,57434452,23291,57214553,57607769,219899
19,ENSG00000167476.4,2256417,19-2254027-T-C,rs10411919,-1,T,C,2254027,2390,2059809,2453025,194218
19,ENSG00000105373.12,47745546,19-47779238-C-T,rs10412896,1,C,T,47779238,33692,47548938,47942154,230300
19,ENSG00000105373.12,47745546,19-47779238-C-G,rs10412896,1,C,G,47779238,33692,47548938,47942154,230300
19,ENSG00000196365.5,5720146,19-5595343-T-C,rs10413286,-1,T,C,5595343,124803,5523538,5916754,71805
19,ENSG00000196365.5,5720146,19-5595343-T-A,rs10413286,-1,T,A,5595343,124803,5523538,5916754,71805
19,ENSG00000065000.9,2151566,19-2106697-T-C,rs10413398,-1,T,C,2106697,44869,1954958,2348174,151739
19,ENSG00000161609.4,49388249,19-49390280-A-G,rs10413687,1,A,G,49390280,2031,49191641,49584857,198639
19,ENSG00000160352.9,21082203,19-20997981-T-C,rs10413841,1,T,C,20997981,84222,20885595,21278811,112386
19,ENSG00000105723.6,42242602,19-42081822-T-C,rs10414151,-1,T,C,42081822,160780,42045994,42439210,35828
19,ENSG00000105723.6,42242602,19-42081822-T-G,rs10414151,-1,T,G,42081822,160780,42045994,42439210,35828
19,ENSG00000182087.6,1021123,19-1020288-A-G,rs10414196,-1,A,G,1020288,835,824515,1217731,195773
19,ENSG00000182087.6,1021123,19-1020288-A-C,rs10414196,-1,A,C,1020288,835,824515,1217731,195773
19,ENSG00000196605.2,9768617,19-9724944-G-A,rs10414758,-1,G,A,9724944,43673,9572009,9965225,152935
19,ENSG00000196605.2,9768617,19-9724944-G-T,rs10414758,-1,G,T,9724944,43673,9572009,9965225,152935
19,ENSG00000196605.2,9768617,19-9724944-G-C,rs10414758,-1,G,C,9724944,43673,9572009,9965225,152935
19,ENSG00000053501.7,17215357,19-17401603-G-A,rs10415893,1,G,A,17401603,186246,17018749,17411965,382854
19,ENSG00000197937.5,53159053,19-53159053-T-C,rs10417172,-1,T,C,53159053,0,52962445,53355661,196608
19,ENSG00000197937.5,53159053,19-53159053-T-A,rs10417172,-1,T,A,53159053,0,52962445,53355661,196608
19,ENSG00000127903.10,56671757,19-56670599-C-T,rs10420727,-1,C,T,56670599,1158,56475149,56868365,195450
19,ENSG00000125910.3,3178769,19-3171567-A-G,rs10421389,1,A,G,3171567,7202,2982161,3375377,189406
19,ENSG00000127220.3,17303425,19-17345414-A-G,rs10421557,-1,A,G,17345414,41989,17106817,17500033,238597
19,ENSG00000127220.3,17303425,19-17345414-A-T,rs10421557,-1,A,T,17345414,41989,17106817,17500033,238597
19,ENSG00000141905.11,3366583,19-3379048-A-G,rs10422402,1,A,G,3379048,12465,3169975,3563191,209073
19,ENSG00000141905.11,3366583,19-3379048-A-T,rs10422402,1,A,T,3379048,12465,3169975,3563191,209073
19,ENSG00000196263.2,56507855,19-56403850-A-G,rs10424112,1,A,G,56403850,104005,56311247,56704463,92603
19,ENSG00000198046.5,56477345,19-56403850-A-G,rs10424112,-1,A,G,56403850,73495,56280737,56673953,123113
19,ENSG00000007255.5,45178237,19-45136866-A-G,rs10425074,-1,A,G,45136866,41371,44981629,45374845,155237
19,ENSG00000197497.5,53193358,19-53194155-A-C,rs10426161,-1,A,C,53194155,797,52996750,53389966,197405
19,ENSG00000197497.5,53193358,19-53194155-A-T,rs10426161,-1,A,T,53194155,797,52996750,53389966,197405
19,ENSG00000197128.5,57477566,19-57472437-A-G,rs10426255,-1,A,G,57472437,5129,57280958,57674174,191479
19,ENSG00000197128.5,57477566,19-57472437-A-C,rs10426255,-1,A,C,57472437,5129,57280958,57674174,191479
19,ENSG00000171236.6,4540036,19-4651257-G-A,rs10426502,-1,G,A,4651257,111221,4343428,4736644,307829
19,ENSG00000214456.3,4535224,19-4651257-G-A,rs10426502,-1,G,A,4651257,116033,4338616,4731832,312641
19,ENSG00000226763.2,43612088,19-43795146-C-T,rs10426528,1,C,T,43795146,183058,43415480,43808696,379666
19,ENSG00000099817.6,1095375,19-1084573-A-G,rs10426888,-1,A,G,1084573,10802,898767,1291983,185806
19,ENSG00000130813.12,10086317,19-10046990-A-G,rs10432313,1,A,G,10046990,39327,9889709,10282925,157281
19,ENSG00000130812.5,10102678,19-10046990-A-G,rs10432313,-1,A,G,10046990,55688,9906070,10299286,140920
19,ENSG00000213024.4,49929504,19-49911460-C-T,rs1044167,-1,C,T,49911460,18044,49732896,50126112,178564
19,ENSG00000089327.8,35154735,19-35169849-C-T,rs1046345,1,C,T,35169849,15114,34958127,35351343,211722
19,ENSG00000179115.5,12933711,19-12943967-G-T,rs1049481,-1,G,T,12943967,10256,12737103,13130319,206864
19,ENSG00000179115.5,12933711,19-12943967-G-C,rs1049481,-1,G,C,12943967,10256,12737103,13130319,206864
19,ENSG00000168661.8,34926903,19-34908502-C-T,rs10518287,1,C,T,34908502,18401,34730295,35123511,178207
19,ENSG00000221923.3,52369923,19-52366799-C-T,rs1054612,1,C,T,52366799,3124,52173315,52566531,193484
19,ENSG00000221923.3,52369923,19-52366799-C-G,rs1054612,1,C,G,52366799,3124,52173315,52566531,193484
19,ENSG00000221923.3,52369923,19-52366799-C-A,rs1054612,1,C,A,52366799,3124,52173315,52566531,193484
19,ENSG00000130513.3,18386158,19-18388974-C-T,rs1055150,1,C,T,18388974,2816,18189550,18582766,199424
19,ENSG00000130513.3,18386158,19-18388974-C-A,rs1055150,1,C,A,18388974,2816,18189550,18582766,199424
19,ENSG00000130513.3,18386158,19-18388974-C-G,rs1055150,1,C,G,18388974,2816,18189550,18582766,199424
19,ENSG00000256087.1,52048838,19-51855916-C-T,rs1056294,-1,C,T,51855916,192922,51852230,52245446,3686
19,ENSG00000124299.7,33521791,19-33387292-A-T,rs1061338,-1,A,T,33387292,134499,33325183,33718399,62109
19,ENSG00000124299.7,33521791,19-33387292-A-G,rs1061338,-1,A,G,33387292,134499,33325183,33718399,62109
19,ENSG00000125735.5,6670160,19-6668961-C-G,rs1077667,-1,C,G,6668961,1199,6473552,6866768,195409
19,ENSG00000125735.5,6670160,19-6668961-C-T,rs1077667,-1,C,T,6668961,1199,6473552,6866768,195409
19,ENSG00000104872.5,49451814,19-49465828-C-A,rs10853810,-1,C,A,49465828,14014,49255206,49648422,210622
19,ENSG00000104872.5,49451814,19-49465828-C-T,rs10853810,-1,C,T,49465828,14014,49255206,49648422,210622
19,ENSG00000065268.3,984345,19-990702-C-T,rs10854001,1,C,T,990702,6357,787737,1180953,202965
19,ENSG00000105186.7,32675180,19-32655508-T-C,rs1103851,-1,T,C,32655508,19672,32478572,32871788,176936
19,ENSG00000105619.8,54115657,19-54124919-A-G,rs11084311,-1,A,G,54124919,9262,53919049,54312265,205870
19,ENSG00000141985.4,4400547,19-4368145-C-T,rs11085072,-1,C,T,4368145,32402,4203939,4597155,164206
19,ENSG00000141965.3,4791734,19-4794245-T-C,rs11085099,1,T,C,4794245,2511,4595126,4988342,199119
19,ENSG00000141965.3,4791734,19-4794245-T-G,rs11085099,1,T,G,4794245,2511,4595126,4988342,199119
19,ENSG00000141965.3,4791734,19-4794245-T-A,rs11085099,1,T,A,4794245,2511,4595126,4988342,199119
19,ENSG00000256229.1,20167214,19-20276525-G-A,rs11085305,1,G,A,20276525,109311,19970606,20363822,305919
19,ENSG00000182141.4,21329410,19-21244575-A-T,rs11085438,-1,A,T,21244575,84835,21132802,21526018,111773
19,ENSG00000182141.4,21329410,19-21244575-A-G,rs11085438,-1,A,G,21244575,84835,21132802,21526018,111773
19,ENSG00000079999.8,10503356,19-10422436-C-G,rs11085732,-1,C,G,10422436,80920,10306748,10699964,115688
19,ENSG00000142444.5,10928811,19-10954733-A-C,rs11085752,1,A,C,10954733,25922,10732203,11125419,222530
19,ENSG00000142444.5,10928811,19-10954733-A-G,rs11085752,1,A,G,10954733,25922,10732203,11125419,222530
19,ENSG00000127616.9,10961030,19-11017920-A-G,rs11085754,1,A,G,11017920,56890,10764422,11157638,253498
19,ENSG00000260001.1,7914830,19-8072959-A-C,rs111332402,1,A,C,8072959,158129,7718222,8111438,354737
19,ENSG00000115255.5,1491181,19-1497494-G-T,rs111564187,1,G,T,1497494,6313,1294573,1687789,202921
19,ENSG00000115255.5,1491181,19-1497494-G-A,rs111564187,1,G,A,1497494,6313,1294573,1687789,202921
19,ENSG00000127527.7,16471970,19-16339063-C-A,rs111776577,-1,C,A,16339063,132907,16275362,16668578,63701
19,ENSG00000130175.4,11435635,19-11447636-A-G,rs111813645,1,A,G,11447636,12001,11239027,11632243,208609
19,ENSG00000187266.7,11384314,19-11447636-A-G,rs111813645,-1,A,G,11447636,63322,11187706,11580922,259930
19,ENSG00000104870.6,49512661,19-49513222-T-G,rs111981233,1,T,G,49513222,561,49316053,49709269,197169
19,ENSG00000099624.2,1241751,19-1150087-C-T,rs111984437,1,C,T,1150087,91664,1045143,1438359,104944
19,ENSG00000213967.5,23914886,19-23950679-C-T,rs1122950,1,C,T,23950679,35793,23718278,24111494,232401
19,ENSG00000205744.4,6481787,19-6381626-G-A,rs113337492,-1,G,A,6381626,100161,6285179,6678395,96447
19,ENSG00000160877.4,13118264,19-13201861-C-G,rs113906375,1,C,G,13201861,83597,12921656,13314872,280205
19,ENSG00000018869.10,56393534,19-56273852-T-C,rs115099495,-1,T,C,56273852,119682,56196926,56590142,76926
19,ENSG00000077348.3,41397359,19-41410644-C-T,rs11549936,-1,C,T,41410644,13285,41200751,41593967,209893
19,ENSG00000077348.3,41397359,19-41410644-C-A,rs11549936,-1,C,A,41410644,13285,41200751,41593967,209893
19,ENSG00000077348.3,41397359,19-41410644-C-G,rs11549936,-1,C,G,41410644,13285,41200751,41593967,209893
19,ENSG00000186230.5,57435325,19-57428251-C-G,rs11665675,1,C,G,57428251,7074,57238717,57631933,189534
19,ENSG00000186230.5,57435325,19-57428251-C-T,rs11665675,1,C,T,57428251,7074,57238717,57631933,189534
19,ENSG00000186230.5,57435325,19-57428251-C-A,rs11665675,1,C,A,57428251,7074,57238717,57631933,189534
19,ENSG00000087088.14,48954875,19-48758444-C-T,rs11665841,1,C,T,48758444,196431,48758267,49151483,177
19,ENSG00000160953.8,1354959,19-1389518-C-G,rs11666067,1,C,G,1389518,34559,1158351,1551567,231167
19,ENSG00000160953.8,1354959,19-1389518-C-T,rs11666067,1,C,T,1389518,34559,1158351,1551567,231167
19,ENSG00000160953.8,1354959,19-1389518-C-A,rs11666067,1,C,A,1389518,34559,1158351,1551567,231167
19,ENSG00000174837.8,6887579,19-6920086-T-C,rs11668744,1,T,C,6920086,32507,6690971,7084187,229115
19,ENSG00000197619.7,52008211,19-51981396-G-A,rs11669564,-1,G,A,51981396,26815,51811603,52204819,169793
19,ENSG00000183850.7,23117025,19-23134145-C-T,rs11670477,1,C,T,23134145,17120,22920417,23313633,213728
19,ENSG00000011304.10,797452,19-711637-C-A,rs11671100,1,C,A,711637,85815,600844,994060,110793
19,ENSG00000130309.4,17555649,19-17507002-G-A,rs11671357,1,G,A,17507002,48647,17359041,17752257,147961
19,ENSG00000187912.7,14583084,19-14596218-T-A,rs11671501,1,T,A,14596218,13134,14386476,14779692,209742
19,ENSG00000187912.7,14583084,19-14596218-T-C,rs11671501,1,T,C,14596218,13134,14386476,14779692,209742
19,ENSG00000130299.10,17337553,19-17256283-T-C,rs11671659,1,T,C,17256283,81270,17140945,17534161,115338
19,ENSG00000010310.3,45668221,19-45669020-G-A,rs11671664,1,G,A,45669020,799,45471613,45864829,197407
19,ENSG00000125657.2,6531026,19-6501987-C-T,rs11672092,1,C,T,6501987,29039,6334418,6727634,167569
19,ENSG00000121289.11,32971958,19-32884435-C-T,rs11672662,-1,C,T,32884435,87523,32775350,33168566,109085
19,ENSG00000076662.4,10339624,19-10327765-C-T,rs11673632,-1,C,T,10327765,11859,10143016,10536232,184749
19,ENSG00000099875.8,2051244,19-2173964-T-G,rs116853588,-1,T,G,2173964,122720,1854636,2247852,319328
19,ENSG00000130159.6,11529134,19-11510616-C-T,rs116893606,-1,C,T,11510616,18518,11332526,11725742,178090
19,ENSG00000123143.7,14433306,19-14363842-C-A,rs116910289,1,C,A,14363842,69464,14236698,14629914,127144
19,ENSG00000123143.7,14433306,19-14363842-C-T,rs116910289,1,C,T,14363842,69464,14236698,14629914,127144
19,ENSG00000099822.1,589881,19-658335-C-T,rs116941761,1,C,T,658335,68454,393273,786489,265062
19,ENSG00000182566.6,7732110,19-7731701-T-G,rs117034642,-1,T,G,7731701,409,7535502,7928718,196199
19,ENSG00000134815.12,47349315,19-47263212-A-G,rs117098219,1,A,G,47263212,86103,47152707,47545923,110505
19,ENSG00000134815.12,47349315,19-47263212-A-C,rs117098219,1,A,C,47263212,86103,47152707,47545923,110505
19,ENSG00000011243.10,15418988,19-15402192-T-C,rs117122231,-1,T,C,15402192,16796,15222380,15615596,179812
19,ENSG00000189144.6,37779586,19-37735595-C-A,rs117173235,-1,C,A,37735595,43991,37582978,37976194,152617
19,ENSG00000188368.4,42302132,19-42183461-C-A,rs117187065,1,C,A,42183461,118671,42105524,42498740,77937
19,ENSG00000188368.4,42302132,19-42183461-C-T,rs117187065,1,C,T,42183461,118671,42105524,42498740,77937
19,ENSG00000180061.4,55325341,19-55308477-C-T,rs1172822,-1,C,T,55308477,16864,55128733,55521949,179744
19,ENSG00000118160.7,47471893,19-47419614-A-T,rs117390197,-1,A,T,47419614,52279,47275285,47668501,144329
19,ENSG00000118160.7,47471893,19-47419614-A-G,rs117390197,-1,A,G,47419614,52279,47275285,47668501,144329
19,ENSG00000105583.4,12669415,19-12694610-C-T,rs117566511,-1,C,T,12694610,25195,12472807,12866023,221803
19,ENSG00000130881.6,33194330,19-33279980-C-T,rs117588766,1,C,T,33279980,85650,32997722,33390938,282258
19,ENSG00000127511.4,16829398,19-17024826-T-A,rs117589420,1,T,A,17024826,195428,16632790,17026006,392036
19,ENSG00000127511.4,16829398,19-17024826-T-C,rs117589420,1,T,C,17024826,195428,16632790,17026006,392036
19,ENSG00000105443.8,48469369,19-48538718-T-C,rs117651565,1,T,C,48538718,69349,48272761,48665977,265957
19,ENSG00000072071.11,14206169,19-14370633-C-T,rs117809409,-1,C,T,14370633,164464,14009561,14402777,361072
19,ENSG00000072071.11,14206169,19-14370633-C-G,rs117809409,-1,C,G,14370633,164464,14009561,14402777,361072
19,ENSG00000079385.14,42528481,19-42668795-A-G,rs117831884,-1,A,G,42668795,140314,42331873,42725089,336922
19,ENSG00000189164.8,37371099,19-37407574-C-T,rs117985733,1,C,T,37407574,36475,37174491,37567707,233083
19,ENSG00000099331.7,17075777,19-17046798-C-T,rs118025973,1,C,T,17046798,28979,16879169,17272385,167629
19,ENSG00000174652.12,9435573,19-9421017-C-T,rs11880207,-1,C,T,9421017,14556,9238965,9632181,182052
19,ENSG00000142453.6,10871553,19-10881151-G-A,rs11880628,1,G,A,10881151,9598,10674945,11068161,206206
19,ENSG00000197933.6,11738946,19-11717595-A-G,rs11882565,-1,A,G,11717595,21351,11542338,11935554,175257
19,ENSG00000008382.10,4343562,19-4352962-A-G,rs11882587,1,A,G,4352962,9400,4146954,4540170,206008
19,ENSG00000095066.6,12775552,19-12794432-C-A,rs1205170,-1,C,A,12794432,18880,12578944,12972160,215488
19,ENSG00000105429.7,42325635,19-42351015-T-C,rs1206028,1,T,C,42351015,25380,42129027,42522243,221988
19,ENSG00000167619.6,42313309,19-42336734-G-A,rs1206036,1,G,A,42336734,23425,42116701,42509917,220033
19,ENSG00000197951.3,56595302,19-56573310-G-A,rs12104210,1,G,A,56573310,21992,56398694,56791910,174616
19,ENSG00000197951.3,56595302,19-56573310-G-C,rs12104210,1,G,C,56573310,21992,56398694,56791910,174616
19,ENSG00000197951.3,56595302,19-56573310-G-T,rs12104210,1,G,T,56573310,21992,56398694,56791910,174616
19,ENSG00000171469.6,9621232,19-9704486-A-G,rs12104234,-1,A,G,9704486,83254,9424624,9817840,279862
19,ENSG00000179262.3,12945862,19-13101211-C-T,rs12151248,1,C,T,13101211,155349,12749254,13142470,351957
19,ENSG00000179262.3,12945862,19-13101211-C-A,rs12151248,1,C,A,13101211,155349,12749254,13142470,351957
19,ENSG00000167654.11,3880685,19-3743705-G-A,rs12459269,1,G,A,3743705,136980,3684077,4077293,59628
19,ENSG00000115257.9,1490408,19-1495278-C-G,rs12459408,-1,C,G,1495278,4870,1293800,1687016,201478
19,ENSG00000115257.9,1490408,19-1495278-C-T,rs12459408,-1,C,T,1495278,4870,1293800,1687016,201478
19,ENSG00000160013.3,46625089,19-46623357-C-G,rs12459883,-1,C,G,46623357,1732,46428481,46821697,194876
19,ENSG00000160013.3,46625089,19-46623357-C-T,rs12459883,-1,C,T,46623357,1732,46428481,46821697,194876
19,ENSG00000105298.7,3626790,19-3645949-G-A,rs12460780,-1,G,A,3645949,19159,3430182,3823398,215767
19,ENSG00000105298.7,3626790,19-3645949-G-C,rs12460780,-1,G,C,3645949,19159,3430182,3823398,215767
19,ENSG00000105298.7,3626790,19-3645949-G-T,rs12460780,-1,G,T,3645949,19159,3430182,3823398,215767
19,ENSG00000244165.1,10111693,19-10111519-A-T,rs12460842,1,A,T,10111519,174,9915085,10308301,196434
19,ENSG00000244165.1,10111693,19-10111519-A-C,rs12460842,1,A,C,10111519,174,9915085,10308301,196434
19,ENSG00000244165.1,10111693,19-10111519-A-G,rs12460842,1,A,G,10111519,174,9915085,10308301,196434
19,ENSG00000178980.9,47778703,19-47738727-C-T,rs12461370,1,C,T,47738727,39976,47582095,47975311,156632
19,ENSG00000133243.3,2015714,19-1988445-C-A,rs12461737,-1,C,A,1988445,27269,1819106,2212322,169339
19,ENSG00000133243.3,2015714,19-1988445-C-T,rs12461737,-1,C,T,1988445,27269,1819106,2212322,169339
19,ENSG00000248099.2,17821519,19-17816476-T-G,rs12462622,-1,T,G,17816476,5043,17624911,18018127,191565
19,ENSG00000181007.6,36418644,19-36367183-T-C,rs12462725,-1,T,C,36367183,51461,36222036,36615252,145147
19,ENSG00000063180.3,48646187,19-48618792-T-C,rs12608448,-1,T,C,48618792,27395,48449579,48842795,169213
19,ENSG00000089639.5,19643657,19-19603995-T-C,rs12611058,-1,T,C,19603995,39662,19447049,19840265,156946
19,ENSG00000171291.3,11848726,19-11851818-T-C,rs12972457,1,T,C,11851818,3092,11652118,12045334,199700
19,ENSG00000010361.7,49813292,19-49811481-A-C,rs12973635,-1,A,C,49811481,1811,49616684,50009900,194797
19,ENSG00000170608.1,45864326,19-45877352-G-T,rs12974366,1,G,T,45877352,13026,45667718,46060934,209634
19,ENSG00000170608.1,45864326,19-45877352-G-A,rs12974366,1,G,A,45877352,13026,45667718,46060934,209634
19,ENSG00000077009.7,3933069,19-4020447-T-C,rs12975232,1,T,C,4020447,87378,3736461,4129677,283986
19,ENSG00000077009.7,3933069,19-4020447-T-G,rs12975232,1,T,G,4020447,87378,3736461,4129677,283986
19,ENSG00000077009.7,3933069,19-4020447-T-A,rs12975232,1,T,A,4020447,87378,3736461,4129677,283986
19,ENSG00000186806.3,51342139,19-51299282-C-T,rs12976697,-1,C,T,51299282,42857,51145531,51538747,153751
19,ENSG00000182013.11,46471563,19-46471049-A-C,rs12978825,-1,A,C,46471049,514,46274955,46668171,196094
19,ENSG00000105699.9,35249002,19-35257803-A-G,rs12979792,1,A,G,35257803,8801,35052394,35445610,205409
19,ENSG00000130545.10,6464271,19-6458718-C-T,rs12980141,1,C,T,6458718,5553,6267663,6660879,191055
19,ENSG00000104946.4,49877702,19-49905398-G-T,rs12980435,1,G,T,49905398,27696,49681094,50074310,224304
19,ENSG00000105755.2,43527201,19-43504376-C-T,rs12980646,-1,C,T,43504376,22825,43330593,43723809,173783
19,ENSG00000105755.2,43527201,19-43504376-C-A,rs12980646,-1,C,A,43504376,22825,43330593,43723809,173783
19,ENSG00000160961.6,14690048,19-14776080-A-C,rs12980660,1,A,C,14776080,86032,14493440,14886656,282640
19,ENSG00000160961.6,14690048,19-14776080-A-T,rs12980660,1,A,T,14776080,86032,14493440,14886656,282640
19,ENSG00000160961.6,14690048,19-14776080-A-G,rs12980660,1,A,G,14776080,86032,14493440,14886656,282640
19,ENSG00000127507.11,14778560,19-14776080-A-C,rs12980660,-1,A,C,14776080,2480,14581952,14975168,194128
19,ENSG00000127507.11,14778560,19-14776080-A-T,rs12980660,-1,A,T,14776080,2480,14581952,14975168,194128
19,ENSG00000127507.11,14778560,19-14776080-A-G,rs12980660,-1,A,G,14776080,2480,14581952,14975168,194128
19,ENSG00000186115.5,15898074,19-15938038-G-A,rs12980757,-1,G,A,15938038,39964,15701466,16094682,236572
19,ENSG00000161277.6,36054285,19-36033380-T-G,rs12981654,-1,T,G,36033380,20905,35857677,36250893,175703
19,ENSG00000161277.6,36054285,19-36033380-T-C,rs12981654,-1,T,C,36033380,20905,35857677,36250893,175703
19,ENSG00000074219.8,49362416,19-49297912-T-C,rs12982246,-1,T,C,49297912,64504,49165808,49559024,132104
19,ENSG00000074219.8,49362416,19-49297912-T-A,rs12982246,-1,T,A,49297912,64504,49165808,49559024,132104
19,ENSG00000105750.8,20923251,19-20965579-T-G,rs12983125,1,T,G,20965579,42328,20726643,21119859,238936
19,ENSG00000105750.8,20923251,19-20965579-T-A,rs12983125,1,T,A,20965579,42328,20726643,21119859,238936
19,ENSG00000188785.6,57389854,19-57406904-C-G,rs12984074,1,C,G,57406904,17050,57193246,57586462,213658
19,ENSG00000142065.7,36379201,19-36536168-A-C,rs12984401,-1,A,C,36536168,156967,36182593,36575809,353575
19,ENSG00000099804.2,531760,19-533201-G-A,rs12984645,1,G,A,533201,1441,335152,728368,198049
19,ENSG00000099804.2,531760,19-533201-G-C,rs12984645,1,G,C,533201,1441,335152,728368,198049
19,ENSG00000105227.8,40413378,19-40401029-C-T,rs12985877,-1,C,T,40401029,12349,40216770,40609986,184259
19,ENSG00000105568.11,52190052,19-52190024-T-C,rs13344984,1,T,C,52190024,28,51993444,52386660,196580
19,ENSG00000181029.6,7680833,19-7497110-T-C,rs1363938,1,T,C,7497110,183723,7484225,7877441,12885
19,ENSG00000183617.3,3762682,19-3762700-C-T,rs13960,1,C,T,3762700,18,3566074,3959290,196626
19,ENSG00000183617.3,3762682,19-3762700-C-A,rs13960,1,C,A,3762700,18,3566074,3959290,196626
19,ENSG00000183617.3,3762682,19-3762700-C-G,rs13960,1,C,G,3762700,18,3566074,3959290,196626
19,ENSG00000039987.2,12751791,19-12883437-C-G,rs140010597,1,C,G,12883437,131646,12555183,12948399,328254
19,ENSG00000039987.2,12751791,19-12883437-C-T,rs140010597,1,C,T,12883437,131646,12555183,12948399,328254
19,ENSG00000186204.8,15673087,19-15775732-G-A,rs1465708,1,G,A,15775732,102645,15476479,15869695,299253
19,ENSG00000159915.6,44259886,19-44386512-A-G,rs148795043,1,A,G,44386512,126626,44063278,44456494,323234
19,ENSG00000205517.6,11419314,19-11461837-G-C,rs1531101,-1,G,C,11461837,42523,11222706,11615922,239131
19,ENSG00000205517.6,11419314,19-11461837-G-T,rs1531101,-1,G,T,11461837,42523,11222706,11615922,239131
19,ENSG00000213889.5,45498443,19-45492798-G-A,rs1573606,1,G,A,45492798,5645,45301835,45695051,190963
19,ENSG00000213889.5,45498443,19-45492798-G-T,rs1573606,1,G,T,45492798,5645,45301835,45695051,190963
19,ENSG00000213889.5,45498443,19-45492798-G-C,rs1573606,1,G,C,45492798,5645,45301835,45695051,190963
19,ENSG00000197020.5,21767579,19-21680617-T-C,rs1589280,-1,T,C,21680617,86962,21570971,21964187,109646
19,ENSG00000125503.6,55117637,19-55066696-T-C,rs1654460,-1,T,C,55066696,50941,54921029,55314245,145667
19,ENSG00000125503.6,55117637,19-55066696-T-A,rs1654460,-1,T,A,55066696,50941,54921029,55314245,145667
19,ENSG00000105472.6,50723364,19-50907860-T-C,rs1654553,1,T,C,50907860,184496,50526756,50919972,381104
19,ENSG00000105472.6,50723364,19-50907860-T-A,rs1654553,1,T,A,50907860,184496,50526756,50919972,381104
19,ENSG00000105472.6,50723364,19-50907860-T-G,rs1654553,1,T,G,50907860,184496,50526756,50919972,381104
19,ENSG00000160439.9,55063148,19-55062265-G-T,rs1671169,-1,G,T,55062265,883,54866540,55259756,195725
19,ENSG00000160439.9,55063148,19-55062265-G-A,rs1671169,-1,G,A,55062265,883,54866540,55259756,195725
19,ENSG00000197766.1,859664,19-869037-A-G,rs1683591,1,A,G,869037,9373,663056,1056272,205981
19,ENSG00000120784.9,37655465,19-37633334-A-G,rs16958863,-1,A,G,37633334,22131,37458857,37852073,174477
19,ENSG00000177025.2,57974534,19-57826845-C-G,rs16960555,-1,C,G,57826845,147689,57777926,58171142,48919
19,ENSG00000177025.2,57974534,19-57826845-C-T,rs16960555,-1,C,T,57826845,147689,57777926,58171142,48919
19,ENSG00000177025.2,57974534,19-57826845-C-A,rs16960555,-1,C,A,57826845,147689,57777926,58171142,48919
19,ENSG00000142541.10,49487608,19-49454349-T-C,rs16981276,1,T,C,49454349,33259,49291000,49684216,163349
19,ENSG00000142541.10,49487608,19-49454349-T-A,rs16981276,1,T,A,49454349,33259,49291000,49684216,163349
19,ENSG00000039650.4,49867576,19-49856551-C-T,rs16981492,-1,C,T,49856551,11025,49670968,50064184,185583
19,ENSG00000039650.4,49867576,19-49856551-C-G,rs16981492,-1,C,G,49856551,11025,49670968,50064184,185583
19,ENSG00000204673.5,49877355,19-49896837-C-T,rs16981522,-1,C,T,49896837,19482,49680747,50073963,216090
19,ENSG00000204673.5,49877355,19-49896837-C-G,rs16981522,-1,C,G,49896837,19482,49680747,50073963,216090
19,ENSG00000178150.3,48270081,19-48241088-T-C,rs16981853,1,T,C,48241088,28993,48073473,48466689,167615
19,ENSG00000174951.4,48752641,19-48699602-G-A,rs16982241,-1,G,A,48699602,53039,48556033,48949249,143569
19,ENSG00000167554.9,52336243,19-52333321-T-C,rs16983718,1,T,C,52333321,2922,52139635,52532851,193686
19,ENSG00000244482.3,54242791,19-54203996-G-A,rs16985475,-1,G,A,54203996,38795,54046183,54439399,157813
19,ENSG00000161091.7,3557586,19-3557007-A-T,rs1715092,-1,A,T,3557007,579,3360978,3754194,196029
19,ENSG00000161091.7,3557586,19-3557007-A-G,rs1715092,-1,A,G,3557007,579,3360978,3754194,196029
19,ENSG00000099785.5,8413305,19-8483705-G-A,rs17160520,1,G,A,8483705,70400,8216697,8609913,267008
19,ENSG00000099785.5,8413305,19-8483705-G-T,rs17160520,1,G,T,8483705,70400,8216697,8609913,267008
19,ENSG00000087076.3,48836491,19-48838980-C-G,rs17206679,-1,C,G,48838980,2489,48639883,49033099,199097
19,ENSG00000087076.3,48836491,19-48838980-C-A,rs17206679,-1,C,A,48838980,2489,48639883,49033099,199097
19,ENSG00000170889.9,54200858,19-54205460-C-T,rs17273267,1,C,T,54205460,4602,54004250,54397466,201210
19,ENSG00000130810.14,10106362,19-10206539-G-A,rs17291414,1,G,A,10206539,100177,9909754,10302970,296785
19,ENSG00000083844.5,57191500,19-57111915-G-C,rs17305542,1,G,C,57111915,79585,56994892,57388108,117023
19,ENSG00000083844.5,57191500,19-57111915-G-T,rs17305542,1,G,T,57111915,79585,56994892,57388108,117023
19,ENSG00000172006.6,2819868,19-2790396-G-T,rs1736176,1,G,T,2790396,29472,2623260,3016476,167136
19,ENSG00000172006.6,2819868,19-2790396-G-A,rs1736176,1,G,A,2790396,29472,2623260,3016476,167136
19,ENSG00000130751.4,47019837,19-46894238-C-A,rs17367673,1,C,A,46894238,125599,46823229,47216445,71009
19,ENSG00000130751.4,47019837,19-46894238-C-G,rs17367673,1,C,G,46894238,125599,46823229,47216445,71009
19,ENSG00000130751.4,47019837,19-46894238-C-T,rs17367673,1,C,T,46894238,125599,46823229,47216445,71009
19,ENSG00000189114.5,45178784,19-45103881-G-A,rs17562787,1,G,A,45103881,74903,44982176,45375392,121705
19,ENSG00000167685.8,56141287,19-56011557-C-T,rs17608620,1,C,T,56011557,129730,55944679,56337895,66878
19,ENSG00000130669.11,39125802,19-39183394-A-C,rs17641276,1,A,C,39183394,57592,38929194,39322410,254200
19,ENSG00000130669.11,39125802,19-39183394-A-G,rs17641276,1,A,G,39183394,57592,38929194,39322410,254200
19,ENSG00000130669.11,39125802,19-39183394-A-T,rs17641276,1,A,T,39183394,57592,38929194,39322410,254200
19,ENSG00000104953.11,2977564,19-2977601-C-G,rs17681742,1,C,G,2977601,37,2780956,3174172,196645
19,ENSG00000104953.11,2977564,19-2977601-C-T,rs17681742,1,C,T,2977601,37,2780956,3174172,196645
19,ENSG00000070423.10,663214,19-741758-G-A,rs17684039,-1,G,A,741758,78544,466606,859822,275152
19,ENSG00000108107.7,55385932,19-55385959-A-C,rs17700376,1,A,C,55385959,27,55189324,55582540,196635
19,ENSG00000108107.7,55385932,19-55385959-A-G,rs17700376,1,A,G,55385959,27,55189324,55582540,196635
19,ENSG00000099338.14,38335830,19-38490363-C-A,rs17708009,1,C,A,38490363,154533,38139222,38532438,351141
19,ENSG00000099338.14,38335830,19-38490363-C-T,rs17708009,1,C,T,38490363,154533,38139222,38532438,351141
19,ENSG00000176920.10,48695971,19-48703029-A-G,rs1800021,1,A,G,48703029,7058,48499363,48892579,203666
19,ENSG00000167601.6,41219223,19-41341955-G-A,rs1800472,1,G,A,41341955,122732,41022615,41415831,319340
19,ENSG00000126264.4,35902529,19-35904544-T-G,rs1802029,1,T,G,35904544,2015,35705921,36099137,198623
19,ENSG00000130270.8,1812276,19-1823761-C-T,rs186176871,-1,C,T,1823761,11485,1615668,2008884,208093
19,ENSG00000174788.4,7633719,19-7633434-C-T,rs1862514,-1,C,T,7633434,285,7437111,7830327,196323
19,ENSG00000197857.7,12294883,19-12111566-C-G,rs1866382,-1,C,G,12111566,183317,12098275,12491491,13291
19,ENSG00000197857.7,12294883,19-12111566-C-A,rs1866382,-1,C,A,12111566,183317,12098275,12491491,13291
19,ENSG00000197857.7,12294883,19-12111566-C-T,rs1866382,-1,C,T,12111566,183317,12098275,12491491,13291
19,ENSG00000175489.6,18397622,19-18402784-T-G,rs1985157,-1,T,G,18402784,5162,18201014,18594230,201770
19,ENSG00000175489.6,18397622,19-18402784-T-A,rs1985157,-1,T,A,18402784,5162,18201014,18594230,201770
19,ENSG00000175489.6,18397622,19-18402784-T-C,rs1985157,-1,T,C,18402784,5162,18201014,18594230,201770
19,ENSG00000131845.9,57351271,19-57366826-G-T,rs1989455,1,G,T,57366826,15555,57154663,57547879,212163
19,ENSG00000131845.9,57351271,19-57366826-G-C,rs1989455,1,G,C,57366826,15555,57154663,57547879,212163
19,ENSG00000131845.9,57351271,19-57366826-G-A,rs1989455,1,G,A,57366826,15555,57154663,57547879,212163
19,ENSG00000197016.6,56567468,19-56581001-C-T,rs2024395,1,C,T,56581001,13533,56370860,56764076,210141
19,ENSG00000171747.3,38812945,19-38812203-A-G,rs2052569,-1,A,G,38812203,742,38616337,39009553,195866
19,ENSG00000167645.11,38315947,19-38500903-G-A,rs2071088,-1,G,A,38500903,184956,38119339,38512555,381564
19,ENSG00000064687.7,1040107,19-1073074-A-T,rs2072102,1,A,T,1073074,32967,843499,1236715,229575
19,ENSG00000064687.7,1040107,19-1073074-A-G,rs2072102,1,A,G,1073074,32967,843499,1236715,229575
19,ENSG00000064687.7,1040107,19-1073074-A-C,rs2072102,1,A,C,1073074,32967,843499,1236715,229575
19,ENSG00000179909.9,57709204,19-57746752-G-C,rs2074080,-1,G,C,57746752,37548,57512596,57905812,234156
19,ENSG00000179909.9,57709204,19-57746752-G-A,rs2074080,-1,G,A,57746752,37548,57512596,57905812,234156
19,ENSG00000179909.9,57709204,19-57746752-G-T,rs2074080,-1,G,T,57746752,37548,57512596,57905812,234156
19,ENSG00000204514.3,57889037,19-57746752-G-C,rs2074080,-1,G,C,57746752,142285,57692429,58085645,54323
19,ENSG00000204514.3,57889037,19-57746752-G-A,rs2074080,-1,G,A,57746752,142285,57692429,58085645,54323
19,ENSG00000204514.3,57889037,19-57746752-G-T,rs2074080,-1,G,T,57746752,142285,57692429,58085645,54323
19,ENSG00000105771.8,43754962,19-43734195-A-G,rs2074634,-1,A,G,43734195,20767,43558354,43951570,175841
19,ENSG00000121417.9,57633168,19-57618090-A-G,rs2079033,1,A,G,57618090,15078,57436560,57829776,181530
19,ENSG00000121417.9,57633168,19-57618090-A-T,rs2079033,1,A,T,57618090,15078,57436560,57829776,181530
19,ENSG00000196684.6,16143685,19-16223187-G-A,rs2124902,1,G,A,16223187,79502,15947077,16340293,276110
19,ENSG00000060566.7,4153631,19-4186146-C-T,rs2159981,1,C,T,4186146,32515,3957023,4350239,229123
19,ENSG00000196172.8,23758891,19-23838525-G-A,rs2194275,-1,G,A,23838525,79634,23562283,23955499,276242
19,ENSG00000127533.2,16888999,19-16894218-C-T,rs2227359,1,C,T,16894218,5219,16692391,17085607,201827
19,ENSG00000172270.12,572596,19-580388-C-T,rs2229664,1,C,T,580388,7792,375988,769204,204400
19,ENSG00000172270.12,572596,19-580388-C-G,rs2229664,1,C,G,580388,7792,375988,769204,204400
19,ENSG00000172270.12,572596,19-580388-C-A,rs2229664,1,C,A,580388,7792,375988,769204,204400
19,ENSG00000105258.3,36114875,19-36114892-C-G,rs2231568,-1,C,G,36114892,17,35918267,36311483,196625
19,ENSG00000105258.3,36114875,19-36114892-C-A,rs2231568,-1,C,A,36114892,17,35918267,36311483,196625
19,ENSG00000105258.3,36114875,19-36114892-C-T,rs2231568,-1,C,T,36114892,17,35918267,36311483,196625
19,ENSG00000051128.12,18941217,19-18831750-C-G,rs2238652,-1,C,G,18831750,109467,18744609,19137825,87141
19,ENSG00000051128.12,18941217,19-18831750-C-T,rs2238652,-1,C,T,18831750,109467,18744609,19137825,87141
19,ENSG00000051128.12,18941217,19-18831750-C-A,rs2238652,-1,C,A,18831750,109467,18744609,19137825,87141
19,ENSG00000012124.9,35329187,19-35340746-C-A,rs2239512,1,C,A,35340746,11559,35132579,35525795,208167
19,ENSG00000012124.9,35329187,19-35340746-C-T,rs2239512,1,C,T,35340746,11559,35132579,35525795,208167
19,ENSG00000188493.8,40750477,19-40749595-C-G,rs2254343,-1,C,G,40749595,882,40553869,40947085,195726
19,ENSG00000188493.8,40750477,19-40749595-C-T,rs2254343,-1,C,T,40749595,882,40553869,40947085,195726
19,ENSG00000188493.8,40750477,19-40749595-C-A,rs2254343,-1,C,A,40749595,882,40553869,40947085,195726
19,ENSG00000254858.2,18193218,19-18195014-C-T,rs2271881,1,C,T,18195014,1796,17996610,18389826,198404
19,ENSG00000254858.2,18193218,19-18195014-C-A,rs2271881,1,C,A,18195014,1796,17996610,18389826,198404
19,ENSG00000118162.8,47484219,19-47475414-G-A,rs2272295,-1,G,A,47475414,8805,47287611,47680827,187803
19,ENSG00000130311.5,17309563,19-17210075-A-G,rs2279001,1,A,G,17210075,99488,17112955,17506171,97120
19,ENSG00000130311.5,17309563,19-17210075-A-T,rs2279001,1,A,T,17210075,99488,17112955,17506171,97120
19,ENSG00000105668.2,35666516,19-35735098-T-G,rs2280743,1,T,G,35735098,68582,35469908,35863124,265190
19,ENSG00000105668.2,35666516,19-35735098-T-C,rs2280743,1,T,C,35735098,68582,35469908,35863124,265190
19,ENSG00000159905.8,43951228,19-43954922-T-C,rs2284243,1,T,C,43954922,3694,43754620,44147836,200302
19,ENSG00000256060.1,57363551,19-57363586-C-G,rs2285604,1,C,G,57363586,35,57166943,57560159,196643
19,ENSG00000131355.9,14674844,19-14776447-T-A,rs2286361,-1,T,A,14776447,101603,14478236,14871452,298211
19,ENSG00000131355.9,14674844,19-14776447-T-C,rs2286361,-1,T,C,14776447,101603,14478236,14871452,298211
19,ENSG00000131355.9,14674844,19-14776447-T-G,rs2286361,-1,T,G,14776447,101603,14478236,14871452,298211
19,ENSG00000130818.4,9538645,19-9469358-T-G,rs2287698,-1,T,G,9469358,69287,9342037,9735253,127321
19,ENSG00000167617.2,54473296,19-54471384-G-A,rs2287822,-1,G,A,54471384,1912,54276688,54669904,194696
19,ENSG00000105245.4,40690651,19-40703272-C-T,rs2288450,-1,C,T,40703272,12621,40494043,40887259,209229
19,ENSG00000121410.6,58353492,19-58393348-C-A,rs2289143,-1,C,A,58393348,39856,58156884,58550100,236464
19,ENSG00000121410.6,58353492,19-58393348-C-T,rs2289143,-1,C,T,58393348,39856,58156884,58550100,236464
19,ENSG00000167658.9,3985463,19-4013324-T-C,rs2289865,-1,T,C,4013324,27861,3788855,4182071,224469
19,ENSG00000188227.6,37506939,19-37507050-C-A,rs2291004,1,C,A,37507050,111,37310331,37703547,196719
19,ENSG00000188227.6,37506939,19-37507050-C-T,rs2291004,1,C,T,37507050,111,37310331,37703547,196719
19,ENSG00000105146.7,57231023,19-57230880-C-A,rs2302060,1,C,A,57230880,143,57034415,57427631,196465
19,ENSG00000105146.7,57231023,19-57230880-C-T,rs2302060,1,C,T,57230880,143,57034415,57427631,196465
19,ENSG00000105656.4,18522070,19-18446847-C-G,rs2303692,-1,C,G,18446847,75223,18325462,18718678,121385
19,ENSG00000105656.4,18522070,19-18446847-C-T,rs2303692,-1,C,T,18446847,75223,18325462,18718678,121385
19,ENSG00000090554.6,49474215,19-49365794-T-G,rs2303759,1,T,G,49365794,108421,49277607,49670823,88187
19,ENSG00000131351.9,17075452,19-17059126-G-A,rs2305756,-1,G,A,17059126,16326,16878844,17272060,180282
19,ENSG00000167578.11,40778247,19-40763171-T-C,rs2305797,1,T,C,40763171,15076,40581639,40974855,181532
19,ENSG00000004777.10,35775564,19-35769209-T-G,rs231214,1,T,G,35769209,6355,35578956,35972172,190253
19,ENSG00000004777.10,35775564,19-35769209-T-A,rs231214,1,T,A,35769209,6355,35578956,35972172,190253
19,ENSG00000004777.10,35775564,19-35769209-T-C,rs231214,1,T,C,35769209,6355,35578956,35972172,190253
19,ENSG00000221983.2,18571857,19-18581132-A-T,rs2314664,1,A,T,18581132,9275,18375249,18768465,205883
19,ENSG00000221983.2,18571857,19-18581132-A-C,rs2314664,1,A,C,18581132,9275,18375249,18768465,205883
19,ENSG00000221983.2,18571857,19-18581132-A-G,rs2314664,1,A,G,18581132,9275,18375249,18768465,205883
19,ENSG00000161618.4,49453225,19-49453753-C-T,rs2335183,1,C,T,49453753,528,49256617,49649833,197136
19,ENSG00000187187.7,39997060,19-40024036-T-C,rs234355,1,T,C,40024036,26976,39800452,40193668,223584
19,ENSG00000187187.7,39997060,19-40024036-T-A,rs234355,1,T,A,40024036,26976,39800452,40193668,223584
19,ENSG00000179922.3,55624566,19-55619339-C-T,rs2431798,-1,C,T,55619339,5227,55427958,55821174,191381
19,ENSG00000196357.6,36214665,19-36229488-C-T,rs2438517,-1,C,T,36229488,14823,36018057,36411273,211431
19,ENSG00000188305.2,2282175,19-2274579-T-C,rs2523177,-1,T,C,2274579,7596,2085567,2478783,189012
19,ENSG00000188305.2,2282175,19-2274579-T-A,rs2523177,-1,T,A,2274579,7596,2085567,2478783,189012
19,ENSG00000105650.12,18226475,19-18240262-A-T,rs2544725,-1,A,T,18240262,13787,18029867,18423083,210395
19,ENSG00000105650.12,18226475,19-18240262-A-G,rs2544725,-1,A,G,18240262,13787,18029867,18423083,210395
19,ENSG00000105650.12,18226475,19-18240262-A-C,rs2544725,-1,A,C,18240262,13787,18029867,18423083,210395
19,ENSG00000073050.5,43575527,19-43546814-T-C,rs25484,-1,T,C,43546814,28713,43378919,43772135,167895
19,ENSG00000167748.5,50823787,19-50824837-G-A,rs2560934,-1,G,A,50824837,1050,50627179,51020395,197658
19,ENSG00000167748.5,50823787,19-50824837-G-C,rs2560934,-1,G,C,50824837,1050,50627179,51020395,197658
19,ENSG00000182318.4,58326994,19-58286934-C-T,rs260474,1,C,T,58286934,40060,58130386,58523602,156548
19,ENSG00000160410.8,40576873,19-40700850-A-C,rs2604885,1,A,C,40700850,123977,40380265,40773481,320585
19,ENSG00000160410.8,40576873,19-40700850-A-T,rs2604885,1,A,T,40700850,123977,40380265,40773481,320585
19,ENSG00000205784.2,4902896,19-4933216-A-C,rs262567,-1,A,C,4933216,30320,4706288,5099504,226928
19,ENSG00000205784.2,4902896,19-4933216-A-G,rs262567,-1,A,G,4933216,30320,4706288,5099504,226928
19,ENSG00000105072.3,16496394,19-16691198-T-A,rs2633339,1,T,A,16691198,194804,16299786,16693002,391412
19,ENSG00000105072.3,16496394,19-16691198-T-C,rs2633339,1,T,C,16691198,194804,16299786,16693002,391412
19,ENSG00000105072.3,16496394,19-16691198-T-G,rs2633339,1,T,G,16691198,194804,16299786,16693002,391412
19,ENSG00000115266.6,1450121,19-1540507-A-G,rs2668433,1,A,G,1540507,90386,1253513,1646729,286994
19,ENSG00000090013.4,40465745,19-40457390-G-A,rs268692,-1,G,A,40457390,8355,40269137,40662353,188253
19,ENSG00000105383.9,51225080,19-51091973-A-C,rs2691270,1,A,C,51091973,133107,51028472,51421688,63501
19,ENSG00000105383.9,51225080,19-51091973-A-G,rs2691270,1,A,G,51091973,133107,51028472,51421688,63501
19,ENSG00000105516.5,48637379,19-48661695-A-G,rs281392,-1,A,G,48661695,24316,48440771,48833987,220924
19,ENSG00000105371.7,10286955,19-10286562-C-T,rs281437,1,C,T,10286562,393,10090347,10483563,196215
19,ENSG00000105371.7,10286955,19-10286562-C-G,rs281437,1,C,G,10286562,393,10090347,10483563,196215
19,ENSG00000188321.7,9324179,19-9324196-C-T,rs28384491,1,C,T,9324196,17,9127571,9520787,196625
19,ENSG00000129968.10,1885496,19-1806464-G-T,rs28397595,-1,G,T,1806464,79032,1688888,2082104,117576
19,ENSG00000129968.10,1885496,19-1806464-G-A,rs28397595,-1,G,A,1806464,79032,1688888,2082104,117576
19,ENSG00000177191.1,41427374,19-41426707-C-T,rs284663,-1,C,T,41426707,667,41230766,41623982,195941
19,ENSG00000177191.1,41427374,19-41426707-C-G,rs284663,-1,C,G,41426707,667,41230766,41623982,195941
19,ENSG00000181240.8,6433763,19-6436211-C-T,rs2860185,-1,C,T,6436211,2448,6237155,6630371,199056
19,ENSG00000181240.8,6433763,19-6436211-C-A,rs2860185,-1,C,A,6436211,2448,6237155,6630371,199056
19,ENSG00000181240.8,6433763,19-6436211-C-G,rs2860185,-1,C,G,6436211,2448,6237155,6630371,199056
19,ENSG00000197044.6,11767000,19-11782740-T-C,rs286217,1,T,C,11782740,15740,11570392,11963608,212348
19,ENSG00000161265.6,35745418,19-35741519-C-T,rs2871921,-1,C,T,35741519,3899,35548810,35942026,192709
19,ENSG00000229676.2,22634324,19-22656585-A-G,rs2885221,1,A,G,22656585,22261,22437716,22830932,218869
19,ENSG00000196867.1,56538948,19-56568579-G-T,rs2904239,1,G,T,56568579,29631,56342340,56735556,226239
19,ENSG00000196867.1,56538948,19-56568579-G-A,rs2904239,1,G,A,56568579,29631,56342340,56735556,226239
19,ENSG00000196867.1,56538948,19-56568579-G-C,rs2904239,1,G,C,56568579,29631,56342340,56735556,226239
19,ENSG00000185236.6,8390360,19-8339218-C-T,rs2913960,1,C,T,8339218,51142,8193752,8586968,145466
19,ENSG00000069399.7,44748708,19-44734556-T-C,rs2965101,1,T,C,44734556,14152,44552100,44945316,182456
19,ENSG00000198858.4,913219,19-896506-A-G,rs2965285,-1,A,G,896506,16713,716611,1109827,179895
19,ENSG00000161298.11,36605313,19-36536315-A-G,rs2967465,1,A,G,36536315,68998,36408705,36801921,127610
19,ENSG00000130544.6,7069703,19-7106712-G-A,rs2967661,1,G,A,7106712,37009,6873095,7266311,233617
19,ENSG00000130544.6,7069703,19-7106712-G-C,rs2967661,1,G,C,7106712,37009,6873095,7266311,233617
19,ENSG00000167785.3,8832304,19-8809491-G-T,rs2967745,-1,G,T,8809491,22813,8635696,9028912,173795
19,ENSG00000105607.6,12891160,19-12951169-C-T,rs2974754,1,C,T,12951169,60009,12694552,13087768,256617
19,ENSG00000105607.6,12891160,19-12951169-C-G,rs2974754,1,C,G,12951169,60009,12694552,13087768,256617
19,ENSG00000088256.3,3094362,19-3099984-T-A,rs308033,1,T,A,3099984,5622,2897754,3290970,202230
19,ENSG00000088256.3,3094362,19-3099984-T-C,rs308033,1,T,C,3099984,5622,2897754,3290970,202230
19,ENSG00000060558.2,3136033,19-3098247-A-T,rs308037,1,A,T,3098247,37786,2939425,3332641,158822
19,ENSG00000060558.2,3136033,19-3098247-A-G,rs308037,1,A,G,3098247,37786,2939425,3332641,158822
19,ENSG00000186020.7,36573292,19-36739589-C-A,rs3108586,-1,C,A,36739589,166297,36376684,36769900,362905
19,ENSG00000186020.7,36573292,19-36739589-C-T,rs3108586,-1,C,T,36739589,166297,36376684,36769900,362905
19,ENSG00000105287.7,46717114,19-46673568-T-C,rs314666,-1,T,C,46673568,43546,46520506,46913722,153062
19,ENSG00000142252.5,45079260,19-45090912-A-G,rs3178166,1,A,G,45090912,11652,44882652,45275868,208260
19,ENSG00000130176.2,11538851,19-11365923-C-T,rs317914,1,C,T,11365923,172928,11342243,11735459,23680
19,ENSG00000105639.13,17847982,19-17826949-C-T,rs3212798,-1,C,T,17826949,21033,17651374,18044590,175575
19,ENSG00000105639.13,17847982,19-17826949-C-A,rs3212798,-1,C,A,17826949,21033,17651374,18044590,175575
19,ENSG00000237440.2,20565781,19-20543062-G-A,rs33930,-1,G,A,20543062,22719,20369173,20762389,173889
19,ENSG00000130758.2,40191426,19-40191154-T-C,rs339526,1,T,C,40191154,272,39994818,40388034,196336
19,ENSG00000125734.7,6737580,19-6739267-C-T,rs340141,-1,C,T,6739267,1687,6540972,6934188,198295
19,ENSG00000105520.5,11355432,19-11337256-A-G,rs34053641,1,A,G,11337256,18176,11158824,11552040,178432
19,ENSG00000105520.5,11355432,19-11337256-A-C,rs34053641,1,A,C,11337256,18176,11158824,11552040,178432
19,ENSG00000167635.6,36215106,19-36224951-A-G,rs34242075,1,A,G,36224951,9845,36018498,36411714,206453
19,ENSG00000167232.8,23395471,19-23404477-C-T,rs34614912,-1,C,T,23404477,9006,23198863,23592079,205614
19,ENSG00000105325.8,3506311,19-3603229-C-T,rs34620121,1,C,T,3603229,96918,3309703,3702919,293526
19,ENSG00000182310.7,51693330,19-51705239-G-C,rs34764077,1,G,C,51705239,11909,51496722,51889938,208517
19,ENSG00000182310.7,51693330,19-51705239-G-A,rs34764077,1,G,A,51705239,11909,51496722,51889938,208517
19,ENSG00000011478.6,45692666,19-45686603-C-T,rs35089411,1,C,T,45686603,6063,45496058,45889274,190545
19,ENSG00000196381.3,37692315,19-37660841-A-G,rs35153242,-1,A,G,37660841,31474,37495707,37888923,165134
19,ENSG00000130208.4,44914608,19-45039860-C-T,rs35242164,1,C,T,45039860,125252,44718000,45111216,321860
19,ENSG00000077463.9,4182563,19-4180839-C-T,rs352493,-1,C,T,4180839,1724,3985955,4379171,194884
19,ENSG00000077463.9,4182563,19-4180839-C-G,rs352493,-1,C,G,4180839,1724,3985955,4379171,194884
19,ENSG00000104921.9,7702131,19-7688020-A-G,rs35387182,-1,A,G,7688020,14111,7505523,7898739,182497
19,ENSG00000105717.5,19618687,19-19668203-G-A,rs35449009,-1,G,A,19668203,49516,19422079,19815295,246124
19,ENSG00000130383.5,5870540,19-5976749-T-C,rs35549731,-1,T,C,5976749,106209,5673932,6067148,302817
19,ENSG00000175691.6,2944971,19-2936537-G-A,rs35699176,-1,G,A,2936537,8434,2748363,3141579,188174
19,ENSG00000099337.2,38319845,19-38303728-T-C,rs35710536,1,T,C,38303728,16117,38123237,38516453,180491
19,ENSG00000179873.8,55831994,19-55956804-C-T,rs35751079,-1,C,T,55956804,124810,55635386,56028602,321418
19,ENSG00000125743.5,45691953,19-45697955-T-G,rs36040835,-1,T,G,45697955,6002,45495345,45888561,202610
19,ENSG00000125743.5,45691953,19-45697955-T-A,rs36040835,-1,T,A,45697955,6002,45495345,45888561,202610
19,ENSG00000125505.10,54189580,19-54193859-T-A,rs36621,-1,T,A,54193859,4279,53992972,54386188,200887
19,ENSG00000125505.10,54189580,19-54193859-T-C,rs36621,-1,T,C,54193859,4279,53992972,54386188,200887
19,ENSG00000104859.9,45039045,19-45091337-T-C,rs3745157,1,T,C,45091337,52292,44842437,45235653,248900
19,ENSG00000167483.11,17527267,19-17341415-C-A,rs3745194,1,C,A,17341415,185852,17330659,17723875,10756
19,ENSG00000167483.11,17527267,19-17341415-C-T,rs3745194,1,C,T,17341415,185852,17330659,17723875,10756
19,ENSG00000086544.1,40717112,19-40742104-C-T,rs3745213,1,C,T,40742104,24992,40520504,40913720,221600
19,ENSG00000142046.9,41376533,19-41384098-C-G,rs3745290,1,C,G,41384098,7565,41179925,41573141,204173
19,ENSG00000142046.9,41376533,19-41384098-C-T,rs3745290,1,C,T,41384098,7565,41179925,41573141,204173
19,ENSG00000104883.2,7489035,19-7488135-C-T,rs3745356,-1,C,T,7488135,900,7292427,7685643,195708
19,ENSG00000090971.3,55485188,19-55485572-G-T,rs3745450,1,G,T,55485572,384,55288580,55681796,196992
19,ENSG00000090971.3,55485188,19-55485572-G-A,rs3745450,1,G,A,55485572,384,55288580,55681796,196992
19,ENSG00000126464.7,49591182,19-49653072-A-G,rs3745470,1,A,G,49653072,61890,49394574,49787790,258498
19,ENSG00000126467.5,49763306,19-49762292-T-C,rs3745477,-1,T,C,49762292,1014,49566698,49959914,195594
19,ENSG00000126467.5,49763306,19-49762292-T-G,rs3745477,-1,T,G,49762292,1014,49566698,49959914,195594
19,ENSG00000126467.5,49763306,19-49762292-T-A,rs3745477,-1,T,A,49762292,1014,49566698,49959914,195594
19,ENSG00000131409.6,50568435,19-50458805-G-A,rs3745518,-1,G,A,50458805,109630,50371827,50765043,86978
19,ENSG00000131409.6,50568435,19-50458805-G-C,rs3745518,-1,G,C,50458805,109630,50371827,50765043,86978
19,ENSG00000197863.3,36838387,19-36819442-T-C,rs3745775,-1,T,C,36819442,18945,36641779,37034995,177663
19,ENSG00000213965.2,32691821,19-32827006-A-G,rs3746028,1,A,G,32827006,135185,32495213,32888429,331793
19,ENSG00000213965.2,32691821,19-32827006-A-C,rs3746028,1,A,C,32827006,135185,32495213,32888429,331793
19,ENSG00000105676.7,19033603,19-19134962-A-C,rs3746259,1,A,C,19134962,101359,18836995,19230211,297967
19,ENSG00000105676.7,19033603,19-19134962-A-G,rs3746259,1,A,G,19134962,101359,18836995,19230211,297967
19,ENSG00000104804.3,48898744,19-48899921-G-T,rs3760785,-1,G,T,48899921,1177,48702136,49095352,197785
19,ENSG00000142227.5,48325552,19-48343219-G-A,rs3760790,1,G,A,48343219,17667,48128944,48522160,214275
19,ENSG00000125755.11,45863147,19-45785448-A-T,rs3760843,-1,A,T,45785448,77699,45666539,46059755,118909
19,ENSG00000125755.11,45863147,19-45785448-A-G,rs3760843,-1,A,G,45785448,77699,45666539,46059755,118909
19,ENSG00000125755.11,45863147,19-45785448-A-C,rs3760843,-1,A,C,45785448,77699,45666539,46059755,118909
19,ENSG00000104915.9,13150375,19-13155172-C-T,rs3760911,-1,C,T,13155172,4797,12953767,13346983,201405
19,ENSG00000083845.3,58387269,19-58385345-C-T,rs3764536,1,C,T,58385345,1924,58190661,58583877,194684
19,ENSG00000161031.7,15479501,19-15460120-G-A,rs3764566,-1,G,A,15460120,19381,15282893,15676109,177227
19,ENSG00000167642.6,38264573,19-38265224-C-T,rs3786870,1,C,T,38265224,651,38067965,38461181,197259
19,ENSG00000167642.6,38264573,19-38265224-C-G,rs3786870,1,C,G,38265224,651,38067965,38461181,197259
19,ENSG00000125650.2,6375933,19-6228206-C-T,rs3787064,-1,C,T,6228206,147727,6179325,6572541,48881
19,ENSG00000130725.2,58558611,19-58559684-C-A,rs3794963,-1,C,A,58559684,1073,58362003,58755219,197681
19,ENSG00000130725.2,58558611,19-58559684-C-T,rs3794963,-1,C,T,58559684,1073,58362003,58755219,197681
19,ENSG00000130725.2,58558611,19-58559684-C-G,rs3794963,-1,C,G,58559684,1073,58362003,58755219,197681
19,ENSG00000099326.3,58573335,19-58557629-C-T,rs3794966,-1,C,T,58557629,15706,58376727,58769943,180902
19,ENSG00000220008.1,2292024,19-2160530-C-T,rs3803915,-1,C,T,2160530,131494,2095416,2488632,65114
19,ENSG00000220008.1,2292024,19-2160530-C-A,rs3803915,-1,C,A,2160530,131494,2095416,2488632,65114
19,ENSG00000182986.7,52897635,19-52897507-C-G,rs3810115,-1,C,G,52897507,128,52701027,53094243,196480
19,ENSG00000182986.7,52897635,19-52897507-C-A,rs3810115,-1,C,A,52897507,128,52701027,53094243,196480
19,ENSG00000105341.11,41439912,19-41398260-C-A,rs3810174,-1,C,A,41398260,41652,41243304,41636520,154956
19,ENSG00000105341.11,41439912,19-41398260-C-T,rs3810174,-1,C,T,41398260,41652,41243304,41636520,154956
19,ENSG00000131944.4,32972242,19-32937260-T-G,rs3816031,1,T,G,32937260,34982,32775634,33168850,161626
19,ENSG00000131944.4,32972242,19-32937260-T-A,rs3816031,1,T,A,32937260,34982,32775634,33168850,161626
19,ENSG00000169136.3,49929205,19-49928131-G-A,rs3826777,1,G,A,49928131,1074,49732597,50125813,195534
19,ENSG00000169136.3,49929205,19-49928131-G-C,rs3826777,1,G,C,49928131,1074,49732597,50125813,195534
19,ENSG00000126246.4,35742452,19-35725155-G-T,rs3848662,-1,G,T,35725155,17297,35545844,35939060,179311
19,ENSG00000104964.9,3062495,19-3056215-G-A,rs3888377,-1,G,A,3056215,6280,2865887,3259103,190328
19,ENSG00000104884.9,45370573,19-45356900-G-A,rs3916856,-1,G,A,45356900,13673,45173965,45567181,182935
19,ENSG00000159871.9,43802447,19-43962150-T-A,rs393403,-1,T,A,43962150,159703,43605839,43999055,356311
19,ENSG00000159871.9,43802447,19-43962150-T-C,rs393403,-1,T,C,43962150,159703,43605839,43999055,356311
19,ENSG00000159871.9,43802447,19-43962150-T-G,rs393403,-1,T,G,43962150,159703,43605839,43999055,356311
19,ENSG00000167637.11,43827321,19-43895154-A-G,rs396973,1,A,G,43895154,67833,43630713,44023929,264441
19,ENSG00000176222.6,43883964,19-43895154-A-G,rs396973,-1,A,G,43895154,11190,43687356,44080572,207798
19,ENSG00000076924.6,7629545,19-7627063-A-G,rs4134831,-1,A,G,7627063,2482,7432937,7826153,194126
19,ENSG00000167384.5,44500522,19-44481456-T-C,rs4141695,-1,T,C,44481456,19066,44303914,44697130,177542
19,ENSG00000234465.4,43575801,19-43647373-C-T,rs4251953,1,C,T,43647373,71572,43379193,43772409,268180
19,ENSG00000130522.3,18281622,19-18284727-C-G,rs4254438,-1,C,G,18284727,3105,18085014,18478230,199713
19,ENSG00000130522.3,18281622,19-18284727-C-T,rs4254438,-1,C,T,18284727,3105,18085014,18478230,199713
19,ENSG00000180089.3,55228763,19-55228147-T-G,rs4255895,-1,T,G,55228147,616,55032155,55425371,195992
19,ENSG00000180089.3,55228763,19-55228147-T-C,rs4255895,-1,T,C,55228147,616,55032155,55425371,195992
19,ENSG00000105464.2,48393668,19-48388280-G-A,rs433956,1,G,A,48388280,5388,48197060,48590276,191220
19,ENSG00000105464.2,48393668,19-48388280-G-C,rs433956,1,G,C,48388280,5388,48197060,48590276,191220
19,ENSG00000096996.9,18086934,19-18086825-G-A,rs436857,-1,G,A,18086825,109,17890326,18283542,196499
19,ENSG00000160505.9,55836540,19-55857823-G-C,rs441827,1,G,C,55857823,21283,55639932,56033148,217891
19,ENSG00000160505.9,55836540,19-55857823-G-A,rs441827,1,G,A,55857823,21283,55639932,56033148,217891
19,ENSG00000197405.2,47309861,19-47312458-G-C,rs4427917,1,G,C,47312458,2597,47113253,47506469,199205
19,ENSG00000090006.12,40601369,19-40614471-G-A,rs4435368,1,G,A,40614471,13102,40404761,40797977,209710
19,ENSG00000090006.12,40601369,19-40614471-G-T,rs4435368,1,G,T,40614471,13102,40404761,40797977,209710
19,ENSG00000132004.7,12696631,19-12691339-C-T,rs45478502,-1,C,T,12691339,5292,12500023,12893239,191316
19,ENSG00000132004.7,12696631,19-12691339-C-A,rs45478502,-1,C,A,12691339,5292,12500023,12893239,191316
19,ENSG00000104774.6,12666742,19-12691339-C-T,rs45478502,-1,C,T,12691339,24597,12470134,12863350,221205
19,ENSG00000104774.6,12666742,19-12691339-C-A,rs45478502,-1,C,A,12691339,24597,12470134,12863350,221205
19,ENSG00000169169.9,49691116,19-49690690-A-G,rs45492293,1,A,G,49690690,426,49494508,49887724,196182
19,ENSG00000248098.2,41397818,19-41397794-T-G,rs45500792,1,T,G,41397794,24,41201210,41594426,196584
19,ENSG00000104885.9,2163933,19-2098064-A-T,rs45506200,1,A,T,2098064,65869,1967325,2360541,130739
19,ENSG00000126458.2,49640143,19-49690180-C-T,rs45613034,-1,C,T,49690180,50037,49443535,49836751,246645
19,ENSG00000126458.2,49640143,19-49690180-C-A,rs45613034,-1,C,A,49690180,50037,49443535,49836751,246645
19,ENSG00000119574.7,58519810,19-58336750-G-C,rs4801262,-1,G,C,58336750,183060,58323202,58716418,13548
19,ENSG00000119574.7,58519810,19-58336750-G-A,rs4801262,-1,G,A,58336750,183060,58323202,58716418,13548
19,ENSG00000083807.4,58511992,19-58488906-A-G,rs4801273,-1,A,G,58488906,23086,58315384,58708600,173522
19,ENSG00000083812.5,58467080,19-58488906-A-G,rs4801273,1,A,G,58488906,21826,58270472,58663688,218434
19,ENSG00000178229.6,57320472,19-57323938-C-T,rs4801468,1,C,T,57323938,3466,57123864,57517080,200074
19,ENSG00000178229.6,57320472,19-57323938-C-G,rs4801468,1,C,G,57323938,3466,57123864,57517080,200074
19,ENSG00000179134.8,39342421,19-39523280-C-G,rs4802035,1,C,G,39523280,180859,39145813,39539029,377467
19,ENSG00000167378.3,43596134,19-43631041-G-T,rs4802188,-1,G,T,43631041,34907,43399526,43792742,231515
19,ENSG00000167378.3,43596134,19-43631041-G-A,rs4802188,-1,G,A,43631041,34907,43399526,43792742,231515
19,ENSG00000167378.3,43596134,19-43631041-G-C,rs4802188,-1,G,C,43631041,34907,43399526,43792742,231515
19,ENSG00000099341.5,38374571,19-38450959-C-T,rs4802467,1,C,T,38450959,76388,38177963,38571179,272996
19,ENSG00000099341.5,38374571,19-38450959-C-G,rs4802467,1,C,G,38450959,76388,38177963,38571179,272996
19,ENSG00000099341.5,38374571,19-38450959-C-A,rs4802467,1,C,A,38450959,76388,38177963,38571179,272996
19,ENSG00000142534.1,49496434,19-49486493-A-G,rs4802612,1,A,G,49486493,9941,49299826,49693042,186667
19,ENSG00000142534.1,49496434,19-49486493-A-C,rs4802612,1,A,C,49486493,9941,49299826,49693042,186667
19,ENSG00000123810.2,41364149,19-41355454-T-C,rs4803457,-1,T,C,41355454,8695,41167541,41560757,187913
19,ENSG00000105321.6,47256525,19-47277768-A-G,rs4804037,1,A,G,47277768,21243,47059917,47453133,217851
19,ENSG00000079805.9,10718079,19-10756772-G-A,rs4804524,1,G,A,10756772,38693,10521471,10914687,235301
19,ENSG00000079805.9,10718079,19-10756772-G-C,rs4804524,1,G,C,10756772,38693,10521471,10914687,235301
19,ENSG00000105618.8,54115754,19-54115811-G-A,rs4806711,1,G,A,54115811,57,53919146,54312362,196665
19,ENSG00000105618.8,54115754,19-54115811-G-C,rs4806711,1,G,C,54115811,57,53919146,54312362,196665
19,ENSG00000095932.4,3480525,19-3390056-G-A,rs4806927,-1,G,A,3390056,90469,3283917,3677133,106139
19,ENSG00000167468.10,1103994,19-1099070-G-A,rs4806970,1,G,A,1099070,4924,907386,1300602,191684
19,ENSG00000167468.10,1103994,19-1099070-G-T,rs4806970,1,G,T,1099070,4924,907386,1300602,191684
19,ENSG00000127666.7,4831712,19-4831866-A-T,rs4807000,-1,A,T,4831866,154,4635104,5028320,196762
19,ENSG00000127666.7,4831712,19-4831866-A-G,rs4807000,-1,A,G,4831866,154,4635104,5028320,196762
19,ENSG00000171124.7,5851449,19-5954151-A-T,rs4807826,-1,A,T,5954151,102702,5654841,6048057,299310
19,ENSG00000171124.7,5851449,19-5954151-A-G,rs4807826,-1,A,G,5954151,102702,5654841,6048057,299310
19,ENSG00000171124.7,5851449,19-5954151-A-C,rs4807826,-1,A,C,5954151,102702,5654841,6048057,299310
19,ENSG00000250067.3,19528911,19-19443994-G-A,rs4808200,1,G,A,19443994,84917,19332303,19725519,111691
19,ENSG00000197013.4,21505602,19-21569207-A-T,rs4808279,1,A,T,21569207,63605,21308994,21702210,260213
19,ENSG00000197013.4,21505602,19-21569207-A-C,rs4808279,1,A,C,21569207,63605,21308994,21702210,260213
19,ENSG00000197013.4,21505602,19-21569207-A-G,rs4808279,1,A,G,21569207,63605,21308994,21702210,260213
19,ENSG00000072958.3,16197911,19-16194197-A-G,rs4808467,1,A,G,16194197,3714,16001303,16394519,192894
19,ENSG00000130511.8,18419398,19-18484026-G-A,rs4808807,1,G,A,18484026,64628,18222790,18616006,261236
19,ENSG00000081665.7,19821750,19-19810158-C-T,rs4808993,-1,C,T,19810158,11592,19625142,20018358,185016
19,ENSG00000081665.7,19821750,19-19810158-C-A,rs4808993,-1,C,A,19810158,11592,19625142,20018358,185016
19,ENSG00000160229.6,20776304,19-20690398-A-C,rs4809099,1,A,C,20690398,85906,20579696,20972912,110702
19,ENSG00000160229.6,20776304,19-20690398-A-T,rs4809099,1,A,T,20690398,85906,20579696,20972912,110702
19,ENSG00000160229.6,20776304,19-20690398-A-G,rs4809099,1,A,G,20690398,85906,20579696,20972912,110702
19,ENSG00000141933.6,507497,19-556632-A-G,rs4919850,1,A,G,556632,49135,310889,704105,245743
19,ENSG00000141933.6,507497,19-556632-A-T,rs4919850,1,A,T,556632,49135,310889,704105,245743
19,ENSG00000090932.5,39498947,19-39397809-C-T,rs519575,1,C,T,39397809,101138,39302339,39695555,95470
19,ENSG00000063241.2,55461642,19-55627209-T-A,rs522669,-1,T,A,55627209,165567,55265034,55658250,362175
19,ENSG00000063241.2,55461642,19-55627209-T-G,rs522669,-1,T,G,55627209,165567,55265034,55658250,362175
19,ENSG00000063241.2,55461642,19-55627209-T-C,rs522669,-1,T,C,55627209,165567,55265034,55658250,362175
19,ENSG00000220201.3,10309880,19-10284792-G-A,rs5497,-1,G,A,10284792,25088,10113272,10506488,171520
19,ENSG00000220201.3,10309880,19-10284792-G-T,rs5497,-1,G,T,10284792,25088,10113272,10506488,171520
19,ENSG00000083828.8,57769676,19-57790042-T-G,rs55658516,1,T,G,57790042,20366,57573068,57966284,216974
19,ENSG00000083828.8,57769676,19-57790042-T-C,rs55658516,1,T,C,57790042,20366,57573068,57966284,216974
19,ENSG00000083828.8,57769676,19-57790042-T-A,rs55658516,1,T,A,57790042,20366,57573068,57966284,216974
19,ENSG00000130332.8,2328586,19-2356267-G-A,rs55769436,-1,G,A,2356267,27681,2131978,2525194,224289
19,ENSG00000166289.4,29665461,19-29539645-G-A,rs56102015,1,G,A,29539645,125816,29468853,29862069,70792
19,ENSG00000130477.9,17688354,19-17618978-T-G,rs56257446,-1,T,G,17618978,69376,17491746,17884962,127232
19,ENSG00000171574.11,58408649,19-58407953-A-G,rs56290606,1,A,G,58407953,696,58212041,58605257,195912
19,ENSG00000171574.11,58408649,19-58407953-A-C,rs56290606,1,A,C,58407953,696,58212041,58605257,195912
19,ENSG00000131400.2,50365639,19-50435226-G-A,rs57092106,-1,G,A,50435226,69587,50169031,50562247,266195
19,ENSG00000198131.7,58228914,19-58137169-C-T,rs57656768,1,C,T,58137169,91745,58032306,58425522,104863
19,ENSG00000198131.7,58228914,19-58137169-C-A,rs57656768,1,C,A,58137169,91745,58032306,58425522,104863
19,ENSG00000198131.7,58228914,19-58137169-C-G,rs57656768,1,C,G,58137169,91745,58032306,58425522,104863
19,ENSG00000256771.1,19865882,19-19860347-T-C,rs58205702,1,T,C,19860347,5535,19669274,20062490,191073
19,ENSG00000090372.7,46746450,19-46714657-A-T,rs588712,-1,A,T,46714657,31793,46549842,46943058,164815
19,ENSG00000090372.7,46746450,19-46714657-A-G,rs588712,-1,A,G,46714657,31793,46549842,46943058,164815
19,ENSG00000090372.7,46746450,19-46714657-A-C,rs588712,-1,A,C,46714657,31793,46549842,46943058,164815
19,ENSG00000131398.8,50329377,19-50344768-G-A,rs59323905,-1,G,A,50344768,15391,50132769,50525985,211999
19,ENSG00000167595.8,35758153,19-35663156-G-A,rs59627042,1,G,A,35663156,94997,35561545,35954761,101611
19,ENSG00000121413.7,58098231,19-58090085-G-A,rs61736354,-1,G,A,58090085,8146,57901623,58294839,188462
19,ENSG00000121413.7,58098231,19-58090085-G-C,rs61736354,-1,G,C,58090085,8146,57901623,58294839,188462
19,ENSG00000167618.4,54502831,19-54633172-C-T,rs61739171,1,C,T,54633172,130341,54306223,54699439,326949
19,ENSG00000167618.4,54502831,19-54633172-C-G,rs61739171,1,C,G,54633172,130341,54306223,54699439,326949
19,ENSG00000167618.4,54502831,19-54633172-C-A,rs61739171,1,C,A,54633172,130341,54306223,54699439,326949
19,ENSG00000132003.4,13795443,19-13796991-C-T,rs62108166,1,C,T,13796991,1548,13598835,13992051,198156
19,ENSG00000132003.4,13795443,19-13796991-C-A,rs62108166,1,C,A,13796991,1548,13598835,13992051,198156
19,ENSG00000032444.9,7535717,19-7576904-T-C,rs62111357,1,T,C,7576904,41187,7339109,7732325,237795
19,ENSG00000032444.9,7535717,19-7576904-T-G,rs62111357,1,T,G,7576904,41187,7339109,7732325,237795
19,ENSG00000176531.5,43504746,19-43529945-G-C,rs62115749,-1,G,C,43529945,25199,43308138,43701354,221807
19,ENSG00000204920.4,43984188,19-43984200-G-A,rs62116613,1,G,A,43984200,12,43787580,44180796,196620
19,ENSG00000182472.3,38744474,19-38719953-G-A,rs62119115,-1,G,A,38719953,24521,38547866,38941082,172087
19,ENSG00000186567.7,44671482,19-44618732-A-C,rs62119261,1,A,C,44618732,52750,44474874,44868090,143858
19,ENSG00000186567.7,44671482,19-44618732-A-T,rs62119261,1,A,T,44618732,52750,44474874,44868090,143858
19,ENSG00000160117.8,17281901,19-17332474-G-A,rs62128106,1,G,A,17332474,50573,17085293,17478509,247181
19,ENSG00000175221.7,893187,19-887226-G-T,rs62132322,-1,G,T,887226,5961,696579,1089795,190647
19,ENSG00000175221.7,893187,19-887226-G-A,rs62132322,-1,G,A,887226,5961,696579,1089795,190647
19,ENSG00000105193.3,39435949,19-39435961-C-A,rs640000,-1,C,A,39435961,12,39239341,39632557,196620
19,ENSG00000105193.3,39435949,19-39435961-C-T,rs640000,-1,C,T,39435961,12,39239341,39632557,196620
19,ENSG00000065989.9,10420538,19-10411921-G-C,rs6417247,1,G,C,10411921,8617,10223930,10617146,187991
19,ENSG00000065989.9,10420538,19-10411921-G-A,rs6417247,1,G,A,10411921,8617,10223930,10617146,187991
19,ENSG00000167608.6,54173160,19-54173068-T-G,rs641738,-1,T,G,54173068,92,53976552,54369768,196516
19,ENSG00000167608.6,54173160,19-54173068-T-C,rs641738,-1,T,C,54173068,92,53976552,54369768,196516
19,ENSG00000167608.6,54173160,19-54173068-T-A,rs641738,-1,T,A,54173068,92,53976552,54369768,196516
19,ENSG00000172687.8,21359000,19-21341600-G-C,rs644795,1,G,C,21341600,17400,21162392,21555608,179208
19,ENSG00000172687.8,21359000,19-21341600-G-A,rs644795,1,G,A,21341600,17400,21162392,21555608,179208
19,ENSG00000104824.8,38849986,19-38865036-G-A,rs6508822,-1,G,A,38865036,15050,38653378,39046594,211658
19,ENSG00000176401.4,39532852,19-39584670-C-A,rs6508870,-1,C,A,39584670,51818,39336244,39729460,248426
19,ENSG00000176401.4,39532852,19-39584670-C-T,rs6508870,-1,C,T,39584670,51818,39336244,39729460,248426
19,ENSG00000125753.8,45507479,19-45478557-G-C,rs6509214,1,G,C,45478557,28922,45310871,45704087,167686
19,ENSG00000125753.8,45507479,19-45478557-G-A,rs6509214,1,G,A,45478557,28922,45310871,45704087,167686
19,ENSG00000125753.8,45507479,19-45478557-G-T,rs6509214,1,G,T,45478557,28922,45310871,45704087,167686
19,ENSG00000105497.2,51571283,19-51572369-G-A,rs6509552,1,G,A,51572369,1086,51374675,51767891,197694
19,ENSG00000173581.2,55648212,19-55703818-G-A,rs6509955,1,G,A,55703818,55606,55451604,55844820,252214
19,ENSG00000173581.2,55648212,19-55703818-G-C,rs6509955,1,G,C,55703818,55606,55451604,55844820,252214
19,ENSG00000105136.13,57487750,19-57524397-T-A,rs6510089,1,T,A,57524397,36647,57291142,57684358,233255
19,ENSG00000105136.13,57487750,19-57524397-T-G,rs6510089,1,T,G,57524397,36647,57291142,57684358,233255
19,ENSG00000174586.4,58362751,19-58352784-T-C,rs6510137,-1,T,C,58352784,9967,58166143,58559359,186641
19,ENSG00000174586.4,58362751,19-58352784-T-A,rs6510137,-1,T,A,58352784,9967,58166143,58559359,186641
19,ENSG00000197124.5,20039505,19-20051886-A-C,rs6511071,-1,A,C,20051886,12381,19842897,20236113,208989
19,ENSG00000196705.3,21142040,19-21204952-C-A,rs6511210,1,C,A,21204952,62912,20945432,21338648,259520
19,ENSG00000196705.3,21142040,19-21204952-C-G,rs6511210,1,C,G,21204952,62912,20945432,21338648,259520
19,ENSG00000037757.8,13764522,19-13758437-G-A,rs6511887,1,G,A,13758437,6085,13567914,13961130,190523
19,ENSG00000037757.8,13764522,19-13758437-G-T,rs6511887,1,G,T,13758437,6085,13567914,13961130,190523
19,ENSG00000142347.9,8577442,19-8403267-C-T,rs6603065,-1,C,T,8403267,174175,8380834,8774050,22433
19,ENSG00000105711.5,35030470,19-35034040-G-T,rs67486287,1,G,T,35034040,3570,34833862,35227078,200178
19,ENSG00000105711.5,35030470,19-35034040-G-C,rs67486287,1,G,C,35034040,3570,34833862,35227078,200178
19,ENSG00000105711.5,35030470,19-35034040-G-A,rs67486287,1,G,A,35034040,3570,34833862,35227078,200178
19,ENSG00000104783.5,43780973,19-43761943-T-C,rs679084,-1,T,C,43761943,19030,43584365,43977581,177578
19,ENSG00000104983.3,45995467,19-46002747-A-G,rs67978203,1,A,G,46002747,7280,45798859,46192075,203888
19,ENSG00000105559.5,48868617,19-48793397-C-T,rs684959,-1,C,T,48793397,75220,48672009,49065225,121388
19,ENSG00000130312.1,17305872,19-17306756-C-T,rs6903,1,C,T,17306756,884,17109264,17502480,197492
19,ENSG00000132002.2,14518397,19-14514978-G-A,rs7003,-1,G,A,14514978,3419,14321789,14715005,193189
19,ENSG00000104969.4,2783273,19-2754794-G-A,rs7009,-1,G,A,2754794,28479,2586665,2979881,168129
19,ENSG00000104969.4,2783273,19-2754794-G-C,rs7009,-1,G,C,2754794,28479,2586665,2979881,168129
19,ENSG00000104969.4,2783273,19-2754794-G-T,rs7009,-1,G,T,2754794,28479,2586665,2979881,168129
19,ENSG00000167562.6,52570287,19-52494305-A-G,rs707314,1,A,G,52494305,75982,52373679,52766895,120626
19,ENSG00000170909.9,54100803,19-53993315-G-A,rs71365417,-1,G,A,53993315,107488,53904195,54297411,89120
19,ENSG00000167815.7,12801800,19-12700231-T-G,rs722572,-1,T,G,12700231,101569,12605192,12998408,95039
19,ENSG00000167815.7,12801800,19-12700231-T-C,rs722572,-1,T,C,12700231,101569,12605192,12998408,95039
19,ENSG00000177051.3,45730896,19-45692498-A-C,rs7245708,-1,A,C,45692498,38398,45534288,45927504,158210
19,ENSG00000105131.2,15232448,19-15101493-T-C,rs7246549,-1,T,C,15101493,130955,15035840,15429056,65653
19,ENSG00000105131.2,15232448,19-15101493-T-A,rs7246549,-1,T,A,15101493,130955,15035840,15429056,65653
19,ENSG00000170906.9,54102855,19-53918182-G-A,rs7246670,1,G,A,53918182,184673,53906247,54299463,11935
19,ENSG00000170906.9,54102855,19-53918182-G-T,rs7246670,1,G,T,53918182,184673,53906247,54299463,11935
19,ENSG00000179218.6,12938609,19-12977872-C-T,rs7246919,1,C,T,12977872,39263,12742001,13135217,235871
19,ENSG00000178531.3,7926135,19-8121379-G-A,rs7247560,-1,G,A,8121379,195244,7729527,8122743,391852
19,ENSG00000104823.3,38831794,19-38827366-C-G,rs7248208,-1,C,G,38827366,4428,38635186,39028402,192180
19,ENSG00000104823.3,38831794,19-38827366-C-T,rs7248208,-1,C,T,38827366,4428,38635186,39028402,192180
19,ENSG00000178982.4,38619188,19-38767337-A-T,rs7248248,1,A,T,38767337,148149,38422580,38815796,344757
19,ENSG00000197608.6,52095765,19-52085891-A-G,rs7249005,-1,A,G,52085891,9874,51899157,52292373,186734
19,ENSG00000105612.3,12881449,19-12881765-G-T,rs7249143,-1,G,T,12881765,316,12684841,13078057,196924
19,ENSG00000160392.8,40348397,19-40347585-C-T,rs7249146,-1,C,T,40347585,812,40151789,40545005,195796
19,ENSG00000160392.8,40348397,19-40347585-C-A,rs7249146,-1,C,A,40347585,812,40151789,40545005,195796
19,ENSG00000180884.7,34964229,19-34950545-T-G,rs7250359,-1,T,G,34950545,13684,34767621,35160837,182924
19,ENSG00000180884.7,34964229,19-34950545-T-C,rs7250359,-1,T,C,34950545,13684,34767621,35160837,182924
19,ENSG00000115268.3,1438396,19-1438866-C-T,rs7251165,1,C,T,1438866,470,1241788,1635004,197078
19,ENSG00000099860.3,2476127,19-2426039-C-A,rs7252121,1,C,A,2426039,50088,2279519,2672735,146520
19,ENSG00000099860.3,2476127,19-2426039-C-T,rs7252121,1,C,T,2426039,50088,2279519,2672735,146520
19,ENSG00000130475.9,17751477,19-17734085-A-G,rs7253117,1,A,G,17734085,17392,17554869,17948085,179216
19,ENSG00000064666.7,1026608,19-1027798-A-C,rs7253254,1,A,C,1027798,1190,830000,1223216,197798
19,ENSG00000126460.5,49581316,19-49603051-T-G,rs7253295,1,T,G,49603051,21735,49384708,49777924,218343
19,ENSG00000126460.5,49581316,19-49603051-T-C,rs7253295,1,T,C,49603051,21735,49384708,49777924,218343
19,ENSG00000167634.6,54947505,19-54987376-G-A,rs7253480,-1,G,A,54987376,39871,54750897,55144113,236479
19,ENSG00000022556.10,54966374,19-54987376-G-A,rs7253480,1,G,A,54987376,21002,54769766,55162982,217610
19,ENSG00000178386.6,44052036,19-44060954-G-T,rs7254182,1,G,T,44060954,8918,43855428,44248644,205526
19,ENSG00000089351.7,35000323,19-35084260-C-G,rs7254457,1,C,G,35084260,83937,34803715,35196931,280545
19,ENSG00000089351.7,35000323,19-35084260-C-T,rs7254457,1,C,T,35084260,83937,34803715,35196931,280545
19,ENSG00000183397.4,3539174,19-3488182-C-T,rs7255097,1,C,T,3488182,50992,3342566,3735782,145616
19,ENSG00000042753.6,46850846,19-46820983-G-A,rs7255228,-1,G,A,46820983,29863,46654238,47047454,166745
19,ENSG00000181894.9,58150789,19-58206902-G-A,rs7256349,-1,G,A,58206902,56113,57954181,58347397,252721
19,ENSG00000198182.6,37719761,19-37577097-T-C,rs7256747,-1,T,C,37577097,142664,37523153,37916369,53944
19,ENSG00000198182.6,37719761,19-37577097-T-G,rs7256747,-1,T,G,37577097,142664,37523153,37916369,53944
19,ENSG00000198182.6,37719761,19-37577097-T-A,rs7256747,-1,T,A,37577097,142664,37523153,37916369,53944
19,ENSG00000167766.11,52638355,19-52615776-T-A,rs7257138,-1,T,A,52615776,22579,52441747,52834963,174029
19,ENSG00000167766.11,52638355,19-52615776-T-C,rs7257138,-1,T,C,52615776,22579,52441747,52834963,174029
19,ENSG00000167766.11,52638355,19-52615776-T-G,rs7257138,-1,T,G,52615776,22579,52441747,52834963,174029
19,ENSG00000142039.2,41310172,19-41321215-C-A,rs7257310,1,C,A,41321215,11043,41113564,41506780,207651
19,ENSG00000142039.2,41310172,19-41321215-C-T,rs7257310,1,C,T,41321215,11043,41113564,41506780,207651
19,ENSG00000251247.3,36850876,19-36905055-A-T,rs7257484,1,A,T,36905055,54179,36654268,37047484,250787
19,ENSG00000251247.3,36850876,19-36905055-A-G,rs7257484,1,A,G,36905055,54179,36654268,37047484,250787
19,ENSG00000228300.7,1275530,19-1275089-T-A,rs7257836,1,T,A,1275089,441,1078922,1472138,196167
19,ENSG00000228300.7,1275530,19-1275089-T-C,rs7257836,1,T,C,1275089,441,1078922,1472138,196167
19,ENSG00000228300.7,1275530,19-1275089-T-G,rs7257836,1,T,G,1275089,441,1078922,1472138,196167
19,ENSG00000104856.8,45001464,19-44929300-G-C,rs7259004,1,G,C,44929300,72164,44804856,45198072,124444
19,ENSG00000104856.8,45001464,19-44929300-G-T,rs7259004,1,G,T,44929300,72164,44804856,45198072,124444
19,ENSG00000189042.7,36687612,19-36687445-A-G,rs7259256,1,A,G,36687445,167,36491004,36884220,196441
19,ENSG00000189042.7,36687612,19-36687445-A-T,rs7259256,1,A,T,36687445,167,36491004,36884220,196441
19,ENSG00000169021.3,29213151,19-29395122-T-C,rs7259598,-1,T,C,29395122,181971,29016543,29409759,378579
19,ENSG00000169021.3,29213151,19-29395122-T-A,rs7259598,-1,T,A,29395122,181971,29016543,29409759,378579
19,ENSG00000169021.3,29213151,19-29395122-T-G,rs7259598,-1,T,G,29395122,181971,29016543,29409759,378579
19,ENSG00000131849.8,58440153,19-58439756-T-C,rs7259841,-1,T,C,58439756,397,58243545,58636761,196211
19,ENSG00000131849.8,58440153,19-58439756-T-G,rs7259841,-1,T,G,58439756,397,58243545,58636761,196211
19,ENSG00000167670.9,4402640,19-4511943-T-A,rs7260518,1,T,A,4511943,109303,4206032,4599248,305911
19,ENSG00000167670.9,4402640,19-4511943-T-C,rs7260518,1,T,C,4511943,109303,4206032,4599248,305911
19,ENSG00000104805.10,48900312,19-48897377-C-T,rs7260579,1,C,T,48897377,2935,48703704,49096920,193673
19,ENSG00000104805.10,48900312,19-48897377-C-A,rs7260579,1,C,A,48897377,2935,48703704,49096920,193673
19,ENSG00000167657.5,3971099,19-3853532-T-C,rs72975109,-1,T,C,3853532,117567,3774491,4167707,79041
19,ENSG00000105248.10,4247080,19-4070544-G-A,rs72977000,1,G,A,4070544,176536,4050472,4443688,20072
19,ENSG00000198429.5,11887782,19-11985493-A-G,rs72988696,1,A,G,11985493,97711,11691174,12084390,294319
19,ENSG00000076826.4,7595863,19-7597004-G-A,rs72992520,1,G,A,7597004,1141,7399255,7792471,197749
19,ENSG00000076826.4,7595863,19-7597004-G-C,rs72992520,1,G,C,7597004,1141,7399255,7792471,197749
19,ENSG00000074181.2,15200995,19-15383118-G-A,rs72994068,-1,G,A,15383118,182123,15004387,15397603,378731
19,ENSG00000104880.11,7348937,19-7423875-T-G,rs72994557,1,T,G,7423875,74938,7152329,7545545,271546
19,ENSG00000104880.11,7348937,19-7423875-T-C,rs72994557,1,T,C,7423875,74938,7152329,7545545,271546
19,ENSG00000129933.11,19320829,19-19496039-C-G,rs73002973,1,C,G,19496039,175210,19124221,19517437,371818
19,ENSG00000129933.11,19320829,19-19496039-C-T,rs73002973,1,C,T,19496039,175210,19124221,19517437,371818
19,ENSG00000160113.3,17245919,19-17237270-G-A,rs73012579,-1,G,A,17237270,8649,17049311,17442527,187959
19,ENSG00000130204.7,44891254,19-44928146-C-G,rs73033507,1,C,G,44928146,36892,44694646,45087862,233500
19,ENSG00000130204.7,44891254,19-44928146-C-T,rs73033507,1,C,T,44928146,36892,44694646,45087862,233500
19,ENSG00000197380.5,46661182,19-46539194-A-G,rs73054610,-1,A,G,46539194,121988,46464574,46857790,74620
19,ENSG00000251369.2,57559863,19-57567169-A-C,rs73060424,-1,A,C,57567169,7306,57363255,57756471,203914
19,ENSG00000251369.2,57559863,19-57567169-A-T,rs73060424,-1,A,T,57567169,7306,57363255,57756471,203914
19,ENSG00000251369.2,57559863,19-57567169-A-G,rs73060424,-1,A,G,57567169,7306,57363255,57756471,203914
19,ENSG00000152439.6,57499938,19-57567169-A-C,rs73060424,1,A,C,57567169,67231,57303330,57696546,263839
19,ENSG00000152439.6,57499938,19-57567169-A-T,rs73060424,1,A,T,57567169,67231,57303330,57696546,263839
19,ENSG00000152439.6,57499938,19-57567169-A-G,rs73060424,1,A,G,57567169,67231,57303330,57696546,263839
19,ENSG00000178201.3,57457140,19-57471713-C-A,rs73065298,-1,C,A,57471713,14573,57260532,57653748,211181
19,ENSG00000105063.12,55259017,19-55227680-G-A,rs73068639,-1,G,A,55227680,31337,55062409,55455625,165271
19,ENSG00000104899.2,2249323,19-2241328-G-T,rs733846,1,G,T,2241328,7995,2052715,2445931,188613
19,ENSG00000104899.2,2249323,19-2241328-G-C,rs733846,1,G,C,2241328,7995,2052715,2445931,188613
19,ENSG00000197134.5,22052484,19-22187022-C-A,rs7343144,1,C,A,22187022,134538,21855876,22249092,331146
19,ENSG00000197134.5,22052484,19-22187022-C-T,rs7343144,1,C,T,22187022,134538,21855876,22249092,331146
19,ENSG00000188000.2,9178979,19-9153725-G-A,rs73494602,1,G,A,9153725,25254,8982371,9375587,171354
19,ENSG00000130803.9,9140397,19-9153725-G-A,rs73494602,1,G,A,9153725,13328,8943789,9337005,209936
19,ENSG00000178078.5,4338827,19-4323997-C-T,rs73534876,-1,C,T,4323997,14830,4142219,4535435,181778
19,ENSG00000074842.2,4670342,19-4705544-C-T,rs73543629,-1,C,T,4705544,35202,4473734,4866950,231810
19,ENSG00000187650.2,5904872,19-5885516-T-C,rs73548308,1,T,C,5885516,19356,5708264,6101480,177252
19,ENSG00000105404.5,41959321,19-41959295-C-T,rs735571,-1,C,T,41959295,26,41762713,42155929,196582
19,ENSG00000076944.7,7637110,19-7636862-T-A,rs7359905,1,T,A,7636862,248,7440502,7833718,196360
19,ENSG00000076944.7,7637110,19-7636862-T-C,rs7359905,1,T,C,7636862,248,7440502,7833718,196360
19,ENSG00000173809.11,32719753,19-32654739-C-T,rs736452,1,C,T,32654739,65014,32523145,32916361,131594
19,ENSG00000086967.8,50432892,19-50467752-C-A,rs736769,1,C,A,50467752,34860,50236284,50629500,231468
19,ENSG00000130300.3,17377342,19-17373316-C-G,rs73930549,-1,C,G,17373316,4026,17180734,17573950,192582
19,ENSG00000130300.3,17377342,19-17373316-C-T,rs73930549,-1,C,T,17373316,4026,17180734,17573950,192582
19,ENSG00000104825.12,38899969,19-38801051-A-G,rs73933058,1,A,G,38801051,98918,38703361,39096577,97690
19,ENSG00000133246.4,8502640,19-8477121-A-G,rs7408960,-1,A,G,8477121,25519,8306032,8699248,171089
19,ENSG00000178297.7,2389761,19-2430234-T-C,rs743578,1,T,C,2430234,40473,2193153,2586369,237081
19,ENSG00000105053.5,50025372,19-49994266-C-T,rs745952,-1,C,T,49994266,31106,49828764,50221980,165502
19,ENSG00000105053.5,50025372,19-49994266-C-G,rs745952,-1,C,G,49994266,31106,49828764,50221980,165502
19,ENSG00000125648.8,6459792,19-6472919-C-A,rs74800876,-1,C,A,6472919,13127,6263184,6656400,209735
19,ENSG00000099864.10,708935,19-729850-G-A,rs74812357,1,G,A,729850,20915,512327,905543,217523
19,ENSG00000099864.10,708935,19-729850-G-T,rs74812357,1,G,T,729850,20915,512327,905543,217523
19,ENSG00000181027.5,46746057,19-46771075-G-A,rs75206071,1,G,A,46771075,25018,46549449,46942665,221626
19,ENSG00000183647.5,57599885,19-57684839-G-A,rs752150,1,G,A,57684839,84954,57403277,57796493,281562
19,ENSG00000188051.5,17448668,19-17430208-A-G,rs754847,-1,A,G,17430208,18460,17252060,17645276,178148
19,ENSG00000188051.5,17448668,19-17430208-A-T,rs754847,-1,A,T,17430208,18460,17252060,17645276,178148
19,ENSG00000197256.5,11197545,19-11193728-C-T,rs755237,-1,C,T,11193728,3817,11000937,11394153,192791
19,ENSG00000123815.6,40716886,19-40724964-G-A,rs755635,-1,G,A,40724964,8078,40520278,40913494,204686
19,ENSG00000123815.6,40716886,19-40724964-G-C,rs755635,-1,G,C,40724964,8078,40520278,40913494,204686
19,ENSG00000186111.3,3700468,19-3688526-C-T,rs75760304,-1,C,T,3688526,11942,3503860,3897076,184666
19,ENSG00000254901.1,19192152,19-19198895-G-A,rs75833713,-1,G,A,19198895,6743,18995544,19388760,203351
19,ENSG00000254901.1,19192152,19-19198895-G-C,rs75833713,-1,G,C,19198895,6743,18995544,19388760,203351
19,ENSG00000176472.5,43533188,19-43553946-T-C,rs762507,1,T,C,43553946,20758,43336580,43729796,217366
19,ENSG00000176472.5,43533188,19-43553946-T-A,rs762507,1,T,A,43553946,20758,43336580,43729796,217366
19,ENSG00000176472.5,43533188,19-43553946-T-G,rs762507,1,T,G,43553946,20758,43336580,43729796,217366
19,ENSG00000126259.10,35856911,19-35700416-C-T,rs77680881,1,C,T,35700416,156495,35660303,36053519,40113
19,ENSG00000213015.3,55641002,19-55683874-T-C,rs77802081,1,T,C,55683874,42872,55444394,55837610,239480
19,ENSG00000181588.12,1568325,19-1673757-C-T,rs78522833,-1,C,T,1673757,105432,1371717,1764933,302040
19,ENSG00000181588.12,1568325,19-1673757-C-A,rs78522833,-1,C,A,1673757,105432,1371717,1764933,302040
19,ENSG00000126249.1,34404399,19-34385518-G-T,rs78770765,1,G,T,34385518,18881,34207791,34601007,177727
19,ENSG00000170954.6,53132910,19-52944989-A-G,rs78842293,-1,A,G,52944989,187921,52936302,53329518,8687
19,ENSG00000170954.6,53132910,19-52944989-A-C,rs78842293,-1,A,C,52944989,187921,52936302,53329518,8687
19,ENSG00000167671.6,4457794,19-4444745-A-G,rs78869060,-1,A,G,4444745,13049,4261186,4654402,183559
19,ENSG00000167671.6,4457794,19-4444745-A-C,rs78869060,-1,A,C,4444745,13049,4261186,4654402,183559
19,ENSG00000233927.2,8321496,19-8355699-G-A,rs79293855,1,G,A,8355699,34203,8124888,8518104,230811
19,ENSG00000130518.7,18274452,19-18299559-G-A,rs79534846,-1,G,A,18299559,25107,18077844,18471060,221715
19,ENSG00000105519.5,5914254,19-5900460-C-T,rs79569934,1,C,T,5900460,13794,5717646,6110862,182814
19,ENSG00000171649.5,57584145,19-57666390-C-G,rs79655520,1,C,G,57666390,82245,57387537,57780753,278853
19,ENSG00000171649.5,57584145,19-57666390-C-T,rs79655520,1,C,T,57666390,82245,57387537,57780753,278853
19,ENSG00000239382.4,36014213,19-35848908-T-C,rs80321803,-1,T,C,35848908,165305,35817605,36210821,31303
19,ENSG00000239382.4,36014213,19-35848908-T-G,rs80321803,-1,T,G,35848908,165305,35817605,36210821,31303
19,ENSG00000072954.1,16661139,19-16650266-C-G,rs8101030,1,C,G,16650266,10873,16464531,16857747,185735
19,ENSG00000072954.1,16661139,19-16650266-C-A,rs8101030,1,C,A,16650266,10873,16464531,16857747,185735
19,ENSG00000130377.8,6135667,19-6167403-A-T,rs8101237,1,A,T,6167403,31736,5939059,6332275,228344
19,ENSG00000130377.8,6135667,19-6167403-A-G,rs8101237,1,A,G,6167403,31736,5939059,6332275,228344
19,ENSG00000141994.9,5791163,19-5792463-A-T,rs8101416,-1,A,T,5792463,1300,5594555,5987771,197908
19,ENSG00000166704.7,58002820,19-57899184-G-A,rs8103254,-1,G,A,57899184,103636,57806212,58199428,92972
19,ENSG00000064607.11,19033517,19-19040883-T-A,rs8104799,-1,T,A,19040883,7366,18836909,19230125,203974
19,ENSG00000064607.11,19033517,19-19040883-T-G,rs8104799,-1,T,G,19040883,7366,18836909,19230125,203974
19,ENSG00000064607.11,19033517,19-19040883-T-C,rs8104799,-1,T,C,19040883,7366,18836909,19230125,203974
19,ENSG00000176909.6,48719725,19-48746631-G-A,rs8105137,-1,G,A,48746631,26906,48523117,48916333,223514
19,ENSG00000176909.6,48719725,19-48746631-G-C,rs8105137,-1,G,C,48746631,26906,48523117,48916333,223514
19,ENSG00000176909.6,48719725,19-48746631-G-T,rs8105137,-1,G,T,48746631,26906,48523117,48916333,223514
19,ENSG00000007264.8,3786381,19-3781586-C-T,rs8105735,-1,C,T,3781586,4795,3589773,3982989,191813
19,ENSG00000007264.8,3786381,19-3781586-C-G,rs8105735,-1,C,G,3781586,4795,3589773,3982989,191813
19,ENSG00000104972.10,54630484,19-54611998-T-A,rs8105809,1,T,A,54611998,18486,54433876,54827092,178122
19,ENSG00000104972.10,54630484,19-54611998-T-C,rs8105809,1,T,C,54611998,18486,54433876,54827092,178122
19,ENSG00000104972.10,54630484,19-54611998-T-G,rs8105809,1,T,G,54611998,18486,54433876,54827092,178122
19,ENSG00000104853.9,44955380,19-44898409-A-G,rs8106922,1,A,G,44898409,56971,44758772,45151988,139637
19,ENSG00000064545.8,19138478,19-18983417-A-G,rs8107145,-1,A,G,18983417,155061,18941870,19335086,41547
19,ENSG00000064545.8,19138478,19-18983417-A-T,rs8107145,-1,A,T,18983417,155061,18941870,19335086,41547
19,ENSG00000064545.8,19138478,19-18983417-A-C,rs8107145,-1,A,C,18983417,155061,18941870,19335086,41547
19,ENSG00000132016.6,13906117,19-13864563-A-C,rs8107465,-1,A,C,13864563,41554,13709509,14102725,155054
19,ENSG00000132016.6,13906117,19-13864563-A-G,rs8107465,-1,A,G,13864563,41554,13709509,14102725,155054
19,ENSG00000196268.6,21397133,19-21403434-T-C,rs8107999,1,T,C,21403434,6301,21200525,21593741,202909
19,ENSG00000188171.8,20661571,19-20679944-C-T,rs8108244,-1,C,T,20679944,18373,20464963,20858179,214981
19,ENSG00000105499.8,48110817,19-48141972-G-T,rs8108486,-1,G,T,48141972,31155,47914209,48307425,227763
19,ENSG00000105499.8,48110817,19-48141972-G-A,rs8108486,-1,G,A,48141972,31155,47914209,48307425,227763
19,ENSG00000104894.6,49335406,19-49342638-C-G,rs8108669,1,C,G,49342638,7232,49138798,49532014,203840
19,ENSG00000104894.6,49335406,19-49342638-C-T,rs8108669,1,C,T,49342638,7232,49138798,49532014,203840
19,ENSG00000167460.9,16076495,19-16074749-G-A,rs8109288,1,G,A,16074749,1746,15879887,16273103,194862
19,ENSG00000186026.5,44072159,19-44034684-A-T,rs8109313,1,A,T,44034684,37475,43875551,44268767,159133
19,ENSG00000186026.5,44072159,19-44034684-A-G,rs8109313,1,A,G,44034684,37475,43875551,44268767,159133
19,ENSG00000105374.4,51372654,19-51372692-C-G,rs8109405,-1,C,G,51372692,38,51176046,51569262,196646
19,ENSG00000105374.4,51372654,19-51372692-C-T,rs8109405,-1,C,T,51372692,38,51176046,51569262,196646
19,ENSG00000181035.8,19063994,19-19063428-C-G,rs8110629,1,C,G,19063428,566,18867386,19260602,196042
19,ENSG00000181035.8,19063994,19-19063428-C-A,rs8110629,1,C,A,19063428,566,18867386,19260602,196042
19,ENSG00000181035.8,19063994,19-19063428-C-T,rs8110629,1,C,T,19063428,566,18867386,19260602,196042
19,ENSG00000131941.2,33064888,19-33224440-C-T,rs8110876,-1,C,T,33224440,159552,32868280,33261496,356160
19,ENSG00000105492.10,51531670,19-51470447-A-G,rs8110997,-1,A,G,51470447,61223,51335062,51728278,135385
19,ENSG00000262874.1,51390591,19-51391484-G-A,rs8111906,-1,G,A,51391484,893,51193983,51587199,197501
19,ENSG00000105401.1,10403542,19-10409388-G-A,rs8112449,-1,G,A,10409388,5846,10206934,10600150,202454
19,ENSG00000089335.14,34677678,19-34644604-T-G,rs8112651,1,T,G,34644604,33074,34481070,34874286,163534
19,ENSG00000167600.7,41193219,19-41193981-G-C,rs8192793,1,G,C,41193981,762,40996611,41389827,197370
19,ENSG00000249471.2,58451622,19-58480533-G-A,rs882610,1,G,A,58480533,28911,58255014,58648230,225519
19,ENSG00000179954.7,55488436,19-55493534-G-A,rs889090,1,G,A,55493534,5098,55291828,55685044,201706
19,ENSG00000179954.7,55488436,19-55493534-G-T,rs889090,1,G,T,55493534,5098,55291828,55685044,201706
19,ENSG00000188505.3,39196964,19-39194269-A-C,rs892015,1,A,C,39194269,2695,39000356,39393572,193913
19,ENSG00000188505.3,39196964,19-39194269-A-T,rs892015,1,A,T,39194269,2695,39000356,39393572,193913
19,ENSG00000188505.3,39196964,19-39194269-A-G,rs892015,1,A,G,39194269,2695,39000356,39393572,193913
19,ENSG00000063127.10,49325191,19-49364656-G-T,rs919364,-1,G,T,49364656,39465,49128583,49521799,236073
19,ENSG00000063127.10,49325191,19-49364656-G-A,rs919364,-1,G,A,49364656,39465,49128583,49521799,236073
19,ENSG00000099821.6,633537,19-630844-C-G,rs9304924,-1,C,G,630844,2693,436929,830145,193915
19,ENSG00000099821.6,633537,19-630844-C-A,rs9304924,-1,C,A,630844,2693,436929,830145,193915
19,ENSG00000196081.4,23250394,19-23384249-T-A,rs9305004,-1,T,A,23384249,133855,23053786,23447002,330463
19,ENSG00000196081.4,23250394,19-23384249-T-G,rs9305004,-1,T,G,23384249,133855,23053786,23447002,330463
19,ENSG00000121406.3,57527356,19-57677919-C-G,rs9676604,1,C,G,57677919,150563,57330748,57723964,347171
19,ENSG00000121406.3,57527356,19-57677919-C-T,rs9676604,1,C,T,57677919,150563,57330748,57723964,347171
19,ENSG00000105202.2,39846379,19-39856395-G-A,rs1001974,-1,G,A,39856395,10016,39649771,40042987,206624
19,ENSG00000011332.13,38224222,19-38272365-G-A,rs10048529,-1,G,A,38272365,48143,38027614,38420830,244751
19,ENSG00000099864.10,708935,19-730297-G-T,rs1009690,1,G,T,730297,21362,512327,905543,217970
19,ENSG00000099864.10,708935,19-730297-G-C,rs1009690,1,G,C,730297,21362,512327,905543,217970
19,ENSG00000099864.10,708935,19-730297-G-A,rs1009690,1,G,A,730297,21362,512327,905543,217970
19,ENSG00000012061.9,45423917,19-45451943-G-T,rs1018765,-1,G,T,45451943,28026,45227309,45620525,224634
19,ENSG00000175489.6,18397622,19-18527595-C-A,rs10401741,-1,C,A,18527595,129973,18201014,18594230,326581
19,ENSG00000105699.9,35249002,19-35289948-A-G,rs10402233,1,A,G,35289948,40946,35052394,35445610,237554
19,ENSG00000189190.6,52786807,19-52793157-G-C,rs10402737,-1,G,C,52793157,6350,52590199,52983415,202958
19,ENSG00000189190.6,52786807,19-52793157-G-A,rs10402737,-1,G,A,52793157,6350,52590199,52983415,202958
19,ENSG00000189190.6,52786807,19-52793157-G-T,rs10402737,-1,G,T,52793157,6350,52590199,52983415,202958
19,ENSG00000105664.4,18791305,19-18629398-T-A,rs10402779,-1,T,A,18629398,161907,18594697,18987913,34701
19,ENSG00000105664.4,18791305,19-18629398-T-G,rs10402779,-1,T,G,18629398,161907,18594697,18987913,34701
19,ENSG00000105664.4,18791305,19-18629398-T-C,rs10402779,-1,T,C,18629398,161907,18594697,18987913,34701
19,ENSG00000184635.7,19900946,19-19886791-T-G,rs10403255,1,T,G,19886791,14155,19704338,20097554,182453
19,ENSG00000184635.7,19900946,19-19886791-T-A,rs10403255,1,T,A,19886791,14155,19704338,20097554,182453
19,ENSG00000011478.6,45692666,19-45688570-C-T,rs10403723,1,C,T,45688570,4096,45496058,45889274,192512
19,ENSG00000011478.6,45692666,19-45688570-C-A,rs10403723,1,C,A,45688570,4096,45496058,45889274,192512
19,ENSG00000197050.5,37078433,19-36885854-G-A,rs10403906,1,G,A,36885854,192579,36881825,37275041,4029
19,ENSG00000090932.5,39498947,19-39422994-G-C,rs10407035,1,G,C,39422994,75953,39302339,39695555,120655
19,ENSG00000090932.5,39498947,19-39422994-G-T,rs10407035,1,G,T,39422994,75953,39302339,39695555,120655
19,ENSG00000090932.5,39498947,19-39422994-G-A,rs10407035,1,G,A,39422994,75953,39302339,39695555,120655
19,ENSG00000105136.13,57487750,19-57568438-A-G,rs10407412,1,A,G,57568438,80688,57291142,57684358,277296
19,ENSG00000142230.6,47130835,19-47227858-C-A,rs10407441,1,C,A,47227858,97023,46934227,47327443,293631
19,ENSG00000104835.8,38930763,19-38968534-A-T,rs10409200,-1,A,T,38968534,37771,38734155,39127371,234379
19,ENSG00000104835.8,38930763,19-38968534-A-C,rs10409200,-1,A,C,38968534,37771,38734155,39127371,234379
19,ENSG00000104835.8,38930763,19-38968534-A-G,rs10409200,-1,A,G,38968534,37771,38734155,39127371,234379
19,ENSG00000079385.14,42528481,19-42352925-C-T,rs10411498,-1,C,T,42352925,175556,42331873,42725089,21052
19,ENSG00000161888.5,11155782,19-11062453-G-A,rs10411606,-1,G,A,11062453,93329,10959174,11352390,103279
19,ENSG00000105011.3,14136589,19-14256326-T-G,rs10411875,-1,T,G,14256326,119737,13939981,14333197,316345
19,ENSG00000105011.3,14136589,19-14256326-T-C,rs10411875,-1,T,C,14256326,119737,13939981,14333197,316345
19,ENSG00000188000.2,9178979,19-9203459-T-G,rs10415904,1,T,G,9203459,24480,8982371,9375587,221088
19,ENSG00000089335.14,34677678,19-34792543-G-A,rs10416755,1,G,A,34792543,114865,34481070,34874286,311473
19,ENSG00000197961.4,9584504,19-9490715-C-T,rs10419036,-1,C,T,9490715,93789,9387896,9781112,102819
19,ENSG00000125912.5,3185930,19-3171567-A-G,rs10421389,1,A,G,3171567,14363,2989322,3382538,182245
19,ENSG00000171574.11,58408649,19-58416935-T-A,rs10423138,1,T,A,58416935,8286,58212041,58605257,204894
19,ENSG00000171574.11,58408649,19-58416935-T-C,rs10423138,1,T,C,58416935,8286,58212041,58605257,204894
19,ENSG00000167595.8,35758153,19-35577979-A-G,rs10424120,1,A,G,35577979,180174,35561545,35954761,16434
19,ENSG00000167595.8,35758153,19-35577979-A-T,rs10424120,1,A,T,35577979,180174,35561545,35954761,16434
19,ENSG00000105655.10,18438133,19-18245763-C-T,rs10424581,-1,C,T,18245763,192370,18241525,18634741,4238
19,ENSG00000064687.7,1040107,19-1038926-G-A,rs10426279,1,G,A,1038926,1181,843499,1236715,195427
19,ENSG00000074842.2,4670342,19-4651257-G-A,rs10426502,-1,G,A,4651257,19085,4473734,4866950,177523
19,ENSG00000117877.5,45406644,19-45263956-G-A,rs10445572,1,G,A,45263956,142688,45210036,45603252,53920
19,ENSG00000105650.12,18226475,19-18178088-T-C,rs1045747,-1,T,C,18178088,48387,18029867,18423083,148221
19,ENSG00000178297.7,2389761,19-2428255-A-G,rs1050009,1,A,G,2428255,38494,2193153,2586369,235102
19,ENSG00000167617.2,54473296,19-54468529-T-C,rs10853871,-1,T,C,54468529,4767,54276688,54669904,191841
19,ENSG00000104903.3,13102858,19-13173789-T-C,rs10854122,-1,T,C,13173789,70931,12906250,13299466,267539
19,ENSG00000153885.7,33796870,19-33836850-C-G,rs1102161,1,C,G,33836850,39980,33600262,33993478,236588
19,ENSG00000159882.7,44002957,19-44165166-A-G,rs1107064,1,A,G,44165166,162209,43806349,44199565,358817
19,ENSG00000105287.7,46717114,19-46704397-G-A,rs11083846,-1,G,A,46704397,12717,46520506,46913722,183891
19,ENSG00000126460.5,49581316,19-49592887-T-C,rs11083979,1,T,C,49592887,11571,49384708,49777924,208179
19,ENSG00000170889.9,54200858,19-54202904-A-G,rs11084316,1,A,G,54202904,2046,54004250,54397466,198654
19,ENSG00000170889.9,54200858,19-54202904-A-C,rs11084316,1,A,C,54202904,2046,54004250,54397466,198654
19,ENSG00000170889.9,54200858,19-54202904-A-T,rs11084316,1,A,T,54202904,2046,54004250,54397466,198654
19,ENSG00000125503.6,55117637,19-55128942-G-T,rs11084391,-1,G,T,55128942,11305,54921029,55314245,207913
19,ENSG00000125503.6,55117637,19-55128942-G-C,rs11084391,-1,G,C,55128942,11305,54921029,55314245,207913
19,ENSG00000065717.8,3029280,19-2909095-G-C,rs11084972,-1,G,C,2909095,120185,2832672,3225888,76423
19,ENSG00000008382.10,4343562,19-4368145-C-T,rs11085072,1,C,T,4368145,24583,4146954,4540170,221191
19,ENSG00000105750.8,20923251,19-20924683-T-C,rs11085403,1,T,C,20924683,1432,20726643,21119859,198040
19,ENSG00000105639.13,17847982,19-17913462-T-C,rs11086082,-1,T,C,17913462,65480,17651374,18044590,262088
19,ENSG00000104853.9,44955380,19-45133061-C-A,rs1114831,1,C,A,45133061,177681,44758772,45151988,374289
19,ENSG00000104853.9,44955380,19-45133061-C-T,rs1114831,1,C,T,45133061,177681,44758772,45151988,374289
19,ENSG00000105427.4,42390297,19-42226065-C-T,rs111722832,-1,C,T,42226065,164232,42193689,42586905,32376
19,ENSG00000129355.5,10568979,19-10431645-C-G,rs111740485,-1,C,G,10431645,137334,10372371,10765587,59274
19,ENSG00000130812.5,10102678,19-10029499-G-A,rs112645523,-1,G,A,10029499,73179,9906070,10299286,123429
19,ENSG00000248098.2,41397818,19-41379846-G-C,rs112708650,1,G,C,41379846,17972,41201210,41594426,178636
19,ENSG00000174586.4,58362751,19-58396333-G-A,rs112710702,-1,G,A,58396333,33582,58166143,58559359,230190
19,ENSG00000105205.5,39738029,19-39678029-G-A,rs113169072,-1,G,A,39678029,60000,39541421,39934637,136608
19,ENSG00000104808.3,48933699,19-48977799-C-G,rs113600772,1,C,G,48977799,44100,48737091,49130307,240708
19,ENSG00000174788.4,7633719,19-7748256-G-A,rs11465362,-1,G,A,7748256,114537,7437111,7830327,311145
19,ENSG00000174788.4,7633719,19-7748256-G-T,rs11465362,-1,G,T,7748256,114537,7437111,7830327,311145
19,ENSG00000161265.6,35745418,19-35577259-G-A,rs114852218,-1,G,A,35577259,168159,35548810,35942026,28449
19,ENSG00000198521.5,21836182,19-21772578-G-T,rs115053831,-1,G,T,21772578,63604,21639574,22032790,133004
19,ENSG00000198521.5,21836182,19-21772578-G-A,rs115053831,-1,G,A,21772578,63604,21639574,22032790,133004
19,ENSG00000212123.3,5784746,19-5782920-C-A,rs115109202,-1,C,A,5782920,1826,5588138,5981354,194782
19,ENSG00000169136.3,49929205,19-49917414-C-A,rs1152239,1,C,A,49917414,11791,49732597,50125813,184817
19,ENSG00000169136.3,49929205,19-49917414-C-G,rs1152239,1,C,G,49917414,11791,49732597,50125813,184817
19,ENSG00000169136.3,49929205,19-49917414-C-T,rs1152239,1,C,T,49917414,11791,49732597,50125813,184817
19,ENSG00000105186.7,32675180,19-32672252-G-A,rs115273093,-1,G,A,32672252,2928,32478572,32871788,193680
19,ENSG00000065268.3,984345,19-991129-G-A,rs11538683,1,G,A,991129,6784,787737,1180953,203392
19,ENSG00000065268.3,984345,19-991129-G-C,rs11538683,1,G,C,991129,6784,787737,1180953,203392
19,ENSG00000141933.6,507497,19-455661-A-G,rs11667579,1,A,G,455661,51836,310889,704105,144772
19,ENSG00000197951.3,56595302,19-56567833-C-T,rs11667718,1,C,T,56567833,27469,56398694,56791910,169139
19,ENSG00000160352.9,21082203,19-21130037-T-C,rs11667905,1,T,C,21130037,47834,20885595,21278811,244442
19,ENSG00000174951.4,48752641,19-48788938-A-G,rs11668745,-1,A,G,48788938,36297,48556033,48949249,232905
19,ENSG00000127511.4,16829398,19-17000864-T-C,rs11669497,1,T,C,17000864,171466,16632790,17026006,368074
19,ENSG00000213799.4,53333749,19-53194115-T-G,rs11669754,1,T,G,53194115,139634,53137141,53530357,56974
19,ENSG00000160014.11,46601330,19-46577993-G-A,rs11670297,1,G,A,46577993,23337,46404722,46797938,173271
19,ENSG00000174652.12,9435573,19-9453501-G-T,rs11670509,-1,G,T,9453501,17928,9238965,9632181,214536
19,ENSG00000174652.12,9435573,19-9453501-G-C,rs11670509,-1,G,C,9453501,17928,9238965,9632181,214536
19,ENSG00000174652.12,9435573,19-9453501-G-A,rs11670509,-1,G,A,9453501,17928,9238965,9632181,214536
19,ENSG00000197857.7,12294883,19-12204157-C-A,rs11670770,-1,C,A,12204157,90726,12098275,12491491,105882
19,ENSG00000171606.12,58183061,19-58237485-T-C,rs11671874,1,T,C,58237485,54424,57986453,58379669,251032
19,ENSG00000105255.5,4304598,19-4304501-A-C,rs11671916,1,A,C,4304501,97,4107990,4501206,196511
19,ENSG00000105255.5,4304598,19-4304501-A-G,rs11671916,1,A,G,4304501,97,4107990,4501206,196511
19,ENSG00000105255.5,4304598,19-4304501-A-T,rs11671916,1,A,T,4304501,97,4107990,4501206,196511
19,ENSG00000179954.7,55488436,19-55498098-G-T,rs11672130,1,G,T,55498098,9662,55291828,55685044,206270
19,ENSG00000179954.7,55488436,19-55498098-G-A,rs11672130,1,G,A,55498098,9662,55291828,55685044,206270
19,ENSG00000105290.4,35868574,19-36043371-T-C,rs116855108,1,T,C,36043371,174797,35671966,36065182,371405
19,ENSG00000239998.1,54573790,19-54441210-T-A,rs116940585,1,T,A,54441210,132580,54377182,54770398,64028
19,ENSG00000239998.1,54573790,19-54441210-T-C,rs116940585,1,T,C,54441210,132580,54377182,54770398,64028
19,ENSG00000130311.5,17309563,19-17289560-G-A,rs116951567,1,G,A,17289560,20003,17112955,17506171,176605
19,ENSG00000130311.5,17309563,19-17289560-G-T,rs116951567,1,G,T,17289560,20003,17112955,17506171,176605
19,ENSG00000105672.8,35641745,19-35644881-G-A,rs117704954,1,G,A,35644881,3136,35445137,35838353,199744
19,ENSG00000099795.1,14572066,19-14483117-G-A,rs117714987,-1,G,A,14483117,88949,14375458,14768674,107659
19,ENSG00000180257.8,52962881,19-53024808-C-T,rs117828954,-1,C,T,53024808,61927,52766273,53159489,258535
19,ENSG00000188283.6,37218214,19-37058854-C-A,rs117875908,1,C,A,37058854,159360,37021606,37414822,37248
19,ENSG00000188283.6,37218214,19-37058854-C-T,rs117875908,1,C,T,37058854,159360,37021606,37414822,37248
19,ENSG00000024422.5,47713422,19-47715155-G-A,rs118085184,1,G,A,47715155,1733,47516814,47910030,198341
19,ENSG00000218891.1,55580848,19-55582190-A-T,rs11879347,-1,A,T,55582190,1342,55384240,55777456,197950
19,ENSG00000172009.9,2785503,19-2650036-T-A,rs11880582,1,T,A,2650036,135467,2588895,2982111,61141
19,ENSG00000172009.9,2785503,19-2650036-T-C,rs11880582,1,T,C,2650036,135467,2588895,2982111,61141
19,ENSG00000127507.11,14778560,19-14777242-T-C,rs11881701,-1,T,C,14777242,1318,14581952,14975168,195290
19,ENSG00000126267.3,35648323,19-35768390-C-T,rs11881839,1,C,T,35768390,120067,35451715,35844931,316675
19,ENSG00000131400.2,50365639,19-50331031-A-G,rs11882877,-1,A,G,50331031,34608,50169031,50562247,162000
19,ENSG00000076944.7,7637110,19-7657750-G-A,rs11883223,1,G,A,7657750,20640,7440502,7833718,217248
19,ENSG00000248099.2,17821519,19-17824817-T-G,rs11888,-1,T,G,17824817,3298,17624911,18018127,199906
19,ENSG00000248099.2,17821519,19-17824817-T-C,rs11888,-1,T,C,17824817,3298,17624911,18018127,199906
19,ENSG00000248099.2,17821519,19-17824817-T-A,rs11888,-1,T,A,17824817,3298,17624911,18018127,199906
19,ENSG00000167815.7,12801800,19-12794432-C-A,rs1205170,-1,C,A,12794432,7368,12605192,12998408,189240
19,ENSG00000095059.10,12681880,19-12794432-C-A,rs1205170,-1,C,A,12794432,112552,12485272,12878488,309160
19,ENSG00000186204.8,15673087,19-15681756-C-T,rs12151032,1,C,T,15681756,8669,15476479,15869695,205277
19,ENSG00000104998.1,14031762,19-14018588-G-A,rs12460424,1,G,A,14018588,13174,13835154,14228370,183434
19,ENSG00000105085.4,16628204,19-16578828-C-T,rs12461030,-1,C,T,16578828,49376,16431596,16824812,147232
19,ENSG00000104863.5,49114370,19-49161260-G-A,rs12461291,1,G,A,49161260,46890,48917762,49310978,243498
19,ENSG00000104863.5,49114370,19-49161260-G-T,rs12461291,1,G,T,49161260,46890,48917762,49310978,243498
19,ENSG00000176490.3,2721372,19-2722548-T-G,rs12462143,-1,T,G,2722548,1176,2524764,2917980,197784
19,ENSG00000176490.3,2721372,19-2722548-T-C,rs12462143,-1,T,C,2722548,1176,2524764,2917980,197784
19,ENSG00000142039.2,41310172,19-41226518-T-C,rs12462203,1,T,C,41226518,83654,41113564,41506780,112954
19,ENSG00000142039.2,41310172,19-41226518-T-G,rs12462203,1,T,G,41226518,83654,41113564,41506780,112954
19,ENSG00000142065.7,36379201,19-36367183-T-C,rs12462725,-1,T,C,36367183,12018,36182593,36575809,184590
19,ENSG00000104979.3,13774456,19-13661811-G-A,rs12462927,1,G,A,13661811,112645,13577848,13971064,83963
19,ENSG00000104979.3,13774456,19-13661811-G-T,rs12462927,1,G,T,13661811,112645,13577848,13971064,83963
19,ENSG00000153879.2,33373709,19-33326227-A-G,rs12608723,1,A,G,33326227,47482,33177101,33570317,149126
19,ENSG00000153879.2,33373709,19-33326227-A-T,rs12608723,1,A,T,33326227,47482,33177101,33570317,149126
19,ENSG00000090372.7,46746450,19-46662617-C-T,rs12608819,-1,C,T,46662617,83833,46549842,46943058,112775
19,ENSG00000125735.5,6670160,19-6663905-G-A,rs12609318,-1,G,A,6663905,6255,6473552,6866768,190353
19,ENSG00000115268.3,1438396,19-1309370-G-A,rs12609567,1,G,A,1309370,129026,1241788,1635004,67582
19,ENSG00000115268.3,1438396,19-1309370-G-C,rs12609567,1,G,C,1309370,129026,1241788,1635004,67582
19,ENSG00000104973.8,49818289,19-49832615-A-G,rs1290652,1,A,G,49832615,14326,49621681,50014897,210934
19,ENSG00000104973.8,49818289,19-49832615-A-C,rs1290652,1,A,C,49832615,14326,49621681,50014897,210934
19,ENSG00000213024.4,49929504,19-49901682-T-G,rs1290754,-1,T,G,49901682,27822,49732896,50126112,168786
19,ENSG00000129347.14,10566010,19-10564658-T-C,rs12971428,-1,T,C,10564658,1352,10369402,10762618,195256
19,ENSG00000129347.14,10566010,19-10564658-T-A,rs12971428,-1,T,A,10564658,1352,10369402,10762618,195256
19,ENSG00000166398.5,34254554,19-34314622-T-C,rs12973790,1,T,C,34314622,60068,34057946,34451162,256676
19,ENSG00000196867.1,56538948,19-56509385-C-A,rs12978999,1,C,A,56509385,29563,56342340,56735556,167045
19,ENSG00000167766.11,52638355,19-52644517-G-A,rs12980672,-1,G,A,52644517,6162,52441747,52834963,202770
19,ENSG00000167766.11,52638355,19-52644517-G-C,rs12980672,-1,G,C,52644517,6162,52441747,52834963,202770
19,ENSG00000181392.9,36008813,19-36033380-T-C,rs12981654,-1,T,C,36033380,24567,35812205,36205421,221175
19,ENSG00000181392.9,36008813,19-36033380-T-G,rs12981654,-1,T,G,36033380,24567,35812205,36205421,221175
19,ENSG00000062370.9,44356680,19-44505925-C-T,rs12981961,-1,C,T,44505925,149245,44160072,44553288,345853
19,ENSG00000104888.4,49441527,19-49297912-T-A,rs12982246,-1,T,A,49297912,143615,49244919,49638135,52993
19,ENSG00000104888.4,49441527,19-49297912-T-C,rs12982246,-1,T,C,49297912,143615,49244919,49638135,52993
19,ENSG00000134815.12,47349315,19-47301962-C-T,rs12983014,1,C,T,47301962,47353,47152707,47545923,149255
19,ENSG00000262874.1,51390591,19-51377087-T-G,rs12983461,-1,T,G,51377087,13504,51193983,51587199,183104
19,ENSG00000262874.1,51390591,19-51377087-T-C,rs12983461,-1,T,C,51377087,13504,51193983,51587199,183104
19,ENSG00000180089.3,55228763,19-55249092-G-A,rs12983684,-1,G,A,55249092,20329,55032155,55425371,216937
19,ENSG00000105483.10,48255912,19-48255702-T-C,rs12984288,-1,T,C,48255702,210,48059304,48452520,196398
19,ENSG00000104884.9,45370573,19-45351661-T-G,rs13181,-1,T,G,45351661,18912,45173965,45567181,177696
19,ENSG00000104884.9,45370573,19-45351661-T-A,rs13181,-1,T,A,45351661,18912,45173965,45567181,177696
19,ENSG00000130517.5,18340598,19-18333999-A-T,rs1363119,1,A,T,18333999,6599,18143990,18537206,190009
19,ENSG00000130517.5,18340598,19-18333999-A-G,rs1363119,1,A,G,18333999,6599,18143990,18537206,190009
19,ENSG00000197619.7,52008211,19-51887473-C-A,rs1433082,-1,C,A,51887473,120738,51811603,52204819,75870
19,ENSG00000037757.8,13764522,19-13772285-A-C,rs1469071,1,A,C,13772285,7763,13567914,13961130,204371
19,ENSG00000037757.8,13764522,19-13772285-A-G,rs1469071,1,A,G,13772285,7763,13567914,13961130,204371
19,ENSG00000185453.7,48170680,19-48055131-T-C,rs1529479,1,T,C,48055131,115549,47974072,48367288,81059
19,ENSG00000178201.3,57457140,19-57547168-A-G,rs1548476,-1,A,G,57547168,90028,57260532,57653748,286636
19,ENSG00000197124.5,20039505,19-20107417-G-C,rs1621688,-1,G,C,20107417,67912,19842897,20236113,264520
19,ENSG00000197124.5,20039505,19-20107417-G-A,rs1621688,-1,G,A,20107417,67912,19842897,20236113,264520
19,ENSG00000197124.5,20039505,19-20107417-G-T,rs1621688,-1,G,T,20107417,67912,19842897,20236113,264520
19,ENSG00000198453.7,36916332,19-36987809-G-A,rs1644673,1,G,A,36987809,71477,36719724,37112940,268085
19,ENSG00000160439.9,55063148,19-55013445-C-T,rs1654410,-1,C,T,55013445,49703,54866540,55259756,146905
19,ENSG00000160439.9,55063148,19-55013445-C-G,rs1654410,-1,C,G,55013445,49703,54866540,55259756,146905
19,ENSG00000079462.2,42302624,19-42330599-A-C,rs1676222,-1,A,C,42330599,27975,42106016,42499232,224583
19,ENSG00000079462.2,42302624,19-42330599-A-G,rs1676222,-1,A,G,42330599,27975,42106016,42499232,224583
19,ENSG00000089327.8,35154735,19-35157462-T-A,rs1688005,1,T,A,35157462,2727,34958127,35351343,199335
19,ENSG00000089327.8,35154735,19-35157462-T-G,rs1688005,1,T,G,35157462,2727,34958127,35351343,199335
19,ENSG00000105675.2,35563658,19-35396227-T-C,rs16970288,-1,T,C,35396227,167431,35367050,35760266,29177
19,ENSG00000126243.3,35936374,19-35877146-T-G,rs16970737,1,T,G,35877146,59228,35739766,36132982,137380
19,ENSG00000141971.7,17420047,19-17420100-G-T,rs16981816,1,G,T,17420100,53,17223439,17616655,196661
19,ENSG00000105443.8,48469369,19-48318500-G-A,rs16981988,1,G,A,48318500,150869,48272761,48665977,45739
19,ENSG00000170954.6,53132910,19-53178789-T-C,rs16984547,-1,T,C,53178789,45879,52936302,53329518,242487
19,ENSG00000172006.6,2819868,19-2782451-G-A,rs16991385,1,G,A,2782451,37417,2623260,3016476,159191
19,ENSG00000186111.3,3700468,19-3675727-A-G,rs16991994,-1,A,G,3675727,24741,3503860,3897076,171867
19,ENSG00000186111.3,3700468,19-3675727-A-C,rs16991994,-1,A,C,3675727,24741,3503860,3897076,171867
19,ENSG00000007264.8,3786381,19-3757052-T-C,rs16992030,-1,T,C,3757052,29329,3589773,3982989,167279
19,ENSG00000090659.11,7747534,19-7744745-C-T,rs17159889,-1,C,T,7744745,2789,7550926,7944142,193819
19,ENSG00000090659.11,7747534,19-7744745-C-A,rs17159889,-1,C,A,7744745,2789,7550926,7944142,193819
19,ENSG00000099785.5,8413305,19-8443507-G-A,rs17160489,1,G,A,8443507,30202,8216697,8609913,226810
19,ENSG00000160336.10,53431984,19-53302942-C-G,rs17239350,1,C,G,53302942,129042,53235376,53628592,67566
19,ENSG00000105514.2,11339657,19-11325166-C-T,rs172757,-1,C,T,11325166,14491,11143049,11536265,182117
19,ENSG00000105364.8,10252214,19-10206539-G-A,rs17291414,1,G,A,10206539,45675,10055606,10448822,150933
19,ENSG00000105146.7,57231023,19-57111915-G-T,rs17305542,1,G,T,57111915,119108,57034415,57427631,77500
19,ENSG00000105146.7,57231023,19-57111915-G-C,rs17305542,1,G,C,57111915,119108,57034415,57427631,77500
19,ENSG00000123810.2,41364149,19-41431190-G-A,rs17318596,-1,G,A,41431190,67041,41167541,41560757,263649
19,ENSG00000105771.8,43754962,19-43730363-T-C,rs17560331,-1,T,C,43730363,24599,43558354,43951570,172009
19,ENSG00000099822.1,589881,19-760948-A-G,rs17604253,1,A,G,760948,171067,393273,786489,367675
19,ENSG00000142409.3,56121295,19-56011557-C-T,rs17608620,-1,C,T,56011557,109738,55924687,56317903,86870
19,ENSG00000124299.7,33521791,19-33459371-C-T,rs17761012,-1,C,T,33459371,62420,33325183,33718399,134188
19,ENSG00000127616.9,10961030,19-10948504-C-T,rs17842117,1,C,T,10948504,12526,10764422,11157638,184082
19,ENSG00000105270.7,36032873,19-36103161-C-T,rs17851502,-1,C,T,36103161,70288,35836265,36229481,266896
19,ENSG00000105270.7,36032873,19-36103161-C-A,rs17851502,-1,C,A,36103161,70288,35836265,36229481,266896
19,ENSG00000213015.3,55641002,19-55710155-C-T,rs17886456,1,C,T,55710155,69153,55444394,55837610,265761
19,ENSG00000087088.14,48954875,19-49097335-G-A,rs1806713,1,G,A,49097335,142460,48758267,49151483,339068
19,ENSG00000087088.14,48954875,19-49097335-G-T,rs1806713,1,G,T,49097335,142460,48758267,49151483,339068
19,ENSG00000161091.7,3557586,19-3481580-T-C,rs1860192,-1,T,C,3481580,76006,3360978,3754194,120602
19,ENSG00000183617.3,3762682,19-3769472-G-A,rs1860322,1,G,A,3769472,6790,3566074,3959290,203398
19,ENSG00000076924.6,7629545,19-7633434-C-T,rs1862514,-1,C,T,7633434,3889,7432937,7826153,200497
19,ENSG00000086544.1,40717112,19-40750614-T-G,rs1870086,1,T,G,40750614,33502,40520504,40913720,230110
19,ENSG00000123815.6,40716886,19-40750614-T-G,rs1870086,-1,T,G,40750614,33728,40520278,40913494,230336
19,ENSG00000126266.2,35351552,19-35332532-G-T,rs1894310,1,G,T,35332532,19020,35154944,35548160,177588
19,ENSG00000104825.12,38899969,19-38769830-A-T,rs1966961,1,A,T,38769830,130139,38703361,39096577,66469
19,ENSG00000104825.12,38899969,19-38769830-A-G,rs1966961,1,A,G,38769830,130139,38703361,39096577,66469
19,ENSG00000104825.12,38899969,19-38769830-A-C,rs1966961,1,A,C,38769830,130139,38703361,39096577,66469
19,ENSG00000105656.4,18522070,19-18402784-T-C,rs1985157,-1,T,C,18402784,119286,18325462,18718678,77322
19,ENSG00000105656.4,18522070,19-18402784-T-A,rs1985157,-1,T,A,18402784,119286,18325462,18718678,77322
19,ENSG00000105656.4,18522070,19-18402784-T-G,rs1985157,-1,T,G,18402784,119286,18325462,18718678,77322
19,ENSG00000161671.10,50476507,19-50436610-G-A,rs2004423,1,G,A,50436610,39897,50279899,50673115,156711
19,ENSG00000220008.1,2292024,19-2477279-C-T,rs2024144,-1,C,T,2477279,185255,2095416,2488632,381863
19,ENSG00000142556.13,52028379,19-52179259-A-G,rs2059810,-1,A,G,52179259,150880,51831771,52224987,347488
19,ENSG00000196381.3,37692315,19-37793150-G-T,rs2075283,-1,G,T,37793150,100835,37495707,37888923,297443
19,ENSG00000196381.3,37692315,19-37793150-G-A,rs2075283,-1,G,A,37793150,100835,37495707,37888923,297443
19,ENSG00000120784.9,37655465,19-37793150-G-T,rs2075283,-1,G,T,37793150,137685,37458857,37852073,334293
19,ENSG00000120784.9,37655465,19-37793150-G-A,rs2075283,-1,G,A,37793150,137685,37458857,37852073,334293
19,ENSG00000167468.10,1103994,19-1106846-C-T,rs2075710,1,C,T,1106846,2852,907386,1300602,199460
19,ENSG00000167658.9,3985463,19-4042925-A-G,rs2121137,-1,A,G,4042925,57462,3788855,4182071,254070
19,ENSG00000131355.9,14674844,19-14629631-T-C,rs2126979,-1,T,C,14629631,45213,14478236,14871452,151395
19,ENSG00000104883.2,7489035,19-7510032-G-A,rs2161568,-1,G,A,7510032,20997,7292427,7685643,217605
19,ENSG00000160111.6,17026810,19-16890740-G-A,rs2227349,-1,G,A,16890740,136070,16830202,17223418,60538
19,ENSG00000160111.6,17026810,19-16890740-G-T,rs2227349,-1,G,T,16890740,136070,16830202,17223418,60538
19,ENSG00000099783.5,8444975,19-8308268-T-C,rs2232775,1,T,C,8308268,136707,8248367,8641583,59901
19,ENSG00000188493.8,40750477,19-40775201-G-A,rs2233153,-1,G,A,40775201,24724,40553869,40947085,221332
19,ENSG00000188493.8,40750477,19-40775201-G-C,rs2233153,-1,G,C,40775201,24724,40553869,40947085,221332
19,ENSG00000105669.6,18919387,19-18831750-C-A,rs2238652,-1,C,A,18831750,87637,18722779,19115995,108971
19,ENSG00000105669.6,18919387,19-18831750-C-G,rs2238652,-1,C,G,18831750,87637,18722779,19115995,108971
19,ENSG00000105669.6,18919387,19-18831750-C-T,rs2238652,-1,C,T,18831750,87637,18722779,19115995,108971
19,ENSG00000251369.2,57559863,19-57444603-C-T,rs2240039,-1,C,T,57444603,115260,57363255,57756471,81348
19,ENSG00000125734.7,6737580,19-6685219-G-C,rs2241394,-1,G,C,6685219,52361,6540972,6934188,144247
19,ENSG00000167608.6,54173160,19-54151910-C-T,rs2241790,-1,C,T,54151910,21250,53976552,54369768,175358
19,ENSG00000124466.6,43465608,19-43450763-C-A,rs2247798,-1,C,A,43450763,14845,43269000,43662216,181763
19,ENSG00000180884.7,34964229,19-35039877-A-C,rs2278996,-1,A,C,35039877,75648,34767621,35160837,272256
19,ENSG00000076650.1,33081181,19-33117827-C-A,rs2287681,1,C,A,33117827,36646,32884573,33277789,233254
19,ENSG00000076650.1,33081181,19-33117827-C-T,rs2287681,1,C,T,33117827,36646,32884573,33277789,233254
19,ENSG00000076650.1,33081181,19-33117827-C-G,rs2287681,1,C,G,33117827,36646,32884573,33277789,233254
19,ENSG00000160117.8,17281901,19-17306443-C-A,rs2288464,1,C,A,17306443,24542,17085293,17478509,221150
19,ENSG00000160117.8,17281901,19-17306443-C-T,rs2288464,1,C,T,17306443,24542,17085293,17478509,221150
19,ENSG00000156413.7,5839702,19-5776190-C-T,rs2290778,-1,C,T,5776190,63512,5643094,6036310,133096
19,ENSG00000156413.7,5839702,19-5776190-C-A,rs2290778,-1,C,A,5776190,63512,5643094,6036310,133096
19,ENSG00000104872.5,49451814,19-49451759-G-T,rs2293011,-1,G,T,49451759,55,49255206,49648422,196553
19,ENSG00000105737.4,42070206,19-42236972-A-G,rs2302485,-1,A,G,42236972,166766,41873598,42266814,363374
19,ENSG00000167460.9,16076495,19-16086567-C-T,rs2303150,1,C,T,16086567,10072,15879887,16273103,206680
19,ENSG00000256771.1,19865882,19-19865892-A-T,rs2304169,1,A,T,19865892,10,19669274,20062490,196618
19,ENSG00000256771.1,19865882,19-19865892-A-G,rs2304169,1,A,G,19865892,10,19669274,20062490,196618
19,ENSG00000167618.4,54502831,19-54515214-C-T,rs2363059,1,C,T,54515214,12383,54306223,54699439,208991
19,ENSG00000167618.4,54502831,19-54515214-C-A,rs2363059,1,C,A,54515214,12383,54306223,54699439,208991
19,ENSG00000167618.4,54502831,19-54515214-C-G,rs2363059,1,C,G,54515214,12383,54306223,54699439,208991
19,ENSG00000175221.7,893187,19-892615-A-G,rs2365703,-1,A,G,892615,572,696579,1089795,196036
19,ENSG00000175221.7,893187,19-892615-A-C,rs2365703,-1,A,C,892615,572,696579,1089795,196036
19,ENSG00000142279.6,34481758,19-34385628-T-A,rs2377572,1,T,A,34385628,96130,34285150,34678366,100478
19,ENSG00000142279.6,34481758,19-34385628-T-C,rs2377572,1,T,C,34385628,96130,34285150,34678366,100478
19,ENSG00000189042.7,36687612,19-36543680-T-C,rs2385655,1,T,C,36543680,143932,36491004,36884220,52676
19,ENSG00000011422.6,43670169,19-43852735-A-T,rs239948,-1,A,T,43852735,182566,43473561,43866777,379174
19,ENSG00000011422.6,43670169,19-43852735-A-C,rs239948,-1,A,C,43852735,182566,43473561,43866777,379174
19,ENSG00000011422.6,43670169,19-43852735-A-G,rs239948,-1,A,G,43852735,182566,43473561,43866777,379174
19,ENSG00000251247.3,36850876,19-36835382-G-A,rs2431776,1,G,A,36835382,15494,36654268,37047484,181114
19,ENSG00000251247.3,36850876,19-36835382-G-T,rs2431776,1,G,T,36835382,15494,36654268,37047484,181114
19,ENSG00000167671.6,4457794,19-4442532-T-C,rs243382,-1,T,C,4442532,15262,4261186,4654402,181346
19,ENSG00000167671.6,4457794,19-4442532-T-A,rs243382,-1,T,A,4442532,15262,4261186,4654402,181346
19,ENSG00000160410.8,40576873,19-40718409-G-T,rs2561530,1,G,T,40718409,141536,40380265,40773481,338144
19,ENSG00000160410.8,40576873,19-40718409-G-A,rs2561530,1,G,A,40718409,141536,40380265,40773481,338144
19,ENSG00000160410.8,40576873,19-40718409-G-C,rs2561530,1,G,C,40718409,141536,40380265,40773481,338144
19,ENSG00000072954.1,16661139,19-16691198-T-A,rs2633339,1,T,A,16691198,30059,16464531,16857747,226667
19,ENSG00000072954.1,16661139,19-16691198-T-C,rs2633339,1,T,C,16691198,30059,16464531,16857747,226667
19,ENSG00000072954.1,16661139,19-16691198-T-G,rs2633339,1,T,G,16691198,30059,16464531,16857747,226667
19,ENSG00000182141.4,21329410,19-21478235-G-C,rs2650808,-1,G,C,21478235,148825,21132802,21526018,345433
19,ENSG00000105447.7,48445983,19-48581398-G-A,rs2665584,1,G,A,48581398,135415,48249375,48642591,332023
19,ENSG00000105447.7,48445983,19-48581398-G-T,rs2665584,1,G,T,48581398,135415,48249375,48642591,332023
19,ENSG00000105755.2,43527201,19-43578277-C-A,rs2682587,-1,C,A,43578277,51076,43330593,43723809,247684
19,ENSG00000022556.10,54966374,19-54970301-T-C,rs269913,1,T,C,54970301,3927,54769766,55162982,200535
19,ENSG00000167634.6,54947505,19-54970301-T-C,rs269913,-1,T,C,54970301,22796,54750897,55144113,219404
19,ENSG00000176920.10,48695971,19-48714004-A-C,rs281385,1,A,C,48714004,18033,48499363,48892579,214641
19,ENSG00000176920.10,48695971,19-48714004-A-G,rs281385,1,A,G,48714004,18033,48499363,48892579,214641
19,ENSG00000087074.5,48872421,19-48724253-T-C,rs281405,1,T,C,48724253,148168,48675813,49069029,48440
19,ENSG00000087074.5,48872421,19-48724253-T-A,rs281405,1,T,A,48724253,148168,48675813,49069029,48440
19,ENSG00000076662.4,10339624,19-10336058-G-A,rs281413,-1,G,A,10336058,3566,10143016,10536232,193042
19,ENSG00000104921.9,7702131,19-7690399-A-T,rs28364072,-1,A,T,7690399,11732,7505523,7898739,184876
19,ENSG00000104921.9,7702131,19-7690399-A-G,rs28364072,-1,A,G,7690399,11732,7505523,7898739,184876
19,ENSG00000176472.5,43533188,19-43570060-A-T,rs2854510,1,A,T,43570060,36872,43336580,43729796,233480
19,ENSG00000176472.5,43533188,19-43570060-A-G,rs2854510,1,A,G,43570060,36872,43336580,43729796,233480
19,ENSG00000105227.8,40413378,19-40459443-A-C,rs28608147,-1,A,C,40459443,46065,40216770,40609986,242673
19,ENSG00000105227.8,40413378,19-40459443-A-T,rs28608147,-1,A,T,40459443,46065,40216770,40609986,242673
19,ENSG00000105227.8,40413378,19-40459443-A-G,rs28608147,-1,A,G,40459443,46065,40216770,40609986,242673
19,ENSG00000171291.3,11848726,19-11720774-C-G,rs286278,1,C,G,11720774,127952,11652118,12045334,68656
19,ENSG00000197044.6,11767000,19-11678744-G-A,rs286293,1,G,A,11678744,88256,11570392,11963608,108352
19,ENSG00000004777.10,35775564,19-35741519-C-T,rs2871921,1,C,T,35741519,34045,35578956,35972172,162563
19,ENSG00000141965.3,4791734,19-4772437-C-G,rs2885717,1,C,G,4772437,19297,4595126,4988342,177311
19,ENSG00000141965.3,4791734,19-4772437-C-T,rs2885717,1,C,T,4772437,19297,4595126,4988342,177311
19,ENSG00000121289.11,32971958,19-32953550-A-G,rs2944021,-1,A,G,32953550,18408,32775350,33168566,178200
19,ENSG00000197766.1,859664,19-896506-A-G,rs2965285,1,A,G,896506,36842,663056,1056272,233450
19,ENSG00000161298.11,36605313,19-36556570-G-A,rs2967436,1,G,A,36556570,48743,36408705,36801921,147865
19,ENSG00000069399.7,44748708,19-44814896-G-C,rs2968180,1,G,C,44814896,66188,44552100,44945316,262796
19,ENSG00000069399.7,44748708,19-44814896-G-T,rs2968180,1,G,T,44814896,66188,44552100,44945316,262796
19,ENSG00000069399.7,44748708,19-44814896-G-A,rs2968180,1,G,A,44814896,66188,44552100,44945316,262796
19,ENSG00000181007.6,36418644,19-36323070-A-G,rs2972631,-1,A,G,36323070,95574,36222036,36615252,101034
19,ENSG00000181007.6,36418644,19-36323070-A-T,rs2972631,-1,A,T,36323070,95574,36222036,36615252,101034
19,ENSG00000104907.7,13116740,19-12951169-C-T,rs2974754,-1,C,T,12951169,165571,12920132,13313348,31037
19,ENSG00000104907.7,13116740,19-12951169-C-G,rs2974754,-1,C,G,12951169,165571,12920132,13313348,31037
19,ENSG00000171425.4,55643649,19-55837269-A-G,rs302468,1,A,G,55837269,193620,55447041,55840257,390228
19,ENSG00000105371.7,10286955,19-10286727-C-T,rs3093030,1,C,T,10286727,228,10090347,10483563,196380
19,ENSG00000181027.5,46746057,19-46783912-G-C,rs313852,1,G,C,46783912,37855,46549449,46942665,234463
19,ENSG00000181027.5,46746057,19-46783912-G-A,rs313852,1,G,A,46783912,37855,46549449,46942665,234463
19,ENSG00000198464.7,52297169,19-52305733-A-G,rs321913,1,A,G,52305733,8564,52100561,52493777,205172
19,ENSG00000196214.5,52269587,19-52334684-C-T,rs321921,1,C,T,52334684,65097,52072979,52466195,261705
19,ENSG00000196214.5,52269587,19-52334684-C-G,rs321921,1,C,G,52334684,65097,52072979,52466195,261705
19,ENSG00000161243.3,39032549,19-38931317-A-C,rs33988199,-1,A,C,38931317,101232,38835941,39229157,95376
19,ENSG00000161243.3,39032549,19-38931317-A-G,rs33988199,-1,A,G,38931317,101232,38835941,39229157,95376
19,ENSG00000105556.3,344796,19-506712-G-A,rs34026602,-1,G,A,506712,161916,148188,541404,358524
19,ENSG00000127220.3,17303425,19-17276367-A-G,rs34084277,-1,A,G,17276367,27058,17106817,17500033,169550
19,ENSG00000187650.2,5904872,19-5940334-G-A,rs34185207,1,G,A,5940334,35462,5708264,6101480,232070
19,ENSG00000197213.3,56197920,19-56222056-C-A,rs34187696,-1,C,A,56222056,24136,56001312,56394528,220744
19,ENSG00000197213.3,56197920,19-56222056-C-T,rs34187696,-1,C,T,56222056,24136,56001312,56394528,220744
19,ENSG00000249115.2,35612735,19-35459272-A-G,rs34536858,1,A,G,35459272,153463,35416127,35809343,43145
19,ENSG00000249115.2,35612735,19-35459272-A-T,rs34536858,1,A,T,35459272,153463,35416127,35809343,43145
19,ENSG00000105711.5,35030470,19-34958582-T-G,rs34687332,1,T,G,34958582,71888,34833862,35227078,124720
19,ENSG00000105711.5,35030470,19-34958582-T-C,rs34687332,1,T,C,34958582,71888,34833862,35227078,124720
19,ENSG00000104833.4,6502309,19-6461705-G-T,rs348357,-1,G,T,6461705,40604,6305701,6698917,156004
19,ENSG00000104833.4,6502309,19-6461705-G-A,rs348357,-1,G,A,6461705,40604,6305701,6698917,156004
19,ENSG00000125648.8,6459792,19-6461705-G-T,rs348357,-1,G,T,6461705,1913,6263184,6656400,198521
19,ENSG00000125648.8,6459792,19-6461705-G-A,rs348357,-1,G,A,6461705,1913,6263184,6656400,198521
19,ENSG00000172270.12,572596,19-566103-C-G,rs34884009,1,C,G,566103,6493,375988,769204,190115
19,ENSG00000172270.12,572596,19-566103-C-T,rs34884009,1,C,T,566103,6493,375988,769204,190115
19,ENSG00000197256.5,11197545,19-11189232-C-T,rs34958840,-1,C,T,11189232,8313,11000937,11394153,188295
19,ENSG00000039650.4,49867576,19-49809544-C-T,rs35002951,-1,C,T,49809544,58032,49670968,50064184,138576
19,ENSG00000204673.5,49877355,19-49809544-C-T,rs35002951,-1,C,T,49809544,67811,49680747,50073963,128797
19,ENSG00000104894.6,49335406,19-49297570-A-G,rs354009,1,A,G,49297570,37836,49138798,49532014,158772
19,ENSG00000104894.6,49335406,19-49297570-A-T,rs354009,1,A,T,49297570,37836,49138798,49532014,158772
19,ENSG00000104894.6,49335406,19-49297570-A-C,rs354009,1,A,C,49297570,37836,49138798,49532014,158772
19,ENSG00000130724.3,58555105,19-58516795-G-A,rs35430780,-1,G,A,58516795,38310,58358497,58751713,158298
19,ENSG00000130724.3,58555105,19-58516795-G-C,rs35430780,-1,G,C,58516795,38310,58358497,58751713,158298
19,ENSG00000064547.8,19628220,19-19668203-G-A,rs35449009,-1,G,A,19668203,39983,19431612,19824828,236591
19,ENSG00000083845.3,58387269,19-58443552-C-T,rs35713506,1,C,T,58443552,56283,58190661,58583877,252891
19,ENSG00000126461.8,49642209,19-49812826-C-T,rs35816883,1,C,T,49812826,170617,49445601,49838817,367225
19,ENSG00000249709.1,12551482,19-12410890-C-T,rs36058989,-1,C,T,12410890,140592,12354874,12748090,56016
19,ENSG00000177380.8,49119544,19-49196609-C-T,rs3745301,1,C,T,49196609,77065,48922936,49316152,273673
19,ENSG00000130810.14,10106362,19-10113850-C-T,rs3745600,1,C,T,10113850,7488,9909754,10302970,204096
19,ENSG00000181666.11,37334649,19-37363678-C-T,rs3745764,1,C,T,37363678,29029,37138041,37531257,225637
19,ENSG00000099804.2,531760,19-511453-A-T,rs3745924,1,A,T,511453,20307,335152,728368,176301
19,ENSG00000099804.2,531760,19-511453-A-G,rs3745924,1,A,G,511453,20307,335152,728368,176301
19,ENSG00000006638.6,3606875,19-3618930-G-A,rs3746125,-1,G,A,3618930,12055,3410267,3803483,208663
19,ENSG00000160961.6,14690048,19-14717925-G-A,rs3752185,1,G,A,14717925,27877,14493440,14886656,224485
19,ENSG00000160961.6,14690048,19-14717925-G-T,rs3752185,1,G,T,14717925,27877,14493440,14886656,224485
19,ENSG00000105176.12,29942239,19-29915325-T-G,rs375299,1,T,G,29915325,26914,29745631,30138847,169694
19,ENSG00000105176.12,29942239,19-29915325-T-C,rs375299,1,T,C,29915325,26914,29745631,30138847,169694
19,ENSG00000130204.7,44891254,19-44953923-T-C,rs3760627,1,T,C,44953923,62669,44694646,45087862,259277
19,ENSG00000130204.7,44891254,19-44953923-T-G,rs3760627,1,T,G,44953923,62669,44694646,45087862,259277
19,ENSG00000167775.4,8308358,19-8324127-C-A,rs3760685,-1,C,A,8324127,15769,8111750,8504966,212377
19,ENSG00000142534.1,49496434,19-49581115-C-A,rs3760706,1,C,A,49581115,84681,49299826,49693042,281289
19,ENSG00000125910.3,3178769,19-3176172-A-C,rs3760960,1,A,C,3176172,2597,2982161,3375377,194011
19,ENSG00000125910.3,3178769,19-3176172-A-G,rs3760960,1,A,G,3176172,2597,2982161,3375377,194011
19,ENSG00000249471.2,58451622,19-58417827-A-G,rs3764533,1,A,G,58417827,33795,58255014,58648230,162813
19,ENSG00000187912.7,14583084,19-14447009-A-G,rs3786654,1,A,G,14447009,136075,14386476,14779692,60533
19,ENSG00000099338.14,38335830,19-38268302-A-G,rs3786874,1,A,G,38268302,67528,38139222,38532438,129080
19,ENSG00000160505.9,55836540,19-55858800-C-T,rs379327,1,C,T,55858800,22260,55639932,56033148,218868
19,ENSG00000160505.9,55836540,19-55858800-C-G,rs379327,1,C,G,55858800,22260,55639932,56033148,218868
19,ENSG00000166704.7,58002820,19-57972341-A-G,rs3810128,-1,A,G,57972341,30479,57806212,58199428,166129
19,ENSG00000104904.4,2269520,19-2180516-G-A,rs3810409,1,G,A,2180516,89004,2072912,2466128,107604
19,ENSG00000130513.3,18386158,19-18258401-T-G,rs3810434,1,T,G,18258401,127757,18189550,18582766,68851
19,ENSG00000073050.5,43575527,19-43614036-A-C,rs3815422,-1,A,C,43614036,38509,43378919,43772135,235117
19,ENSG00000073050.5,43575527,19-43614036-A-T,rs3815422,-1,A,T,43614036,38509,43378919,43772135,235117
19,ENSG00000125746.8,45639397,19-45621259-C-T,rs3816045,-1,C,T,45621259,18138,45442789,45836005,178470
19,ENSG00000130159.6,11529134,19-11335844-T-G,rs3816864,-1,T,G,11335844,193290,11332526,11725742,3318
19,ENSG00000205155.1,35745651,19-35907997-C-T,rs3817624,1,C,T,35907997,162346,35549043,35942259,358954
19,ENSG00000099331.7,17075777,19-17188084-G-A,rs3826689,1,G,A,17188084,112307,16879169,17272385,308915
19,ENSG00000099331.7,17075777,19-17188084-G-T,rs3826689,1,G,T,17188084,112307,16879169,17272385,308915
19,ENSG00000099331.7,17075777,19-17188084-G-C,rs3826689,1,G,C,17188084,112307,16879169,17272385,308915
19,ENSG00000104951.10,49896887,19-49928131-G-A,rs3826777,-1,G,A,49928131,31244,49700279,50093495,227852
19,ENSG00000104951.10,49896887,19-49928131-G-C,rs3826777,-1,G,C,49928131,31244,49700279,50093495,227852
19,ENSG00000105516.5,48637379,19-48680027-G-A,rs3826838,-1,G,A,48680027,42648,48440771,48833987,239256
19,ENSG00000105516.5,48637379,19-48680027-G-T,rs3826838,-1,G,T,48680027,42648,48440771,48833987,239256
19,ENSG00000167637.11,43827321,19-43962944-T-G,rs383133,1,T,G,43962944,135623,43630713,44023929,332231
19,ENSG00000167637.11,43827321,19-43962944-T-A,rs383133,1,T,A,43962944,135623,43630713,44023929,332231
19,ENSG00000105499.8,48110817,19-48103274-A-G,rs385203,-1,A,G,48103274,7543,47914209,48307425,189065
19,ENSG00000099337.2,38319845,19-38309525-C-T,rs3900981,1,C,T,38309525,10320,38123237,38516453,186288
19,ENSG00000099337.2,38319845,19-38309525-C-G,rs3900981,1,C,G,38309525,10320,38123237,38516453,186288
19,ENSG00000198182.6,37719761,19-37801729-C-T,rs3910952,-1,C,T,37801729,81968,37523153,37916369,278576
19,ENSG00000141905.11,3366583,19-3403233-A-T,rs3922397,1,A,T,3403233,36650,3169975,3563191,233258
19,ENSG00000141905.11,3366583,19-3403233-A-G,rs3922397,1,A,G,3403233,36650,3169975,3563191,233258
19,ENSG00000141905.11,3366583,19-3403233-A-C,rs3922397,1,A,C,3403233,36650,3169975,3563191,233258
19,ENSG00000204920.4,43984188,19-43984375-A-C,rs398981,1,A,C,43984375,187,43787580,44180796,196795
19,ENSG00000204920.4,43984188,19-43984375-A-G,rs398981,1,A,G,43984375,187,43787580,44180796,196795
19,ENSG00000196646.7,12163096,19-11990359-G-A,rs400606,1,G,A,11990359,172737,11966488,12359704,23871
19,ENSG00000096996.9,18086934,19-18059187-A-T,rs404733,-1,A,T,18059187,27747,17890326,18283542,168861
19,ENSG00000171777.9,38426219,19-38507639-G-A,rs41274328,-1,G,A,38507639,81420,38229611,38622827,278028
19,ENSG00000099821.6,633537,19-624405-G-A,rs41558812,-1,G,A,624405,9132,436929,830145,187476
19,ENSG00000018869.10,56393534,19-56575446-C-T,rs4239476,-1,C,T,56575446,181912,56196926,56590142,378520
19,ENSG00000018869.10,56393534,19-56575446-C-A,rs4239476,-1,C,A,56575446,181912,56196926,56590142,378520
19,ENSG00000130475.9,17751477,19-17767913-A-T,rs4239635,1,A,T,17767913,16436,17554869,17948085,213044
19,ENSG00000130475.9,17751477,19-17767913-A-G,rs4239635,1,A,G,17767913,16436,17554869,17948085,213044
19,ENSG00000104783.5,43780973,19-43659703-C-A,rs4251856,-1,C,A,43659703,121270,43584365,43977581,75338
19,ENSG00000104783.5,43780973,19-43659703-C-T,rs4251856,-1,C,T,43659703,121270,43584365,43977581,75338
19,ENSG00000160007.11,46860997,19-46868359-G-A,rs425655,1,G,A,46868359,7362,46664389,47057605,203970
19,ENSG00000182013.11,46471563,19-46428805-A-C,rs427250,-1,A,C,46428805,42758,46274955,46668171,153850
19,ENSG00000182013.11,46471563,19-46428805-A-G,rs427250,-1,A,G,46428805,42758,46274955,46668171,153850
19,ENSG00000182013.11,46471563,19-46428805-A-T,rs427250,-1,A,T,46428805,42758,46274955,46668171,153850
19,ENSG00000160392.8,40348397,19-40308106-C-G,rs4273150,-1,C,G,40308106,40291,40151789,40545005,156317
19,ENSG00000160392.8,40348397,19-40308106-C-T,rs4273150,-1,C,T,40308106,40291,40151789,40545005,156317
19,ENSG00000176222.6,43883964,19-43986820-G-C,rs430746,-1,G,C,43986820,102856,43687356,44080572,299464
19,ENSG00000176222.6,43883964,19-43986820-G-A,rs430746,-1,G,A,43986820,102856,43687356,44080572,299464
19,ENSG00000167380.11,44165100,19-44094715-T-G,rs4429390,1,T,G,44094715,70385,43968492,44361708,126223
19,ENSG00000132002.2,14518397,19-14481942-G-A,rs4461186,-1,G,A,14481942,36455,14321789,14715005,160153
19,ENSG00000188171.8,20661571,19-20621885-T-C,rs4483974,-1,T,C,20621885,39686,20464963,20858179,156922
19,ENSG00000188171.8,20661571,19-20621885-T-A,rs4483974,-1,T,A,20621885,39686,20464963,20858179,156922
19,ENSG00000188171.8,20661571,19-20621885-T-G,rs4483974,-1,T,G,20621885,39686,20464963,20858179,156922
19,ENSG00000011304.10,797452,19-773437-C-A,rs4536588,1,C,A,773437,24015,600844,994060,172593
19,ENSG00000011304.10,797452,19-773437-C-T,rs4536588,1,C,T,773437,24015,600844,994060,172593
19,ENSG00000011304.10,797452,19-773437-C-G,rs4536588,1,C,G,773437,24015,600844,994060,172593
19,ENSG00000171443.5,55600288,19-55511567-C-G,rs477933,1,C,G,55511567,88721,55403680,55796896,107887
19,ENSG00000171443.5,55600288,19-55511567-C-T,rs477933,1,C,T,55511567,88721,55403680,55796896,107887
19,ENSG00000171443.5,55600288,19-55511567-C-A,rs477933,1,C,A,55511567,88721,55403680,55796896,107887
19,ENSG00000083807.4,58511992,19-58458732-A-G,rs4801591,-1,A,G,58458732,53260,58315384,58708600,143348
19,ENSG00000104826.5,49017091,19-49011700-C-T,rs4802536,-1,C,T,49011700,5391,48820483,49213699,191217
19,ENSG00000161609.4,49388249,19-49368828-G-A,rs4802597,1,G,A,49368828,19421,49191641,49584857,177187
19,ENSG00000161618.4,49453225,19-49456107-G-C,rs4802607,1,G,C,49456107,2882,49256617,49649833,199490
19,ENSG00000167748.5,50823787,19-50800047-A-G,rs4802742,-1,A,G,50800047,23740,50627179,51020395,172868
19,ENSG00000167748.5,50823787,19-50800047-A-C,rs4802742,-1,A,C,50800047,23740,50627179,51020395,172868
19,ENSG00000182310.7,51693330,19-51623881-C-T,rs4802831,1,C,T,51623881,69449,51496722,51889938,127159
19,ENSG00000182310.7,51693330,19-51623881-C-G,rs4802831,1,C,G,51623881,69449,51496722,51889938,127159
19,ENSG00000204604.3,52857619,19-52864085-G-A,rs4803014,-1,G,A,52864085,6466,52661011,53054227,203074
19,ENSG00000197937.5,53159053,19-53168784-T-C,rs4803055,-1,T,C,53168784,9731,52962445,53355661,206339
19,ENSG00000105341.11,41439912,19-41412149-G-C,rs4803464,-1,G,C,41412149,27763,41243304,41636520,168845
19,ENSG00000105341.11,41439912,19-41412149-G-A,rs4803464,-1,G,A,41412149,27763,41243304,41636520,168845
19,ENSG00000077348.3,41397359,19-41412149-G-C,rs4803464,-1,G,C,41412149,14790,41200751,41593967,211398
19,ENSG00000077348.3,41397359,19-41412149-G-A,rs4803464,-1,G,A,41412149,14790,41200751,41593967,211398
19,ENSG00000177045.4,45769252,19-45735668-G-C,rs4803852,-1,G,C,45735668,33584,45572644,45965860,163024
19,ENSG00000177045.4,45769252,19-45735668-G-T,rs4803852,-1,G,T,45735668,33584,45572644,45965860,163024
19,ENSG00000167642.6,38264573,19-38237000-A-G,rs4803899,1,A,G,38237000,27573,38067965,38461181,169035
19,ENSG00000167642.6,38264573,19-38237000-A-T,rs4803899,1,A,T,38237000,27573,38067965,38461181,169035
19,ENSG00000167642.6,38264573,19-38237000-A-C,rs4803899,1,A,C,38237000,27573,38067965,38461181,169035
19,ENSG00000257704.1,47274885,19-47284247-G-A,rs4804044,1,G,A,47284247,9362,47078277,47471493,205970
19,ENSG00000257704.1,47274885,19-47284247-G-C,rs4804044,1,G,C,47284247,9362,47078277,47471493,205970
19,ENSG00000105321.6,47256525,19-47284247-G-A,rs4804044,1,G,A,47284247,27722,47059917,47453133,224330
19,ENSG00000105321.6,47256525,19-47284247-G-C,rs4804044,1,G,C,47284247,27722,47059917,47453133,224330
19,ENSG00000260001.1,7914830,19-7718688-G-C,rs4804227,1,G,C,7718688,196142,7718222,8111438,466
19,ENSG00000260001.1,7914830,19-7718688-G-T,rs4804227,1,G,T,7718688,196142,7718222,8111438,466
19,ENSG00000171017.5,7888510,19-7718688-G-C,rs4804227,1,G,C,7718688,169822,7691902,8085118,26786
19,ENSG00000171017.5,7888510,19-7718688-G-T,rs4804227,1,G,T,7718688,169822,7691902,8085118,26786
19,ENSG00000198551.4,11597483,19-11619875-C-T,rs4804613,1,C,T,11619875,22392,11400875,11794091,219000
19,ENSG00000064666.7,1026608,19-1026478-G-T,rs4807440,1,G,T,1026478,130,830000,1223216,196478
19,ENSG00000077463.9,4182563,19-4182063-T-C,rs4807546,-1,T,C,4182063,500,3985955,4379171,196108
19,ENSG00000077463.9,4182563,19-4182063-T-G,rs4807546,-1,T,G,4182063,500,3985955,4379171,196108
19,ENSG00000185361.3,4639516,19-4658595-C-T,rs4807622,1,C,T,4658595,19079,4442908,4836124,215687
19,ENSG00000105426.8,5340812,19-5289511-A-G,rs4807709,-1,A,G,5289511,51301,5144204,5537420,145307
19,ENSG00000181035.8,19063994,19-19028242-A-G,rs4808178,1,A,G,19028242,35752,18867386,19260602,160856
19,ENSG00000130309.4,17555649,19-17557324-C-T,rs4808666,1,C,T,17557324,1675,17359041,17752257,198283
19,ENSG00000007080.5,17933015,19-17911265-C-T,rs4808714,1,C,T,17911265,21750,17736407,18129623,174858
19,ENSG00000007080.5,17933015,19-17911265-C-G,rs4808714,1,C,G,17911265,21750,17736407,18129623,174858
19,ENSG00000007080.5,17933015,19-17911265-C-A,rs4808714,1,C,A,17911265,21750,17736407,18129623,174858
19,ENSG00000081665.7,19821750,19-19797524-C-T,rs4808991,-1,C,T,19797524,24226,19625142,20018358,172382
19,ENSG00000081665.7,19821750,19-19797524-C-A,rs4808991,-1,C,A,19797524,24226,19625142,20018358,172382
19,ENSG00000074181.2,15200995,19-15270061-T-G,rs4809125,-1,T,G,15270061,69066,15004387,15397603,265674
19,ENSG00000074181.2,15200995,19-15270061-T-C,rs4809125,-1,T,C,15270061,69066,15004387,15397603,265674
19,ENSG00000074181.2,15200995,19-15270061-T-A,rs4809125,-1,T,A,15270061,69066,15004387,15397603,265674
19,ENSG00000063180.3,48646187,19-48818719-G-A,rs482226,-1,G,A,48818719,172532,48449579,48842795,369140
19,ENSG00000063180.3,48646187,19-48818719-G-T,rs482226,-1,G,T,48818719,172532,48449579,48842795,369140
19,ENSG00000130844.11,53538145,19-53529790-T-G,rs4994351,1,T,G,53529790,8355,53341537,53734753,188253
19,ENSG00000130844.11,53538145,19-53529790-T-C,rs4994351,1,T,C,53529790,8355,53341537,53734753,188253
19,ENSG00000089351.7,35000323,19-34999957-C-G,rs4997929,1,C,G,34999957,366,34803715,35196931,196242
19,ENSG00000089351.7,35000323,19-34999957-C-A,rs4997929,1,C,A,34999957,366,34803715,35196931,196242
19,ENSG00000006712.9,39391106,19-39397809-C-T,rs519575,-1,C,T,39397809,6703,39194498,39587714,203311
19,ENSG00000179873.8,55831994,19-55985517-T-C,rs55905529,-1,T,C,55985517,153523,55635386,56028602,350131
19,ENSG00000060566.7,4153631,19-4330639-T-G,rs56083157,1,T,G,4330639,177008,3957023,4350239,373616
19,ENSG00000060566.7,4153631,19-4330639-T-A,rs56083157,1,T,A,4330639,177008,3957023,4350239,373616
19,ENSG00000060566.7,4153631,19-4330639-T-C,rs56083157,1,T,C,4330639,177008,3957023,4350239,373616
19,ENSG00000118162.8,47484219,19-47545258-T-C,rs56162770,-1,T,C,47545258,61039,47287611,47680827,257647
19,ENSG00000131849.8,58440153,19-58407953-A-G,rs56290606,-1,A,G,58407953,32200,58243545,58636761,164408
19,ENSG00000131849.8,58440153,19-58407953-A-C,rs56290606,-1,A,C,58407953,32200,58243545,58636761,164408
19,ENSG00000088256.3,3094362,19-3177281-C-T,rs567806,1,C,T,3177281,82919,2897754,3290970,279527
19,ENSG00000131408.7,50376457,19-50435226-G-A,rs57092106,1,G,A,50435226,58769,50179849,50573065,255377
19,ENSG00000133243.3,2015714,19-2007912-C-T,rs57274573,-1,C,T,2007912,7802,1819106,2212322,188806
19,ENSG00000133243.3,2015714,19-2007912-C-G,rs57274573,-1,C,G,2007912,7802,1819106,2212322,188806
19,ENSG00000160013.3,46625089,19-46492517-C-T,rs57318042,-1,C,T,46492517,132572,46428481,46821697,64036
19,ENSG00000083828.8,57769676,19-57740100-G-A,rs58789890,1,G,A,57740100,29576,57573068,57966284,167032
19,ENSG00000132003.4,13795443,19-13850312-G-A,rs59136837,1,G,A,13850312,54869,13598835,13992051,251477
19,ENSG00000132003.4,13795443,19-13850312-G-T,rs59136837,1,G,T,13850312,54869,13598835,13992051,251477
19,ENSG00000141994.9,5791163,19-5772939-G-A,rs61180947,-1,G,A,5772939,18224,5594555,5987771,178384
19,ENSG00000176293.13,58059282,19-58090085-G-A,rs61736354,1,G,A,58090085,30803,57862674,58255890,227411
19,ENSG00000176293.13,58059282,19-58090085-G-C,rs61736354,1,G,C,58090085,30803,57862674,58255890,227411
19,ENSG00000105583.4,12669415,19-12669365-G-A,rs62108388,-1,G,A,12669365,50,12472807,12866023,196558
19,ENSG00000126246.4,35742452,19-35742925-C-T,rs62109455,-1,C,T,35742925,473,35545844,35939060,197081
19,ENSG00000205138.2,35995188,19-36161845-C-A,rs62112152,1,C,A,36161845,166657,35798580,36191796,363265
19,ENSG00000205138.2,35995188,19-36161845-C-T,rs62112152,1,C,T,36161845,166657,35798580,36191796,363265
19,ENSG00000186567.7,44671482,19-44728895-G-T,rs62117160,1,G,T,44728895,57413,44474874,44868090,254021
19,ENSG00000186567.7,44671482,19-44728895-G-A,rs62117160,1,G,A,44728895,57413,44474874,44868090,254021
19,ENSG00000167785.3,8832304,19-8878318-C-A,rs62120169,-1,C,A,8878318,46014,8635696,9028912,242622
19,ENSG00000167785.3,8832304,19-8878318-C-T,rs62120169,-1,C,T,8878318,46014,8635696,9028912,242622
19,ENSG00000011132.6,3761692,19-3890924-C-T,rs62133058,-1,C,T,3890924,129232,3565084,3958300,325840
19,ENSG00000130165.5,11559230,19-11577093-G-A,rs62638747,-1,G,A,11577093,17863,11362622,11755838,214471
19,ENSG00000104805.10,48900312,19-48872419-T-G,rs638050,1,T,G,48872419,27893,48703704,49096920,168715
19,ENSG00000104805.10,48900312,19-48872419-T-C,rs638050,1,T,C,48872419,27893,48703704,49096920,168715
19,ENSG00000104824.8,38849986,19-38990844-T-C,rs649150,-1,T,C,38990844,140858,38653378,39046594,337466
19,ENSG00000213965.2,32691821,19-32692763-C-T,rs6510277,1,C,T,32692763,942,32495213,32888429,197550
19,ENSG00000213965.2,32691821,19-32692763-C-A,rs6510277,1,C,A,32692763,942,32495213,32888429,197550
19,ENSG00000012124.9,35329187,19-35293263-A-G,rs6510476,1,A,G,35293263,35924,35132579,35525795,160684
19,ENSG00000104953.11,2977564,19-2989699-T-C,rs6510730,1,T,C,2989699,12135,2780956,3174172,208743
19,ENSG00000161914.3,11505839,19-11500344-C-T,rs657435,-1,C,T,11500344,5495,11309231,11702447,191113
19,ENSG00000130669.11,39125802,19-39165761-A-G,rs691577,1,A,G,39165761,39959,38929194,39322410,236567
19,ENSG00000153896.10,34773215,19-34846523-T-C,rs71351794,-1,T,C,34846523,73308,34576607,34969823,269916
19,ENSG00000095066.6,12775552,19-12700231-T-G,rs722572,-1,T,G,12700231,75321,12578944,12972160,121287
19,ENSG00000095066.6,12775552,19-12700231-T-C,rs722572,-1,T,C,12700231,75321,12578944,12972160,121287
19,ENSG00000125753.8,45507479,19-45692498-A-C,rs7245708,1,A,C,45692498,185019,45310871,45704087,381627
19,ENSG00000099622.8,1269332,19-1442971-C-T,rs7245774,1,C,T,1442971,173639,1072724,1465940,370247
19,ENSG00000185761.5,1513019,19-1442971-C-T,rs7245774,-1,C,T,1442971,70048,1316411,1709627,126560
19,ENSG00000171105.7,7294414,19-7471335-G-A,rs7245775,-1,G,A,7471335,176921,7097806,7491022,373529
19,ENSG00000181240.8,6433763,19-6451422-G-T,rs7247153,-1,G,T,6451422,17659,6237155,6630371,214267
19,ENSG00000181240.8,6433763,19-6451422-G-A,rs7247153,-1,G,A,6451422,17659,6237155,6630371,214267
19,ENSG00000186818.6,54662995,19-54549255-G-T,rs7247291,1,G,T,54549255,113740,54466387,54859603,82868
19,ENSG00000186818.6,54662995,19-54549255-G-C,rs7247291,1,G,C,54549255,113740,54466387,54859603,82868
19,ENSG00000186818.6,54662995,19-54549255-G-A,rs7247291,1,G,A,54549255,113740,54466387,54859603,82868
19,ENSG00000234465.4,43575801,19-43455962-A-C,rs7248167,1,A,C,43455962,119839,43379193,43772409,76769
19,ENSG00000234465.4,43575801,19-43455962-A-G,rs7248167,1,A,G,43455962,119839,43379193,43772409,76769
19,ENSG00000167378.3,43596134,19-43455962-A-C,rs7248167,-1,A,C,43455962,140172,43399526,43792742,56436
19,ENSG00000167378.3,43596134,19-43455962-A-G,rs7248167,-1,A,G,43455962,140172,43399526,43792742,56436
19,ENSG00000176531.5,43504746,19-43455962-A-C,rs7248167,-1,A,C,43455962,48784,43308138,43701354,147824
19,ENSG00000176531.5,43504746,19-43455962-A-G,rs7248167,-1,A,G,43455962,48784,43308138,43701354,147824
19,ENSG00000175691.6,2944971,19-2923162-A-G,rs7248226,-1,A,G,2923162,21809,2748363,3141579,174799
19,ENSG00000099326.3,58573335,19-58567890-A-G,rs7248800,-1,A,G,58567890,5445,58376727,58769943,191163
19,ENSG00000090674.10,7522624,19-7698159-C-T,rs7249320,1,C,T,7698159,175535,7326016,7719232,372143
19,ENSG00000090674.10,7522624,19-7698159-C-A,rs7249320,1,C,A,7698159,175535,7326016,7719232,372143
19,ENSG00000127526.8,16572415,19-16710755-C-A,rs7250069,-1,C,A,16710755,138340,16375807,16769023,334948
19,ENSG00000127526.8,16572415,19-16710755-C-T,rs7250069,-1,C,T,16710755,138340,16375807,16769023,334948
19,ENSG00000105695.8,35292161,19-35284538-A-G,rs7251432,1,A,G,35284538,7623,35095553,35488769,188985
19,ENSG00000105695.8,35292161,19-35284538-A-T,rs7251432,1,A,T,35284538,7623,35095553,35488769,188985
19,ENSG00000197020.5,21767579,19-21725251-C-T,rs7252798,-1,C,T,21725251,42328,21570971,21964187,154280
19,ENSG00000197020.5,21767579,19-21725251-C-A,rs7252798,-1,C,A,21725251,42328,21570971,21964187,154280
19,ENSG00000105677.5,35545626,19-35519356-G-A,rs7253270,1,G,A,35519356,26270,35349018,35742234,170338
19,ENSG00000007255.5,45178237,19-45177876-G-C,rs7253652,-1,G,C,45177876,361,44981629,45374845,196247
19,ENSG00000182986.7,52897635,19-52904544-C-A,rs7254555,-1,C,A,52904544,6909,52701027,53094243,203517
19,ENSG00000182986.7,52897635,19-52904544-C-T,rs7254555,-1,C,T,52904544,6909,52701027,53094243,203517
19,ENSG00000121406.3,57527356,19-57499274-T-A,rs7255481,1,T,A,57499274,28082,57330748,57723964,168526
19,ENSG00000121406.3,57527356,19-57499274-T-C,rs7255481,1,T,C,57499274,28082,57330748,57723964,168526
19,ENSG00000179922.3,55624566,19-55704073-T-C,rs7255531,-1,T,C,55704073,79507,55427958,55821174,276115
19,ENSG00000179922.3,55624566,19-55704073-T-G,rs7255531,-1,T,G,55704073,79507,55427958,55821174,276115
19,ENSG00000105643.3,18008170,19-18013156-C-T,rs7255589,1,C,T,18013156,4986,17811562,18204778,201594
19,ENSG00000104823.3,38831794,19-38844634-T-C,rs7255774,-1,T,C,38844634,12840,38635186,39028402,209448
19,ENSG00000104972.10,54630484,19-54598418-C-T,rs7255954,1,C,T,54598418,32066,54433876,54827092,164542
19,ENSG00000104972.10,54630484,19-54598418-C-A,rs7255954,1,C,A,54598418,32066,54433876,54827092,164542
19,ENSG00000174837.8,6887579,19-6958123-A-T,rs7256163,1,A,T,6958123,70544,6690971,7084187,267152
19,ENSG00000174837.8,6887579,19-6958123-A-G,rs7256163,1,A,G,6958123,70544,6690971,7084187,267152
19,ENSG00000011243.10,15418988,19-15551388-A-C,rs7256787,-1,A,C,15551388,132400,15222380,15615596,329008
19,ENSG00000011243.10,15418988,19-15551388-A-G,rs7256787,-1,A,G,15551388,132400,15222380,15615596,329008
19,ENSG00000127666.7,4831712,19-4758010-A-G,rs7257877,-1,A,G,4758010,73702,4635104,5028320,122906
19,ENSG00000160113.3,17245919,19-17229591-C-T,rs7258100,-1,C,T,17229591,16328,17049311,17442527,180280
19,ENSG00000125755.11,45863147,19-45853290-T-C,rs7258364,-1,T,C,45853290,9857,45666539,46059755,186751
19,ENSG00000125755.11,45863147,19-45853290-T-A,rs7258364,-1,T,A,45853290,9857,45666539,46059755,186751
19,ENSG00000070423.10,663214,19-728476-G-T,rs7258499,-1,G,T,728476,65262,466606,859822,261870
19,ENSG00000197016.6,56567468,19-56556670-C-T,rs7258886,1,C,T,56556670,10798,56370860,56764076,185810
19,ENSG00000130299.10,17337553,19-17351983-G-A,rs7259703,1,G,A,17351983,14430,17140945,17534161,211038
19,ENSG00000197134.5,22052484,19-22108969-C-A,rs7260331,1,C,A,22108969,56485,21855876,22249092,253093
19,ENSG00000197134.5,22052484,19-22108969-C-T,rs7260331,1,C,T,22108969,56485,21855876,22249092,253093
19,ENSG00000099875.8,2051244,19-2217204-G-A,rs72985483,-1,G,A,2217204,165960,1854636,2247852,362568
19,ENSG00000127540.4,1605462,19-1579618-C-T,rs72989710,-1,C,T,1579618,25844,1408854,1802070,170764
19,ENSG00000181896.6,19668839,19-19547423-C-T,rs73004906,1,C,T,19547423,121416,19472231,19865447,75192
19,ENSG00000181896.6,19668839,19-19547423-C-A,rs73004906,1,C,A,19547423,121416,19472231,19865447,75192
19,ENSG00000130758.2,40191426,19-40195363-A-T,rs73042673,1,A,T,40195363,3937,39994818,40388034,200545
19,ENSG00000130758.2,40191426,19-40195363-A-G,rs73042673,1,A,G,40195363,3937,39994818,40388034,200545
19,ENSG00000130758.2,40191426,19-40195363-A-C,rs73042673,1,A,C,40195363,3937,39994818,40388034,200545
19,ENSG00000187902.6,55443300,19-55478213-G-A,rs73057168,-1,G,A,55478213,34913,55246692,55639908,231521
19,ENSG00000187902.6,55443300,19-55478213-G-T,rs73057168,-1,G,T,55478213,34913,55246692,55639908,231521
19,ENSG00000187902.6,55443300,19-55478213-G-C,rs73057168,-1,G,C,55478213,34913,55246692,55639908,231521
19,ENSG00000178229.6,57320472,19-57433318-C-T,rs73065212,1,C,T,57433318,112846,57123864,57517080,309454
19,ENSG00000105374.4,51372654,19-51542591-G-A,rs73067324,-1,G,A,51542591,169937,51176046,51569262,366545
19,ENSG00000174917.3,5680516,19-5861289-A-G,rs73538632,-1,A,G,5861289,180773,5483908,5877124,377381
19,ENSG00000118160.7,47471893,19-47318117-C-T,rs73554060,-1,C,T,47318117,153776,47275285,47668501,42832
19,ENSG00000167685.8,56141287,19-56193310-C-A,rs73617569,1,C,A,56193310,52023,55944679,56337895,248631
19,ENSG00000130477.9,17688354,19-17602165-C-T,rs73922140,-1,C,T,17602165,86189,17491746,17884962,110419
19,ENSG00000130477.9,17688354,19-17602165-C-A,rs73922140,-1,C,A,17602165,86189,17491746,17884962,110419
19,ENSG00000189013.8,54803611,19-54881501-T-G,rs73932253,1,T,G,54881501,77890,54607003,55000219,274498
19,ENSG00000105193.3,39435949,19-39434416-A-T,rs74712803,-1,A,T,39434416,1533,39239341,39632557,195075
19,ENSG00000105193.3,39435949,19-39434416-A-G,rs74712803,-1,A,G,39434416,1533,39239341,39632557,195075
19,ENSG00000105193.3,39435949,19-39434416-A-C,rs74712803,-1,A,C,39434416,1533,39239341,39632557,195075
19,ENSG00000221923.3,52369923,19-52377746-G-T,rs74760116,1,G,T,52377746,7823,52173315,52566531,204431
19,ENSG00000221923.3,52369923,19-52377746-G-C,rs74760116,1,G,C,52377746,7823,52173315,52566531,204431
19,ENSG00000121413.7,58098231,19-58285848-G-C,rs74771247,-1,G,C,58285848,187617,57901623,58294839,384225
19,ENSG00000132017.5,13952509,19-13849748-T-A,rs7507168,1,T,A,13849748,102761,13755901,14149117,93847
19,ENSG00000132017.5,13952509,19-13849748-T-C,rs7507168,1,T,C,13849748,102761,13755901,14149117,93847
19,ENSG00000176533.7,2702694,19-2675680-T-C,rs75162160,-1,T,C,2675680,27014,2506086,2899302,169594
19,ENSG00000176533.7,2702694,19-2675680-T-G,rs75162160,-1,T,G,2675680,27014,2506086,2899302,169594
19,ENSG00000126247.4,36140066,19-36152793-T-G,rs753420,1,T,G,36152793,12727,35943458,36336674,209335
19,ENSG00000130270.8,1812276,19-1811409-C-T,rs75759084,-1,C,T,1811409,867,1615668,2008884,195741
19,ENSG00000130270.8,1812276,19-1811409-C-G,rs75759084,-1,C,G,1811409,867,1615668,2008884,195741
19,ENSG00000131941.2,33064888,19-32978621-T-G,rs75770523,-1,T,G,32978621,86267,32868280,33261496,110341
19,ENSG00000131941.2,33064888,19-32978621-T-C,rs75770523,-1,T,C,32978621,86267,32868280,33261496,110341
19,ENSG00000213889.5,45498443,19-45509757-A-T,rs758761,1,A,T,45509757,11314,45301835,45695051,207922
19,ENSG00000213889.5,45498443,19-45509757-A-G,rs758761,1,A,G,45509757,11314,45301835,45695051,207922
19,ENSG00000130254.5,5622776,19-5454039-G-A,rs75921881,-1,G,A,5454039,168737,5426168,5819384,27871
19,ENSG00000104812.8,48993309,19-49105783-C-T,rs76688659,-1,C,T,49105783,112474,48796701,49189917,309082
19,ENSG00000171469.6,9621232,19-9642129-G-A,rs76767474,-1,G,A,9642129,20897,9424624,9817840,217505
19,ENSG00000130377.8,6135667,19-6148777-C-T,rs76790614,1,C,T,6148777,13110,5939059,6332275,209718
19,ENSG00000130377.8,6135667,19-6148777-C-A,rs76790614,1,C,A,6148777,13110,5939059,6332275,209718
19,ENSG00000213988.5,20078000,19-20247488-T-C,rs77216541,1,T,C,20247488,169488,19881392,20274608,366096
19,ENSG00000105402.2,47515063,19-47442209-G-A,rs77268107,-1,G,A,47442209,72854,47318455,47711671,123754
19,ENSG00000105248.10,4247080,19-4378830-C-A,rs77425329,1,C,A,4378830,131750,4050472,4443688,328358
19,ENSG00000105668.2,35666516,19-35775463-G-A,rs77750939,1,G,A,35775463,108947,35469908,35863124,305555
19,ENSG00000105472.6,50723364,19-50627238-T-C,rs77757123,1,T,C,50627238,96126,50526756,50919972,100482
19,ENSG00000161277.6,36054285,19-35907512-C-A,rs77782321,-1,C,A,35907512,146773,35857677,36250893,49835
19,ENSG00000167645.11,38315947,19-38195162-C-T,rs78005068,-1,C,T,38195162,120785,38119339,38512555,75823
19,ENSG00000105323.10,41264372,19-41170011-C-A,rs78144186,1,C,A,41170011,94361,41067764,41460980,102247
19,ENSG00000105323.10,41264372,19-41170011-C-T,rs78144186,1,C,T,41170011,94361,41067764,41460980,102247
19,ENSG00000076928.11,41883184,19-41815574-C-T,rs78214518,1,C,T,41815574,67610,41686576,42079792,128998
19,ENSG00000198858.4,913219,19-900951-A-G,rs78580402,-1,A,G,900951,12268,716611,1109827,184340
19,ENSG00000065000.9,2151566,19-2173105-C-T,rs78591932,-1,C,T,2173105,21539,1954958,2348174,218147
19,ENSG00000064607.11,19033517,19-19079965-C-A,rs78696337,-1,C,A,19079965,46448,18836909,19230125,243056
19,ENSG00000064607.11,19033517,19-19079965-C-T,rs78696337,-1,C,T,19079965,46448,18836909,19230125,243056
19,ENSG00000133247.8,55339876,19-55301303-A-C,rs79178882,1,A,C,55301303,38573,55143268,55536484,158035
19,ENSG00000130382.6,6279975,19-6227568-G-A,rs79422852,-1,G,A,6227568,52407,6083367,6476583,144201
19,ENSG00000167733.8,5681027,19-5756634-G-A,rs79696139,1,G,A,5756634,75607,5484419,5877635,272215
19,ENSG00000105612.3,12881449,19-12899706-A-T,rs8012,-1,A,T,12899706,18257,12684841,13078057,214865
19,ENSG00000105612.3,12881449,19-12899706-A-G,rs8012,-1,A,G,12899706,18257,12684841,13078057,214865
19,ENSG00000198258.5,9827918,19-10000389-G-A,rs8102728,1,G,A,10000389,172471,9631310,10024526,369079
19,ENSG00000130312.1,17305872,19-17327833-A-G,rs8102944,1,A,G,17327833,21961,17109264,17502480,218569
19,ENSG00000197019.4,40425992,19-40333757-A-C,rs8103796,-1,A,C,40333757,92235,40229384,40622600,104373
19,ENSG00000197019.4,40425992,19-40333757-A-G,rs8103796,-1,A,G,40333757,92235,40229384,40622600,104373
19,ENSG00000197019.4,40425992,19-40333757-A-T,rs8103796,-1,A,T,40333757,92235,40229384,40622600,104373
19,ENSG00000173809.11,32719753,19-32791430-A-G,rs8104532,1,A,G,32791430,71677,32523145,32916361,268285
19,ENSG00000105376.3,10289952,19-10259457-G-T,rs8104608,1,G,T,10259457,30495,10093344,10486560,166113
19,ENSG00000105376.3,10289952,19-10259457-G-A,rs8104608,1,G,A,10259457,30495,10093344,10486560,166113
19,ENSG00000186272.7,57411161,19-57338184-C-G,rs8105683,1,C,G,57338184,72977,57214553,57607769,123631
19,ENSG00000121410.6,58353492,19-58309722-T-C,rs8105935,-1,T,C,58309722,43770,58156884,58550100,152838
19,ENSG00000104859.9,45039045,19-44898409-A-G,rs8106922,1,A,G,44898409,140636,44842437,45235653,55972
19,ENSG00000105519.5,5914254,19-5903796-G-A,rs8108064,1,G,A,5903796,10458,5717646,6110862,186150
19,ENSG00000105519.5,5914254,19-5903796-G-T,rs8108064,1,G,T,5903796,10458,5717646,6110862,186150
19,ENSG00000189114.5,45178784,19-45219485-G-A,rs8109764,1,G,A,45219485,40701,44982176,45375392,237309
19,ENSG00000105401.1,10403542,19-10447570-T-C,rs8110715,-1,T,C,10447570,44028,10206934,10600150,240636
19,ENSG00000125743.5,45691953,19-45664843-A-G,rs8111428,-1,A,G,45664843,27110,45495345,45888561,169498
19,ENSG00000187994.6,38878275,19-38838877-C-T,rs8111670,-1,C,T,38838877,39398,38681667,39074883,157210
19,ENSG00000132024.11,13906201,19-13912682-T-C,rs8111764,1,T,C,13912682,6481,13709593,14102809,203089
19,ENSG00000197841.7,34734243,19-34644604-T-G,rs8112651,1,T,G,34644604,89639,34537635,34930851,106969
19,ENSG00000229676.2,22634324,19-22641717-T-C,rs8112981,1,T,C,22641717,7393,22437716,22830932,204001
19,ENSG00000180061.4,55325341,19-55322817-G-A,rs8113016,-1,G,A,55322817,2524,55128733,55521949,194084
19,ENSG00000197128.5,57477566,19-57487814-A-T,rs8113039,-1,A,T,57487814,10248,57280958,57674174,206856
19,ENSG00000197128.5,57477566,19-57487814-A-G,rs8113039,-1,A,G,57487814,10248,57280958,57674174,206856
19,ENSG00000197128.5,57477566,19-57487814-A-C,rs8113039,-1,A,C,57487814,10248,57280958,57674174,206856
19,ENSG00000168661.8,34926903,19-34851013-A-T,rs8113147,1,A,T,34851013,75890,34730295,35123511,120718
19,ENSG00000168661.8,34926903,19-34851013-A-G,rs8113147,1,A,G,34851013,75890,34730295,35123511,120718
19,ENSG00000089639.5,19643657,19-19566201-C-G,rs8113221,-1,C,G,19566201,77456,19447049,19840265,119152
19,ENSG00000089639.5,19643657,19-19566201-C-T,rs8113221,-1,C,T,19566201,77456,19447049,19840265,119152
19,ENSG00000099817.6,1095375,19-1088018-A-T,rs8113305,-1,A,T,1088018,7357,898767,1291983,189251
19,ENSG00000099817.6,1095375,19-1088018-A-C,rs8113305,-1,A,C,1088018,7357,898767,1291983,189251
19,ENSG00000228300.7,1275530,19-1245701-G-T,rs8113509,1,G,T,1245701,29829,1078922,1472138,166779
19,ENSG00000228300.7,1275530,19-1245701-G-C,rs8113509,1,G,C,1245701,29829,1078922,1472138,166779
19,ENSG00000228300.7,1275530,19-1245701-G-A,rs8113509,1,G,A,1245701,29829,1078922,1472138,166779
19,ENSG00000130175.4,11435635,19-11450814-T-C,rs8616,1,T,C,11450814,15179,11239027,11632243,211787
19,ENSG00000186230.5,57435325,19-57359773-C-A,rs862710,1,C,A,57359773,75552,57238717,57631933,121056
19,ENSG00000186230.5,57435325,19-57359773-C-T,rs862710,1,C,T,57359773,75552,57238717,57631933,121056
19,ENSG00000130520.3,18323076,19-18374112-G-T,rs888663,-1,G,T,18374112,51036,18126468,18519684,247644
19,ENSG00000131409.6,50568435,19-50514578-G-A,rs889131,-1,G,A,50514578,53857,50371827,50765043,142751
19,ENSG00000123143.7,14433306,19-14563423-C-A,rs891089,1,C,A,14563423,130117,14236698,14629914,326725
19,ENSG00000123143.7,14433306,19-14563423-C-T,rs891089,1,C,T,14563423,130117,14236698,14629914,326725
19,ENSG00000105467.3,48364367,19-48365921-C-T,rs919804,1,C,T,48365921,1554,48167759,48560975,198162
19,ENSG00000182472.3,38744474,19-38742506-A-T,rs936524,-1,A,T,38742506,1968,38547866,38941082,194640
19,ENSG00000182472.3,38744474,19-38742506-A-G,rs936524,-1,A,G,38742506,1968,38547866,38941082,194640
19,ENSG00000197013.4,21505602,19-21594280-G-A,rs939301,1,G,A,21594280,88678,21308994,21702210,285286
19,ENSG00000083814.7,57727624,19-57711583-A-G,rs9438914,-1,A,G,57711583,16041,57531016,57924232,180567
19,ENSG00000196365.5,5720146,19-5707193-T-C,rs945828,-1,T,C,5707193,12953,5523538,5916754,183655
19,ENSG00000196365.5,5720146,19-5707193-T-A,rs945828,-1,T,A,5707193,12953,5523538,5916754,183655
19,ENSG00000010310.3,45668221,19-45697518-C-T,rs9636135,1,C,T,45697518,29297,45471613,45864829,225905
19,ENSG00000196466.5,12401271,19-12438271-C-G,rs9676510,-1,C,G,12438271,37000,12204663,12597879,233608
19,ENSG00000196466.5,12401271,19-12438271-C-T,rs9676510,-1,C,T,12438271,37000,12204663,12597879,233608
19,ENSG00000188505.3,39196964,19-39187438-T-C,rs9676717,1,T,C,39187438,9526,39000356,39393572,187082
19,ENSG00000121417.9,57633168,19-57723547-T-C,rs9676736,1,T,C,57723547,90379,57436560,57829776,286987
19,ENSG00000133246.4,8502640,19-8502591-T-C,rs968502,-1,T,C,8502591,49,8306032,8699248,196559
19,ENSG00000141858.7,14090751,19-14058322-A-G,rs9749255,-1,A,G,14058322,32429,13894143,14287359,164179
19,ENSG00000104804.3,48898744,19-48893480-G-A,rs9941490,-1,G,A,48893480,5264,48702136,49095352,191344
19,ENSG00000105568.11,52190052,19-52184435-G-C,rs997703,1,G,C,52184435,5617,51993444,52386660,190991
19,ENSG00000105568.11,52190052,19-52184435-G-A,rs997703,1,G,A,52184435,5617,51993444,52386660,190991
19,ENSG00000105325.8,3506311,19-3643095-G-C,rs1004323,1,G,C,3643095,136784,3309703,3702919,333392
19,ENSG00000105325.8,3506311,19-3643095-G-A,rs1004323,1,G,A,3643095,136784,3309703,3702919,333392
19,ENSG00000166704.7,58002820,19-58016935-A-C,rs1014767,-1,A,C,58016935,14115,57806212,58199428,210723
19,ENSG00000166704.7,58002820,19-58016935-A-G,rs1014767,-1,A,G,58016935,14115,57806212,58199428,210723
19,ENSG00000105426.8,5340812,19-5336378-C-T,rs1015675,-1,C,T,5336378,4434,5144204,5537420,192174
19,ENSG00000197128.5,57477566,19-57558696-A-C,rs10221464,-1,A,C,57558696,81130,57280958,57674174,277738
19,ENSG00000185869.9,36916291,19-36862889-C-T,rs1035441,-1,C,T,36862889,53402,36719683,37112899,143206
19,ENSG00000185869.9,36916291,19-36862889-C-G,rs1035441,-1,C,G,36862889,53402,36719683,37112899,143206
19,ENSG00000171466.4,9675100,19-9733277-A-G,rs10401263,-1,A,G,9733277,58177,9478492,9871708,254785
19,ENSG00000171466.4,9675100,19-9733277-A-T,rs10401263,-1,A,T,9733277,58177,9478492,9871708,254785
19,ENSG00000105245.4,40690651,19-40686512-C-A,rs10401344,-1,C,A,40686512,4139,40494043,40887259,192469
19,ENSG00000105245.4,40690651,19-40686512-C-T,rs10401344,-1,C,T,40686512,4139,40494043,40887259,192469
19,ENSG00000105245.4,40690651,19-40686512-C-G,rs10401344,-1,C,G,40686512,4139,40494043,40887259,192469
19,ENSG00000104808.3,48933699,19-48933725-G-A,rs10401800,1,G,A,48933725,26,48737091,49130307,196634
19,ENSG00000104808.3,48933699,19-48933725-G-C,rs10401800,1,G,C,48933725,26,48737091,49130307,196634
19,ENSG00000104808.3,48933699,19-48933725-G-T,rs10401800,1,G,T,48933725,26,48737091,49130307,196634
19,ENSG00000189042.7,36687612,19-36669627-T-C,rs10402182,1,T,C,36669627,17985,36491004,36884220,178623
19,ENSG00000189042.7,36687612,19-36669627-T-A,rs10402182,1,T,A,36669627,17985,36491004,36884220,178623
19,ENSG00000125755.11,45863147,19-45810500-G-C,rs10402263,-1,G,C,45810500,52647,45666539,46059755,143961
19,ENSG00000125755.11,45863147,19-45810500-G-A,rs10402263,-1,G,A,45810500,52647,45666539,46059755,143961
19,ENSG00000125755.11,45863147,19-45810500-G-T,rs10402263,-1,G,T,45810500,52647,45666539,46059755,143961
19,ENSG00000161888.5,11155782,19-11146211-T-A,rs10402592,-1,T,A,11146211,9571,10959174,11352390,187037
19,ENSG00000161888.5,11155782,19-11146211-T-G,rs10402592,-1,T,G,11146211,9571,10959174,11352390,187037
19,ENSG00000161888.5,11155782,19-11146211-T-C,rs10402592,-1,T,C,11146211,9571,10959174,11352390,187037
19,ENSG00000105136.13,57487750,19-57593879-G-C,rs10403092,1,G,C,57593879,106129,57291142,57684358,302737
19,ENSG00000105136.13,57487750,19-57593879-G-A,rs10403092,1,G,A,57593879,106129,57291142,57684358,302737
19,ENSG00000197020.5,21767579,19-21803490-C-T,rs10403430,-1,C,T,21803490,35911,21570971,21964187,232519
19,ENSG00000213965.2,32691821,19-32867106-T-C,rs10404771,1,T,C,32867106,175285,32495213,32888429,371893
19,ENSG00000213965.2,32691821,19-32867106-T-G,rs10404771,1,T,G,32867106,175285,32495213,32888429,371893
19,ENSG00000127533.2,16888999,19-16877975-G-A,rs10407613,1,G,A,16877975,11024,16692391,17085607,185584
19,ENSG00000160113.3,17245919,19-17296606-A-G,rs10409801,-1,A,G,17296606,50687,17049311,17442527,247295
19,ENSG00000213999.7,19170263,19-19207349-A-C,rs10412238,-1,A,C,19207349,37086,18973655,19366871,233694
19,ENSG00000213999.7,19170263,19-19207349-A-G,rs10412238,-1,A,G,19207349,37086,18973655,19366871,233694
19,ENSG00000071655.9,1592865,19-1763777-A-C,rs10412454,-1,A,C,1763777,170912,1396257,1789473,367520
19,ENSG00000182310.7,51693330,19-51651652-A-G,rs10412972,1,A,G,51651652,41678,51496722,51889938,154930
19,ENSG00000182310.7,51693330,19-51651652-A-C,rs10412972,1,A,C,51651652,41678,51496722,51889938,154930
19,ENSG00000182310.7,51693330,19-51651652-A-T,rs10412972,1,A,T,51651652,41678,51496722,51889938,154930
19,ENSG00000105146.7,57231023,19-57260515-A-G,rs10413037,1,A,G,57260515,29492,57034415,57427631,226100
19,ENSG00000105146.7,57231023,19-57260515-A-C,rs10413037,1,A,C,57260515,29492,57034415,57427631,226100
19,ENSG00000133243.3,2015714,19-2002391-T-G,rs10413498,-1,T,G,2002391,13323,1819106,2212322,183285
19,ENSG00000133243.3,2015714,19-2002391-T-A,rs10413498,-1,T,A,2002391,13323,1819106,2212322,183285
19,ENSG00000133243.3,2015714,19-2002391-T-C,rs10413498,-1,T,C,2002391,13323,1819106,2212322,183285
19,ENSG00000105640.6,17859910,19-17860442-C-T,rs10413723,1,C,T,17860442,532,17663302,18056518,197140
19,ENSG00000105011.3,14136589,19-14052915-A-G,rs10414047,-1,A,G,14052915,83674,13939981,14333197,112934
19,ENSG00000125656.3,6361531,19-6491865-T-A,rs10414082,1,T,A,6491865,130334,6164923,6558139,326942
19,ENSG00000125656.3,6361531,19-6491865-T-G,rs10414082,1,T,G,6491865,130334,6164923,6558139,326942
19,ENSG00000018869.10,56393534,19-56450042-G-T,rs10415307,-1,G,T,56450042,56508,56196926,56590142,253116
19,ENSG00000018869.10,56393534,19-56450042-G-A,rs10415307,-1,G,A,56450042,56508,56196926,56590142,253116
19,ENSG00000064547.8,19628220,19-19609015-C-G,rs10417097,-1,C,G,19609015,19205,19431612,19824828,177403
19,ENSG00000130511.8,18419398,19-18346153-G-C,rs10421536,1,G,C,18346153,73245,18222790,18616006,123363
19,ENSG00000126243.3,35936374,19-36018287-G-A,rs10421578,1,G,A,36018287,81913,35739766,36132982,278521
19,ENSG00000130005.6,1401542,19-1262979-T-C,rs10422807,-1,T,C,1262979,138563,1204934,1598150,58045
19,ENSG00000170954.6,53132910,19-53145820-A-G,rs10423215,-1,A,G,53145820,12910,52936302,53329518,209518
19,ENSG00000170954.6,53132910,19-53145820-A-C,rs10423215,-1,A,C,53145820,12910,52936302,53329518,209518
19,ENSG00000170954.6,53132910,19-53145820-A-T,rs10423215,-1,A,T,53145820,12910,52936302,53329518,209518
19,ENSG00000197933.6,11738946,19-11782751-T-C,rs10424512,-1,T,C,11782751,43805,11542338,11935554,240413
19,ENSG00000197937.5,53159053,19-53194155-A-C,rs10426161,-1,A,C,53194155,35102,52962445,53355661,231710
19,ENSG00000197937.5,53159053,19-53194155-A-T,rs10426161,-1,A,T,53194155,35102,52962445,53355661,231710
19,ENSG00000083807.4,58511992,19-58581872-T-A,rs10448,-1,T,A,58581872,69880,58315384,58708600,266488
19,ENSG00000083807.4,58511992,19-58581872-T-C,rs10448,-1,T,C,58581872,69880,58315384,58708600,266488
19,ENSG00000125651.7,6393164,19-6494491-T-C,rs1053377,-1,T,C,6494491,101327,6196556,6589772,297935
19,ENSG00000196172.8,23758891,19-23870949-C-T,rs1065019,-1,C,T,23870949,112058,23562283,23955499,308666
19,ENSG00000104885.9,2163933,19-2158749-A-C,rs1074047,1,A,C,2158749,5184,1967325,2360541,191424
19,ENSG00000104885.9,2163933,19-2158749-A-G,rs1074047,1,A,G,2158749,5184,1967325,2360541,191424
19,ENSG00000104885.9,2163933,19-2158749-A-T,rs1074047,1,A,T,2158749,5184,1967325,2360541,191424
19,ENSG00000127220.3,17303425,19-17321868-G-A,rs1079098,-1,G,A,17321868,18443,17106817,17500033,215051
19,ENSG00000221983.2,18571857,19-18652786-T-A,rs10854003,1,T,A,18652786,80929,18375249,18768465,277537
19,ENSG00000221983.2,18571857,19-18652786-T-C,rs10854003,1,T,C,18652786,80929,18375249,18768465,277537
19,ENSG00000221983.2,18571857,19-18652786-T-G,rs10854003,1,T,G,18652786,80929,18375249,18768465,277537
19,ENSG00000037757.8,13764522,19-13748453-C-T,rs109083,1,C,T,13748453,16069,13567914,13961130,180539
19,ENSG00000037757.8,13764522,19-13748453-C-G,rs109083,1,C,G,13748453,16069,13567914,13961130,180539
19,ENSG00000083817.6,57578911,19-57660630-T-G,rs11084514,-1,T,G,57660630,81719,57382303,57775519,278327
19,ENSG00000083817.6,57578911,19-57660630-T-A,rs11084514,-1,T,A,57660630,81719,57382303,57775519,278327
19,ENSG00000083817.6,57578911,19-57660630-T-C,rs11084514,-1,T,C,57660630,81719,57382303,57775519,278327
19,ENSG00000105672.8,35641745,19-35521526-T-C,rs11084819,1,T,C,35521526,120219,35445137,35838353,76389
19,ENSG00000081665.7,19821750,19-19965350-T-C,rs11085286,-1,T,C,19965350,143600,19625142,20018358,340208
19,ENSG00000081665.7,19821750,19-19965350-T-A,rs11085286,-1,T,A,19965350,143600,19625142,20018358,340208
19,ENSG00000160961.6,14690048,19-14690354-C-T,rs11085906,1,C,T,14690354,306,14493440,14886656,196914
19,ENSG00000104980.2,7943666,19-7750804-G-T,rs111296792,-1,G,T,7750804,192862,7747058,8140274,3746
19,ENSG00000104980.2,7943666,19-7750804-G-A,rs111296792,-1,G,A,7750804,192862,7747058,8140274,3746
19,ENSG00000181035.8,19063994,19-19142584-G-T,rs111620326,1,G,T,19142584,78590,18867386,19260602,275198
19,ENSG00000181035.8,19063994,19-19142584-G-A,rs111620326,1,G,A,19142584,78590,18867386,19260602,275198
19,ENSG00000105072.3,16496394,19-16339063-C-A,rs111776577,1,C,A,16339063,157331,16299786,16693002,39277
19,ENSG00000099326.3,58573335,19-58446205-G-A,rs112807223,-1,G,A,58446205,127130,58376727,58769943,69478
19,ENSG00000089639.5,19643657,19-19651867-C-T,rs113428937,-1,C,T,19651867,8210,19447049,19840265,204818
19,ENSG00000170608.1,45864326,19-45765938-C-T,rs114060947,1,C,T,45765938,98388,45667718,46060934,98220
19,ENSG00000105341.11,41439912,19-41333933-G-A,rs11466353,-1,G,A,41333933,105979,41243304,41636520,90629
19,ENSG00000105341.11,41439912,19-41333933-G-T,rs11466353,-1,G,T,41333933,105979,41243304,41636520,90629
19,ENSG00000167637.11,43827321,19-43798914-C-T,rs11547806,1,C,T,43798914,28407,43630713,44023929,168201
19,ENSG00000167637.11,43827321,19-43798914-C-G,rs11547806,1,C,G,43798914,28407,43630713,44023929,168201
19,ENSG00000125734.7,6737580,19-6702444-G-C,rs11569450,-1,G,C,6702444,35136,6540972,6934188,161472
19,ENSG00000125734.7,6737580,19-6702444-G-A,rs11569450,-1,G,A,6702444,35136,6540972,6934188,161472
19,ENSG00000130479.5,17719480,19-17681173-C-A,rs116035892,1,C,A,17681173,38307,17522872,17916088,158301
19,ENSG00000167733.8,5681027,19-5829581-A-G,rs11666494,1,A,G,5829581,148554,5484419,5877635,345162
19,ENSG00000130725.2,58558611,19-58402864-A-T,rs11666928,-1,A,T,58402864,155747,58362003,58755219,40861
19,ENSG00000130725.2,58558611,19-58402864-A-G,rs11666928,-1,A,G,58402864,155747,58362003,58755219,40861
19,ENSG00000160392.8,40348397,19-40335973-G-A,rs11668006,-1,G,A,40335973,12424,40151789,40545005,184184
19,ENSG00000011132.6,3761692,19-3757411-C-T,rs11668141,-1,C,T,3757411,4281,3565084,3958300,192327
19,ENSG00000011132.6,3761692,19-3757411-C-A,rs11668141,-1,C,A,3757411,4281,3565084,3958300,192327
19,ENSG00000011132.6,3761692,19-3757411-C-G,rs11668141,-1,C,G,3757411,4281,3565084,3958300,192327
19,ENSG00000129355.5,10568979,19-10505627-T-A,rs11668429,-1,T,A,10505627,63352,10372371,10765587,133256
19,ENSG00000129355.5,10568979,19-10505627-T-G,rs11668429,-1,T,G,10505627,63352,10372371,10765587,133256
19,ENSG00000129355.5,10568979,19-10505627-T-C,rs11668429,-1,T,C,10505627,63352,10372371,10765587,133256
19,ENSG00000105607.6,12891160,19-12965372-T-G,rs11668444,1,T,G,12965372,74212,12694552,13087768,270820
19,ENSG00000244482.3,54242791,19-54245208-C-T,rs11668526,-1,C,T,54245208,2417,54046183,54439399,199025
19,ENSG00000244482.3,54242791,19-54245208-C-G,rs11668526,-1,C,G,54245208,2417,54046183,54439399,199025
19,ENSG00000168661.8,34926903,19-34917975-G-A,rs11668916,1,G,A,34917975,8928,34730295,35123511,187680
19,ENSG00000168661.8,34926903,19-34917975-G-C,rs11668916,1,G,C,34917975,8928,34730295,35123511,187680
19,ENSG00000178078.5,4338827,19-4304501-A-C,rs11671916,-1,A,C,4304501,34326,4142219,4535435,162282
19,ENSG00000178078.5,4338827,19-4304501-A-G,rs11671916,-1,A,G,4304501,34326,4142219,4535435,162282
19,ENSG00000178078.5,4338827,19-4304501-A-T,rs11671916,-1,A,T,4304501,34326,4142219,4535435,162282
19,ENSG00000127666.7,4831712,19-4949254-A-G,rs11672626,-1,A,G,4949254,117542,4635104,5028320,314150
19,ENSG00000127666.7,4831712,19-4949254-A-C,rs11672626,-1,A,C,4949254,117542,4635104,5028320,314150
19,ENSG00000213638.2,1905399,19-1750448-T-A,rs11673055,1,T,A,1750448,154951,1708791,2102007,41657
19,ENSG00000213638.2,1905399,19-1750448-T-G,rs11673055,1,T,G,1750448,154951,1708791,2102007,41657
19,ENSG00000127511.4,16829398,19-16972112-C-T,rs116866928,1,C,T,16972112,142714,16632790,17026006,339322
19,ENSG00000127511.4,16829398,19-16972112-C-A,rs116866928,1,C,A,16972112,142714,16632790,17026006,339322
19,ENSG00000196417.6,53395149,19-53503380-G-A,rs116915840,1,G,A,53503380,108231,53198541,53591757,304839
19,ENSG00000196417.6,53395149,19-53503380-G-T,rs116915840,1,G,T,53503380,108231,53198541,53591757,304839
19,ENSG00000167674.7,4472297,19-4547282-A-G,rs116974600,1,A,G,4547282,74985,4275689,4668905,271593
19,ENSG00000077348.3,41397359,19-41360047-G-A,rs117031209,-1,G,A,41360047,37312,41200751,41593967,159296
19,ENSG00000131409.6,50568435,19-50684017-C-T,rs117120439,-1,C,T,50684017,115582,50371827,50765043,312190
19,ENSG00000213020.2,52735044,19-52734098-C-T,rs117169408,-1,C,T,52734098,946,52538436,52931652,195662
19,ENSG00000125652.2,6372794,19-6396284-G-T,rs117230333,1,G,T,6396284,23490,6176186,6569402,220098
19,ENSG00000125652.2,6372794,19-6396284-G-A,rs117230333,1,G,A,6396284,23490,6176186,6569402,220098
19,ENSG00000142552.2,49528003,19-49462431-G-A,rs117605916,1,G,A,49462431,65572,49331395,49724611,131036
19,ENSG00000142552.2,49528003,19-49462431-G-C,rs117605916,1,G,C,49462431,65572,49331395,49724611,131036
19,ENSG00000105675.2,35563658,19-35461163-A-G,rs117731902,-1,A,G,35461163,102495,35367050,35760266,94113
19,ENSG00000069399.7,44748708,19-44819059-C-T,rs117737673,1,C,T,44819059,70351,44552100,44945316,266959
19,ENSG00000116014.3,917333,19-1021520-T-C,rs118187422,1,T,C,1021520,104187,720725,1113941,300795
19,ENSG00000116014.3,917333,19-1021520-T-A,rs118187422,1,T,A,1021520,104187,720725,1113941,300795
19,ENSG00000116014.3,917333,19-1021520-T-G,rs118187422,1,T,G,1021520,104187,720725,1113941,300795
19,ENSG00000180855.10,12441021,19-12515647-T-C,rs11878413,-1,T,C,12515647,74626,12244413,12637629,271234
19,ENSG00000105671.6,18919715,19-18764758-C-T,rs11879043,1,C,T,18764758,154957,18723107,19116323,41651
19,ENSG00000133275.9,1941172,19-1961894-C-T,rs11879858,1,C,T,1961894,20722,1744564,2137780,217330
19,ENSG00000133275.9,1941172,19-1961894-C-G,rs11879858,1,C,G,1961894,20722,1744564,2137780,217330
19,ENSG00000214456.3,4535224,19-4636934-C-T,rs11880374,-1,C,T,4636934,101710,4338616,4731832,298318
19,ENSG00000214456.3,4535224,19-4636934-C-G,rs11880374,-1,C,G,4636934,101710,4338616,4731832,298318
19,ENSG00000214456.3,4535224,19-4636934-C-A,rs11880374,-1,C,A,4636934,101710,4338616,4731832,298318
19,ENSG00000127616.9,10961030,19-10881151-G-A,rs11880628,1,G,A,10881151,79879,10764422,11157638,116729
19,ENSG00000171649.5,57584145,19-57660933-C-A,rs11881170,1,C,A,57660933,76788,57387537,57780753,273396
19,ENSG00000171649.5,57584145,19-57660933-C-G,rs11881170,1,C,G,57660933,76788,57387537,57780753,273396
19,ENSG00000188505.3,39196964,19-39209665-T-A,rs11882959,1,T,A,39209665,12701,39000356,39393572,209309
19,ENSG00000188505.3,39196964,19-39209665-T-G,rs11882959,1,T,G,39209665,12701,39000356,39393572,209309
19,ENSG00000126458.2,49640143,19-49632149-T-G,rs11883023,-1,T,G,49632149,7994,49443535,49836751,188614
19,ENSG00000180257.8,52962881,19-52962729-G-A,rs11883049,-1,G,A,52962729,152,52766273,53159489,196456
19,ENSG00000167619.6,42313309,19-42366721-A-C,rs1206033,1,A,C,42366721,53412,42116701,42509917,250020
19,ENSG00000090013.4,40465745,19-40433758-T-C,rs12459578,-1,T,C,40433758,31987,40269137,40662353,164621
19,ENSG00000196365.5,5720146,19-5555087-A-C,rs12461806,-1,A,C,5555087,165059,5523538,5916754,31549
19,ENSG00000196365.5,5720146,19-5555087-A-T,rs12461806,-1,A,T,5555087,165059,5523538,5916754,31549
19,ENSG00000196365.5,5720146,19-5555087-A-G,rs12461806,-1,A,G,5555087,165059,5523538,5916754,31549
19,ENSG00000160877.4,13118264,19-13220929-T-C,rs12461897,1,T,C,13220929,102665,12921656,13314872,299273
19,ENSG00000105329.4,41353922,19-41226518-T-G,rs12462203,-1,T,G,41226518,127404,41157314,41550530,69204
19,ENSG00000105329.4,41353922,19-41226518-T-C,rs12462203,-1,T,C,41226518,127404,41157314,41550530,69204
19,ENSG00000256683.1,51986840,19-51818851-G-A,rs12463097,-1,G,A,51818851,167989,51790232,52183448,28619
19,ENSG00000256683.1,51986840,19-51818851-G-C,rs12463097,-1,G,C,51818851,167989,51790232,52183448,28619
19,ENSG00000141934.3,291403,19-418556-G-A,rs12609625,-1,G,A,418556,127153,94795,488011,323761
19,ENSG00000181029.6,7680833,19-7686089-G-A,rs12610479,1,G,A,7686089,5256,7484225,7877441,201864
19,ENSG00000171777.9,38426219,19-38234776-T-C,rs12610482,-1,T,C,38234776,191443,38229611,38622827,5165
19,ENSG00000063176.9,48619506,19-48749732-C-T,rs12611028,1,C,T,48749732,130226,48422898,48816114,326834
19,ENSG00000105516.5,48637379,19-48749732-C-T,rs12611028,-1,C,T,48749732,112353,48440771,48833987,308961
19,ENSG00000174586.4,58362751,19-58377741-G-T,rs12611047,-1,G,T,58377741,14990,58166143,58559359,211598
19,ENSG00000105677.5,35545626,19-35399303-G-A,rs12611325,1,G,A,35399303,146323,35349018,35742234,50285
19,ENSG00000090339.3,10271120,19-10359299-A-G,rs12720356,1,A,G,10359299,88179,10074512,10467728,284787
19,ENSG00000090339.3,10271120,19-10359299-A-C,rs12720356,1,A,C,10359299,88179,10074512,10467728,284787
19,ENSG00000169136.3,49929205,19-49901682-T-G,rs1290754,1,T,G,49901682,27523,49732597,50125813,169085
19,ENSG00000104951.10,49896887,19-49901682-T-G,rs1290754,-1,T,G,49901682,4795,49700279,50093495,201403
19,ENSG00000105321.6,47256525,19-47200561-C-T,rs12973505,1,C,T,47200561,55964,47059917,47453133,140644
19,ENSG00000160013.3,46625089,19-46634202-C-T,rs12974613,-1,C,T,46634202,9113,46428481,46821697,205721
19,ENSG00000182472.3,38744474,19-38628854-A-C,rs12976749,-1,A,C,38628854,115620,38547866,38941082,80988
19,ENSG00000196605.2,9768617,19-9746309-A-T,rs12976807,-1,A,T,9746309,22308,9572009,9965225,174300
19,ENSG00000196605.2,9768617,19-9746309-A-C,rs12976807,-1,A,C,9746309,22308,9572009,9965225,174300
19,ENSG00000196605.2,9768617,19-9746309-A-G,rs12976807,-1,A,G,9746309,22308,9572009,9965225,174300
19,ENSG00000105404.5,41959321,19-41963455-C-T,rs12977527,-1,C,T,41963455,4134,41762713,42155929,200742
19,ENSG00000105404.5,41959321,19-41963455-C-A,rs12977527,-1,C,A,41963455,4134,41762713,42155929,200742
19,ENSG00000105404.5,41959321,19-41963455-C-G,rs12977527,-1,C,G,41963455,4134,41762713,42155929,200742
19,ENSG00000196867.1,56538948,19-56399620-T-C,rs12980022,1,T,C,56399620,139328,56342340,56735556,57280
19,ENSG00000197928.4,53254873,19-53431384-G-A,rs12981260,-1,G,A,53431384,176511,53058265,53451481,373119
19,ENSG00000072958.3,16197911,19-16244324-A-G,rs12982021,1,A,G,16244324,46413,16001303,16394519,243021
19,ENSG00000105323.10,41264372,19-41264985-A-G,rs12983339,1,A,G,41264985,613,41067764,41460980,197221
19,ENSG00000105323.10,41264372,19-41264985-A-T,rs12983339,1,A,T,41264985,613,41067764,41460980,197221
19,ENSG00000065268.3,984345,19-1010023-C-T,rs13627,1,C,T,1010023,25678,787737,1180953,222286
19,ENSG00000105193.3,39435949,19-39268683-C-G,rs142031126,-1,C,G,39268683,167266,39239341,39632557,29342
19,ENSG00000161551.7,51887951,19-51887473-C-A,rs1433082,-1,C,A,51887473,478,51691343,52084559,196130
19,ENSG00000129347.14,10566010,19-10568166-T-C,rs1465701,-1,T,C,10568166,2156,10369402,10762618,198764
19,ENSG00000161558.5,48363940,19-48279986-C-G,rs1504520,-1,C,G,48279986,83954,48167332,48560548,112654
19,ENSG00000161558.5,48363940,19-48279986-C-T,rs1504520,-1,C,T,48279986,83954,48167332,48560548,112654
19,ENSG00000181894.9,58150789,19-58164527-C-G,rs157362,-1,C,G,58164527,13738,57954181,58347397,210346
19,ENSG00000104884.9,45370573,19-45368348-T-A,rs1618536,-1,T,A,45368348,2225,45173965,45567181,194383
19,ENSG00000104884.9,45370573,19-45368348-T-C,rs1618536,-1,T,C,45368348,2225,45173965,45567181,194383
19,ENSG00000076924.6,7629545,19-7597643-T-C,rs1644759,-1,T,C,7597643,31902,7432937,7826153,164706
19,ENSG00000160439.9,55063148,19-54994189-C-T,rs1654504,-1,C,T,54994189,68959,54866540,55259756,127649
19,ENSG00000189164.8,37371099,19-37243986-C-A,rs1657508,1,C,A,37243986,127113,37174491,37567707,69495
19,ENSG00000189164.8,37371099,19-37243986-C-T,rs1657508,1,C,T,37243986,127113,37174491,37567707,69495
19,ENSG00000076944.7,7637110,19-7610991-T-C,rs1674034,1,T,C,7610991,26119,7440502,7833718,170489
19,ENSG00000130158.8,11262524,19-11416089-T-A,rs167479,-1,T,A,11416089,153565,11065916,11459132,350173
19,ENSG00000130158.8,11262524,19-11416089-T-G,rs167479,-1,T,G,11416089,153565,11065916,11459132,350173
19,ENSG00000130158.8,11262524,19-11416089-T-C,rs167479,-1,T,C,11416089,153565,11065916,11459132,350173
19,ENSG00000175221.7,893187,19-859214-C-A,rs1683564,-1,C,A,859214,33973,696579,1089795,162635
19,ENSG00000089327.8,35154735,19-35203870-A-G,rs1687990,1,A,G,35203870,49135,34958127,35351343,245743
19,ENSG00000105173.8,29811991,19-29974636-T-C,rs169349,1,T,C,29974636,162645,29615383,30008599,359253
19,ENSG00000152454.2,57947706,19-57826845-C-G,rs16960555,-1,C,G,57826845,120861,57751098,58144314,75747
19,ENSG00000152454.2,57947706,19-57826845-C-T,rs16960555,-1,C,T,57826845,120861,57751098,58144314,75747
19,ENSG00000152454.2,57947706,19-57826845-C-A,rs16960555,-1,C,A,57826845,120861,57751098,58144314,75747
19,ENSG00000169021.3,29213151,19-29396850-A-G,rs16962831,-1,A,G,29396850,183699,29016543,29409759,380307
19,ENSG00000169021.3,29213151,19-29396850-A-T,rs16962831,-1,A,T,29396850,183699,29016543,29409759,380307
19,ENSG00000131944.4,32972242,19-32922053-T-C,rs16967583,1,T,C,32922053,50189,32775634,33168850,146419
19,ENSG00000076650.1,33081181,19-33047391-C-T,rs16967749,1,C,T,33047391,33790,32884573,33277789,162818
19,ENSG00000076650.1,33081181,19-33047391-C-G,rs16967749,1,C,G,33047391,33790,32884573,33277789,162818
19,ENSG00000126249.1,34404399,19-34549416-T-C,rs16969466,1,T,C,34549416,145017,34207791,34601007,341625
19,ENSG00000205155.1,35745651,19-35726432-C-T,rs16970648,1,C,T,35726432,19219,35549043,35942259,177389
19,ENSG00000132003.4,13795443,19-13779391-A-G,rs16979344,1,A,G,13779391,16052,13598835,13992051,180556
19,ENSG00000204673.5,49877355,19-49825179-A-T,rs16981464,-1,A,T,49825179,52176,49680747,50073963,144432
19,ENSG00000204673.5,49877355,19-49825179-A-G,rs16981464,-1,A,G,49825179,52176,49680747,50073963,144432
19,ENSG00000204673.5,49877355,19-49825179-A-C,rs16981464,-1,A,C,49825179,52176,49680747,50073963,144432
19,ENSG00000105443.8,48469369,19-48530338-A-G,rs16982125,1,A,G,48530338,60969,48272761,48665977,257577
19,ENSG00000130520.3,18323076,19-18199868-G-C,rs16995485,-1,G,C,18199868,123208,18126468,18519684,73400
19,ENSG00000242852.2,12484816,19-12314455-T-C,rs17001926,-1,T,C,12314455,170361,12288208,12681424,26247
19,ENSG00000242852.2,12484816,19-12314455-T-A,rs17001926,-1,T,A,12314455,170361,12288208,12681424,26247
19,ENSG00000074842.2,4670342,19-4796694-C-T,rs17262997,-1,C,T,4796694,126352,4473734,4866950,322960
19,ENSG00000073008.8,44643910,19-44536461-G-A,rs1727738,1,G,A,44536461,107449,44447302,44840518,89159
19,ENSG00000239998.1,54573790,19-54415008-G-A,rs17516383,1,G,A,54415008,158782,54377182,54770398,37826
19,ENSG00000130299.10,17337553,19-17173636-T-C,rs17534314,1,T,C,17173636,163917,17140945,17534161,32691
19,ENSG00000115266.6,1450121,19-1539268-C-T,rs17604651,1,C,T,1539268,89147,1253513,1646729,285755
19,ENSG00000125733.10,6739680,19-6722033-G-A,rs17626094,1,G,A,6722033,17647,6543072,6936288,178961
19,ENSG00000125733.10,6739680,19-6722033-G-C,rs17626094,1,G,C,6722033,17647,6543072,6936288,178961
19,ENSG00000153879.2,33373709,19-33232799-T-G,rs17694094,1,T,G,33232799,140910,33177101,33570317,55698
19,ENSG00000198093.5,51905017,19-52036028-C-T,rs17696172,-1,C,T,52036028,131011,51708409,52101625,327619
19,ENSG00000153896.10,34773215,19-34757228-C-T,rs17718397,-1,C,T,34757228,15987,34576607,34969823,180621
19,ENSG00000089335.14,34677678,19-34842272-C-T,rs17775427,1,C,T,34842272,164594,34481070,34874286,361202
19,ENSG00000262874.1,51390591,19-51397030-G-C,rs17802282,-1,G,C,51397030,6439,51193983,51587199,203047
19,ENSG00000262874.1,51390591,19-51397030-G-A,rs17802282,-1,G,A,51397030,6439,51193983,51587199,203047
19,ENSG00000142453.6,10871553,19-10948504-C-T,rs17842117,1,C,T,10948504,76951,10674945,11068161,273559
19,ENSG00000129932.2,3500674,19-3481580-T-C,rs1860192,-1,T,C,3481580,19094,3304066,3697282,177514
19,ENSG00000104953.11,2977564,19-2863879-G-C,rs1883037,1,G,C,2863879,113685,2780956,3174172,82923
19,ENSG00000104953.11,2977564,19-2863879-G-T,rs1883037,1,G,T,2863879,113685,2780956,3174172,82923
19,ENSG00000104953.11,2977564,19-2863879-G-A,rs1883037,1,G,A,2863879,113685,2780956,3174172,82923
19,ENSG00000178093.8,19515548,19-19333177-T-C,rs2011503,-1,T,C,19333177,182371,19318940,19712156,14237
19,ENSG00000178093.8,19515548,19-19333177-T-G,rs2011503,-1,T,G,19333177,182371,19318940,19712156,14237
19,ENSG00000186115.5,15898074,19-15747910-C-G,rs2040811,-1,C,G,15747910,150164,15701466,16094682,46444
19,ENSG00000186115.5,15898074,19-15747910-C-A,rs2040811,-1,C,A,15747910,150164,15701466,16094682,46444
19,ENSG00000186115.5,15898074,19-15747910-C-T,rs2040811,-1,C,T,15747910,150164,15701466,16094682,46444
19,ENSG00000178229.6,57320472,19-57291456-G-A,rs2041110,1,G,A,57291456,29016,57123864,57517080,167592
19,ENSG00000196466.5,12401271,19-12478360-G-T,rs2042297,-1,G,T,12478360,77089,12204663,12597879,273697
19,ENSG00000072954.1,16661139,19-16493866-T-C,rs2059155,1,T,C,16493866,167273,16464531,16857747,29335
19,ENSG00000072954.1,16661139,19-16493866-T-A,rs2059155,1,T,A,16493866,167273,16464531,16857747,29335
19,ENSG00000072954.1,16661139,19-16493866-T-G,rs2059155,1,T,G,16493866,167273,16464531,16857747,29335
19,ENSG00000104969.4,2783273,19-2785378-T-C,rs2071015,-1,T,C,2785378,2105,2586665,2979881,198713
19,ENSG00000099821.6,633537,19-619913-T-A,rs2074548,-1,T,A,619913,13624,436929,830145,182984
19,ENSG00000099821.6,633537,19-619913-T-C,rs2074548,-1,T,C,619913,13624,436929,830145,182984
19,ENSG00000099821.6,633537,19-619913-T-G,rs2074548,-1,T,G,619913,13624,436929,830145,182984
19,ENSG00000099875.8,2051244,19-2199352-T-C,rs2074554,-1,T,C,2199352,148108,1854636,2247852,344716
19,ENSG00000185761.5,1513019,19-1615797-G-T,rs2074888,-1,G,T,1615797,102778,1316411,1709627,299386
19,ENSG00000185761.5,1513019,19-1615797-G-A,rs2074888,-1,G,A,1615797,102778,1316411,1709627,299386
19,ENSG00000167642.6,38264573,19-38381695-C-A,rs2074981,1,C,A,38381695,117122,38067965,38461181,313730
19,ENSG00000198858.4,913219,19-967584-T-C,rs2098019,-1,T,C,967584,54365,716611,1109827,250973
19,ENSG00000198858.4,913219,19-967584-T-A,rs2098019,-1,T,A,967584,54365,716611,1109827,250973
19,ENSG00000160014.11,46601330,19-46565124-G-T,rs2099362,1,G,T,46565124,36206,46404722,46797938,160402
19,ENSG00000160014.11,46601330,19-46565124-G-A,rs2099362,1,G,A,46565124,36206,46404722,46797938,160402
19,ENSG00000160014.11,46601330,19-46565124-G-C,rs2099362,1,G,C,46565124,36206,46404722,46797938,160402
19,ENSG00000197619.7,52008211,19-51837473-T-C,rs2109657,-1,T,C,51837473,170738,51811603,52204819,25870
19,ENSG00000197619.7,52008211,19-51837473-T-G,rs2109657,-1,T,G,51837473,170738,51811603,52204819,25870
19,ENSG00000180089.3,55228763,19-55361223-C-T,rs2124920,-1,C,T,55361223,132460,55032155,55425371,329068
19,ENSG00000171017.5,7888510,19-7698362-G-A,rs2228137,1,G,A,7698362,190148,7691902,8085118,6460
19,ENSG00000171017.5,7888510,19-7698362-G-C,rs2228137,1,G,C,7698362,190148,7691902,8085118,6460
19,ENSG00000142530.4,50476848,19-50406508-C-T,rs2230245,-1,C,T,50406508,70340,50280240,50673456,126268
19,ENSG00000083828.8,57769676,19-57719563-C-T,rs2239985,1,C,T,57719563,50113,57573068,57966284,146495
19,ENSG00000083828.8,57769676,19-57719563-C-A,rs2239985,1,C,A,57719563,50113,57573068,57966284,146495
19,ENSG00000104899.2,2249323,19-2201899-G-T,rs2240130,1,G,T,2201899,47424,2052715,2445931,149184
19,ENSG00000104899.2,2249323,19-2201899-G-A,rs2240130,1,G,A,2201899,47424,2052715,2445931,149184
19,ENSG00000141933.6,507497,19-405929-T-C,rs2241407,1,T,C,405929,101568,310889,704105,95040
19,ENSG00000141933.6,507497,19-405929-T-G,rs2241407,1,T,G,405929,101568,310889,704105,95040
19,ENSG00000086544.1,40717112,19-40749595-C-G,rs2254343,1,C,G,40749595,32483,40520504,40913720,229091
19,ENSG00000086544.1,40717112,19-40749595-C-T,rs2254343,1,C,T,40749595,32483,40520504,40913720,229091
19,ENSG00000086544.1,40717112,19-40749595-C-A,rs2254343,1,C,A,40749595,32483,40520504,40913720,229091
19,ENSG00000039650.4,49867576,19-49866809-C-T,rs2257103,-1,C,T,49866809,767,49670968,50064184,195841
19,ENSG00000121417.9,57633168,19-57614276-A-G,rs2269818,1,A,G,57614276,18892,57436560,57829776,177716
19,ENSG00000121417.9,57633168,19-57614276-A-C,rs2269818,1,A,C,57614276,18892,57436560,57829776,177716
19,ENSG00000104870.6,49512661,19-49487409-A-C,rs2271953,1,A,C,49487409,25252,49316053,49709269,171356
19,ENSG00000104870.6,49512661,19-49487409-A-T,rs2271953,1,A,T,49487409,25252,49316053,49709269,171356
19,ENSG00000104870.6,49512661,19-49487409-A-G,rs2271953,1,A,G,49487409,25252,49316053,49709269,171356
19,ENSG00000121289.11,32971958,19-32918507-G-C,rs2278404,-1,G,C,32918507,53451,32775350,33168566,143157
19,ENSG00000121289.11,32971958,19-32918507-G-T,rs2278404,-1,G,T,32918507,53451,32775350,33168566,143157
19,ENSG00000131849.8,58440153,19-58499452-G-T,rs2278497,-1,G,T,58499452,59299,58243545,58636761,255907
19,ENSG00000131849.8,58440153,19-58499452-G-C,rs2278497,-1,G,C,58499452,59299,58243545,58636761,255907
19,ENSG00000105656.4,18522070,19-18595694-G-A,rs2283617,-1,G,A,18595694,73624,18325462,18718678,270232
19,ENSG00000105656.4,18522070,19-18595694-G-C,rs2283617,-1,G,C,18595694,73624,18325462,18718678,270232
19,ENSG00000167378.3,43596134,19-43658909-T-C,rs2283628,-1,T,C,43658909,62775,43399526,43792742,259383
19,ENSG00000250067.3,19528911,19-19652826-C-T,rs2288865,1,C,T,19652826,123915,19332303,19725519,320523
19,ENSG00000250067.3,19528911,19-19652826-C-G,rs2288865,1,C,G,19652826,123915,19332303,19725519,320523
19,ENSG00000181240.8,6433763,19-6458229-G-C,rs2289784,-1,G,C,6458229,24466,6237155,6630371,221074
19,ENSG00000181240.8,6433763,19-6458229-G-T,rs2289784,-1,G,T,6458229,24466,6237155,6630371,221074
19,ENSG00000105479.10,48321971,19-48296459-A-G,rs2292112,-1,A,G,48296459,25512,48125363,48518579,171096
19,ENSG00000105668.2,35666516,19-35551305-C-G,rs2301617,1,C,G,35551305,115211,35469908,35863124,81397
19,ENSG00000105668.2,35666516,19-35551305-C-A,rs2301617,1,C,A,35551305,115211,35469908,35863124,81397
19,ENSG00000105668.2,35666516,19-35551305-C-T,rs2301617,1,C,T,35551305,115211,35469908,35863124,81397
19,ENSG00000063244.6,55655035,19-55461583-T-C,rs2303088,1,T,C,55461583,193452,55458427,55851643,3156
19,ENSG00000063244.6,55655035,19-55461583-T-G,rs2303088,1,T,G,55461583,193452,55458427,55851643,3156
19,ENSG00000129911.3,1863579,19-1817867-C-T,rs2304612,-1,C,T,1817867,45712,1666971,2060187,150896
19,ENSG00000095752.1,55370463,19-55347858-G-A,rs2305785,-1,G,A,55347858,22605,55173855,55567071,174003
19,ENSG00000126246.4,35742452,19-35758620-G-A,rs231237,-1,G,A,35758620,16168,35545844,35939060,212776
19,ENSG00000161618.4,49453225,19-49511720-G-A,rs2335534,1,G,A,49511720,58495,49256617,49649833,255103
19,ENSG00000011422.6,43670169,19-43848513-T-C,rs2356437,-1,T,C,43848513,178344,43473561,43866777,374952
19,ENSG00000104972.10,54630484,19-54600320-T-C,rs2363863,1,T,C,54600320,30164,54433876,54827092,166444
19,ENSG00000104972.10,54630484,19-54600320-T-G,rs2363863,1,T,G,54600320,30164,54433876,54827092,166444
19,ENSG00000104972.10,54630484,19-54600320-T-A,rs2363863,1,T,A,54600320,30164,54433876,54827092,166444
19,ENSG00000248099.2,17821519,19-17823209-G-T,rs2382987,-1,G,T,17823209,1690,17624911,18018127,198298
19,ENSG00000248099.2,17821519,19-17823209-G-A,rs2382987,-1,G,A,17823209,1690,17624911,18018127,198298
19,ENSG00000248099.2,17821519,19-17823209-G-C,rs2382987,-1,G,C,17823209,1690,17624911,18018127,198298
19,ENSG00000105726.11,19663676,19-19738888-G-A,rs247767,-1,G,A,19738888,75212,19467068,19860284,271820
19,ENSG00000105726.11,19663676,19-19738888-G-C,rs247767,-1,G,C,19738888,75212,19467068,19860284,271820
19,ENSG00000105708.7,19733112,19-19737995-C-A,rs247770,-1,C,A,19737995,4883,19536504,19929720,201491
19,ENSG00000188305.2,2282175,19-2275080-A-C,rs2523178,-1,A,C,2275080,7095,2085567,2478783,189513
19,ENSG00000188305.2,2282175,19-2275080-A-T,rs2523178,-1,A,T,2275080,7095,2085567,2478783,189513
19,ENSG00000188305.2,2282175,19-2275080-A-G,rs2523178,-1,A,G,2275080,7095,2085567,2478783,189513
19,ENSG00000176472.5,43533188,19-43521049-T-G,rs2599454,1,T,G,43521049,12139,43336580,43729796,184469
19,ENSG00000176472.5,43533188,19-43521049-T-A,rs2599454,1,T,A,43521049,12139,43336580,43729796,184469
19,ENSG00000176472.5,43533188,19-43521049-T-C,rs2599454,1,T,C,43521049,12139,43336580,43729796,184469
19,ENSG00000171606.12,58183061,19-58234104-C-T,rs260444,1,C,T,58234104,51043,57986453,58379669,247651
19,ENSG00000249471.2,58451622,19-58278729-T-C,rs260503,1,T,C,58278729,172893,58255014,58648230,23715
19,ENSG00000249471.2,58451622,19-58278729-T-G,rs260503,1,T,G,58278729,172893,58255014,58648230,23715
19,ENSG00000249471.2,58451622,19-58278729-T-A,rs260503,1,T,A,58278729,172893,58255014,58648230,23715
19,ENSG00000196268.6,21397133,19-21482835-T-C,rs2650781,1,T,C,21482835,85702,21200525,21593741,282310
19,ENSG00000180884.7,34964229,19-34962556-T-G,rs2651077,-1,T,G,34962556,1673,34767621,35160837,194935
19,ENSG00000180884.7,34964229,19-34962556-T-A,rs2651077,-1,T,A,34962556,1673,34767621,35160837,194935
19,ENSG00000062370.9,44356680,19-44469752-T-C,rs2686779,-1,T,C,44469752,113072,44160072,44553288,309680
19,ENSG00000213799.4,53333749,19-53446227-A-T,rs2708751,1,A,T,53446227,112478,53137141,53530357,309086
19,ENSG00000213799.4,53333749,19-53446227-A-G,rs2708751,1,A,G,53446227,112478,53137141,53530357,309086
19,ENSG00000096996.9,18086934,19-18104437-A-G,rs273504,-1,A,G,18104437,17503,17890326,18283542,214111
19,ENSG00000176909.6,48719725,19-48714004-A-G,rs281385,-1,A,G,48714004,5721,48523117,48916333,190887
19,ENSG00000176909.6,48719725,19-48714004-A-C,rs281385,-1,A,C,48714004,5721,48523117,48916333,190887
19,ENSG00000105612.3,12881449,19-12938601-C-T,rs28365950,-1,C,T,12938601,57152,12684841,13078057,253760
19,ENSG00000130812.5,10102678,19-10098169-C-A,rs28379440,-1,C,A,10098169,4509,9906070,10299286,192099
19,ENSG00000130812.5,10102678,19-10098169-C-G,rs28379440,-1,C,G,10098169,4509,9906070,10299286,192099
19,ENSG00000177191.1,41427374,19-41422796-C-T,rs284653,-1,C,T,41422796,4578,41230766,41623982,192030
19,ENSG00000256771.1,19865882,19-19790327-A-G,rs2878398,1,A,G,19790327,75555,19669274,20062490,121053
19,ENSG00000186020.7,36573292,19-36519650-C-T,rs2945988,-1,C,T,36519650,53642,36376684,36769900,142966
19,ENSG00000186020.7,36573292,19-36519650-C-G,rs2945988,-1,C,G,36519650,53642,36376684,36769900,142966
19,ENSG00000089351.7,35000323,19-34981513-T-A,rs295771,1,T,A,34981513,18810,34803715,35196931,177798
19,ENSG00000089351.7,35000323,19-34981513-T-C,rs295771,1,T,C,34981513,18810,34803715,35196931,177798
19,ENSG00000099860.3,2476127,19-2599403-T-C,rs2965206,1,T,C,2599403,123276,2279519,2672735,319884
19,ENSG00000099860.3,2476127,19-2599403-T-A,rs2965206,1,T,A,2599403,123276,2279519,2672735,319884
19,ENSG00000099860.3,2476127,19-2599403-T-G,rs2965206,1,T,G,2599403,123276,2279519,2672735,319884
19,ENSG00000099864.10,708935,19-890844-A-C,rs2965292,1,A,C,890844,181909,512327,905543,378517
19,ENSG00000099864.10,708935,19-890844-A-G,rs2965292,1,A,G,890844,181909,512327,905543,378517
19,ENSG00000099785.5,8413305,19-8404854-C-G,rs2967605,1,C,G,8404854,8451,8216697,8609913,188157
19,ENSG00000099785.5,8413305,19-8404854-C-A,rs2967605,1,C,A,8404854,8451,8216697,8609913,188157
19,ENSG00000099785.5,8413305,19-8404854-C-T,rs2967605,1,C,T,8404854,8451,8216697,8609913,188157
19,ENSG00000105738.5,37907208,19-37712909-T-C,rs2972435,1,T,C,37712909,194299,37710600,38103816,2309
19,ENSG00000105738.5,37907208,19-37712909-T-G,rs2972435,1,T,G,37712909,194299,37710600,38103816,2309
19,ENSG00000105254.5,36115468,19-36258902-C-T,rs2972548,1,C,T,36258902,143434,35918860,36312076,340042
19,ENSG00000105755.2,43527201,19-43594811-C-T,rs304725,-1,C,T,43594811,67610,43330593,43723809,264218
19,ENSG00000105755.2,43527201,19-43594811-C-G,rs304725,-1,C,G,43594811,67610,43330593,43723809,264218
19,ENSG00000105755.2,43527201,19-43594811-C-A,rs304725,-1,C,A,43594811,67610,43330593,43723809,264218
19,ENSG00000105371.7,10286955,19-10285660-C-T,rs3093032,1,C,T,10285660,1295,10090347,10483563,195313
19,ENSG00000090971.3,55485188,19-55534155-G-T,rs310456,1,G,T,55534155,48967,55288580,55681796,245575
19,ENSG00000130175.4,11435635,19-11442095-A-G,rs313624,1,A,G,11442095,6460,11239027,11632243,203068
19,ENSG00000130175.4,11435635,19-11442095-A-C,rs313624,1,A,C,11442095,6460,11239027,11632243,203068
19,ENSG00000105281.6,46788594,19-46692822-T-C,rs314675,-1,T,C,46692822,95772,46591986,46985202,100836
19,ENSG00000117877.5,45406644,19-45413183-T-G,rs3212980,1,T,G,45413183,6539,45210036,45603252,203147
19,ENSG00000161677.5,50511191,19-50407401-C-T,rs3218755,-1,C,T,50407401,103790,50314583,50707799,92818
19,ENSG00000221923.3,52369923,19-52377513-C-T,rs324087,1,C,T,52377513,7590,52173315,52566531,204198
19,ENSG00000221923.3,52369923,19-52377513-C-G,rs324087,1,C,G,52377513,7590,52173315,52566531,204198
19,ENSG00000188171.8,20661571,19-20543062-G-A,rs33930,-1,G,A,20543062,118509,20464963,20858179,78099
19,ENSG00000167766.11,52638355,19-52606851-G-A,rs34577894,-1,G,A,52606851,31504,52441747,52834963,165104
19,ENSG00000064961.12,3572944,19-3603229-C-T,rs34620121,1,C,T,3603229,30285,3376336,3769552,226893
19,ENSG00000130545.10,6464271,19-6461705-G-A,rs348357,1,G,A,6461705,2566,6267663,6660879,194042
19,ENSG00000130545.10,6464271,19-6461705-G-T,rs348357,1,G,T,6461705,2566,6267663,6660879,194042
19,ENSG00000205744.4,6481787,19-6461705-G-A,rs348357,-1,G,A,6461705,20082,6285179,6678395,176526
19,ENSG00000205744.4,6481787,19-6461705-G-T,rs348357,-1,G,T,6461705,20082,6285179,6678395,176526
19,ENSG00000104833.4,6502309,19-6543206-T-C,rs348372,-1,T,C,6543206,40897,6305701,6698917,237505
19,ENSG00000179954.7,55488436,19-55429526-C-T,rs35179611,1,C,T,55429526,58910,55291828,55685044,137698
19,ENSG00000161609.4,49388249,19-49279364-G-A,rs353999,1,G,A,49279364,108885,49191641,49584857,87723
19,ENSG00000063127.10,49325191,19-49473961-T-C,rs35538484,-1,T,C,49473961,148770,49128583,49521799,345378
19,ENSG00000132016.6,13906117,19-13856728-C-G,rs35647811,-1,C,G,13856728,49389,13709509,14102725,147219
19,ENSG00000132016.6,13906117,19-13856728-C-T,rs35647811,-1,C,T,13856728,49389,13709509,14102725,147219
19,ENSG00000176401.4,39532852,19-39411699-A-T,rs35686858,-1,A,T,39411699,121153,39336244,39729460,75455
19,ENSG00000176401.4,39532852,19-39411699-A-G,rs35686858,-1,A,G,39411699,121153,39336244,39729460,75455
19,ENSG00000142541.10,49487608,19-49680192-C-T,rs35791962,1,C,T,49680192,192584,49291000,49684216,389192
19,ENSG00000104894.6,49335406,19-49383919-T-C,rs35828275,1,T,C,49383919,48513,49138798,49532014,245121
19,ENSG00000125743.5,45691953,19-45621273-G-A,rs36062041,-1,G,A,45621273,70680,45495345,45888561,125928
19,ENSG00000261857.1,40775521,19-40804704-A-G,rs3733828,1,A,G,40804704,29183,40578913,40972129,225791
19,ENSG00000261857.1,40775521,19-40804704-A-C,rs3733828,1,A,C,40804704,29183,40578913,40972129,225791
19,ENSG00000123815.6,40716886,19-40804704-A-G,rs3733828,-1,A,G,40804704,87818,40520278,40913494,284426
19,ENSG00000123815.6,40716886,19-40804704-A-C,rs3733828,-1,A,C,40804704,87818,40520278,40913494,284426
19,ENSG00000183617.3,3762682,19-3762500-C-T,rs3746118,1,C,T,3762500,182,3566074,3959290,196426
19,ENSG00000197951.3,56595302,19-56525284-G-T,rs3752176,1,G,T,56525284,70018,56398694,56791910,126590
19,ENSG00000197951.3,56595302,19-56525284-G-A,rs3752176,1,G,A,56525284,70018,56398694,56791910,126590
19,ENSG00000197016.6,56567468,19-56525284-G-T,rs3752176,1,G,T,56525284,42184,56370860,56764076,154424
19,ENSG00000197016.6,56567468,19-56525284-G-A,rs3752176,1,G,A,56525284,42184,56370860,56764076,154424
19,ENSG00000099817.6,1095375,19-1041353-A-G,rs3752229,-1,A,G,1041353,54022,898767,1291983,142586
19,ENSG00000099817.6,1095375,19-1041353-A-C,rs3752229,-1,A,C,1041353,54022,898767,1291983,142586
19,ENSG00000115255.5,1491181,19-1402998-G-A,rs3760991,1,G,A,1402998,88183,1294573,1687789,108425
19,ENSG00000115255.5,1491181,19-1402998-G-C,rs3760991,1,G,C,1402998,88183,1294573,1687789,108425
19,ENSG00000105499.8,48110817,19-48072851-T-C,rs3786772,-1,T,C,48072851,37966,47914209,48307425,158642
19,ENSG00000099338.14,38335830,19-38267150-A-G,rs3786873,1,A,G,38267150,68680,38139222,38532438,127928
19,ENSG00000171574.11,58408649,19-58559684-C-T,rs3794963,1,C,T,58559684,151035,58212041,58605257,347643
19,ENSG00000171574.11,58408649,19-58559684-C-A,rs3794963,1,C,A,58559684,151035,58212041,58605257,347643
19,ENSG00000171574.11,58408649,19-58559684-C-G,rs3794963,1,C,G,58559684,151035,58212041,58605257,347643
19,ENSG00000160570.8,42217677,19-42390329-C-A,rs3810147,-1,C,A,42390329,172652,42021069,42414285,369260
19,ENSG00000160570.8,42217677,19-42390329-C-T,rs3810147,-1,C,T,42390329,172652,42021069,42414285,369260
19,ENSG00000086967.8,50432892,19-50431682-G-C,rs3810276,1,G,C,50431682,1210,50236284,50629500,195398
19,ENSG00000086967.8,50432892,19-50431682-G-A,rs3810276,1,G,A,50431682,1210,50236284,50629500,195398
19,ENSG00000167414.3,46636202,19-46635389-G-T,rs3810295,-1,G,T,46635389,813,46439594,46832810,195795
19,ENSG00000204920.4,43984188,19-43962004-C-A,rs381872,1,C,A,43962004,22184,43787580,44180796,174424
19,ENSG00000204920.4,43984188,19-43962004-C-T,rs381872,1,C,T,43962004,22184,43787580,44180796,174424
19,ENSG00000197766.1,859664,19-862912-C-G,rs3826945,1,C,G,862912,3248,663056,1056272,199856
19,ENSG00000197766.1,859664,19-862912-C-T,rs3826945,1,C,T,862912,3248,663056,1056272,199856
19,ENSG00000174951.4,48752641,19-48750132-C-T,rs4015,-1,C,T,48750132,2509,48556033,48949249,194099
19,ENSG00000167608.6,54173160,19-54193607-A-G,rs4042,-1,A,G,54193607,20447,53976552,54369768,217055
19,ENSG00000167608.6,54173160,19-54193607-A-C,rs4042,-1,A,C,54193607,20447,53976552,54369768,217055
19,ENSG00000090674.10,7522624,19-7629507-G-C,rs4134809,1,G,C,7629507,106883,7326016,7719232,303491
19,ENSG00000090674.10,7522624,19-7629507-G-T,rs4134809,1,G,T,7629507,106883,7326016,7719232,303491
19,ENSG00000090674.10,7522624,19-7629507-G-A,rs4134809,1,G,A,7629507,106883,7326016,7719232,303491
19,ENSG00000088256.3,3094362,19-3123115-C-T,rs415647,1,C,T,3123115,28753,2897754,3290970,225361
19,ENSG00000170889.9,54200858,19-54252131-A-G,rs417523,1,A,G,54252131,51273,54004250,54397466,247881
19,ENSG00000105176.12,29942239,19-30108876-G-A,rs454282,1,G,A,30108876,166637,29745631,30138847,363245
19,ENSG00000012124.9,35329187,19-35345037-C-T,rs45453699,1,C,T,35345037,15850,35132579,35525795,212458
19,ENSG00000167815.7,12801800,19-12691339-C-T,rs45478502,-1,C,T,12691339,110461,12605192,12998408,86147
19,ENSG00000167815.7,12801800,19-12691339-C-A,rs45478502,-1,C,A,12691339,110461,12605192,12998408,86147
19,ENSG00000105576.9,12723932,19-12691339-C-T,rs45478502,-1,C,T,12691339,32593,12527324,12920540,164015
19,ENSG00000105576.9,12723932,19-12691339-C-A,rs45478502,-1,C,A,12691339,32593,12527324,12920540,164015
19,ENSG00000251369.2,57559863,19-57541945-A-G,rs45533235,-1,A,G,57541945,17918,57363255,57756471,178690
19,ENSG00000224420.2,49689594,19-49690180-C-T,rs45613034,1,C,T,49690180,586,49492986,49886202,197194
19,ENSG00000224420.2,49689594,19-49690180-C-A,rs45613034,1,C,A,49690180,586,49492986,49886202,197194
19,ENSG00000169169.9,49691116,19-49705370-C-T,rs45617640,1,C,T,49705370,14254,49494508,49887724,210862
19,ENSG00000142252.5,45079260,19-45093023-A-C,rs4608431,1,A,C,45093023,13763,44882652,45275868,210371
19,ENSG00000142252.5,45079260,19-45093023-A-T,rs4608431,1,A,T,45093023,13763,44882652,45275868,210371
19,ENSG00000121410.6,58353492,19-58360360-C-T,rs4801266,-1,C,T,58360360,6868,58156884,58550100,203476
19,ENSG00000121410.6,58353492,19-58360360-C-A,rs4801266,-1,C,A,58360360,6868,58156884,58550100,203476
19,ENSG00000196724.6,57935402,19-57877987-C-G,rs4801528,-1,C,G,57877987,57415,57738794,58132010,139193
19,ENSG00000196724.6,57935402,19-57877987-C-A,rs4801528,-1,C,A,57877987,57415,57738794,58132010,139193
19,ENSG00000196724.6,57935402,19-57877987-C-T,rs4801528,-1,C,T,57877987,57415,57738794,58132010,139193
19,ENSG00000142534.1,49496434,19-49445355-A-G,rs4801799,1,A,G,49445355,51079,49299826,49693042,145529
19,ENSG00000142534.1,49496434,19-49445355-A-T,rs4801799,1,A,T,49445355,51079,49299826,49693042,145529
19,ENSG00000181027.5,46746057,19-46739735-G-A,rs4802322,1,G,A,46739735,6322,46549449,46942665,190286
19,ENSG00000142235.3,48511835,19-48559306-G-A,rs4802489,-1,G,A,48559306,47471,48315227,48708443,244079
19,ENSG00000087088.14,48954875,19-49085163-T-C,rs4802550,1,T,C,49085163,130288,48758267,49151483,326896
19,ENSG00000087088.14,48954875,19-49085163-T-G,rs4802550,1,T,G,49085163,130288,48758267,49151483,326896
19,ENSG00000087088.14,48954875,19-49085163-T-A,rs4802550,1,T,A,49085163,130288,48758267,49151483,326896
19,ENSG00000010361.7,49813292,19-49928622-T-C,rs4802639,-1,T,C,49928622,115330,49616684,50009900,311938
19,ENSG00000104825.12,38899969,19-38914160-A-G,rs4803027,1,A,G,38914160,14191,38703361,39096577,210799
19,ENSG00000104825.12,38899969,19-38914160-A-C,rs4803027,1,A,C,38914160,14191,38703361,39096577,210799
19,ENSG00000248098.2,41397818,19-41412149-G-C,rs4803464,1,G,C,41412149,14331,41201210,41594426,210939
19,ENSG00000248098.2,41397818,19-41412149-G-A,rs4803464,1,G,A,41412149,14331,41201210,41594426,210939
19,ENSG00000176531.5,43504746,19-43524879-G-C,rs4803640,-1,G,C,43524879,20133,43308138,43701354,216741
19,ENSG00000226763.2,43612088,19-43524879-G-C,rs4803640,1,G,C,43524879,87209,43415480,43808696,109399
19,ENSG00000176222.6,43883964,19-43786083-C-T,rs4803659,-1,C,T,43786083,97881,43687356,44080572,98727
19,ENSG00000176222.6,43883964,19-43786083-C-A,rs4803659,-1,C,A,43786083,97881,43687356,44080572,98727
19,ENSG00000130203.4,44905796,19-45020201-G-A,rs4803790,1,G,A,45020201,114405,44709188,45102404,311013
19,ENSG00000130203.4,44905796,19-45020201-G-C,rs4803790,1,G,C,45020201,114405,44709188,45102404,311013
19,ENSG00000105287.7,46717114,19-46773197-G-A,rs4804000,-1,G,A,46773197,56083,46520506,46913722,252691
19,ENSG00000183401.5,11346519,19-11356065-C-G,rs4804161,1,C,G,11356065,9546,11149911,11543127,206154
19,ENSG00000130164.6,11089463,19-11166398-C-A,rs4804572,1,C,A,11166398,76935,10892855,11286071,273543
19,ENSG00000130164.6,11089463,19-11166398-C-G,rs4804572,1,C,G,11166398,76935,10892855,11286071,273543
19,ENSG00000130164.6,11089463,19-11166398-C-T,rs4804572,1,C,T,11166398,76935,10892855,11286071,273543
19,ENSG00000132004.7,12696631,19-12536469-G-A,rs4804716,-1,G,A,12536469,160162,12500023,12893239,36446
19,ENSG00000124299.7,33521791,19-33348648-A-G,rs4805033,-1,A,G,33348648,173143,33325183,33718399,23465
19,ENSG00000257103.2,34172504,19-34136314-T-C,rs4805072,1,T,C,34136314,36190,33975896,34369112,160418
19,ENSG00000105258.3,36114875,19-36183403-A-T,rs4805162,-1,A,T,36183403,68528,35918267,36311483,265136
19,ENSG00000105258.3,36114875,19-36183403-A-G,rs4805162,-1,A,G,36183403,68528,35918267,36311483,265136
19,ENSG00000105258.3,36114875,19-36183403-A-C,rs4805162,-1,A,C,36183403,68528,35918267,36311483,265136
19,ENSG00000126267.3,35648323,19-35658859-A-C,rs4806187,1,A,C,35658859,10536,35451715,35844931,207144
19,ENSG00000126267.3,35648323,19-35658859-A-G,rs4806187,1,A,G,35658859,10536,35451715,35844931,207144
19,ENSG00000126267.3,35648323,19-35658859-A-T,rs4806187,1,A,T,35658859,10536,35451715,35844931,207144
19,ENSG00000105619.8,54115657,19-54115811-G-A,rs4806711,-1,G,A,54115811,154,53919049,54312265,196762
19,ENSG00000105619.8,54115657,19-54115811-G-C,rs4806711,-1,G,C,54115811,154,53919049,54312265,196762
19,ENSG00000182087.6,1021123,19-1004824-G-A,rs4806908,-1,G,A,1004824,16299,824515,1217731,180309
19,ENSG00000095932.4,3480525,19-3487535-T-C,rs4806939,-1,T,C,3487535,7010,3283917,3677133,203618
19,ENSG00000095932.4,3480525,19-3487535-T-A,rs4806939,-1,T,A,3487535,7010,3283917,3677133,203618
19,ENSG00000127540.4,1605462,19-1745611-G-A,rs4807137,-1,G,A,1745611,140149,1408854,1802070,336757
19,ENSG00000127540.4,1605462,19-1745611-G-T,rs4807137,-1,G,T,1745611,140149,1408854,1802070,336757
19,ENSG00000127540.4,1605462,19-1745611-G-C,rs4807137,-1,G,C,1745611,140149,1408854,1802070,336757
19,ENSG00000161091.7,3557586,19-3493333-A-G,rs4807477,-1,A,G,3493333,64253,3360978,3754194,132355
19,ENSG00000089847.7,4182689,19-4182063-T-G,rs4807546,1,T,G,4182063,626,3986081,4379297,195982
19,ENSG00000089847.7,4182689,19-4182063-T-C,rs4807546,1,T,C,4182063,626,3986081,4379297,195982
19,ENSG00000160161.3,19538265,19-19443994-G-A,rs4808200,1,G,A,19443994,94271,19341657,19734873,102337
19,ENSG00000074181.2,15200995,19-15284812-T-G,rs4808278,-1,T,G,15284812,83817,15004387,15397603,280425
19,ENSG00000074181.2,15200995,19-15284812-T-A,rs4808278,-1,T,A,15284812,83817,15004387,15397603,280425
19,ENSG00000127507.11,14778560,19-14728348-T-A,rs4808387,-1,T,A,14728348,50212,14581952,14975168,146396
19,ENSG00000127507.11,14778560,19-14728348-T-C,rs4808387,-1,T,C,14728348,50212,14581952,14975168,146396
19,ENSG00000130309.4,17555649,19-17505232-G-A,rs4808657,1,G,A,17505232,50417,17359041,17752257,146191
19,ENSG00000130309.4,17555649,19-17505232-G-T,rs4808657,1,G,T,17505232,50417,17359041,17752257,146191
19,ENSG00000130309.4,17555649,19-17505232-G-C,rs4808657,1,G,C,17505232,50417,17359041,17752257,146191
19,ENSG00000064545.8,19138478,19-19138570-A-C,rs4808925,-1,A,C,19138570,92,18941870,19335086,196700
19,ENSG00000064545.8,19138478,19-19138570-A-G,rs4808925,-1,A,G,19138570,92,18941870,19335086,196700
19,ENSG00000130803.9,9140397,19-9214440-G-T,rs5020278,1,G,T,9214440,74043,8943789,9337005,270651
19,ENSG00000130803.9,9140397,19-9214440-G-C,rs5020278,1,G,C,9214440,74043,8943789,9337005,270651
19,ENSG00000130803.9,9140397,19-9214440-G-A,rs5020278,1,G,A,9214440,74043,8943789,9337005,270651
19,ENSG00000105197.4,39480838,19-39397809-C-T,rs519575,1,C,T,39397809,83029,39284230,39677446,113579
19,ENSG00000072071.11,14206169,19-14269255-A-G,rs530311,-1,A,G,14269255,63086,14009561,14402777,259694
19,ENSG00000179922.3,55624566,19-55659049-T-C,rs540607,-1,T,C,55659049,34483,55427958,55821174,231091
19,ENSG00000179922.3,55624566,19-55659049-T-A,rs540607,-1,T,A,55659049,34483,55427958,55821174,231091
19,ENSG00000105397.7,10380572,19-10284792-G-A,rs5497,-1,G,A,10284792,95780,10183964,10577180,100828
19,ENSG00000105397.7,10380572,19-10284792-G-T,rs5497,-1,G,T,10284792,95780,10183964,10577180,100828
19,ENSG00000167748.5,50823787,19-50819976-T-C,rs5517,-1,T,C,50819976,3811,50627179,51020395,192797
19,ENSG00000167748.5,50823787,19-50819976-T-A,rs5517,-1,T,A,50819976,3811,50627179,51020395,192797
19,ENSG00000167748.5,50823787,19-50819976-T-G,rs5517,-1,T,G,50819976,3811,50627179,51020395,192797
19,ENSG00000060558.2,3136033,19-3326294-C-T,rs55907706,1,C,T,3326294,190261,2939425,3332641,386869
19,ENSG00000060558.2,3136033,19-3326294-C-G,rs55907706,1,C,G,3326294,190261,2939425,3332641,386869
19,ENSG00000099822.1,589881,19-633013-G-A,rs56090114,1,G,A,633013,43132,393273,786489,239740
19,ENSG00000105402.2,47515063,19-47545258-T-C,rs56162770,-1,T,C,47545258,30195,47318455,47711671,226803
19,ENSG00000105699.9,35249002,19-35138110-T-C,rs56168231,1,T,C,35138110,110892,35052394,35445610,85716
19,ENSG00000105699.9,35249002,19-35138110-T-A,rs56168231,1,T,A,35138110,110892,35052394,35445610,85716
19,ENSG00000105699.9,35249002,19-35138110-T-G,rs56168231,1,T,G,35138110,110892,35052394,35445610,85716
19,ENSG00000153885.7,33796870,19-33843952-G-A,rs576556,1,G,A,33843952,47082,33600262,33993478,243690
19,ENSG00000179909.9,57709204,19-57746021-G-T,rs57990162,-1,G,T,57746021,36817,57512596,57905812,233425
19,ENSG00000104921.9,7702131,19-7546231-T-A,rs586551,-1,T,A,7546231,155900,7505523,7898739,40708
19,ENSG00000104921.9,7702131,19-7546231-T-C,rs586551,-1,T,C,7546231,155900,7505523,7898739,40708
19,ENSG00000161265.6,35745418,19-35666838-C-A,rs61741212,-1,C,A,35666838,78580,35548810,35942026,118028
19,ENSG00000161265.6,35745418,19-35666838-C-G,rs61741212,-1,C,G,35666838,78580,35548810,35942026,118028
19,ENSG00000161265.6,35745418,19-35666838-C-T,rs61741212,-1,C,T,35666838,78580,35548810,35942026,118028
19,ENSG00000167578.11,40778247,19-40800745-C-T,rs61750953,1,C,T,40800745,22498,40581639,40974855,219106
19,ENSG00000198464.7,52297169,19-52319375-G-A,rs62110455,1,G,A,52319375,22206,52100561,52493777,218814
19,ENSG00000167685.8,56141287,19-56008436-G-C,rs62123587,1,G,C,56008436,132851,55944679,56337895,63757
19,ENSG00000167685.8,56141287,19-56008436-G-A,rs62123587,1,G,A,56008436,132851,55944679,56337895,63757
19,ENSG00000090661.6,8209370,19-8182669-G-A,rs62124529,1,G,A,8182669,26701,8012762,8405978,169907
19,ENSG00000223638.3,55759097,19-55598565-A-G,rs62127845,1,A,G,55598565,160532,55562489,55955705,36076
19,ENSG00000105523.2,48615076,19-48595522-C-T,rs62130308,-1,C,T,48595522,19554,48418468,48811684,177054
19,ENSG00000130159.6,11529134,19-11445316-C-T,rs62131153,-1,C,T,11445316,83818,11332526,11725742,112790
19,ENSG00000064666.7,1026608,19-838178-C-G,rs62132293,1,C,G,838178,188430,830000,1223216,8178
19,ENSG00000062822.6,50384347,19-50227554-T-C,rs637586,1,T,C,50227554,156793,50187739,50580955,39815
19,ENSG00000062822.6,50384347,19-50227554-T-G,rs637586,1,T,G,50227554,156793,50187739,50580955,39815
19,ENSG00000062822.6,50384347,19-50227554-T-A,rs637586,1,T,A,50227554,156793,50187739,50580955,39815
19,ENSG00000213015.3,55641002,19-55636562-G-A,rs644230,1,G,A,55636562,4440,55444394,55837610,192168
19,ENSG00000213015.3,55641002,19-55636562-G-T,rs644230,1,G,T,55636562,4440,55444394,55837610,192168
19,ENSG00000213015.3,55641002,19-55636562-G-C,rs644230,1,G,C,55636562,4440,55444394,55837610,192168
19,ENSG00000105053.5,50025372,19-50189839-T-C,rs648691,-1,T,C,50189839,164467,49828764,50221980,361075
19,ENSG00000105053.5,50025372,19-50189839-T-G,rs648691,-1,T,G,50189839,164467,49828764,50221980,361075
19,ENSG00000063322.6,39391378,19-39217471-A-C,rs6508849,1,A,C,39217471,173907,39194770,39587986,22701
19,ENSG00000063322.6,39391378,19-39217471-A-T,rs6508849,1,A,T,39217471,173907,39194770,39587986,22701
19,ENSG00000063322.6,39391378,19-39217471-A-G,rs6508849,1,A,G,39217471,173907,39194770,39587986,22701
19,ENSG00000167634.6,54947505,19-55051034-A-C,rs6509916,-1,A,C,55051034,103529,54750897,55144113,300137
19,ENSG00000167634.6,54947505,19-55051034-A-G,rs6509916,-1,A,G,55051034,103529,54750897,55144113,300137
19,ENSG00000022556.10,54966374,19-55051034-A-C,rs6509916,1,A,C,55051034,84660,54769766,55162982,281268
19,ENSG00000022556.10,54966374,19-55051034-A-G,rs6509916,1,A,G,55051034,84660,54769766,55162982,281268
19,ENSG00000197714.3,57280485,19-57237572-C-A,rs6510052,1,C,A,57237572,42913,57083877,57477093,153695
19,ENSG00000197714.3,57280485,19-57237572-C-T,rs6510052,1,C,T,57237572,42913,57083877,57477093,153695
19,ENSG00000205138.2,35995188,19-36061179-C-T,rs6510516,1,C,T,36061179,65991,35798580,36191796,262599
19,ENSG00000196684.6,16143685,19-16186097-C-T,rs67000086,1,C,T,16186097,42412,15947077,16340293,239020
19,ENSG00000160633.6,5623083,19-5469096-C-T,rs676382,1,C,T,5469096,153987,5426475,5819691,42621
19,ENSG00000218891.1,55580848,19-55492713-G-C,rs721781,-1,G,C,55492713,88135,55384240,55777456,108473
19,ENSG00000076662.4,10339624,19-10227675-C-T,rs7246367,-1,C,T,10227675,111949,10143016,10536232,84659
19,ENSG00000129968.10,1885496,19-1884553-G-A,rs7246402,-1,G,A,1884553,943,1688888,2082104,195665
19,ENSG00000105085.4,16628204,19-16612772-A-G,rs7246513,-1,A,G,16612772,15432,16431596,16824812,181176
19,ENSG00000204604.3,52857619,19-52838585-A-T,rs7247271,-1,A,T,52838585,19034,52661011,53054227,177574
19,ENSG00000204604.3,52857619,19-52838585-A-G,rs7247271,-1,A,G,52838585,19034,52661011,53054227,177574
19,ENSG00000188785.6,57389854,19-57349717-T-C,rs7250371,1,T,C,57349717,40137,57193246,57586462,156471
19,ENSG00000188785.6,57389854,19-57349717-T-A,rs7250371,1,T,A,57349717,40137,57193246,57586462,156471
19,ENSG00000188785.6,57389854,19-57349717-T-G,rs7250371,1,T,G,57349717,40137,57193246,57586462,156471
19,ENSG00000115268.3,1438396,19-1434136-T-C,rs7251937,1,T,C,1434136,4260,1241788,1635004,192348
19,ENSG00000124459.5,43935282,19-44115389-T-A,rs7252108,-1,T,A,44115389,180107,43738674,44131890,376715
19,ENSG00000124459.5,43935282,19-44115389-T-C,rs7252108,-1,T,C,44115389,180107,43738674,44131890,376715
19,ENSG00000124459.5,43935282,19-44115389-T-G,rs7252108,-1,T,G,44115389,180107,43738674,44131890,376715
19,ENSG00000188493.8,40750477,19-40795210-G-T,rs7252227,-1,G,T,40795210,44733,40553869,40947085,241341
19,ENSG00000249115.2,35612735,19-35436251-C-A,rs7252554,1,C,A,35436251,176484,35416127,35809343,20124
19,ENSG00000130810.14,10106362,19-10184448-G-A,rs7253062,1,G,A,10184448,78086,9909754,10302970,274694
19,ENSG00000179855.5,3585478,19-3623536-A-G,rs7253265,1,A,G,3623536,38058,3388870,3782086,234666
19,ENSG00000179855.5,3585478,19-3623536-A-C,rs7253265,1,A,C,3623536,38058,3388870,3782086,234666
19,ENSG00000189190.6,52786807,19-52904544-C-T,rs7254555,-1,C,T,52904544,117737,52590199,52983415,314345
19,ENSG00000189190.6,52786807,19-52904544-C-A,rs7254555,-1,C,A,52904544,117737,52590199,52983415,314345
19,ENSG00000243207.2,10106395,19-10084208-C-T,rs7255032,1,C,T,10084208,22187,9909787,10303003,174421
19,ENSG00000243207.2,10106395,19-10084208-C-G,rs7255032,1,C,G,10084208,22187,9909787,10303003,174421
19,ENSG00000126460.5,49581316,19-49549078-T-C,rs7256758,1,T,C,49549078,32238,49384708,49777924,164370
19,ENSG00000141985.4,4400547,19-4441957-C-A,rs7258012,-1,C,A,4441957,41410,4203939,4597155,238018
19,ENSG00000141985.4,4400547,19-4441957-C-T,rs7258012,-1,C,T,4441957,41410,4203939,4597155,238018
19,ENSG00000126464.7,49591182,19-49649784-C-T,rs7258381,1,C,T,49649784,58602,49394574,49787790,255210
19,ENSG00000174837.8,6887579,19-6943399-G-A,rs7259047,1,G,A,6943399,55820,6690971,7084187,252428
19,ENSG00000174837.8,6887579,19-6943399-G-C,rs7259047,1,G,C,6943399,55820,6690971,7084187,252428
19,ENSG00000125503.6,55117637,19-55103392-A-G,rs7259963,-1,A,G,55103392,14245,54921029,55314245,182363
19,ENSG00000125503.6,55117637,19-55103392-A-T,rs7259963,-1,A,T,55103392,14245,54921029,55314245,182363
19,ENSG00000125503.6,55117637,19-55103392-A-C,rs7259963,-1,A,C,55103392,14245,54921029,55314245,182363
19,ENSG00000105278.5,3869038,19-3853532-T-C,rs72975109,-1,T,C,3853532,15506,3672430,4065646,181102
19,ENSG00000105519.5,5914254,19-5763318-C-T,rs72983161,1,C,T,5763318,150936,5717646,6110862,45672
19,ENSG00000130475.9,17751477,19-17707308-T-G,rs73013739,1,T,G,17707308,44169,17554869,17948085,152439
19,ENSG00000130475.9,17751477,19-17707308-T-C,rs73013739,1,T,C,17707308,44169,17554869,17948085,152439
19,ENSG00000099330.3,17226226,19-17401653-A-G,rs73018431,1,A,G,17401653,175427,17029618,17422834,372035
19,ENSG00000118162.8,47484219,19-47585297-T-C,rs73033595,-1,T,C,47585297,101078,47287611,47680827,297686
19,ENSG00000186567.7,44671482,19-44477583-T-C,rs73036497,1,T,C,44477583,193899,44474874,44868090,2709
19,ENSG00000167617.2,54473296,19-54478404-C-T,rs73064143,-1,C,T,54478404,5108,54276688,54669904,201716
19,ENSG00000167617.2,54473296,19-54478404-C-G,rs73064143,-1,C,G,54478404,5108,54276688,54669904,201716
19,ENSG00000160469.9,55283997,19-55251413-G-A,rs73068666,1,G,A,55251413,32584,55087389,55480605,164024
19,ENSG00000131848.4,56314839,19-56266223-T-C,rs73069649,-1,T,C,56266223,48616,56118231,56511447,147992
19,ENSG00000161640.10,49961172,19-49877601-T-G,rs731826,-1,T,G,49877601,83571,49764564,50157780,113037
19,ENSG00000131398.8,50329377,19-50467752-C-A,rs736769,-1,C,A,50467752,138375,50132769,50525985,334983
19,ENSG00000105695.8,35292161,19-35221646-G-A,rs7409420,1,G,A,35221646,70515,35095553,35488769,126093
19,ENSG00000125657.2,6531026,19-6621697-C-T,rs74441035,1,C,T,6621697,90671,6334418,6727634,287279
19,ENSG00000223802.2,18896158,19-18762771-C-T,rs74736618,-1,C,T,18762771,133387,18699550,19092766,63221
19,ENSG00000105520.5,11355432,19-11495489-G-T,rs74759079,1,G,T,11495489,140057,11158824,11552040,336665
19,ENSG00000099331.7,17075777,19-17072129-T-C,rs7507441,1,T,C,17072129,3648,16879169,17272385,192960
19,ENSG00000187187.7,39997060,19-39867023-C-T,rs75241092,1,C,T,39867023,130037,39800452,40193668,66571
19,ENSG00000011304.10,797452,19-759864-G-A,rs75424782,1,G,A,759864,37588,600844,994060,159020
19,ENSG00000011304.10,797452,19-759864-G-T,rs75424782,1,G,T,759864,37588,600844,994060,159020
19,ENSG00000168813.9,32345610,19-32280056-G-A,rs75471356,1,G,A,32280056,65554,32149002,32542218,131054
19,ENSG00000104960.10,49851159,19-49854876-T-A,rs75478119,1,T,A,49854876,3717,49654551,50047767,200325
19,ENSG00000104960.10,49851159,19-49854876-T-G,rs75478119,1,T,G,49854876,3717,49654551,50047767,200325
19,ENSG00000179873.8,55831994,19-55738079-A-G,rs755804,-1,A,G,55738079,93915,55635386,56028602,102693
19,ENSG00000176533.7,2702694,19-2646886-G-A,rs75670922,-1,G,A,2646886,55808,2506086,2899302,140800
19,ENSG00000186111.3,3700468,19-3660621-A-G,rs757454,-1,A,G,3660621,39847,3503860,3897076,156761
19,ENSG00000186111.3,3700468,19-3660621-A-T,rs757454,-1,A,T,3660621,39847,3503860,3897076,156761
19,ENSG00000105642.8,17967107,19-17811959-C-T,rs76106223,1,C,T,17811959,155148,17770499,18163715,41460
19,ENSG00000104872.5,49451814,19-49492486-G-T,rs76997502,-1,G,T,49492486,40672,49255206,49648422,237280
19,ENSG00000104872.5,49451814,19-49492486-G-A,rs76997502,-1,G,A,49492486,40672,49255206,49648422,237280
19,ENSG00000083812.5,58467080,19-58571901-G-A,rs77537775,1,G,A,58571901,104821,58270472,58663688,301429
19,ENSG00000104998.1,14031762,19-14088294-G-A,rs77876260,1,G,A,14088294,56532,13835154,14228370,253140
19,ENSG00000126262.2,35448257,19-35459404-G-A,rs78036837,1,G,A,35459404,11147,35251649,35644865,207755
19,ENSG00000105204.8,39834162,19-39727055-G-A,rs78198540,-1,G,A,39727055,107107,39637554,40030770,89501
19,ENSG00000104880.11,7348937,19-7519597-A-G,rs78214445,1,A,G,7519597,170660,7152329,7545545,367268
19,ENSG00000104880.11,7348937,19-7519597-A-C,rs78214445,1,A,C,7519597,170660,7152329,7545545,367268
19,ENSG00000179134.8,39342421,19-39447789-T-C,rs78361906,1,T,C,39447789,105368,39145813,39539029,301976
19,ENSG00000104904.4,2269520,19-2238720-C-A,rs78481493,1,C,A,2238720,30800,2072912,2466128,165808
19,ENSG00000104904.4,2269520,19-2238720-C-T,rs78481493,1,C,T,2238720,30800,2072912,2466128,165808
19,ENSG00000180061.4,55325341,19-55479109-G-A,rs78768334,-1,G,A,55479109,153768,55128733,55521949,350376
19,ENSG00000167775.4,8308358,19-8355699-G-A,rs79293855,-1,G,A,8355699,47341,8111750,8504966,243949
19,ENSG00000172006.6,2819868,19-2779423-A-G,rs79528039,1,A,G,2779423,40445,2623260,3016476,156163
19,ENSG00000130312.1,17305872,19-17242557-C-A,rs8099896,1,C,A,17242557,63315,17109264,17502480,133293
19,ENSG00000130312.1,17305872,19-17242557-C-G,rs8099896,1,C,G,17242557,63315,17109264,17502480,133293
19,ENSG00000130312.1,17305872,19-17242557-C-T,rs8099896,1,C,T,17242557,63315,17109264,17502480,133293
19,ENSG00000060566.7,4153631,19-4005783-C-T,rs8100558,1,C,T,4005783,147848,3957023,4350239,48760
19,ENSG00000234906.2,44946051,19-44813933-G-A,rs8101274,1,G,A,44813933,132118,44749443,45142659,64490
19,ENSG00000234906.2,44946051,19-44813933-G-C,rs8101274,1,G,C,44813933,132118,44749443,45142659,64490
19,ENSG00000105379.4,51366388,19-51479780-T-C,rs8101768,-1,T,C,51479780,113392,51169780,51562996,310000
19,ENSG00000141965.3,4791734,19-4804512-T-C,rs8102626,1,T,C,4804512,12778,4595126,4988342,209386
19,ENSG00000160117.8,17281901,19-17264404-C-T,rs8102890,1,C,T,17264404,17497,17085293,17478509,179111
19,ENSG00000167468.10,1103994,19-1103466-A-G,rs8103188,1,A,G,1103466,528,907386,1300602,196080
19,ENSG00000167468.10,1103994,19-1103466-A-T,rs8103188,1,A,T,1103466,528,907386,1300602,196080
19,ENSG00000105122.6,15464544,19-15626300-A-G,rs8103544,-1,A,G,15626300,161756,15267936,15661152,358364
19,ENSG00000125910.3,3178769,19-3170977-C-T,rs8105189,1,C,T,3170977,7792,2982161,3375377,188816
19,ENSG00000104856.8,45001464,19-44864520-C-T,rs8105340,1,C,T,44864520,136944,44804856,45198072,59664
19,ENSG00000090372.7,46746450,19-46784893-C-A,rs8105903,-1,C,A,46784893,38443,46549842,46943058,235051
19,ENSG00000090372.7,46746450,19-46784893-C-G,rs8105903,-1,C,G,46784893,38443,46549842,46943058,235051
19,ENSG00000105641.2,17871945,19-17684551-C-G,rs8106359,1,C,G,17684551,187394,17675337,18068553,9214
19,ENSG00000156413.7,5839702,19-5785801-G-A,rs8107987,-1,G,A,5785801,53901,5643094,6036310,142707
19,ENSG00000131115.9,44212532,19-44279851-C-T,rs8109462,1,C,T,44279851,67319,44015924,44409140,263927
19,ENSG00000182013.11,46471563,19-46446405-C-T,rs8109759,-1,C,T,46446405,25158,46274955,46668171,171450
19,ENSG00000182013.11,46471563,19-46446405-C-G,rs8109759,-1,C,G,46446405,25158,46274955,46668171,171450
19,ENSG00000182013.11,46471563,19-46446405-C-A,rs8109759,-1,C,A,46446405,25158,46274955,46668171,171450
19,ENSG00000167618.4,54502831,19-54522790-T-A,rs8109847,1,T,A,54522790,19959,54306223,54699439,216567
19,ENSG00000167618.4,54502831,19-54522790-T-G,rs8109847,1,T,G,54522790,19959,54306223,54699439,216567
19,ENSG00000167618.4,54502831,19-54522790-T-C,rs8109847,1,T,C,54522790,19959,54306223,54699439,216567
19,ENSG00000167460.9,16076495,19-16084227-G-C,rs8110506,1,G,C,16084227,7732,15879887,16273103,204340
19,ENSG00000167460.9,16076495,19-16084227-G-T,rs8110506,1,G,T,16084227,7732,15879887,16273103,204340
19,ENSG00000167460.9,16076495,19-16084227-G-A,rs8110506,1,G,A,16084227,7732,15879887,16273103,204340
19,ENSG00000086548.7,41755530,19-41567265-A-T,rs8110782,1,A,T,41567265,188265,41558922,41952138,8343
19,ENSG00000086548.7,41755530,19-41567265-A-G,rs8110782,1,A,G,41567265,188265,41558922,41952138,8343
19,ENSG00000011478.6,45692666,19-45664843-A-G,rs8111428,1,A,G,45664843,27823,45496058,45889274,168785
19,ENSG00000104823.3,38831794,19-38838877-C-T,rs8111670,-1,C,T,38838877,7083,38635186,39028402,203691
19,ENSG00000249709.1,12551482,19-12390621-A-G,rs8112445,-1,A,G,12390621,160861,12354874,12748090,35747
19,ENSG00000249709.1,12551482,19-12390621-A-T,rs8112445,-1,A,T,12390621,160861,12354874,12748090,35747
19,ENSG00000186230.5,57435325,19-57352233-G-T,rs862700,1,G,T,57352233,83092,57238717,57631933,113516
19,ENSG00000119574.7,58519810,19-58554585-T-C,rs873104,-1,T,C,58554585,34775,58323202,58716418,231383
19,ENSG00000119574.7,58519810,19-58554585-T-G,rs873104,-1,T,G,58554585,34775,58323202,58716418,231383
19,ENSG00000172270.12,572596,19-588305-A-C,rs873634,1,A,C,588305,15709,375988,769204,212317
19,ENSG00000257704.1,47274885,19-47267681-C-A,rs883030,1,C,A,47267681,7204,47078277,47471493,189404
19,ENSG00000257704.1,47274885,19-47267681-C-T,rs883030,1,C,T,47267681,7204,47078277,47471493,189404
19,ENSG00000171105.7,7294414,19-7228332-A-G,rs890861,-1,A,G,7228332,66082,7097806,7491022,130526
19,ENSG00000186026.5,44072159,19-44129933-C-T,rs9304638,1,C,T,44129933,57774,43875551,44268767,254382
19,ENSG00000186026.5,44072159,19-44129933-C-G,rs9304638,1,C,G,44129933,57774,43875551,44268767,254382
19,ENSG00000182986.7,52897635,19-52948038-T-C,rs9304742,-1,T,C,52948038,50403,52701027,53094243,247011
19,ENSG00000182986.7,52897635,19-52948038-T-A,rs9304742,-1,T,A,52948038,50403,52701027,53094243,247011
19,ENSG00000105298.7,3626790,19-3578655-C-T,rs939209,-1,C,T,3578655,48135,3430182,3823398,148473
19,ENSG00000011243.10,15418988,19-15534958-G-A,rs939501,-1,G,A,15534958,115970,15222380,15615596,312578
19,ENSG00000197134.5,22052484,19-22117205-T-G,rs987711,1,T,G,22117205,64721,21855876,22249092,261329
18,ENSG00000141384.6,26226445,18-26159350-T-C,rs10048370,1,T,C,26159350,67095,26029837,26423053,129513
18,ENSG00000141384.6,26226445,18-26159350-T-G,rs10048370,1,T,G,26159350,67095,26029837,26423053,129513
18,ENSG00000154040.15,24139062,18-24119273-C-T,rs10163625,1,C,T,24119273,19789,23942454,24335670,176819
18,ENSG00000154040.15,24139062,18-24119273-C-G,rs10163625,1,C,G,24119273,19789,23942454,24335670,176819
18,ENSG00000154040.15,24139062,18-24119273-C-A,rs10163625,1,C,A,24119273,19789,23942454,24335670,176819
18,ENSG00000141391.8,12407929,18-12410279-C-G,rs10164125,1,C,G,12410279,2350,12211321,12604537,198958
18,ENSG00000141759.9,79988563,18-79985640-A-G,rs10438902,-1,A,G,79985640,2923,79791955,80185171,193685
18,ENSG00000134504.7,26548553,18-26559729-G-A,rs10454720,-1,G,A,26559729,11176,26351945,26745161,207784
18,ENSG00000134779.8,36829002,18-36818951-C-T,rs1045781,-1,C,T,36818951,10051,36632394,37025610,186557
18,ENSG00000176624.8,51197681,18-51159098-G-A,rs10502915,-1,G,A,51159098,38583,51001073,51394289,158025
18,ENSG00000170677.4,70289045,18-70425839-G-A,rs10513985,1,G,A,70425839,136794,70092437,70485653,333402
18,ENSG00000128791.6,9334773,18-9335745-C-T,rs11081472,1,C,T,9335745,972,9138165,9531381,197580
18,ENSG00000101751.5,54269517,18-54255524-T-C,rs11083047,1,T,C,54255524,13993,54072909,54466125,182615
18,ENSG00000187323.6,52340197,18-52499139-A-G,rs112391890,1,A,G,52499139,158942,52143589,52536805,355550
18,ENSG00000150637.3,69947873,18-69881391-G-A,rs1124980,-1,G,A,69881391,66482,69751265,70144481,130126
18,ENSG00000150637.3,69947873,18-69881391-G-T,rs1124980,-1,G,T,69881391,66482,69751265,70144481,130126
18,ENSG00000085415.10,12948011,18-12991394-T-A,rs11663049,1,T,A,12991394,43383,12751403,13144619,239991
18,ENSG00000085415.10,12948011,18-12991394-T-C,rs11663049,1,T,C,12991394,43383,12751403,13144619,239991
18,ENSG00000141458.5,23586506,18-23487112-A-G,rs11663645,-1,A,G,23487112,99394,23389898,23783114,97214
18,ENSG00000141458.5,23586506,18-23487112-A-C,rs11663645,-1,A,C,23487112,99394,23389898,23783114,97214
18,ENSG00000119541.4,63422476,18-63429686-T-C,rs118023911,-1,T,C,63429686,7210,63225868,63619084,203818
18,ENSG00000166377.13,79069394,18-79152854-A-G,rs11874851,1,A,G,79152854,83460,78872786,79266002,280068
18,ENSG00000141434.6,32190039,18-32014377-C-T,rs11875344,1,C,T,32014377,175662,31993431,32386647,20946
18,ENSG00000141434.6,32190039,18-32014377-C-A,rs11875344,1,C,A,32014377,175662,31993431,32386647,20946
18,ENSG00000075336.6,74148523,18-74093984-A-G,rs11876260,1,A,G,74093984,54539,73951915,74345131,142069
18,ENSG00000206418.2,8609437,18-8553600-C-T,rs11876268,1,C,T,8553600,55837,8412829,8806045,140771
18,ENSG00000170579.8,4455307,18-4491031-T-C,rs12150808,-1,T,C,4491031,35724,4258699,4651915,232332
18,ENSG00000170579.8,4455307,18-4491031-T-A,rs12150808,-1,T,A,4491031,35724,4258699,4651915,232332
18,ENSG00000134444.8,62187255,18-62161754-A-G,rs12327015,1,A,G,62161754,25501,61990647,62383863,171107
18,ENSG00000197705.4,32773023,18-32703014-A-G,rs12455936,-1,A,G,32703014,70009,32576415,32969631,126599
18,ENSG00000152223.6,45967329,18-45843159-C-G,rs12458195,-1,C,G,45843159,124170,45770721,46163937,72438
18,ENSG00000152223.6,45967329,18-45843159-C-T,rs12458195,-1,C,T,45843159,124170,45770721,46163937,72438
18,ENSG00000141664.4,62523025,18-62428753-T-C,rs12607917,1,T,C,62428753,94272,62326417,62719633,102336
18,ENSG00000141664.4,62523025,18-62428753-T-A,rs12607917,1,T,A,62428753,94272,62326417,62719633,102336
18,ENSG00000177576.5,49487234,18-49509185-A-T,rs12954680,-1,A,T,49509185,21951,49290626,49683842,218559
18,ENSG00000177576.5,49487234,18-49509185-A-C,rs12954680,-1,A,C,49509185,21951,49290626,49683842,218559
18,ENSG00000177576.5,49487234,18-49509185-A-G,rs12954680,-1,A,G,49509185,21951,49290626,49683842,218559
18,ENSG00000134278.9,12658107,18-12593637-G-A,rs12955162,-1,G,A,12593637,64470,12461499,12854715,132138
18,ENSG00000128789.13,12703042,18-12669613-C-A,rs12965990,1,C,A,12669613,33429,12506434,12899650,163179
18,ENSG00000128789.13,12703042,18-12669613-C-G,rs12965990,1,C,G,12669613,33429,12506434,12899650,163179
18,ENSG00000118680.7,3262133,18-3246826-G-A,rs1443129,1,G,A,3246826,15307,3065525,3458741,181301
18,ENSG00000141437.5,31760880,18-31576019-T-C,rs1449083,-1,T,C,31576019,184861,31564272,31957488,11747
18,ENSG00000167220.5,47150500,18-47147723-C-T,rs16948914,-1,C,T,47147723,2777,46953892,47347108,193831
18,ENSG00000134030.7,48539031,18-48579990-T-G,rs16949525,1,T,G,48579990,40959,48342423,48735639,237567
18,ENSG00000176105.8,812242,18-807819-A-G,rs16950778,-1,A,G,807819,4423,615634,1008850,192185
18,ENSG00000118276.6,31684581,18-31652330-T-C,rs16962266,-1,T,C,31652330,32251,31487973,31881189,164357
18,ENSG00000134758.8,32091874,18-31986219-T-A,rs16962615,1,T,A,31986219,105655,31895266,32288482,90953
18,ENSG00000134758.8,32091874,18-31986219-T-C,rs16962615,1,T,C,31986219,105655,31895266,32288482,90953
18,ENSG00000132874.6,45615476,18-45565606-G-C,rs16978406,1,G,C,45565606,49870,45418868,45812084,146738
18,ENSG00000132874.6,45615476,18-45565606-G-A,rs16978406,1,G,A,45565606,49870,45418868,45812084,146738
18,ENSG00000166342.13,72867987,18-72852066-T-C,rs17086484,-1,T,C,72852066,15921,72671379,73064595,180687
18,ENSG00000166342.13,72867987,18-72852066-T-A,rs17086484,-1,T,A,72852066,15921,72671379,73064595,180687
18,ENSG00000141425.11,36067559,18-36132745-G-A,rs17672308,-1,G,A,36132745,65186,35870951,36264167,261794
18,ENSG00000183287.7,59697423,18-59874574-G-A,rs17771727,-1,G,A,59874574,177151,59500815,59894031,373759
18,ENSG00000183287.7,59697423,18-59874574-G-C,rs17771727,-1,G,C,59874574,177151,59500815,59894031,373759
18,ENSG00000141447.11,24397824,18-24540972-T-C,rs17798101,-1,T,C,24540972,143148,24201216,24594432,339756
18,ENSG00000122490.12,79951653,18-79942025-T-A,rs1835410,-1,T,A,79942025,9628,79755045,80148261,186980
18,ENSG00000122490.12,79951653,18-79942025-T-C,rs1835410,-1,T,C,79942025,9628,79755045,80148261,186980
18,ENSG00000168461.6,9708301,18-9712101-C-T,rs1893126,1,C,T,9712101,3800,9511693,9904909,200408
18,ENSG00000154845.10,9614559,18-9712101-C-T,rs1893126,-1,C,T,9712101,97542,9417951,9811167,294150
18,ENSG00000134755.9,31102421,18-31062536-C-T,rs2019624,-1,C,T,31062536,39885,30905813,31299029,156723
18,ENSG00000134755.9,31102421,18-31062536-C-A,rs2019624,-1,C,A,31062536,39885,30905813,31299029,156723
18,ENSG00000178184.10,80247514,18-80178889-A-C,rs2030336,-1,A,C,80178889,68625,80050906,80444122,127983
18,ENSG00000178184.10,80247514,18-80178889-A-G,rs2030336,-1,A,G,80178889,68625,80050906,80444122,127983
18,ENSG00000178184.10,80247514,18-80178889-A-T,rs2030336,-1,A,T,80178889,68625,80050906,80444122,127983
18,ENSG00000017797.6,9475513,18-9661018-T-G,rs2124299,1,T,G,9661018,185505,9278905,9672121,382113
18,ENSG00000017797.6,9475513,18-9661018-T-A,rs2124299,1,T,A,9661018,185505,9278905,9672121,382113
18,ENSG00000017797.6,9475513,18-9661018-T-C,rs2124299,1,T,C,9661018,185505,9278905,9672121,382113
18,ENSG00000175322.5,14132435,18-14026536-G-A,rs2192169,-1,G,A,14026536,105899,13935827,14329043,90709
18,ENSG00000175322.5,14132435,18-14026536-G-C,rs2192169,-1,G,C,14026536,105899,13935827,14329043,90709
18,ENSG00000176890.10,657653,18-675787-C-G,rs2260821,1,C,G,675787,18134,461045,854261,214742
18,ENSG00000176890.10,657653,18-675787-C-T,rs2260821,1,C,T,675787,18134,461045,854261,214742
18,ENSG00000176890.10,657653,18-675787-C-A,rs2260821,1,C,A,675787,18134,461045,854261,214742
18,ENSG00000066926.5,57586702,18-57571588-A-T,rs2272783,-1,A,T,57571588,15114,57390094,57783310,181494
18,ENSG00000066926.5,57586702,18-57571588-A-C,rs2272783,-1,A,C,57571588,15114,57390094,57783310,181494
18,ENSG00000066926.5,57586702,18-57571588-A-G,rs2272783,-1,A,G,57571588,15114,57390094,57783310,181494
18,ENSG00000101638.7,46757053,18-46763291-C-A,rs2298777,-1,C,A,46763291,6238,46560445,46953661,202846
18,ENSG00000101638.7,46757053,18-46763291-C-T,rs2298777,-1,C,T,46763291,6238,46560445,46953661,202846
18,ENSG00000175354.11,12884237,18-12779948-G-T,rs2542151,-1,G,T,12779948,104289,12687629,13080845,92319
18,ENSG00000132199.11,712630,18-688463-G-C,rs2612088,-1,G,C,688463,24167,516022,909238,172441
18,ENSG00000132199.11,712630,18-688463-G-A,rs2612088,-1,G,A,688463,24167,516022,909238,172441
18,ENSG00000132199.11,712630,18-688463-G-T,rs2612088,-1,G,T,688463,24167,516022,909238,172441
18,ENSG00000158270.9,500701,18-462289-T-A,rs2846669,-1,T,A,462289,38412,304093,697309,158196
18,ENSG00000158270.9,500701,18-462289-T-C,rs2846669,-1,T,C,462289,38412,304093,697309,158196
18,ENSG00000158270.9,500701,18-462289-T-G,rs2846669,-1,T,G,462289,38412,304093,697309,158196
18,ENSG00000082212.6,50879118,18-50896529-T-C,rs2850544,1,T,C,50896529,17411,50682510,51075726,214019
18,ENSG00000082212.6,50879118,18-50896529-T-A,rs2850544,1,T,A,50896529,17411,50682510,51075726,214019
18,ENSG00000101695.3,32018825,18-32091547-T-G,rs28538314,1,T,G,32091547,72722,31822217,32215433,269330
18,ENSG00000101695.3,32018825,18-32091547-T-C,rs28538314,1,T,C,32091547,72722,31822217,32215433,269330
18,ENSG00000101544.4,80109262,18-80197495-C-T,rs2886235,1,C,T,80197495,88233,79912654,80305870,284841
18,ENSG00000178127.7,9102699,18-9288499-A-G,rs2902783,1,A,G,9288499,185800,8906091,9299307,382408
18,ENSG00000186496.4,35377337,18-35379433-C-T,rs2978362,-1,C,T,35379433,2096,35180729,35573945,198704
18,ENSG00000101624.5,12702723,18-12727144-G-T,rs34040888,-1,G,T,12727144,24421,12506115,12899331,221029
18,ENSG00000153391.9,35497960,18-35492920-T-G,rs355327,-1,T,G,35492920,5040,35301352,35694568,191568
18,ENSG00000153391.9,35497960,18-35492920-T-A,rs355327,-1,T,A,35492920,5040,35301352,35694568,191568
18,ENSG00000153391.9,35497960,18-35492920-T-C,rs355327,-1,T,C,35492920,5040,35301352,35694568,191568
18,ENSG00000141429.6,35581740,18-35499248-T-G,rs355338,1,T,G,35499248,82492,35385132,35778348,114116
18,ENSG00000141429.6,35581740,18-35499248-T-A,rs355338,1,T,A,35499248,82492,35385132,35778348,114116
18,ENSG00000141429.6,35581740,18-35499248-T-C,rs355338,1,T,C,35499248,82492,35385132,35778348,114116
18,ENSG00000154839.4,50375046,18-50327002-C-G,rs35802264,1,C,G,50327002,48044,50178438,50571654,148564
18,ENSG00000154839.4,50375046,18-50327002-C-T,rs35802264,1,C,T,50327002,48044,50178438,50571654,148564
18,ENSG00000101546.7,80034434,18-80045949-A-C,rs3744873,1,A,C,80045949,11515,79837826,80231042,208123
18,ENSG00000078142.4,41955234,18-42004300-C-T,rs3819162,1,C,T,42004300,49066,41758626,42151842,245674
18,ENSG00000078142.4,41955234,18-42004300-C-G,rs3819162,1,C,G,42004300,49066,41758626,42151842,245674
18,ENSG00000101605.7,3219968,18-3246393-C-G,rs3819221,-1,C,G,3246393,26425,3023360,3416576,223033
18,ENSG00000101605.7,3219968,18-3246393-C-T,rs3819221,-1,C,T,3246393,26425,3023360,3416576,223033
18,ENSG00000154889.11,11908317,18-11892846-A-G,rs3974590,-1,A,G,11892846,15471,11711709,12104925,181137
18,ENSG00000141682.10,59899996,18-59909081-C-G,rs4447521,1,C,G,59909081,9085,59703388,60096604,205693
18,ENSG00000141682.10,59899996,18-59909081-C-T,rs4447521,1,C,T,59909081,9085,59703388,60096604,205693
18,ENSG00000197046.4,45825675,18-45831225-C-A,rs477397,1,C,A,45831225,5550,45629067,46022283,202158
18,ENSG00000197046.4,45825675,18-45831225-C-G,rs477397,1,C,G,45831225,5550,45629067,46022283,202158
18,ENSG00000197046.4,45825675,18-45831225-C-T,rs477397,1,C,T,45831225,5550,45629067,46022283,202158
18,ENSG00000177150.7,13726558,18-13782868-A-C,rs4797816,-1,A,C,13782868,56310,13529950,13923166,252918
18,ENSG00000177150.7,13726558,18-13782868-A-T,rs4797816,-1,A,T,13782868,56310,13529950,13923166,252918
18,ENSG00000177150.7,13726558,18-13782868-A-G,rs4797816,-1,A,G,13782868,56310,13529950,13923166,252918
18,ENSG00000226742.2,79964643,18-79976735-T-A,rs4799116,1,T,A,79976735,12092,79768035,80161251,208700
18,ENSG00000226742.2,79964643,18-79976735-T-C,rs4799116,1,T,C,79976735,12092,79768035,80161251,208700
18,ENSG00000226742.2,79964643,18-79976735-T-G,rs4799116,1,T,G,79976735,12092,79768035,80161251,208700
18,ENSG00000172175.7,58671465,18-58602505-A-T,rs4940730,1,A,T,58602505,68960,58474857,58868073,127648
18,ENSG00000172175.7,58671465,18-58602505-A-G,rs4940730,1,A,G,58602505,68960,58474857,58868073,127648
18,ENSG00000197563.4,62187056,18-62084098-A-T,rs4941107,-1,A,T,62084098,102958,61990448,62383664,93650
18,ENSG00000197563.4,62187056,18-62084098-A-G,rs4941107,-1,A,G,62084098,102958,61990448,62383664,93650
18,ENSG00000197563.4,62187056,18-62084098-A-C,rs4941107,-1,A,C,62084098,102958,61990448,62383664,93650
18,ENSG00000130856.10,76822557,18-76886452-C-T,rs517637,1,C,T,76886452,63895,76625949,77019165,260503
18,ENSG00000166974.5,35041413,18-35071832-C-T,rs527789,1,C,T,35071832,30419,34844805,35238021,227027
18,ENSG00000166974.5,35041413,18-35071832-C-G,rs527789,1,C,G,35071832,30419,34844805,35238021,227027
18,ENSG00000166974.5,35041413,18-35071832-C-A,rs527789,1,C,A,35071832,30419,34844805,35238021,227027
18,ENSG00000134265.6,10526027,18-10524456-A-G,rs544553,1,A,G,10524456,1571,10329419,10722635,195037
18,ENSG00000134265.6,10526027,18-10524456-A-C,rs544553,1,A,C,10524456,1571,10329419,10722635,195037
18,ENSG00000134265.6,10526027,18-10524456-A-T,rs544553,1,A,T,10524456,1571,10329419,10722635,195037
18,ENSG00000176225.7,70205687,18-70387670-C-G,rs55717492,-1,C,G,70387670,181983,70009079,70402295,378591
18,ENSG00000176014.6,12308241,18-12318060-A-G,rs58136410,1,A,G,12318060,9819,12111633,12504849,206427
18,ENSG00000176014.6,12308241,18-12318060-A-C,rs58136410,1,A,C,12318060,9819,12111633,12504849,206427
18,ENSG00000166845.8,54357906,18-54314777-T-G,rs601995,1,T,G,54314777,43129,54161298,54554514,153479
18,ENSG00000166845.8,54357906,18-54314777-T-A,rs601995,1,T,A,54314777,43129,54161298,54554514,153479
18,ENSG00000255112.1,11851413,18-11882269-T-A,rs602201,1,T,A,11882269,30856,11654805,12048021,227464
18,ENSG00000134759.9,36129899,18-36178473-A-G,rs610492,1,A,G,36178473,48574,35933291,36326507,245182
18,ENSG00000134762.11,31042742,18-31069009-C-T,rs61731921,-1,C,T,31069009,26267,30846134,31239350,222875
18,ENSG00000134762.11,31042742,18-31069009-C-A,rs61731921,-1,C,A,31069009,26267,30846134,31239350,222875
18,ENSG00000101577.4,3013144,18-2968754-C-G,rs625527,-1,C,G,2968754,44390,2816536,3209752,152218
18,ENSG00000101577.4,3013144,18-2968754-C-A,rs625527,-1,C,A,2968754,44390,2816536,3209752,152218
18,ENSG00000179981.8,75210797,18-75264387-G-A,rs6566069,1,G,A,75264387,53590,75014189,75407405,250198
18,ENSG00000101596.8,2655726,18-2641859-C-T,rs7229070,1,C,T,2641859,13867,2459118,2852334,182741
18,ENSG00000242550.1,63907958,18-63895157-A-C,rs7229383,1,A,C,63895157,12801,63711350,64104566,183807
18,ENSG00000180011.5,75209139,18-75202325-G-A,rs7230037,-1,G,A,75202325,6814,75012531,75405747,189794
18,ENSG00000134049.3,47176364,18-47277739-A-C,rs7231801,-1,A,C,47277739,101375,46979756,47372972,297983
18,ENSG00000167216.10,46917602,18-46776717-T-G,rs7240457,1,T,G,46776717,140885,46720994,47114210,55723
18,ENSG00000167216.10,46917602,18-46776717-T-C,rs7240457,1,T,C,46776717,140885,46720994,47114210,55723
18,ENSG00000166562.3,59139884,18-59141274-G-A,rs7241012,1,G,A,59141274,1390,58943276,59336492,197998
18,ENSG00000166562.3,59139884,18-59141274-G-C,rs7241012,1,G,C,59141274,1390,58943276,59336492,197998
18,ENSG00000101489.10,37565798,18-37495287-A-G,rs72891035,-1,A,G,37495287,70511,37369190,37762406,126097
18,ENSG00000152234.7,46098296,18-46099143-T-C,rs72903438,-1,T,C,46099143,847,45901688,46294904,197455
18,ENSG00000046604.7,31498177,18-31493410-C-T,rs72938851,1,C,T,31493410,4767,31301569,31694785,191841
18,ENSG00000101493.6,76495242,18-76461482-A-C,rs72982096,-1,A,C,76461482,33760,76298634,76691850,162848
18,ENSG00000101752.6,21740792,18-21703245-T-C,rs73963238,1,T,C,21703245,37547,21544184,21937400,159061
18,ENSG00000101752.6,21740792,18-21703245-T-G,rs73963238,1,T,G,21703245,37547,21544184,21937400,159061
18,ENSG00000101574.9,2571505,18-2533131-T-C,rs770224,-1,T,C,2533131,38374,2374897,2768113,158234
18,ENSG00000141449.8,21242232,18-21255192-C-G,rs77838622,1,C,G,21255192,12960,21045624,21438840,209568
18,ENSG00000141449.8,21242232,18-21255192-C-T,rs77838622,1,C,T,21255192,12960,21045624,21438840,209568
18,ENSG00000133313.9,74496363,18-74510230-A-G,rs8084058,1,A,G,74510230,13867,74299755,74692971,210475
18,ENSG00000186814.5,35290229,18-35291918-C-T,rs8089948,-1,C,T,35291918,1689,35093621,35486837,198297
18,ENSG00000101608.5,3247801,18-3267402-A-C,rs8097802,1,A,C,3267402,19601,3051193,3444409,216209
18,ENSG00000101608.5,3247801,18-3267402-A-T,rs8097802,1,A,T,3267402,19601,3051193,3444409,216209
18,ENSG00000101608.5,3247801,18-3267402-A-G,rs8097802,1,A,G,3267402,19601,3051193,3444409,216209
18,ENSG00000198081.5,5295726,18-5246399-C-T,rs8576,-1,C,T,5246399,49327,5099118,5492334,147281
18,ENSG00000141385.3,12377227,18-12301323-T-C,rs9303768,-1,T,C,12301323,75904,12180619,12573835,120704
18,ENSG00000101745.9,9136781,18-8984512-C-T,rs9304026,1,C,T,8984512,152269,8940173,9333389,44339
18,ENSG00000079134.6,268047,18-165503-G-A,rs948263,-1,G,A,165503,102544,71439,464655,94064
18,ENSG00000079134.6,268047,18-165503-G-T,rs948263,-1,G,T,165503,102544,71439,464655,94064
18,ENSG00000141404.7,11689264,18-11788535-A-G,rs9676233,1,A,G,11788535,99271,11492656,11885872,295879
18,ENSG00000166401.9,63970081,18-63953532-G-A,rs9945924,1,G,A,63953532,16549,63773473,64166689,180059
18,ENSG00000166401.9,63970081,18-63953532-G-C,rs9945924,1,G,C,63953532,16549,63773473,64166689,180059
18,ENSG00000221887.4,63949301,18-63953532-G-A,rs9945924,1,G,A,63953532,4231,63752693,64145909,200839
18,ENSG00000221887.4,63949301,18-63953532-G-C,rs9945924,1,G,C,63953532,4231,63752693,64145909,200839
18,ENSG00000141380.8,26090613,18-26091223-G-T,rs994729,-1,G,T,26091223,610,25894005,26287221,197218
18,ENSG00000141380.8,26090613,18-26091223-G-A,rs994729,-1,G,A,26091223,610,25894005,26287221,197218
18,ENSG00000172466.9,35344420,18-35325746-T-C,rs9951480,-1,T,C,35325746,18674,35147812,35541028,177934
18,ENSG00000172466.9,35344420,18-35325746-T-G,rs9951480,-1,T,G,35325746,18674,35147812,35541028,177934
18,ENSG00000172466.9,35344420,18-35325746-T-A,rs9951480,-1,T,A,35325746,18674,35147812,35541028,177934
18,ENSG00000141452.3,23503511,18-23502740-T-C,rs9954865,1,T,C,23502740,771,23306903,23700119,195837
18,ENSG00000141428.10,35972679,18-35987098-T-C,rs9956938,1,T,C,35987098,14419,35776071,36169287,211027
18,ENSG00000141428.10,35972679,18-35987098-T-A,rs9956938,1,T,A,35987098,14419,35776071,36169287,211027
18,ENSG00000186812.6,35241034,18-35334640-C-T,rs9958086,1,C,T,35334640,93606,35044426,35437642,290214
18,ENSG00000186812.6,35241034,18-35334640-C-G,rs9958086,1,C,G,35334640,93606,35044426,35437642,290214
18,ENSG00000141469.9,45724181,18-45692233-T-G,rs9959467,1,T,G,45692233,31948,45527573,45920789,164660
18,ENSG00000141469.9,45724181,18-45692233-T-A,rs9959467,1,T,A,45692233,31948,45527573,45920789,164660
18,ENSG00000141469.9,45724181,18-45692233-T-C,rs9959467,1,T,C,45692233,31948,45527573,45920789,164660
18,ENSG00000152240.4,46104385,18-46057277-G-A,rs9966603,1,G,A,46057277,47108,45907777,46300993,149500
18,ENSG00000152240.4,46104385,18-46057277-G-C,rs9966603,1,G,C,46057277,47108,45907777,46300993,149500
18,ENSG00000141384.6,26226445,18-26201546-A-G,rs10468885,1,A,G,26201546,24899,26029837,26423053,171709
18,ENSG00000221887.4,63949301,18-63809220-G-C,rs10503087,1,G,C,63809220,140081,63752693,64145909,56527
18,ENSG00000221887.4,63949301,18-63809220-G-T,rs10503087,1,G,T,63809220,140081,63752693,64145909,56527
18,ENSG00000198796.5,58629091,18-58564676-C-T,rs111521599,-1,C,T,58564676,64415,58432483,58825699,132193
18,ENSG00000152223.6,45967329,18-45871966-G-C,rs11663670,-1,G,C,45871966,95363,45770721,46163937,101245
18,ENSG00000152223.6,45967329,18-45871966-G-A,rs11663670,-1,G,A,45871966,95363,45770721,46163937,101245
18,ENSG00000141424.6,36129340,18-36060616-G-A,rs118148296,-1,G,A,36060616,68724,35932732,36325948,127884
18,ENSG00000130856.10,76822557,18-76946479-G-T,rs118181340,1,G,T,76946479,123922,76625949,77019165,320530
18,ENSG00000091157.7,56651359,18-56516863-C-T,rs11873188,1,C,T,56516863,134496,56454751,56847967,62112
18,ENSG00000141469.9,45724181,18-45727281-C-T,rs11877062,1,C,T,45727281,3100,45527573,45920789,199708
18,ENSG00000101546.7,80034434,18-79918327-A-T,rs12454768,1,A,T,79918327,116107,79837826,80231042,80501
18,ENSG00000101546.7,80034434,18-79918327-A-G,rs12454768,1,A,G,79918327,116107,79837826,80231042,80501
18,ENSG00000128791.6,9334773,18-9357499-A-C,rs12455836,1,A,C,9357499,22726,9138165,9531381,219334
18,ENSG00000141644.12,50281523,18-50184289-T-G,rs12457149,-1,T,G,50184289,97234,50084915,50478131,99374
18,ENSG00000141644.12,50281523,18-50184289-T-A,rs12457149,-1,T,A,50184289,97234,50084915,50478131,99374
18,ENSG00000178184.10,80247514,18-80208397-G-T,rs12960187,-1,G,T,80208397,39117,80050906,80444122,157491
18,ENSG00000178184.10,80247514,18-80208397-G-A,rs12960187,-1,G,A,80208397,39117,80050906,80444122,157491
18,ENSG00000141759.9,79988563,18-80034810-G-A,rs12964779,-1,G,A,80034810,46247,79791955,80185171,242855
18,ENSG00000141759.9,79988563,18-80034810-G-C,rs12964779,-1,G,C,80034810,46247,79791955,80185171,242855
18,ENSG00000177426.14,3450172,18-3594106-C-A,rs12967944,1,C,A,3594106,143934,3253564,3646780,340542
18,ENSG00000177426.14,3450172,18-3594106-C-G,rs12967944,1,C,G,3594106,143934,3253564,3646780,340542
18,ENSG00000119541.4,63422476,18-63503267-T-C,rs1455557,-1,T,C,63503267,80791,63225868,63619084,277399
18,ENSG00000119541.4,63422476,18-63503267-T-A,rs1455557,-1,T,A,63503267,80791,63225868,63619084,277399
18,ENSG00000158270.9,500701,18-486757-T-A,rs1480269,-1,T,A,486757,13944,304093,697309,182664
18,ENSG00000158270.9,500701,18-486757-T-C,rs1480269,-1,T,C,486757,13944,304093,697309,182664
18,ENSG00000134755.9,31102421,18-31197343-G-A,rs16961434,-1,G,A,31197343,94922,30905813,31299029,291530
18,ENSG00000153339.8,31943128,18-31903703-G-A,rs16962565,-1,G,A,31903703,39425,31746520,32139736,157183
18,ENSG00000134265.6,10526027,18-10531109-A-T,rs16974725,1,A,T,10531109,5082,10329419,10722635,201690
18,ENSG00000134265.6,10526027,18-10531109-A-G,rs16974725,1,A,G,10531109,5082,10329419,10722635,201690
18,ENSG00000141404.7,11689264,18-11561843-T-C,rs16976488,1,T,C,11561843,127421,11492656,11885872,69187
18,ENSG00000152217.10,44680888,18-44834455-G-T,rs16978191,1,G,T,44834455,153567,44484280,44877496,350175
18,ENSG00000152217.10,44680888,18-44834455-G-A,rs16978191,1,G,A,44834455,153567,44484280,44877496,350175
18,ENSG00000166401.9,63970081,18-64056205-T-G,rs17072514,1,T,G,64056205,86124,63773473,64166689,282732
18,ENSG00000166401.9,63970081,18-64056205-T-C,rs17072514,1,T,C,64056205,86124,63773473,64166689,282732
18,ENSG00000101577.4,3013144,18-2943797-C-G,rs17556090,-1,C,G,2943797,69347,2816536,3209752,127261
18,ENSG00000082212.6,50879118,18-50831970-G-A,rs17663462,1,G,A,50831970,47148,50682510,51075726,149460
18,ENSG00000082212.6,50879118,18-50831970-G-T,rs17663462,1,G,T,50831970,47148,50682510,51075726,149460
18,ENSG00000197705.4,32773023,18-32883856-T-C,rs17666735,-1,T,C,32883856,110833,32576415,32969631,307441
18,ENSG00000141639.6,50560087,18-50557151-C-T,rs17741772,1,C,T,50557151,2936,50363479,50756695,193672
18,ENSG00000242550.1,63907958,18-63775676-G-A,rs17781440,1,G,A,63775676,132282,63711350,64104566,64326
18,ENSG00000166347.12,74291963,18-74277951-T-C,rs1788638,-1,T,C,74277951,14012,74095355,74488571,182596
18,ENSG00000166347.12,74291963,18-74277951-T-G,rs1788638,-1,T,G,74277951,14012,74095355,74488571,182596
18,ENSG00000066926.5,57586702,18-57568045-T-A,rs1790619,-1,T,A,57568045,18657,57390094,57783310,177951
18,ENSG00000066926.5,57586702,18-57568045-T-C,rs1790619,-1,T,C,57568045,18657,57390094,57783310,177951
18,ENSG00000134762.11,31042742,18-31062163-G-T,rs1790694,-1,G,T,31062163,19421,30846134,31239350,216029
18,ENSG00000134762.11,31042742,18-31062163-G-A,rs1790694,-1,G,A,31062163,19421,30846134,31239350,216029
18,ENSG00000154864.6,11149569,18-11005558-A-C,rs1876371,-1,A,C,11005558,144011,10952961,11346177,52597
18,ENSG00000101670.5,49562057,18-49661607-G-C,rs1943979,1,G,C,49661607,99550,49365449,49758665,296158
18,ENSG00000101670.5,49562057,18-49661607-G-A,rs1943979,1,G,A,49661607,99550,49365449,49758665,296158
18,ENSG00000101665.3,48950965,18-48805987-G-A,rs1994559,-1,G,A,48805987,144978,48754357,49147573,51630
18,ENSG00000133313.9,74496363,18-74501373-G-C,rs2303463,1,G,C,74501373,5010,74299755,74692971,201618
18,ENSG00000133313.9,74496363,18-74501373-G-A,rs2303463,1,G,A,74501373,5010,74299755,74692971,201618
18,ENSG00000134779.8,36829002,18-36744413-A-T,rs2303508,-1,A,T,36744413,84589,36632394,37025610,112019
18,ENSG00000134779.8,36829002,18-36744413-A-G,rs2303508,-1,A,G,36744413,84589,36632394,37025610,112019
18,ENSG00000176890.10,657653,18-678847-T-C,rs2606246,1,T,C,678847,21194,461045,854261,217802
18,ENSG00000101574.9,2571505,18-2571847-A-G,rs2677895,-1,A,G,2571847,342,2374897,2768113,196950
18,ENSG00000175354.11,12884237,18-12821594-A-G,rs2847281,-1,A,G,12821594,62643,12687629,13080845,133965
18,ENSG00000132874.6,45615476,18-45724638-G-A,rs28994269,1,G,A,45724638,109162,45418868,45812084,305770
18,ENSG00000134030.7,48539031,18-48644253-T-G,rs299729,1,T,G,48644253,105222,48342423,48735639,301830
18,ENSG00000153391.9,35497960,18-35468590-C-T,rs3088182,-1,C,T,35468590,29370,35301352,35694568,167238
18,ENSG00000153391.9,35497960,18-35468590-C-G,rs3088182,-1,C,G,35468590,29370,35301352,35694568,167238
18,ENSG00000101544.4,80109262,18-79915085-T-C,rs35025619,1,T,C,79915085,194177,79912654,80305870,2431
18,ENSG00000101608.5,3247801,18-3170960-C-T,rs35331620,1,C,T,3170960,76841,3051193,3444409,119767
18,ENSG00000101596.8,2655726,18-2846501-T-C,rs3810068,1,T,C,2846501,190775,2459118,2852334,387383
18,ENSG00000154845.10,9614559,18-9704772-C-G,rs3897633,-1,C,G,9704772,90213,9417951,9811167,286821
18,ENSG00000154845.10,9614559,18-9704772-C-A,rs3897633,-1,C,A,9704772,90213,9417951,9811167,286821
18,ENSG00000226742.2,79964643,18-79961125-A-G,rs4081877,1,A,G,79961125,3518,79768035,80161251,193090
18,ENSG00000101638.7,46757053,18-46750641-T-C,rs4624284,-1,T,C,46750641,6412,46560445,46953661,190196
18,ENSG00000101638.7,46757053,18-46750641-T-G,rs4624284,-1,T,G,46750641,6412,46560445,46953661,190196
18,ENSG00000101638.7,46757053,18-46750641-T-A,rs4624284,-1,T,A,46750641,6412,46560445,46953661,190196
18,ENSG00000101605.7,3219968,18-3247258-A-C,rs4798075,-1,A,C,3247258,27290,3023360,3416576,223898
18,ENSG00000101605.7,3219968,18-3247258-A-T,rs4798075,-1,A,T,3247258,27290,3023360,3416576,223898
18,ENSG00000134758.8,32091874,18-32159267-A-G,rs4799636,1,A,G,32159267,67393,31895266,32288482,264001
18,ENSG00000167315.10,49813533,18-49619613-A-G,rs4939879,-1,A,G,49619613,193920,49616925,50010141,2688
18,ENSG00000171791.9,63319769,18-63126688-T-C,rs4987852,-1,T,C,63126688,193081,63123161,63516377,3527
18,ENSG00000079134.6,268047,18-208998-G-A,rs617421,-1,G,A,208998,59049,71439,464655,137559
18,ENSG00000179981.8,75210797,18-75258246-G-A,rs62089819,1,G,A,75258246,47449,75014189,75407405,244057
18,ENSG00000167216.10,46917602,18-47095011-A-C,rs62095459,1,A,C,47095011,177409,46720994,47114210,374017
18,ENSG00000167216.10,46917602,18-47095011-A-T,rs62095459,1,A,T,47095011,177409,46720994,47114210,374017
18,ENSG00000101751.5,54269517,18-54253095-C-G,rs635857,1,C,G,54253095,16422,54072909,54466125,180186
18,ENSG00000101751.5,54269517,18-54253095-C-A,rs635857,1,C,A,54253095,16422,54072909,54466125,180186
18,ENSG00000176014.6,12308241,18-12280923-A-G,rs6505744,1,A,G,12280923,27318,12111633,12504849,169290
18,ENSG00000176014.6,12308241,18-12280923-A-C,rs6505744,1,A,C,12280923,27318,12111633,12504849,169290
18,ENSG00000176014.6,12308241,18-12280923-A-T,rs6505744,1,A,T,12280923,27318,12111633,12504849,169290
18,ENSG00000101639.11,12991362,18-12976468-G-A,rs6505774,1,G,A,12976468,14894,12794754,13187970,181714
18,ENSG00000101639.11,12991362,18-12976468-G-T,rs6505774,1,G,T,12976468,14894,12794754,13187970,181714
18,ENSG00000168234.6,24014754,18-23988403-C-T,rs6508073,1,C,T,23988403,26351,23818146,24211362,170257
18,ENSG00000134046.6,54224669,18-54316312-C-A,rs665445,-1,C,A,54316312,91643,54028061,54421277,288251
18,ENSG00000166845.8,54357906,18-54285043-G-A,rs669442,1,G,A,54285043,72863,54161298,54554514,123745
18,ENSG00000118680.7,3262133,18-3252926-A-G,rs717183,1,A,G,3252926,9207,3065525,3458741,187401
18,ENSG00000118680.7,3262133,18-3252926-A-T,rs717183,1,A,T,3252926,9207,3065525,3458741,187401
18,ENSG00000168461.6,9708301,18-9723766-C-T,rs7229181,1,C,T,9723766,15465,9511693,9904909,212073
18,ENSG00000168461.6,9708301,18-9723766-C-A,rs7229181,1,C,A,9723766,15465,9511693,9904909,212073
18,ENSG00000168461.6,9708301,18-9723766-C-G,rs7229181,1,C,G,9723766,15465,9511693,9904909,212073
18,ENSG00000180011.5,75209139,18-75268918-T-C,rs7229426,-1,T,C,75268918,59779,75012531,75405747,256387
18,ENSG00000180011.5,75209139,18-75268918-T-G,rs7229426,-1,T,G,75268918,59779,75012531,75405747,256387
18,ENSG00000141665.6,74147834,18-73957932-T-C,rs7233034,-1,T,C,73957932,189902,73951226,74344442,6706
18,ENSG00000150637.3,69947873,18-69843831-A-G,rs7237652,-1,A,G,69843831,104042,69751265,70144481,92566
18,ENSG00000167220.5,47150500,18-47344209-T-C,rs7239153,-1,T,C,47344209,193709,46953892,47347108,390317
18,ENSG00000170677.4,70289045,18-70266469-G-A,rs7240210,1,G,A,70266469,22576,70092437,70485653,174032
18,ENSG00000154040.15,24139062,18-24193133-C-T,rs7242469,1,C,T,24193133,54071,23942454,24335670,250679
18,ENSG00000154040.15,24139062,18-24193133-C-G,rs7242469,1,C,G,24193133,54071,23942454,24335670,250679
18,ENSG00000166562.3,59139884,18-59204946-G-C,rs7244741,1,G,C,59204946,65062,58943276,59336492,261670
18,ENSG00000166562.3,59139884,18-59204946-G-A,rs7244741,1,G,A,59204946,65062,58943276,59336492,261670
18,ENSG00000166974.5,35041413,18-35215117-G-C,rs72953757,1,G,C,35215117,173704,34844805,35238021,370312
18,ENSG00000166974.5,35041413,18-35215117-G-T,rs72953757,1,G,T,35215117,173704,34844805,35238021,370312
18,ENSG00000152240.4,46104385,18-46209054-T-C,rs74427086,1,T,C,46209054,104669,45907777,46300993,301277
18,ENSG00000197563.4,62187056,18-62028865-G-C,rs746280,-1,G,C,62028865,158191,61990448,62383664,38417
18,ENSG00000101624.5,12702723,18-12568203-T-C,rs78167074,-1,T,C,12568203,134520,12506115,12899331,62088
18,ENSG00000141458.5,23586506,18-23586828-C-T,rs8083325,-1,C,T,23586828,322,23389898,23783114,196930
18,ENSG00000141380.8,26090613,18-25961494-G-A,rs8091309,-1,G,A,25961494,129119,25894005,26287221,67489
18,ENSG00000122490.12,79951653,18-80068684-C-G,rs8094631,-1,C,G,80068684,117031,79755045,80148261,313639
18,ENSG00000082397.10,5543997,18-5651994-T-G,rs8096594,-1,T,G,5651994,107997,5347389,5740605,304605
18,ENSG00000141391.8,12407929,18-12446690-G-T,rs919,1,G,T,12446690,38761,12211321,12604537,235369
18,ENSG00000176624.8,51197681,18-51140256-A-G,rs9949574,-1,A,G,51140256,57425,51001073,51394289,139183
18,ENSG00000132199.11,712630,18-709202-G-C,rs9952691,-1,G,C,709202,3428,516022,909238,193180
18,ENSG00000132199.11,712630,18-709202-G-A,rs9952691,-1,G,A,709202,3428,516022,909238,193180
18,ENSG00000172175.7,58671465,18-58567880-T-C,rs9957531,1,T,C,58567880,103585,58474857,58868073,93023
18,ENSG00000172175.7,58671465,18-58567880-T-G,rs9957531,1,T,G,58567880,103585,58474857,58868073,93023
18,ENSG00000085415.10,12948011,18-13007347-C-T,rs9957933,1,C,T,13007347,59336,12751403,13144619,255944
18,ENSG00000085415.10,12948011,18-13007347-C-A,rs9957933,1,C,A,13007347,59336,12751403,13144619,255944
18,ENSG00000141682.10,59899996,18-60061547-A-T,rs9959155,1,A,T,60061547,161551,59703388,60096604,358159
18,ENSG00000101782.9,23453287,18-23258322-G-A,rs10210,1,G,A,23258322,194965,23256679,23649895,1643
18,ENSG00000101782.9,23453287,18-23258322-G-T,rs10210,1,G,T,23258322,194965,23256679,23649895,1643
18,ENSG00000132199.11,712630,18-676789-A-T,rs10502289,-1,A,T,676789,35841,516022,909238,160767
18,ENSG00000134758.8,32091874,18-32217515-C-T,rs10502584,1,C,T,32217515,125641,31895266,32288482,322249
18,ENSG00000197046.4,45825675,18-45762168-A-G,rs10502870,1,A,G,45762168,63507,45629067,46022283,133101
18,ENSG00000197046.4,45825675,18-45762168-A-T,rs10502870,1,A,T,45762168,63507,45629067,46022283,133101
18,ENSG00000141664.4,62523025,18-62586528-C-G,rs1052315,1,C,G,62586528,63503,62326417,62719633,260111
18,ENSG00000141664.4,62523025,18-62586528-C-A,rs1052315,1,C,A,62586528,63503,62326417,62719633,260111
18,ENSG00000141664.4,62523025,18-62586528-C-T,rs1052315,1,C,T,62586528,63503,62326417,62719633,260111
18,ENSG00000141429.6,35581740,18-35468437-A-G,rs11659769,1,A,G,35468437,113303,35385132,35778348,83305
18,ENSG00000141429.6,35581740,18-35468437-A-T,rs11659769,1,A,T,35468437,113303,35385132,35778348,83305
18,ENSG00000074657.8,58864877,18-58933140-G-T,rs117001517,1,G,T,58933140,68263,58668269,59061485,264871
18,ENSG00000074657.8,58864877,18-58933140-G-A,rs117001517,1,G,A,58933140,68263,58668269,59061485,264871
18,ENSG00000134504.7,26548553,18-26464023-C-A,rs117338826,-1,C,A,26464023,84530,26351945,26745161,112078
18,ENSG00000153339.8,31943128,18-31866435-T-C,rs11872757,-1,T,C,31866435,76693,31746520,32139736,119915
18,ENSG00000196628.7,55588192,18-55629992-G-A,rs12104073,-1,G,A,55629992,41800,55391584,55784800,238408
18,ENSG00000196628.7,55588192,18-55629992-G-C,rs12104073,-1,G,C,55629992,41800,55391584,55784800,238408
18,ENSG00000177426.14,3450172,18-3597840-C-T,rs12455764,1,C,T,3597840,147668,3253564,3646780,344276
18,ENSG00000134049.3,47176364,18-47039036-T-G,rs12457793,-1,T,G,47039036,137328,46979756,47372972,59280
18,ENSG00000134049.3,47176364,18-47039036-T-C,rs12457793,-1,T,C,47039036,137328,46979756,47372972,59280
18,ENSG00000177150.7,13726558,18-13801920-C-A,rs12605682,-1,C,A,13801920,75362,13529950,13923166,271970
18,ENSG00000177150.7,13726558,18-13801920-C-G,rs12605682,-1,C,G,13801920,75362,13529950,13923166,271970
18,ENSG00000141622.7,46334018,18-46422305-C-A,rs12607419,1,C,A,46422305,88287,46137410,46530626,284895
18,ENSG00000166845.8,54357906,18-54506271-T-C,rs12955166,1,T,C,54506271,148365,54161298,54554514,344973
18,ENSG00000176014.6,12308241,18-12345823-C-A,rs12956849,1,C,A,12345823,37582,12111633,12504849,234190
18,ENSG00000178184.10,80247514,18-80249901-T-C,rs12970236,-1,T,C,80249901,2387,80050906,80444122,198995
18,ENSG00000074695.4,59359265,18-59429370-G-A,rs1444485,-1,G,A,59429370,70105,59162657,59555873,266713
18,ENSG00000118276.6,31684581,18-31705884-G-C,rs1667294,-1,G,C,31705884,21303,31487973,31881189,217911
18,ENSG00000175322.5,14132435,18-14101472-G-T,rs16941609,-1,G,T,14101472,30963,13935827,14329043,165645
18,ENSG00000101695.3,32018825,18-32195735-A-G,rs16962793,1,A,G,32195735,176910,31822217,32215433,373518
18,ENSG00000179981.8,75210797,18-75233313-A-G,rs17056699,1,A,G,75233313,22516,75014189,75407405,219124
18,ENSG00000134775.9,36297713,18-36431035-A-C,rs1708693,1,A,C,36431035,133322,36101105,36494321,329930
18,ENSG00000134775.9,36297713,18-36431035-A-G,rs1708693,1,A,G,36431035,133322,36101105,36494321,329930
18,ENSG00000134775.9,36297713,18-36431035-A-T,rs1708693,1,A,T,36431035,133322,36101105,36494321,329930
18,ENSG00000132205.5,2847006,18-2873941-C-G,rs17553620,1,C,G,2873941,26935,2650398,3043614,223543
18,ENSG00000141452.3,23503511,18-23517496-A-C,rs1788817,1,A,C,23517496,13985,23306903,23700119,210593
18,ENSG00000141452.3,23503511,18-23517496-A-T,rs1788817,1,A,T,23517496,13985,23306903,23700119,210593
18,ENSG00000141452.3,23503511,18-23517496-A-G,rs1788817,1,A,G,23517496,13985,23306903,23700119,210593
18,ENSG00000141458.5,23586506,18-23534953-A-C,rs1788823,-1,A,C,23534953,51553,23389898,23783114,145055
18,ENSG00000141458.5,23586506,18-23534953-A-G,rs1788823,-1,A,G,23534953,51553,23389898,23783114,145055
18,ENSG00000141458.5,23586506,18-23534953-A-T,rs1788823,-1,A,T,23534953,51553,23389898,23783114,145055
18,ENSG00000134769.14,34710298,18-34526454-A-G,rs1962503,1,A,G,34526454,183844,34513690,34906906,12764
18,ENSG00000178127.7,9102699,18-9028512-C-G,rs2032161,1,C,G,9028512,74187,8906091,9299307,122421
18,ENSG00000178127.7,9102699,18-9028512-C-T,rs2032161,1,C,T,9028512,74187,8906091,9299307,122421
18,ENSG00000186812.6,35241034,18-35337680-T-A,rs2032729,1,T,A,35337680,96646,35044426,35437642,293254
18,ENSG00000186812.6,35241034,18-35337680-T-C,rs2032729,1,T,C,35337680,96646,35044426,35437642,293254
18,ENSG00000166562.3,59139884,18-59153086-G-T,rs2085632,1,G,T,59153086,13202,58943276,59336492,209810
18,ENSG00000166562.3,59139884,18-59153086-G-C,rs2085632,1,G,C,59153086,13202,58943276,59336492,209810
18,ENSG00000175354.11,12884237,18-12772319-C-A,rs2542145,-1,C,A,12772319,111918,12687629,13080845,84690
18,ENSG00000175354.11,12884237,18-12772319-C-T,rs2542145,-1,C,T,12772319,111918,12687629,13080845,84690
18,ENSG00000101639.11,12991362,18-12817816-A-G,rs2847286,1,A,G,12817816,173546,12794754,13187970,23062
18,ENSG00000134440.6,57621836,18-57671424-G-C,rs317838,-1,G,C,57671424,49588,57425228,57818444,246196
18,ENSG00000134440.6,57621836,18-57671424-G-T,rs317838,-1,G,T,57671424,49588,57425228,57818444,246196
18,ENSG00000134440.6,57621836,18-57671424-G-A,rs317838,-1,G,A,57671424,49588,57425228,57818444,246196
18,ENSG00000133313.9,74496363,18-74507221-C-T,rs36089221,1,C,T,74507221,10858,74299755,74692971,207466
18,ENSG00000133313.9,74496363,18-74507221-C-G,rs36089221,1,C,G,74507221,10858,74299755,74692971,207466
18,ENSG00000066926.5,57586702,18-57620295-C-T,rs3745063,-1,C,T,57620295,33593,57390094,57783310,230201
18,ENSG00000066926.5,57586702,18-57620295-C-G,rs3745063,-1,C,G,57620295,33593,57390094,57783310,230201
18,ENSG00000154040.15,24139062,18-24129035-G-A,rs3816822,1,G,A,24129035,10027,23942454,24335670,186581
18,ENSG00000168461.6,9708301,18-9704772-C-A,rs3897633,1,C,A,9704772,3529,9511693,9904909,193079
18,ENSG00000168461.6,9708301,18-9704772-C-G,rs3897633,1,C,G,9704772,3529,9511693,9904909,193079
18,ENSG00000186814.5,35290229,18-35377319-C-T,rs4291985,-1,C,T,35377319,87090,35093621,35486837,283698
18,ENSG00000186814.5,35290229,18-35377319-C-G,rs4291985,-1,C,G,35377319,87090,35093621,35486837,283698
18,ENSG00000101654.11,13726673,18-13726082-G-C,rs4393641,1,G,C,13726082,591,13530065,13923281,196017
18,ENSG00000101654.11,13726673,18-13726082-G-A,rs4393641,1,G,A,13726082,591,13530065,13923281,196017
18,ENSG00000215421.4,74597870,18-74626357-A-C,rs4606815,1,A,C,74626357,28487,74401262,74794478,225095
18,ENSG00000215421.4,74597870,18-74626357-A-G,rs4606815,1,A,G,74626357,28487,74401262,74794478,225095
18,ENSG00000079134.6,268047,18-139767-C-T,rs4797697,-1,C,T,139767,128280,71439,464655,68328
18,ENSG00000079134.6,268047,18-139767-C-G,rs4797697,-1,C,G,139767,128280,71439,464655,68328
18,ENSG00000079134.6,268047,18-139767-C-A,rs4797697,-1,C,A,139767,128280,71439,464655,68328
18,ENSG00000118680.7,3262133,18-3363597-T-G,rs4798085,1,T,G,3363597,101464,3065525,3458741,298072
18,ENSG00000118680.7,3262133,18-3363597-T-A,rs4798085,1,T,A,3363597,101464,3065525,3458741,298072
18,ENSG00000118680.7,3262133,18-3363597-T-C,rs4798085,1,T,C,3363597,101464,3065525,3458741,298072
18,ENSG00000141380.8,26090613,18-26106125-A-G,rs4800715,-1,A,G,26106125,15512,25894005,26287221,212120
18,ENSG00000141380.8,26090613,18-26106125-A-T,rs4800715,-1,A,T,26106125,15512,25894005,26287221,212120
18,ENSG00000141391.8,12407929,18-12447304-C-T,rs496485,1,C,T,12447304,39375,12211321,12604537,235983
18,ENSG00000141391.8,12407929,18-12447304-C-G,rs496485,1,C,G,12447304,39375,12211321,12604537,235983
18,ENSG00000141391.8,12407929,18-12447304-C-A,rs496485,1,C,A,12447304,39375,12211321,12604537,235983
18,ENSG00000134265.6,10526027,18-10690681-G-C,rs56126774,1,G,C,10690681,164654,10329419,10722635,361262
18,ENSG00000134265.6,10526027,18-10690681-G-A,rs56126774,1,G,A,10690681,164654,10329419,10722635,361262
18,ENSG00000134265.6,10526027,18-10690681-G-T,rs56126774,1,G,T,10690681,164654,10329419,10722635,361262
18,ENSG00000178342.3,79797938,18-79755031-G-A,rs58190761,1,G,A,79755031,42907,79601330,79994546,153701
18,ENSG00000197563.4,62187056,18-61999661-G-A,rs583339,-1,G,A,61999661,187395,61990448,62383664,9213
18,ENSG00000197563.4,62187056,18-61999661-G-C,rs583339,-1,G,C,61999661,187395,61990448,62383664,9213
18,ENSG00000197563.4,62187056,18-61999661-G-T,rs583339,-1,G,T,61999661,187395,61990448,62383664,9213
18,ENSG00000101751.5,54269517,18-54226736-G-A,rs603097,1,G,A,54226736,42781,54072909,54466125,153827
18,ENSG00000134046.6,54224669,18-54288937-T-G,rs620495,-1,T,G,54288937,64268,54028061,54421277,260876
18,ENSG00000134046.6,54224669,18-54288937-T-C,rs620495,-1,T,C,54288937,64268,54028061,54421277,260876
18,ENSG00000134046.6,54224669,18-54288937-T-A,rs620495,-1,T,A,54288937,64268,54028061,54421277,260876
18,ENSG00000046604.7,31498177,18-31379872-G-A,rs62095161,1,G,A,31379872,118305,31301569,31694785,78303
18,ENSG00000226742.2,79964643,18-79933268-G-A,rs62101198,1,G,A,79933268,31375,79768035,80161251,165233
18,ENSG00000226742.2,79964643,18-79933268-G-T,rs62101198,1,G,T,79933268,31375,79768035,80161251,165233
18,ENSG00000141759.9,79988563,18-79874276-T-C,rs62103198,-1,T,C,79874276,114287,79791955,80185171,82321
18,ENSG00000180011.5,75209139,18-75194082-T-C,rs629081,-1,T,C,75194082,15057,75012531,75405747,181551
18,ENSG00000180011.5,75209139,18-75194082-T-A,rs629081,-1,T,A,75194082,15057,75012531,75405747,181551
18,ENSG00000167216.10,46917602,18-46817728-A-C,rs646128,1,A,C,46817728,99874,46720994,47114210,96734
18,ENSG00000167216.10,46917602,18-46817728-A-T,rs646128,1,A,T,46817728,99874,46720994,47114210,96734
18,ENSG00000101608.5,3247801,18-3156063-G-A,rs6506073,1,G,A,3156063,91738,3051193,3444409,104870
18,ENSG00000170677.4,70289045,18-70261385-T-G,rs6566465,1,T,G,70261385,27660,70092437,70485653,168948
18,ENSG00000170677.4,70289045,18-70261385-T-C,rs6566465,1,T,C,70261385,27660,70092437,70485653,168948
18,ENSG00000131196.11,79395930,18-79303413-A-C,rs7233974,1,A,C,79303413,92517,79199322,79592538,104091
18,ENSG00000101574.9,2571505,18-2594550-T-G,rs7244453,-1,T,G,2594550,23045,2374897,2768113,219653
18,ENSG00000101574.9,2571505,18-2594550-T-A,rs7244453,-1,T,A,2594550,23045,2374897,2768113,219653
18,ENSG00000101574.9,2571505,18-2594550-T-C,rs7244453,-1,T,C,2594550,23045,2374897,2768113,219653
18,ENSG00000075643.3,36187497,18-36211841-G-A,rs73430987,1,G,A,36211841,24344,35990889,36384105,220952
18,ENSG00000075643.3,36187497,18-36211841-G-T,rs73430987,1,G,T,36211841,24344,35990889,36384105,220952
18,ENSG00000154839.4,50375046,18-50557654-G-A,rs74729070,1,G,A,50557654,182608,50178438,50571654,379216
18,ENSG00000221887.4,63949301,18-63883064-C-T,rs75308532,1,C,T,63883064,66237,63752693,64145909,130371
18,ENSG00000141644.12,50281523,18-50181937-T-C,rs76182653,-1,T,C,50181937,99586,50084915,50478131,97022
18,ENSG00000152240.4,46104385,18-46276761-G-T,rs77784260,1,G,T,46276761,172376,45907777,46300993,368984
18,ENSG00000152240.4,46104385,18-46276761-G-A,rs77784260,1,G,A,46276761,172376,45907777,46300993,368984
18,ENSG00000049759.11,58044226,18-58067418-T-C,rs79642458,1,T,C,58067418,23192,57847618,58240834,219800
18,ENSG00000141434.6,32190039,18-32013940-A-G,rs8083251,1,A,G,32013940,176099,31993431,32386647,20509
18,ENSG00000141434.6,32190039,18-32013940-A-C,rs8083251,1,A,C,32013940,176099,31993431,32386647,20509
18,ENSG00000168675.12,13278105,18-13471200-C-T,rs8084766,1,C,T,13471200,193095,13081497,13474713,389703
18,ENSG00000079101.10,596988,18-494113-A-G,rs8088035,1,A,G,494113,102875,400380,793596,93733
18,ENSG00000130856.10,76822557,18-76690378-G-T,rs8095258,1,G,T,76690378,132179,76625949,77019165,64429
18,ENSG00000130856.10,76822557,18-76690378-G-A,rs8095258,1,G,A,76690378,132179,76625949,77019165,64429
18,ENSG00000075336.6,74148523,18-74069540-C-T,rs8097532,1,C,T,74069540,78983,73951915,74345131,117625
18,ENSG00000141469.9,45724181,18-45710796-T-C,rs923072,1,T,C,45710796,13385,45527573,45920789,183223
18,ENSG00000172466.9,35344420,18-35185182-C-T,rs9675472,-1,C,T,35185182,159238,35147812,35541028,37370
18,ENSG00000119541.4,63422476,18-63420040-C-T,rs9952790,-1,C,T,63420040,2436,63225868,63619084,194172
18,ENSG00000085415.10,12948011,18-13030618-T-C,rs9953764,1,T,C,13030618,82607,12751403,13144619,279215
18,ENSG00000166347.12,74291963,18-74313155-C-A,rs9963129,-1,C,A,74313155,21192,74095355,74488571,217800
18,ENSG00000166510.7,54959461,18-55024882-C-T,rs9967044,-1,C,T,55024882,65421,54762853,55156069,262029
17,ENSG00000141068.8,27456448,17-27492187-A-C,rs10083891,1,A,C,27492187,35739,27259840,27653056,232347
17,ENSG00000129214.9,7630135,17-7818613-G-A,rs10153304,1,G,A,7818613,188478,7433527,7826743,385086
17,ENSG00000108666.4,32342173,17-32331987-T-A,rs1019152,-1,T,A,32331987,10186,32145565,32538781,186422
17,ENSG00000108666.4,32342173,17-32331987-T-C,rs1019152,-1,T,C,32331987,10186,32145565,32538781,186422
17,ENSG00000108666.4,32342173,17-32331987-T-G,rs1019152,-1,T,G,32331987,10186,32145565,32538781,186422
17,ENSG00000064300.4,49495293,17-49486650-T-G,rs1035050,1,T,G,49486650,8643,49298685,49691901,187965
17,ENSG00000064300.4,49495293,17-49486650-T-A,rs1035050,1,T,A,49486650,8643,49298685,49691901,187965
17,ENSG00000064300.4,49495293,17-49486650-T-C,rs1035050,1,T,C,49486650,8643,49298685,49691901,187965
17,ENSG00000141127.8,18858131,17-18861708-A-G,rs1037037,1,A,G,18861708,3577,18661523,19054739,200185
17,ENSG00000006125.11,35587322,17-35627508-C-G,rs10491114,1,C,G,35627508,40186,35390714,35783930,236794
17,ENSG00000108559.6,5419662,17-5381424-T-C,rs1065482,-1,T,C,5381424,38238,5223054,5616270,158370
17,ENSG00000108559.6,5419662,17-5381424-T-G,rs1065482,-1,T,G,5381424,38238,5223054,5616270,158370
17,ENSG00000154258.10,69060927,17-69191800-G-C,rs11077403,-1,G,C,69191800,130873,68864319,69257535,327481
17,ENSG00000133030.12,17042457,17-17105884-T-C,rs11078372,1,T,C,17105884,63427,16845849,17239065,260035
17,ENSG00000175662.12,17972400,17-17972697-A-G,rs11078408,-1,A,G,17972697,297,17775792,18169008,196905
17,ENSG00000175662.12,17972400,17-17972697-A-C,rs11078408,-1,A,C,17972697,297,17775792,18169008,196905
17,ENSG00000175662.12,17972400,17-17972697-A-T,rs11078408,-1,A,T,17972697,297,17775792,18169008,196905
17,ENSG00000179029.9,8176380,17-8197906-T-G,rs11078734,-1,T,G,8197906,21526,7979772,8372988,218134
17,ENSG00000179029.9,8176380,17-8197906-T-A,rs11078734,-1,T,A,8197906,21526,7979772,8372988,218134
17,ENSG00000179029.9,8176380,17-8197906-T-C,rs11078734,-1,T,C,8197906,21526,7979772,8372988,218134
17,ENSG00000141756.11,41813004,17-41819772-G-A,rs11079016,1,G,A,41819772,6768,41616396,42009612,203376
17,ENSG00000167183.1,47957883,17-47943332-C-T,rs11079804,-1,C,T,47943332,14551,47761275,48154491,182057
17,ENSG00000002919.9,48107766,17-48181148-T-C,rs11079813,1,T,C,48181148,73382,47911158,48304374,269990
17,ENSG00000109084.8,28319200,17-28318965-G-A,rs11080054,1,G,A,28318965,235,28122592,28515808,196373
17,ENSG00000166750.4,35243072,17-35244527-G-C,rs11080327,1,G,C,35244527,1455,35046464,35439680,198063
17,ENSG00000166750.4,35243072,17-35244527-G-T,rs11080327,1,G,T,35244527,1455,35046464,35439680,198063
17,ENSG00000166750.4,35243072,17-35244527-G-A,rs11080327,1,G,A,35244527,1455,35046464,35439680,198063
17,ENSG00000142494.7,19533854,17-19695170-G-A,rs111233471,1,G,A,19695170,161316,19337246,19730462,357924
17,ENSG00000214087.4,81683797,17-81671775-C-T,rs11150805,-1,C,T,81671775,12022,81487189,81880405,184586
17,ENSG00000187624.7,410325,17-409857-G-T,rs11150882,1,G,T,409857,468,213717,606933,196140
17,ENSG00000187624.7,410325,17-409857-G-A,rs11150882,1,G,A,409857,468,213717,606933,196140
17,ENSG00000074356.11,3846246,17-3750465-C-T,rs112808026,-1,C,T,3750465,95781,3649638,4042854,100827
17,ENSG00000006025.6,47821794,17-47891962-C-T,rs112811776,-1,C,T,47891962,70168,47625186,48018402,266776
17,ENSG00000173801.11,41786711,17-41917616-G-A,rs112918580,-1,G,A,41917616,130905,41590103,41983319,327513
17,ENSG00000007312.7,63932331,17-63960008-G-T,rs113937879,-1,G,T,63960008,27677,63735723,64128939,224285
17,ENSG00000169660.10,82418347,17-82419814-T-A,rs1141463,1,T,A,82419814,1467,82221739,82614955,198075
17,ENSG00000169660.10,82418347,17-82419814-T-G,rs1141463,1,T,G,82419814,1467,82221739,82614955,198075
17,ENSG00000177302.7,18314994,17-18148792-G-A,rs114274755,-1,G,A,18148792,166202,18118386,18511602,30406
17,ENSG00000121104.3,49764131,17-49599829-T-C,rs11539921,-1,T,C,49599829,164302,49567523,49960739,32306
17,ENSG00000121060.10,56914049,17-56889444-A-G,rs11540270,-1,A,G,56889444,24605,56717441,57110657,172003
17,ENSG00000177303.4,75515537,17-75506555-T-C,rs115438731,-1,T,C,75506555,8982,75318929,75712145,187626
17,ENSG00000185504.11,81552353,17-81547103-G-C,rs11552304,-1,G,C,81547103,5250,81355745,81748961,191358
17,ENSG00000185504.11,81552353,17-81547103-G-A,rs11552304,-1,G,A,81547103,5250,81355745,81748961,191358
17,ENSG00000141579.4,82840022,17-82959416-T-C,rs115559627,-1,T,C,82959416,119394,82643414,83036630,316002
17,ENSG00000007171.11,27800529,17-27923083-G-C,rs1157502,-1,G,C,27923083,122554,27603921,27997137,319162
17,ENSG00000007171.11,27800529,17-27923083-G-T,rs1157502,-1,G,T,27923083,122554,27603921,27997137,319162
17,ENSG00000136449.9,50508439,17-50504915-G-A,rs11649849,1,G,A,50504915,3524,50311831,50705047,193084
17,ENSG00000141219.10,73232433,17-73180195-C-G,rs11650133,1,C,G,73180195,52238,73035825,73429041,144370
17,ENSG00000141219.10,73232433,17-73180195-C-T,rs11650133,1,C,T,73180195,52238,73035825,73429041,144370
17,ENSG00000205045.3,35537678,17-35537613-A-G,rs11650473,-1,A,G,35537613,65,35341070,35734286,196543
17,ENSG00000154945.6,50707914,17-50708855-T-C,rs11651060,-1,T,C,50708855,941,50511306,50904522,197549
17,ENSG00000176749.3,32486993,17-32516592-G-A,rs11651743,1,G,A,32516592,29599,32290385,32683601,226207
17,ENSG00000132359.9,2796438,17-2812520-C-T,rs11652853,1,C,T,2812520,16082,2599830,2993046,212690
17,ENSG00000132359.9,2796438,17-2812520-C-G,rs11652853,1,C,G,2812520,16082,2599830,2993046,212690
17,ENSG00000161960.9,7572825,17-7608756-G-A,rs11653545,1,G,A,7608756,35931,7376217,7769433,232539
17,ENSG00000161960.9,7572825,17-7608756-G-C,rs11653545,1,G,C,7608756,35931,7376217,7769433,232539
17,ENSG00000181350.7,16492193,17-16461772-A-G,rs11654069,-1,A,G,16461772,30421,16295585,16688801,166187
17,ENSG00000178971.8,8248056,17-8238006-T-C,rs11655903,-1,T,C,8238006,10050,8051448,8444664,186558
17,ENSG00000006744.10,13018027,17-12982758-C-A,rs11655929,-1,C,A,12982758,35269,12821419,13214635,161339
17,ENSG00000006744.10,13018027,17-12982758-C-T,rs11655929,-1,C,T,12982758,35269,12821419,13214635,161339
17,ENSG00000108924.7,55264960,17-55330231-A-G,rs11657291,1,A,G,55330231,65271,55068352,55461568,261879
17,ENSG00000166579.10,8435884,17-8441224-A-C,rs11657789,1,A,C,8441224,5340,8239276,8632492,201948
17,ENSG00000166579.10,8435884,17-8441224-A-T,rs11657789,1,A,T,8441224,5340,8239276,8632492,201948
17,ENSG00000166579.10,8435884,17-8441224-A-G,rs11657789,1,A,G,8441224,5340,8239276,8632492,201948
17,ENSG00000108406.4,59565610,17-59526143-A-G,rs11658504,1,A,G,59526143,39467,59369002,59762218,157141
17,ENSG00000172301.5,31859244,17-31859593-C-T,rs11658984,-1,C,T,31859593,349,31662636,32055852,196957
17,ENSG00000172301.5,31859244,17-31859593-C-A,rs11658984,-1,C,A,31859593,349,31662636,32055852,196957
17,ENSG00000109103.5,28552624,17-28474619-G-A,rs117101115,-1,G,A,28474619,78005,28356016,28749232,118603
17,ENSG00000181408.2,82371765,17-82311161-C-T,rs117247165,1,C,T,82311161,60604,82175157,82568373,136004
17,ENSG00000161664.1,44170704,17-44206926-C-T,rs117467674,1,C,T,44206926,36222,43974096,44367312,232830
17,ENSG00000154262.7,69141895,17-69063421-G-T,rs117519040,-1,G,T,69063421,78474,68945287,69338503,118134
17,ENSG00000189120.2,47851163,17-47748018-A-G,rs117549066,-1,A,G,47748018,103145,47654555,48047771,93463
17,ENSG00000169696.8,81977629,17-81992184-C-A,rs117574737,1,C,A,81992184,14555,81781021,82174237,211163
17,ENSG00000173894.6,79778148,17-79723452-G-A,rs117605502,1,G,A,79723452,54696,79581540,79974756,141912
17,ENSG00000132382.9,4555384,17-4555340-C-G,rs117790724,-1,C,G,4555340,44,4358776,4751992,196564
17,ENSG00000132382.9,4555384,17-4555340-C-T,rs117790724,-1,C,T,4555340,44,4358776,4751992,196564
17,ENSG00000108702.2,34363233,17-34502465-A-C,rs118003219,-1,A,C,34502465,139232,34166625,34559841,335840
17,ENSG00000256618.1,22523415,17-22683802-C-T,rs118171966,1,C,T,22683802,160387,22326807,22720023,356995
17,ENSG00000176155.10,82212819,17-82309750-A-C,rs11868932,-1,A,C,82309750,96931,82016211,82409427,293539
17,ENSG00000167447.7,59210035,17-59311549-C-T,rs11870504,1,C,T,59311549,101514,59013427,59406643,298122
17,ENSG00000167447.7,59210035,17-59311549-C-A,rs11870504,1,C,A,59311549,101514,59013427,59406643,298122
17,ENSG00000129657.8,77140969,17-77168804-A-G,rs11871056,1,A,G,77168804,27835,76944361,77337577,224443
17,ENSG00000161929.9,5234860,17-5201752-T-C,rs12449298,-1,T,C,5201752,33108,5038252,5431468,163500
17,ENSG00000055483.10,78840814,17-78695176-T-C,rs12449669,-1,T,C,78695176,145638,78644206,79037422,50970
17,ENSG00000055483.10,78840814,17-78695176-T-G,rs12449669,-1,T,G,78695176,145638,78644206,79037422,50970
17,ENSG00000167720.7,2303950,17-2304131-C-G,rs12450028,1,C,G,2304131,181,2107342,2500558,196789
17,ENSG00000167720.7,2303950,17-2304131-C-T,rs12450028,1,C,T,2304131,181,2107342,2500558,196789
17,ENSG00000171298.8,80101581,17-80102793-A-C,rs12450199,1,A,C,80102793,1212,79904973,80298189,197820
17,ENSG00000170310.5,9575820,17-9434344-G-C,rs12452001,-1,G,C,9434344,141476,9379212,9772428,55132
17,ENSG00000196388.4,4997033,17-4814149-G-A,rs12452111,-1,G,A,4814149,182884,4800425,5193641,13724
17,ENSG00000196388.4,4997033,17-4814149-G-C,rs12452111,-1,G,C,4814149,182884,4800425,5193641,13724
17,ENSG00000185359.7,81684011,17-81715184-G-A,rs12452231,1,G,A,81715184,31173,81487403,81880619,227781
17,ENSG00000185359.7,81684011,17-81715184-G-C,rs12452231,1,G,C,81715184,31173,81487403,81880619,227781
17,ENSG00000108829.9,50397523,17-50387614-A-G,rs12452484,-1,A,G,50387614,9909,50200915,50594131,186699
17,ENSG00000141540.5,74213571,17-74239422-C-A,rs12452652,1,C,A,74239422,25851,74016963,74410179,222459
17,ENSG00000141232.4,50866354,17-50892014-G-C,rs12452766,-1,G,C,50892014,25660,50669746,51062962,222268
17,ENSG00000141314.7,32265832,17-32268820-T-C,rs12453610,1,T,C,32268820,2988,32069224,32462440,199596
17,ENSG00000121053.4,58192726,17-58192760-T-A,rs12602891,1,T,A,58192760,34,57996118,58389334,196642
17,ENSG00000121053.4,58192726,17-58192760-T-C,rs12602891,1,T,C,58192760,34,57996118,58389334,196642
17,ENSG00000121053.4,58192726,17-58192760-T-G,rs12602891,1,T,G,58192760,34,57996118,58389334,196642
17,ENSG00000005100.8,5468982,17-5444636-A-T,rs12603094,-1,A,T,5444636,24346,5272374,5665590,172262
17,ENSG00000005100.8,5468982,17-5444636-A-G,rs12603094,-1,A,G,5444636,24346,5272374,5665590,172262
17,ENSG00000262814.1,81703367,17-81540246-G-C,rs12675,1,G,C,81540246,163121,81506759,81899975,33487
17,ENSG00000262814.1,81703367,17-81540246-G-A,rs12675,1,G,A,81540246,163121,81506759,81899975,33487
17,ENSG00000189050.9,59964740,17-59856808-A-G,rs1292043,-1,A,G,59856808,107932,59768132,60161348,88676
17,ENSG00000189050.9,59964740,17-59856808-A-T,rs1292043,-1,A,T,59856808,107932,59768132,60161348,88676
17,ENSG00000189050.9,59964740,17-59856808-A-C,rs1292043,-1,A,C,59856808,107932,59768132,60161348,88676
17,ENSG00000172057.4,39927601,17-39872867-C-G,rs12936231,-1,C,G,39872867,54734,39730993,40124209,141874
17,ENSG00000172057.4,39927601,17-39872867-C-T,rs12936231,-1,C,T,39872867,54734,39730993,40124209,141874
17,ENSG00000181031.11,352807,17-218895-G-C,rs12941133,-1,G,C,218895,133912,156199,549415,62696
17,ENSG00000136451.3,57988254,17-57915502-T-C,rs12941179,-1,T,C,57915502,72752,57791646,58184862,123856
17,ENSG00000141504.7,7627821,17-7579461-T-C,rs12942088,-1,T,C,7579461,48360,7431213,7824429,148248
17,ENSG00000187838.10,7394525,17-7415616-C-T,rs12947017,-1,C,T,7415616,21091,7197917,7591133,217699
17,ENSG00000177469.10,42423256,17-42386961-A-T,rs12947808,-1,A,T,42386961,36295,42226648,42619864,160313
17,ENSG00000177469.10,42423256,17-42386961-A-C,rs12947808,-1,A,C,42386961,36295,42226648,42619864,160313
17,ENSG00000221926.5,15684311,17-15593463-C-G,rs146110909,-1,C,G,15593463,90848,15487703,15880919,105760
17,ENSG00000221926.5,15684311,17-15593463-C-T,rs146110909,-1,C,T,15593463,90848,15487703,15880919,105760
17,ENSG00000221926.5,15684311,17-15593463-C-A,rs146110909,-1,C,A,15593463,90848,15487703,15880919,105760
17,ENSG00000175931.7,76453152,17-76439277-C-A,rs1466003,-1,C,A,76439277,13875,76256544,76649760,182733
17,ENSG00000175931.7,76453152,17-76439277-C-T,rs1466003,-1,C,T,76439277,13875,76256544,76649760,182733
17,ENSG00000065559.7,12020877,17-12018627-T-C,rs1468501,1,T,C,12018627,2250,11824269,12217485,194358
17,ENSG00000065559.7,12020877,17-12018627-T-A,rs1468501,1,T,A,12018627,2250,11824269,12217485,194358
17,ENSG00000256806.1,6651762,17-6605509-C-G,rs1470297,1,C,G,6605509,46253,6455154,6848370,150355
17,ENSG00000183979.6,81902238,17-81859050-C-T,rs1533756,1,C,T,81859050,43188,81705630,82098846,153420
17,ENSG00000183979.6,81902238,17-81859050-C-G,rs1533756,1,C,G,81859050,43188,81705630,82098846,153420
17,ENSG00000181513.9,45135687,17-45139448-G-A,rs16939884,1,G,A,45139448,3761,44939079,45332295,200369
17,ENSG00000181513.9,45135687,17-45139448-G-T,rs16939884,1,G,T,45139448,3761,44939079,45332295,200369
17,ENSG00000006062.8,45317020,17-45346524-T-C,rs16939964,-1,T,C,45346524,29504,45120412,45513628,226112
17,ENSG00000108424.4,47649919,17-47693188-T-C,rs16942912,1,T,C,47693188,43269,47453311,47846527,239877
17,ENSG00000198740.4,49362250,17-49455151-G-A,rs16948122,-1,G,A,49455151,92901,49165642,49558858,289509
17,ENSG00000184619.3,8376704,17-8376006-T-C,rs1695213,-1,T,C,8376006,698,8180096,8573312,195910
17,ENSG00000184619.3,8376704,17-8376006-T-A,rs1695213,-1,T,A,8376006,698,8180096,8573312,195910
17,ENSG00000183688.4,445939,17-615160-T-C,rs16953975,-1,T,C,615160,169221,249331,642547,365829
17,ENSG00000132535.11,7217627,17-7076954-C-T,rs16956478,-1,C,T,7076954,140673,7021019,7414235,55935
17,ENSG00000129654.6,76141245,17-76070395-T-C,rs16968495,-1,T,C,76070395,70850,75944637,76337853,125758
17,ENSG00000121057.7,57085246,17-56932701-G-A,rs16968987,1,G,A,56932701,152545,56888638,57281854,44063
17,ENSG00000154803.7,17237168,17-17228555-T-C,rs1708618,-1,T,C,17228555,8613,17040560,17433776,187995
17,ENSG00000154803.7,17237168,17-17228555-T-G,rs1708618,-1,T,G,17228555,8613,17040560,17433776,187995
17,ENSG00000154803.7,17237168,17-17228555-T-A,rs1708618,-1,T,A,17228555,8613,17040560,17433776,187995
17,ENSG00000167740.3,4143197,17-4032749-C-T,rs17175962,1,C,T,4032749,110448,3946589,4339805,86160
17,ENSG00000108852.10,43907536,17-43914607-T-A,rs1731889,-1,T,A,43914607,7071,43710928,44104144,203679
17,ENSG00000108852.10,43907536,17-43914607-T-G,rs1731889,-1,T,G,43914607,7071,43710928,44104144,203679
17,ENSG00000141349.3,44070735,17-43995281-C-T,rs1731902,1,C,T,43995281,75454,43874127,44267343,121154
17,ENSG00000141349.3,44070735,17-43995281-C-A,rs1731902,1,C,A,43995281,75454,43874127,44267343,121154
17,ENSG00000108423.9,59892943,17-59781345-C-T,rs17581463,-1,C,T,59781345,111598,59696335,60089551,85010
17,ENSG00000108423.9,59892943,17-59781345-C-G,rs17581463,-1,C,G,59781345,111598,59696335,60089551,85010
17,ENSG00000108582.5,30378927,17-30572006-C-T,rs17606460,1,C,T,30572006,193079,30182319,30575535,389687
17,ENSG00000141510.9,7687490,17-7581464-G-A,rs17607,-1,G,A,7581464,106026,7490882,7884098,90582
17,ENSG00000183153.4,40364737,17-40523355-C-T,rs17634993,-1,C,T,40523355,158618,40168129,40561345,355226
17,ENSG00000120063.4,65056740,17-64985215-A-C,rs17685439,-1,A,C,64985215,71525,64860132,65253348,125083
17,ENSG00000120063.4,65056740,17-64985215-A-T,rs17685439,-1,A,T,64985215,71525,64860132,65253348,125083
17,ENSG00000197417.7,3636250,17-3601939-C-T,rs17707155,-1,C,T,3601939,34311,3439642,3832858,162297
17,ENSG00000109046.9,27294114,17-27338610-C-T,rs17714734,1,C,T,27338610,44496,27097506,27490722,241104
17,ENSG00000109046.9,27294114,17-27338610-C-G,rs17714734,1,C,G,27338610,44496,27097506,27490722,241104
17,ENSG00000109046.9,27294114,17-27338610-C-A,rs17714734,1,C,A,27338610,44496,27097506,27490722,241104
17,ENSG00000174282.7,7479631,17-7354136-G-T,rs17732672,-1,G,T,7354136,125495,7283023,7676239,71113
17,ENSG00000129226.8,7579638,17-7383040-C-T,rs17732702,1,C,T,7383040,196598,7383030,7776246,10
17,ENSG00000129226.8,7579638,17-7383040-C-A,rs17732702,1,C,A,7383040,196598,7383030,7776246,10
17,ENSG00000153933.5,56834151,17-56763132-G-A,rs17760549,1,G,A,56763132,71019,56637543,57030759,125589
17,ENSG00000108518.7,4948530,17-5083186-C-G,rs17765422,-1,C,G,5083186,134656,4751922,5145138,331264
17,ENSG00000108518.7,4948530,17-5083186-C-T,rs17765422,-1,C,T,5083186,134656,4751922,5145138,331264
17,ENSG00000166260.6,54968654,17-54933020-T-G,rs17817829,-1,T,G,54933020,35634,54772046,55165262,160974
17,ENSG00000141198.9,54900852,17-54967964-G-A,rs17817950,1,G,A,54967964,67112,54704244,55097460,263720
17,ENSG00000166582.4,16353469,17-16229730-G-A,rs178787,-1,G,A,16229730,123739,16156861,16550077,72869
17,ENSG00000108561.4,5439155,17-5414172-C-A,rs1806263,-1,C,A,5414172,24983,5242547,5635763,171625
17,ENSG00000108561.4,5439155,17-5414172-C-G,rs1806263,-1,C,G,5414172,24983,5242547,5635763,171625
17,ENSG00000185156.4,8799365,17-8800102-C-T,rs1826925,-1,C,T,8800102,737,8602757,8995973,197345
17,ENSG00000172123.7,35432500,17-35422900-A-T,rs1849733,-1,A,T,35422900,9600,35235892,35629108,187008
17,ENSG00000172123.7,35432500,17-35422900-A-C,rs1849733,-1,A,C,35422900,9600,35235892,35629108,187008
17,ENSG00000174326.7,7044092,17-7136633-T-C,rs1875557,-1,T,C,7136633,92541,6847484,7240700,289149
17,ENSG00000213246.1,58352201,17-58339641-A-G,rs1985749,-1,A,G,58339641,12560,58155593,58548809,184048
17,ENSG00000108379.5,46818692,17-46743059-T-A,rs199536,-1,T,A,46743059,75633,46622084,47015300,120975
17,ENSG00000108379.5,46818692,17-46743059-T-C,rs199536,-1,T,C,46743059,75633,46622084,47015300,120975
17,ENSG00000178789.3,74531475,17-74487632-G-A,rs2007766,-1,G,A,74487632,43843,74334867,74728083,152765
17,ENSG00000198933.4,47694161,17-47713757-T-G,rs2013383,1,T,G,47713757,19596,47497553,47890769,216204
17,ENSG00000198933.4,47694161,17-47713757-T-A,rs2013383,1,T,A,47713757,19596,47497553,47890769,216204
17,ENSG00000184988.2,43211875,17-43153809-G-T,rs2037075,1,G,T,43153809,58066,43015267,43408483,138542
17,ENSG00000257949.1,75979240,17-76001393-G-A,rs2069528,1,G,A,76001393,22153,75782632,76175848,218761
17,ENSG00000167711.9,1742871,17-1745000-C-T,rs2070862,1,C,T,1745000,2129,1546263,1939479,198737
17,ENSG00000108384.9,58692602,17-58527452-G-T,rs2072316,1,G,T,58527452,165150,58495994,58889210,31458
17,ENSG00000258315.1,7014782,17-6996757-G-A,rs2073438,1,G,A,6996757,18025,6818174,7211390,178583
17,ENSG00000004660.10,3893053,17-3904738-A-G,rs2074989,-1,A,G,3904738,11685,3696445,4089661,208293
17,ENSG00000004660.10,3893053,17-3904738-A-C,rs2074989,-1,A,C,3904738,11685,3696445,4089661,208293
17,ENSG00000068097.8,60078921,17-60079066-G-A,rs2087840,-1,G,A,60079066,145,59882313,60275529,196753
17,ENSG00000108826.11,50373184,17-50353333-G-A,rs2097844,-1,G,A,50353333,19851,50176576,50569792,176757
17,ENSG00000108826.11,50373184,17-50353333-G-T,rs2097844,-1,G,T,50353333,19851,50176576,50569792,176757
17,ENSG00000159202.11,48908407,17-48899763-G-T,rs2112617,1,G,T,48899763,8644,48711799,49105015,187964
17,ENSG00000159202.11,48908407,17-48899763-G-C,rs2112617,1,G,C,48899763,8644,48711799,49105015,187964
17,ENSG00000159202.11,48908407,17-48899763-G-A,rs2112617,1,G,A,48899763,8644,48711799,49105015,187964
17,ENSG00000108592.9,63827663,17-63728247-G-A,rs2137144,-1,G,A,63728247,99416,63631055,64024271,97192
17,ENSG00000091622.10,6556555,17-6578174-T-C,rs2165844,-1,T,C,6578174,21619,6359947,6753163,218227
17,ENSG00000198920.4,6640711,17-6703699-G-C,rs218676,-1,G,C,6703699,62988,6444103,6837319,259596
17,ENSG00000198920.4,6640711,17-6703699-G-A,rs218676,-1,G,A,6703699,62988,6444103,6837319,259596
17,ENSG00000125430.4,14301081,17-14350631-G-A,rs2199999,1,G,A,14350631,49550,14104473,14497689,246158
17,ENSG00000132517.10,5035426,17-4956069-C-T,rs2230257,-1,C,T,4956069,79357,4838818,5232034,117251
17,ENSG00000213977.3,3668578,17-3664167-G-A,rs2235107,-1,G,A,3664167,4411,3471970,3865186,192197
17,ENSG00000213977.3,3668578,17-3664167-G-C,rs2235107,-1,G,C,3664167,4411,3471970,3865186,192197
17,ENSG00000108468.9,48101478,17-48074960-T-C,rs2240121,-1,T,C,48074960,26518,47904870,48298086,170090
17,ENSG00000125445.5,75261879,17-75246854-A-T,rs2242231,1,A,T,75246854,15025,75065271,75458487,181583
17,ENSG00000125445.5,75261879,17-75246854-A-G,rs2242231,1,A,G,75246854,15025,75065271,75458487,181583
17,ENSG00000125445.5,75261879,17-75246854-A-C,rs2242231,1,A,C,75246854,15025,75065271,75458487,181583
17,ENSG00000141560.8,82716706,17-82722573-G-T,rs2243523,1,G,T,82722573,5867,82520098,82913314,202475
17,ENSG00000108797.6,42682531,17-42683904-A-C,rs2271029,1,A,C,42683904,1373,42485923,42879139,197981
17,ENSG00000108797.6,42682531,17-42683904-A-G,rs2271029,1,A,G,42683904,1373,42485923,42879139,197981
17,ENSG00000214226.4,56833920,17-56735154-C-T,rs227666,-1,C,T,56735154,98766,56637312,57030528,97842
17,ENSG00000214226.4,56833920,17-56735154-C-A,rs227666,-1,C,A,56735154,98766,56637312,57030528,97842
17,ENSG00000108960.3,55421835,17-55407825-C-T,rs2286806,-1,C,T,55407825,14010,55225227,55618443,182598
17,ENSG00000070540.7,68457496,17-68434373-G-C,rs2287301,-1,G,C,68434373,23123,68260888,68654104,173485
17,ENSG00000070540.7,68457496,17-68434373-G-A,rs2287301,-1,G,A,68434373,23123,68260888,68654104,173485
17,ENSG00000214447.3,44899774,17-44876041-A-G,rs2289674,1,A,G,44876041,23733,44703166,45096382,172875
17,ENSG00000125450.5,75205679,17-75232049-T-C,rs2291030,1,T,C,75232049,26370,75009071,75402287,222978
17,ENSG00000213859.3,7352162,17-7350340-T-A,rs2292068,1,T,A,7350340,1822,7155554,7548770,194786
17,ENSG00000213859.3,7352162,17-7350340-T-C,rs2292068,1,T,C,7350340,1822,7155554,7548770,194786
17,ENSG00000126561.9,42288498,17-42308985-C-G,rs2293154,1,C,G,42308985,20487,42091890,42485106,217095
17,ENSG00000126561.9,42288498,17-42308985-C-T,rs2293154,1,C,T,42308985,20487,42091890,42485106,217095
17,ENSG00000141294.4,47831670,17-47844540-T-C,rs2325752,1,T,C,47844540,12870,47635062,48028278,209478
17,ENSG00000141294.4,47831670,17-47844540-T-G,rs2325752,1,T,G,47844540,12870,47635062,48028278,209478
17,ENSG00000068489.7,59155746,17-59192067-T-A,rs2333465,1,T,A,59192067,36321,58959138,59352354,232929
17,ENSG00000068489.7,59155746,17-59192067-T-C,rs2333465,1,T,C,59192067,36321,58959138,59352354,232929
17,ENSG00000068489.7,59155746,17-59192067-T-G,rs2333465,1,T,G,59192067,36321,58959138,59352354,232929
17,ENSG00000132141.8,34961460,17-34826300-C-G,rs234824,-1,C,G,34826300,135160,34764852,35158068,61448
17,ENSG00000132141.8,34961460,17-34826300-C-T,rs234824,-1,C,T,34826300,135160,34764852,35158068,61448
17,ENSG00000141543.4,80147128,17-80138078-T-C,rs2361710,-1,T,C,80138078,9050,79950520,80343736,187558
17,ENSG00000171302.9,79009764,17-78998287-C-T,rs2377301,-1,C,T,78998287,11477,78813156,79206372,185131
17,ENSG00000126860.5,31321622,17-31320890-T-G,rs2525563,-1,T,G,31320890,732,31125014,31518230,195876
17,ENSG00000126860.5,31321622,17-31320890-T-C,rs2525563,-1,T,C,31320890,732,31125014,31518230,195876
17,ENSG00000129204.11,5116032,17-5310096-C-T,rs2585266,1,C,T,5310096,194064,4919424,5312640,390672
17,ENSG00000141570.6,79797077,17-79816336-T-G,rs2587507,-1,T,G,79816336,19259,79600469,79993685,215867
17,ENSG00000141570.6,79797077,17-79816336-T-C,rs2587507,-1,T,C,79816336,19259,79600469,79993685,215867
17,ENSG00000131899.6,18225635,17-18233436-C-T,rs2605136,1,C,T,18233436,7801,18029027,18422243,204409
17,ENSG00000131899.6,18225635,17-18233436-C-G,rs2605136,1,C,G,18233436,7801,18029027,18422243,204409
17,ENSG00000167695.8,732596,17-731840-A-C,rs2657621,1,A,C,731840,756,535988,929204,195852
17,ENSG00000167850.3,74546115,17-74466882-C-T,rs2670827,-1,C,T,74466882,79233,74349507,74742723,117375
17,ENSG00000087191.7,63827431,17-63899888-T-C,rs2854160,1,T,C,63899888,72457,63630823,64024039,269065
17,ENSG00000089685.7,78214253,17-78226226-T-C,rs28612787,1,T,C,78226226,11973,78017645,78410861,208581
17,ENSG00000089685.7,78214253,17-78226226-T-G,rs28612787,1,T,G,78226226,11973,78017645,78410861,208581
17,ENSG00000089685.7,78214253,17-78226226-T-A,rs28612787,1,T,A,78226226,11973,78017645,78410861,208581
17,ENSG00000108395.8,59106880,17-59061932-G-C,rs2877926,-1,G,C,59061932,44948,58910272,59303488,151660
17,ENSG00000108395.8,59106880,17-59061932-G-A,rs2877926,-1,G,A,59061932,44948,58910272,59303488,151660
17,ENSG00000108395.8,59106880,17-59061932-G-T,rs2877926,-1,G,T,59061932,44948,58910272,59303488,151660
17,ENSG00000154957.6,11997475,17-12140928-G-C,rs28921112,-1,G,C,12140928,143453,11800867,12194083,340061
17,ENSG00000154957.6,11997475,17-12140928-G-A,rs28921112,-1,G,A,12140928,143453,11800867,12194083,340061
17,ENSG00000141337.6,68291495,17-68483075-A-G,rs2952278,1,A,G,68483075,191580,68094887,68488103,388188
17,ENSG00000007314.6,63972918,17-63999149-G-A,rs3181027,-1,G,A,63999149,26231,63776310,64169526,222839
17,ENSG00000007314.6,63972918,17-63999149-G-C,rs3181027,-1,G,C,63999149,26231,63776310,64169526,222839
17,ENSG00000007314.6,63972918,17-63999149-G-T,rs3181027,-1,G,T,63999149,26231,63776310,64169526,222839
17,ENSG00000236320.2,35560819,17-35554699-G-A,rs321613,-1,G,A,35554699,6120,35364211,35757427,190488
17,ENSG00000167723.9,3557812,17-3556729-T-C,rs322960,-1,T,C,3556729,1083,3361204,3754420,195525
17,ENSG00000167862.4,75012670,17-75006887-C-T,rs34014427,1,C,T,75006887,5783,74816062,75209278,190825
17,ENSG00000167862.4,75012670,17-75006887-C-A,rs34014427,1,C,A,75006887,5783,74816062,75209278,190825
17,ENSG00000177294.6,6776215,17-6760434-A-G,rs34195599,1,A,G,6760434,15781,6579607,6972823,180827
17,ENSG00000185105.4,81947233,17-81942024-G-C,rs34319293,-1,G,C,81942024,5209,81750625,82143841,191399
17,ENSG00000185105.4,81947233,17-81942024-G-A,rs34319293,-1,G,A,81942024,5209,81750625,82143841,191399
17,ENSG00000182612.6,81642413,17-81650504-A-T,rs3432,1,A,T,81650504,8091,81445805,81839021,204699
17,ENSG00000182612.6,81642413,17-81650504-A-G,rs3432,1,A,G,81650504,8091,81445805,81839021,204699
17,ENSG00000182612.6,81642413,17-81650504-A-C,rs3432,1,A,C,81650504,8091,81445805,81839021,204699
17,ENSG00000184557.2,78360077,17-78459935-C-G,rs34438166,-1,C,G,78459935,99858,78163469,78556685,296466
17,ENSG00000184557.2,78360077,17-78459935-C-T,rs34438166,-1,C,T,78459935,99858,78163469,78556685,296466
17,ENSG00000011028.8,62627670,17-62683934-A-C,rs34466614,1,A,C,62683934,56264,62431062,62824278,252872
17,ENSG00000175866.10,81035151,17-81094956-G-A,rs34534119,1,G,A,81094956,59805,80838543,81231759,256413
17,ENSG00000175866.10,81035151,17-81094956-G-T,rs34534119,1,G,T,81094956,59805,80838543,81231759,256413
17,ENSG00000161920.5,4731428,17-4903019-G-A,rs34563587,1,G,A,4903019,171591,4534820,4928036,368199
17,ENSG00000161920.5,4731428,17-4903019-G-C,rs34563587,1,G,C,4903019,171591,4534820,4928036,368199
17,ENSG00000141582.9,79839440,17-80013440-C-T,rs34603877,-1,C,T,80013440,174000,79642832,80036048,370608
17,ENSG00000167131.10,44899729,17-44908404-C-T,rs34637106,1,C,T,44908404,8675,44703121,45096337,205283
17,ENSG00000167131.10,44899729,17-44908404-C-G,rs34637106,1,C,G,44908404,8675,44703121,45096337,205283
17,ENSG00000108389.4,58514638,17-58523387-A-G,rs35288118,-1,A,G,58523387,8749,58318030,58711246,205357
17,ENSG00000108389.4,58514638,17-58523387-A-C,rs35288118,-1,A,C,58523387,8749,58318030,58711246,205357
17,ENSG00000175711.4,83051770,17-82970798-G-C,rs35355170,-1,G,C,82970798,80972,82855162,83248378,115636
17,ENSG00000173818.12,80415167,17-80415678-G-C,rs35549084,1,G,C,80415678,511,80218559,80611775,197119
17,ENSG00000173818.12,80415167,17-80415678-G-A,rs35549084,1,G,A,80415678,511,80218559,80611775,197119
17,ENSG00000185829.10,46579691,17-46755851-C-A,rs35732828,-1,C,A,46755851,176160,46383083,46776299,372768
17,ENSG00000173838.6,62808314,17-62667879-A-C,rs35769372,-1,A,C,62667879,140435,62611706,63004922,56173
17,ENSG00000072818.6,7336529,17-7323638-G-A,rs35776863,1,G,A,7323638,12891,7139921,7533137,183717
17,ENSG00000180340.4,44557484,17-44622752-G-A,rs35991370,1,G,A,44622752,65268,44360876,44754092,261876
17,ENSG00000180340.4,44557484,17-44622752-G-C,rs35991370,1,G,C,44622752,65268,44360876,44754092,261876
17,ENSG00000167363.8,82735615,17-82773222-G-A,rs36087138,1,G,A,82773222,37607,82539007,82932223,234215
17,ENSG00000167100.10,50130160,17-50090211-C-T,rs36103008,-1,C,T,50090211,39949,49933552,50326768,156659
17,ENSG00000136444.5,50478860,17-50485811-C-T,rs3744531,1,C,T,50485811,6951,50282252,50675468,203559
17,ENSG00000196544.6,8190180,17-8320815-T-C,rs3744646,-1,T,C,8320815,130635,7993572,8386788,327243
17,ENSG00000108679.5,78979923,17-78807115-C-T,rs3744796,-1,C,T,78807115,172808,78783315,79176531,23800
17,ENSG00000108679.5,78979923,17-78807115-C-G,rs3744796,-1,C,G,78807115,172808,78783315,79176531,23800
17,ENSG00000166685.5,73193055,17-73193043-A-C,rs3764359,1,A,C,73193043,12,72996447,73389663,196596
17,ENSG00000166685.5,73193055,17-73193043-A-G,rs3764359,1,A,G,73193043,12,72996447,73389663,196596
17,ENSG00000092871.11,35063707,17-35105735-G-T,rs3785754,-1,G,T,35105735,42028,34867099,35260315,238636
17,ENSG00000092871.11,35063707,17-35105735-G-C,rs3785754,-1,G,C,35105735,42028,34867099,35260315,238636
17,ENSG00000189152.5,19127589,17-19287629-G-A,rs3785787,1,G,A,19287629,160040,18930981,19324197,356648
17,ENSG00000189152.5,19127589,17-19287629-G-T,rs3785787,1,G,T,19287629,160040,18930981,19324197,356648
17,ENSG00000108511.8,48604986,17-48619054-C-G,rs3809775,-1,C,G,48619054,14068,48408378,48801594,210676
17,ENSG00000108511.8,48604986,17-48619054-C-A,rs3809775,-1,C,A,48619054,14068,48408378,48801594,210676
17,ENSG00000182156.5,79730943,17-79733322-G-A,rs3923265,1,G,A,79733322,2379,79534335,79927551,198987
17,ENSG00000170425.2,15945130,17-15834610-C-T,rs3925260,1,C,T,15834610,110520,15748522,16141738,86088
17,ENSG00000171634.11,67825503,17-67818266-C-G,rs3936134,1,C,G,67818266,7237,67628895,68022111,189371
17,ENSG00000091947.4,44014963,17-43997533-G-A,rs3964442,-1,G,A,43997533,17430,43818355,44211571,179178
17,ENSG00000179598.4,17206333,17-17123941-G-T,rs4074819,-1,G,T,17123941,82392,17009725,17402941,114216
17,ENSG00000179598.4,17206333,17-17123941-G-A,rs4074819,-1,G,A,17123941,82392,17009725,17402941,114216
17,ENSG00000169683.2,82023305,17-82021766-T-A,rs4077074,1,T,A,82021766,1539,81826697,82219913,195069
17,ENSG00000169683.2,82023305,17-82021766-T-C,rs4077074,1,T,C,82021766,1539,81826697,82219913,195069
17,ENSG00000141551.9,82273700,17-82234774-C-T,rs4077539,-1,C,T,82234774,38926,82077092,82470308,157682
17,ENSG00000171928.8,18781183,17-18812329-T-A,rs4123417,1,T,A,18812329,31146,18584575,18977791,227754
17,ENSG00000171928.8,18781183,17-18812329-T-C,rs4123417,1,T,C,18812329,31146,18584575,18977791,227754
17,ENSG00000141736.7,39700064,17-39715782-G-T,rs4252633,1,G,T,39715782,15718,39503456,39896672,212326
17,ENSG00000131467.4,42833397,17-43018881-T-A,rs429464,1,T,A,43018881,185484,42636789,43030005,382092
17,ENSG00000131467.4,42833397,17-43018881-T-C,rs429464,1,T,C,43018881,185484,42636789,43030005,382092
17,ENSG00000136485.8,63550477,17-63483656-C-T,rs4313,1,C,T,63483656,66821,63353869,63747085,129787
17,ENSG00000136485.8,63550477,17-63483656-C-G,rs4313,1,C,G,63483656,66821,63353869,63747085,129787
17,ENSG00000108950.6,68601367,17-68731783-C-T,rs4368217,-1,C,T,68731783,130416,68404759,68797975,327024
17,ENSG00000133195.6,73092688,17-73152237-C-T,rs4387653,-1,C,T,73152237,59549,72896080,73289296,256157
17,ENSG00000133195.6,73092688,17-73152237-C-A,rs4387653,-1,C,A,73152237,59549,72896080,73289296,256157
17,ENSG00000141569.5,75896951,17-75892192-C-A,rs4398150,-1,C,A,75892192,4759,75700343,76093559,191849
17,ENSG00000141569.5,75896951,17-75892192-C-T,rs4398150,-1,C,T,75892192,4759,75700343,76093559,191849
17,ENSG00000132478.4,75784806,17-75892192-C-A,rs4398150,1,C,A,75892192,107386,75588198,75981414,303994
17,ENSG00000132478.4,75784806,17-75892192-C-T,rs4398150,1,C,T,75892192,107386,75588198,75981414,303994
17,ENSG00000161921.10,4739928,17-4729671-T-C,rs4433856,-1,T,C,4729671,10257,4543320,4936536,186351
17,ENSG00000072778.12,7219938,17-7213534-C-A,rs446994,1,C,A,7213534,6404,7023330,7416546,190204
17,ENSG00000072778.12,7219938,17-7213534-C-T,rs446994,1,C,T,7213534,6404,7023330,7416546,190204
17,ENSG00000170291.8,7252215,17-7260420-A-G,rs4562,1,A,G,7260420,8205,7055607,7448823,204813
17,ENSG00000170291.8,7252215,17-7260420-A-T,rs4562,1,A,T,7260420,8205,7055607,7448823,204813
17,ENSG00000161594.5,41837825,17-41941933-T-C,rs4594300,1,T,C,41941933,104108,41641217,42034433,300716
17,ENSG00000161594.5,41837825,17-41941933-T-G,rs4594300,1,T,G,41941933,104108,41641217,42034433,300716
17,ENSG00000167863.6,75046969,17-75106316-G-A,rs4789142,-1,G,A,75106316,59347,74850361,75243577,255955
17,ENSG00000167863.6,75046969,17-75106316-G-T,rs4789142,-1,G,T,75106316,59347,74850361,75243577,255955
17,ENSG00000129667.6,76501423,17-76484633-T-G,rs4789302,-1,T,G,76484633,16790,76304815,76698031,179818
17,ENSG00000129667.6,76501423,17-76484633-T-C,rs4789302,-1,T,C,76484633,16790,76304815,76698031,179818
17,ENSG00000129667.6,76501423,17-76484633-T-A,rs4789302,-1,T,A,76484633,16790,76304815,76698031,179818
17,ENSG00000141580.10,82648444,17-82613184-A-G,rs4789704,-1,A,G,82613184,35260,82451836,82845052,161348
17,ENSG00000175832.7,43546340,17-43579424-C-A,rs4792900,-1,C,A,43579424,33084,43349732,43742948,229692
17,ENSG00000175832.7,43546340,17-43579424-C-G,rs4792900,-1,C,G,43579424,33084,43349732,43742948,229692
17,ENSG00000175832.7,43546340,17-43579424-C-T,rs4792900,-1,C,T,43579424,33084,43349732,43742948,229692
17,ENSG00000108439.4,47941571,17-47956739-T-C,rs4793734,1,T,C,47956739,15168,47744963,48138179,211776
17,ENSG00000167083.2,49210574,17-49202939-T-C,rs4794029,-1,T,C,49202939,7635,49013966,49407182,188973
17,ENSG00000161395.7,39688057,17-39611200-A-G,rs4795388,-1,A,G,39611200,76857,39491449,39884665,119751
17,ENSG00000004142.6,28357527,17-28389898-G-T,rs4795434,-1,G,T,28389898,32371,28160919,28554135,228979
17,ENSG00000109113.11,28717868,17-28898919-C-T,rs4795473,-1,C,T,28898919,181051,28521260,28914476,377659
17,ENSG00000109113.11,28717868,17-28898919-C-G,rs4795473,-1,C,G,28898919,181051,28521260,28914476,377659
17,ENSG00000132507.13,7307628,17-7304878-C-T,rs4796398,1,C,T,7304878,2750,7111020,7504236,193858
17,ENSG00000132507.13,7307628,17-7304878-C-G,rs4796398,1,C,G,7304878,2750,7111020,7504236,193858
17,ENSG00000141696.6,41811949,17-41837496-T-C,rs4796714,-1,T,C,41837496,25547,41615341,42008557,222155
17,ENSG00000161513.6,74872994,17-74872953-G-C,rs492095,-1,G,C,74872953,41,74676386,75069602,196567
17,ENSG00000161513.6,74872994,17-74872953-G-A,rs492095,-1,G,A,74872953,41,74676386,75069602,196567
17,ENSG00000171953.9,18039168,17-17895319-A-G,rs4925126,-1,A,G,17895319,143849,17842560,18235776,52759
17,ENSG00000182628.7,59155186,17-59199202-G-C,rs493740,-1,G,C,59199202,44016,58958578,59351794,240624
17,ENSG00000108932.6,68291127,17-68288654-C-T,rs4968868,-1,C,T,68288654,2473,68094519,68487735,194135
17,ENSG00000187775.10,78577396,17-78476773-C-T,rs4969207,-1,C,T,78476773,100623,78380788,78774004,95985
17,ENSG00000187775.10,78577396,17-78476773-C-A,rs4969207,-1,C,A,78476773,100623,78380788,78774004,95985
17,ENSG00000168792.2,29567037,17-29568510-T-A,rs497993,-1,T,A,29568510,1473,29370429,29763645,198081
17,ENSG00000168792.2,29567037,17-29568510-T-G,rs497993,-1,T,G,29568510,1473,29370429,29763645,198081
17,ENSG00000168792.2,29567037,17-29568510-T-C,rs497993,-1,T,C,29568510,1473,29370429,29763645,198081
17,ENSG00000136492.3,61863528,17-61863272-C-T,rs4988340,-1,C,T,61863272,256,61666920,62060136,196352
17,ENSG00000181856.10,7281718,17-7280727-G-A,rs5412,1,G,A,7280727,991,7085110,7478326,195617
17,ENSG00000108352.5,40177470,17-40208512-C-A,rs55673000,1,C,A,40208512,31042,39980862,40374078,227650
17,ENSG00000108352.5,40177470,17-40208512-C-T,rs55673000,1,C,T,40208512,31042,39980862,40374078,227650
17,ENSG00000187607.9,15699752,17-15703968-T-A,rs55748835,1,T,A,15703968,4216,15503144,15896360,200824
17,ENSG00000187607.9,15699752,17-15703968-T-G,rs55748835,1,T,G,15703968,4216,15503144,15896360,200824
17,ENSG00000187607.9,15699752,17-15703968-T-C,rs55748835,1,T,C,15703968,4216,15503144,15896360,200824
17,ENSG00000091640.3,4967817,17-5005426-A-G,rs55770506,-1,A,G,5005426,37609,4771209,5164425,234217
17,ENSG00000091640.3,4967817,17-5005426-A-T,rs55770506,-1,A,T,5005426,37609,4771209,5164425,234217
17,ENSG00000141316.6,32991847,17-32910749-C-A,rs55957450,1,C,A,32910749,81098,32795239,33188455,115510
17,ENSG00000172421.3,62380553,17-62570090-A-G,rs56186083,1,A,G,62570090,189537,62183945,62577161,386145
17,ENSG00000034152.13,21284711,17-21379298-C-T,rs56369900,1,C,T,21379298,94587,21088103,21481319,291195
17,ENSG00000034152.13,21284711,17-21379298-C-G,rs56369900,1,C,G,21379298,94587,21088103,21481319,291195
17,ENSG00000108651.3,31901708,17-31811171-T-G,rs58436179,-1,T,G,31811171,90537,31705100,32098316,106071
17,ENSG00000108786.4,42552923,17-42553082-C-T,rs597255,1,C,T,42553082,159,42356315,42749531,196767
17,ENSG00000184361.7,45262094,17-45257282-C-A,rs60163605,-1,C,A,45257282,4812,45065486,45458702,191796
17,ENSG00000184361.7,45262094,17-45257282-C-G,rs60163605,-1,C,G,45257282,4812,45065486,45458702,191796
17,ENSG00000136436.9,48831035,17-48840842-A-C,rs612720,1,A,C,48840842,9807,48634427,49027643,206415
17,ENSG00000136436.9,48831035,17-48840842-A-G,rs612720,1,A,G,48840842,9807,48634427,49027643,206415
17,ENSG00000136436.9,48831035,17-48840842-A-T,rs612720,1,A,T,48840842,9807,48634427,49027643,206415
17,ENSG00000167693.12,979776,17-825992-G-A,rs61731765,-1,G,A,825992,153784,783168,1176384,42824
17,ENSG00000169710.5,82098236,17-81933271-T-A,rs61747618,-1,T,A,81933271,164965,81901628,82294844,31643
17,ENSG00000169710.5,82098236,17-81933271-T-C,rs61747618,-1,T,C,81933271,164965,81901628,82294844,31643
17,ENSG00000167280.10,79074824,17-79083494-A-G,rs61756761,1,A,G,79083494,8670,78878216,79271432,205278
17,ENSG00000182557.3,4433940,17-4541790-G-A,rs62066360,1,G,A,4541790,107850,4237332,4630548,304458
17,ENSG00000167524.8,28614185,17-28527846-C-T,rs62066766,-1,C,T,28527846,86339,28417577,28810793,110269
17,ENSG00000180616.3,73165010,17-73157397-G-A,rs62071603,1,G,A,73157397,7613,72968402,73361618,188995
17,ENSG00000187997.6,78146385,17-78157867-C-T,rs62079083,1,C,T,78157867,11482,77949777,78342993,208090
17,ENSG00000187997.6,78146385,17-78157867-C-G,rs62079083,1,C,G,78157867,11482,77949777,78342993,208090
17,ENSG00000108798.4,49210707,17-49209747-G-A,rs634370,1,G,A,49209747,960,49014099,49407315,195648
17,ENSG00000108798.4,49210707,17-49209747-G-T,rs634370,1,G,T,49209747,960,49014099,49407315,195648
17,ENSG00000182173.7,75516528,17-75517353-A-G,rs6501819,1,A,G,75517353,825,75319920,75713136,197433
17,ENSG00000182173.7,75516528,17-75517353-A-T,rs6501819,1,A,T,75517353,825,75319920,75713136,197433
17,ENSG00000136448.6,45061317,17-45086483-T-G,rs6503422,1,T,G,45086483,25166,44864709,45257925,221774
17,ENSG00000136448.6,45061317,17-45086483-T-C,rs6503422,1,T,C,45086483,25166,44864709,45257925,221774
17,ENSG00000008838.11,40054408,17-40035671-A-G,rs6503534,-1,A,G,40035671,18737,39857800,40251016,177871
17,ENSG00000008838.11,40054408,17-40035671-A-T,rs6503534,-1,A,T,40035671,18737,39857800,40251016,177871
17,ENSG00000141293.9,48430214,17-48330072-T-C,rs6504172,-1,T,C,48330072,100142,48233606,48626822,96466
17,ENSG00000108576.4,30235697,17-30292352-A-C,rs6505170,-1,A,C,30292352,56655,30039089,30432305,253263
17,ENSG00000176974.11,18363550,17-18360643-G-C,rs669340,-1,G,C,18360643,2907,18166942,18560158,193701
17,ENSG00000176974.11,18363550,17-18360643-G-A,rs669340,-1,G,A,18360643,2907,18166942,18560158,193701
17,ENSG00000176974.11,18363550,17-18360643-G-T,rs669340,-1,G,T,18360643,2907,18166942,18560158,193701
17,ENSG00000170160.10,16690241,17-16797711-A-T,rs678522,1,A,T,16797711,107470,16493633,16886849,304078
17,ENSG00000109066.8,74776499,17-74862956-G-T,rs690371,1,G,T,74862956,86457,74579891,74973107,283065
17,ENSG00000109066.8,74776499,17-74862956-G-A,rs690371,1,G,A,74862956,86457,74579891,74973107,283065
17,ENSG00000087157.11,78378649,17-78490091-T-A,rs691323,1,T,A,78490091,111442,78182041,78575257,308050
17,ENSG00000087157.11,78378649,17-78490091-T-C,rs691323,1,T,C,78490091,111442,78182041,78575257,308050
17,ENSG00000196704.6,68248043,17-68256954-T-A,rs7105,1,T,A,68256954,8911,68051435,68444651,205519
17,ENSG00000189159.9,75154512,17-75030368-G-A,rs71380857,-1,G,A,75030368,124144,74957904,75351120,72464
17,ENSG00000189159.9,75154512,17-75030368-G-T,rs71380857,-1,G,T,75030368,124144,74957904,75351120,72464
17,ENSG00000128487.10,20009359,17-20098299-G-A,rs7207625,1,G,A,20098299,88940,19812751,20205967,285548
17,ENSG00000128487.10,20009359,17-20098299-G-C,rs7207625,1,G,C,20098299,88940,19812751,20205967,285548
17,ENSG00000035862.7,78925387,17-78947947-G-T,rs7208912,-1,G,T,78947947,22560,78728779,79121995,219168
17,ENSG00000131477.5,42761227,17-42723621-T-C,rs7209643,1,T,C,42723621,37606,42564619,42957835,159002
17,ENSG00000131473.10,41918951,17-42029141-A-G,rs7210636,-1,A,G,42029141,110190,41722343,42115559,306798
17,ENSG00000141295.8,47841273,17-47848524-A-G,rs7212099,-1,A,G,47848524,7251,47644665,48037881,203859
17,ENSG00000136450.6,58007246,17-58033296-G-C,rs7212100,-1,G,C,58033296,26050,57810638,58203854,222658
17,ENSG00000108825.11,42980528,17-42955268-G-A,rs7212564,-1,G,A,42955268,25260,42783920,43177136,171348
17,ENSG00000005882.6,50095351,17-50093531-G-A,rs7212617,1,G,A,50093531,1820,49898743,50291959,194788
17,ENSG00000181396.7,82418586,17-82421063-T-G,rs7213057,-1,T,G,82421063,2477,82221978,82615194,199085
17,ENSG00000181396.7,82418586,17-82421063-T-C,rs7213057,-1,T,C,82421063,2477,82221978,82615194,199085
17,ENSG00000181396.7,82418586,17-82421063-T-A,rs7213057,-1,T,A,82421063,2477,82221978,82615194,199085
17,ENSG00000121101.10,58692045,17-58774559-C-G,rs7214266,-1,C,G,58774559,82514,58495437,58888653,279122
17,ENSG00000121101.10,58692045,17-58774559-C-T,rs7214266,-1,C,T,58774559,82514,58495437,58888653,279122
17,ENSG00000129195.9,6444455,17-6437195-A-C,rs7214517,1,A,C,6437195,7260,6247847,6641063,189348
17,ENSG00000129195.9,6444455,17-6437195-A-T,rs7214517,1,A,T,6437195,7260,6247847,6641063,189348
17,ENSG00000132388.8,4366675,17-4303948-T-A,rs7216130,-1,T,A,4303948,62727,4170067,4563283,133881
17,ENSG00000167302.5,81239055,17-81273998-G-A,rs7216728,-1,G,A,81273998,34943,81042447,81435663,231551
17,ENSG00000167302.5,81239055,17-81273998-G-T,rs7216728,-1,G,T,81273998,34943,81042447,81435663,231551
17,ENSG00000167302.5,81239055,17-81273998-G-C,rs7216728,-1,G,C,81273998,34943,81042447,81435663,231551
17,ENSG00000132386.5,1762060,17-1781659-G-A,rs7216863,1,G,A,1781659,19599,1565452,1958668,216207
17,ENSG00000161958.5,7439512,17-7492230-A-T,rs7217258,1,A,T,7492230,52718,7242904,7636120,249326
17,ENSG00000161958.5,7439512,17-7492230-A-G,rs7217258,1,A,G,7492230,52718,7242904,7636120,249326
17,ENSG00000177885.8,75405678,17-75300472-G-T,rs7217413,-1,G,T,75300472,105206,75209070,75602286,91402
17,ENSG00000177885.8,75405678,17-75300472-G-C,rs7217413,-1,G,C,75300472,105206,75209070,75602286,91402
17,ENSG00000188878.9,75941042,17-75923457-G-A,rs7218738,-1,G,A,75923457,17585,75744434,76137650,179023
17,ENSG00000186532.7,1829902,17-1807298-C-T,rs7219095,-1,C,T,1807298,22604,1633294,2026510,174004
17,ENSG00000186532.7,1829902,17-1807298-C-G,rs7219095,-1,C,G,1807298,22604,1633294,2026510,174004
17,ENSG00000172809.7,74203678,17-74200252-C-A,rs7219464,1,C,A,74200252,3426,74007070,74400286,193182
17,ENSG00000153982.5,59220511,17-59243933-G-A,rs7220082,1,G,A,59243933,23422,59023903,59417119,220030
17,ENSG00000173065.8,28842790,17-29014416-A-G,rs7220474,-1,A,G,29014416,171626,28646182,29039398,368234
17,ENSG00000167105.3,50274466,17-50279635-A-G,rs7221526,1,A,G,50279635,5169,50077858,50471074,201777
17,ENSG00000167105.3,50274466,17-50279635-A-T,rs7221526,1,A,T,50279635,5169,50077858,50471074,201777
17,ENSG00000109118.7,28951518,17-28875870-G-C,rs7221773,-1,G,C,28875870,75648,28754910,29148126,120960
17,ENSG00000109118.7,28951518,17-28875870-G-A,rs7221773,-1,G,A,28875870,75648,28754910,29148126,120960
17,ENSG00000108771.6,42112714,17-42137346-G-A,rs7224737,-1,G,A,42137346,24632,41916106,42309322,221240
17,ENSG00000205309.7,17303373,17-17305389-C-T,rs7226045,1,C,T,17305389,2016,17106765,17499981,198624
17,ENSG00000205309.7,17303373,17-17305389-C-A,rs7226045,1,C,A,17305389,2016,17106765,17499981,198624
17,ENSG00000108556.7,4903098,17-4902094-G-A,rs72835059,-1,G,A,4902094,1004,4706490,5099706,195604
17,ENSG00000205710.3,4899536,17-4926522-G-A,rs72835079,1,G,A,4926522,26986,4702928,5096144,223594
17,ENSG00000205710.3,4899536,17-4926522-G-T,rs72835079,1,G,T,4926522,26986,4702928,5096144,223594
17,ENSG00000170004.12,7888789,17-8025664-T-C,rs72841487,1,T,C,8025664,136875,7692181,8085397,333483
17,ENSG00000170004.12,7888789,17-8025664-T-G,rs72841487,1,T,G,8025664,136875,7692181,8085397,333483
17,ENSG00000184185.4,21376357,17-21539286-C-G,rs72842005,1,C,G,21539286,162929,21179749,21572965,359537
17,ENSG00000184185.4,21376357,17-21539286-C-T,rs72842005,1,C,T,21539286,162929,21179749,21572965,359537
17,ENSG00000180901.5,75047225,17-75068856-G-C,rs72844534,1,G,C,75068856,21631,74850617,75243833,218239
17,ENSG00000180901.5,75047225,17-75068856-G-A,rs72844534,1,G,A,75068856,21631,74850617,75243833,218239
17,ENSG00000176108.5,80991841,17-81036173-A-G,rs72851872,1,A,G,81036173,44332,80795233,81188449,240940
17,ENSG00000141556.14,82752065,17-82929318-G-A,rs729123,1,G,A,82929318,177253,82555457,82948673,373861
17,ENSG00000125319.8,44141930,17-44161981-T-C,rs730228,1,T,C,44161981,20051,43945322,44338538,216659
17,ENSG00000214941.2,15999704,17-15999834-G-A,rs73276080,-1,G,A,15999834,130,15803096,16196312,196738
17,ENSG00000108306.6,39401626,17-39569554-G-A,rs73302588,-1,G,A,39569554,167928,39205018,39598234,364536
17,ENSG00000108306.6,39401626,17-39569554-G-T,rs73302588,-1,G,T,39569554,167928,39205018,39598234,364536
17,ENSG00000161905.7,4641678,17-4538423-C-G,rs73335852,-1,C,G,4538423,103255,4445070,4838286,93353
17,ENSG00000161905.7,4641678,17-4538423-C-A,rs73335852,-1,C,A,4538423,103255,4445070,4838286,93353
17,ENSG00000161905.7,4641678,17-4538423-C-T,rs73335852,-1,C,T,4538423,103255,4445070,4838286,93353
17,ENSG00000185527.7,81656542,17-81621316-T-C,rs73369283,-1,T,C,81621316,35226,81459934,81853150,161382
17,ENSG00000166484.13,19378498,17-19411298-T-C,rs739830,1,T,C,19411298,32800,19181890,19575106,229408
17,ENSG00000129646.8,76308276,17-76304210-A-G,rs73996304,-1,A,G,76304210,4066,76111668,76504884,192542
17,ENSG00000078687.11,78005056,17-77846029-T-C,rs7406199,1,T,C,77846029,159027,77808448,78201664,37581
17,ENSG00000141562.11,82458741,17-82469464-G-T,rs7406694,1,G,T,82469464,10723,82262133,82655349,207331
17,ENSG00000141562.11,82458741,17-82469464-G-C,rs7406694,1,G,C,82469464,10723,82262133,82655349,207331
17,ENSG00000108883.6,44899445,17-44932518-G-A,rs744281,-1,G,A,44932518,33073,44702837,45096053,229681
17,ENSG00000108883.6,44899445,17-44932518-G-T,rs744281,-1,G,T,44932518,33073,44702837,45096053,229681
17,ENSG00000108256.2,29294148,17-29417420-G-A,rs74925747,-1,G,A,29417420,123272,29097540,29490756,319880
17,ENSG00000141574.2,82333766,17-82376017-A-G,rs7502317,-1,A,G,82376017,42251,82137158,82530374,238859
17,ENSG00000185298.8,81666737,17-81664491-A-G,rs7502320,1,A,G,81664491,2246,81470129,81863345,194362
17,ENSG00000186765.7,81528377,17-81508845-G-C,rs7503750,1,G,C,81508845,19532,81331769,81724985,177076
17,ENSG00000186765.7,81528377,17-81508845-G-A,rs7503750,1,G,A,81508845,19532,81331769,81724985,177076
17,ENSG00000108799.6,42745040,17-42749806-T-C,rs752313,-1,T,C,42749806,4766,42548432,42941648,201374
17,ENSG00000108799.6,42745040,17-42749806-T-A,rs752313,-1,T,A,42749806,4766,42548432,42941648,201374
17,ENSG00000259207.2,47253827,17-47271687-G-A,rs75563753,1,G,A,47271687,17860,47057219,47450435,214468
17,ENSG00000108375.7,58417534,17-58347349-T-G,rs757485,-1,T,G,58347349,70185,58220926,58614142,126423
17,ENSG00000108375.7,58417534,17-58347349-T-C,rs757485,-1,T,C,58347349,70185,58220926,58614142,126423
17,ENSG00000168646.7,65561648,17-65565474-G-T,rs757558,-1,G,T,65565474,3826,65365040,65758256,200434
17,ENSG00000179859.7,7916289,17-7821549-T-C,rs75758523,-1,T,C,7821549,94740,7719681,8112897,101868
17,ENSG00000141367.5,59619895,17-59426291-G-C,rs758382,1,G,C,59426291,193604,59423287,59816503,3004
17,ENSG00000011052.16,51153590,17-51160591-C-A,rs76221971,1,C,A,51160591,7001,50956982,51350198,203609
17,ENSG00000171475.8,40219304,17-40241730-T-C,rs76277587,1,T,C,40241730,22426,40022696,40415912,219034
17,ENSG00000154229.6,66302613,17-66367135-A-G,rs764523,1,A,G,66367135,64522,66106005,66499221,261130
17,ENSG00000089558.2,42181142,17-42248694-C-A,rs76806513,-1,C,A,42248694,67552,41984534,42377750,264160
17,ENSG00000141568.13,82519732,17-82328114-C-A,rs77309989,1,C,A,82328114,191618,82323124,82716340,4990
17,ENSG00000141568.13,82519732,17-82328114-C-T,rs77309989,1,C,T,82328114,191618,82323124,82716340,4990
17,ENSG00000172716.11,35373621,17-35351808-A-G,rs77814639,-1,A,G,35351808,21813,35177013,35570229,174795
17,ENSG00000168591.10,44186972,17-43998999-G-C,rs77900930,1,G,C,43998999,187973,43990364,44383580,8635
17,ENSG00000168591.10,44186972,17-43998999-G-A,rs77900930,1,G,A,43998999,187973,43990364,44383580,8635
17,ENSG00000182446.8,81637112,17-81647108-T-G,rs78163298,-1,T,G,81647108,9996,81440504,81833720,206604
17,ENSG00000182446.8,81637112,17-81647108-T-C,rs78163298,-1,T,C,81647108,9996,81440504,81833720,206604
17,ENSG00000182446.8,81637112,17-81647108-T-A,rs78163298,-1,T,A,81647108,9996,81440504,81833720,206604
17,ENSG00000131759.12,40309180,17-40276973-A-C,rs78201730,1,A,C,40276973,32207,40112572,40505788,164401
17,ENSG00000131759.12,40309180,17-40276973-A-G,rs78201730,1,A,G,40276973,32207,40112572,40505788,164401
17,ENSG00000181284.2,7435435,17-7575084-C-G,rs78414518,1,C,G,7575084,139649,7238827,7632043,336257
17,ENSG00000167900.6,78187052,17-78234103-C-T,rs78780583,-1,C,T,78234103,47051,77990444,78383660,243659
17,ENSG00000108309.7,44308601,17-44489753-T-C,rs78965384,1,T,C,44489753,181152,44111993,44505209,377760
17,ENSG00000173812.4,41688885,17-41714986-T-G,rs79715822,1,T,G,41714986,26101,41492277,41885493,222709
17,ENSG00000173812.4,41688885,17-41714986-T-C,rs79715822,1,T,C,41714986,26101,41492277,41885493,222709
17,ENSG00000005156.5,34980512,17-35087739-C-A,rs797989,1,C,A,35087739,107227,34783904,35177120,303835
17,ENSG00000168256.12,42020090,17-41954317-A-G,rs80162003,1,A,G,41954317,65773,41823482,42216698,130835
17,ENSG00000006695.5,14069504,17-14109705-G-C,rs8064562,1,G,C,14109705,40201,13872896,14266112,236809
17,ENSG00000006695.5,14069504,17-14109705-G-A,rs8064562,1,G,A,14109705,40201,13872896,14266112,236809
17,ENSG00000174292.7,7381089,17-7369744-C-T,rs8066451,1,C,T,7369744,11345,7184481,7577697,185263
17,ENSG00000176390.9,30824692,17-30775327-T-G,rs8067338,-1,T,G,30775327,49365,30628084,31021300,147243
17,ENSG00000176390.9,30824692,17-30775327-T-C,rs8067338,-1,T,C,30775327,49365,30628084,31021300,147243
17,ENSG00000131480.3,42844580,17-42927357-T-C,rs8067341,1,T,C,42927357,82777,42647972,43041188,279385
17,ENSG00000073605.12,39918635,17-39895095-A-C,rs8067378,-1,A,C,39895095,23540,39722027,40115243,173068
17,ENSG00000073605.12,39918635,17-39895095-A-G,rs8067378,-1,A,G,39895095,23540,39722027,40115243,173068
17,ENSG00000186075.7,39868202,17-39895095-A-C,rs8067378,1,A,C,39895095,26893,39671594,40064810,223501
17,ENSG00000186075.7,39868202,17-39895095-A-G,rs8067378,1,A,G,39895095,26893,39671594,40064810,223501
17,ENSG00000182963.4,44830287,17-44854825-C-T,rs8067689,-1,C,T,44854825,24538,44633679,45026895,221146
17,ENSG00000167895.8,78130771,17-78136611-T-C,rs8068430,1,T,C,78136611,5840,77934163,78327379,202448
17,ENSG00000108510.4,62065278,17-62163315-G-A,rs8069151,-1,G,A,62163315,98037,61868670,62261886,294645
17,ENSG00000236383.1,43228623,17-43189967-A-G,rs8070085,-1,A,G,43189967,38656,43032015,43425231,157952
17,ENSG00000196712.10,31094977,17-31261672-A-G,rs8072417,1,A,G,31261672,166695,30898369,31291585,363303
17,ENSG00000170412.11,74432088,17-74393831-G-A,rs8073071,1,G,A,74393831,38257,74235480,74628696,158351
17,ENSG00000184451.4,42681843,17-42588259-G-C,rs8073311,-1,G,C,42588259,93584,42485235,42878451,103024
17,ENSG00000184451.4,42681843,17-42588259-G-T,rs8073311,-1,G,T,42588259,93584,42485235,42878451,103024
17,ENSG00000167842.11,5486566,17-5523795-T-C,rs8074853,1,T,C,5523795,37229,5289958,5683174,233837
17,ENSG00000161653.4,44004622,17-44000862-G-A,rs8074997,1,G,A,44000862,3760,43808014,44201230,192848
17,ENSG00000109063.7,10657309,17-10698004-C-T,rs8075503,-1,C,T,10698004,40695,10460701,10853917,237303
17,ENSG00000109063.7,10657309,17-10698004-C-A,rs8075503,-1,C,A,10698004,40695,10460701,10853917,237303
17,ENSG00000174327.6,7036015,17-7065381-T-C,rs8075513,1,T,C,7065381,29366,6839407,7232623,225974
17,ENSG00000006282.13,50547174,17-50548567-C-G,rs8076632,1,C,G,50548567,1393,50350566,50743782,198001
17,ENSG00000073670.7,44758988,17-44864100-T-C,rs8077272,1,T,C,44864100,105112,44562380,44955596,301720
17,ENSG00000181523.7,80220333,17-80207628-C-T,rs8078181,-1,C,T,80207628,12705,80023725,80416941,183903
17,ENSG00000178921.8,8249289,17-8225842-A-G,rs8078338,1,A,G,8225842,23447,8052681,8445897,173161
17,ENSG00000224877.2,81239318,17-81201316-C-T,rs8079383,1,C,T,81201316,38002,81042710,81435926,158606
17,ENSG00000198231.6,63774170,17-63652522-A-G,rs8080211,1,A,G,63652522,121648,63577562,63970778,74960
17,ENSG00000132470.8,75721459,17-75752027-C-T,rs820391,1,C,T,75752027,30568,75524851,75918067,227176
17,ENSG00000108823.11,50166005,17-50151620-T-A,rs847688,1,T,A,50151620,14385,49969397,50362613,182223
17,ENSG00000108823.11,50166005,17-50151620-T-G,rs847688,1,T,G,50151620,14385,49969397,50362613,182223
17,ENSG00000108823.11,50166005,17-50151620-T-C,rs847688,1,T,C,50151620,14385,49969397,50362613,182223
17,ENSG00000091542.7,18183828,17-18170002-T-C,rs854798,1,T,C,18170002,13826,17987220,18380436,182782
17,ENSG00000177427.7,18260662,17-18164090-A-G,rs854804,1,A,G,18164090,96572,18064054,18457270,100036
17,ENSG00000177427.7,18260662,17-18164090-A-T,rs854804,1,A,T,18164090,96572,18064054,18457270,100036
17,ENSG00000183010.11,81937300,17-81852587-A-G,rs876016,-1,A,G,81852587,84713,81740692,82133908,111895
17,ENSG00000183010.11,81937300,17-81852587-A-T,rs876016,-1,A,T,81852587,84713,81740692,82133908,111895
17,ENSG00000126351.7,40062965,17-40096407-G-A,rs883871,1,G,A,40096407,33442,39866357,40259573,230050
17,ENSG00000129673.4,76467603,17-76483732-C-T,rs885140,1,C,T,76483732,16129,76270995,76664211,212737
17,ENSG00000072210.12,19648751,17-19742625-A-C,rs887241,1,A,C,19742625,93874,19452143,19845359,290482
17,ENSG00000072210.12,19648751,17-19742625-A-T,rs887241,1,A,T,19742625,93874,19452143,19845359,290482
17,ENSG00000108262.9,29589648,17-29582334-C-T,rs894606,-1,C,T,29582334,7314,29393040,29786256,189294
17,ENSG00000073350.8,75525697,17-75563261-G-C,rs936060,1,G,C,75563261,37564,75329089,75722305,234172
17,ENSG00000073350.8,75525697,17-75563261-G-A,rs936060,1,G,A,75563261,37564,75329089,75722305,234172
17,ENSG00000167434.4,60149973,17-59969622-A-G,rs9890003,1,A,G,59969622,180351,59953365,60346581,16257
17,ENSG00000011295.7,15999824,17-16029313-T-C,rs9890012,1,T,C,16029313,29489,15803216,16196432,226097
17,ENSG00000181222.10,7484366,17-7675361-A-G,rs9895829,1,A,G,7675361,190995,7287758,7680974,387603
17,ENSG00000172171.5,30906238,17-30860479-A-T,rs9896095,-1,A,T,30860479,45759,30709630,31102846,150849
17,ENSG00000172171.5,30906238,17-30860479-A-G,rs9896095,-1,A,G,30860479,45759,30709630,31102846,150849
17,ENSG00000141741.6,39730532,17-39739722-A-C,rs9896940,-1,A,C,39739722,9190,39533924,39927140,205798
17,ENSG00000141741.6,39730532,17-39739722-A-G,rs9896940,-1,A,G,39739722,9190,39533924,39927140,205798
17,ENSG00000141698.10,41836232,17-41836332-C-A,rs9897034,-1,C,A,41836332,100,41639624,42032840,196708
17,ENSG00000141698.10,41836232,17-41836332-C-T,rs9897034,-1,C,T,41836332,100,41639624,42032840,196708
17,ENSG00000141698.10,41836232,17-41836332-C-G,rs9897034,-1,C,G,41836332,100,41639624,42032840,196708
17,ENSG00000132530.11,6756046,17-6899220-A-C,rs9897943,1,A,C,6899220,143174,6559438,6952654,339782
17,ENSG00000062725.4,60526242,17-60649064-C-T,rs9898109,-1,C,T,60649064,122822,60329634,60722850,319430
17,ENSG00000172992.6,45051632,17-45038945-C-T,rs9898793,-1,C,T,45038945,12687,44855024,45248240,183921
17,ENSG00000109065.6,74776345,17-74772483-C-T,rs9898841,-1,C,T,74772483,3862,74579737,74972953,192746
17,ENSG00000073584.13,40647818,17-40617695-C-G,rs9902509,-1,C,G,40617695,30123,40451210,40844426,166485
17,ENSG00000073584.13,40647818,17-40617695-C-T,rs9902509,-1,C,T,40617695,30123,40451210,40844426,166485
17,ENSG00000092931.6,76738119,17-76737427-C-G,rs9902624,1,C,G,76737427,692,76541511,76934727,195916
17,ENSG00000092931.6,76738119,17-76737427-C-T,rs9902624,1,C,T,76737427,692,76541511,76934727,195916
17,ENSG00000179604.7,73312001,17-73315555-G-A,rs9902729,-1,G,A,73315555,3554,73115393,73508609,200162
17,ENSG00000141576.8,76240493,17-76239124-A-C,rs9903178,-1,A,C,76239124,1369,76043885,76437101,195239
17,ENSG00000141576.8,76240493,17-76239124-A-G,rs9903178,-1,A,G,76239124,1369,76043885,76437101,195239
17,ENSG00000141576.8,76240493,17-76239124-A-T,rs9903178,-1,A,T,76239124,1369,76043885,76437101,195239
17,ENSG00000073861.1,47733236,17-47831335-G-A,rs9904966,1,G,A,47831335,98099,47536628,47929844,294707
17,ENSG00000073861.1,47733236,17-47831335-G-C,rs9904966,1,G,C,47831335,98099,47536628,47929844,294707
17,ENSG00000168961.11,27631188,17-27641274-G-A,rs9905566,1,G,A,27641274,10086,27434580,27827796,206694
17,ENSG00000154760.9,35448766,17-35480231-T-A,rs9905892,-1,T,A,35480231,31465,35252158,35645374,228073
17,ENSG00000154760.9,35448766,17-35480231-T-G,rs9905892,-1,T,G,35480231,31465,35252158,35645374,228073
17,ENSG00000108861.3,43778977,17-43632167-G-A,rs9905917,-1,G,A,43632167,146810,43582369,43975585,49798
17,ENSG00000161714.6,45132515,17-45306158-G-A,rs9906772,-1,G,A,45306158,173643,44935907,45329123,370251
17,ENSG00000108506.6,61927982,17-62072573-C-T,rs9907047,-1,C,T,62072573,144591,61731374,62124590,341199
17,ENSG00000177602.4,3723903,17-3724179-C-T,rs9907144,1,C,T,3724179,276,3527295,3920511,196884
17,ENSG00000177602.4,3723903,17-3724179-C-G,rs9907144,1,C,G,3724179,276,3527295,3920511,196884
17,ENSG00000083457.6,3801188,17-3724179-C-T,rs9907144,-1,C,T,3724179,77009,3604580,3997796,119599
17,ENSG00000083457.6,3801188,17-3724179-C-G,rs9907144,-1,C,G,3724179,77009,3604580,3997796,119599
17,ENSG00000136490.3,63700125,17-63791011-A-G,rs9907702,-1,A,G,63791011,90886,63503517,63896733,287494
17,ENSG00000169738.1,82037697,17-82034939-A-C,rs9908344,-1,A,C,82034939,2758,81841089,82234305,193850
17,ENSG00000169738.1,82037697,17-82034939-A-G,rs9908344,-1,A,G,82034939,2758,81841089,82234305,193850
17,ENSG00000198336.4,47209348,17-47075548-C-A,rs9908463,1,C,A,47075548,133800,47012740,47405956,62808
17,ENSG00000132481.1,75878581,17-75877313-A-G,rs9908862,-1,A,G,75877313,1268,75681973,76075189,195340
17,ENSG00000124422.6,21043011,17-21010843-G-A,rs9909279,-1,G,A,21010843,32168,20846403,21239619,164440
17,ENSG00000075461.4,66964707,17-67038851-C-A,rs9910905,1,C,A,67038851,74144,66768099,67161315,270752
17,ENSG00000075461.4,66964707,17-67038851-C-G,rs9910905,1,C,G,67038851,74144,66768099,67161315,270752
17,ENSG00000179477.4,8087716,17-8068322-G-C,rs9911427,-1,G,C,8068322,19394,7891108,8284324,177214
17,ENSG00000179477.4,8087716,17-8068322-G-A,rs9911427,-1,G,A,8068322,19394,7891108,8284324,177214
17,ENSG00000065320.4,9021510,17-9107126-C-T,rs9914560,1,C,T,9107126,85616,8824902,9218118,282224
17,ENSG00000065320.4,9021510,17-9107126-C-G,rs9914560,1,C,G,9107126,85616,8824902,9218118,282224
17,ENSG00000007237.10,10198606,17-10268374-T-A,rs9914572,-1,T,A,10268374,69768,10001998,10395214,266376
17,ENSG00000182534.7,76710965,17-76710142-T-C,rs9915664,-1,T,C,76710142,823,76514357,76907573,195785
17,ENSG00000182534.7,76710965,17-76710142-T-A,rs9915664,-1,T,A,76710142,823,76514357,76907573,195785
17,ENSG00000161405.11,39864312,17-39805567-G-A,rs9941391,-1,G,A,39805567,58745,39667704,40060920,137863
17,ENSG00000161405.11,39864312,17-39805567-G-T,rs9941391,-1,G,T,39805567,58745,39667704,40060920,137863
17,ENSG00000184060.5,30921945,17-30832311-G-A,rs999797,1,G,A,30832311,89634,30725337,31118553,106974
17,ENSG00000108852.10,43907536,17-43916513-C-G,rs1035284,-1,C,G,43916513,8977,43710928,44104144,205585
17,ENSG00000196689.6,3609411,17-3544620-C-T,rs1039519,-1,C,T,3544620,64791,3412803,3806019,131817
17,ENSG00000068079.3,43006784,17-42993510-C-T,rs1043284,1,C,T,42993510,13274,42810176,43203392,183334
17,ENSG00000006282.13,50547174,17-50531356-T-C,rs1064055,1,T,C,50531356,15818,50350566,50743782,180790
17,ENSG00000006282.13,50547174,17-50531356-T-A,rs1064055,1,T,A,50531356,15818,50350566,50743782,180790
17,ENSG00000006282.13,50547174,17-50531356-T-G,rs1064055,1,T,G,50531356,15818,50350566,50743782,180790
17,ENSG00000070540.7,68457496,17-68490686-C-T,rs10852738,-1,C,T,68490686,33190,68260888,68654104,229798
17,ENSG00000070540.7,68457496,17-68490686-C-A,rs10852738,-1,C,A,68490686,33190,68260888,68654104,229798
17,ENSG00000125450.5,75205679,17-75191024-G-C,rs11077778,1,G,C,75191024,14655,75009071,75402287,181953
17,ENSG00000125450.5,75205679,17-75191024-G-A,rs11077778,1,G,A,75191024,14655,75009071,75402287,181953
17,ENSG00000006695.5,14069504,17-14207584-A-G,rs11078234,1,A,G,14207584,138080,13872896,14266112,334688
17,ENSG00000006695.5,14069504,17-14207584-A-T,rs11078234,1,A,T,14207584,138080,13872896,14266112,334688
17,ENSG00000006695.5,14069504,17-14207584-A-C,rs11078234,1,A,C,14207584,138080,13872896,14266112,334688
17,ENSG00000205544.3,7404097,17-7407154-A-C,rs11078674,-1,A,C,7407154,3057,7207489,7600705,199665
17,ENSG00000174282.7,7479631,17-7521618-C-T,rs11078691,-1,C,T,7521618,41987,7283023,7676239,238595
17,ENSG00000174282.7,7479631,17-7521618-C-G,rs11078691,-1,C,G,7521618,41987,7283023,7676239,238595
17,ENSG00000182224.6,7858003,17-7873896-G-T,rs11078711,1,G,T,7873896,15893,7661395,8054611,212501
17,ENSG00000172057.4,39927601,17-39752614-C-A,rs11078921,-1,C,A,39752614,174987,39730993,40124209,21621
17,ENSG00000186075.7,39868202,17-39752614-C-A,rs11078921,1,C,A,39752614,115588,39671594,40064810,81020
17,ENSG00000175832.7,43546340,17-43433482-A-G,rs11079387,-1,A,G,43433482,112858,43349732,43742948,83750
17,ENSG00000175832.7,43546340,17-43433482-A-T,rs11079387,-1,A,T,43433482,112858,43349732,43742948,83750
17,ENSG00000141294.4,47831670,17-47834936-C-T,rs11079797,1,C,T,47834936,3266,47635062,48028278,199874
17,ENSG00000189120.2,47851163,17-47878707-A-C,rs11079799,-1,A,C,47878707,27544,47654555,48047771,224152
17,ENSG00000189120.2,47851163,17-47878707-A-G,rs11079799,-1,A,G,47878707,27544,47654555,48047771,224152
17,ENSG00000189120.2,47851163,17-47878707-A-T,rs11079799,-1,A,T,47878707,27544,47654555,48047771,224152
17,ENSG00000167100.10,50130160,17-49980509-G-C,rs11079881,-1,G,C,49980509,149651,49933552,50326768,46957
17,ENSG00000167100.10,50130160,17-49980509-G-A,rs11079881,-1,G,A,49980509,149651,49933552,50326768,46957
17,ENSG00000141551.9,82273700,17-82260296-A-G,rs111285726,-1,A,G,82260296,13404,82077092,82470308,183204
17,ENSG00000185298.8,81666737,17-81663208-A-G,rs11150804,1,A,G,81663208,3529,81470129,81863345,193079
17,ENSG00000185298.8,81666737,17-81663208-A-T,rs11150804,1,A,T,81663208,3529,81470129,81863345,193079
17,ENSG00000182612.6,81642413,17-81663208-A-G,rs11150804,1,A,G,81663208,20795,81445805,81839021,217403
17,ENSG00000182612.6,81642413,17-81663208-A-T,rs11150804,1,A,T,81663208,20795,81445805,81839021,217403
17,ENSG00000167524.8,28614185,17-28444547-A-G,rs111661889,-1,A,G,28444547,169638,28417577,28810793,26970
17,ENSG00000167524.8,28614185,17-28444547-A-T,rs111661889,-1,A,T,28444547,169638,28417577,28810793,26970
17,ENSG00000124422.6,21043011,17-20948672-A-G,rs11204324,-1,A,G,20948672,94339,20846403,21239619,102269
17,ENSG00000124422.6,21043011,17-20948672-A-T,rs11204324,-1,A,T,20948672,94339,20846403,21239619,102269
17,ENSG00000141564.9,80544838,17-80396348-G-A,rs112152354,1,G,A,80396348,148490,80348230,80741446,48118
17,ENSG00000131477.5,42761227,17-42833562-C-T,rs11542143,1,C,T,42833562,72335,42564619,42957835,268943
17,ENSG00000129214.9,7630135,17-7559238-G-A,rs11552708,1,G,A,7559238,70897,7433527,7826743,125711
17,ENSG00000129214.9,7630135,17-7559238-G-C,rs11552708,1,G,C,7559238,70897,7433527,7826743,125711
17,ENSG00000182459.4,82359247,17-82321773-C-T,rs11575031,1,C,T,82321773,37474,82162639,82555855,159134
17,ENSG00000167183.1,47957883,17-47950486-G-A,rs11650043,-1,G,A,47950486,7397,47761275,48154491,189211
17,ENSG00000108641.9,19362723,17-19551061-T-C,rs11650156,-1,T,C,19551061,188338,19166115,19559331,384946
17,ENSG00000075461.4,66964707,17-67036944-A-T,rs11650741,1,A,T,67036944,72237,66768099,67161315,268845
17,ENSG00000075461.4,66964707,17-67036944-A-G,rs11650741,1,A,G,67036944,72237,66768099,67161315,268845
17,ENSG00000166750.4,35243072,17-35265572-C-T,rs11651240,1,C,T,35265572,22500,35046464,35439680,219108
17,ENSG00000141574.2,82333766,17-82397724-T-A,rs11652009,-1,T,A,82397724,63958,82137158,82530374,260566
17,ENSG00000141574.2,82333766,17-82397724-T-C,rs11652009,-1,T,C,82397724,63958,82137158,82530374,260566
17,ENSG00000171962.9,17972862,17-18018847-C-T,rs11652819,1,C,T,18018847,45985,17776254,18169470,242593
17,ENSG00000073670.7,44758988,17-44578375-G-C,rs11654001,1,G,C,44578375,180613,44562380,44955596,15995
17,ENSG00000073670.7,44758988,17-44578375-G-A,rs11654001,1,G,A,44578375,180613,44562380,44955596,15995
17,ENSG00000073670.7,44758988,17-44578375-G-T,rs11654001,1,G,T,44578375,180613,44562380,44955596,15995
17,ENSG00000131462.2,42609683,17-42645443-T-C,rs11654121,1,T,C,42645443,35760,42413075,42806291,232368
17,ENSG00000232859.3,27893365,17-27989788-T-A,rs11654191,-1,T,A,27989788,96423,27696757,28089973,293031
17,ENSG00000232859.3,27893365,17-27989788-T-C,rs11654191,-1,T,C,27989788,96423,27696757,28089973,293031
17,ENSG00000232859.3,27893365,17-27989788-T-G,rs11654191,-1,T,G,27989788,96423,27696757,28089973,293031
17,ENSG00000161405.11,39864312,17-40013441-C-T,rs11655821,-1,C,T,40013441,149129,39667704,40060920,345737
17,ENSG00000188554.7,43171214,17-43189010-C-A,rs117796976,1,C,A,43189010,17796,42974606,43367822,214404
17,ENSG00000010244.10,32350157,17-32489780-C-T,rs118075579,1,C,T,32489780,139623,32153549,32546765,336231
17,ENSG00000179859.7,7916289,17-7727187-T-C,rs11867551,-1,T,C,7727187,189102,7719681,8112897,7506
17,ENSG00000175866.10,81035151,17-81128530-T-C,rs11871062,1,T,C,81128530,93379,80838543,81231759,289987
17,ENSG00000170315.6,16381091,17-16495241-C-T,rs11871620,1,C,T,16495241,114150,16184483,16577699,310758
17,ENSG00000170315.6,16381091,17-16495241-C-A,rs11871620,1,C,A,16495241,114150,16184483,16577699,310758
17,ENSG00000181350.7,16492193,17-16495241-C-T,rs11871620,-1,C,T,16495241,3048,16295585,16688801,199656
17,ENSG00000181350.7,16492193,17-16495241-C-A,rs11871620,-1,C,A,16495241,3048,16295585,16688801,199656
17,ENSG00000141499.10,7688477,17-7640576-C-T,rs12051767,1,C,T,7640576,47901,7491869,7885085,148707
17,ENSG00000170291.8,7252215,17-7260031-A-G,rs1215,1,A,G,7260031,7816,7055607,7448823,204424
17,ENSG00000108599.8,19977828,17-19967410-G-A,rs12325682,-1,G,A,19967410,10418,19781220,20174436,186190
17,ENSG00000129195.9,6444455,17-6454854-A-C,rs12449488,1,A,C,6454854,10399,6247847,6641063,207007
17,ENSG00000129195.9,6444455,17-6454854-A-G,rs12449488,1,A,G,6454854,10399,6247847,6641063,207007
17,ENSG00000161664.1,44170704,17-44016811-C-A,rs12450548,1,C,A,44016811,153893,43974096,44367312,42715
17,ENSG00000187624.7,410325,17-388402-T-G,rs12450894,1,T,G,388402,21923,213717,606933,174685
17,ENSG00000187624.7,410325,17-388402-T-A,rs12450894,1,T,A,388402,21923,213717,606933,174685
17,ENSG00000187624.7,410325,17-388402-T-C,rs12450894,1,T,C,388402,21923,213717,606933,174685
17,ENSG00000133030.12,17042457,17-17040309-A-C,rs12601422,1,A,C,17040309,2148,16845849,17239065,194460
17,ENSG00000133030.12,17042457,17-17040309-A-T,rs12601422,1,A,T,17040309,2148,16845849,17239065,194460
17,ENSG00000181031.11,352807,17-237970-A-T,rs12603796,-1,A,T,237970,114837,156199,549415,81771
17,ENSG00000181031.11,352807,17-237970-A-C,rs12603796,-1,A,C,237970,114837,156199,549415,81771
17,ENSG00000136492.3,61863528,17-61856635-A-C,rs12603878,-1,A,C,61856635,6893,61666920,62060136,189715
17,ENSG00000179604.7,73312001,17-73284583-T-A,rs12795,-1,T,A,73284583,27418,73115393,73508609,169190
17,ENSG00000179604.7,73312001,17-73284583-T-C,rs12795,-1,T,C,73284583,27418,73115393,73508609,169190
17,ENSG00000189050.9,59964740,17-59851958-T-C,rs1292068,-1,T,C,59851958,112782,59768132,60161348,83826
17,ENSG00000189050.9,59964740,17-59851958-T-G,rs1292068,-1,T,G,59851958,112782,59768132,60161348,83826
17,ENSG00000173868.7,49230787,17-49367080-T-C,rs12937634,-1,T,C,49367080,136293,49034179,49427395,332901
17,ENSG00000173868.7,49230787,17-49367080-T-A,rs12937634,-1,T,A,49367080,136293,49034179,49427395,332901
17,ENSG00000141198.9,54900852,17-54854469-C-A,rs12940613,1,C,A,54854469,46383,54704244,55097460,150225
17,ENSG00000141198.9,54900852,17-54854469-C-T,rs12940613,1,C,T,54854469,46383,54704244,55097460,150225
17,ENSG00000108384.9,58692602,17-58567455-T-C,rs12944693,1,T,C,58567455,125147,58495994,58889210,71461
17,ENSG00000182628.7,59155186,17-59132952-G-T,rs12945875,-1,G,T,59132952,22234,58958578,59351794,174374
17,ENSG00000182628.7,59155186,17-59132952-G-A,rs12945875,-1,G,A,59132952,22234,58958578,59351794,174374
17,ENSG00000141580.10,82648444,17-82616656-A-G,rs12950772,-1,A,G,82616656,31788,82451836,82845052,164820
17,ENSG00000141580.10,82648444,17-82616656-A-C,rs12950772,-1,A,C,82616656,31788,82451836,82845052,164820
17,ENSG00000141562.11,82458741,17-82491821-C-T,rs1317685,1,C,T,82491821,33080,82262133,82655349,229688
17,ENSG00000141562.11,82458741,17-82491821-C-G,rs1317685,1,C,G,82491821,33080,82262133,82655349,229688
17,ENSG00000108826.11,50373184,17-50520814-A-C,rs1460213,-1,A,C,50520814,147630,50176576,50569792,344238
17,ENSG00000108826.11,50373184,17-50520814-A-G,rs1460213,-1,A,G,50520814,147630,50176576,50569792,344238
17,ENSG00000108826.11,50373184,17-50520814-A-T,rs1460213,-1,A,T,50520814,147630,50176576,50569792,344238
17,ENSG00000108924.7,55264960,17-55284477-T-C,rs1477141,1,T,C,55284477,19517,55068352,55461568,216125
17,ENSG00000108924.7,55264960,17-55284477-T-G,rs1477141,1,T,G,55284477,19517,55068352,55461568,216125
17,ENSG00000108924.7,55264960,17-55284477-T-A,rs1477141,1,T,A,55284477,19517,55068352,55461568,216125
17,ENSG00000250506.1,76000855,17-75889724-C-A,rs1551619,1,C,A,75889724,111131,75804247,76197463,85477
17,ENSG00000250506.1,76000855,17-75889724-C-T,rs1551619,1,C,T,75889724,111131,75804247,76197463,85477
17,ENSG00000006042.5,32928153,17-32970468-A-T,rs1557752,1,A,T,32970468,42315,32731545,33124761,238923
17,ENSG00000006042.5,32928153,17-32970468-A-G,rs1557752,1,A,G,32970468,42315,32731545,33124761,238923
17,ENSG00000006042.5,32928153,17-32970468-A-C,rs1557752,1,A,C,32970468,42315,32731545,33124761,238923
17,ENSG00000120088.9,45784320,17-45679603-A-C,rs1635288,1,A,C,45679603,104717,45587712,45980928,91891
17,ENSG00000120088.9,45784320,17-45679603-A-T,rs1635288,1,A,T,45679603,104717,45587712,45980928,91891
17,ENSG00000120088.9,45784320,17-45679603-A-G,rs1635288,1,A,G,45679603,104717,45587712,45980928,91891
17,ENSG00000141279.7,47531108,17-47693188-T-C,rs16942912,1,T,C,47693188,162080,47334500,47727716,358688
17,ENSG00000108387.9,58544328,17-58623311-G-A,rs16943142,-1,G,A,58623311,78983,58347720,58740936,275591
17,ENSG00000198740.4,49362250,17-49549049-T-C,rs16948257,-1,T,C,49549049,186799,49165642,49558858,383407
17,ENSG00000005882.6,50095351,17-50094913-A-G,rs16948691,1,A,G,50094913,438,49898743,50291959,196170
17,ENSG00000005882.6,50095351,17-50094913-A-T,rs16948691,1,A,T,50094913,438,49898743,50291959,196170
17,ENSG00000132517.10,5035426,17-5201895-G-A,rs16954473,-1,G,A,5201895,166469,4838818,5232034,363077
17,ENSG00000183011.8,7857559,17-7787792-G-T,rs16956952,-1,G,T,7787792,69767,7660951,8054167,126841
17,ENSG00000141027.13,16215534,17-16374264-C-T,rs16959630,-1,C,T,16374264,158730,16018926,16412142,355338
17,ENSG00000108370.10,65137370,17-65277266-C-T,rs16961970,1,C,T,65277266,139896,64940762,65333978,336504
17,ENSG00000178691.5,31937007,17-31787844-C-T,rs16966900,1,C,T,31787844,149163,31740399,32133615,47445
17,ENSG00000168259.7,42017439,17-42112875-C-T,rs16967499,-1,C,T,42112875,95436,41820831,42214047,292044
17,ENSG00000126861.3,31297239,17-31305974-A-G,rs16972178,-1,A,G,31305974,8735,31100631,31493847,205343
17,ENSG00000126860.5,31321622,17-31371919-C-T,rs16972221,-1,C,T,31371919,50297,31125014,31518230,246905
17,ENSG00000154803.7,17237168,17-17244311-C-T,rs1708628,-1,C,T,17244311,7143,17040560,17433776,203751
17,ENSG00000167740.3,4143197,17-4104356-A-G,rs17176181,1,A,G,4104356,38841,3946589,4339805,157767
17,ENSG00000186868.10,45894554,17-45823708-A-G,rs173365,1,A,G,45823708,70846,45697946,46091162,125762
17,ENSG00000186868.10,45894554,17-45823708-A-C,rs173365,1,A,C,45823708,70846,45697946,46091162,125762
17,ENSG00000186868.10,45894554,17-45823708-A-T,rs173365,1,A,T,45823708,70846,45697946,46091162,125762
17,ENSG00000129657.8,77140969,17-77194030-C-T,rs17540424,1,C,T,77194030,53061,76944361,77337577,249669
17,ENSG00000172716.11,35373621,17-35374471-T-C,rs17548596,-1,T,C,35374471,850,35177013,35570229,197458
17,ENSG00000132481.1,75878581,17-75797966-T-C,rs17581498,-1,T,C,75797966,80615,75681973,76075189,115993
17,ENSG00000132481.1,75878581,17-75797966-T-G,rs17581498,-1,T,G,75797966,80615,75681973,76075189,115993
17,ENSG00000161544.4,76537709,17-76442038-A-T,rs17596582,-1,A,T,76442038,95671,76341101,76734317,100937
17,ENSG00000168591.10,44186972,17-44278330-C-T,rs17614452,1,C,T,44278330,91358,43990364,44383580,287966
17,ENSG00000159210.4,48944842,17-48801263-A-G,rs17634167,-1,A,G,48801263,143579,48748234,49141450,53029
17,ENSG00000154258.10,69060927,17-69021789-T-C,rs17684521,-1,T,C,69021789,39138,68864319,69257535,157470
17,ENSG00000108984.8,69414697,17-69521284-G-A,rs17690945,1,G,A,69521284,106587,69218089,69611305,303195
17,ENSG00000173917.8,48545109,17-48489772-T-C,rs17703660,-1,T,C,48489772,55337,48348501,48741717,141271
17,ENSG00000167543.9,29568701,17-29544007-A-G,rs17766675,1,A,G,29544007,24694,29372093,29765309,171914
17,ENSG00000108582.5,30378927,17-30254025-T-G,rs17767256,1,T,G,30254025,124902,30182319,30575535,71706
17,ENSG00000108582.5,30378927,17-30254025-T-A,rs17767256,1,T,A,30254025,124902,30182319,30575535,71706
17,ENSG00000256806.1,6651762,17-6574706-C-T,rs17804092,1,C,T,6574706,77056,6455154,6848370,119552
17,ENSG00000136436.9,48831035,17-48873507-A-T,rs178467,1,A,T,48873507,42472,48634427,49027643,239080
17,ENSG00000136436.9,48831035,17-48873507-A-G,rs178467,1,A,G,48873507,42472,48634427,49027643,239080
17,ENSG00000132359.9,2796438,17-2793022-C-T,rs178573,1,C,T,2793022,3416,2599830,2993046,193192
17,ENSG00000132359.9,2796438,17-2793022-C-G,rs178573,1,C,G,2793022,3416,2599830,2993046,193192
17,ENSG00000072210.12,19648751,17-19661321-C-G,rs1800869,1,C,G,19661321,12570,19452143,19845359,209178
17,ENSG00000072210.12,19648751,17-19661321-C-T,rs1800869,1,C,T,19661321,12570,19452143,19845359,209178
17,ENSG00000108821.8,50201631,17-50170328-C-T,rs1801191,-1,C,T,50170328,31303,50005023,50398239,165305
17,ENSG00000214226.4,56833920,17-56755082-A-G,rs191955432,-1,A,G,56755082,78838,56637312,57030528,117770
17,ENSG00000170425.2,15945130,17-15774570-T-G,rs1971159,1,T,G,15774570,170560,15748522,16141738,26048
17,ENSG00000109084.8,28319200,17-28321466-G-A,rs1981512,1,G,A,28321466,2266,28122592,28515808,198874
17,ENSG00000007314.6,63972918,17-63965855-A-G,rs2008896,-1,A,G,63965855,7063,63776310,64169526,189545
17,ENSG00000072818.6,7336529,17-7334027-T-C,rs2047803,1,T,C,7334027,2502,7139921,7533137,194106
17,ENSG00000154025.10,18952165,17-18969208-A-G,rs2074273,1,A,G,18969208,17043,18755557,19148773,213651
17,ENSG00000108405.3,3916465,17-3904738-A-C,rs2074989,-1,A,C,3904738,11727,3719857,4113073,184881
17,ENSG00000108405.3,3916465,17-3904738-A-G,rs2074989,-1,A,G,3904738,11727,3719857,4113073,184881
17,ENSG00000087191.7,63827431,17-63728247-G-A,rs2137144,1,G,A,63728247,99184,63630823,64024039,97424
17,ENSG00000177602.4,3723903,17-3724918-T-C,rs220461,1,T,C,3724918,1015,3527295,3920511,197623
17,ENSG00000197417.7,3636250,17-3605586-G-T,rs222741,-1,G,T,3605586,30664,3439642,3832858,165944
17,ENSG00000197417.7,3636250,17-3605586-G-A,rs222741,-1,G,A,3605586,30664,3439642,3832858,165944
17,ENSG00000197417.7,3636250,17-3605586-G-C,rs222741,-1,G,C,3605586,30664,3439642,3832858,165944
17,ENSG00000213977.3,3668578,17-3585577-G-A,rs222745,-1,G,A,3585577,83001,3471970,3865186,113607
17,ENSG00000040531.10,3636760,17-3650765-G-T,rs222779,1,G,T,3650765,14005,3440152,3833368,210613
17,ENSG00000040531.10,3636760,17-3650765-G-A,rs222779,1,G,A,3650765,14005,3440152,3833368,210613
17,ENSG00000153933.5,56834151,17-56834568-G-A,rs2235092,1,G,A,56834568,417,56637543,57030759,197025
17,ENSG00000153933.5,56834151,17-56834568-G-T,rs2235092,1,G,T,56834568,417,56637543,57030759,197025
17,ENSG00000153933.5,56834151,17-56834568-G-C,rs2235092,1,G,C,56834568,417,56637543,57030759,197025
17,ENSG00000168646.7,65561648,17-65558473-G-C,rs2240308,-1,G,C,65558473,3175,65365040,65758256,193433
17,ENSG00000168646.7,65561648,17-65558473-G-A,rs2240308,-1,G,A,65558473,3175,65365040,65758256,193433
17,ENSG00000006125.11,35587322,17-35593017-A-G,rs225306,1,A,G,35593017,5695,35390714,35783930,202303
17,ENSG00000006125.11,35587322,17-35593017-A-C,rs225306,1,A,C,35593017,5695,35390714,35783930,202303
17,ENSG00000224877.2,81239318,17-81239762-T-C,rs2255166,1,T,C,81239762,444,81042710,81435926,197052
17,ENSG00000224877.2,81239318,17-81239762-T-A,rs2255166,1,T,A,81239762,444,81042710,81435926,197052
17,ENSG00000125691.7,38853721,17-38880235-C-T,rs226213,-1,C,T,38880235,26514,38657113,39050329,223122
17,ENSG00000125319.8,44141930,17-44018516-T-C,rs228781,1,T,C,44018516,123414,43945322,44338538,73194
17,ENSG00000214447.3,44899774,17-44883641-C-G,rs2289677,1,C,G,44883641,16133,44703166,45096382,180475
17,ENSG00000214447.3,44899774,17-44883641-C-T,rs2289677,1,C,T,44883641,16133,44703166,45096382,180475
17,ENSG00000177885.8,75405678,17-75234868-G-A,rs2291032,-1,G,A,75234868,170810,75209070,75602286,25798
17,ENSG00000177885.8,75405678,17-75234868-G-C,rs2291032,-1,G,C,75234868,170810,75209070,75602286,25798
17,ENSG00000181513.9,45135687,17-45254998-A-G,rs2291448,1,A,G,45254998,119311,44939079,45332295,315919
17,ENSG00000167850.3,74546115,17-74474006-G-T,rs2293189,-1,G,T,74474006,72109,74349507,74742723,124499
17,ENSG00000167850.3,74546115,17-74474006-G-A,rs2293189,-1,G,A,74474006,72109,74349507,74742723,124499
17,ENSG00000083457.6,3801188,17-3695750-C-T,rs2293880,-1,C,T,3695750,105438,3604580,3997796,91170
17,ENSG00000011143.11,58219255,17-58305116-C-T,rs2301868,-1,C,T,58305116,85861,58022647,58415863,282469
17,ENSG00000011052.16,51153590,17-51153539-C-A,rs2302254,1,C,A,51153539,51,50956982,51350198,196557
17,ENSG00000011052.16,51153590,17-51153539-C-T,rs2302254,1,C,T,51153539,51,50956982,51350198,196557
17,ENSG00000181523.7,80220333,17-80201684-T-C,rs2304856,-1,T,C,80201684,18649,80023725,80416941,177959
17,ENSG00000141295.8,47841273,17-47844540-T-C,rs2325752,-1,T,C,47844540,3267,47644665,48037881,199875
17,ENSG00000141295.8,47841273,17-47844540-T-G,rs2325752,-1,T,G,47844540,3267,47644665,48037881,199875
17,ENSG00000183018.3,4498881,17-4497551-A-G,rs2326064,1,A,G,4497551,1330,4302273,4695489,195278
17,ENSG00000183018.3,4498881,17-4497551-A-C,rs2326064,1,A,C,4497551,1330,4302273,4695489,195278
17,ENSG00000183018.3,4498881,17-4497551-A-T,rs2326064,1,A,T,4497551,1330,4302273,4695489,195278
17,ENSG00000092931.6,76738119,17-76737017-G-C,rs237057,1,G,C,76737017,1102,76541511,76934727,195506
17,ENSG00000092931.6,76738119,17-76737017-G-A,rs237057,1,G,A,76737017,1102,76541511,76934727,195506
17,ENSG00000087157.11,78378649,17-78406024-A-C,rs2376583,1,A,C,78406024,27375,78182041,78575257,223983
17,ENSG00000087157.11,78378649,17-78406024-A-T,rs2376583,1,A,T,78406024,27375,78182041,78575257,223983
17,ENSG00000181038.7,76726839,17-76748932-C-T,rs2429452,1,C,T,76748932,22093,76530231,76923447,218701
17,ENSG00000176974.11,18363550,17-18362153-C-T,rs2461837,-1,C,T,18362153,1397,18166942,18560158,195211
17,ENSG00000167842.11,5486566,17-5437730-G-C,rs2472614,1,G,C,5437730,48836,5289958,5683174,147772
17,ENSG00000167842.11,5486566,17-5437730-G-A,rs2472614,1,G,A,5437730,48836,5289958,5683174,147772
17,ENSG00000167842.11,5486566,17-5437730-G-T,rs2472614,1,G,T,5437730,48836,5289958,5683174,147772
17,ENSG00000108439.4,47941571,17-47999599-A-G,rs2525096,1,A,G,47999599,58028,47744963,48138179,254636
17,ENSG00000108375.7,58417534,17-58351733-A-T,rs2526375,-1,A,T,58351733,65801,58220926,58614142,130807
17,ENSG00000108375.7,58417534,17-58351733-A-G,rs2526375,-1,A,G,58351733,65801,58220926,58614142,130807
17,ENSG00000108375.7,58417534,17-58351733-A-C,rs2526375,-1,A,C,58351733,65801,58220926,58614142,130807
17,ENSG00000213246.1,58352201,17-58326988-A-C,rs2526378,-1,A,C,58326988,25213,58155593,58548809,171395
17,ENSG00000213246.1,58352201,17-58326988-A-G,rs2526378,-1,A,G,58326988,25213,58155593,58548809,171395
17,ENSG00000213246.1,58352201,17-58326988-A-T,rs2526378,-1,A,T,58326988,25213,58155593,58548809,171395
17,ENSG00000064300.4,49495293,17-49489224-C-A,rs2537710,1,C,A,49489224,6069,49298685,49691901,190539
17,ENSG00000064300.4,49495293,17-49489224-C-G,rs2537710,1,C,G,49489224,6069,49298685,49691901,190539
17,ENSG00000141504.7,7627821,17-7635645-C-A,rs2543553,-1,C,A,7635645,7824,7431213,7824429,204432
17,ENSG00000108443.8,59893121,17-59808764-T-G,rs2645487,1,T,G,59808764,84357,59696513,60089729,112251
17,ENSG00000108443.8,59893121,17-59808764-T-A,rs2645487,1,T,A,59808764,84357,59696513,60089729,112251
17,ENSG00000141293.9,48430214,17-48252822-T-C,rs2957932,-1,T,C,48252822,177392,48233606,48626822,19216
17,ENSG00000141293.9,48430214,17-48252822-T-G,rs2957932,-1,T,G,48252822,177392,48233606,48626822,19216
17,ENSG00000141293.9,48430214,17-48252822-T-A,rs2957932,-1,T,A,48252822,177392,48233606,48626822,19216
17,ENSG00000108559.6,5419662,17-5378463-G-A,rs3026105,-1,G,A,5378463,41199,5223054,5616270,155409
17,ENSG00000170004.12,7888789,17-7721745-T-C,rs307627,1,T,C,7721745,167044,7692181,8085397,29564
17,ENSG00000170004.12,7888789,17-7721745-T-G,rs307627,1,T,G,7721745,167044,7692181,8085397,29564
17,ENSG00000170004.12,7888789,17-7721745-T-A,rs307627,1,T,A,7721745,167044,7692181,8085397,29564
17,ENSG00000258315.1,7014782,17-6974080-G-A,rs311734,1,G,A,6974080,40702,6818174,7211390,155906
17,ENSG00000005156.5,34980512,17-34986292-G-A,rs3135966,1,G,A,34986292,5780,34783904,35177120,202388
17,ENSG00000005156.5,34980512,17-34986292-G-T,rs3135966,1,G,T,34986292,5780,34783904,35177120,202388
17,ENSG00000182963.4,44830287,17-44926116-T-C,rs3169733,-1,T,C,44926116,95829,44633679,45026895,292437
17,ENSG00000141337.6,68291495,17-68250275-A-T,rs3213690,1,A,T,68250275,41220,68094887,68488103,155388
17,ENSG00000141337.6,68291495,17-68250275-A-G,rs3213690,1,A,G,68250275,41220,68094887,68488103,155388
17,ENSG00000109046.9,27294114,17-27382312-G-T,rs322190,1,G,T,27382312,88198,27097506,27490722,284806
17,ENSG00000175906.2,43398993,17-43407654-G-A,rs34228036,1,G,A,43407654,8661,43202385,43595601,205269
17,ENSG00000108298.4,39200283,17-39145832-C-A,rs34266566,1,C,A,39145832,54451,39003675,39396891,142157
17,ENSG00000108298.4,39200283,17-39145832-C-T,rs34266566,1,C,T,39145832,54451,39003675,39396891,142157
17,ENSG00000161921.10,4739928,17-4903019-G-C,rs34563587,-1,G,C,4903019,163091,4543320,4936536,359699
17,ENSG00000161921.10,4739928,17-4903019-G-A,rs34563587,-1,G,A,4903019,163091,4543320,4936536,359699
17,ENSG00000129204.11,5116032,17-5029546-C-T,rs346818,1,C,T,5029546,86486,4919424,5312640,110122
17,ENSG00000108771.6,42112714,17-42111440-T-C,rs34891485,-1,T,C,42111440,1274,41916106,42309322,195334
17,ENSG00000182156.5,79730943,17-79722218-C-T,rs35246623,1,C,T,79722218,8725,79534335,79927551,187883
17,ENSG00000182156.5,79730943,17-79722218-C-A,rs35246623,1,C,A,79722218,8725,79534335,79927551,187883
17,ENSG00000167711.9,1742871,17-1745728-C-T,rs35259159,1,C,T,1745728,2857,1546263,1939479,199465
17,ENSG00000108784.3,42536241,17-42620270-T-A,rs35635959,1,T,A,42620270,84029,42339633,42732849,280637
17,ENSG00000108784.3,42536241,17-42620270-T-C,rs35635959,1,T,C,42620270,84029,42339633,42732849,280637
17,ENSG00000186566.5,44503406,17-44358852-G-A,rs35941271,-1,G,A,44358852,144554,44306798,44700014,52054
17,ENSG00000187997.6,78146385,17-78166053-C-T,rs3644,1,C,T,78166053,19668,77949777,78342993,216276
17,ENSG00000188878.9,75941042,17-75978805-T-C,rs3744034,-1,T,C,75978805,37763,75744434,76137650,234371
17,ENSG00000072134.10,19237366,17-19403853-G-T,rs3744391,1,G,T,19403853,166487,19040758,19433974,363095
17,ENSG00000072134.10,19237366,17-19403853-G-C,rs3744391,1,G,C,19403853,166487,19040758,19433974,363095
17,ENSG00000181856.10,7281718,17-7289936-G-T,rs3744405,1,G,T,7289936,8218,7085110,7478326,204826
17,ENSG00000181856.10,7281718,17-7289936-G-A,rs3744405,1,G,A,7289936,8218,7085110,7478326,204826
17,ENSG00000141570.6,79797077,17-79784892-G-A,rs3751957,-1,G,A,79784892,12185,79600469,79993685,184423
17,ENSG00000167131.10,44899729,17-44916487-A-T,rs3760379,1,A,T,44916487,16758,44703121,45096337,213366
17,ENSG00000167131.10,44899729,17-44916487-A-G,rs3760379,1,A,G,44916487,16758,44703121,45096337,213366
17,ENSG00000108262.9,29589648,17-29621826-C-T,rs3760456,-1,C,T,29621826,32178,29393040,29786256,228786
17,ENSG00000196704.6,68248043,17-68248437-T-A,rs3764855,1,T,A,68248437,394,68051435,68444651,197002
17,ENSG00000196704.6,68248043,17-68248437-T-G,rs3764855,1,T,G,68248437,394,68051435,68444651,197002
17,ENSG00000196704.6,68248043,17-68248437-T-C,rs3764855,1,T,C,68248437,394,68051435,68444651,197002
17,ENSG00000108468.9,48101478,17-48182704-T-C,rs3805372,-1,T,C,48182704,81226,47904870,48298086,277834
17,ENSG00000108468.9,48101478,17-48182704-T-A,rs3805372,-1,T,A,48182704,81226,47904870,48298086,277834
17,ENSG00000160602.7,28728788,17-28738193-T-C,rs3809797,1,T,C,28738193,9405,28532180,28925396,206013
17,ENSG00000160602.7,28728788,17-28738193-T-G,rs3809797,1,T,G,28738193,9405,28532180,28925396,206013
17,ENSG00000132382.9,4555384,17-4555303-G-C,rs3809849,-1,G,C,4555303,81,4358776,4751992,196527
17,ENSG00000132382.9,4555384,17-4555303-G-T,rs3809849,-1,G,T,4555303,81,4358776,4751992,196527
17,ENSG00000184988.2,43211875,17-43019464-G-T,rs382571,1,G,T,43019464,192411,43015267,43408483,4197
17,ENSG00000184988.2,43211875,17-43019464-G-A,rs382571,1,G,A,43019464,192411,43015267,43408483,4197
17,ENSG00000214087.4,81683797,17-81655869-T-C,rs3830068,-1,T,C,81655869,27928,81487189,81880405,168680
17,ENSG00000132475.3,75779779,17-75725076-G-A,rs3851021,-1,G,A,75725076,54703,75583171,75976387,141905
17,ENSG00000169738.1,82037697,17-82022880-C-A,rs3934983,-1,C,A,82022880,14817,81841089,82234305,181791
17,ENSG00000205710.3,4899536,17-4903803-T-C,rs3966782,1,T,C,4903803,4267,4702928,5096144,200875
17,ENSG00000181396.7,82418586,17-82436204-G-A,rs4072532,-1,G,A,82436204,17618,82221978,82615194,214226
17,ENSG00000181396.7,82418586,17-82436204-G-C,rs4072532,-1,G,C,82436204,17618,82221978,82615194,214226
17,ENSG00000181396.7,82418586,17-82436204-G-T,rs4072532,-1,G,T,82436204,17618,82221978,82615194,214226
17,ENSG00000132386.5,1762060,17-1942656-T-C,rs4073661,1,T,C,1942656,180596,1565452,1958668,377204
17,ENSG00000181408.2,82371765,17-82386714-G-A,rs4073961,1,G,A,82386714,14949,82175157,82568373,211557
17,ENSG00000240505.2,16972118,17-16987505-T-G,rs4075606,-1,T,G,16987505,15387,16775510,17168726,211995
17,ENSG00000240505.2,16972118,17-16987505-T-C,rs4075606,-1,T,C,16987505,15387,16775510,17168726,211995
17,ENSG00000240505.2,16972118,17-16987505-T-A,rs4075606,-1,T,A,16987505,15387,16775510,17168726,211995
17,ENSG00000259024.1,15563561,17-15607542-C-T,rs41346256,-1,C,T,15607542,43981,15366953,15760169,240589
17,ENSG00000154945.6,50707914,17-50656384-G-C,rs4148411,-1,G,C,50656384,51530,50511306,50904522,145078
17,ENSG00000187838.10,7394525,17-7439363-C-G,rs4151122,-1,C,G,7439363,44838,7197917,7591133,241446
17,ENSG00000187838.10,7394525,17-7439363-C-T,rs4151122,-1,C,T,7439363,44838,7197917,7591133,241446
17,ENSG00000169718.12,82065804,17-82081076-T-G,rs4246444,-1,T,G,82081076,15272,81869196,82262412,211880
17,ENSG00000141127.8,18858131,17-18676396-T-A,rs4449005,1,T,A,18676396,181735,18661523,19054739,14873
17,ENSG00000141127.8,18858131,17-18676396-T-C,rs4449005,1,T,C,18676396,181735,18661523,19054739,14873
17,ENSG00000141543.4,80147128,17-79951924-C-T,rs4503834,-1,C,T,79951924,195204,79950520,80343736,1404
17,ENSG00000141543.4,80147128,17-79951924-C-A,rs4503834,-1,C,A,79951924,195204,79950520,80343736,1404
17,ENSG00000108950.6,68601367,17-68756343-A-T,rs4541139,-1,A,T,68756343,154976,68404759,68797975,351584
17,ENSG00000108950.6,68601367,17-68756343-A-G,rs4541139,-1,A,G,68756343,154976,68404759,68797975,351584
17,ENSG00000108961.8,8288670,17-8129964-C-G,rs4545881,1,C,G,8129964,158706,8092062,8485278,37902
17,ENSG00000108961.8,8288670,17-8129964-C-T,rs4545881,1,C,T,8129964,158706,8092062,8485278,37902
17,ENSG00000173818.12,80415167,17-80502268-G-A,rs4561525,1,G,A,80502268,87101,80218559,80611775,283709
17,ENSG00000171475.8,40219304,17-40258097-G-T,rs4566234,1,G,T,40258097,38793,40022696,40415912,235401
17,ENSG00000171475.8,40219304,17-40258097-G-A,rs4566234,1,G,A,40258097,38793,40022696,40415912,235401
17,ENSG00000259224.1,7481446,17-7394133-A-G,rs4613118,1,A,G,7394133,87313,7284838,7678054,109295
17,ENSG00000259224.1,7481446,17-7394133-A-T,rs4613118,1,A,T,7394133,87313,7284838,7678054,109295
17,ENSG00000170703.10,48817229,17-48755936-G-C,rs4629011,-1,G,C,48755936,61293,48620621,49013837,135315
17,ENSG00000170703.10,48817229,17-48755936-G-A,rs4629011,-1,G,A,48755936,61293,48620621,49013837,135315
17,ENSG00000170703.10,48817229,17-48755936-G-T,rs4629011,-1,G,T,48755936,61293,48620621,49013837,135315
17,ENSG00000167895.8,78130771,17-78142496-A-G,rs4789015,1,A,G,78142496,11725,77934163,78327379,208333
17,ENSG00000167895.8,78130771,17-78142496-A-T,rs4789015,1,A,T,78142496,11725,77934163,78327379,208333
17,ENSG00000167895.8,78130771,17-78142496-A-C,rs4789015,1,A,C,78142496,11725,77934163,78327379,208333
17,ENSG00000055483.10,78840814,17-78881589-C-A,rs4789940,-1,C,A,78881589,40775,78644206,79037422,237383
17,ENSG00000161929.9,5234860,17-5068360-A-T,rs4790246,-1,A,T,5068360,166500,5038252,5431468,30108
17,ENSG00000161929.9,5234860,17-5068360-A-G,rs4790246,-1,A,G,5068360,166500,5038252,5431468,30108
17,ENSG00000179111.3,8124106,17-7967816-T-C,rs4792023,-1,T,C,7967816,156290,7927498,8320714,40318
17,ENSG00000178971.8,8248056,17-8257284-T-C,rs4792687,-1,T,C,8257284,9228,8051448,8444664,205836
17,ENSG00000178971.8,8248056,17-8257284-T-A,rs4792687,-1,T,A,8257284,9228,8051448,8444664,205836
17,ENSG00000108666.4,32342173,17-32307344-C-T,rs4794915,-1,C,T,32307344,34829,32145565,32538781,161779
17,ENSG00000109118.7,28951518,17-28969251-A-G,rs4795480,-1,A,G,28969251,17733,28754910,29148126,214341
17,ENSG00000168961.11,27631188,17-27568007-G-A,rs4795747,1,G,A,27568007,63181,27434580,27827796,133427
17,ENSG00000161594.5,41837825,17-41727537-A-G,rs4796691,1,A,G,41727537,110288,41641217,42034433,86320
17,ENSG00000161594.5,41837825,17-41727537-A-T,rs4796691,1,A,T,41727537,110288,41641217,42034433,86320
17,ENSG00000141756.11,41813004,17-41940220-G-A,rs4796744,1,G,A,41940220,127216,41616396,42009612,323824
17,ENSG00000141756.11,41813004,17-41940220-G-C,rs4796744,1,G,C,41940220,127216,41616396,42009612,323824
17,ENSG00000171298.8,80101581,17-80084052-G-A,rs4889814,1,G,A,80084052,17529,79904973,80298189,179079
17,ENSG00000131759.12,40309180,17-40447297-A-C,rs4890114,1,A,C,40447297,138117,40112572,40505788,334725
17,ENSG00000131759.12,40309180,17-40447297-A-G,rs4890114,1,A,G,40447297,138117,40112572,40505788,334725
17,ENSG00000178789.3,74531475,17-74676064-C-A,rs495713,-1,C,A,74676064,144589,74334867,74728083,341197
17,ENSG00000154263.11,69228824,17-69182813-C-T,rs4968851,-1,C,T,69182813,46011,69032216,69425432,150597
17,ENSG00000154263.11,69228824,17-69182813-C-A,rs4968851,-1,C,A,69182813,46011,69032216,69425432,150597
17,ENSG00000154263.11,69228824,17-69182813-C-G,rs4968851,-1,C,G,69182813,46011,69032216,69425432,150597
17,ENSG00000187531.7,81918176,17-82017959-C-G,rs4969475,-1,C,G,82017959,99783,81721568,82114784,296391
17,ENSG00000187531.7,81918176,17-82017959-C-T,rs4969475,-1,C,T,82017959,99783,81721568,82114784,296391
17,ENSG00000091592.9,5584509,17-5770807-T-C,rs4985687,-1,T,C,5770807,186298,5387901,5781117,382906
17,ENSG00000067191.10,39197669,17-39198813-C-A,rs521633,-1,C,A,39198813,1144,39001061,39394277,197752
17,ENSG00000067191.10,39197669,17-39198813-C-G,rs521633,-1,C,G,39198813,1144,39001061,39394277,197752
17,ENSG00000132478.4,75784806,17-75651349-C-T,rs55853884,1,C,T,75651349,133457,75588198,75981414,63151
17,ENSG00000161395.7,39688057,17-39669996-A-G,rs5638,-1,A,G,39669996,18061,39491449,39884665,178547
17,ENSG00000205309.7,17303373,17-17331326-G-A,rs56383549,1,G,A,17331326,27953,17106765,17499981,224561
17,ENSG00000141026.2,17477000,17-17331326-G-A,rs56383549,1,G,A,17331326,145674,17280392,17673608,50934
17,ENSG00000136449.9,50508439,17-50459143-G-T,rs57223264,1,G,T,50459143,49296,50311831,50705047,147312
17,ENSG00000136449.9,50508439,17-50459143-G-A,rs57223264,1,G,A,50459143,49296,50311831,50705047,147312
17,ENSG00000159202.11,48908407,17-48885491-C-A,rs58376900,1,C,A,48885491,22916,48711799,49105015,173692
17,ENSG00000159202.11,48908407,17-48885491-C-G,rs58376900,1,C,G,48885491,22916,48711799,49105015,173692
17,ENSG00000159202.11,48908407,17-48885491-C-T,rs58376900,1,C,T,48885491,22916,48711799,49105015,173692
17,ENSG00000170049.5,7929856,17-8035059-C-T,rs60415448,-1,C,T,8035059,105203,7733248,8126464,301811
17,ENSG00000129673.4,76467603,17-76489222-T-G,rs61088918,1,T,G,76489222,21619,76270995,76664211,218227
17,ENSG00000179409.6,752264,17-822487-G-A,rs61197180,-1,G,A,822487,70223,555656,948872,266831
17,ENSG00000186185.7,44947773,17-45114656-T-G,rs61516629,-1,T,G,45114656,166883,44751165,45144381,363491
17,ENSG00000175931.7,76453152,17-76468754-C-T,rs61739395,-1,C,T,76468754,15602,76256544,76649760,212210
17,ENSG00000175931.7,76453152,17-76468754-C-A,rs61739395,-1,C,A,76468754,15602,76256544,76649760,212210
17,ENSG00000213859.3,7352162,17-7272525-C-T,rs62059189,1,C,T,7272525,79637,7155554,7548770,116971
17,ENSG00000240445.2,18682314,17-18682866-G-A,rs62073687,-1,G,A,18682866,552,18485706,18878922,197160
17,ENSG00000240445.2,18682314,17-18682866-G-C,rs62073687,-1,G,C,18682866,552,18485706,18878922,197160
17,ENSG00000078687.11,78005056,17-77889088-C-T,rs62078513,1,C,T,77889088,115968,77808448,78201664,80640
17,ENSG00000182534.7,76710965,17-76752247-T-C,rs62086788,-1,T,C,76752247,41282,76514357,76907573,237890
17,ENSG00000004142.6,28357527,17-28536905-C-T,rs624196,-1,C,T,28536905,179378,28160919,28554135,375986
17,ENSG00000167693.12,979776,17-999562-G-A,rs62640032,-1,G,A,999562,19786,783168,1176384,216394
17,ENSG00000167693.12,979776,17-999562-G-T,rs62640032,-1,G,T,999562,19786,783168,1176384,216394
17,ENSG00000168792.2,29567037,17-29564846-A-G,rs636000,-1,A,G,29564846,2191,29370429,29763645,194417
17,ENSG00000171595.8,74274234,17-74282731-A-G,rs6501705,1,A,G,74282731,8497,74077626,74470842,205105
17,ENSG00000175711.4,83051770,17-83083462-A-G,rs6502044,-1,A,G,83083462,31692,82855162,83248378,228300
17,ENSG00000180787.5,5078467,17-5053297-A-T,rs6502832,1,A,T,5053297,25170,4881859,5275075,171438
17,ENSG00000180787.5,5078467,17-5053297-A-G,rs6502832,1,A,G,5053297,25170,4881859,5275075,171438
17,ENSG00000161381.8,39151637,17-39074161-C-G,rs6503745,-1,C,G,39074161,77476,38955029,39348245,119132
17,ENSG00000087995.10,62423897,17-62603107-A-T,rs6504112,1,A,T,62603107,179210,62227289,62620505,375818
17,ENSG00000087995.10,62423897,17-62603107-A-G,rs6504112,1,A,G,62603107,179210,62227289,62620505,375818
17,ENSG00000087995.10,62423897,17-62603107-A-C,rs6504112,1,A,C,62603107,179210,62227289,62620505,375818
17,ENSG00000198231.6,63774170,17-63735295-G-A,rs6504177,1,G,A,63735295,38875,63577562,63970778,157733
17,ENSG00000007171.11,27800529,17-27937085-T-A,rs6505066,-1,T,A,27937085,136556,27603921,27997137,333164
17,ENSG00000007171.11,27800529,17-27937085-T-C,rs6505066,-1,T,C,27937085,136556,27603921,27997137,333164
17,ENSG00000007171.11,27800529,17-27937085-T-G,rs6505066,-1,T,G,27937085,136556,27603921,27997137,333164
17,ENSG00000170689.7,48626358,17-48803569-G-C,rs677521,-1,G,C,48803569,177211,48429750,48822966,373819
17,ENSG00000170689.7,48626358,17-48803569-G-A,rs677521,-1,G,A,48803569,177211,48429750,48822966,373819
17,ENSG00000170689.7,48626358,17-48803569-G-T,rs677521,-1,G,T,48803569,177211,48429750,48822966,373819
17,ENSG00000180901.5,75047225,17-74904329-A-T,rs690476,1,A,T,74904329,142896,74850617,75243833,53712
17,ENSG00000180901.5,75047225,17-74904329-A-C,rs690476,1,A,C,74904329,142896,74850617,75243833,53712
17,ENSG00000180901.5,75047225,17-74904329-A-G,rs690476,1,A,G,74904329,142896,74850617,75243833,53712
17,ENSG00000187775.10,78577396,17-78490091-T-A,rs691323,-1,T,A,78490091,87305,78380788,78774004,109303
17,ENSG00000187775.10,78577396,17-78490091-T-C,rs691323,-1,T,C,78490091,87305,78380788,78774004,109303
17,ENSG00000212658.1,41302851,17-41364996-A-C,rs71373411,-1,A,C,41364996,62145,41106243,41499459,258753
17,ENSG00000004897.6,47189295,17-47347921-C-T,rs71377306,-1,C,T,47347921,158626,46992687,47385903,355234
17,ENSG00000091542.7,18183828,17-18305230-G-A,rs7207123,1,G,A,18305230,121402,17987220,18380436,318010
17,ENSG00000091542.7,18183828,17-18305230-G-C,rs7207123,1,G,C,18305230,121402,17987220,18380436,318010
17,ENSG00000091542.7,18183828,17-18305230-G-T,rs7207123,1,G,T,18305230,121402,17987220,18380436,318010
17,ENSG00000184060.5,30921945,17-30935755-T-C,rs7208859,1,T,C,30935755,13810,30725337,31118553,210418
17,ENSG00000141576.8,76240493,17-76226239-C-G,rs7210049,-1,C,G,76226239,14254,76043885,76437101,182354
17,ENSG00000141576.8,76240493,17-76226239-C-T,rs7210049,-1,C,T,76226239,14254,76043885,76437101,182354
17,ENSG00000180616.3,73165010,17-73170963-T-C,rs7210080,1,T,C,73170963,5953,72968402,73361618,202561
17,ENSG00000109079.3,28335761,17-28359195-C-A,rs7210719,1,C,A,28359195,23434,28139153,28532369,220042
17,ENSG00000109079.3,28335761,17-28359195-C-T,rs7210719,1,C,T,28359195,23434,28139153,28532369,220042
17,ENSG00000109079.3,28335761,17-28359195-C-G,rs7210719,1,C,G,28359195,23434,28139153,28532369,220042
17,ENSG00000169660.10,82418347,17-82409477-G-C,rs7211306,1,G,C,82409477,8870,82221739,82614955,187738
17,ENSG00000169660.10,82418347,17-82409477-G-A,rs7211306,1,G,A,82409477,8870,82221739,82614955,187738
17,ENSG00000179314.9,6070379,17-5991699-G-T,rs7211811,1,G,T,5991699,78680,5873771,6266987,117928
17,ENSG00000179314.9,6070379,17-5991699-G-A,rs7211811,1,G,A,5991699,78680,5873771,6266987,117928
17,ENSG00000170043.7,7931946,17-7819047-C-T,rs7213894,-1,C,T,7819047,112899,7735338,8128554,83709
17,ENSG00000184361.7,45262094,17-45293115-C-G,rs721579,-1,C,G,45293115,31021,45065486,45458702,227629
17,ENSG00000184361.7,45262094,17-45293115-C-T,rs721579,-1,C,T,45293115,31021,45065486,45458702,227629
17,ENSG00000184361.7,45262094,17-45293115-C-A,rs721579,-1,C,A,45293115,31021,45065486,45458702,227629
17,ENSG00000186919.7,76079182,17-75897953-T-C,rs7216470,1,T,C,75897953,181229,75882574,76275790,15379
17,ENSG00000126353.2,40565472,17-40600717-G-C,rs7216890,-1,G,C,40600717,35245,40368864,40762080,231853
17,ENSG00000126353.2,40565472,17-40600717-G-A,rs7216890,-1,G,A,40600717,35245,40368864,40762080,231853
17,ENSG00000126353.2,40565472,17-40600717-G-T,rs7216890,-1,G,T,40600717,35245,40368864,40762080,231853
17,ENSG00000174292.7,7381089,17-7492230-A-G,rs7217258,1,A,G,7492230,111141,7184481,7577697,307749
17,ENSG00000174292.7,7381089,17-7492230-A-T,rs7217258,1,A,T,7492230,111141,7184481,7577697,307749
17,ENSG00000188522.8,19004764,17-19005730-A-G,rs7218569,-1,A,G,19005730,966,18808156,19201372,197574
17,ENSG00000094804.4,40287879,17-40366397-C-A,rs7218663,1,C,A,40366397,78518,40091271,40484487,275126
17,ENSG00000094804.4,40287879,17-40366397-C-T,rs7218663,1,C,T,40366397,78518,40091271,40484487,275126
17,ENSG00000179598.4,17206333,17-17212252-A-G,rs7218795,-1,A,G,17212252,5919,17009725,17402941,202527
17,ENSG00000179598.4,17206333,17-17212252-A-T,rs7218795,-1,A,T,17212252,5919,17009725,17402941,202527
17,ENSG00000167281.12,79611051,17-79460227-C-A,rs7220244,-1,C,A,79460227,150824,79414443,79807659,45784
17,ENSG00000221926.5,15684311,17-15623452-C-T,rs7221749,-1,C,T,15623452,60859,15487703,15880919,135749
17,ENSG00000186765.7,81528377,17-81526313-C-T,rs7221858,1,C,T,81526313,2064,81331769,81724985,194544
17,ENSG00000186765.7,81528377,17-81526313-C-G,rs7221858,1,C,G,81526313,2064,81331769,81724985,194544
17,ENSG00000108953.10,1400222,17-1352208-G-A,rs7224258,-1,G,A,1352208,48014,1203614,1596830,148594
17,ENSG00000108953.10,1400222,17-1352208-G-C,rs7224258,-1,G,C,1352208,48014,1203614,1596830,148594
17,ENSG00000172301.5,31859244,17-31984378-C-T,rs72823802,-1,C,T,31984378,125134,31662636,32055852,321742
17,ENSG00000239704.4,15467621,17-15514705-A-C,rs72824497,-1,A,C,15514705,47084,15271013,15664229,243692
17,ENSG00000167447.7,59210035,17-59349987-C-T,rs72831262,1,C,T,59349987,139952,59013427,59406643,336560
17,ENSG00000006062.8,45317020,17-45507570-C-G,rs72834517,-1,C,G,45507570,190550,45120412,45513628,387158
17,ENSG00000161958.5,7439512,17-7310241-C-G,rs72840907,1,C,G,7310241,129271,7242904,7636120,67337
17,ENSG00000170175.6,7445061,17-7425815-G-A,rs72842820,1,G,A,7425815,19246,7248453,7641669,177362
17,ENSG00000182173.7,75516528,17-75541512-C-T,rs72851957,1,C,T,75541512,24984,75319920,75713136,221592
17,ENSG00000196544.6,8190180,17-8340280-C-A,rs73250854,-1,C,A,8340280,150100,7993572,8386788,346708
17,ENSG00000196544.6,8190180,17-8340280-C-T,rs73250854,-1,C,T,8340280,150100,7993572,8386788,346708
17,ENSG00000121073.7,49707964,17-49514247-T-A,rs734194,-1,T,A,49514247,193717,49511356,49904572,2891
17,ENSG00000121073.7,49707964,17-49514247-T-G,rs734194,-1,T,G,49514247,193717,49511356,49904572,2891
17,ENSG00000185504.11,81552353,17-81516973-T-C,rs7342974,-1,T,C,81516973,35380,81355745,81748961,161228
17,ENSG00000120071.8,46193429,17-46032905-G-A,rs7350980,-1,G,A,46032905,160524,45996821,46390037,36084
17,ENSG00000076351.7,28406212,17-28396803-C-T,rs739439,-1,C,T,28396803,9409,28209604,28602820,187199
17,ENSG00000219200.5,7012624,17-6941534-A-G,rs73976112,1,A,G,6941534,71090,6816016,7209232,125518
17,ENSG00000132507.13,7307628,17-7310260-A-G,rs73977632,1,A,G,7310260,2632,7111020,7504236,199240
17,ENSG00000132507.13,7307628,17-7310260-A-T,rs73977632,1,A,T,7310260,2632,7111020,7504236,199240
17,ENSG00000177303.4,75515537,17-75590244-G-A,rs73998360,-1,G,A,75590244,74707,75318929,75712145,271315
17,ENSG00000170412.11,74432088,17-74400997-T-C,rs7406641,1,T,C,74400997,31091,74235480,74628696,165517
17,ENSG00000170412.11,74432088,17-74400997-T-A,rs7406641,1,T,A,74400997,31091,74235480,74628696,165517
17,ENSG00000170412.11,74432088,17-74400997-T-G,rs7406641,1,T,G,74400997,31091,74235480,74628696,165517
17,ENSG00000141378.11,59707430,17-59815934-A-G,rs74256802,-1,A,G,59815934,108504,59510822,59904038,305112
17,ENSG00000244045.3,28357647,17-28413082-G-A,rs74256941,1,G,A,28413082,55435,28161039,28554255,252043
17,ENSG00000244045.3,28357647,17-28413082-G-T,rs74256941,1,G,T,28413082,55435,28161039,28554255,252043
17,ENSG00000132141.8,34961460,17-34831774-T-C,rs744298,-1,T,C,34831774,129686,34764852,35158068,66922
17,ENSG00000068097.8,60078921,17-60106569-G-A,rs74776296,-1,G,A,60106569,27648,59882313,60275529,224256
17,ENSG00000068097.8,60078921,17-60106569-G-T,rs74776296,-1,G,T,60106569,27648,59882313,60275529,224256
17,ENSG00000185379.14,35119860,17-35053870-C-A,rs74818874,-1,C,A,35053870,65990,34923252,35316468,130618
17,ENSG00000185379.14,35119860,17-35053870-C-T,rs74818874,-1,C,T,35053870,65990,34923252,35316468,130618
17,ENSG00000185379.14,35119860,17-35053870-C-G,rs74818874,-1,C,G,35053870,65990,34923252,35316468,130618
17,ENSG00000141527.10,80170030,17-80210594-C-G,rs7503034,1,C,G,80210594,40564,79973422,80366638,237172
17,ENSG00000141527.10,80170030,17-80210594-C-T,rs7503034,1,C,T,80210594,40564,79973422,80366638,237172
17,ENSG00000108963.10,2030153,17-1841709-A-G,rs7503251,1,A,G,1841709,188444,1833545,2226761,8164
17,ENSG00000108963.10,2030153,17-1841709-A-C,rs7503251,1,A,C,1841709,188444,1833545,2226761,8164
17,ENSG00000108963.10,2030153,17-1841709-A-T,rs7503251,1,A,T,1841709,188444,1833545,2226761,8164
17,ENSG00000108423.9,59892943,17-59863342-G-A,rs75440302,-1,G,A,59863342,29601,59696335,60089551,167007
17,ENSG00000109063.7,10657309,17-10739713-A-G,rs75656180,-1,A,G,10739713,82404,10460701,10853917,279012
17,ENSG00000109063.7,10657309,17-10739713-A-C,rs75656180,-1,A,C,10739713,82404,10460701,10853917,279012
17,ENSG00000236383.1,43228623,17-43347027-G-C,rs76063231,-1,G,C,43347027,118404,43032015,43425231,315012
17,ENSG00000236383.1,43228623,17-43347027-G-T,rs76063231,-1,G,T,43347027,118404,43032015,43425231,315012
17,ENSG00000243678.6,51166411,17-51160591-C-A,rs76221971,1,C,A,51160591,5820,50969803,51363019,190788
17,ENSG00000091622.10,6556555,17-6570204-C-T,rs76525613,-1,C,T,6570204,13649,6359947,6753163,210257
17,ENSG00000185527.7,81656542,17-81500378-G-T,rs77128153,-1,G,T,81500378,156164,81459934,81853150,40444
17,ENSG00000185527.7,81656542,17-81500378-G-A,rs77128153,-1,G,A,81500378,156164,81459934,81853150,40444
17,ENSG00000182446.8,81637112,17-81500378-G-T,rs77128153,-1,G,T,81500378,136734,81440504,81833720,59874
17,ENSG00000182446.8,81637112,17-81500378-G-A,rs77128153,-1,G,A,81500378,136734,81440504,81833720,59874
17,ENSG00000141698.10,41836232,17-41807103-C-T,rs77237766,-1,C,T,41807103,29129,41639624,42032840,167479
17,ENSG00000141696.6,41811949,17-41807103-C-T,rs77237766,-1,C,T,41807103,4846,41615341,42008557,191762
17,ENSG00000125445.5,75261879,17-75278477-G-A,rs77860123,1,G,A,75278477,16598,75065271,75458487,213206
17,ENSG00000177374.7,2055103,17-1968876-T-C,rs78116599,1,T,C,1968876,86227,1858495,2251711,110381
17,ENSG00000166260.6,54968654,17-54834860-G-A,rs78309177,-1,G,A,54834860,133794,54772046,55165262,62814
17,ENSG00000154914.10,9645517,17-9777783-C-A,rs78994777,1,C,A,9777783,132266,9448909,9842125,328874
17,ENSG00000169733.6,82051811,17-81954288-G-A,rs79066457,-1,G,A,81954288,97523,81855203,82248419,99085
17,ENSG00000167840.9,5111841,17-5007944-T-C,rs79554147,-1,T,C,5007944,103897,4915233,5308449,92711
17,ENSG00000161682.8,44363853,17-44451394-A-C,rs79759095,-1,A,C,44451394,87541,44167245,44560461,284149
17,ENSG00000160551.3,29390363,17-29279685-C-A,rs797967,1,C,A,29279685,110678,29193755,29586971,85930
17,ENSG00000160551.3,29390363,17-29279685-C-G,rs797967,1,C,G,29279685,110678,29193755,29586971,85930
17,ENSG00000160551.3,29390363,17-29279685-C-T,rs797967,1,C,T,29279685,110678,29193755,29586971,85930
17,ENSG00000128422.10,41624575,17-41709861-G-A,rs80303456,-1,G,A,41709861,85286,41427967,41821183,281894
17,ENSG00000073584.13,40647818,17-40594044-G-A,rs803119,-1,G,A,40594044,53774,40451210,40844426,142834
17,ENSG00000073584.13,40647818,17-40594044-G-C,rs803119,-1,G,C,40594044,53774,40451210,40844426,142834
17,ENSG00000173894.6,79778148,17-79723327-A-C,rs8065292,1,A,C,79723327,54821,79581540,79974756,141787
17,ENSG00000173894.6,79778148,17-79723327-A-G,rs8065292,1,A,G,79723327,54821,79581540,79974756,141787
17,ENSG00000141560.8,82716706,17-82736950-T-A,rs8067360,1,T,A,82736950,20244,82520098,82913314,216852
17,ENSG00000141560.8,82716706,17-82736950-T-C,rs8067360,1,T,C,82736950,20244,82520098,82913314,216852
17,ENSG00000205045.3,35537678,17-35513246-A-T,rs8068906,-1,A,T,35513246,24432,35341070,35734286,172176
17,ENSG00000205045.3,35537678,17-35513246-A-G,rs8068906,-1,A,G,35513246,24432,35341070,35734286,172176
17,ENSG00000161714.6,45132515,17-45151932-A-G,rs8070447,-1,A,G,45151932,19417,44935907,45329123,216025
17,ENSG00000161714.6,45132515,17-45151932-A-C,rs8070447,-1,A,C,45151932,19417,44935907,45329123,216025
17,ENSG00000153944.5,57256523,17-57290729-C-T,rs8071867,1,C,T,57290729,34206,57059915,57453131,230814
17,ENSG00000153944.5,57256523,17-57290729-C-G,rs8071867,1,C,G,57290729,34206,57059915,57453131,230814
17,ENSG00000108932.6,68291127,17-68252373-G-C,rs8077152,-1,G,C,68252373,38754,68094519,68487735,157854
17,ENSG00000108932.6,68291127,17-68252373-G-T,rs8077152,-1,G,T,68252373,38754,68094519,68487735,157854
17,ENSG00000108932.6,68291127,17-68252373-G-A,rs8077152,-1,G,A,68252373,38754,68094519,68487735,157854
17,ENSG00000177302.7,18314994,17-18161416-C-T,rs8077577,-1,C,T,18161416,153578,18118386,18511602,43030
17,ENSG00000108960.3,55421835,17-55445071-C-G,rs8079205,-1,C,G,55445071,23236,55225227,55618443,219844
17,ENSG00000108960.3,55421835,17-55445071-C-T,rs8079205,-1,C,T,55445071,23236,55225227,55618443,219844
17,ENSG00000161940.6,7023050,17-7093521-A-G,rs8079569,1,A,G,7093521,70471,6826442,7219658,267079
17,ENSG00000141030.6,17281246,17-17218310-T-C,rs8080386,-1,T,C,17218310,62936,17084638,17477854,133672
17,ENSG00000141030.6,17281246,17-17218310-T-A,rs8080386,-1,T,A,17218310,62936,17084638,17477854,133672
17,ENSG00000129646.8,76308276,17-76258437-T-C,rs8082199,-1,T,C,76258437,49839,76111668,76504884,146769
17,ENSG00000121053.4,58192726,17-58242569-A-C,rs8178289,1,A,C,58242569,49843,57996118,58389334,246451
17,ENSG00000005379.10,58328795,17-58243009-C-G,rs8178291,-1,C,G,58243009,85786,58132187,58525403,110822
17,ENSG00000131899.6,18225635,17-18143584-T-G,rs854777,1,T,G,18143584,82051,18029027,18422243,114557
17,ENSG00000131899.6,18225635,17-18143584-T-C,rs854777,1,T,C,18143584,82051,18029027,18422243,114557
17,ENSG00000167716.12,1724704,17-1917456-G-A,rs882495,1,G,A,1917456,192752,1528096,1921312,389360
17,ENSG00000008838.11,40054408,17-39977669-G-A,rs921651,-1,G,A,39977669,76739,39857800,40251016,119869
17,ENSG00000008838.11,40054408,17-39977669-G-C,rs921651,-1,G,C,39977669,76739,39857800,40251016,119869
17,ENSG00000177469.10,42423256,17-42402831-G-A,rs9252,-1,G,A,42402831,20425,42226648,42619864,176183
17,ENSG00000175155.3,59331655,17-59299448-A-T,rs9303407,1,A,T,59299448,32207,59135047,59528263,164401
17,ENSG00000175155.3,59331655,17-59299448-A-G,rs9303407,1,A,G,59299448,32207,59135047,59528263,164401
17,ENSG00000141068.8,27456448,17-27522312-T-A,rs940015,1,T,A,27522312,65864,27259840,27653056,262472
17,ENSG00000141068.8,27456448,17-27522312-T-G,rs940015,1,T,G,27522312,65864,27259840,27653056,262472
17,ENSG00000141068.8,27456448,17-27522312-T-C,rs940015,1,T,C,27522312,65864,27259840,27653056,262472
17,ENSG00000175106.10,15563483,17-15586837-G-C,rs949426,-1,G,C,15586837,23354,15366875,15760091,219962
17,ENSG00000221995.3,29078857,17-29009544-T-C,rs9652879,-1,T,C,29009544,69313,28882249,29275465,127295
17,ENSG00000176749.3,32486993,17-32448743-T-C,rs9889352,1,T,C,32448743,38250,32290385,32683601,158358
17,ENSG00000172123.7,35432500,17-35412930-G-A,rs9889442,-1,G,A,35412930,19570,35235892,35629108,177038
17,ENSG00000166685.5,73193055,17-73243459-C-T,rs9890798,1,C,T,73243459,50404,72996447,73389663,247012
17,ENSG00000166685.5,73193055,17-73243459-C-G,rs9890798,1,C,G,73243459,50404,72996447,73389663,247012
17,ENSG00000133026.7,8630725,17-8574230-A-G,rs9890899,-1,A,G,8574230,56495,8434117,8827333,140113
17,ENSG00000171634.11,67825503,17-67991933-T-C,rs9891146,1,T,C,67991933,166430,67628895,68022111,363038
17,ENSG00000126858.11,32142502,17-32108758-A-C,rs9892952,1,A,C,32108758,33744,31945894,32339110,162864
17,ENSG00000154920.10,50373229,17-50413414-A-G,rs9895339,1,A,G,50413414,40185,50176621,50569837,236793
17,ENSG00000109016.12,21126964,17-21246567-G-T,rs9896085,1,G,T,21246567,119603,20930356,21323572,316211
17,ENSG00000131470.9,42577729,17-42694896-C-T,rs9897724,-1,C,T,42694896,117167,42381121,42774337,313775
17,ENSG00000141258.7,2337501,17-2421612-T-C,rs9898228,1,T,C,2421612,84111,2140893,2534109,280719
17,ENSG00000127804.6,2511888,17-2487417-C-A,rs9898813,-1,C,A,2487417,24471,2315280,2708496,172137
17,ENSG00000002834.11,38870058,17-38952990-T-C,rs9899905,1,T,C,38952990,82932,38673450,39066666,279540
17,ENSG00000108846.11,50634881,17-50799903-A-G,rs9901362,1,A,G,50799903,165022,50438273,50831489,361630
17,ENSG00000108846.11,50634881,17-50799903-A-C,rs9901362,1,A,C,50799903,165022,50438273,50831489,361630
17,ENSG00000108846.11,50634881,17-50799903-A-T,rs9901362,1,A,T,50799903,165022,50438273,50831489,361630
17,ENSG00000141569.5,75896951,17-75900965-A-T,rs9902371,-1,A,T,75900965,4014,75700343,76093559,200622
17,ENSG00000141569.5,75896951,17-75900965-A-G,rs9902371,-1,A,G,75900965,4014,75700343,76093559,200622
17,ENSG00000004660.10,3893053,17-3918775-A-G,rs9904166,-1,A,G,3918775,25722,3696445,4089661,222330
17,ENSG00000089685.7,78214253,17-78232549-C-A,rs9907137,1,C,A,78232549,18296,78017645,78410861,214904
17,ENSG00000089685.7,78214253,17-78232549-C-G,rs9907137,1,C,G,78232549,18296,78017645,78410861,214904
17,ENSG00000089685.7,78214253,17-78232549-C-T,rs9907137,1,C,T,78232549,18296,78017645,78410861,214904
17,ENSG00000236320.2,35560819,17-35548265-G-A,rs9907259,-1,G,A,35548265,12554,35364211,35757427,184054
17,ENSG00000007312.7,63932331,17-63824651-C-T,rs9910549,-1,C,T,63824651,107680,63735723,64128939,88928
17,ENSG00000182557.3,4433940,17-4544941-C-T,rs9910749,1,C,T,4544941,111001,4237332,4630548,307609
17,ENSG00000129226.8,7579638,17-7542055-C-A,rs9912001,1,C,A,7542055,37583,7383030,7776246,159025
17,ENSG00000129226.8,7579638,17-7542055-C-T,rs9912001,1,C,T,7542055,37583,7383030,7776246,159025
17,ENSG00000108592.9,63827663,17-63685848-A-G,rs9912201,-1,A,G,63685848,141815,63631055,64024271,54793
17,ENSG00000185105.4,81947233,17-82001783-C-T,rs9912335,-1,C,T,82001783,54550,81750625,82143841,251158
17,ENSG00000185105.4,81947233,17-82001783-C-G,rs9912335,-1,C,G,82001783,54550,81750625,82143841,251158
17,ENSG00000108622.5,64020633,17-63824782-T-C,rs9912451,-1,T,C,63824782,195851,63824025,64217241,757
17,ENSG00000177728.9,75456635,17-75420733-G-A,rs9913538,1,G,A,75420733,35902,75260027,75653243,160706
17,ENSG00000177728.9,75456635,17-75420733-G-C,rs9913538,1,G,C,75420733,35902,75260027,75653243,160706
17,ENSG00000177728.9,75456635,17-75420733-G-T,rs9913538,1,G,T,75420733,35902,75260027,75653243,160706
17,ENSG00000108556.7,4903098,17-4928495-G-A,rs9914087,-1,G,A,4928495,25397,4706490,5099706,222005
17,ENSG00000108556.7,4903098,17-4928495-G-T,rs9914087,-1,G,T,4928495,25397,4706490,5099706,222005
17,ENSG00000136448.6,45061317,17-44960841-C-T,rs1007190,1,C,T,44960841,100476,44864709,45257925,96132
17,ENSG00000168646.7,65561648,17-65567788-A-C,rs1017020,-1,A,C,65567788,6140,65365040,65758256,202748
17,ENSG00000170160.10,16690241,17-16516442-T-C,rs1017095,1,T,C,16516442,173799,16493633,16886849,22809
17,ENSG00000198720.7,29593132,17-29585397-C-A,rs1017529,1,C,A,29585397,7735,29396524,29789740,188873
17,ENSG00000198720.7,29593132,17-29585397-C-T,rs1017529,1,C,T,29585397,7735,29396524,29789740,188873
17,ENSG00000219200.5,7012624,17-7114101-G-C,rs10459916,1,G,C,7114101,101477,6816016,7209232,298085
17,ENSG00000219200.5,7012624,17-7114101-G-A,rs10459916,1,G,A,7114101,101477,6816016,7209232,298085
17,ENSG00000205710.3,4899536,17-5095912-G-A,rs1047966,1,G,A,5095912,196376,4702928,5096144,392984
17,ENSG00000205710.3,4899536,17-5095912-G-T,rs1047966,1,G,T,5095912,196376,4702928,5096144,392984
17,ENSG00000082641.10,48048359,17-48044763-G-T,rs10491183,1,G,T,48044763,3596,47851751,48244967,193012
17,ENSG00000082641.10,48048359,17-48044763-G-C,rs10491183,1,G,C,48044763,3596,47851751,48244967,193012
17,ENSG00000109089.7,74987632,17-75019707-G-C,rs10512599,1,G,C,75019707,32075,74791024,75184240,228683
17,ENSG00000214226.4,56833920,17-56786087-G-T,rs10515134,-1,G,T,56786087,47833,56637312,57030528,148775
17,ENSG00000214226.4,56833920,17-56786087-G-A,rs10515134,-1,G,A,56786087,47833,56637312,57030528,148775
17,ENSG00000223510.2,14236862,17-14074847-A-G,rs10521253,-1,A,G,14074847,162015,14040254,14433470,34593
17,ENSG00000125454.6,75289433,17-75288686-C-G,rs10852762,-1,C,G,75288686,747,75092825,75486041,195861
17,ENSG00000125454.6,75289433,17-75288686-C-A,rs10852762,-1,C,A,75288686,747,75092825,75486041,195861
17,ENSG00000175711.4,83051770,17-83048410-G-A,rs10852789,-1,G,A,83048410,3360,82855162,83248378,193248
17,ENSG00000175711.4,83051770,17-83048410-G-T,rs10852789,-1,G,T,83048410,3360,82855162,83248378,193248
17,ENSG00000129226.8,7579638,17-7587492-G-C,rs10852891,1,G,C,7587492,7854,7383030,7776246,204462
17,ENSG00000129226.8,7579638,17-7587492-G-T,rs10852891,1,G,T,7587492,7854,7383030,7776246,204462
17,ENSG00000129226.8,7579638,17-7587492-G-A,rs10852891,1,G,A,7587492,7854,7383030,7776246,204462
17,ENSG00000141568.13,82519732,17-82446450-G-T,rs11077994,1,G,T,82446450,73282,82323124,82716340,123326
17,ENSG00000091622.10,6556555,17-6553289-T-G,rs11078637,-1,T,G,6553289,3266,6359947,6753163,193342
17,ENSG00000091622.10,6556555,17-6553289-T-A,rs11078637,-1,T,A,6553289,3266,6359947,6753163,193342
17,ENSG00000091622.10,6556555,17-6553289-T-C,rs11078637,-1,T,C,6553289,3266,6359947,6753163,193342
17,ENSG00000126860.5,31321622,17-31296270-C-T,rs11080149,-1,C,T,31296270,25352,31125014,31518230,171256
17,ENSG00000178502.4,41865423,17-41673050-A-C,rs111335146,-1,A,C,41673050,192373,41668815,42062031,4235
17,ENSG00000073670.7,44758988,17-44807170-C-A,rs1122109,1,C,A,44807170,48182,44562380,44955596,244790
17,ENSG00000073670.7,44758988,17-44807170-C-G,rs1122109,1,C,G,44807170,48182,44562380,44955596,244790
17,ENSG00000073670.7,44758988,17-44807170-C-T,rs1122109,1,C,T,44807170,48182,44562380,44955596,244790
17,ENSG00000250506.1,76000855,17-76006849-G-C,rs1128889,1,G,C,76006849,5994,75804247,76197463,202602
17,ENSG00000250506.1,76000855,17-76006849-G-A,rs1128889,1,G,A,76006849,5994,75804247,76197463,202602
17,ENSG00000129197.9,5420182,17-5594629-G-A,rs113050992,1,G,A,5594629,174447,5223574,5616790,371055
17,ENSG00000125458.1,75131742,17-74977867-G-A,rs113409681,-1,G,A,74977867,153875,74935134,75328350,42733
17,ENSG00000257949.1,75979240,17-75930040-C-A,rs1135889,1,C,A,75930040,49200,75782632,76175848,147408
17,ENSG00000153982.5,59220511,17-59342520-C-T,rs113688928,1,C,T,59342520,122009,59023903,59417119,318617
17,ENSG00000177731.8,18258738,17-18148792-G-A,rs114274755,-1,G,A,18148792,109946,18062130,18455346,86662
17,ENSG00000073350.8,75525697,17-75620784-C-T,rs11470,1,C,T,75620784,95087,75329089,75722305,291695
17,ENSG00000073350.8,75525697,17-75620784-C-A,rs11470,1,C,A,75620784,95087,75329089,75722305,291695
17,ENSG00000167193.7,1456232,17-1495634-G-A,rs11559105,-1,G,A,1495634,39402,1259624,1652840,236010
17,ENSG00000167193.7,1456232,17-1495634-G-T,rs11559105,-1,G,T,1495634,39402,1259624,1652840,236010
17,ENSG00000183018.3,4498881,17-4633537-G-C,rs11568125,1,G,C,4633537,134656,4302273,4695489,331264
17,ENSG00000183018.3,4498881,17-4633537-G-A,rs11568125,1,G,A,4633537,134656,4302273,4695489,331264
17,ENSG00000168517.5,45161875,17-45342482-A-T,rs116054740,1,A,T,45342482,180607,44965267,45358483,377215
17,ENSG00000168517.5,45161875,17-45342482-A-G,rs116054740,1,A,G,45342482,180607,44965267,45358483,377215
17,ENSG00000108439.4,47941571,17-47950486-G-A,rs11650043,1,G,A,47950486,8915,47744963,48138179,205523
17,ENSG00000173762.2,82317608,17-82372800-A-G,rs11650469,-1,A,G,82372800,55192,82121000,82514216,251800
17,ENSG00000161960.9,7572825,17-7422804-A-G,rs11652328,1,A,G,7422804,150021,7376217,7769433,46587
17,ENSG00000168259.7,42017439,17-41934914-C-T,rs11652920,-1,C,T,41934914,82525,41820831,42214047,114083
17,ENSG00000168259.7,42017439,17-41934914-C-A,rs11652920,-1,C,A,41934914,82525,41820831,42214047,114083
17,ENSG00000132141.8,34961460,17-34796763-T-C,rs11653855,-1,T,C,34796763,164697,34764852,35158068,31911
17,ENSG00000169738.1,82037697,17-82024601-T-C,rs11659000,-1,T,C,82024601,13096,81841089,82234305,183512
17,ENSG00000187607.9,15699752,17-15698649-G-A,rs117200551,1,G,A,15698649,1103,15503144,15896360,195505
17,ENSG00000108582.5,30378927,17-30332001-A-C,rs117221215,1,A,C,30332001,46926,30182319,30575535,149682
17,ENSG00000182040.3,74923255,17-74996888-T-C,rs117231470,-1,T,C,74996888,73633,74726647,75119863,270241
17,ENSG00000185813.4,81911399,17-81730141-T-C,rs117422889,-1,T,C,81730141,181258,81714791,82108007,15350
17,ENSG00000182156.5,79730943,17-79723452-G-A,rs117605502,1,G,A,79723452,7491,79534335,79927551,189117
17,ENSG00000141556.14,82752065,17-82612049-A-C,rs117822865,1,A,C,82612049,140016,82555457,82948673,56592
17,ENSG00000179761.5,29043141,17-29171113-A-G,rs117910261,1,A,G,29171113,127972,28846533,29239749,324580
17,ENSG00000167851.8,74466634,17-74369301-G-C,rs117982488,1,G,C,74369301,97333,74270026,74663242,99275
17,ENSG00000167851.8,74466634,17-74369301-G-A,rs117982488,1,G,A,74369301,97333,74270026,74663242,99275
17,ENSG00000176170.7,76384609,17-76564789-A-G,rs118003258,1,A,G,76564789,180180,76188001,76581217,376788
17,ENSG00000259224.1,7481446,17-7388085-G-C,rs11867353,1,G,C,7388085,93361,7284838,7678054,103247
17,ENSG00000108946.7,68512430,17-68469439-C-T,rs11868680,1,C,T,68469439,42991,68315822,68709038,153617
17,ENSG00000108946.7,68512430,17-68469439-C-A,rs11868680,1,C,A,68469439,42991,68315822,68709038,153617
17,ENSG00000128487.10,20009359,17-20054639-G-A,rs11870381,1,G,A,20054639,45280,19812751,20205967,241888
17,ENSG00000181513.9,45135687,17-44980217-C-T,rs11871217,1,C,T,44980217,155470,44939079,45332295,41138
17,ENSG00000072310.10,17836986,17-17763092-C-G,rs12103424,-1,C,G,17763092,73894,17640378,18033594,122714
17,ENSG00000167131.10,44899729,17-44869703-G-C,rs12150008,1,G,C,44869703,30026,44703121,45096337,166582
17,ENSG00000141570.6,79797077,17-79789145-A-G,rs12150587,-1,A,G,79789145,7932,79600469,79993685,188676
17,ENSG00000004142.6,28357527,17-28189182-G-C,rs1242299,-1,G,C,28189182,168345,28160919,28554135,28263
17,ENSG00000004142.6,28357527,17-28189182-G-T,rs1242299,-1,G,T,28189182,168345,28160919,28554135,28263
17,ENSG00000004142.6,28357527,17-28189182-G-A,rs1242299,-1,G,A,28189182,168345,28160919,28554135,28263
17,ENSG00000189120.2,47851163,17-47795818-T-C,rs12451413,-1,T,C,47795818,55345,47654555,48047771,141263
17,ENSG00000189120.2,47851163,17-47795818-T-A,rs12451413,-1,T,A,47795818,55345,47654555,48047771,141263
17,ENSG00000169710.5,82098236,17-82048551-G-T,rs12452625,-1,G,T,82048551,49685,81901628,82294844,146923
17,ENSG00000169710.5,82098236,17-82048551-G-A,rs12452625,-1,G,A,82048551,49685,81901628,82294844,146923
17,ENSG00000171595.8,74274234,17-74239422-C-A,rs12452652,1,C,A,74239422,34812,74077626,74470842,161796
17,ENSG00000256806.1,6651762,17-6836215-C-T,rs12601859,1,C,T,6836215,184453,6455154,6848370,381061
17,ENSG00000256806.1,6651762,17-6836215-C-A,rs12601859,1,C,A,6836215,184453,6455154,6848370,381061
17,ENSG00000108559.6,5419662,17-5444636-A-T,rs12603094,-1,A,T,5444636,24974,5223054,5616270,221582
17,ENSG00000108559.6,5419662,17-5444636-A-G,rs12603094,-1,A,G,5444636,24974,5223054,5616270,221582
17,ENSG00000108950.6,68601367,17-68566603-C-G,rs12603521,-1,C,G,68566603,34764,68404759,68797975,161844
17,ENSG00000108950.6,68601367,17-68566603-C-T,rs12603521,-1,C,T,68566603,34764,68404759,68797975,161844
17,ENSG00000225190.2,45490721,17-45430857-G-T,rs12939187,-1,G,T,45430857,59864,45294113,45687329,136744
17,ENSG00000225190.2,45490721,17-45430857-G-A,rs12939187,-1,G,A,45430857,59864,45294113,45687329,136744
17,ENSG00000108819.9,50150677,17-50300424-A-G,rs12940293,-1,A,G,50300424,149747,49954069,50347285,346355
17,ENSG00000141068.8,27456448,17-27629322-A-C,rs12945695,1,A,C,27629322,172874,27259840,27653056,369482
17,ENSG00000129667.6,76501423,17-76503318-G-C,rs12948783,-1,G,C,76503318,1895,76304815,76698031,198503
17,ENSG00000129667.6,76501423,17-76503318-G-T,rs12948783,-1,G,T,76503318,1895,76304815,76698031,198503
17,ENSG00000129667.6,76501423,17-76503318-G-A,rs12948783,-1,G,A,76503318,1895,76304815,76698031,198503
17,ENSG00000179477.4,8087716,17-8120803-C-T,rs1442849,-1,C,T,8120803,33087,7891108,8284324,229695
17,ENSG00000179477.4,8087716,17-8120803-C-G,rs1442849,-1,C,G,8120803,33087,7891108,8284324,229695
17,ENSG00000070444.8,2401060,17-2392111-C-T,rs1545717,-1,C,T,2392111,8949,2204452,2597668,187659
17,ENSG00000083454.16,3696155,17-3697014-T-C,rs160590,-1,T,C,3697014,859,3499547,3892763,197467
17,ENSG00000083457.6,3801188,17-3697014-T-C,rs160590,-1,T,C,3697014,104174,3604580,3997796,92434
17,ENSG00000221926.5,15684311,17-15711508-A-T,rs163372,-1,A,T,15711508,27197,15487703,15880919,223805
17,ENSG00000221926.5,15684311,17-15711508-A-G,rs163372,-1,A,G,15711508,27197,15487703,15880919,223805
17,ENSG00000221926.5,15684311,17-15711508-A-C,rs163372,-1,A,C,15711508,27197,15487703,15880919,223805
17,ENSG00000141510.9,7687490,17-7654101-A-T,rs1642763,-1,A,T,7654101,33389,7490882,7884098,163219
17,ENSG00000141510.9,7687490,17-7654101-A-G,rs1642763,-1,A,G,7654101,33389,7490882,7884098,163219
17,ENSG00000161381.8,39151637,17-39131878-C-T,rs16495,-1,C,T,39131878,19759,38955029,39348245,176849
17,ENSG00000184361.7,45262094,17-45106052-C-G,rs16939858,-1,C,G,45106052,156042,45065486,45458702,40566
17,ENSG00000184361.7,45262094,17-45106052-C-T,rs16939858,-1,C,T,45106052,156042,45065486,45458702,40566
17,ENSG00000224383.2,63998351,17-64020486-C-A,rs16947352,1,C,A,64020486,22135,63801743,64194959,218743
17,ENSG00000224383.2,63998351,17-64020486-C-T,rs16947352,1,C,T,64020486,22135,63801743,64194959,218743
17,ENSG00000087095.7,28042677,17-28022972-G-A,rs16964148,1,G,A,28022972,19705,27846069,28239285,176903
17,ENSG00000168961.11,27631188,17-27488287-A-G,rs16966128,1,A,G,27488287,142901,27434580,27827796,53707
17,ENSG00000198863.2,42980565,17-42844546-A-G,rs16968038,1,A,G,42844546,136019,42783957,43177173,60589
17,ENSG00000161547.8,76737331,17-76752153-G-C,rs16969259,-1,G,C,76752153,14822,76540723,76933939,211430
17,ENSG00000154263.11,69228824,17-69225161-C-T,rs16973838,-1,C,T,69225161,3663,69032216,69425432,192945
17,ENSG00000154263.11,69228824,17-69225161-C-G,rs16973838,-1,C,G,69225161,3663,69032216,69425432,192945
17,ENSG00000167850.3,74546115,17-74555418-C-T,rs1719479,-1,C,T,74555418,9303,74349507,74742723,205911
17,ENSG00000167721.5,2336457,17-2505381-T-C,rs17221733,-1,T,C,2505381,168924,2139849,2533065,365532
17,ENSG00000141576.8,76240493,17-76222525-T-C,rs17508653,-1,T,C,76222525,17968,76043885,76437101,178640
17,ENSG00000172992.6,45051632,17-44974024-C-A,rs17547180,-1,C,A,44974024,77608,44855024,45248240,119000
17,ENSG00000166750.4,35243072,17-35219913-T-C,rs17629798,1,T,C,35219913,23159,35046464,35439680,173449
17,ENSG00000166750.4,35243072,17-35219913-T-G,rs17629798,1,T,G,35219913,23159,35046464,35439680,173449
17,ENSG00000007314.6,63972918,17-63816716-T-C,rs17638873,-1,T,C,63816716,156202,63776310,64169526,40406
17,ENSG00000136449.9,50508439,17-50503154-A-G,rs17641908,1,A,G,50503154,5285,50311831,50705047,191323
17,ENSG00000258890.1,64506977,17-64483156-A-C,rs17650301,1,A,C,64483156,23821,64310369,64703585,172787
17,ENSG00000258890.1,64506977,17-64483156-A-T,rs17650301,1,A,T,64483156,23821,64310369,64703585,172787
17,ENSG00000073584.13,40647818,17-40581901-A-T,rs17709159,-1,A,T,40581901,65917,40451210,40844426,130691
17,ENSG00000073584.13,40647818,17-40581901-A-G,rs17709159,-1,A,G,40581901,65917,40451210,40844426,130691
17,ENSG00000087111.14,28571524,17-28676503-G-A,rs17720594,-1,G,A,28676503,104979,28374916,28768132,301587
17,ENSG00000108375.7,58417534,17-58521630-T-A,rs17741424,-1,T,A,58521630,104096,58220926,58614142,300704
17,ENSG00000136450.6,58007246,17-57971281-T-G,rs17762434,-1,T,G,57971281,35965,57810638,58203854,160643
17,ENSG00000108578.8,30291944,17-30254025-T-A,rs17767256,-1,T,A,30254025,37919,30095336,30488552,158689
17,ENSG00000108578.8,30291944,17-30254025-T-G,rs17767256,-1,T,G,30254025,37919,30095336,30488552,158689
17,ENSG00000141314.7,32265832,17-32279282-G-T,rs17780388,1,G,T,32279282,13450,32069224,32462440,210058
17,ENSG00000174282.7,7479631,17-7448844-T-C,rs17806566,-1,T,C,7448844,30787,7283023,7676239,165821
17,ENSG00000109063.7,10657309,17-10722486-T-C,rs17816912,-1,T,C,10722486,65177,10460701,10853917,261785
17,ENSG00000141295.8,47841273,17-47840239-T-C,rs17856536,-1,T,C,47840239,1034,47644665,48037881,195574
17,ENSG00000141127.8,18858131,17-18939993-G-A,rs1859083,1,G,A,18939993,81862,18661523,19054739,278470
17,ENSG00000141127.8,18858131,17-18939993-G-T,rs1859083,1,G,T,18939993,81862,18661523,19054739,278470
17,ENSG00000120088.9,45784320,17-45749300-C-T,rs1880756,1,C,T,45749300,35020,45587712,45980928,161588
17,ENSG00000132530.11,6756046,17-6753506-T-C,rs1983181,1,T,C,6753506,2540,6559438,6952654,194068
17,ENSG00000108433.10,46923160,17-46759287-G-A,rs199530,1,G,A,46759287,163873,46726552,47119768,32735
17,ENSG00000170412.11,74432088,17-74487632-G-A,rs2007766,1,G,A,74487632,55544,74235480,74628696,252152
17,ENSG00000132361.9,2711764,17-2803299-T-C,rs2028000,-1,T,C,2803299,91535,2515156,2908372,288143
17,ENSG00000184988.2,43211875,17-43377341-G-A,rs2061872,1,G,A,43377341,165466,43015267,43408483,362074
17,ENSG00000184988.2,43211875,17-43377341-G-C,rs2061872,1,G,C,43377341,165466,43015267,43408483,362074
17,ENSG00000141522.6,81871337,17-81847258-G-A,rs2070871,-1,G,A,81847258,24079,81674729,82067945,172529
17,ENSG00000141522.6,81871337,17-81847258-G-C,rs2070871,-1,G,C,81847258,24079,81674729,82067945,172529
17,ENSG00000215644.4,81804150,17-81847258-G-A,rs2070871,1,G,A,81847258,43108,81607542,82000758,239716
17,ENSG00000215644.4,81804150,17-81847258-G-C,rs2070871,1,G,C,81847258,43108,81607542,82000758,239716
17,ENSG00000132481.1,75878581,17-76018387-C-T,rs2071194,-1,C,T,76018387,139806,75681973,76075189,336414
17,ENSG00000132481.1,75878581,17-76018387-C-A,rs2071194,-1,C,A,76018387,139806,75681973,76075189,336414
17,ENSG00000006740.10,12789498,17-12940809-A-G,rs2072256,1,A,G,12940809,151311,12592890,12986106,347919
17,ENSG00000006740.10,12789498,17-12940809-A-T,rs2072256,1,A,T,12940809,151311,12592890,12986106,347919
17,ENSG00000189152.5,19127589,17-19014602-C-T,rs2074280,1,C,T,19014602,112987,18930981,19324197,83621
17,ENSG00000186075.7,39868202,17-40017100-C-T,rs2227331,1,C,T,40017100,148898,39671594,40064810,345506
17,ENSG00000004975.7,7234517,17-7229843-G-A,rs222836,-1,G,A,7229843,4674,7037909,7431125,191934
17,ENSG00000072778.12,7219938,17-7207146-A-C,rs222855,1,A,C,7207146,12792,7023330,7416546,183816
17,ENSG00000072778.12,7219938,17-7207146-A-T,rs222855,1,A,T,7207146,12792,7023330,7416546,183816
17,ENSG00000154920.10,50373229,17-50465329-G-A,rs2231510,1,G,A,50465329,92100,50176621,50569837,288708
17,ENSG00000141543.4,80147128,17-80140033-G-A,rs2241886,-1,G,A,80140033,7095,79950520,80343736,189513
17,ENSG00000141543.4,80147128,17-80140033-G-C,rs2241886,-1,G,C,80140033,7095,79950520,80343736,189513
17,ENSG00000141560.8,82716706,17-82723299-A-G,rs2246558,1,A,G,82723299,6593,82520098,82913314,203201
17,ENSG00000128482.9,19411232,17-19551420-G-C,rs2247436,1,G,C,19551420,140188,19214624,19607840,336796
17,ENSG00000128482.9,19411232,17-19551420-G-A,rs2247436,1,G,A,19551420,140188,19214624,19607840,336796
17,ENSG00000005884.12,50056110,17-50072022-C-T,rs2269772,1,C,T,50072022,15912,49859502,50252718,212520
17,ENSG00000161929.9,5234860,17-5391681-A-T,rs2285748,-1,A,T,5391681,156821,5038252,5431468,353429
17,ENSG00000161929.9,5234860,17-5391681-A-G,rs2285748,-1,A,G,5391681,156821,5038252,5431468,353429
17,ENSG00000108883.6,44899445,17-44876041-A-G,rs2289674,-1,A,G,44876041,23404,44702837,45096053,173204
17,ENSG00000006062.8,45317020,17-45254998-A-G,rs2291448,-1,A,G,45254998,62022,45120412,45513628,134586
17,ENSG00000179598.4,17206333,17-17222727-G-A,rs2292527,-1,G,A,17222727,16394,17009725,17402941,213002
17,ENSG00000178789.3,74531475,17-74474006-G-T,rs2293189,-1,G,T,74474006,57469,74334867,74728083,139139
17,ENSG00000178789.3,74531475,17-74474006-G-A,rs2293189,-1,G,A,74474006,57469,74334867,74728083,139139
17,ENSG00000177602.4,3723903,17-3695750-C-T,rs2293880,1,C,T,3695750,28153,3527295,3920511,168455
17,ENSG00000108474.7,16217210,17-16025270-T-A,rs2301652,1,T,A,16025270,191940,16020602,16413818,4668
17,ENSG00000108474.7,16217210,17-16025270-T-G,rs2301652,1,T,G,16025270,191940,16020602,16413818,4668
17,ENSG00000141562.11,82458741,17-82468759-T-C,rs2306752,1,T,C,82468759,10018,82262133,82655349,206626
17,ENSG00000108651.3,31901708,17-31916564-C-A,rs2344312,-1,C,A,31916564,14856,31705100,32098316,211464
17,ENSG00000136436.9,48831035,17-48982428-C-T,rs2411758,1,C,T,48982428,151393,48634427,49027643,348001
17,ENSG00000182534.7,76710965,17-76748932-C-T,rs2429452,-1,C,T,76748932,37967,76514357,76907573,234575
17,ENSG00000072210.12,19648751,17-19543703-T-C,rs2440155,1,T,C,19543703,105048,19452143,19845359,91560
17,ENSG00000176658.10,32877124,17-32896503-C-T,rs2466857,-1,C,T,32896503,19379,32680516,33073732,215987
17,ENSG00000176658.10,32877124,17-32896503-C-A,rs2466857,-1,C,A,32896503,19379,32680516,33073732,215987
17,ENSG00000171475.8,40219304,17-40349572-C-G,rs2586116,1,C,G,40349572,130268,40022696,40415912,326876
17,ENSG00000166260.6,54968654,17-55081000-G-A,rs2628302,-1,G,A,55081000,112346,54772046,55165262,308954
17,ENSG00000064300.4,49495293,17-49467548-G-A,rs2671629,1,G,A,49467548,27745,49298685,49691901,168863
17,ENSG00000213246.1,58352201,17-58354188-A-G,rs2680702,-1,A,G,58354188,1987,58155593,58548809,198595
17,ENSG00000006042.5,32928153,17-32948562-G-A,rs2726132,1,G,A,32948562,20409,32731545,33124761,217017
17,ENSG00000067596.4,43483975,17-43552281-T-C,rs28513436,1,T,C,43552281,68306,43287367,43680583,264914
17,ENSG00000166582.4,16353469,17-16231822-G-A,rs28622079,-1,G,A,16231822,121647,16156861,16550077,74961
17,ENSG00000004660.10,3893053,17-3896924-C-G,rs28930668,-1,C,G,3896924,3871,3696445,4089661,200479
17,ENSG00000004660.10,3893053,17-3896924-C-A,rs28930668,-1,C,A,3896924,3871,3696445,4089661,200479
17,ENSG00000004660.10,3893053,17-3896924-C-T,rs28930668,-1,C,T,3896924,3871,3696445,4089661,200479
17,ENSG00000171962.9,17972862,17-18081663-T-G,rs2955375,1,T,G,18081663,108801,17776254,18169470,305409
17,ENSG00000171962.9,17972862,17-18081663-T-A,rs2955375,1,T,A,18081663,108801,17776254,18169470,305409
17,ENSG00000171962.9,17972862,17-18081663-T-C,rs2955375,1,T,C,18081663,108801,17776254,18169470,305409
17,ENSG00000141198.9,54900852,17-54875669-C-A,rs2958933,1,C,A,54875669,25183,54704244,55097460,171425
17,ENSG00000141198.9,54900852,17-54875669-C-G,rs2958933,1,C,G,54875669,25183,54704244,55097460,171425
17,ENSG00000141198.9,54900852,17-54875669-C-T,rs2958933,1,C,T,54875669,25183,54704244,55097460,171425
17,ENSG00000180626.8,5191868,17-5377145-T-C,rs3026101,-1,T,C,5377145,185277,4995260,5388476,381885
17,ENSG00000180626.8,5191868,17-5377145-T-G,rs3026101,-1,T,G,5377145,185277,4995260,5388476,381885
17,ENSG00000167100.10,50130160,17-50273064-C-T,rs34052864,-1,C,T,50273064,142904,49933552,50326768,339512
17,ENSG00000141219.10,73232433,17-73088979-C-G,rs34207139,1,C,G,73088979,143454,73035825,73429041,53154
17,ENSG00000141219.10,73232433,17-73088979-C-T,rs34207139,1,C,T,73088979,143454,73035825,73429041,53154
17,ENSG00000167291.9,80035872,17-80198493-G-A,rs34367357,-1,G,A,80198493,162621,79839264,80232480,359229
17,ENSG00000189050.9,59964740,17-60132228-A-C,rs345166,-1,A,C,60132228,167488,59768132,60161348,364096
17,ENSG00000189050.9,59964740,17-60132228-A-T,rs345166,-1,A,T,60132228,167488,59768132,60161348,364096
17,ENSG00000189050.9,59964740,17-60132228-A-G,rs345166,-1,A,G,60132228,167488,59768132,60161348,364096
17,ENSG00000175155.3,59331655,17-59404122-C-T,rs34557869,1,C,T,59404122,72467,59135047,59528263,269075
17,ENSG00000108961.8,8288670,17-8263180-G-A,rs34778863,1,G,A,8263180,25490,8092062,8485278,171118
17,ENSG00000196704.6,68248043,17-68235121-C-G,rs34963864,1,C,G,68235121,12922,68051435,68444651,183686
17,ENSG00000196704.6,68248043,17-68235121-C-T,rs34963864,1,C,T,68235121,12922,68051435,68444651,183686
17,ENSG00000131477.5,42761227,17-42847286-G-A,rs35296742,1,G,A,42847286,86059,42564619,42957835,282667
17,ENSG00000006695.5,14069504,17-14205230-C-T,rs35991544,1,C,T,14205230,135726,13872896,14266112,332334
17,ENSG00000108932.6,68291127,17-68212998-C-T,rs36123298,-1,C,T,68212998,78129,68094519,68487735,118479
17,ENSG00000174326.7,7044092,17-7031942-G-C,rs374177,-1,G,C,7031942,12150,6847484,7240700,184458
17,ENSG00000174326.7,7044092,17-7031942-G-T,rs374177,-1,G,T,7031942,12150,6847484,7240700,184458
17,ENSG00000129657.8,77140969,17-77214492-A-C,rs3744063,1,A,C,77214492,73523,76944361,77337577,270131
17,ENSG00000129657.8,77140969,17-77214492-A-G,rs3744063,1,A,G,77214492,73523,76944361,77337577,270131
17,ENSG00000129657.8,77140969,17-77214492-A-T,rs3744063,1,A,T,77214492,73523,76944361,77337577,270131
17,ENSG00000178971.8,8248056,17-8320815-T-C,rs3744646,-1,T,C,8320815,72759,8051448,8444664,269367
17,ENSG00000167695.8,732596,17-746966-C-T,rs3744742,1,C,T,746966,14370,535988,929204,210978
17,ENSG00000171302.9,79009764,17-78827178-A-C,rs3744791,-1,A,C,78827178,182586,78813156,79206372,14022
17,ENSG00000187838.10,7394525,17-7416823-C-T,rs3752031,-1,C,T,7416823,22298,7197917,7591133,218906
17,ENSG00000070540.7,68457496,17-68292900-T-C,rs3760269,-1,T,C,68292900,164596,68260888,68654104,32012
17,ENSG00000070540.7,68457496,17-68292900-T-G,rs3760269,-1,T,G,68292900,164596,68260888,68654104,32012
17,ENSG00000083290.13,19867936,17-19677696-A-T,rs3760489,-1,A,T,19677696,190240,19671328,20064544,6368
17,ENSG00000083290.13,19867936,17-19677696-A-C,rs3760489,-1,A,C,19677696,190240,19671328,20064544,6368
17,ENSG00000083290.13,19867936,17-19677696-A-G,rs3760489,-1,A,G,19677696,190240,19671328,20064544,6368
17,ENSG00000198231.6,63774170,17-63946431-T-C,rs3785568,1,T,C,63946431,172261,63577562,63970778,368869
17,ENSG00000198231.6,63774170,17-63946431-T-G,rs3785568,1,T,G,63946431,172261,63577562,63970778,368869
17,ENSG00000198231.6,63774170,17-63946431-T-A,rs3785568,1,T,A,63946431,172261,63577562,63970778,368869
17,ENSG00000167925.9,42194494,17-42155150-G-A,rs3785900,-1,G,A,42155150,39344,41997886,42391102,157264
17,ENSG00000166685.5,73193055,17-73205536-T-C,rs3829571,1,T,C,73205536,12481,72996447,73389663,209089
17,ENSG00000166685.5,73193055,17-73205536-T-G,rs3829571,1,T,G,73205536,12481,72996447,73389663,209089
17,ENSG00000166685.5,73193055,17-73205536-T-A,rs3829571,1,T,A,73205536,12481,72996447,73389663,209089
17,ENSG00000141480.12,4710632,17-4783119-A-G,rs3851,1,A,G,4783119,72487,4514024,4907240,269095
17,ENSG00000141480.12,4710632,17-4783119-A-C,rs3851,1,A,C,4783119,72487,4514024,4907240,269095
17,ENSG00000005381.5,58280935,17-58156138-C-T,rs3863502,-1,C,T,58156138,124797,58084327,58477543,71811
17,ENSG00000185105.4,81947233,17-82022880-C-A,rs3934983,-1,C,A,82022880,75647,81750625,82143841,272255
17,ENSG00000130935.4,67717936,17-67818266-C-G,rs3936134,1,C,G,67818266,100330,67521328,67914544,296938
17,ENSG00000177728.9,75456635,17-75545929-G-A,rs4073422,1,G,A,75545929,89294,75260027,75653243,285902
17,ENSG00000141258.7,2337501,17-2334167-T-G,rs413016,1,T,G,2334167,3334,2140893,2534109,193274
17,ENSG00000141258.7,2337501,17-2334167-T-A,rs413016,1,T,A,2334167,3334,2140893,2534109,193274
17,ENSG00000141258.7,2337501,17-2334167-T-C,rs413016,1,T,C,2334167,3334,2140893,2534109,193274
17,ENSG00000109046.9,27294114,17-27362796-A-T,rs4239230,1,A,T,27362796,68682,27097506,27490722,265290
17,ENSG00000109046.9,27294114,17-27362796-A-G,rs4239230,1,A,G,27362796,68682,27097506,27490722,265290
17,ENSG00000136485.8,63550477,17-63667729-A-G,rs4456567,1,A,G,63667729,117252,63353869,63747085,313860
17,ENSG00000108298.4,39200283,17-39315229-G-T,rs4516267,1,G,T,39315229,114946,39003675,39396891,311554
17,ENSG00000129673.4,76467603,17-76491653-T-C,rs4788926,1,T,C,76491653,24050,76270995,76664211,220658
17,ENSG00000129673.4,76467603,17-76491653-T-G,rs4788926,1,T,G,76491653,24050,76270995,76664211,220658
17,ENSG00000125450.5,75205679,17-75082092-C-T,rs4789131,1,C,T,75082092,123587,75009071,75402287,73021
17,ENSG00000167711.9,1742871,17-1606612-A-G,rs4790708,1,A,G,1606612,136259,1546263,1939479,60349
17,ENSG00000167711.9,1742871,17-1606612-A-T,rs4790708,1,A,T,1606612,136259,1546263,1939479,60349
17,ENSG00000120063.4,65056740,17-65130151-C-A,rs4790958,-1,C,A,65130151,73411,64860132,65253348,270019
17,ENSG00000120063.4,65056740,17-65130151-C-G,rs4790958,-1,C,G,65130151,73411,64860132,65253348,270019
17,ENSG00000178921.8,8249289,17-8213797-A-G,rs4792590,1,A,G,8213797,35492,8052681,8445897,161116
17,ENSG00000178921.8,8249289,17-8213797-A-T,rs4792590,1,A,T,8213797,35492,8052681,8445897,161116
17,ENSG00000006282.13,50547174,17-50541888-C-A,rs4794159,1,C,A,50541888,5286,50350566,50743782,191322
17,ENSG00000153933.5,56834151,17-56772968-A-T,rs4794665,1,A,T,56772968,61183,56637543,57030759,135425
17,ENSG00000153933.5,56834151,17-56772968-A-C,rs4794665,1,A,C,56772968,61183,56637543,57030759,135425
17,ENSG00000153933.5,56834151,17-56772968-A-G,rs4794665,1,A,G,56772968,61183,56637543,57030759,135425
17,ENSG00000141741.6,39730532,17-39910767-C-T,rs4795400,-1,C,T,39910767,180235,39533924,39927140,376843
17,ENSG00000131242.10,31391675,17-31491876-A-C,rs4795613,1,A,C,31491876,100201,31195067,31588283,296809
17,ENSG00000131242.10,31391675,17-31491876-A-T,rs4795613,1,A,T,31491876,100201,31195067,31588283,296809
17,ENSG00000131242.10,31391675,17-31491876-A-G,rs4795613,1,A,G,31491876,100201,31195067,31588283,296809
17,ENSG00000126858.11,32142502,17-32242917-G-A,rs4795682,1,G,A,32242917,100415,31945894,32339110,297023
17,ENSG00000132507.13,7307628,17-7271578-T-C,rs4796392,1,T,C,7271578,36050,7111020,7504236,160558
17,ENSG00000132507.13,7307628,17-7271578-T-G,rs4796392,1,T,G,7271578,36050,7111020,7504236,160558
17,ENSG00000072818.6,7336529,17-7366054-C-G,rs4796409,1,C,G,7366054,29525,7139921,7533137,226133
17,ENSG00000072818.6,7336529,17-7366054-C-T,rs4796409,1,C,T,7366054,29525,7139921,7533137,226133
17,ENSG00000142494.7,19533854,17-19710044-A-G,rs4925044,1,A,G,19710044,176190,19337246,19730462,372798
17,ENSG00000177302.7,18314994,17-18269823-G-A,rs4925157,-1,G,A,18269823,45171,18118386,18511602,151437
17,ENSG00000108405.3,3916465,17-3918546-T-G,rs4995290,-1,T,G,3918546,2081,3719857,4113073,198689
17,ENSG00000108405.3,3916465,17-3918546-T-A,rs4995290,-1,T,A,3918546,2081,3719857,4113073,198689
17,ENSG00000108405.3,3916465,17-3918546-T-C,rs4995290,-1,T,C,3918546,2081,3719857,4113073,198689
17,ENSG00000167447.7,59210035,17-59294071-A-T,rs534242,1,A,T,59294071,84036,59013427,59406643,280644
17,ENSG00000167447.7,59210035,17-59294071-A-G,rs534242,1,A,G,59294071,84036,59013427,59406643,280644
17,ENSG00000182628.7,59155186,17-59294071-A-T,rs534242,-1,A,T,59294071,138885,58958578,59351794,335493
17,ENSG00000182628.7,59155186,17-59294071-A-G,rs534242,-1,A,G,59294071,138885,58958578,59351794,335493
17,ENSG00000212658.1,41302851,17-41137194-A-G,rs55667536,-1,A,G,41137194,165657,41106243,41499459,30951
17,ENSG00000177885.8,75405678,17-75393064-G-A,rs56150553,-1,G,A,75393064,12614,75209070,75602286,183994
17,ENSG00000181031.11,352807,17-200073-C-T,rs56209223,-1,C,T,200073,152734,156199,549415,43874
17,ENSG00000174292.7,7381089,17-7360708-G-A,rs56360822,1,G,A,7360708,20381,7184481,7577697,176227
17,ENSG00000170425.2,15945130,17-15861193-T-G,rs578065,1,T,G,15861193,83937,15748522,16141738,112671
17,ENSG00000170425.2,15945130,17-15861193-T-A,rs578065,1,T,A,15861193,83937,15748522,16141738,112671
17,ENSG00000168792.2,29567037,17-29577304-A-G,rs601364,-1,A,G,29577304,10267,29370429,29763645,206875
17,ENSG00000168792.2,29567037,17-29577304-A-C,rs601364,-1,A,C,29577304,10267,29370429,29763645,206875
17,ENSG00000168792.2,29567037,17-29577304-A-T,rs601364,-1,A,T,29577304,10267,29370429,29763645,206875
17,ENSG00000214087.4,81683797,17-81672654-G-C,rs61742298,-1,G,C,81672654,11143,81487189,81880405,185465
17,ENSG00000214087.4,81683797,17-81672654-G-A,rs61742298,-1,G,A,81672654,11143,81487189,81880405,185465
17,ENSG00000108666.4,32342173,17-32507599-T-C,rs62065495,-1,T,C,32507599,165426,32145565,32538781,362034
17,ENSG00000154025.10,18952165,17-18961970-G-T,rs62076169,1,G,T,18961970,9805,18755557,19148773,206413
17,ENSG00000154025.10,18952165,17-18961970-G-C,rs62076169,1,G,C,18961970,9805,18755557,19148773,206413
17,ENSG00000141524.9,78128755,17-78123014-G-A,rs62079069,-1,G,A,78123014,5741,77932147,78325363,190867
17,ENSG00000141524.9,78128755,17-78123014-G-T,rs62079069,-1,G,T,78123014,5741,77932147,78325363,190867
17,ENSG00000133195.6,73092688,17-73128764-G-A,rs6501601,-1,G,A,73128764,36076,72896080,73289296,232684
17,ENSG00000108395.8,59106880,17-58986806-A-G,rs6503890,-1,A,G,58986806,120074,58910272,59303488,76534
17,ENSG00000108395.8,59106880,17-58986806-A-T,rs6503890,-1,A,T,58986806,120074,58910272,59303488,76534
17,ENSG00000076351.7,28406212,17-28410870-C-A,rs6505081,-1,C,A,28410870,4658,28209604,28602820,201266
17,ENSG00000076351.7,28406212,17-28410870-C-T,rs6505081,-1,C,T,28410870,4658,28209604,28602820,201266
17,ENSG00000076351.7,28406212,17-28410870-C-G,rs6505081,-1,C,G,28410870,4658,28209604,28602820,201266
17,ENSG00000181481.7,30971039,17-30799933-G-A,rs6505211,1,G,A,30799933,171106,30774431,31167647,25502
17,ENSG00000108797.6,42682531,17-42570011-A-G,rs665268,1,A,G,42570011,112520,42485923,42879139,84088
17,ENSG00000108797.6,42682531,17-42570011-A-T,rs665268,1,A,T,42570011,112520,42485923,42879139,84088
17,ENSG00000108797.6,42682531,17-42570011-A-C,rs665268,1,A,C,42570011,112520,42485923,42879139,84088
17,ENSG00000161513.6,74872994,17-74894376-T-A,rs689992,-1,T,A,74894376,21382,74676386,75069602,217990
17,ENSG00000087157.11,78378649,17-78429095-G-C,rs691094,1,G,C,78429095,50446,78182041,78575257,247054
17,ENSG00000087157.11,78378649,17-78429095-G-A,rs691094,1,G,A,78429095,50446,78182041,78575257,247054
17,ENSG00000167083.2,49210574,17-49257937-T-G,rs705970,-1,T,G,49257937,47363,49013966,49407182,243971
17,ENSG00000167083.2,49210574,17-49257937-T-C,rs705970,-1,T,C,49257937,47363,49013966,49407182,243971
17,ENSG00000179094.8,8152404,17-8263060-T-A,rs7206953,-1,T,A,8263060,110656,7955796,8349012,307264
17,ENSG00000179094.8,8152404,17-8263060-T-C,rs7206953,-1,T,C,8263060,110656,7955796,8349012,307264
17,ENSG00000185156.4,8799365,17-8900268-T-C,rs7210930,-1,T,C,8900268,100903,8602757,8995973,297511
17,ENSG00000167525.8,28711888,17-28895970-G-T,rs7215315,-1,G,T,28895970,184082,28515280,28908496,380690
17,ENSG00000167525.8,28711888,17-28895970-G-C,rs7215315,-1,G,C,28895970,184082,28515280,28908496,380690
17,ENSG00000108771.6,42112714,17-42155060-T-A,rs7218506,-1,T,A,42155060,42346,41916106,42309322,238954
17,ENSG00000108771.6,42112714,17-42155060-T-G,rs7218506,-1,T,G,42155060,42346,41916106,42309322,238954
17,ENSG00000131747.9,40417896,17-40366397-C-A,rs7218663,-1,C,A,40366397,51499,40221288,40614504,145109
17,ENSG00000131747.9,40417896,17-40366397-C-T,rs7218663,-1,C,T,40366397,51499,40221288,40614504,145109
17,ENSG00000172057.4,39927601,17-39958263-A-C,rs7219080,-1,A,C,39958263,30662,39730993,40124209,227270
17,ENSG00000167693.12,979776,17-1121408-C-T,rs7220097,-1,C,T,1121408,141632,783168,1176384,338240
17,ENSG00000132589.8,28897733,17-29014416-A-G,rs7220474,-1,A,G,29014416,116683,28701125,29094341,313291
17,ENSG00000170832.7,60392133,17-60222610-C-T,rs7224812,-1,C,T,60222610,169523,60195525,60588741,27085
17,ENSG00000170832.7,60392133,17-60222610-C-A,rs7224812,-1,C,A,60222610,169523,60195525,60588741,27085
17,ENSG00000121067.12,49678097,17-49824823-C-T,rs7224846,-1,C,T,49824823,146726,49481489,49874705,343334
17,ENSG00000121104.3,49764131,17-49721363-A-T,rs7225566,-1,A,T,49721363,42768,49567523,49960739,153840
17,ENSG00000121104.3,49764131,17-49721363-A-G,rs7225566,-1,A,G,49721363,42768,49567523,49960739,153840
17,ENSG00000184640.10,77281499,17-77207010-C-T,rs7226135,1,C,T,77207010,74489,77084891,77478107,122119
17,ENSG00000177469.10,42423256,17-42361714-T-C,rs72823022,-1,T,C,42361714,61542,42226648,42619864,135066
17,ENSG00000177469.10,42423256,17-42361714-T-G,rs72823022,-1,T,G,42361714,61542,42226648,42619864,135066
17,ENSG00000108406.4,59565610,17-59539396-T-G,rs72839058,1,T,G,59539396,26214,59369002,59762218,170394
17,ENSG00000007171.11,27800529,17-27719666-G-A,rs72845833,-1,G,A,27719666,80863,27603921,27997137,115745
17,ENSG00000185298.8,81666737,17-81593382-T-C,rs7406863,1,T,C,81593382,73355,81470129,81863345,123253
17,ENSG00000141540.5,74213571,17-74081626-G-A,rs74254407,1,G,A,74081626,131945,74016963,74410179,64663
17,ENSG00000108798.4,49210707,17-49229467-C-T,rs74584378,1,C,T,49229467,18760,49014099,49407315,215368
17,ENSG00000169660.10,82418347,17-82378693-C-A,rs75021657,1,C,A,82378693,39654,82221739,82614955,156954
17,ENSG00000169660.10,82418347,17-82378693-C-T,rs75021657,1,C,T,82378693,39654,82221739,82614955,156954
17,ENSG00000182446.8,81637112,17-81672168-C-G,rs7502870,-1,C,G,81672168,35056,81440504,81833720,231664
17,ENSG00000182446.8,81637112,17-81672168-C-T,rs7502870,-1,C,T,81672168,35056,81440504,81833720,231664
17,ENSG00000170291.8,7252215,17-7162236-A-T,rs75060477,1,A,T,7162236,89979,7055607,7448823,106629
17,ENSG00000181523.7,80220333,17-80253549-G-A,rs75123972,-1,G,A,80253549,33216,80023725,80416941,229824
17,ENSG00000011028.8,62627670,17-62588972-C-T,rs76402483,1,C,T,62588972,38698,62431062,62824278,157910
17,ENSG00000183688.4,445939,17-525073-T-G,rs764490,-1,T,G,525073,79134,249331,642547,275742
17,ENSG00000142507.5,4796164,17-4654566-G-A,rs76577060,1,G,A,4654566,141598,4599556,4992772,55010
17,ENSG00000161958.5,7439512,17-7263341-C-G,rs77549883,1,C,G,7263341,176171,7242904,7636120,20437
17,ENSG00000161958.5,7439512,17-7263341-C-T,rs77549883,1,C,T,7263341,176171,7242904,7636120,20437
17,ENSG00000198740.4,49362250,17-49221604-C-T,rs77624269,-1,C,T,49221604,140646,49165642,49558858,55962
17,ENSG00000185722.9,4263979,17-4420839-C-A,rs78057571,-1,C,A,4420839,156860,4067371,4460587,353468
17,ENSG00000185722.9,4263979,17-4420839-C-G,rs78057571,-1,C,G,4420839,156860,4067371,4460587,353468
17,ENSG00000185722.9,4263979,17-4420839-C-T,rs78057571,-1,C,T,4420839,156860,4067371,4460587,353468
17,ENSG00000181350.7,16492193,17-16442439-G-T,rs78133126,-1,G,T,16442439,49754,16295585,16688801,146854
17,ENSG00000181350.7,16492193,17-16442439-G-A,rs78133126,-1,G,A,16442439,49754,16295585,16688801,146854
17,ENSG00000108828.9,43022385,17-42886907-G-A,rs78621411,-1,G,A,42886907,135478,42825777,43218993,61130
17,ENSG00000176563.4,42798861,17-42786243-G-A,rs78645838,1,G,A,42786243,12618,42602253,42995469,183990
17,ENSG00000196169.10,74326226,17-74396639-G-A,rs78857211,1,G,A,74396639,70413,74129618,74522834,267021
17,ENSG00000170310.5,9575820,17-9551127-C-G,rs79223721,-1,C,G,9551127,24693,9379212,9772428,171915
17,ENSG00000170310.5,9575820,17-9551127-C-T,rs79223721,-1,C,T,9551127,24693,9379212,9772428,171915
17,ENSG00000204316.7,75904884,17-75901263-G-A,rs79354765,-1,G,A,75901263,3621,75708276,76101492,192987
17,ENSG00000129204.11,5116032,17-5007944-T-C,rs79554147,1,T,C,5007944,108088,4919424,5312640,88520
17,ENSG00000154945.6,50707914,17-50743979-G-A,rs79777439,-1,G,A,50743979,36065,50511306,50904522,232673
17,ENSG00000125445.5,75261879,17-75237504-G-A,rs79858696,1,G,A,75237504,24375,75065271,75458487,172233
17,ENSG00000125445.5,75261879,17-75237504-G-C,rs79858696,1,G,C,75237504,24375,75065271,75458487,172233
17,ENSG00000125430.4,14301081,17-14348429-T-C,rs80319203,1,T,C,14348429,47348,14104473,14497689,243956
17,ENSG00000177303.4,75515537,17-75523332-C-G,rs8064529,-1,C,G,75523332,7795,75318929,75712145,204403
17,ENSG00000177303.4,75515537,17-75523332-C-T,rs8064529,-1,C,T,75523332,7795,75318929,75712145,204403
17,ENSG00000182173.7,75516528,17-75523332-C-G,rs8064529,1,C,G,75523332,6804,75319920,75713136,203412
17,ENSG00000182173.7,75516528,17-75523332-C-T,rs8064529,1,C,T,75523332,6804,75319920,75713136,203412
17,ENSG00000159199.8,48892787,17-48703467-A-G,rs8064938,1,A,G,48703467,189320,48696179,49089395,7288
17,ENSG00000091542.7,18183828,17-18142976-T-C,rs8065026,1,T,C,18142976,40852,17987220,18380436,155756
17,ENSG00000182612.6,81642413,17-81705575-G-A,rs8065104,1,G,A,81705575,63162,81445805,81839021,259770
17,ENSG00000154803.7,17237168,17-17196403-G-T,rs8066234,-1,G,T,17196403,40765,17040560,17433776,155843
17,ENSG00000204815.3,41930617,17-41771314-G-A,rs8066392,1,G,A,41771314,159303,41734009,42127225,37305
17,ENSG00000108309.7,44308601,17-44289209-C-G,rs8067711,1,C,G,44289209,19392,44111993,44505209,177216
17,ENSG00000125691.7,38853721,17-38835851-G-A,rs8068270,-1,G,A,38835851,17870,38657113,39050329,178738
17,ENSG00000171298.8,80101581,17-80126932-A-G,rs8068856,1,A,G,80126932,25351,79904973,80298189,221959
17,ENSG00000171298.8,80101581,17-80126932-A-C,rs8068856,1,A,C,80126932,25351,79904973,80298189,221959
17,ENSG00000171298.8,80101581,17-80126932-A-T,rs8068856,1,A,T,80126932,25351,79904973,80298189,221959
17,ENSG00000166579.10,8435884,17-8338333-A-G,rs8069620,1,A,G,8338333,97551,8239276,8632492,99057
17,ENSG00000068097.8,60078921,17-59896559-T-C,rs8071475,-1,T,C,59896559,182362,59882313,60275529,14246
17,ENSG00000141574.2,82333766,17-82415501-G-T,rs8072110,-1,G,T,82415501,81735,82137158,82530374,278343
17,ENSG00000141574.2,82333766,17-82415501-G-A,rs8072110,-1,G,A,82415501,81735,82137158,82530374,278343
17,ENSG00000141574.2,82333766,17-82415501-G-C,rs8072110,-1,G,C,82415501,81735,82137158,82530374,278343
17,ENSG00000005882.6,50095351,17-50146185-T-C,rs8073095,1,T,C,50146185,50834,49898743,50291959,247442
17,ENSG00000109066.8,74776499,17-74713605-C-A,rs8073748,1,C,A,74713605,62894,74579891,74973107,133714
17,ENSG00000109066.8,74776499,17-74713605-C-T,rs8073748,1,C,T,74713605,62894,74579891,74973107,133714
17,ENSG00000141569.5,75896951,17-75817169-C-T,rs8074216,-1,C,T,75817169,79782,75700343,76093559,116826
17,ENSG00000141569.5,75896951,17-75817169-C-G,rs8074216,-1,C,G,75817169,79782,75700343,76093559,116826
17,ENSG00000141569.5,75896951,17-75817169-C-A,rs8074216,-1,C,A,75817169,79782,75700343,76093559,116826
17,ENSG00000205544.3,7404097,17-7407503-T-C,rs8075459,-1,T,C,7407503,3406,7207489,7600705,200014
17,ENSG00000187624.7,410325,17-438357-C-T,rs8076098,1,C,T,438357,28032,213717,606933,224640
17,ENSG00000187624.7,410325,17-438357-C-G,rs8076098,1,C,G,438357,28032,213717,606933,224640
17,ENSG00000141696.6,41811949,17-41973245-C-T,rs8077391,-1,C,T,41973245,161296,41615341,42008557,357904
17,ENSG00000141696.6,41811949,17-41973245-C-A,rs8077391,-1,C,A,41973245,161296,41615341,42008557,357904
17,ENSG00000174327.6,7036015,17-7044260-G-A,rs8078000,1,G,A,7044260,8245,6839407,7232623,204853
17,ENSG00000006283.13,50560715,17-50587783-A-G,rs8078184,1,A,G,50587783,27068,50364107,50757323,223676
17,ENSG00000006283.13,50560715,17-50587783-A-T,rs8078184,1,A,T,50587783,27068,50364107,50757323,223676
17,ENSG00000006283.13,50560715,17-50587783-A-C,rs8078184,1,A,C,50587783,27068,50364107,50757323,223676
17,ENSG00000243678.6,51166411,17-51132389-G-A,rs8078191,1,G,A,51132389,34022,50969803,51363019,162586
17,ENSG00000141698.10,41836232,17-41968753-T-G,rs8078650,-1,T,G,41968753,132521,41639624,42032840,329129
17,ENSG00000197417.7,3636250,17-3577102-C-G,rs8078936,-1,C,G,3577102,59148,3439642,3832858,137460
17,ENSG00000197417.7,3636250,17-3577102-C-A,rs8078936,-1,C,A,3577102,59148,3439642,3832858,137460
17,ENSG00000197417.7,3636250,17-3577102-C-T,rs8078936,-1,C,T,3577102,59148,3439642,3832858,137460
17,ENSG00000034152.13,21284711,17-21177642-T-G,rs8080379,1,T,G,21177642,107069,21088103,21481319,89539
17,ENSG00000034152.13,21284711,17-21177642-T-C,rs8080379,1,T,C,21177642,107069,21088103,21481319,89539
17,ENSG00000109016.12,21126964,17-21115728-G-A,rs8081296,1,G,A,21115728,11236,20930356,21323572,185372
17,ENSG00000092931.6,76738119,17-76654526-T-G,rs8182300,1,T,G,76654526,83593,76541511,76934727,113015
17,ENSG00000092931.6,76738119,17-76654526-T-A,rs8182300,1,T,A,76654526,83593,76541511,76934727,113015
17,ENSG00000092931.6,76738119,17-76654526-T-C,rs8182300,1,T,C,76654526,83593,76541511,76934727,113015
17,ENSG00000141294.4,47831670,17-47819112-T-C,rs878171,1,T,C,47819112,12558,47635062,48028278,184050
17,ENSG00000186532.7,1829902,17-1917456-G-A,rs882495,-1,G,A,1917456,87554,1633294,2026510,284162
17,ENSG00000108379.5,46818692,17-46785767-T-C,rs916888,-1,T,C,46785767,32925,46622084,47015300,163683
17,ENSG00000131470.9,42577729,17-42402831-G-A,rs9252,-1,G,A,42402831,174898,42381121,42774337,21710
17,ENSG00000154258.10,69060927,17-69113692-T-A,rs9282554,-1,T,A,69113692,52765,68864319,69257535,249373
17,ENSG00000125319.8,44141930,17-44201473-A-T,rs9303601,1,A,T,44201473,59543,43945322,44338538,256151
17,ENSG00000125319.8,44141930,17-44201473-A-G,rs9303601,1,A,G,44201473,59543,43945322,44338538,256151
17,ENSG00000108352.5,40177470,17-40075600-T-G,rs939348,1,T,G,40075600,101870,39980862,40374078,94738
17,ENSG00000108352.5,40177470,17-40075600-T-C,rs939348,1,T,C,40075600,101870,39980862,40374078,94738
17,ENSG00000244045.3,28357647,17-28440862-G-T,rs9675204,1,G,T,28440862,83215,28161039,28554255,279823
17,ENSG00000244045.3,28357647,17-28440862-G-A,rs9675204,1,G,A,28440862,83215,28161039,28554255,279823
17,ENSG00000173838.6,62808314,17-62712044-T-C,rs9891713,-1,T,C,62712044,96270,62611706,63004922,100338
17,ENSG00000220205.3,8162948,17-8195865-G-A,rs9891949,-1,G,A,8195865,32917,7966340,8359556,229525
17,ENSG00000108528.9,4940046,17-5102453-T-C,rs9893521,-1,T,C,5102453,162407,4743438,5136654,359015
17,ENSG00000108528.9,4940046,17-5102453-T-G,rs9893521,-1,T,G,5102453,162407,4743438,5136654,359015
17,ENSG00000108528.9,4940046,17-5102453-T-A,rs9893521,-1,T,A,5102453,162407,4743438,5136654,359015
17,ENSG00000176845.8,83079609,17-83013582-G-A,rs9893868,1,G,A,83013582,66027,82883001,83276217,130581
17,ENSG00000167840.9,5111841,17-5042515-C-A,rs9898431,-1,C,A,5042515,69326,4915233,5308449,127282
17,ENSG00000198242.7,28719985,17-28764815-G-A,rs9898968,1,G,A,28764815,44830,28523377,28916593,241438
17,ENSG00000167862.4,75012670,17-75013349-C-T,rs9899328,1,C,T,75013349,679,74816062,75209278,197287
17,ENSG00000185245.5,4932277,17-4835866-T-G,rs9900036,1,T,G,4835866,96411,4735669,5128885,100197
17,ENSG00000185245.5,4932277,17-4835866-T-A,rs9900036,1,T,A,4835866,96411,4735669,5128885,100197
17,ENSG00000108556.7,4903098,17-4835866-T-G,rs9900036,-1,T,G,4835866,67232,4706490,5099706,129376
17,ENSG00000108556.7,4903098,17-4835866-T-A,rs9900036,-1,T,A,4835866,67232,4706490,5099706,129376
17,ENSG00000175866.10,81035151,17-81137595-C-T,rs9900420,1,C,T,81137595,102444,80838543,81231759,299052
17,ENSG00000175866.10,81035151,17-81137595-C-G,rs9900420,1,C,G,81137595,102444,80838543,81231759,299052
17,ENSG00000175866.10,81035151,17-81137595-C-A,rs9900420,1,C,A,81137595,102444,80838543,81231759,299052
17,ENSG00000108861.3,43778977,17-43690607-C-T,rs9901754,-1,C,T,43690607,88370,43582369,43975585,108238
17,ENSG00000180901.5,75047225,17-75053342-G-A,rs9906330,1,G,A,75053342,6117,74850617,75243833,202725
17,ENSG00000180901.5,75047225,17-75053342-G-C,rs9906330,1,G,C,75053342,6117,74850617,75243833,202725
17,ENSG00000180901.5,75047225,17-75053342-G-T,rs9906330,1,G,T,75053342,6117,74850617,75243833,202725
17,ENSG00000214447.3,44899774,17-44930583-T-C,rs9908100,1,T,C,44930583,30809,44703166,45096382,227417
17,ENSG00000214447.3,44899774,17-44930583-T-A,rs9908100,1,T,A,44930583,30809,44703166,45096382,227417
17,ENSG00000171916.11,18476789,17-18638910-G-T,rs9909256,1,G,T,18638910,162121,18280181,18673397,358729
17,ENSG00000171916.11,18476789,17-18638910-G-C,rs9909256,1,G,C,18638910,162121,18280181,18673397,358729
17,ENSG00000161664.1,44170704,17-44205669-C-A,rs9910055,1,C,A,44205669,34965,43974096,44367312,231573
17,ENSG00000161664.1,44170704,17-44205669-C-T,rs9910055,1,C,T,44205669,34965,43974096,44367312,231573
17,ENSG00000224877.2,81239318,17-81168719-G-C,rs9911980,1,G,C,81168719,70599,81042710,81435926,126009
17,ENSG00000224877.2,81239318,17-81168719-G-A,rs9911980,1,G,A,81168719,70599,81042710,81435926,126009
17,ENSG00000181409.7,81166221,17-81168719-G-C,rs9911980,-1,G,C,81168719,2498,80969613,81362829,199106
17,ENSG00000181409.7,81166221,17-81168719-G-A,rs9911980,-1,G,A,81168719,2498,80969613,81362829,199106
17,ENSG00000167085.6,49414882,17-49294955-C-A,rs9914524,-1,C,A,49294955,119927,49218274,49611490,76681
17,ENSG00000167085.6,49414882,17-49294955-C-T,rs9914524,-1,C,T,49294955,119927,49218274,49611490,76681
17,ENSG00000005156.5,34980512,17-35116196-A-G,rs9915078,1,A,G,35116196,135684,34783904,35177120,332292
17,ENSG00000180616.3,73165010,17-73169153-A-G,rs998571,1,A,G,73169153,4143,72968402,73361618,200751
16,ENSG00000183196.4,75495441,16-75486019-G-A,rs100912,-1,G,A,75486019,9422,75298833,75692049,187186
16,ENSG00000183196.4,75495441,16-75486019-G-C,rs100912,-1,G,C,75486019,9422,75298833,75692049,187186
16,ENSG00000197912.8,89508403,16-89582837-A-G,rs101151,1,A,G,89582837,74434,89311795,89705011,271042
16,ENSG00000197912.8,89508403,16-89582837-A-T,rs101151,1,A,T,89582837,74434,89311795,89705011,271042
16,ENSG00000118894.9,5097795,16-5107527-T-C,rs10459836,-1,T,C,5107527,9732,4901187,5294403,206340
16,ENSG00000118894.9,5097795,16-5107527-T-A,rs10459836,-1,T,A,5107527,9732,4901187,5294403,206340
16,ENSG00000129636.8,47461063,16-47486253-C-T,rs10459879,-1,C,T,47486253,25190,47264455,47657671,221798
16,ENSG00000213380.7,69339564,16-69342783-C-T,rs1048818,-1,C,T,69342783,3219,69142956,69536172,199827
16,ENSG00000213380.7,69339564,16-69342783-C-A,rs1048818,-1,C,A,69342783,3219,69142956,69536172,199827
16,ENSG00000176953.6,28950937,16-28904206-G-A,rs10499,1,G,A,28904206,46731,28754329,29147545,149877
16,ENSG00000176953.6,28950937,16-28904206-G-T,rs10499,1,G,T,28904206,46731,28754329,29147545,149877
16,ENSG00000184110.9,28711464,16-28904206-G-A,rs10499,1,G,A,28904206,192742,28514856,28908072,389350
16,ENSG00000184110.9,28711464,16-28904206-G-T,rs10499,1,G,T,28904206,192742,28514856,28908072,389350
16,ENSG00000140905.5,81096395,16-81081668-T-C,rs10514514,-1,T,C,81081668,14727,80899787,81293003,181881
16,ENSG00000140905.5,81096395,16-81081668-T-G,rs10514514,-1,T,G,81081668,14727,80899787,81293003,181881
16,ENSG00000140718.14,53704156,16-53874572-T-C,rs10521305,1,T,C,53874572,170416,53507548,53900764,367024
16,ENSG00000131153.3,85688954,16-85678254-C-T,rs1053328,-1,C,T,85678254,10700,85492346,85885562,185908
16,ENSG00000161996.13,649365,16-522855-G-T,rs1054363,1,G,T,522855,126510,452757,845973,70098
16,ENSG00000161996.13,649365,16-522855-G-A,rs1054363,1,G,A,522855,126510,452757,845973,70098
16,ENSG00000141012.7,88856947,16-88835775-G-A,rs1064315,-1,G,A,88835775,21172,88660339,89053555,175436
16,ENSG00000159708.12,67326815,16-67304594-A-G,rs10852437,1,A,G,67304594,22221,67130207,67523423,174387
16,ENSG00000159708.12,67326815,16-67304594-A-T,rs10852437,1,A,T,67304594,22221,67130207,67523423,174387
16,ENSG00000166669.9,10386061,16-10492970-T-C,rs11074871,1,T,C,10492970,106909,10189453,10582669,303517
16,ENSG00000166669.9,10386061,16-10492970-T-A,rs11074871,1,T,A,10492970,106909,10189453,10582669,303517
16,ENSG00000162076.8,2883215,16-2904915-T-C,rs11076933,1,T,C,2904915,21700,2686607,3079823,218308
16,ENSG00000162076.8,2883215,16-2904915-T-G,rs11076933,1,T,G,2904915,21700,2686607,3079823,218308
16,ENSG00000135702.10,75536108,16-75568899-G-A,rs11149841,-1,G,A,75568899,32791,75339500,75732716,229399
16,ENSG00000135702.10,75536108,16-75568899-G-T,rs11149841,-1,G,T,75568899,32791,75339500,75732716,229399
16,ENSG00000103227.12,970984,16-940631-C-T,rs112029446,-1,C,T,940631,30353,774376,1167592,166255
16,ENSG00000185883.5,2513952,16-2439969-C-T,rs11248924,1,C,T,2439969,73983,2317344,2710560,122625
16,ENSG00000149923.9,30075994,16-29992435-C-T,rs112533759,1,C,T,29992435,83559,29879386,30272602,113049
16,ENSG00000149932.11,29962079,16-29992435-C-T,rs112533759,1,C,T,29992435,30356,29765471,30158687,226964
16,ENSG00000181019.8,69726560,16-69726438-A-G,rs114238154,-1,A,G,69726438,122,69529952,69923168,196486
16,ENSG00000181019.8,69726560,16-69726438-A-C,rs114238154,-1,A,C,69726438,122,69529952,69923168,196486
16,ENSG00000181019.8,69726560,16-69726438-A-T,rs114238154,-1,A,T,69726438,122,69529952,69923168,196486
16,ENSG00000103313.6,3256633,16-3066294-A-G,rs115567031,-1,A,G,3066294,190339,3060025,3453241,6269
16,ENSG00000103313.6,3256633,16-3066294-A-C,rs115567031,-1,A,C,3066294,190339,3060025,3453241,6269
16,ENSG00000259803.1,89200537,16-89084627-T-C,rs11642779,-1,T,C,89084627,115910,89003929,89397145,80698
16,ENSG00000259803.1,89200537,16-89084627-T-G,rs11642779,-1,T,G,89084627,115910,89003929,89397145,80698
16,ENSG00000102870.4,30787205,16-30774503-C-T,rs11642862,-1,C,T,30774503,12702,30590597,30983813,183906
16,ENSG00000166592.7,66925535,16-66976846-C-T,rs11645675,-1,C,T,66976846,51311,66728927,67122143,247919
16,ENSG00000167977.4,2682523,16-2663274-T-C,rs11646579,1,T,C,2663274,19249,2485915,2879131,177359
16,ENSG00000066654.8,20741818,16-20763597-G-A,rs11647477,-1,G,A,20763597,21779,20545210,20938426,218387
16,ENSG00000066654.8,20741818,16-20763597-G-T,rs11647477,-1,G,T,20763597,21779,20545210,20938426,218387
16,ENSG00000184602.5,11668455,16-11693858-G-C,rs11648550,1,G,C,11693858,25403,11471847,11865063,222011
16,ENSG00000184602.5,11668455,16-11693858-G-A,rs11648550,1,G,A,11693858,25403,11471847,11865063,222011
16,ENSG00000184602.5,11668455,16-11693858-G-T,rs11648550,1,G,T,11693858,25403,11471847,11865063,222011
16,ENSG00000140995.12,89948755,16-89979578-A-G,rs11648898,1,A,G,89979578,30823,89752147,90145363,227431
16,ENSG00000124391.4,88638572,16-88700532-C-G,rs11649140,1,C,G,88700532,61960,88441964,88835180,258568
16,ENSG00000124391.4,88638572,16-88700532-C-T,rs11649140,1,C,T,88700532,61960,88441964,88835180,258568
16,ENSG00000155393.8,50065970,16-50057424-C-T,rs11649294,1,C,T,50057424,8546,49869362,50262578,188062
16,ENSG00000155393.8,50065970,16-50057424-C-G,rs11649294,1,C,G,50057424,8546,49869362,50262578,188062
16,ENSG00000059145.13,1414704,16-1370637-C-T,rs116678909,-1,C,T,1370637,44067,1218096,1611312,152541
16,ENSG00000185164.10,18562097,16-18757454-A-G,rs117059302,-1,A,G,18757454,195357,18365489,18758705,391965
16,ENSG00000103260.3,715118,16-770938-G-A,rs117105357,1,G,A,770938,55820,518510,911726,252428
16,ENSG00000167186.6,19067614,16-19071502-A-G,rs117361580,1,A,G,19071502,3888,18871006,19264222,200496
16,ENSG00000102897.5,20900771,16-20755278-C-G,rs117421027,1,C,G,20755278,145493,20704163,21097379,51115
16,ENSG00000177455.6,28931971,16-28811498-T-C,rs117475154,1,T,C,28811498,120473,28735363,29128579,76135
16,ENSG00000103310.6,21211574,16-21251675-C-A,rs117548295,-1,C,A,21251675,40101,21014966,21408182,236709
16,ENSG00000168286.1,67842320,16-67646903-G-T,rs117556162,1,G,T,67646903,195417,67645712,68038928,1191
16,ENSG00000168286.1,67842320,16-67646903-G-A,rs117556162,1,G,A,67646903,195417,67645712,68038928,1191
16,ENSG00000122257.14,24539566,16-24399434-G-A,rs117606263,1,G,A,24399434,140132,24342958,24736174,56476
16,ENSG00000167964.7,2148625,16-2336423-A-G,rs118055416,1,A,G,2336423,187798,1952017,2345233,384406
16,ENSG00000157423.12,71230722,16-71100374-A-C,rs118108478,-1,A,C,71100374,130348,71034114,71427330,66260
16,ENSG00000167930.11,234821,16-314025-C-T,rs118125792,1,C,T,314025,79204,38213,431429,275812
16,ENSG00000168434.8,23453189,16-23428676-T-C,rs11861636,-1,T,C,23428676,24513,23256581,23649797,172095
16,ENSG00000162004.10,726443,16-735279-A-G,rs11864516,-1,A,G,735279,8836,529835,923051,205444
16,ENSG00000162004.10,726443,16-735279-A-T,rs11864516,-1,A,T,735279,8836,529835,923051,205444
16,ENSG00000161999.6,684334,16-735279-A-G,rs11864516,-1,A,G,735279,50945,487726,880942,247553
16,ENSG00000161999.6,684334,16-735279-A-T,rs11864516,-1,A,T,735279,50945,487726,880942,247553
16,ENSG00000102882.7,30123220,16-30119172-C-A,rs11865086,-1,C,A,30119172,4048,29926612,30319828,192560
16,ENSG00000102882.7,30123220,16-30119172-C-T,rs11865086,-1,C,T,30119172,4048,29926612,30319828,192560
16,ENSG00000007516.8,1333645,16-1365298-G-A,rs11865640,1,G,A,1365298,31653,1137037,1530253,228261
16,ENSG00000103245.8,740997,16-733864-C-A,rs12051048,-1,C,A,733864,7133,544389,937605,189475
16,ENSG00000102886.10,30113537,16-30107024-T-G,rs12444415,-1,T,G,30107024,6513,29916929,30310145,190095
16,ENSG00000102886.10,30113537,16-30107024-T-C,rs12444415,-1,T,C,30107024,6513,29916929,30310145,190095
16,ENSG00000102886.10,30113537,16-30107024-T-A,rs12444415,-1,T,A,30107024,6513,29916929,30310145,190095
16,ENSG00000099381.12,30957754,16-30993491-T-C,rs12445568,1,T,C,30993491,35737,30761146,31154362,232345
16,ENSG00000168488.13,28822999,16-28999976-G-A,rs12446189,1,G,A,28999976,176977,28626391,29019607,373585
16,ENSG00000140945.10,82626969,16-82789422-C-A,rs12447750,1,C,A,82789422,162453,82430361,82823577,359061
16,ENSG00000140945.10,82626969,16-82789422-C-T,rs12447750,1,C,T,82789422,162453,82430361,82823577,359061
16,ENSG00000140945.10,82626969,16-82789422-C-G,rs12447750,1,C,G,82789422,162453,82430361,82823577,359061
16,ENSG00000102931.3,57245259,16-57080103-A-G,rs12598418,1,A,G,57080103,165156,57048651,57441867,31452
16,ENSG00000102931.3,57245259,16-57080103-A-C,rs12598418,1,A,C,57080103,165156,57048651,57441867,31452
16,ENSG00000159648.7,57976544,16-57988232-C-T,rs12600304,1,C,T,57988232,11688,57779936,58173152,208296
16,ENSG00000167965.12,2205454,16-2175822-G-A,rs12921326,1,G,A,2175822,29632,2008846,2402062,166976
16,ENSG00000166455.9,81077238,16-81120843-T-C,rs12933918,-1,T,C,81120843,43605,80880630,81273846,240213
16,ENSG00000140798.10,48155993,16-48329160-C-A,rs13331795,-1,C,A,48329160,173167,47959385,48352601,369775
16,ENSG00000013364.14,29820462,16-29839384-C-T,rs13332078,1,C,T,29839384,18922,29623854,30017070,215530
16,ENSG00000127585.7,705801,16-754760-C-G,rs13336445,-1,C,G,754760,48959,509193,902409,245567
16,ENSG00000127585.7,705801,16-754760-C-T,rs13336445,-1,C,T,754760,48959,509193,902409,245567
16,ENSG00000140682.14,31472152,16-31467390-G-A,rs13337037,1,G,A,31467390,4762,31275544,31668760,191846
16,ENSG00000189067.8,11586919,16-11585674-A-G,rs1345442,-1,A,G,11585674,1245,11390311,11783527,195363
16,ENSG00000189067.8,11586919,16-11585674-A-C,rs1345442,-1,A,C,11585674,1245,11390311,11783527,195363
16,ENSG00000183793.9,15378294,16-15397627-C-G,rs153002,-1,C,G,15397627,19333,15181686,15574902,215941
16,ENSG00000183793.9,15378294,16-15397627-C-T,rs153002,-1,C,T,15397627,19333,15181686,15574902,215941
16,ENSG00000166123.9,46884362,16-46935824-A-C,rs1542292,1,A,C,46935824,51462,46687754,47080970,248070
16,ENSG00000166123.9,46884362,16-46935824-A-T,rs1542292,1,A,T,46935824,51462,46687754,47080970,248070
16,ENSG00000166123.9,46884362,16-46935824-A-G,rs1542292,1,A,G,46935824,51462,46687754,47080970,248070
16,ENSG00000086504.10,370538,16-373696-C-T,rs1573735,-1,C,T,373696,3158,173930,567146,199766
16,ENSG00000184857.7,8797639,16-8646561-T-G,rs1641072,-1,T,G,8646561,151078,8601031,8994247,45530
16,ENSG00000184857.7,8797639,16-8646561-T-A,rs1641072,-1,T,A,8646561,151078,8601031,8994247,45530
16,ENSG00000184857.7,8797639,16-8646561-T-C,rs1641072,-1,T,C,8646561,151078,8601031,8994247,45530
16,ENSG00000103415.7,4476398,16-4545106-G-T,rs1659498,1,G,T,4545106,68708,4279790,4673006,265316
16,ENSG00000103415.7,4476398,16-4545106-G-C,rs1659498,1,G,C,4545106,68708,4279790,4673006,265316
16,ENSG00000102910.7,48244300,16-48208448-G-A,rs16945946,1,G,A,48208448,35852,48047692,48440908,160756
16,ENSG00000140931.15,66604704,16-66493956-C-T,rs16956585,1,C,T,66493956,110748,66408096,66801312,85860
16,ENSG00000089505.12,66566439,16-66551327-T-C,rs16956627,1,T,C,66551327,15112,66369831,66763047,181496
16,ENSG00000089505.12,66566439,16-66551327-T-G,rs16956627,1,T,G,66551327,15112,66369831,66763047,181496
16,ENSG00000166816.9,75116780,16-75235226-T-C,rs16957552,-1,T,C,75235226,118446,74920172,75313388,315054
16,ENSG00000125166.7,58734316,16-58634940-C-T,rs16960332,-1,C,T,58634940,99376,58537708,58930924,97232
16,ENSG00000125166.7,58734316,16-58634940-C-G,rs16960332,-1,C,G,58634940,99376,58537708,58930924,97232
16,ENSG00000140835.7,71526426,16-71503647-G-A,rs16973266,1,G,A,71503647,22779,71329818,71723034,173829
16,ENSG00000140835.7,71526426,16-71503647-G-C,rs16973266,1,G,C,71503647,22779,71329818,71723034,173829
16,ENSG00000133392.10,15857028,16-15902668-C-A,rs169983,-1,C,A,15902668,45640,15660420,16053636,242248
16,ENSG00000133392.10,15857028,16-15902668-C-T,rs169983,-1,C,T,15902668,45640,15660420,16053636,242248
16,ENSG00000127561.8,1989970,16-1989590-T-C,rs17135750,1,T,C,1989590,380,1793362,2186578,196228
16,ENSG00000167968.7,2236444,16-2332165-A-G,rs17135882,1,A,G,2332165,95721,2039836,2433052,292329
16,ENSG00000140988.10,1964826,16-1975677-C-A,rs17602,-1,C,A,1975677,10851,1768218,2161434,207459
16,ENSG00000140988.10,1964826,16-1975677-C-T,rs17602,-1,C,T,1975677,10851,1768218,2161434,207459
16,ENSG00000140988.10,1964826,16-1975677-C-G,rs17602,-1,C,G,1975677,10851,1768218,2161434,207459
16,ENSG00000103089.4,74774820,16-74821962-A-C,rs17683948,-1,A,C,74821962,47142,74578212,74971428,243750
16,ENSG00000196678.9,20806472,16-20849750-C-A,rs17691515,-1,C,A,20849750,43278,20609864,21003080,239886
16,ENSG00000196678.9,20806472,16-20849750-C-T,rs17691515,-1,C,T,20849750,43278,20609864,21003080,239886
16,ENSG00000196678.9,20806472,16-20849750-C-G,rs17691515,-1,C,G,20849750,43278,20609864,21003080,239886
16,ENSG00000091651.4,46689659,16-46606680-T-G,rs17728559,1,T,G,46606680,82979,46493051,46886267,113629
16,ENSG00000158486.8,21159441,16-21238712-G-C,rs17764140,-1,G,C,21238712,79271,20962833,21356049,275879
16,ENSG00000158486.8,21159441,16-21238712-G-A,rs17764140,-1,G,A,21238712,79271,20962833,21356049,275879
16,ENSG00000158805.7,89721537,16-89881049-A-G,rs17784386,1,A,G,89881049,159512,89524929,89918145,356120
16,ENSG00000179918.14,30445874,16-30480462-T-C,rs17839544,-1,T,C,30480462,34588,30249266,30642482,231196
16,ENSG00000179918.14,30445874,16-30480462-T-G,rs17839544,-1,T,G,30480462,34588,30249266,30642482,231196
16,ENSG00000169189.12,27268772,16-27426650-G-A,rs179762,-1,G,A,27426650,157878,27072164,27465380,354486
16,ENSG00000154102.5,85751096,16-85800554-T-A,rs1800647,-1,T,A,85800554,49458,85554488,85947704,246066
16,ENSG00000154102.5,85751096,16-85800554-T-C,rs1800647,-1,T,C,85800554,49458,85554488,85947704,246066
16,ENSG00000077238.8,27313974,16-27344882-A-C,rs1805010,1,A,C,27344882,30908,27117366,27510582,227516
16,ENSG00000077238.8,27313974,16-27344882-A-G,rs1805010,1,A,G,27344882,30908,27117366,27510582,227516
16,ENSG00000077238.8,27313974,16-27344882-A-T,rs1805010,1,A,T,27344882,30908,27117366,27510582,227516
16,ENSG00000155714.9,22001116,16-21972811-T-C,rs185951984,-1,T,C,21972811,28305,21804508,22197724,168303
16,ENSG00000006194.6,3283491,16-3288343-G-C,rs188761,1,G,C,3288343,4852,3086883,3480099,201460
16,ENSG00000140749.7,21652608,16-21597151-G-A,rs194548,-1,G,A,21597151,55457,21456000,21849216,141151
16,ENSG00000186153.11,78099654,16-78074077-A-G,rs1950157,1,A,G,78074077,25577,77903046,78296262,171031
16,ENSG00000103510.14,31117664,16-31118621-C-T,rs1978487,1,C,T,31118621,957,30921056,31314272,197565
16,ENSG00000103363.10,2777280,16-2774929-C-G,rs2009509,-1,C,G,2774929,2351,2580672,2973888,194257
16,ENSG00000140968.5,85899162,16-85879487-A-C,rs2017161,1,A,C,85879487,19675,85702554,86095770,176933
16,ENSG00000103540.12,19523857,16-19556707-C-G,rs2028265,1,C,G,19556707,32850,19327249,19720465,229458
16,ENSG00000005194.10,57447385,16-57606941-G-A,rs2044787,-1,G,A,57606941,159556,57250777,57643993,356164
16,ENSG00000196557.6,1153106,16-1203529-T-G,rs2050114,1,T,G,1203529,50423,956498,1349714,247031
16,ENSG00000196557.6,1153106,16-1203529-T-C,rs2050114,1,T,C,1203529,50423,956498,1349714,247031
16,ENSG00000196557.6,1153106,16-1203529-T-A,rs2050114,1,T,A,1203529,50423,956498,1349714,247031
16,ENSG00000232196.2,3372668,16-3485028-G-T,rs2074524,-1,G,T,3485028,112360,3176060,3569276,308968
16,ENSG00000232196.2,3372668,16-3485028-G-A,rs2074524,-1,G,A,3485028,112360,3176060,3569276,308968
16,ENSG00000138834.8,1706195,16-1524029-G-A,rs2076437,1,G,A,1524029,182166,1509587,1902803,14442
16,ENSG00000138834.8,1706195,16-1524029-G-C,rs2076437,1,G,C,1524029,182166,1509587,1902803,14442
16,ENSG00000162069.10,3036944,16-3028543-T-G,rs2079244,-1,T,G,3028543,8401,2840336,3233552,188207
16,ENSG00000118557.11,72172155,16-72322213-G-C,rs2161659,-1,G,C,72322213,150058,71975547,72368763,346666
16,ENSG00000153815.9,81444808,16-81366572-A-T,rs2161728,1,A,T,81366572,78236,81248200,81641416,118372
16,ENSG00000153815.9,81444808,16-81366572-A-G,rs2161728,1,A,G,81366572,78236,81248200,81641416,118372
16,ENSG00000166548.10,66550122,16-66565870-T-G,rs2232728,-1,T,G,66565870,15748,66353514,66746730,212356
16,ENSG00000166548.10,66550122,16-66565870-T-C,rs2232728,-1,T,C,66565870,15748,66353514,66746730,212356
16,ENSG00000100726.9,1493360,16-1524251-A-G,rs2235639,1,A,G,1524251,30891,1296752,1689968,227499
16,ENSG00000100726.9,1493360,16-1524251-A-T,rs2235639,1,A,T,1524251,30891,1296752,1689968,227499
16,ENSG00000085644.9,3135029,16-3144829-A-G,rs2238381,1,A,G,3144829,9800,2938421,3331637,206408
16,ENSG00000005339.7,3880713,16-3863994-A-G,rs2239316,-1,A,G,3863994,16719,3684105,4077321,179889
16,ENSG00000187741.9,89816647,16-89783175-C-T,rs2239360,-1,C,T,89783175,33472,89620039,90013255,163136
16,ENSG00000187741.9,89816647,16-89783175-C-G,rs2239360,-1,C,G,89783175,33472,89620039,90013255,163136
16,ENSG00000010539.7,3235158,16-3251360-A-C,rs224215,-1,A,C,3251360,16202,3038550,3431766,212810
16,ENSG00000010539.7,3235158,16-3251360-A-G,rs224215,-1,A,G,3251360,16202,3038550,3431766,212810
16,ENSG00000065054.8,2026902,16-1947613-A-T,rs2252523,1,A,T,1947613,79289,1830294,2223510,117319
16,ENSG00000065054.8,2026902,16-1947613-A-C,rs2252523,1,A,C,1947613,79289,1830294,2223510,117319
16,ENSG00000065054.8,2026902,16-1947613-A-G,rs2252523,1,A,G,1947613,79289,1830294,2223510,117319
16,ENSG00000154099.12,84145308,16-84180359-G-A,rs2278043,1,G,A,84180359,35051,83948700,84341916,231659
16,ENSG00000103168.12,84187057,16-84180359-G-A,rs2278043,-1,G,A,84180359,6698,83990449,84383665,189910
16,ENSG00000104731.9,87765986,16-87708056-C-T,rs2290019,-1,C,T,87708056,57930,87569378,87962594,138678
16,ENSG00000104731.9,87765986,16-87708056-C-A,rs2290019,-1,C,A,87708056,57930,87569378,87962594,138678
16,ENSG00000103528.12,19168240,16-19211391-T-G,rs229018,1,T,G,19211391,43151,18971632,19364848,239759
16,ENSG00000183723.7,66696743,16-66580105-T-C,rs2290182,-1,T,C,66580105,116638,66500135,66893351,79970
16,ENSG00000127586.11,788620,16-797743-C-T,rs2294451,1,C,T,797743,9123,592012,985228,205731
16,ENSG00000131634.9,1533666,16-1536254-G-A,rs2294624,1,G,A,1536254,2588,1337058,1730274,199196
16,ENSG00000135698.5,82170224,16-82164278-G-A,rs2303266,-1,G,A,82164278,5946,81973616,82366832,190662
16,ENSG00000217555.6,66552576,16-66588308-A-G,rs2305312,1,A,G,66588308,35732,66355968,66749184,232340
16,ENSG00000103021.5,58249936,16-58222005-C-A,rs2432555,1,C,A,58222005,27931,58053328,58446544,168677
16,ENSG00000103021.5,58249936,16-58222005-C-G,rs2432555,1,C,G,58222005,27931,58053328,58446544,168677
16,ENSG00000103034.10,58500143,16-58499805-G-T,rs2432560,1,G,T,58499805,338,58303535,58696751,196270
16,ENSG00000103034.10,58500143,16-58499805-G-A,rs2432560,1,G,A,58499805,338,58303535,58696751,196270
16,ENSG00000166848.4,75647773,16-75452750-A-G,rs247447,1,A,G,75452750,195023,75451165,75844381,1585
16,ENSG00000063854.7,1826825,16-1852104-A-G,rs2492883,-1,A,G,1852104,25279,1630217,2023433,221887
16,ENSG00000213853.5,10580598,16-10654836-G-C,rs2541556,-1,G,C,10654836,74238,10383990,10777206,270846
16,ENSG00000213853.5,10580598,16-10654836-G-A,rs2541556,-1,G,A,10654836,74238,10383990,10777206,270846
16,ENSG00000213853.5,10580598,16-10654836-G-T,rs2541556,-1,G,T,10654836,74238,10383990,10777206,270846
16,ENSG00000161980.5,53608,16-53423-C-A,rs2541593,-1,C,A,53423,185,-143000,250216,196423
16,ENSG00000161980.5,53608,16-53423-C-G,rs2541593,-1,C,G,53423,185,-143000,250216,196423
16,ENSG00000103023.7,58295025,16-58222432-A-G,rs2550379,-1,A,G,58222432,72593,58098417,58491633,124015
16,ENSG00000103023.7,58295025,16-58222432-A-T,rs2550379,-1,A,T,58222432,72593,58098417,58491633,124015
16,ENSG00000103023.7,58295025,16-58222432-A-C,rs2550379,-1,A,C,58222432,72593,58098417,58491633,124015
16,ENSG00000103148.9,138673,16-126744-A-G,rs2562164,-1,A,G,126744,11929,-57935,335281,184679
16,ENSG00000074071.8,1773134,16-1769432-G-A,rs2575329,-1,G,A,1769432,3702,1576526,1969742,192906
16,ENSG00000122386.6,3112586,16-3100895-C-T,rs2717695,1,C,T,3100895,11691,2915978,3309194,184917
16,ENSG00000122386.6,3112586,16-3100895-C-A,rs2717695,1,C,A,3100895,11691,2915978,3309194,184917
16,ENSG00000153060.3,10694930,16-10670588-C-T,rs2719695,-1,C,T,10670588,24342,10498322,10891538,172266
16,ENSG00000167981.4,3443504,16-3444207-A-T,rs27242,-1,A,T,3444207,703,3246896,3640112,197311
16,ENSG00000103187.5,84618078,16-84580748-G-A,rs28557336,-1,G,A,84580748,37330,84421470,84814686,159278
16,ENSG00000103187.5,84618078,16-84580748-G-T,rs28557336,-1,G,T,84580748,37330,84421470,84814686,159278
16,ENSG00000159579.8,57186329,16-57046616-C-A,rs289723,1,C,A,57046616,139713,56989721,57382937,56895
16,ENSG00000167978.10,2752638,16-2764161-G-A,rs3094775,1,G,A,2764161,11523,2556030,2949246,208131
16,ENSG00000167978.10,2752638,16-2764161-G-T,rs3094775,1,G,T,2764161,11523,2556030,2949246,208131
16,ENSG00000188536.7,172876,16-78055-G-A,rs3176373,1,G,A,78055,94821,-23732,369484,101787
16,ENSG00000188536.7,172876,16-78055-G-C,rs3176373,1,G,C,78055,94821,-23732,369484,101787
16,ENSG00000206172.4,176680,16-78055-G-A,rs3176373,1,G,A,78055,98625,-19928,373288,97983
16,ENSG00000206172.4,176680,16-78055-G-C,rs3176373,1,G,C,78055,98625,-19928,373288,97983
16,ENSG00000179889.14,14975026,16-15036083-C-T,rs3198697,1,C,T,15036083,61057,14778418,15171634,257665
16,ENSG00000179889.14,14975026,16-15036083-C-A,rs3198697,1,C,A,15036083,61057,14778418,15171634,257665
16,ENSG00000103037.6,58515517,16-58519873-G-T,rs3200575,1,G,T,58519873,4356,58318909,58712125,200964
16,ENSG00000103037.6,58515517,16-58519873-G-A,rs3200575,1,G,A,58519873,4356,58318909,58712125,200964
16,ENSG00000197599.8,1444556,16-1488559-G-A,rs34993742,-1,G,A,1488559,44003,1247948,1641164,240611
16,ENSG00000118898.9,4937148,16-4870334-A-G,rs35103368,-1,A,G,4870334,66814,4740540,5133756,129794
16,ENSG00000118898.9,4937148,16-4870334-A-T,rs35103368,-1,A,T,4870334,66814,4740540,5133756,129794
16,ENSG00000166847.5,23641466,16-23682449-T-G,rs35635,1,T,G,23682449,40983,23444858,23838074,237591
16,ENSG00000185905.3,29745990,16-29844761-G-A,rs35916172,-1,G,A,29844761,98771,29549382,29942598,295379
16,ENSG00000172824.9,66988594,16-66801488-G-A,rs363199,1,G,A,66801488,187106,66791986,67185202,9502
16,ENSG00000103066.8,68245373,16-68231336-G-A,rs3743738,1,G,A,68231336,14037,68048765,68441981,182571
16,ENSG00000205078.5,77199408,16-77194068-G-T,rs3743763,1,G,T,77194068,5340,77002800,77396016,191268
16,ENSG00000205078.5,77199408,16-77194068-G-A,rs3743763,1,G,A,77194068,5340,77002800,77396016,191268
16,ENSG00000205078.5,77199408,16-77194068-G-C,rs3743763,1,G,C,77194068,5340,77002800,77396016,191268
16,ENSG00000167969.7,2251587,16-2246850-A-G,rs3803695,-1,A,G,2246850,4737,2054979,2448195,191871
16,ENSG00000149922.6,30091924,16-30091839-C-G,rs3809627,-1,C,G,30091839,85,29895316,30288532,196523
16,ENSG00000149922.6,30091924,16-30091839-C-A,rs3809627,-1,C,A,30091839,85,29895316,30288532,196523
16,ENSG00000132613.9,70686053,16-70709122-C-T,rs3813909,-1,C,T,70709122,23069,70489445,70882661,219677
16,ENSG00000103550.9,19718227,16-19711044-T-C,rs3829539,-1,T,C,19711044,7183,19521619,19914835,189425
16,ENSG00000129925.5,381978,16-310303-T-C,rs3842949,-1,T,C,310303,71675,185370,578586,124933
16,ENSG00000129925.5,381978,16-310303-T-G,rs3842949,-1,T,G,310303,71675,185370,578586,124933
16,ENSG00000129925.5,381978,16-310303-T-A,rs3842949,-1,T,A,310303,71675,185370,578586,124933
16,ENSG00000180185.7,1826941,16-1840055-T-G,rs3848348,1,T,G,1840055,13114,1630333,2023549,209722
16,ENSG00000062038.8,68645310,16-68460666-T-C,rs3909544,1,T,C,68460666,184644,68448702,68841918,11964
16,ENSG00000103342.8,11915956,16-11864525-A-G,rs407719,-1,A,G,11864525,51431,11719348,12112564,145177
16,ENSG00000065457.5,75623281,16-75540831-A-G,rs4149501,-1,A,G,75540831,82450,75426673,75819889,114158
16,ENSG00000103126.10,352723,16-325198-C-T,rs426884,-1,C,T,325198,27525,156115,549331,169083
16,ENSG00000188897.3,11527245,16-11495905-A-G,rs4520857,-1,A,G,11495905,31340,11330637,11723853,165268
16,ENSG00000188897.3,11527245,16-11495905-A-C,rs4520857,-1,A,C,11495905,31340,11330637,11723853,165268
16,ENSG00000181938.9,58392471,16-58404793-T-C,rs45439399,1,T,C,58404793,12322,58195863,58589079,208930
16,ENSG00000178773.10,89575758,16-89577593-T-C,rs455527,1,T,C,89577593,1835,89379150,89772366,198443
16,ENSG00000141013.10,90022680,16-89981987-C-T,rs45610233,1,C,T,89981987,40693,89826072,90219288,155915
16,ENSG00000169246.11,21405319,16-21601241-G-A,rs474843,-1,G,A,21601241,195922,21208711,21601927,392530
16,ENSG00000158545.10,88570403,16-88628968-A-C,rs4782307,1,A,C,88628968,58565,88373795,88767011,255173
16,ENSG00000158545.10,88570403,16-88628968-A-G,rs4782307,1,A,G,88628968,58565,88373795,88767011,255173
16,ENSG00000125124.6,56520024,16-56509230-G-A,rs4783943,-1,G,A,56509230,10794,56323416,56716632,185814
16,ENSG00000205832.6,4556340,16-4486933-T-A,rs4785969,1,T,A,4486933,69407,4359732,4752948,127201
16,ENSG00000205832.6,4556340,16-4486933-T-C,rs4785969,1,T,C,4486933,69407,4359732,4752948,127201
16,ENSG00000205832.6,4556340,16-4486933-T-G,rs4785969,1,T,G,4486933,69407,4359732,4752948,127201
16,ENSG00000162062.10,2460109,16-2460602-C-T,rs4786284,1,C,T,2460602,493,2263501,2656717,197101
16,ENSG00000008517.12,3065640,16-3075150-C-G,rs4786376,1,C,G,3075150,9510,2869032,3262248,206118
16,ENSG00000089486.10,4538773,16-4475264-C-A,rs4786500,-1,C,A,4475264,63509,4342165,4735381,133099
16,ENSG00000089486.10,4538773,16-4475264-C-T,rs4786500,-1,C,T,4475264,63509,4342165,4735381,133099
16,ENSG00000178188.10,28863843,16-28983824-C-T,rs4788114,1,C,T,28983824,119981,28667235,29060451,316589
16,ENSG00000140832.5,71626184,16-71600701-A-T,rs4788814,1,A,T,71600701,25483,71429576,71822792,171125
16,ENSG00000140832.5,71626184,16-71600701-A-C,rs4788814,1,A,C,71600701,25483,71429576,71822792,171125
16,ENSG00000140832.5,71626184,16-71600701-A-G,rs4788814,1,A,G,71600701,25483,71429576,71822792,171125
16,ENSG00000129993.10,88977207,16-88912442-C-T,rs555191,-1,C,T,88912442,64765,88780599,89173815,131843
16,ENSG00000167515.6,88857127,16-88731518-A-G,rs55924855,1,A,G,88731518,125609,88660519,89053735,70999
16,ENSG00000223496.1,70251940,16-70428037-G-A,rs57804197,-1,G,A,70428037,176097,70055332,70448548,372705
16,ENSG00000103199.8,4767162,16-4766101-T-A,rs58729822,-1,T,A,4766101,1061,4570554,4963770,195547
16,ENSG00000103199.8,4767162,16-4766101-T-C,rs58729822,-1,T,C,4766101,1061,4570554,4963770,195547
16,ENSG00000125170.6,57486493,16-57487362-T-C,rs604965,-1,T,C,57487362,869,57289885,57683101,197477
16,ENSG00000135740.11,67248979,16-67180047-G-A,rs61733768,1,G,A,67180047,68932,67052371,67445587,127676
16,ENSG00000205937.6,2268126,16-2395338-T-C,rs62040695,-1,T,C,2395338,127212,2071518,2464734,323820
16,ENSG00000184860.4,82011470,16-82011637-C-A,rs62046301,-1,C,A,82011637,167,81814862,82208078,196775
16,ENSG00000184860.4,82011470,16-82011637-C-T,rs62046301,-1,C,T,82011637,167,81814862,82208078,196775
16,ENSG00000184860.4,82011470,16-82011637-C-G,rs62046301,-1,C,G,82011637,167,81814862,82208078,196775
16,ENSG00000135709.8,85027795,16-85028924-G-C,rs62048414,1,G,C,85028924,1129,84831187,85224403,197737
16,ENSG00000135709.8,85027795,16-85028924-G-A,rs62048414,1,G,A,85028924,1129,84831187,85224403,197737
16,ENSG00000130731.11,636305,16-625067-C-A,rs62623587,-1,C,A,625067,11238,439697,832913,185370
16,ENSG00000167191.6,19884848,16-19864823-C-G,rs6497416,-1,C,G,19864823,20025,19688240,20081456,176583
16,ENSG00000167191.6,19884848,16-19864823-C-T,rs6497416,-1,C,T,19864823,20025,19688240,20081456,176583
16,ENSG00000174628.12,19718280,16-19864823-C-G,rs6497416,1,C,G,19864823,146543,19521672,19914888,343151
16,ENSG00000174628.12,19718280,16-19864823-C-T,rs6497416,1,C,T,19864823,146543,19521672,19914888,343151
16,ENSG00000103365.10,23510494,16-23525363-T-C,rs6497671,-1,T,C,23525363,14869,23313886,23707102,211477
16,ENSG00000103365.10,23510494,16-23525363-T-A,rs6497671,-1,T,A,23525363,14869,23313886,23707102,211477
16,ENSG00000182108.5,10942468,16-10941076-A-T,rs6498135,-1,A,T,10941076,1392,10745860,11139076,195216
16,ENSG00000182108.5,10942468,16-10941076-A-G,rs6498135,-1,A,G,10941076,1392,10745860,11139076,195216
16,ENSG00000040199.13,71724701,16-71697582-T-C,rs6499531,-1,T,C,71697582,27119,71528093,71921309,169489
16,ENSG00000040199.13,71724701,16-71697582-T-G,rs6499531,-1,T,G,71697582,27119,71528093,71921309,169489
16,ENSG00000185716.7,22008111,16-21828019-A-G,rs670841,1,A,G,21828019,180092,21811503,22204719,16516
16,ENSG00000185716.7,22008111,16-21828019-A-C,rs670841,1,A,C,21828019,180092,21811503,22204719,16516
16,ENSG00000127578.6,630985,16-734507-C-T,rs67935101,1,C,T,734507,103522,434377,827593,300130
16,ENSG00000064270.7,84368538,16-84464318-C-G,rs707225,1,C,G,84464318,95780,84171930,84565146,292388
16,ENSG00000064270.7,84368538,16-84464318-C-T,rs707225,1,C,T,84464318,95780,84171930,84565146,292388
16,ENSG00000169627.7,30193666,16-30369551-C-G,rs71389465,-1,C,G,30369551,175885,29997058,30390274,372493
16,ENSG00000169627.7,30193666,16-30369551-C-T,rs71389465,-1,C,T,30369551,175885,29997058,30390274,372493
16,ENSG00000185338.4,11256204,16-11076904-C-G,rs7184491,-1,C,G,11076904,179300,11059596,11452812,17308
16,ENSG00000185338.4,11256204,16-11076904-C-T,rs7184491,-1,C,T,11076904,179300,11059596,11452812,17308
16,ENSG00000140876.7,77722514,16-77718311-C-A,rs7184635,1,C,A,77718311,4203,77525906,77919122,192405
16,ENSG00000140876.7,77722514,16-77718311-C-T,rs7184635,1,C,T,77718311,4203,77525906,77919122,192405
16,ENSG00000176715.11,89093852,16-89100686-T-C,rs7188200,1,T,C,89100686,6834,88897244,89290460,203442
16,ENSG00000140839.6,74421478,16-74506199-C-A,rs7189123,-1,C,A,74506199,84721,74224870,74618086,281329
16,ENSG00000140839.6,74421478,16-74506199-C-T,rs7189123,-1,C,T,74506199,84721,74224870,74618086,281329
16,ENSG00000169896.11,31259975,16-31290157-G-C,rs7190018,1,G,C,31290157,30182,31063367,31456583,226790
16,ENSG00000169896.11,31259975,16-31290157-G-A,rs7190018,1,G,A,31290157,30182,31063367,31456583,226790
16,ENSG00000132600.11,68311019,16-68347613-G-A,rs7190134,1,G,A,68347613,36594,68114411,68507627,233202
16,ENSG00000184697.5,3018183,16-2824495-C-T,rs7190558,-1,C,T,2824495,193688,2821575,3214791,2920
16,ENSG00000168411.8,74666877,16-74664845-G-C,rs7191863,-1,G,C,74664845,2032,74470269,74863485,194576
16,ENSG00000011638.6,21158674,16-21172956-A-C,rs7192830,1,A,C,21172956,14282,20962066,21355282,210890
16,ENSG00000011638.6,21158674,16-21172956-A-G,rs7192830,1,A,G,21172956,14282,20962066,21355282,210890
16,ENSG00000011638.6,21158674,16-21172956-A-T,rs7192830,1,A,T,21172956,14282,20962066,21355282,210890
16,ENSG00000197943.5,81779291,16-81831772-G-C,rs7193093,1,G,C,81831772,52481,81582683,81975899,249089
16,ENSG00000153066.7,11742857,16-11676921-A-G,rs7194034,-1,A,G,11676921,65936,11546249,11939465,130672
16,ENSG00000204991.6,89828475,16-89769915-C-A,rs7195066,1,C,A,89769915,58560,89631867,90025083,138048
16,ENSG00000204991.6,89828475,16-89769915-C-T,rs7195066,1,C,T,89769915,58560,89631867,90025083,138048
16,ENSG00000103496.10,31033558,16-31080754-G-A,rs7196726,1,G,A,31080754,47196,30836950,31230166,243804
16,ENSG00000169715.10,56625781,16-56637108-C-A,rs7196890,1,C,A,56637108,11327,56429173,56822389,207935
16,ENSG00000169715.10,56625781,16-56637108-C-G,rs7196890,1,C,G,56637108,11327,56429173,56822389,207935
16,ENSG00000167397.10,31094797,16-30936251-A-G,rs7200879,-1,A,G,30936251,158546,30898189,31291405,38062
16,ENSG00000172828.8,66961266,16-66924068-T-C,rs7203638,1,T,C,66924068,37198,66764658,67157874,159410
16,ENSG00000175643.7,11345459,16-11350715-A-C,rs7204628,1,A,C,11350715,5256,11148851,11542067,201864
16,ENSG00000175643.7,11345459,16-11350715-A-G,rs7204628,1,A,G,11350715,5256,11148851,11542067,201864
16,ENSG00000175643.7,11345459,16-11350715-A-T,rs7204628,1,A,T,11350715,5256,11148851,11542067,201864
16,ENSG00000185947.9,31873807,16-31862552-T-C,rs7205943,1,T,C,31862552,11255,31677199,32070415,185353
16,ENSG00000196408.7,1981469,16-1989004-C-A,rs72766623,-1,C,A,1989004,7535,1784861,2178077,204143
16,ENSG00000196408.7,1981469,16-1989004-C-T,rs72766623,-1,C,T,1989004,7535,1784861,2178077,204143
16,ENSG00000007541.10,569968,16-670833-C-T,rs72773407,1,C,T,670833,100865,373360,766576,297473
16,ENSG00000007541.10,569968,16-670833-C-G,rs72773407,1,C,G,670833,100865,373360,766576,297473
16,ENSG00000156886.10,31393335,16-31408382-G-A,rs72789314,1,G,A,31408382,15047,31196727,31589943,211655
16,ENSG00000188603.12,28492074,16-28640411-C-T,rs72793807,-1,C,T,28640411,148337,28295466,28688682,344945
16,ENSG00000184730.6,28494643,16-28640411-C-T,rs72793807,1,C,T,28640411,145768,28298035,28691251,342376
16,ENSG00000067836.7,4802633,16-4980780-G-A,rs73510408,-1,G,A,4980780,178147,4606025,4999241,374755
16,ENSG00000067836.7,4802633,16-4980780-G-C,rs73510408,-1,G,C,4980780,178147,4606025,4999241,374755
16,ENSG00000161981.6,53828,16-51277-G-T,rs74003635,1,G,T,51277,2551,-142780,250436,194057
16,ENSG00000161981.6,53828,16-51277-G-A,rs74003635,1,G,A,51277,2551,-142780,250436,194057
16,ENSG00000103253.12,727106,16-752234-A-C,rs7404049,1,A,C,752234,25128,530498,923714,221736
16,ENSG00000103253.12,727106,16-752234-A-G,rs7404049,1,A,G,752234,25128,530498,923714,221736
16,ENSG00000158717.6,88706408,16-88708513-C-T,rs7404845,-1,C,T,88708513,2105,88509800,88903016,198713
16,ENSG00000158717.6,88706408,16-88708513-C-G,rs7404845,-1,C,G,88708513,2105,88509800,88903016,198713
16,ENSG00000158717.6,88706408,16-88708513-C-A,rs7404845,-1,C,A,88708513,2105,88509800,88903016,198713
16,ENSG00000174177.8,88706503,16-88708513-C-T,rs7404845,1,C,T,88708513,2010,88509895,88903111,198618
16,ENSG00000174177.8,88706503,16-88708513-C-G,rs7404845,1,C,G,88708513,2010,88509895,88903111,198618
16,ENSG00000174177.8,88706503,16-88708513-C-A,rs7404845,1,C,A,88708513,2010,88509895,88903111,198618
16,ENSG00000197302.6,31713244,16-31679179-G-T,rs74398264,1,G,T,31679179,34065,31516636,31909852,162543
16,ENSG00000038532.9,10944564,16-10794552-G-C,rs74591482,1,G,C,10794552,150012,10747956,11141172,46596
16,ENSG00000189091.7,70523816,16-70438461-G-T,rs74658410,1,G,T,70438461,85355,70327208,70720424,111253
16,ENSG00000189091.7,70523816,16-70438461-G-A,rs74658410,1,G,A,70438461,85355,70327208,70720424,111253
16,ENSG00000006327.9,3020368,16-3020627-C-T,rs74758164,1,C,T,3020627,259,2823760,3216976,196867
16,ENSG00000006327.9,3020368,16-3020627-C-G,rs74758164,1,C,G,3020627,259,2823760,3216976,196867
16,ENSG00000167394.8,31074240,16-31113086-A-G,rs749767,-1,A,G,31113086,38846,30877632,31270848,235454
16,ENSG00000167394.8,31074240,16-31113086-A-T,rs749767,-1,A,T,31113086,38846,30877632,31270848,235454
16,ENSG00000167394.8,31074240,16-31113086-A-C,rs749767,-1,A,C,31113086,38846,30877632,31270848,235454
16,ENSG00000169682.13,28974778,16-28965699-G-A,rs7500321,1,G,A,28965699,9079,28778170,29171386,187529
16,ENSG00000169682.13,28974778,16-28965699-G-C,rs7500321,1,G,C,28965699,9079,28778170,29171386,187529
16,ENSG00000232258.2,8590511,16-8596737-A-T,rs7500465,-1,A,T,8596737,6226,8393903,8787119,202834
16,ENSG00000232258.2,8590511,16-8596737-A-C,rs7500465,-1,A,C,8596737,6226,8393903,8787119,202834
16,ENSG00000232258.2,8590511,16-8596737-A-G,rs7500465,-1,A,G,8596737,6226,8393903,8787119,202834
16,ENSG00000177238.9,31214119,16-31082768-T-C,rs750953,1,T,C,31082768,131351,31017511,31410727,65257
16,ENSG00000140848.12,57092583,16-57084469-T-C,rs75257814,1,T,C,57084469,8114,56895975,57289191,188494
16,ENSG00000167371.12,29812193,16-29887802-G-T,rs75331747,1,G,T,29887802,75609,29615585,30008801,272217
16,ENSG00000149927.13,30011027,16-29887802-G-T,rs75331747,-1,G,T,29887802,123225,29814419,30207635,73383
16,ENSG00000079616.8,29790751,16-29887802-G-T,rs75331747,1,G,T,29887802,97051,29594143,29987359,293659
16,ENSG00000149930.13,29973868,16-29887802-G-T,rs75331747,1,G,T,29887802,86066,29777260,30170476,110542
16,ENSG00000103356.10,23557350,16-23400238-T-C,rs75969326,-1,T,C,23400238,157112,23360742,23753958,39496
16,ENSG00000140937.8,65122063,16-64982262-C-T,rs76181686,-1,C,T,64982262,139801,64925455,65318671,56807
16,ENSG00000140937.8,65122063,16-64982262-C-G,rs76181686,-1,C,G,64982262,139801,64925455,65318671,56807
16,ENSG00000140937.8,65122063,16-64982262-C-A,rs76181686,-1,C,A,64982262,139801,64925455,65318671,56807
16,ENSG00000186260.11,14071319,16-14125980-C-A,rs762767,1,C,A,14125980,54661,13874711,14267927,251269
16,ENSG00000186260.11,14071319,16-14125980-C-T,rs762767,1,C,T,14125980,54661,13874711,14267927,251269
16,ENSG00000103202.7,397199,16-399345-G-C,rs763151,1,G,C,399345,2146,200591,593807,198754
16,ENSG00000008516.11,3046561,16-3065324-G-C,rs76580947,1,G,C,3065324,18763,2849953,3243169,215371
16,ENSG00000008516.11,3046561,16-3065324-G-T,rs76580947,1,G,T,3065324,18763,2849953,3243169,215371
16,ENSG00000153406.9,4474625,16-4473388-T-C,rs77430528,-1,T,C,4473388,1237,4278017,4671233,195371
16,ENSG00000007520.3,1351878,16-1338908-C-G,rs77633104,-1,C,G,1338908,12970,1155270,1548486,183638
16,ENSG00000007520.3,1351878,16-1338908-C-A,rs77633104,-1,C,A,1338908,12970,1155270,1548486,183638
16,ENSG00000007520.3,1351878,16-1338908-C-T,rs77633104,-1,C,T,1338908,12970,1155270,1548486,183638
16,ENSG00000103335.14,88785220,16-88698766-T-G,rs78069475,-1,T,G,88698766,86454,88588612,88981828,110154
16,ENSG00000149929.10,29995617,16-30179570-G-A,rs79623117,-1,G,A,30179570,183953,29799009,30192225,380561
16,ENSG00000149925.12,30065760,16-30179570-G-A,rs79623117,1,G,A,30179570,113810,29869152,30262368,310418
16,ENSG00000131650.9,2964275,16-2858702-C-T,rs8046218,1,C,T,2858702,105573,2767667,3160883,91035
16,ENSG00000169955.6,30534858,16-30697737-T-C,rs8046436,-1,T,C,30697737,162879,30338250,30731466,359487
16,ENSG00000103248.12,86555235,16-86547585-G-A,rs8047645,-1,G,A,86547585,7650,86358627,86751843,188958
16,ENSG00000102935.7,49856112,16-49676179-A-C,rs8048188,-1,A,C,49676179,179933,49659504,50052720,16675
16,ENSG00000102935.7,49856112,16-49676179-A-G,rs8048188,-1,A,G,49676179,179933,49659504,50052720,16675
16,ENSG00000102935.7,49856112,16-49676179-A-T,rs8048188,-1,A,T,49676179,179933,49659504,50052720,16675
16,ENSG00000157322.11,69951334,16-69934298-G-A,rs8048678,1,G,A,69934298,17036,69754726,70147942,179572
16,ENSG00000157322.11,69951334,16-69934298-G-C,rs8048678,1,G,C,69934298,17036,69754726,70147942,179572
16,ENSG00000103479.9,53434471,16-53479143-T-C,rs8049033,1,T,C,53479143,44672,53237863,53631079,241280
16,ENSG00000140678.12,31355176,16-31393250-T-C,rs8050500,1,T,C,31393250,38074,31158568,31551784,234682
16,ENSG00000140678.12,31355176,16-31393250-T-A,rs8050500,1,T,A,31393250,38074,31158568,31551784,234682
16,ENSG00000140678.12,31355176,16-31393250-T-G,rs8050500,1,T,G,31393250,38074,31158568,31551784,234682
16,ENSG00000159625.10,57694806,16-57688040-T-C,rs8051301,1,T,C,57688040,6766,57498198,57891414,189842
16,ENSG00000196470.7,48385413,16-48356601-G-T,rs8053839,-1,G,T,48356601,28812,48188805,48582021,167796
16,ENSG00000196470.7,48385413,16-48356601-G-A,rs8053839,-1,G,A,48356601,28812,48188805,48582021,167796
16,ENSG00000196470.7,48385413,16-48356601-G-C,rs8053839,-1,G,C,48356601,28812,48188805,48582021,167796
16,ENSG00000140830.4,72093620,16-71981507-T-C,rs8056712,-1,T,C,71981507,112113,71897012,72290228,84495
16,ENSG00000140830.4,72093620,16-71981507-T-A,rs8056712,-1,T,A,71981507,112113,71897012,72290228,84495
16,ENSG00000140986.7,1954689,16-2051590-T-C,rs8059880,-1,T,C,2051590,96901,1758081,2151297,293509
16,ENSG00000140986.7,1954689,16-2051590-T-G,rs8059880,-1,T,G,2051590,96901,1758081,2151297,293509
16,ENSG00000003249.8,90019456,16-90013126-A-T,rs8059973,-1,A,T,90013126,6330,89822848,90216064,190278
16,ENSG00000003249.8,90019456,16-90013126-A-G,rs8059973,-1,A,G,90013126,6330,89822848,90216064,190278
16,ENSG00000102871.11,67159909,16-67157812-A-G,rs8060496,-1,A,G,67157812,2097,66963301,67356517,194511
16,ENSG00000051108.10,56932142,16-56896339-T-C,rs8063291,1,T,C,56896339,35803,56735534,57128750,160805
16,ENSG00000168096.9,4734271,16-4699717-A-G,rs841213,-1,A,G,4699717,34554,4537663,4930879,162054
16,ENSG00000168096.9,4734271,16-4699717-A-T,rs841213,-1,A,T,4699717,34554,4537663,4930879,162054
16,ENSG00000168096.9,4734271,16-4699717-A-C,rs841213,-1,A,C,4699717,34554,4537663,4930879,162054
16,ENSG00000102858.7,4624826,16-4691635-T-G,rs841219,1,T,G,4691635,66809,4428218,4821434,263417
16,ENSG00000102858.7,4624826,16-4691635-T-C,rs841219,1,T,C,4691635,66809,4428218,4821434,263417
16,ENSG00000102858.7,4624826,16-4691635-T-A,rs841219,1,T,A,4691635,66809,4428218,4821434,263417
16,ENSG00000159461.9,56425545,16-56320167-G-C,rs899234,-1,G,C,56320167,105378,56228937,56622153,91230
16,ENSG00000159461.9,56425545,16-56320167-G-T,rs899234,-1,G,T,56320167,105378,56228937,56622153,91230
16,ENSG00000159461.9,56425545,16-56320167-G-A,rs899234,-1,G,A,56320167,105378,56228937,56622153,91230
16,ENSG00000159593.9,66830976,16-66739397-A-G,rs9921803,-1,A,G,66739397,91579,66634368,67027584,105029
16,ENSG00000135736.5,57536571,16-57714933-T-C,rs9922246,-1,T,C,57714933,178362,57339963,57733179,374970
16,ENSG00000099365.5,31010638,16-31002858-C-A,rs9926533,-1,C,A,31002858,7780,30814030,31207246,188828
16,ENSG00000099365.5,31010638,16-31002858-C-G,rs9926533,-1,C,G,31002858,7780,30814030,31207246,188828
16,ENSG00000099365.5,31010638,16-31002858-C-T,rs9926533,-1,C,T,31002858,7780,30814030,31207246,188828
16,ENSG00000140941.7,87392336,16-87438267-T-C,rs9927125,1,T,C,87438267,45931,87195728,87588944,242539
16,ENSG00000188215.4,20900358,16-20773171-A-C,rs9927521,-1,A,C,20773171,127187,20703750,21096966,69421
16,ENSG00000188215.4,20900358,16-20773171-A-G,rs9927521,-1,A,G,20773171,127187,20703750,21096966,69421
16,ENSG00000059122.12,2911931,16-2942113-T-A,rs9930148,1,T,A,2942113,30182,2715323,3108539,226790
16,ENSG00000059122.12,2911931,16-2942113-T-C,rs9930148,1,T,C,2942113,30182,2715323,3108539,226790
16,ENSG00000087237.6,56961950,16-56973280-T-C,rs9930761,1,T,C,56973280,11330,56765342,57158558,207938
16,ENSG00000103150.4,83899115,16-83934710-A-G,rs9931455,1,A,G,83934710,35595,83702507,84095723,232203
16,ENSG00000167508.5,88663091,16-88651945-C-T,rs9932581,-1,C,T,88651945,11146,88466483,88859699,185462
16,ENSG00000103174.6,5033935,16-5035335-T-A,rs9937510,-1,T,A,5035335,1400,4837327,5230543,198008
16,ENSG00000103174.6,5033935,16-5035335-T-C,rs9937510,-1,T,C,5035335,1400,4837327,5230543,198008
16,ENSG00000102904.10,67806889,16-67999927-C-T,rs9938884,1,C,T,67999927,193038,67610281,68003497,389646
16,ENSG00000085644.9,3135029,16-3180471-G-A,rs1002965,1,G,A,3180471,45442,2938421,3331637,242050
16,ENSG00000085644.9,3135029,16-3180471-G-C,rs1002965,1,G,C,3180471,45442,2938421,3331637,242050
16,ENSG00000103510.14,31117664,16-31122128-C-T,rs1060506,1,C,T,31122128,4464,30921056,31314272,201072
16,ENSG00000140859.10,57802491,16-57767438-A-G,rs10852557,-1,A,G,57767438,35053,57605883,57999099,161555
16,ENSG00000140859.10,57802491,16-57767438-A-C,rs10852557,-1,A,C,57767438,35053,57605883,57999099,161555
16,ENSG00000140859.10,57802491,16-57767438-A-T,rs10852557,-1,A,T,57767438,35053,57605883,57999099,161555
16,ENSG00000141002.11,89873592,16-90013519-C-T,rs10852628,1,C,T,90013519,139927,89676984,90070200,336535
16,ENSG00000141002.11,89873592,16-90013519-C-A,rs10852628,1,C,A,90013519,139927,89676984,90070200,336535
16,ENSG00000132613.9,70686053,16-70529368-A-G,rs11075766,-1,A,G,70529368,156685,70489445,70882661,39923
16,ENSG00000181938.9,58392471,16-58261988-T-G,rs11076234,1,T,G,58261988,130483,58195863,58589079,66125
16,ENSG00000181938.9,58392471,16-58261988-T-C,rs11076234,1,T,C,58261988,130483,58195863,58589079,66125
16,ENSG00000196470.7,48385413,16-48346421-A-G,rs11076565,-1,A,G,48346421,38992,48188805,48582021,157616
16,ENSG00000185669.5,88686507,16-88673580-G-C,rs11076696,-1,G,C,88673580,12927,88489899,88883115,183681
16,ENSG00000185669.5,88686507,16-88673580-G-T,rs11076696,-1,G,T,88673580,12927,88489899,88883115,183681
16,ENSG00000166847.5,23641466,16-23675835-A-G,rs11188,1,A,G,23675835,34369,23444858,23838074,230977
16,ENSG00000162004.10,726443,16-538512-C-A,rs112669437,-1,C,A,538512,187931,529835,923051,8677
16,ENSG00000161999.6,684334,16-538512-C-A,rs112669437,-1,C,A,538512,145822,487726,880942,50786
16,ENSG00000259803.1,89200537,16-89156343-C-T,rs112924269,-1,C,T,89156343,44194,89003929,89397145,152414
16,ENSG00000259803.1,89200537,16-89156343-C-G,rs112924269,-1,C,G,89156343,44194,89003929,89397145,152414
16,ENSG00000157315.4,69351786,16-69500500-G-A,rs115410815,-1,G,A,69500500,148714,69155178,69548394,345322
16,ENSG00000103067.7,68236127,16-68304045-T-C,rs11548855,-1,T,C,68304045,67918,68039519,68432735,264526
16,ENSG00000140832.5,71626184,16-71721949-T-C,rs11639902,1,T,C,71721949,95765,71429576,71822792,292373
16,ENSG00000125148.6,56608584,16-56610353-G-A,rs11642055,1,G,A,56610353,1769,56411976,56805192,198377
16,ENSG00000125148.6,56608584,16-56610353-G-T,rs11642055,1,G,T,56610353,1769,56411976,56805192,198377
16,ENSG00000166669.9,10386061,16-10243637-T-A,rs11642454,1,T,A,10243637,142424,10189453,10582669,54184
16,ENSG00000166669.9,10386061,16-10243637-T-C,rs11642454,1,T,C,10243637,142424,10189453,10582669,54184
16,ENSG00000140968.5,85899162,16-85969786-T-G,rs11642511,1,T,G,85969786,70624,85702554,86095770,267232
16,ENSG00000140968.5,85899162,16-85969786-T-C,rs11642511,1,T,C,85969786,70624,85702554,86095770,267232
16,ENSG00000167186.6,19067614,16-19132495-G-A,rs11643885,1,G,A,19132495,64881,18871006,19264222,261489
16,ENSG00000167186.6,19067614,16-19132495-G-T,rs11643885,1,G,T,19132495,64881,18871006,19264222,261489
16,ENSG00000169896.11,31259975,16-31348505-C-T,rs11645917,1,C,T,31348505,88530,31063367,31456583,285138
16,ENSG00000169896.11,31259975,16-31348505-C-G,rs11645917,1,C,G,31348505,88530,31063367,31456583,285138
16,ENSG00000167523.8,89657836,16-89791527-G-A,rs11646374,1,G,A,89791527,133691,89461228,89854444,330299
16,ENSG00000167508.5,88663091,16-88663242-T-C,rs11646758,-1,T,C,88663242,151,88466483,88859699,196759
16,ENSG00000170100.9,89217703,16-89065603-T-C,rs117098882,1,T,C,89065603,152100,89021095,89414311,44508
16,ENSG00000087263.11,56451554,16-56481051-C-A,rs117178556,1,C,A,56481051,29497,56254946,56648162,226105
16,ENSG00000087263.11,56451554,16-56481051-C-T,rs117178556,1,C,T,56481051,29497,56254946,56648162,226105
16,ENSG00000258839.1,89918862,16-89973761-C-A,rs117776146,1,C,A,89973761,54899,89722254,90115470,251507
16,ENSG00000258839.1,89918862,16-89973761-C-G,rs117776146,1,C,G,89973761,54899,89722254,90115470,251507
16,ENSG00000103496.10,31033558,16-30964808-T-A,rs117891062,1,T,A,30964808,68750,30836950,31230166,127858
16,ENSG00000005513.9,981770,16-988890-G-A,rs117976932,1,G,A,988890,7120,785162,1178378,203728
16,ENSG00000127586.11,788620,16-760921-C-T,rs118138240,1,C,T,760921,27699,592012,985228,168909
16,ENSG00000158717.6,88706408,16-88696098-A-C,rs11863597,-1,A,C,88696098,10310,88509800,88903016,186298
16,ENSG00000158717.6,88706408,16-88696098-A-T,rs11863597,-1,A,T,88696098,10310,88509800,88903016,186298
16,ENSG00000102886.10,30113537,16-30119172-C-T,rs11865086,-1,C,T,30119172,5635,29916929,30310145,202243
16,ENSG00000102886.10,30113537,16-30119172-C-A,rs11865086,-1,C,A,30119172,5635,29916929,30310145,202243
16,ENSG00000258947.1,89923342,16-89924749-G-A,rs11866243,1,G,A,89924749,1407,89726734,90119950,198015
16,ENSG00000103126.10,352723,16-427619-C-G,rs1204510,-1,C,G,427619,74896,156115,549331,271504
16,ENSG00000140632.11,4847288,16-4784377-A-C,rs12443659,-1,A,C,4784377,62911,4650680,5043896,133697
16,ENSG00000103056.7,68448508,16-68256297-G-T,rs12446418,-1,G,T,68256297,192211,68251900,68645116,4397
16,ENSG00000103056.7,68448508,16-68256297-G-A,rs12446418,-1,G,A,68256297,192211,68251900,68645116,4397
16,ENSG00000140848.12,57092583,16-57080103-A-C,rs12598418,1,A,C,57080103,12480,56895975,57289191,184128
16,ENSG00000140848.12,57092583,16-57080103-A-G,rs12598418,1,A,G,57080103,12480,56895975,57289191,184128
16,ENSG00000242612.1,401885,16-561635-G-T,rs12598643,1,G,T,561635,159750,205277,598493,356358
16,ENSG00000242612.1,401885,16-561635-G-A,rs12598643,1,G,A,561635,159750,205277,598493,356358
16,ENSG00000205078.5,77199408,16-77242918-A-C,rs12599800,1,A,C,77242918,43510,77002800,77396016,240118
16,ENSG00000205078.5,77199408,16-77242918-A-T,rs12599800,1,A,T,77242918,43510,77002800,77396016,240118
16,ENSG00000205078.5,77199408,16-77242918-A-G,rs12599800,1,A,G,77242918,43510,77002800,77396016,240118
16,ENSG00000154102.5,85751096,16-85813882-C-T,rs12919297,-1,C,T,85813882,62786,85554488,85947704,259394
16,ENSG00000154102.5,85751096,16-85813882-C-G,rs12919297,-1,C,G,85813882,62786,85554488,85947704,259394
16,ENSG00000149922.6,30091924,16-30007399-C-T,rs12921753,-1,C,T,30007399,84525,29895316,30288532,112083
16,ENSG00000174628.12,19718280,16-19586089-A-C,rs12929400,1,A,C,19586089,132191,19521672,19914888,64417
16,ENSG00000174628.12,19718280,16-19586089-A-G,rs12929400,1,A,G,19586089,132191,19521672,19914888,64417
16,ENSG00000162104.5,4116442,16-4037511-G-A,rs12933423,-1,G,A,4037511,78931,3919834,4313050,117677
16,ENSG00000102893.11,47461331,16-47650137-T-C,rs13332639,1,T,C,47650137,188806,47264723,47657939,385414
16,ENSG00000140995.12,89948755,16-89971188-G-A,rs13336336,1,G,A,89971188,22433,89752147,90145363,219041
16,ENSG00000167965.12,2205454,16-2075833-T-G,rs13337626,1,T,G,2075833,129621,2008846,2402062,66987
16,ENSG00000167965.12,2205454,16-2075833-T-C,rs13337626,1,T,C,2075833,129621,2008846,2402062,66987
16,ENSG00000070915.5,56865207,16-56816611-A-G,rs13338782,1,A,G,56816611,48596,56668599,57061815,148012
16,ENSG00000070915.5,56865207,16-56816611-A-T,rs13338782,1,A,T,56816611,48596,56668599,57061815,148012
16,ENSG00000103356.10,23557350,16-23524359-A-T,rs1468138,-1,A,T,23524359,32991,23360742,23753958,163617
16,ENSG00000103356.10,23557350,16-23524359-A-C,rs1468138,-1,A,C,23524359,32991,23360742,23753958,163617
16,ENSG00000103356.10,23557350,16-23524359-A-G,rs1468138,-1,A,G,23524359,32991,23360742,23753958,163617
16,ENSG00000167968.7,2236444,16-2242841-A-C,rs160554,1,A,C,2242841,6397,2039836,2433052,203005
16,ENSG00000166743.5,20697680,16-20640701-T-C,rs163234,-1,T,C,20640701,56979,20501072,20894288,139629
16,ENSG00000184939.8,68539291,16-68557447-A-G,rs1645929,1,A,G,68557447,18156,68342683,68735899,214764
16,ENSG00000205832.6,4556340,16-4621465-G-C,rs1684612,1,G,C,4621465,65125,4359732,4752948,261733
16,ENSG00000205832.6,4556340,16-4621465-G-A,rs1684612,1,G,A,4621465,65125,4359732,4752948,261733
16,ENSG00000103121.4,81006885,16-80976945-C-A,rs16954366,-1,C,A,80976945,29940,80810277,81203493,166668
16,ENSG00000103121.4,81006885,16-80976945-C-T,rs16954366,-1,C,T,80976945,29940,80810277,81203493,166668
16,ENSG00000103121.4,81006885,16-80976945-C-G,rs16954366,-1,C,G,80976945,29940,80810277,81203493,166668
16,ENSG00000159387.7,55324203,16-55345292-C-T,rs16954875,1,C,T,55345292,21089,55127595,55520811,217697
16,ENSG00000159387.7,55324203,16-55345292-C-A,rs16954875,1,C,A,55345292,21089,55127595,55520811,217697
16,ENSG00000125149.6,67109941,16-67065821-A-G,rs16957144,1,A,G,67065821,44120,66913333,67306549,152488
16,ENSG00000153406.9,4474625,16-4442717-T-G,rs17137037,-1,T,G,4442717,31908,4278017,4671233,164700
16,ENSG00000232258.2,8590511,16-8423676-A-G,rs17145828,-1,A,G,8423676,166835,8393903,8787119,29773
16,ENSG00000204991.6,89828475,16-89814436-A-G,rs17232120,1,A,G,89814436,14039,89631867,90025083,182569
16,ENSG00000172775.11,57186039,16-57149012-C-A,rs17372662,-1,C,A,57149012,37027,56989431,57382647,159581
16,ENSG00000172775.11,57186039,16-57149012-C-G,rs17372662,-1,C,G,57149012,37027,56989431,57382647,159581
16,ENSG00000103253.12,727106,16-778466-C-T,rs1737341,1,C,T,778466,51360,530498,923714,247968
16,ENSG00000063854.7,1826825,16-1922815-T-C,rs1742402,-1,T,C,1922815,95990,1630217,2023433,292598
16,ENSG00000063854.7,1826825,16-1922815-T-G,rs1742402,-1,T,G,1922815,95990,1630217,2023433,292598
16,ENSG00000182831.7,9091644,16-9093618-A-G,rs17567304,1,A,G,9093618,1974,8895036,9288252,198582
16,ENSG00000182831.7,9091644,16-9093618-A-C,rs17567304,1,A,C,9093618,1974,8895036,9288252,198582
16,ENSG00000059122.12,2911931,16-2935683-G-A,rs17603568,1,G,A,2935683,23752,2715323,3108539,220360
16,ENSG00000103091.10,74985123,16-74818414-T-G,rs17603966,-1,T,G,74818414,166709,74788515,75181731,29899
16,ENSG00000213853.5,10580598,16-10603165-C-T,rs17604279,-1,C,T,10603165,22567,10383990,10777206,219175
16,ENSG00000179965.7,30407606,16-30477606-C-T,rs17839542,1,C,T,30477606,70000,30210998,30604214,266608
16,ENSG00000198931.6,88811928,16-88809263-T-C,rs1799842,-1,T,C,88809263,2665,88615320,89008536,193943
16,ENSG00000198931.6,88811928,16-88809263-T-A,rs1799842,-1,T,A,88809263,2665,88615320,89008536,193943
16,ENSG00000157335.14,70173787,16-70102302-T-G,rs1808417,1,T,G,70102302,71485,69977179,70370395,125123
16,ENSG00000157335.14,70173787,16-70102302-T-C,rs1808417,1,T,C,70102302,71485,69977179,70370395,125123
16,ENSG00000125166.7,58734316,16-58724442-G-A,rs183757,-1,G,A,58724442,9874,58537708,58930924,186734
16,ENSG00000125166.7,58734316,16-58724442-G-C,rs183757,-1,G,C,58724442,9874,58537708,58930924,186734
16,ENSG00000135698.5,82170224,16-82244385-T-G,rs1844722,-1,T,G,82244385,74161,81973616,82366832,270769
16,ENSG00000135698.5,82170224,16-82244385-T-C,rs1844722,-1,T,C,82244385,74161,81973616,82366832,270769
16,ENSG00000135698.5,82170224,16-82244385-T-A,rs1844722,-1,T,A,82244385,74161,81973616,82366832,270769
16,ENSG00000099365.5,31010638,16-30959620-T-C,rs1870293,-1,T,C,30959620,51018,30814030,31207246,145590
16,ENSG00000099365.5,31010638,16-30959620-T-A,rs1870293,-1,T,A,30959620,51018,30814030,31207246,145590
16,ENSG00000099365.5,31010638,16-30959620-T-G,rs1870293,-1,T,G,30959620,51018,30814030,31207246,145590
16,ENSG00000184110.9,28711464,16-28620264-T-G,rs1968752,1,T,G,28620264,91200,28514856,28908072,105408
16,ENSG00000184110.9,28711464,16-28620264-T-A,rs1968752,1,T,A,28620264,91200,28514856,28908072,105408
16,ENSG00000086504.10,370538,16-306689-G-T,rs1981492,-1,G,T,306689,63849,173930,567146,132759
16,ENSG00000086504.10,370538,16-306689-G-A,rs1981492,-1,G,A,306689,63849,173930,567146,132759
16,ENSG00000149926.9,30031271,16-30070046-G-T,rs2071390,-1,G,T,30070046,38775,29834663,30227879,235383
16,ENSG00000149926.9,30031271,16-30070046-G-A,rs2071390,-1,G,A,30070046,38775,29834663,30227879,235383
16,ENSG00000140990.10,1959538,16-1984660-T-C,rs2075812,1,T,C,1984660,25122,1762930,2156146,221730
16,ENSG00000140990.10,1959538,16-1984660-T-G,rs2075812,1,T,G,1984660,25122,1762930,2156146,221730
16,ENSG00000130731.11,636305,16-650970-C-T,rs2076142,-1,C,T,650970,14665,439697,832913,211273
16,ENSG00000130731.11,636305,16-650970-C-A,rs2076142,-1,C,A,650970,14665,439697,832913,211273
16,ENSG00000130731.11,636305,16-650970-C-G,rs2076142,-1,C,G,650970,14665,439697,832913,211273
16,ENSG00000122386.6,3112586,16-3084753-A-G,rs2092015,1,A,G,3084753,27833,2915978,3309194,168775
16,ENSG00000122386.6,3112586,16-3084753-A-T,rs2092015,1,A,T,3084753,27833,2915978,3309194,168775
16,ENSG00000133392.10,15857028,16-15847727-A-C,rs215573,-1,A,C,15847727,9301,15660420,16053636,187307
16,ENSG00000074071.8,1773134,16-1680310-A-T,rs2235487,-1,A,T,1680310,92824,1576526,1969742,103784
16,ENSG00000074071.8,1773134,16-1680310-A-G,rs2235487,-1,A,G,1680310,92824,1576526,1969742,103784
16,ENSG00000131634.9,1533666,16-1523889-G-A,rs2235638,1,G,A,1523889,9777,1337058,1730274,186831
16,ENSG00000131634.9,1533666,16-1523889-G-T,rs2235638,1,G,T,1523889,9777,1337058,1730274,186831
16,ENSG00000103148.9,138673,16-120329-C-T,rs2238368,-1,C,T,120329,18344,-57935,335281,178264
16,ENSG00000006194.6,3283491,16-3221222-C-A,rs2238400,1,C,A,3221222,62269,3086883,3480099,134339
16,ENSG00000006194.6,3283491,16-3221222-C-T,rs2238400,1,C,T,3221222,62269,3086883,3480099,134339
16,ENSG00000005194.10,57447385,16-57451005-G-A,rs223863,-1,G,A,57451005,3620,57250777,57643993,200228
16,ENSG00000140993.5,3305430,16-3258357-G-A,rs224230,-1,G,A,3258357,47073,3108822,3502038,149535
16,ENSG00000103047.2,68843531,16-68823386-T-C,rs2276330,1,T,C,68823386,20145,68646923,69040139,176463
16,ENSG00000051108.10,56932142,16-56902546-A-G,rs2289117,1,A,G,56902546,29596,56735534,57128750,167012
16,ENSG00000132600.11,68311019,16-68255080-T-G,rs2290700,1,T,G,68255080,55939,68114411,68507627,140669
16,ENSG00000169715.10,56625781,16-56659349-G-C,rs2291957,1,G,C,56659349,33568,56429173,56822389,230176
16,ENSG00000169715.10,56625781,16-56659349-G-A,rs2291957,1,G,A,56659349,33568,56429173,56822389,230176
16,ENSG00000169715.10,56625781,16-56659349-G-T,rs2291957,1,G,T,56659349,33568,56429173,56822389,230176
16,ENSG00000180185.7,1826941,16-1764439-A-G,rs2294619,1,A,G,1764439,62502,1630333,2023549,134106
16,ENSG00000127561.8,1989970,16-1971892-A-C,rs2302178,1,A,C,1971892,18078,1793362,2186578,178530
16,ENSG00000127561.8,1989970,16-1971892-A-G,rs2302178,1,A,G,1971892,18078,1793362,2186578,178530
16,ENSG00000103174.6,5033935,16-5021669-A-C,rs2340713,-1,A,C,5021669,12266,4837327,5230543,184342
16,ENSG00000103174.6,5033935,16-5021669-A-T,rs2340713,-1,A,T,5021669,12266,4837327,5230543,184342
16,ENSG00000103174.6,5033935,16-5021669-A-G,rs2340713,-1,A,G,5021669,12266,4837327,5230543,184342
16,ENSG00000103365.10,23510494,16-23383078-C-T,rs250567,-1,C,T,23383078,127416,23313886,23707102,69192
16,ENSG00000140986.7,1954689,16-2053004-C-T,rs2516735,-1,C,T,2053004,98315,1758081,2151297,294923
16,ENSG00000007384.9,72631,16-157612-T-C,rs2541638,-1,T,C,157612,84981,-123977,269239,281589
16,ENSG00000007384.9,72631,16-157612-T-G,rs2541638,-1,T,G,157612,84981,-123977,269239,281589
16,ENSG00000007384.9,72631,16-157612-T-A,rs2541638,-1,T,A,157612,84981,-123977,269239,281589
16,ENSG00000076344.11,275944,16-162329-G-C,rs2541644,-1,G,C,162329,113615,79336,472552,82993
16,ENSG00000076344.11,275944,16-162329-G-A,rs2541644,-1,G,A,162329,113615,79336,472552,82993
16,ENSG00000140905.5,81096395,16-80988939-C-T,rs2549834,-1,C,T,80988939,107456,80899787,81293003,89152
16,ENSG00000140987.14,3401004,16-3216552-G-A,rs2741916,-1,G,A,3216552,184452,3204396,3597612,12156
16,ENSG00000140987.14,3401004,16-3216552-G-T,rs2741916,-1,G,T,3216552,184452,3204396,3597612,12156
16,ENSG00000140987.14,3401004,16-3216552-G-C,rs2741916,-1,G,C,3216552,184452,3204396,3597612,12156
16,ENSG00000140941.7,87392336,16-87264018-A-G,rs28450238,1,A,G,87264018,128318,87195728,87588944,68290
16,ENSG00000176953.6,28950937,16-28814728-C-T,rs28472312,1,C,T,28814728,136209,28754329,29147545,60399
16,ENSG00000176953.6,28950937,16-28814728-C-G,rs28472312,1,C,G,28814728,136209,28754329,29147545,60399
16,ENSG00000176953.6,28950937,16-28814728-C-A,rs28472312,1,C,A,28814728,136209,28754329,29147545,60399
16,ENSG00000099381.12,30957754,16-31094233-A-C,rs2884737,1,A,C,31094233,136479,30761146,31154362,333087
16,ENSG00000129925.5,381978,16-345396-G-A,rs2885415,-1,G,A,345396,36582,185370,578586,160026
16,ENSG00000087237.6,56961950,16-56997298-T-C,rs289736,1,T,C,56997298,35348,56765342,57158558,231956
16,ENSG00000135686.8,84648511,16-84594173-T-A,rs2914835,1,T,A,84594173,54338,84451903,84845119,142270
16,ENSG00000077238.8,27313974,16-27348523-G-A,rs3024585,1,G,A,27348523,34549,27117366,27510582,231157
16,ENSG00000182108.5,10942468,16-10929351-T-G,rs3087519,-1,T,G,10929351,13117,10745860,11139076,183491
16,ENSG00000182108.5,10942468,16-10929351-T-C,rs3087519,-1,T,C,10929351,13117,10745860,11139076,183491
16,ENSG00000182108.5,10942468,16-10929351-T-A,rs3087519,-1,T,A,10929351,13117,10745860,11139076,183491
16,ENSG00000103363.10,2777280,16-2729235-C-G,rs3094481,-1,C,G,2729235,48045,2580672,2973888,148563
16,ENSG00000103363.10,2777280,16-2729235-C-A,rs3094481,-1,C,A,2729235,48045,2580672,2973888,148563
16,ENSG00000103363.10,2777280,16-2729235-C-T,rs3094481,-1,C,T,2729235,48045,2580672,2973888,148563
16,ENSG00000167964.7,2148625,16-2039027-C-G,rs3211994,1,C,G,2039027,109598,1952017,2345233,87010
16,ENSG00000167964.7,2148625,16-2039027-C-T,rs3211994,1,C,T,2039027,109598,1952017,2345233,87010
16,ENSG00000168872.10,70346903,16-70289223-C-T,rs34087264,1,C,T,70289223,57680,70150295,70543511,138928
16,ENSG00000168872.10,70346903,16-70289223-C-G,rs34087264,1,C,G,70289223,57680,70150295,70543511,138928
16,ENSG00000185864.12,21857756,16-22027245-T-C,rs34206908,-1,T,C,22027245,169489,21661148,22054364,366097
16,ENSG00000150281.6,30896614,16-31078020-A-G,rs35041466,1,A,G,31078020,181406,30700006,31093222,378014
16,ENSG00000150281.6,30896614,16-31078020-A-C,rs35041466,1,A,C,31078020,181406,30700006,31093222,378014
16,ENSG00000131153.3,85688954,16-85685312-C-T,rs35444818,-1,C,T,85685312,3642,85492346,85885562,192966
16,ENSG00000131153.3,85688954,16-85685312-C-G,rs35444818,-1,C,G,85685312,3642,85492346,85885562,192966
16,ENSG00000131153.3,85688954,16-85685312-C-A,rs35444818,-1,C,A,85685312,3642,85492346,85885562,192966
16,ENSG00000103034.10,58500143,16-58530960-C-A,rs37059,1,C,A,58530960,30817,58303535,58696751,227425
16,ENSG00000103034.10,58500143,16-58530960-C-T,rs37059,1,C,T,58530960,30817,58303535,58696751,227425
16,ENSG00000179889.14,14975026,16-14889311-C-G,rs3743531,1,C,G,14889311,85715,14778418,15171634,110893
16,ENSG00000103005.5,58001407,16-57996149-T-A,rs3743553,1,T,A,57996149,5258,57804799,58198015,191350
16,ENSG00000103005.5,58001407,16-57996149-T-C,rs3743553,1,T,C,57996149,5258,57804799,58198015,191350
16,ENSG00000159648.7,57976544,16-57996730-C-T,rs3743556,1,C,T,57996730,20186,57779936,58173152,216794
16,ENSG00000159648.7,57976544,16-57996730-C-G,rs3743556,1,C,G,57996730,20186,57779936,58173152,216794
16,ENSG00000103227.12,970984,16-954554-C-T,rs3751667,-1,C,T,954554,16430,774376,1167592,180178
16,ENSG00000131149.13,85613322,16-85678082-G-C,rs3751717,1,G,C,85678082,64760,85416714,85809930,261368
16,ENSG00000131149.13,85613322,16-85678082-G-A,rs3751717,1,G,A,85678082,64760,85416714,85809930,261368
16,ENSG00000125170.6,57486493,16-57486778-A-G,rs3760067,-1,A,G,57486778,285,57289885,57683101,196893
16,ENSG00000141012.7,88856947,16-88859239-C-A,rs3784876,-1,C,A,88859239,2292,88660339,89053555,198900
16,ENSG00000127580.11,690398,16-714040-G-A,rs3809663,-1,G,A,714040,23642,493790,887006,220250
16,ENSG00000156886.10,31393335,16-31486560-G-C,rs3813008,1,G,C,31486560,93225,31196727,31589943,289833
16,ENSG00000156886.10,31393335,16-31486560-G-A,rs3813008,1,G,A,31486560,93225,31196727,31589943,289833
16,ENSG00000185905.3,29745990,16-29667246-T-C,rs3851019,-1,T,C,29667246,78744,29549382,29942598,117864
16,ENSG00000131148.3,85799544,16-85895413-G-A,rs413529,-1,G,A,85895413,95869,85602936,85996152,292477
16,ENSG00000140749.7,21652608,16-21610925-C-T,rs41468646,-1,C,T,21610925,41683,21456000,21849216,154925
16,ENSG00000197943.5,81779291,16-81817172-A-T,rs4243216,1,A,T,81817172,37881,81582683,81975899,234489
16,ENSG00000197943.5,81779291,16-81817172-A-G,rs4243216,1,A,G,81817172,37881,81582683,81975899,234489
16,ENSG00000197943.5,81779291,16-81817172-A-C,rs4243216,1,A,C,81817172,37881,81582683,81975899,234489
16,ENSG00000003249.8,90019456,16-89981987-C-T,rs45610233,-1,C,T,89981987,37469,89822848,90216064,159139
16,ENSG00000167981.4,3443504,16-3357258-A-G,rs4578649,-1,A,G,3357258,86246,3246896,3640112,110362
16,ENSG00000167981.4,3443504,16-3357258-A-C,rs4578649,-1,A,C,3357258,86246,3246896,3640112,110362
16,ENSG00000153060.3,10694930,16-10691460-G-A,rs4636907,-1,G,A,10691460,3470,10498322,10891538,193138
16,ENSG00000153060.3,10694930,16-10691460-G-C,rs4636907,-1,G,C,10691460,3470,10498322,10891538,193138
16,ENSG00000153060.3,10694930,16-10691460-G-T,rs4636907,-1,G,T,10691460,3470,10498322,10891538,193138
16,ENSG00000006007.7,19522098,16-19393323-A-G,rs4780805,-1,A,G,19393323,128775,19325490,19718706,67833
16,ENSG00000006007.7,19522098,16-19393323-A-T,rs4780805,-1,A,T,19393323,128775,19325490,19718706,67833
16,ENSG00000155719.11,21663968,16-21726093-T-C,rs4783414,1,T,C,21726093,62125,21467360,21860576,258733
16,ENSG00000070770.3,58198106,16-58233718-G-C,rs4784029,-1,G,C,58233718,35612,58001498,58394714,232220
16,ENSG00000167208.9,50681312,16-50789053-A-C,rs4785226,-1,A,C,50789053,107741,50484704,50877920,304349
16,ENSG00000167208.9,50681312,16-50789053-A-T,rs4785226,-1,A,T,50789053,107741,50484704,50877920,304349
16,ENSG00000104731.9,87765986,16-87922506-G-A,rs4843739,-1,G,A,87922506,156520,87569378,87962594,353128
16,ENSG00000104731.9,87765986,16-87922506-G-T,rs4843739,-1,G,T,87922506,156520,87569378,87962594,353128
16,ENSG00000104731.9,87765986,16-87922506-G-C,rs4843739,-1,G,C,87922506,156520,87569378,87962594,353128
16,ENSG00000085721.8,15094272,16-15074903-T-C,rs4985147,-1,T,C,15074903,19369,14897664,15290880,177239
16,ENSG00000010539.7,3235158,16-3207868-G-A,rs548927,-1,G,A,3207868,27290,3038550,3431766,169318
16,ENSG00000010539.7,3235158,16-3207868-G-C,rs548927,-1,G,C,3207868,27290,3038550,3431766,169318
16,ENSG00000133393.8,15888603,16-15874737-G-T,rs56275653,-1,G,T,15874737,13866,15691995,16085211,182742
16,ENSG00000133393.8,15888603,16-15874737-G-A,rs56275653,-1,G,A,15874737,13866,15691995,16085211,182742
16,ENSG00000133393.8,15888603,16-15874737-G-C,rs56275653,-1,G,C,15874737,13866,15691995,16085211,182742
16,ENSG00000188897.3,11527245,16-11492360-G-A,rs56761637,-1,G,A,11492360,34885,11330637,11723853,161723
16,ENSG00000176715.11,89093852,16-89010039-C-T,rs58333036,1,C,T,89010039,83813,88897244,89290460,112795
16,ENSG00000176715.11,89093852,16-89010039-C-A,rs58333036,1,C,A,89010039,83813,88897244,89290460,112795
16,ENSG00000075399.7,89720898,16-89598376-G-C,rs60900454,-1,G,C,89598376,122522,89524290,89917506,74086
16,ENSG00000075399.7,89720898,16-89598376-G-A,rs60900454,-1,G,A,89598376,122522,89524290,89917506,74086
16,ENSG00000167526.9,89560682,16-89598376-G-C,rs60900454,1,G,C,89598376,37694,89364074,89757290,234302
16,ENSG00000167526.9,89560682,16-89598376-G-A,rs60900454,1,G,A,89598376,37694,89364074,89757290,234302
16,ENSG00000103275.14,1309636,16-1434454-T-C,rs61743495,1,T,C,1434454,124818,1113028,1506244,321426
16,ENSG00000040199.13,71724701,16-71626501-G-A,rs61753635,-1,G,A,71626501,98200,71528093,71921309,98408
16,ENSG00000058600.11,22297409,16-22228719-T-C,rs62044766,1,T,C,22228719,68690,22100801,22494017,127918
16,ENSG00000167513.4,88803789,16-88744251-T-C,rs62048195,1,T,C,88744251,59538,88607181,89000397,137070
16,ENSG00000157322.11,69951334,16-70091251-T-C,rs62052493,1,T,C,70091251,139917,69754726,70147942,336525
16,ENSG00000197912.8,89508403,16-89414225-T-C,rs6416798,1,T,C,89414225,94178,89311795,89705011,102430
16,ENSG00000158486.8,21159441,16-21092849-T-A,rs6497525,-1,T,A,21092849,66592,20962833,21356049,130016
16,ENSG00000158486.8,21159441,16-21092849-T-C,rs6497525,-1,T,C,21092849,66592,20962833,21356049,130016
16,ENSG00000205423.7,50025225,16-49892463-G-A,rs6500264,1,G,A,49892463,132762,49828617,50221833,63846
16,ENSG00000205423.7,50025225,16-49892463-G-C,rs6500264,1,G,C,49892463,132762,49828617,50221833,63846
16,ENSG00000205423.7,50025225,16-49892463-G-T,rs6500264,1,G,T,49892463,132762,49828617,50221833,63846
16,ENSG00000184517.7,75148524,16-75166189-A-C,rs6564214,1,A,C,75166189,17665,74951916,75345132,214273
16,ENSG00000184517.7,75148524,16-75166189-A-G,rs6564214,1,A,G,75166189,17665,74951916,75345132,214273
16,ENSG00000184517.7,75148524,16-75166189-A-T,rs6564214,1,A,T,75166189,17665,74951916,75345132,214273
16,ENSG00000184860.4,82011470,16-82045486-G-A,rs6564961,-1,G,A,82045486,34016,81814862,82208078,230624
16,ENSG00000189067.8,11586919,16-11548386-T-C,rs7102,-1,T,C,11548386,38533,11390311,11783527,158075
16,ENSG00000189067.8,11586919,16-11548386-T-A,rs7102,-1,T,A,11548386,38533,11390311,11783527,158075
16,ENSG00000007516.8,1333645,16-1445242-T-A,rs710900,1,T,A,1445242,111597,1137037,1530253,308205
16,ENSG00000007516.8,1333645,16-1445242-T-G,rs710900,1,T,G,1445242,111597,1137037,1530253,308205
16,ENSG00000197599.8,1444556,16-1473299-G-T,rs71384102,-1,G,T,1473299,28743,1247948,1641164,225351
16,ENSG00000197599.8,1444556,16-1473299-G-A,rs71384102,-1,G,A,1473299,28743,1247948,1641164,225351
16,ENSG00000140798.10,48155993,16-48129624-G-A,rs7184973,-1,G,A,48129624,26369,47959385,48352601,170239
16,ENSG00000140876.7,77722514,16-77727469-G-A,rs7189238,1,G,A,77727469,4955,77525906,77919122,201563
16,ENSG00000140876.7,77722514,16-77727469-G-C,rs7189238,1,G,C,77727469,4955,77525906,77919122,201563
16,ENSG00000102996.4,58025754,16-57884364-G-A,rs7190372,1,G,A,57884364,141390,57829146,58222362,55218
16,ENSG00000169957.7,30526566,16-30341447-A-G,rs7190535,-1,A,G,30341447,185119,30329958,30723174,11489
16,ENSG00000169957.7,30526566,16-30341447-A-C,rs7190535,-1,A,C,30341447,185119,30329958,30723174,11489
16,ENSG00000121270.11,48247539,16-48195878-G-C,rs7191844,-1,G,C,48195878,51661,48050931,48444147,144947
16,ENSG00000121270.11,48247539,16-48195878-G-T,rs7191844,-1,G,T,48195878,51661,48050931,48444147,144947
16,ENSG00000166548.10,66550122,16-66566576-G-A,rs7193473,-1,G,A,66566576,16454,66353514,66746730,213062
16,ENSG00000089505.12,66566439,16-66566576-G-A,rs7193473,1,G,A,66566576,137,66369831,66763047,196745
16,ENSG00000140835.7,71526426,16-71539915-A-G,rs7194638,1,A,G,71539915,13489,71329818,71723034,210097
16,ENSG00000008517.12,3065640,16-3002959-G-A,rs7200391,1,G,A,3002959,62681,2869032,3262248,133927
16,ENSG00000008517.12,3065640,16-3002959-G-T,rs7200391,1,G,T,3002959,62681,2869032,3262248,133927
16,ENSG00000090565.10,425649,16-605809-G-A,rs72767876,1,G,A,605809,180160,229041,622257,376768
16,ENSG00000127578.6,630985,16-605809-G-A,rs72767876,1,G,A,605809,25176,434377,827593,171432
16,ENSG00000103528.12,19168240,16-19143689-C-T,rs72779541,1,C,T,19143689,24551,18971632,19364848,172057
16,ENSG00000083799.12,50742086,16-50811943-A-G,rs72796400,1,A,G,50811943,69857,50545478,50938694,266465
16,ENSG00000149925.12,30065760,16-29922569-C-T,rs72798151,1,C,T,29922569,143191,29869152,30262368,53417
16,ENSG00000158545.10,88570403,16-88711346-C-T,rs72811470,1,C,T,88711346,140943,88373795,88767011,337551
16,ENSG00000069329.10,46689178,16-46689458-A-C,rs72816873,-1,A,C,46689458,280,46492570,46885786,196888
16,ENSG00000162066.10,2520371,16-2700191-T-G,rs732055,1,T,G,2700191,179820,2323763,2716979,376428
16,ENSG00000162066.10,2520371,16-2700191-T-C,rs732055,1,T,C,2700191,179820,2323763,2716979,376428
16,ENSG00000197562.5,590066,16-766464-A-G,rs73491255,1,A,G,766464,176398,393458,786674,373006
16,ENSG00000197562.5,590066,16-766464-A-C,rs73491255,1,A,C,766464,176398,393458,786674,373006
16,ENSG00000175595.9,13920154,16-13999727-T-C,rs74009291,1,T,C,13999727,79573,13723546,14116762,276181
16,ENSG00000177200.10,53054991,16-53148920-G-A,rs74416819,1,G,A,53148920,93929,52858383,53251599,290537
16,ENSG00000169189.12,27268772,16-27216814-T-C,rs74663472,-1,T,C,27216814,51958,27072164,27465380,144650
16,ENSG00000169189.12,27268772,16-27216814-T-G,rs74663472,-1,T,G,27216814,51958,27072164,27465380,144650
16,ENSG00000103502.8,29863226,16-29887802-G-T,rs75331747,-1,G,T,29887802,24576,29666618,30059834,221184
16,ENSG00000103202.7,397199,16-347044-G-T,rs758033,1,G,T,347044,50155,200591,593807,146453
16,ENSG00000167264.12,68023284,16-68132058-G-C,rs75914405,1,G,C,68132058,108774,67826676,68219892,305382
16,ENSG00000167264.12,68023284,16-68132058-G-A,rs75914405,1,G,A,68132058,108774,67826676,68219892,305382
16,ENSG00000102977.8,67660260,16-67848086-T-G,rs75957286,-1,T,G,67848086,187826,67463652,67856868,384434
16,ENSG00000196155.7,67279532,16-67277715-C-G,rs78132437,1,C,G,67277715,1817,67082924,67476140,194791
16,ENSG00000103404.10,23149452,16-23206231-G-A,rs78367348,-1,G,A,23206231,56779,22952844,23346060,253387
16,ENSG00000103404.10,23149452,16-23206231-G-C,rs78367348,-1,G,C,23206231,56779,22952844,23346060,253387
16,ENSG00000187741.9,89816647,16-89638523-C-T,rs78545310,-1,C,T,89638523,178124,89620039,90013255,18484
16,ENSG00000187741.9,89816647,16-89638523-C-A,rs78545310,-1,C,A,89638523,178124,89620039,90013255,18484
16,ENSG00000187741.9,89816647,16-89638523-C-G,rs78545310,-1,C,G,89638523,178124,89620039,90013255,18484
16,ENSG00000103351.8,3501004,16-3632547-T-G,rs78599052,1,T,G,3632547,131543,3304396,3697612,328151
16,ENSG00000051523.6,88651053,16-88602824-A-G,rs78729051,-1,A,G,88602824,48229,88454445,88847661,148379
16,ENSG00000161981.6,53828,16-47610-G-A,rs798675,1,G,A,47610,6218,-142780,250436,190390
16,ENSG00000161981.6,53828,16-47610-G-T,rs798675,1,G,T,47610,6218,-142780,250436,190390
16,ENSG00000103335.14,88785220,16-88781029-T-A,rs8043839,-1,T,A,88781029,4191,88588612,88981828,192417
16,ENSG00000103335.14,88785220,16-88781029-T-C,rs8043839,-1,T,C,88781029,4191,88588612,88981828,192417
16,ENSG00000118898.9,4937148,16-5072680-C-G,rs8045294,-1,C,G,5072680,135532,4740540,5133756,332140
16,ENSG00000065054.8,2026902,16-2004154-G-A,rs8045887,1,G,A,2004154,22748,1830294,2223510,173860
16,ENSG00000162076.8,2883215,16-2882820-G-A,rs8046450,1,G,A,2882820,395,2686607,3079823,196213
16,ENSG00000103021.5,58249936,16-58287316-G-A,rs8047708,1,G,A,58287316,37380,58053328,58446544,233988
16,ENSG00000103021.5,58249936,16-58287316-G-C,rs8047708,1,G,C,58287316,37380,58053328,58446544,233988
16,ENSG00000188827.6,3611606,16-3699333-C-A,rs8050376,-1,C,A,3699333,87727,3414998,3808214,284335
16,ENSG00000188827.6,3611606,16-3699333-C-G,rs8050376,-1,C,G,3699333,87727,3414998,3808214,284335
16,ENSG00000188827.6,3611606,16-3699333-C-T,rs8050376,-1,C,T,3699333,87727,3414998,3808214,284335
16,ENSG00000140682.14,31472152,16-31393250-T-G,rs8050500,1,T,G,31393250,78902,31275544,31668760,117706
16,ENSG00000140682.14,31472152,16-31393250-T-A,rs8050500,1,T,A,31393250,78902,31275544,31668760,117706
16,ENSG00000140682.14,31472152,16-31393250-T-C,rs8050500,1,T,C,31393250,78902,31275544,31668760,117706
16,ENSG00000103160.6,84145177,16-84307290-A-C,rs8051764,-1,A,C,84307290,162113,83948569,84341785,358721
16,ENSG00000198650.6,71577092,16-71763088-C-T,rs8052152,-1,C,T,71763088,185996,71380484,71773700,382604
16,ENSG00000198650.6,71577092,16-71763088-C-G,rs8052152,-1,C,G,71763088,185996,71380484,71773700,382604
16,ENSG00000198650.6,71577092,16-71763088-C-A,rs8052152,-1,C,A,71763088,185996,71380484,71773700,382604
16,ENSG00000155330.5,46831180,16-46842664-C-T,rs8053297,-1,C,T,46842664,11484,46634572,47027788,208092
16,ENSG00000183336.7,29454351,16-29312371-G-A,rs8055762,-1,G,A,29312371,141980,29257743,29650959,54628
16,ENSG00000185324.17,89686689,16-89748399-T-C,rs8058895,1,T,C,89748399,61710,89490081,89883297,258318
16,ENSG00000141013.10,90022680,16-90013126-A-G,rs8059973,1,A,G,90013126,9554,89826072,90219288,187054
16,ENSG00000141013.10,90022680,16-90013126-A-T,rs8059973,1,A,T,90013126,9554,89826072,90219288,187054
16,ENSG00000089486.10,4538773,16-4370786-T-G,rs8182173,-1,T,G,4370786,167987,4342165,4735381,28621
16,ENSG00000089486.10,4538773,16-4370786-T-C,rs8182173,-1,T,C,4370786,167987,4342165,4735381,28621
16,ENSG00000140988.10,1964826,16-1978401-A-T,rs8460,-1,A,T,1978401,13575,1768218,2161434,210183
16,ENSG00000140988.10,1964826,16-1978401-A-C,rs8460,-1,A,C,1978401,13575,1768218,2161434,210183
16,ENSG00000174177.8,88706503,16-88707330-C-T,rs881633,1,C,T,88707330,827,88509895,88903111,197435
16,ENSG00000167005.8,56451332,16-56287207-A-G,rs899239,-1,A,G,56287207,164125,56254724,56647940,32483
16,ENSG00000167005.8,56451332,16-56287207-A-T,rs899239,-1,A,T,56287207,164125,56254724,56647940,32483
16,ENSG00000213937.3,3012923,16-3115424-A-G,rs909410,1,A,G,3115424,102501,2816315,3209531,299109
16,ENSG00000213937.3,3012923,16-3115424-A-C,rs909410,1,A,C,3115424,102501,2816315,3209531,299109
16,ENSG00000189091.7,70523816,16-70693421-G-T,rs936299,1,G,T,70693421,169605,70327208,70720424,366213
16,ENSG00000011638.6,21158674,16-21187175-C-G,rs9889185,1,C,G,21187175,28501,20962066,21355282,225109
16,ENSG00000011638.6,21158674,16-21187175-C-T,rs9889185,1,C,T,21187175,28501,20962066,21355282,225109
16,ENSG00000185883.5,2513952,16-2337342-A-C,rs9924128,1,A,C,2337342,176610,2317344,2710560,19998
16,ENSG00000185883.5,2513952,16-2337342-A-G,rs9924128,1,A,G,2337342,176610,2317344,2710560,19998
16,ENSG00000168676.6,67326741,16-67317795-A-G,rs9925727,-1,A,G,67317795,8946,67130133,67523349,187662
16,ENSG00000103319.7,22206278,16-22270914-A-C,rs9927408,1,A,C,22270914,64636,22009670,22402886,261244
16,ENSG00000103319.7,22206278,16-22270914-A-T,rs9927408,1,A,T,22270914,64636,22009670,22402886,261244
16,ENSG00000176476.4,28553920,16-28568596-T-C,rs9928136,1,T,C,28568596,14676,28357312,28750528,211284
16,ENSG00000176476.4,28553920,16-28568596-T-G,rs9928136,1,T,G,28568596,14676,28357312,28750528,211284
16,ENSG00000175643.7,11345459,16-11343922-C-T,rs9936459,1,C,T,11343922,1537,11148851,11542067,195071
16,ENSG00000217555.6,66552576,16-66364942-G-A,rs9940166,1,G,A,66364942,187634,66355968,66749184,8974
16,ENSG00000170100.9,89217703,16-89231544-G-A,rs10400958,1,G,A,89231544,13841,89021095,89414311,210449
16,ENSG00000103528.12,19168240,16-19143368-A-G,rs10454701,1,A,G,19143368,24872,18971632,19364848,171736
16,ENSG00000168101.9,4693694,16-4885145-C-T,rs1049206,1,C,T,4885145,191451,4497086,4890302,388059
16,ENSG00000168101.9,4693694,16-4885145-C-A,rs1049206,1,C,A,4885145,191451,4497086,4890302,388059
16,ENSG00000168101.9,4693694,16-4885145-C-G,rs1049206,1,C,G,4885145,191451,4497086,4890302,388059
16,ENSG00000103494.7,53703859,16-53900060-C-T,rs1074903,-1,C,T,53900060,196201,53507251,53900467,392809
16,ENSG00000103313.6,3256633,16-3180887-T-G,rs1076573,-1,T,G,3180887,75746,3060025,3453241,120862
16,ENSG00000103313.6,3256633,16-3180887-T-A,rs1076573,-1,T,A,3180887,75746,3060025,3453241,120862
16,ENSG00000141013.10,90022680,16-89841595-G-A,rs1079558,1,G,A,89841595,181085,89826072,90219288,15523
16,ENSG00000188897.3,11527245,16-11504579-C-A,rs11074994,-1,C,A,11504579,22666,11330637,11723853,173942
16,ENSG00000188897.3,11527245,16-11504579-C-G,rs11074994,-1,C,G,11504579,22666,11330637,11723853,173942
16,ENSG00000188897.3,11527245,16-11504579-C-T,rs11074994,-1,C,T,11504579,22666,11330637,11723853,173942
16,ENSG00000103266.5,680410,16-491818-C-T,rs111811257,1,C,T,491818,188592,483802,877018,8016
16,ENSG00000135709.8,85027795,16-85093437-A-G,rs11548970,1,A,G,85093437,65642,84831187,85224403,262250
16,ENSG00000197774.6,1772810,16-1772641-C-T,rs11552434,1,C,T,1772641,169,1576202,1969418,196439
16,ENSG00000197774.6,1772810,16-1772641-C-G,rs11552434,1,C,G,1772641,169,1576202,1969418,196439
16,ENSG00000175643.7,11345459,16-11326285-C-G,rs11640306,1,C,G,11326285,19174,11148851,11542067,177434
16,ENSG00000175643.7,11345459,16-11326285-C-A,rs11640306,1,C,A,11326285,19174,11148851,11542067,177434
16,ENSG00000155666.6,27203526,16-27233765-G-T,rs11641348,1,G,T,27233765,30239,27006918,27400134,226847
16,ENSG00000155666.6,27203526,16-27233765-G-C,rs11641348,1,G,C,27233765,30239,27006918,27400134,226847
16,ENSG00000155666.6,27203526,16-27233765-G-A,rs11641348,1,G,A,27233765,30239,27006918,27400134,226847
16,ENSG00000159387.7,55324203,16-55476547-T-C,rs11643630,1,T,C,55476547,152344,55127595,55520811,348952
16,ENSG00000159387.7,55324203,16-55476547-T-G,rs11643630,1,T,G,55476547,152344,55127595,55520811,348952
16,ENSG00000175938.5,30949068,16-30953987-G-A,rs11647243,1,G,A,30953987,4919,30752460,31145676,201527
16,ENSG00000140848.12,57092583,16-57091421-G-A,rs11649098,1,G,A,57091421,1162,56895975,57289191,195446
16,ENSG00000007541.10,569968,16-426796-C-A,rs116962191,1,C,A,426796,143172,373360,766576,53436
16,ENSG00000007541.10,569968,16-426796-C-G,rs116962191,1,C,G,426796,143172,373360,766576,53436
16,ENSG00000168676.6,67326741,16-67409456-C-T,rs117028005,-1,C,T,67409456,82715,67130133,67523349,279323
16,ENSG00000196557.6,1153106,16-1282755-C-T,rs117303694,1,C,T,1282755,129649,956498,1349714,326257
16,ENSG00000102870.4,30787205,16-30873137-C-A,rs117378813,-1,C,A,30873137,85932,30590597,30983813,282540
16,ENSG00000140859.10,57802491,16-57670371-G-A,rs117394905,-1,G,A,57670371,132120,57605883,57999099,64488
16,ENSG00000187535.9,1612072,16-1510302-G-C,rs117559520,-1,G,C,1510302,101770,1415464,1808680,94838
16,ENSG00000187535.9,1612072,16-1510302-G-T,rs117559520,-1,G,T,1510302,101770,1415464,1808680,94838
16,ENSG00000189067.8,11586919,16-11598669-C-G,rs117638322,-1,C,G,11598669,11750,11390311,11783527,208358
16,ENSG00000261740.1,29454347,16-29602190-G-A,rs117782601,-1,G,A,29602190,147843,29257739,29650955,344451
16,ENSG00000213658.5,28985052,16-28807220-T-C,rs117822385,1,T,C,28807220,177832,28788444,29181660,18776
16,ENSG00000166592.7,66925535,16-66997578-C-G,rs118033323,-1,C,G,66997578,72043,66728927,67122143,268651
16,ENSG00000135698.5,82170224,16-82189277-G-A,rs11859088,-1,G,A,82189277,19053,81973616,82366832,215661
16,ENSG00000135723.8,67247481,16-67224431-T-G,rs11864907,-1,T,G,67224431,23050,67050873,67444089,173558
16,ENSG00000181019.8,69726560,16-69702948-G-A,rs12232410,-1,G,A,69702948,23612,69529952,69923168,172996
16,ENSG00000103351.8,3501004,16-3355994-A-T,rs1228348,1,A,T,3355994,145010,3304396,3697612,51598
16,ENSG00000103351.8,3501004,16-3355994-A-G,rs1228348,1,A,G,3355994,145010,3304396,3697612,51598
16,ENSG00000048462.5,11965210,16-11960216-G-C,rs12445244,1,G,C,11960216,4994,11768602,12161818,191614
16,ENSG00000177238.9,31214119,16-31373327-C-T,rs12448775,1,C,T,31373327,159208,31017511,31410727,355816
16,ENSG00000176715.11,89093852,16-89211027-G-A,rs12596323,1,G,A,89211027,117175,88897244,89290460,313783
16,ENSG00000005339.7,3880713,16-3935080-G-T,rs12598924,-1,G,T,3935080,54367,3684105,4077321,250975
16,ENSG00000130731.11,636305,16-707166-T-A,rs12599342,-1,T,A,707166,70861,439697,832913,267469
16,ENSG00000130731.11,636305,16-707166-T-C,rs12599342,-1,T,C,707166,70861,439697,832913,267469
16,ENSG00000130731.11,636305,16-707166-T-G,rs12599342,-1,T,G,707166,70861,439697,832913,267469
16,ENSG00000169682.13,28974778,16-28945849-G-A,rs12717010,1,G,A,28945849,28929,28778170,29171386,167679
16,ENSG00000169682.13,28974778,16-28945849-G-T,rs12717010,1,G,T,28945849,28929,28778170,29171386,167679
16,ENSG00000172775.11,57186039,16-57317181-G-A,rs1273585,-1,G,A,57317181,131142,56989431,57382647,327750
16,ENSG00000103051.13,70523554,16-70645482-C-G,rs12919296,-1,C,G,70645482,121928,70326946,70720162,318536
16,ENSG00000103051.13,70523554,16-70645482-C-T,rs12919296,-1,C,T,70645482,121928,70326946,70720162,318536
16,ENSG00000059145.13,1414704,16-1325936-C-G,rs12925270,-1,C,G,1325936,88768,1218096,1611312,107840
16,ENSG00000059145.13,1414704,16-1325936-C-A,rs12925270,-1,C,A,1325936,88768,1218096,1611312,107840
16,ENSG00000166451.9,81007214,16-81016195-T-C,rs12928638,1,T,C,81016195,8981,80810606,81203822,205589
16,ENSG00000166451.9,81007214,16-81016195-T-A,rs12928638,1,T,A,81016195,8981,80810606,81203822,205589
16,ENSG00000005513.9,981770,16-983116-C-T,rs12932842,1,C,T,983116,1346,785162,1178378,197954
16,ENSG00000005513.9,981770,16-983116-C-G,rs12932842,1,C,G,983116,1346,785162,1178378,197954
16,ENSG00000167508.5,88663091,16-88646359-A-G,rs12933505,-1,A,G,88646359,16732,88466483,88859699,179876
16,ENSG00000167508.5,88663091,16-88646359-A-T,rs12933505,-1,A,T,88646359,16732,88466483,88859699,179876
16,ENSG00000149922.6,30091924,16-29910690-C-G,rs12933766,-1,C,G,29910690,181234,29895316,30288532,15374
16,ENSG00000149922.6,30091924,16-29910690-C-T,rs12933766,-1,C,T,29910690,181234,29895316,30288532,15374
16,ENSG00000067955.8,67029149,16-67153308-G-A,rs13312735,1,G,A,67153308,124159,66832541,67225757,320767
16,ENSG00000067955.8,67029149,16-67153308-G-T,rs13312735,1,G,T,67153308,124159,66832541,67225757,320767
16,ENSG00000153060.3,10694930,16-10690624-T-G,rs13335556,-1,T,G,10690624,4306,10498322,10891538,192302
16,ENSG00000140718.14,53704156,16-53853530-G-C,rs13337591,1,G,C,53853530,149374,53507548,53900764,345982
16,ENSG00000140718.14,53704156,16-53853530-G-T,rs13337591,1,G,T,53853530,149374,53507548,53900764,345982
16,ENSG00000140718.14,53704156,16-53853530-G-A,rs13337591,1,G,A,53853530,149374,53507548,53900764,345982
16,ENSG00000140905.5,81096395,16-81112371-C-G,rs145784865,-1,C,G,81112371,15976,80899787,81293003,212584
16,ENSG00000140905.5,81096395,16-81112371-C-T,rs145784865,-1,C,T,81112371,15976,80899787,81293003,212584
16,ENSG00000102977.8,67660260,16-67657612-C-A,rs14920,-1,C,A,67657612,2648,67463652,67856868,193960
16,ENSG00000102977.8,67660260,16-67657612-C-T,rs14920,-1,C,T,67657612,2648,67463652,67856868,193960
16,ENSG00000167969.7,2251587,16-2278789-G-A,rs150928,-1,G,A,2278789,27202,2054979,2448195,223810
16,ENSG00000167969.7,2251587,16-2278789-G-C,rs150928,-1,G,C,2278789,27202,2054979,2448195,223810
16,ENSG00000184730.6,28494643,16-28571894-G-A,rs151230,1,G,A,28571894,77251,28298035,28691251,273859
16,ENSG00000184730.6,28494643,16-28571894-G-T,rs151230,1,G,T,28571894,77251,28298035,28691251,273859
16,ENSG00000205609.7,28403841,16-28517302-T-C,rs153103,-1,T,C,28517302,113461,28207233,28600449,310069
16,ENSG00000103174.6,5033935,16-5011882-A-C,rs1558562,-1,A,C,5011882,22053,4837327,5230543,174555
16,ENSG00000103248.12,86555235,16-86588830-A-T,rs16941554,-1,A,T,86588830,33595,86358627,86751843,230203
16,ENSG00000103248.12,86555235,16-86588830-A-G,rs16941554,-1,A,G,86588830,33595,86358627,86751843,230203
16,ENSG00000171241.4,46621379,16-46501065-C-T,rs16945380,-1,C,T,46501065,120314,46424771,46817987,76294
16,ENSG00000171241.4,46621379,16-46501065-C-A,rs16945380,-1,C,A,46501065,120314,46424771,46817987,76294
16,ENSG00000103381.7,12803887,16-12989021-A-G,rs16960950,-1,A,G,12989021,185134,12607279,13000495,381742
16,ENSG00000072864.8,15650245,16-15727006-C-G,rs16967494,1,C,G,15727006,76761,15453637,15846853,273369
16,ENSG00000072864.8,15650245,16-15727006-C-T,rs16967494,1,C,T,15727006,76761,15453637,15846853,273369
16,ENSG00000157350.8,70439100,16-70419214-G-A,rs16970154,-1,G,A,70419214,19886,70242492,70635708,176722
16,ENSG00000135686.8,84648511,16-84563362-G-T,rs16974136,1,G,T,84563362,85149,84451903,84845119,111459
16,ENSG00000140995.12,89948755,16-90037251-G-A,rs17178299,1,G,A,90037251,88496,89752147,90145363,285104
16,ENSG00000140995.12,89948755,16-90037251-G-T,rs17178299,1,G,T,90037251,88496,89752147,90145363,285104
16,ENSG00000095906.11,1782960,16-1889377-G-C,rs1742454,1,G,C,1889377,106417,1586352,1979568,303025
16,ENSG00000095906.11,1782960,16-1889377-G-A,rs1742454,1,G,A,1889377,106417,1586352,1979568,303025
16,ENSG00000095906.11,1782960,16-1889377-G-T,rs1742454,1,G,T,1889377,106417,1586352,1979568,303025
16,ENSG00000180209.7,30374802,16-30528714-A-G,rs17839547,1,A,G,30528714,153912,30178194,30571410,350520
16,ENSG00000103510.14,31117664,16-30992848-T-C,rs17855121,1,T,C,30992848,124816,30921056,31314272,71792
16,ENSG00000125124.6,56520024,16-56343836-A-T,rs1799917,-1,A,T,56343836,176188,56323416,56716632,20420
16,ENSG00000125124.6,56520024,16-56343836-A-G,rs1799917,-1,A,G,56343836,176188,56323416,56716632,20420
16,ENSG00000125124.6,56520024,16-56343836-A-C,rs1799917,-1,A,C,56343836,176188,56323416,56716632,20420
16,ENSG00000169715.10,56625781,16-56637784-T-A,rs1846692,1,T,A,56637784,12003,56429173,56822389,208611
16,ENSG00000169715.10,56625781,16-56637784-T-G,rs1846692,1,T,G,56637784,12003,56429173,56822389,208611
16,ENSG00000169715.10,56625781,16-56637784-T-C,rs1846692,1,T,C,56637784,12003,56429173,56822389,208611
16,ENSG00000186260.11,14071319,16-13892567-C-T,rs1895560,1,C,T,13892567,178752,13874711,14267927,17856
16,ENSG00000184517.7,75148524,16-74956163-T-A,rs1943063,1,T,A,74956163,192361,74951916,75345132,4247
16,ENSG00000184517.7,75148524,16-74956163-T-C,rs1943063,1,T,C,74956163,192361,74951916,75345132,4247
16,ENSG00000184517.7,75148524,16-74956163-T-G,rs1943063,1,T,G,74956163,192361,74951916,75345132,4247
16,ENSG00000103111.10,77191190,16-77250116-A-G,rs1946282,1,A,G,77250116,58926,76994582,77387798,255534
16,ENSG00000103111.10,77191190,16-77250116-A-T,rs1946282,1,A,T,77250116,58926,76994582,77387798,255534
16,ENSG00000184110.9,28711464,16-28904112-A-T,rs2071342,1,A,T,28904112,192648,28514856,28908072,389256
16,ENSG00000184110.9,28711464,16-28904112-A-C,rs2071342,1,A,C,28904112,192648,28514856,28908072,389256
16,ENSG00000127561.8,1989970,16-1984660-T-C,rs2075812,1,T,C,1984660,5310,1793362,2186578,191298
16,ENSG00000127561.8,1989970,16-1984660-T-G,rs2075812,1,T,G,1984660,5310,1793362,2186578,191298
16,ENSG00000133393.8,15888603,16-15825677-C-T,rs216163,-1,C,T,15825677,62926,15691995,16085211,133682
16,ENSG00000133393.8,15888603,16-15825677-C-G,rs216163,-1,C,G,15825677,62926,15691995,16085211,133682
16,ENSG00000133393.8,15888603,16-15825677-C-A,rs216163,-1,C,A,15825677,62926,15691995,16085211,133682
16,ENSG00000010539.7,3235158,16-3289435-G-A,rs220379,-1,G,A,3289435,54277,3038550,3431766,250885
16,ENSG00000010539.7,3235158,16-3289435-G-C,rs220379,-1,G,C,3289435,54277,3038550,3431766,250885
16,ENSG00000010539.7,3235158,16-3289435-G-T,rs220379,-1,G,T,3289435,54277,3038550,3431766,250885
16,ENSG00000166548.10,66550122,16-66551708-T-C,rs2232722,-1,T,C,66551708,1586,66353514,66746730,198194
16,ENSG00000129910.3,89171748,16-89195074-C-G,rs2270416,1,C,G,89195074,23326,88975140,89368356,219934
16,ENSG00000129910.3,89171748,16-89195074-C-T,rs2270416,1,C,T,89195074,23326,88975140,89368356,219934
16,ENSG00000129910.3,89171748,16-89195074-C-A,rs2270416,1,C,A,89195074,23326,88975140,89368356,219934
16,ENSG00000171724.2,77788564,16-77932936-T-G,rs2435078,1,T,G,77932936,144372,77591956,77985172,340980
16,ENSG00000171724.2,77788564,16-77932936-T-A,rs2435078,1,T,A,77932936,144372,77591956,77985172,340980
16,ENSG00000171724.2,77788564,16-77932936-T-C,rs2435078,1,T,C,77932936,144372,77591956,77985172,340980
16,ENSG00000198736.7,1943199,16-2035679-C-T,rs2516781,-1,C,T,2035679,92480,1746591,2139807,289088
16,ENSG00000254206.1,29404029,16-29209997-T-C,rs252308,-1,T,C,29209997,194032,29207421,29600637,2576
16,ENSG00000254206.1,29404029,16-29209997-T-G,rs252308,-1,T,G,29209997,194032,29207421,29600637,2576
16,ENSG00000161980.5,53608,16-86259-A-G,rs2541622,-1,A,G,86259,32651,-143000,250216,229259
16,ENSG00000161980.5,53608,16-86259-A-C,rs2541622,-1,A,C,86259,32651,-143000,250216,229259
16,ENSG00000188536.7,172876,16-161106-T-A,rs2541645,1,T,A,161106,11770,-23732,369484,184838
16,ENSG00000188536.7,172876,16-161106-T-G,rs2541645,1,T,G,161106,11770,-23732,369484,184838
16,ENSG00000188536.7,172876,16-161106-T-C,rs2541645,1,T,C,161106,11770,-23732,369484,184838
16,ENSG00000206172.4,176680,16-161106-T-A,rs2541645,1,T,A,161106,15574,-19928,373288,181034
16,ENSG00000206172.4,176680,16-161106-T-G,rs2541645,1,T,G,161106,15574,-19928,373288,181034
16,ENSG00000206172.4,176680,16-161106-T-C,rs2541645,1,T,C,161106,15574,-19928,373288,181034
16,ENSG00000103023.7,58295025,16-58194797-C-G,rs2550364,-1,C,G,58194797,100228,58098417,58491633,96380
16,ENSG00000103023.7,58295025,16-58194797-C-T,rs2550364,-1,C,T,58194797,100228,58098417,58491633,96380
16,ENSG00000086504.10,370538,16-274052-A-T,rs2685126,-1,A,T,274052,96486,173930,567146,100122
16,ENSG00000086504.10,370538,16-274052-A-G,rs2685126,-1,A,G,274052,96486,173930,567146,100122
16,ENSG00000099381.12,30957754,16-31147326-C-T,rs28385574,1,C,T,31147326,189572,30761146,31154362,386180
16,ENSG00000159714.6,67416477,16-67344309-G-A,rs2885477,-1,G,A,67344309,72168,67219869,67613085,124440
16,ENSG00000159714.6,67416477,16-67344309-G-T,rs2885477,-1,G,T,67344309,72168,67219869,67613085,124440
16,ENSG00000156886.10,31393335,16-31381987-G-A,rs2929,1,G,A,31381987,11348,31196727,31589943,185260
16,ENSG00000162078.7,2830303,16-2729235-C-A,rs3094481,1,C,A,2729235,101068,2633695,3026911,95540
16,ENSG00000162078.7,2830303,16-2729235-C-G,rs3094481,1,C,G,2729235,101068,2633695,3026911,95540
16,ENSG00000162078.7,2830303,16-2729235-C-T,rs3094481,1,C,T,2729235,101068,2633695,3026911,95540
16,ENSG00000175595.9,13920154,16-13937309-T-C,rs3136161,1,T,C,13937309,17155,13723546,14116762,213763
16,ENSG00000103227.12,970984,16-974083-G-A,rs34319385,-1,G,A,974083,3099,774376,1167592,199707
16,ENSG00000149926.9,30031271,16-30068742-G-A,rs34429195,-1,G,A,30068742,37471,29834663,30227879,234079
16,ENSG00000103152.7,78225,16-76220-G-A,rs34456770,1,G,A,76220,2005,-118383,274833,194603
16,ENSG00000224470.2,71845976,16-71659137-T-C,rs35969776,1,T,C,71659137,186839,71649368,72042584,9769
16,ENSG00000224470.2,71845976,16-71659137-T-G,rs35969776,1,T,G,71659137,186839,71649368,72042584,9769
16,ENSG00000224470.2,71845976,16-71659137-T-A,rs35969776,1,T,A,71659137,186839,71649368,72042584,9769
16,ENSG00000169627.7,30193666,16-30162703-G-A,rs35983149,-1,G,A,30162703,30963,29997058,30390274,165645
16,ENSG00000067365.10,8621698,16-8554256-A-C,rs36048732,1,A,C,8554256,67442,8425090,8818306,129166
16,ENSG00000067365.10,8621698,16-8554256-A-G,rs36048732,1,A,G,8554256,67442,8425090,8818306,129166
16,ENSG00000155330.5,46831180,16-46740389-C-G,rs36463,-1,C,G,46740389,90791,46634572,47027788,105817
16,ENSG00000155330.5,46831180,16-46740389-C-T,rs36463,-1,C,T,46740389,90791,46634572,47027788,105817
16,ENSG00000131634.9,1533666,16-1655080-A-G,rs3743511,1,A,G,1655080,121414,1337058,1730274,318022
16,ENSG00000182831.7,9091644,16-9120023-A-C,rs3743832,1,A,C,9120023,28379,8895036,9288252,224987
16,ENSG00000182831.7,9091644,16-9120023-A-T,rs3743832,1,A,T,9120023,28379,8895036,9288252,224987
16,ENSG00000103199.8,4767162,16-4788616-T-C,rs3747608,-1,T,C,4788616,21454,4570554,4963770,218062
16,ENSG00000185324.17,89686689,16-89685786-G-A,rs3751700,1,G,A,89685786,903,89490081,89883297,195705
16,ENSG00000242612.1,401885,16-424180-G-A,rs3760048,1,G,A,424180,22295,205277,598493,218903
16,ENSG00000162004.10,726443,16-790597-C-T,rs3765265,-1,C,T,790597,64154,529835,923051,260762
16,ENSG00000103150.4,83899115,16-83901550-A-G,rs3785006,1,A,G,83901550,2435,83702507,84095723,199043
16,ENSG00000103150.4,83899115,16-83901550-A-T,rs3785006,1,A,T,83901550,2435,83702507,84095723,199043
16,ENSG00000196408.7,1981469,16-1982407-G-A,rs3785272,-1,G,A,1982407,938,1784861,2178077,197546
16,ENSG00000007376.3,788381,16-714040-G-A,rs3809663,-1,G,A,714040,74341,591773,984989,122267
16,ENSG00000140682.14,31472152,16-31459219-T-A,rs3813002,1,T,A,31459219,12933,31275544,31668760,183675
16,ENSG00000140682.14,31472152,16-31459219-T-C,rs3813002,1,T,C,31459219,12933,31275544,31668760,183675
16,ENSG00000157423.12,71230722,16-71339145-G-A,rs3826248,-1,G,A,71339145,108423,71034114,71427330,305031
16,ENSG00000157423.12,71230722,16-71339145-G-T,rs3826248,-1,G,T,71339145,108423,71034114,71427330,305031
16,ENSG00000169203.11,29499452,16-29667246-T-C,rs3851019,-1,T,C,29667246,167794,29302844,29696060,364402
16,ENSG00000103061.6,68310946,16-68283733-G-T,rs3961283,-1,G,T,68283733,27213,68114338,68507554,169395
16,ENSG00000103061.6,68310946,16-68283733-G-A,rs3961283,-1,G,A,68283733,27213,68114338,68507554,169395
16,ENSG00000103061.6,68310946,16-68283733-G-C,rs3961283,-1,G,C,68283733,27213,68114338,68507554,169395
16,ENSG00000140990.10,1959538,16-1960137-G-A,rs397435,1,G,A,1960137,599,1762930,2156146,197207
16,ENSG00000168404.8,74700862,16-74672838-A-C,rs4072222,-1,A,C,74672838,28024,74504254,74897470,168584
16,ENSG00000168404.8,74700862,16-74672838-A-G,rs4072222,-1,A,G,74672838,28024,74504254,74897470,168584
16,ENSG00000140945.10,82626969,16-82680269-C-T,rs4081995,1,C,T,82680269,53300,82430361,82823577,249908
16,ENSG00000140945.10,82626969,16-82680269-C-G,rs4081995,1,C,G,82680269,53300,82430361,82823577,249908
16,ENSG00000140945.10,82626969,16-82680269-C-A,rs4081995,1,C,A,82680269,53300,82430361,82823577,249908
16,ENSG00000064270.7,84368538,16-84482703-G-C,rs433293,1,G,C,84482703,114165,84171930,84565146,310773
16,ENSG00000064270.7,84368538,16-84482703-G-A,rs433293,1,G,A,84482703,114165,84171930,84565146,310773
16,ENSG00000140795.8,46748344,16-46763256-C-G,rs4401068,-1,C,G,46763256,14912,46551736,46944952,211520
16,ENSG00000140795.8,46748344,16-46763256-C-T,rs4401068,-1,C,T,46763256,14912,46551736,46944952,211520
16,ENSG00000180185.7,1826941,16-1881055-T-A,rs4420529,1,T,A,1881055,54114,1630333,2023549,250722
16,ENSG00000180185.7,1826941,16-1881055-T-C,rs4420529,1,T,C,1881055,54114,1630333,2023549,250722
16,ENSG00000180185.7,1826941,16-1881055-T-G,rs4420529,1,T,G,1881055,54114,1630333,2023549,250722
16,ENSG00000204991.6,89828475,16-89972378-C-G,rs4424910,1,C,G,89972378,143903,89631867,90025083,340511
16,ENSG00000204991.6,89828475,16-89972378-C-A,rs4424910,1,C,A,89972378,143903,89631867,90025083,340511
16,ENSG00000204991.6,89828475,16-89972378-C-T,rs4424910,1,C,T,89972378,143903,89631867,90025083,340511
16,ENSG00000159792.4,67893254,16-67724875-C-T,rs4474673,1,C,T,67724875,168379,67696646,68089862,28229
16,ENSG00000141098.7,67719316,16-67724875-C-T,rs4474673,-1,C,T,67724875,5559,67522708,67915924,202167
16,ENSG00000179965.7,30407606,16-30365370-G-A,rs4500754,1,G,A,30365370,42236,30210998,30604214,154372
16,ENSG00000153066.7,11742857,16-11644181-C-A,rs4510029,-1,C,A,11644181,98676,11546249,11939465,97932
16,ENSG00000153066.7,11742857,16-11644181-C-T,rs4510029,-1,C,T,11644181,98676,11546249,11939465,97932
16,ENSG00000181938.9,58392471,16-58410750-A-G,rs4784933,1,A,G,58410750,18279,58195863,58589079,214887
16,ENSG00000213937.3,3012923,16-2971115-T-C,rs4786365,1,T,C,2971115,41808,2816315,3209531,154800
16,ENSG00000140832.5,71626184,16-71600908-A-C,rs4788815,1,A,C,71600908,25276,71429576,71822792,171332
16,ENSG00000140832.5,71626184,16-71600908-A-G,rs4788815,1,A,G,71600908,25276,71429576,71822792,171332
16,ENSG00000140832.5,71626184,16-71600908-A-T,rs4788815,1,A,T,71600908,25276,71429576,71822792,171332
16,ENSG00000102886.10,30113537,16-30018771-G-A,rs56329348,-1,G,A,30018771,94766,29916929,30310145,101842
16,ENSG00000005187.7,20764014,16-20705964-G-A,rs57286237,1,G,A,20705964,58050,20567406,20960622,138558
16,ENSG00000126856.8,90077331,16-90079880-T-G,rs57932945,-1,T,G,90079880,2549,89880723,90273939,199157
16,ENSG00000126856.8,90077331,16-90079880-T-A,rs57932945,-1,T,A,90079880,2549,89880723,90273939,199157
16,ENSG00000126856.8,90077331,16-90079880-T-C,rs57932945,-1,T,C,90079880,2549,89880723,90273939,199157
16,ENSG00000258429.1,69330588,16-69454281-G-A,rs59651448,-1,G,A,69454281,123693,69133980,69527196,320301
16,ENSG00000059122.12,2911931,16-2923567-A-G,rs62032310,1,A,G,2923567,11636,2715323,3108539,208244
16,ENSG00000162073.9,2969348,16-2923567-A-G,rs62032310,1,A,G,2923567,45781,2772740,3165956,150827
16,ENSG00000063854.7,1826825,16-1837251-T-C,rs62038400,-1,T,C,1837251,10426,1630217,2023433,207034
16,ENSG00000063854.7,1826825,16-1837251-T-G,rs62038400,-1,T,G,1837251,10426,1630217,2023433,207034
16,ENSG00000006007.7,19522098,16-19467430-G-A,rs6497378,-1,G,A,19467430,54668,19325490,19718706,141940
16,ENSG00000103550.9,19718227,16-19864770-C-T,rs6497415,-1,C,T,19864770,146543,19521619,19914835,343151
16,ENSG00000103550.9,19718227,16-19864770-C-A,rs6497415,-1,C,A,19864770,146543,19521619,19914835,343151
16,ENSG00000158717.6,88706408,16-88737574-C-A,rs6500493,-1,C,A,88737574,31166,88509800,88903016,227774
16,ENSG00000158717.6,88706408,16-88737574-C-G,rs6500493,-1,C,G,88737574,31166,88509800,88903016,227774
16,ENSG00000158717.6,88706408,16-88737574-C-T,rs6500493,-1,C,T,88737574,31166,88509800,88903016,227774
16,ENSG00000153406.9,4474625,16-4447536-G-T,rs6500603,-1,G,T,4447536,27089,4278017,4671233,169519
16,ENSG00000153406.9,4474625,16-4447536-G-C,rs6500603,-1,G,C,4447536,27089,4278017,4671233,169519
16,ENSG00000090863.7,74607114,16-74467958-C-G,rs6564117,-1,C,G,74467958,139156,74410506,74803722,57452
16,ENSG00000149925.12,30065760,16-30163605-T-C,rs6565176,1,T,C,30163605,97845,29869152,30262368,294453
16,ENSG00000149925.12,30065760,16-30163605-T-A,rs6565176,1,T,A,30163605,97845,29869152,30262368,294453
16,ENSG00000149925.12,30065760,16-30163605-T-G,rs6565176,1,T,G,30163605,97845,29869152,30262368,294453
16,ENSG00000167965.12,2205454,16-2395362-A-G,rs6600202,1,A,G,2395362,189908,2008846,2402062,386516
16,ENSG00000156968.7,15395754,16-15403697-A-G,rs66615285,1,A,G,15403697,7943,15199146,15592362,204551
16,ENSG00000003249.8,90019456,16-90014444-C-T,rs66701606,-1,C,T,90014444,5012,89822848,90216064,191596
16,ENSG00000162062.10,2460109,16-2598650-G-T,rs71386677,1,G,T,2598650,138541,2263501,2656717,335149
16,ENSG00000174943.5,29926226,16-29895706-C-T,rs71389435,-1,C,T,29895706,30520,29729618,30122834,166088
16,ENSG00000183196.4,75495441,16-75446399-T-A,rs7186825,-1,T,A,75446399,49042,75298833,75692049,147566
16,ENSG00000183196.4,75495441,16-75446399-T-C,rs7186825,-1,T,C,75446399,49042,75298833,75692049,147566
16,ENSG00000184939.8,68539291,16-68611951-C-A,rs7188915,1,C,A,68611951,72660,68342683,68735899,269268
16,ENSG00000184939.8,68539291,16-68611951-C-T,rs7188915,1,C,T,68611951,72660,68342683,68735899,269268
16,ENSG00000140835.7,71526426,16-71611767-A-G,rs7205340,1,A,G,71611767,85341,71329818,71723034,281949
16,ENSG00000140835.7,71526426,16-71611767-A-T,rs7205340,1,A,T,71611767,85341,71329818,71723034,281949
16,ENSG00000140836.9,73048128,16-72903709-C-T,rs7205502,-1,C,T,72903709,144419,72851520,73244736,52189
16,ENSG00000103269.9,675671,16-748536-C-A,rs72773434,1,C,A,748536,72865,479063,872279,269473
16,ENSG00000103021.5,58249936,16-58295465-C-T,rs72786184,1,C,T,58295465,45529,58053328,58446544,242137
16,ENSG00000197272.2,28506834,16-28640411-C-T,rs72793807,-1,C,T,28640411,133577,28310226,28703442,330185
16,ENSG00000149927.13,30011027,16-29922569-C-T,rs72798151,-1,C,T,29922569,88458,29814419,30207635,108150
16,ENSG00000141012.7,88856947,16-88913584-C-G,rs72815512,-1,C,G,88913584,56637,88660339,89053555,253245
16,ENSG00000141012.7,88856947,16-88913584-C-T,rs72815512,-1,C,T,88913584,56637,88660339,89053555,253245
16,ENSG00000161981.6,53828,16-112241-G-A,rs74614704,1,G,A,112241,58413,-142780,250436,255021
16,ENSG00000167526.9,89560682,16-89464901-C-T,rs74829481,1,C,T,89464901,95781,89364074,89757290,100827
16,ENSG00000198931.6,88811928,16-88839558-G-A,rs74837608,-1,G,A,88839558,27630,88615320,89008536,224238
16,ENSG00000198931.6,88811928,16-88839558-G-T,rs74837608,-1,G,T,88839558,27630,88615320,89008536,224238
16,ENSG00000185669.5,88686507,16-88839558-G-A,rs74837608,-1,G,A,88839558,153051,88489899,88883115,349659
16,ENSG00000185669.5,88686507,16-88839558-G-T,rs74837608,-1,G,T,88839558,153051,88489899,88883115,349659
16,ENSG00000225614.2,88382959,16-88255683-G-A,rs7499319,1,G,A,88255683,127276,88186351,88579567,69332
16,ENSG00000225614.2,88382959,16-88255683-G-C,rs7499319,1,G,C,88255683,127276,88186351,88579567,69332
16,ENSG00000225614.2,88382959,16-88255683-G-T,rs7499319,1,G,T,88255683,127276,88186351,88579567,69332
16,ENSG00000140955.6,84191157,16-84238932-A-G,rs75063301,1,A,G,84238932,47775,83994549,84387765,244383
16,ENSG00000141101.7,69754926,16-69890316-A-G,rs75109048,-1,A,G,69890316,135390,69558318,69951534,331998
16,ENSG00000103495.8,29806529,16-29887802-G-T,rs75331747,1,G,T,29887802,81273,29609921,30003137,277881
16,ENSG00000162076.8,2883215,16-2913316-G-C,rs757165,1,G,C,2913316,30101,2686607,3079823,226709
16,ENSG00000162076.8,2883215,16-2913316-G-T,rs757165,1,G,T,2913316,30101,2686607,3079823,226709
16,ENSG00000162076.8,2883215,16-2913316-G-A,rs757165,1,G,A,2913316,30101,2686607,3079823,226709
16,ENSG00000167962.8,2009821,16-1961125-A-T,rs758335,-1,A,T,1961125,48696,1813213,2206429,147912
16,ENSG00000167962.8,2009821,16-1961125-A-G,rs758335,-1,A,G,1961125,48696,1813213,2206429,147912
16,ENSG00000168807.11,69187164,16-69382756-T-C,rs75927521,1,T,C,69382756,195592,68990556,69383772,392200
16,ENSG00000006194.6,3283491,16-3467427-A-T,rs76498019,1,A,T,3467427,183936,3086883,3480099,380544
16,ENSG00000006194.6,3283491,16-3467427-A-C,rs76498019,1,A,C,3467427,183936,3086883,3480099,380544
16,ENSG00000008517.12,3065640,16-3065324-G-C,rs76580947,1,G,C,3065324,316,2869032,3262248,196292
16,ENSG00000008517.12,3065640,16-3065324-G-T,rs76580947,1,G,T,3065324,316,2869032,3262248,196292
16,ENSG00000158545.10,88570403,16-88736178-G-T,rs76834910,1,G,T,88736178,165775,88373795,88767011,362383
16,ENSG00000103534.11,19417883,16-19269766-T-C,rs77108238,1,T,C,19269766,148117,19221275,19614491,48491
16,ENSG00000176723.5,31442789,16-31522425-A-G,rs77263422,-1,A,G,31522425,79636,31246181,31639397,276244
16,ENSG00000174109.3,1420747,16-1338908-C-A,rs77633104,-1,C,A,1338908,81839,1224139,1617355,114769
16,ENSG00000174109.3,1420747,16-1338908-C-T,rs77633104,-1,C,T,1338908,81839,1224139,1617355,114769
16,ENSG00000174109.3,1420747,16-1338908-C-G,rs77633104,-1,C,G,1338908,81839,1224139,1617355,114769
16,ENSG00000102858.7,4624826,16-4482066-G-C,rs77771788,1,G,C,4482066,142760,4428218,4821434,53848
16,ENSG00000168701.13,67227130,16-67277715-C-G,rs78132437,1,C,G,67277715,50585,67030522,67423738,247193
16,ENSG00000149929.10,29995617,16-30120456-G-A,rs78564187,-1,G,A,30120456,124839,29799009,30192225,321447
16,ENSG00000126602.6,3717524,16-3590783-G-A,rs78637028,-1,G,A,3590783,126741,3520916,3914132,69867
16,ENSG00000213398.3,67944120,16-67958069-C-A,rs78818722,-1,C,A,67958069,13949,67747512,68140728,210557
16,ENSG00000213398.3,67944120,16-67958069-C-T,rs78818722,-1,C,T,67958069,13949,67747512,68140728,210557
16,ENSG00000038358.10,67873052,16-67958069-C-A,rs78818722,1,C,A,67958069,85017,67676444,68069660,281625
16,ENSG00000038358.10,67873052,16-67958069-C-T,rs78818722,1,C,T,67958069,85017,67676444,68069660,281625
16,ENSG00000140986.7,1954689,16-1947384-C-G,rs79075024,-1,C,G,1947384,7305,1758081,2151297,189303
16,ENSG00000140986.7,1954689,16-1947384-C-T,rs79075024,-1,C,T,1947384,7305,1758081,2151297,189303
16,ENSG00000188827.6,3611606,16-3606624-G-C,rs79842542,-1,G,C,3606624,4982,3414998,3808214,191626
16,ENSG00000188827.6,3611606,16-3606624-G-A,rs79842542,-1,G,A,3606624,4982,3414998,3808214,191626
16,ENSG00000197943.5,81779291,16-81842674-G-T,rs8043593,1,G,T,81842674,63383,81582683,81975899,259991
16,ENSG00000197943.5,81779291,16-81842674-G-C,rs8043593,1,G,C,81842674,63383,81582683,81975899,259991
16,ENSG00000103222.13,15949616,16-15869644-T-A,rs8044313,1,T,A,15869644,79972,15753008,16146224,116636
16,ENSG00000103222.13,15949616,16-15869644-T-C,rs8044313,1,T,C,15869644,79972,15753008,16146224,116636
16,ENSG00000125166.7,58734316,16-58830640-G-C,rs8046516,-1,G,C,58830640,96324,58537708,58930924,292932
16,ENSG00000125166.7,58734316,16-58830640-G-A,rs8046516,-1,G,A,58830640,96324,58537708,58930924,292932
16,ENSG00000051523.6,88651053,16-88685120-T-A,rs8048658,-1,T,A,88685120,34067,88454445,88847661,230675
16,ENSG00000051523.6,88651053,16-88685120-T-G,rs8048658,-1,T,G,88685120,34067,88454445,88847661,230675
16,ENSG00000140854.8,57735770,16-57603822-A-G,rs8048880,1,A,G,57603822,131948,57539162,57932378,64660
16,ENSG00000187741.9,89816647,16-89957794-G-A,rs8049897,-1,G,A,89957794,141147,89620039,90013255,337755
16,ENSG00000169955.6,30534858,16-30542838-G-C,rs8050463,-1,G,C,30542838,7980,30338250,30731466,204588
16,ENSG00000169955.6,30534858,16-30542838-G-A,rs8050463,-1,G,A,30542838,7980,30338250,30731466,204588
16,ENSG00000103056.7,68448508,16-68394423-A-C,rs8050499,-1,A,C,68394423,54085,68251900,68645116,142523
16,ENSG00000103056.7,68448508,16-68394423-A-G,rs8050499,-1,A,G,68394423,54085,68251900,68645116,142523
16,ENSG00000087250.4,56589528,16-56615725-C-T,rs8055724,1,C,T,56615725,26197,56392920,56786136,222805
16,ENSG00000011638.6,21158674,16-21178771-G-A,rs8055894,1,G,A,21178771,20097,20962066,21355282,216705
16,ENSG00000103257.4,87869507,16-87875812-T-C,rs8058344,-1,T,C,87875812,6305,87672899,88066115,202913
16,ENSG00000103257.4,87869507,16-87875812-T-A,rs8058344,-1,T,A,87875812,6305,87672899,88066115,202913
16,ENSG00000103257.4,87869507,16-87875812-T-G,rs8058344,-1,T,G,87875812,6305,87672899,88066115,202913
16,ENSG00000103089.4,74774820,16-74796446-C-T,rs8060911,-1,C,T,74796446,21626,74578212,74971428,218234
16,ENSG00000205336.6,57628630,16-57602393-C-T,rs8062400,1,C,T,57602393,26237,57432022,57825238,170371
16,ENSG00000005194.10,57447385,16-57389946-C-T,rs8063316,-1,C,T,57389946,57439,57250777,57643993,139169
16,ENSG00000051108.10,56932142,16-56883257-G-C,rs8063406,1,G,C,56883257,48885,56735534,57128750,147723
16,ENSG00000051108.10,56932142,16-56883257-G-T,rs8063406,1,G,T,56883257,48885,56735534,57128750,147723
16,ENSG00000051108.10,56932142,16-56883257-G-A,rs8063406,1,G,A,56883257,48885,56735534,57128750,147723
16,ENSG00000103066.8,68245373,16-68310460-A-C,rs8063446,1,A,C,68310460,65087,68048765,68441981,261695
16,ENSG00000141002.11,89873592,16-90023055-C-G,rs870856,1,C,G,90023055,149463,89676984,90070200,346071
16,ENSG00000183723.7,66696743,16-66573285-A-G,rs896086,-1,A,G,66573285,123458,66500135,66893351,73150
16,ENSG00000152910.13,76277401,16-76300776-G-A,rs929853,1,G,A,76300776,23375,76080793,76474009,219983
16,ENSG00000152910.13,76277401,16-76300776-G-T,rs929853,1,G,T,76300776,23375,76080793,76474009,219983
16,ENSG00000077238.8,27313974,16-27199745-T-C,rs9652596,1,T,C,27199745,114229,27117366,27510582,82379
16,ENSG00000132600.11,68311019,16-68296094-G-A,rs9788810,1,G,A,68296094,14925,68114411,68507627,181683
16,ENSG00000140740.6,21953361,16-22073022-G-T,rs9788908,1,G,T,22073022,119661,21756753,22149969,316269
16,ENSG00000140740.6,21953361,16-22073022-G-A,rs9788908,1,G,A,22073022,119661,21756753,22149969,316269
16,ENSG00000167191.6,19884848,16-20045947-C-T,rs9923019,-1,C,T,20045947,161099,19688240,20081456,357707
16,ENSG00000140876.7,77722514,16-77681143-T-A,rs9930144,1,T,A,77681143,41371,77525906,77919122,155237
16,ENSG00000140876.7,77722514,16-77681143-T-C,rs9930144,1,T,C,77681143,41371,77525906,77919122,155237
16,ENSG00000169957.7,30526566,16-30492093-T-G,rs9930280,-1,T,G,30492093,34473,30329958,30723174,162135
16,ENSG00000197912.8,89508403,16-89561665-G-T,rs9930567,1,G,T,89561665,53262,89311795,89705011,249870
16,ENSG00000197912.8,89508403,16-89561665-G-A,rs9930567,1,G,A,89561665,53262,89311795,89705011,249870
16,ENSG00000127585.7,705801,16-666287-C-A,rs9934288,-1,C,A,666287,39514,509193,902409,157094
16,ENSG00000122257.14,24539566,16-24553800-T-G,rs9937985,1,T,G,24553800,14234,24342958,24736174,210842
16,ENSG00000067836.7,4802633,16-4827552-G-A,rs9938805,-1,G,A,4827552,24919,4606025,4999241,221527
16,ENSG00000067836.7,4802633,16-4827552-G-T,rs9938805,-1,G,T,4827552,24919,4606025,4999241,221527
16,ENSG00000166454.5,81035842,16-80994080-T-G,rs9939934,1,T,G,80994080,41762,80839234,81232450,154846
16,ENSG00000166454.5,81035842,16-80994080-T-C,rs9939934,1,T,C,80994080,41762,80839234,81232450,154846
15,ENSG00000166140.12,40807089,15-40811095-A-G,rs10152371,1,A,G,40811095,4006,40610481,41003697,200614
15,ENSG00000166140.12,40807089,15-40811095-A-C,rs10152371,1,A,C,40811095,4006,40610481,41003697,200614
15,ENSG00000129028.4,70892433,15-71074673-C-A,rs10438292,-1,C,A,71074673,182240,70695825,71089041,378848
15,ENSG00000129028.4,70892433,15-71074673-C-T,rs10438292,-1,C,T,71074673,182240,70695825,71089041,378848
15,ENSG00000129028.4,70892433,15-71074673-C-G,rs10438292,-1,C,G,71074673,182240,70695825,71089041,378848
15,ENSG00000186073.7,36579626,15-36711692-G-T,rs10468086,1,G,T,36711692,132066,36383018,36776234,328674
15,ENSG00000186073.7,36579626,15-36711692-G-A,rs10468086,1,G,A,36711692,132066,36383018,36776234,328674
15,ENSG00000041357.11,78540444,15-78549011-T-C,rs1052035,1,T,C,78549011,8567,78343836,78737052,205175
15,ENSG00000183208.8,90234209,15-90273107-C-T,rs1059495,1,C,T,90273107,38898,90037601,90430817,235506
15,ENSG00000157450.11,58987663,15-58893557-C-T,rs1079087,1,C,T,58893557,94106,58791055,59184271,102502
15,ENSG00000167202.6,78077711,15-77985989-A-G,rs10851899,-1,A,G,77985989,91722,77881103,78274319,104886
15,ENSG00000167202.6,78077711,15-77985989-A-C,rs10851899,-1,A,C,77985989,91722,77881103,78274319,104886
15,ENSG00000167202.6,78077711,15-77985989-A-T,rs10851899,-1,A,T,77985989,91722,77881103,78274319,104886
15,ENSG00000128829.6,39934115,15-40025591-T-C,rs11070245,1,T,C,40025591,91476,39737507,40130723,288084
15,ENSG00000128829.6,39934115,15-40025591-T-G,rs11070245,1,T,G,40025591,91476,39737507,40130723,288084
15,ENSG00000171989.4,59206843,15-59290430-C-T,rs11071425,1,C,T,59290430,83587,59010235,59403451,280195
15,ENSG00000171989.4,59206843,15-59290430-C-A,rs11071425,1,C,A,59290430,83587,59010235,59403451,280195
15,ENSG00000178802.12,74890042,15-74942269-T-A,rs11072518,1,T,A,74942269,52227,74693434,75086650,248835
15,ENSG00000178802.12,74890042,15-74942269-T-C,rs11072518,1,T,C,74942269,52227,74693434,75086650,248835
15,ENSG00000178802.12,74890042,15-74942269-T-G,rs11072518,1,T,G,74942269,52227,74693434,75086650,248835
15,ENSG00000183496.5,82046018,15-81887952-A-G,rs11073021,-1,A,G,81887952,158066,81849410,82242626,38542
15,ENSG00000183496.5,82046018,15-81887952-A-T,rs11073021,-1,A,T,81887952,158066,81849410,82242626,38542
15,ENSG00000182175.9,93089211,15-93205093-A-G,rs11074151,-1,A,G,93205093,115882,92892603,93285819,312490
15,ENSG00000182175.9,93089211,15-93205093-A-T,rs11074151,-1,A,T,93205093,115882,92892603,93285819,312490
15,ENSG00000140525.13,89243979,15-89192987-C-T,rs1109794,1,C,T,89192987,50992,89047371,89440587,145616
15,ENSG00000140525.13,89243979,15-89192987-C-G,rs1109794,1,C,G,89192987,50992,89047371,89440587,145616
15,ENSG00000103647.8,68578993,15-68731330-G-T,rs115701798,1,G,T,68731330,152337,68382385,68775601,348945
15,ENSG00000103647.8,68578993,15-68731330-G-A,rs115701798,1,G,A,68731330,152337,68382385,68775601,348945
15,ENSG00000140450.7,97960703,15-97961563-C-T,rs115948118,1,C,T,97961563,860,97764095,98157311,197468
15,ENSG00000103740.5,78234565,15-78214974-G-A,rs11629576,-1,G,A,78214974,19591,78037957,78431173,177017
15,ENSG00000136379.7,80695310,15-80692946-A-G,rs11629662,1,A,G,80692946,2364,80498702,80891918,194244
15,ENSG00000138623.5,74433958,15-74627252-C-T,rs11629749,-1,C,T,74627252,193294,74237350,74630566,389902
15,ENSG00000138623.5,74433958,15-74627252-C-G,rs11629749,-1,C,G,74627252,193294,74237350,74630566,389902
15,ENSG00000129009.8,74173710,15-74179953-A-G,rs11631944,1,A,G,74179953,6243,73977102,74370318,202851
15,ENSG00000183655.10,85794925,15-85711256-T-C,rs11632005,-1,T,C,85711256,83669,85598317,85991533,112939
15,ENSG00000183655.10,85794925,15-85711256-T-G,rs11632005,-1,T,G,85711256,83669,85598317,85991533,112939
15,ENSG00000068305.12,99565984,15-99514532-A-G,rs11636538,1,A,G,99514532,51452,99369376,99762592,145156
15,ENSG00000068305.12,99565984,15-99514532-A-T,rs11636538,1,A,T,99514532,51452,99369376,99762592,145156
15,ENSG00000068305.12,99565984,15-99514532-A-C,rs11636538,1,A,C,99514532,51452,99369376,99762592,145156
15,ENSG00000103811.10,78945046,15-78939176-A-T,rs11638844,-1,A,T,78939176,5870,78748438,79141654,190738
15,ENSG00000103811.10,78945046,15-78939176-A-G,rs11638844,-1,A,G,78939176,5870,78748438,79141654,190738
15,ENSG00000198690.5,30903915,15-30889629-C-T,rs116880342,1,C,T,30889629,14286,30707307,31100523,182322
15,ENSG00000140382.10,77420888,15-77259074-G-A,rs116902949,1,G,A,77259074,161814,77224280,77617496,34794
15,ENSG00000229474.2,44711323,15-44670486-C-T,rs117096146,-1,C,T,44670486,40837,44514715,44907931,155771
15,ENSG00000261652.2,55408495,15-55371912-G-C,rs117236526,1,G,C,55371912,36583,55211887,55605103,160025
15,ENSG00000128973.7,68229728,15-68055369-A-G,rs117764220,-1,A,G,68055369,174359,68033120,68426336,22249
15,ENSG00000248905.4,33194714,15-33029351-G-A,rs117877616,-1,G,A,33029351,165363,32998106,33391322,31245
15,ENSG00000248905.4,33194714,15-33029351-G-C,rs117877616,-1,G,C,33029351,165363,32998106,33391322,31245
15,ENSG00000256061.3,55508234,15-55441018-A-G,rs118119547,-1,A,G,55441018,67216,55311626,55704842,129392
15,ENSG00000196391.6,90352284,15-90543636-T-G,rs11853611,1,T,G,90543636,191352,90155676,90548892,387960
15,ENSG00000104055.10,43266928,15-43265351-A-G,rs11853991,-1,A,G,43265351,1577,43070320,43463536,195031
15,ENSG00000104055.10,43266928,15-43265351-A-T,rs11853991,-1,A,T,43265351,1577,43070320,43463536,195031
15,ENSG00000197535.9,52528880,15-52482071-A-G,rs11855082,-1,A,G,52482071,46809,52332272,52725488,149799
15,ENSG00000166965.8,90954884,15-90946475-G-A,rs11857545,1,G,A,90946475,8409,90758276,91151492,188199
15,ENSG00000138613.9,63277605,15-63278141-T-A,rs11858705,1,T,A,63278141,536,63080997,63474213,197144
15,ENSG00000138613.9,63277605,15-63278141-T-C,rs11858705,1,T,C,63278141,536,63080997,63474213,197144
15,ENSG00000138613.9,63277605,15-63278141-T-G,rs11858705,1,T,G,63278141,536,63080997,63474213,197144
15,ENSG00000185043.6,90233941,15-90277489-C-T,rs11910,-1,C,T,90277489,43548,90037333,90430549,240156
15,ENSG00000103932.6,41544257,15-41527518-C-A,rs1200345,-1,C,A,41527518,16739,41347649,41740865,179869
15,ENSG00000103932.6,41544257,15-41527518-C-G,rs1200345,-1,C,G,41527518,16739,41347649,41740865,179869
15,ENSG00000103932.6,41544257,15-41527518-C-T,rs1200345,-1,C,T,41527518,16739,41347649,41740865,179869
15,ENSG00000174446.7,66497762,15-66458277-A-G,rs12050732,-1,A,G,66458277,39485,66301154,66694370,157123
15,ENSG00000174446.7,66497762,15-66458277-A-C,rs12050732,-1,A,C,66458277,39485,66301154,66694370,157123
15,ENSG00000174446.7,66497762,15-66458277-A-T,rs12050732,-1,A,T,66458277,39485,66301154,66694370,157123
15,ENSG00000166035.6,58431991,15-58391211-C-T,rs12185072,1,C,T,58391211,40780,58235383,58628599,155828
15,ENSG00000166035.6,58431991,15-58391211-C-A,rs12185072,1,C,A,58391211,40780,58235383,58628599,155828
15,ENSG00000140577.10,90529923,15-90391576-G-A,rs12437529,1,G,A,90391576,138347,90333315,90726531,58261
15,ENSG00000171766.10,45378544,15-45344469-T-A,rs12439274,-1,T,A,45344469,34075,45181936,45575152,162533
15,ENSG00000171766.10,45378544,15-45344469-T-G,rs12439274,-1,T,G,45344469,34075,45181936,45575152,162533
15,ENSG00000171766.10,45378544,15-45344469-T-C,rs12439274,-1,T,C,45344469,34075,45181936,45575152,162533
15,ENSG00000180979.5,42548793,15-42451896-A-G,rs12440118,-1,A,G,42451896,96897,42352185,42745401,99711
15,ENSG00000066933.10,72118150,15-72055549-T-C,rs12441217,-1,T,C,72055549,62601,71921542,72314758,134007
15,ENSG00000170776.14,85380603,15-85563566-A-C,rs12442591,1,A,C,85563566,182963,85183995,85577211,379571
15,ENSG00000170776.14,85380603,15-85563566-A-T,rs12442591,1,A,T,85563566,182963,85183995,85577211,379571
15,ENSG00000173575.10,92900324,15-92984785-C-T,rs12592212,1,C,T,92984785,84461,92703716,93096932,281069
15,ENSG00000137770.9,44427629,15-44589757-C-T,rs12594924,1,C,T,44589757,162128,44231021,44624237,358736
15,ENSG00000137834.9,66702236,15-66602953-C-T,rs12595240,1,C,T,66602953,99283,66505628,66898844,97325
15,ENSG00000067221.9,73992295,15-73954581-A-C,rs12899085,-1,A,C,73954581,37714,73795687,74188903,158894
15,ENSG00000067221.9,73992295,15-73954581-A-G,rs12899085,-1,A,G,73954581,37714,73795687,74188903,158894
15,ENSG00000067221.9,73992295,15-73954581-A-T,rs12899085,-1,A,T,73954581,37714,73795687,74188903,158894
15,ENSG00000064726.5,83067252,15-83031915-A-C,rs12900411,-1,A,C,83031915,35337,82870644,83263860,161271
15,ENSG00000064726.5,83067252,15-83031915-A-G,rs12900411,-1,A,G,83031915,35337,82870644,83263860,161271
15,ENSG00000140479.12,101489707,15-101392873-G-A,rs12903394,-1,G,A,101392873,96834,101293099,101686315,99774
15,ENSG00000140479.12,101489707,15-101392873-G-T,rs12903394,-1,G,T,101392873,96834,101293099,101686315,99774
15,ENSG00000140479.12,101489707,15-101392873-G-C,rs12903394,-1,G,C,101392873,96834,101293099,101686315,99774
15,ENSG00000197978.8,82429816,15-82288923-T-G,rs12905578,1,T,G,82288923,140893,82233208,82626424,55715
15,ENSG00000197978.8,82429816,15-82288923-T-A,rs12905578,1,T,A,82288923,140893,82233208,82626424,55715
15,ENSG00000166262.10,49620818,15-49715151-A-C,rs12906463,-1,A,C,49715151,94333,49424210,49817426,290941
15,ENSG00000186628.8,82806069,15-82825299-T-C,rs12907810,-1,T,C,82825299,19230,82609461,83002677,215838
15,ENSG00000156970.7,40161069,15-40168024-G-T,rs12911157,1,G,T,40168024,6955,39964461,40357677,203563
15,ENSG00000137869.8,51338596,15-51250560-C-T,rs12911554,-1,C,T,51250560,88036,51141988,51535204,108572
15,ENSG00000137869.8,51338596,15-51250560-C-G,rs12911554,-1,C,G,51250560,88036,51141988,51535204,108572
15,ENSG00000104043.10,50119233,15-50138890-C-T,rs12915287,-1,C,T,50138890,19657,49922625,50315841,216265
15,ENSG00000140374.11,76311469,15-76187068-C-T,rs13379729,-1,C,T,76187068,124401,76114861,76508077,72207
15,ENSG00000140374.11,76311469,15-76187068-C-A,rs13379729,-1,C,A,76187068,124401,76114861,76508077,72207
15,ENSG00000092439.8,50686797,15-50586312-T-C,rs1395297,-1,T,C,50586312,100485,50490189,50883405,96123
15,ENSG00000128944.8,40382721,15-40437201-A-G,rs1453184,1,A,G,40437201,54480,40186113,40579329,251088
15,ENSG00000185880.8,44736528,15-44670026-C-T,rs146795158,1,C,T,44670026,66502,44539920,44933136,130106
15,ENSG00000166949.10,67065602,15-67100318-G-A,rs1530061,1,G,A,67100318,34716,66868994,67262210,231324
15,ENSG00000137877.8,41894053,15-41897998-C-T,rs1672461,-1,C,T,41897998,3945,41697445,42090661,200553
15,ENSG00000140511.7,88895544,15-88861821-C-G,rs16942383,-1,C,G,88861821,33723,88698936,89092152,162885
15,ENSG00000140511.7,88895544,15-88861821-C-T,rs16942383,-1,C,T,88861821,33723,88698936,89092152,162885
15,ENSG00000140511.7,88895544,15-88861821-C-A,rs16942383,-1,C,A,88861821,33723,88698936,89092152,162885
15,ENSG00000074621.8,65621938,15-65638545-A-G,rs16948889,1,A,G,65638545,16607,65425330,65818546,213215
15,ENSG00000166938.8,66293568,15-66238394-G-T,rs16949724,1,G,T,66238394,55174,66096960,66490176,141434
15,ENSG00000166938.8,66293568,15-66238394-G-C,rs16949724,1,G,C,66238394,55174,66096960,66490176,141434
15,ENSG00000166938.8,66293568,15-66238394-G-A,rs16949724,1,G,A,66238394,55174,66096960,66490176,141434
15,ENSG00000198146.4,34988287,15-34864781-A-G,rs16959966,-1,A,G,34864781,123506,34791679,35184895,73102
15,ENSG00000198146.4,34988287,15-34864781-A-C,rs16959966,-1,A,C,34864781,123506,34791679,35184895,73102
15,ENSG00000188467.6,48120990,15-48075725-C-T,rs16960537,1,C,T,48075725,45265,47924382,48317598,151343
15,ENSG00000188467.6,48120990,15-48075725-C-G,rs16960537,1,C,G,48075725,45265,47924382,48317598,151343
15,ENSG00000255302.2,48878134,15-48857062-C-T,rs16961743,1,C,T,48857062,21072,48681526,49074742,175536
15,ENSG00000140323.4,40358219,15-40350676-G-T,rs16970633,1,G,T,40350676,7543,40161611,40554827,189065
15,ENSG00000140534.9,89575469,15-89595695-A-G,rs16974170,1,A,G,89595695,20226,89378861,89772077,216834
15,ENSG00000140534.9,89575469,15-89595695-A-C,rs16974170,1,A,C,89595695,20226,89378861,89772077,216834
15,ENSG00000137857.11,45129994,15-45287750-C-T,rs1706824,1,C,T,45287750,157756,44933386,45326602,354364
15,ENSG00000136404.11,83107645,15-83181209-C-T,rs17158059,1,C,T,83181209,73564,82911037,83304253,270172
15,ENSG00000166503.4,83207823,15-83181209-C-T,rs17158059,-1,C,T,83181209,26614,83011215,83404431,169994
15,ENSG00000241839.4,64841915,15-64891602-A-G,rs1719271,1,A,G,64891602,49687,64645307,65038523,246295
15,ENSG00000241839.4,64841915,15-64891602-A-T,rs1719271,1,A,T,64891602,49687,64645307,65038523,246295
15,ENSG00000241839.4,64841915,15-64891602-A-C,rs1719271,1,A,C,64891602,49687,64645307,65038523,246295
15,ENSG00000166839.11,64911902,15-64892293-C-G,rs1719273,1,C,G,64892293,19609,64715294,65108510,176999
15,ENSG00000166839.11,64911902,15-64892293-C-T,rs1719273,1,C,T,64892293,19609,64715294,65108510,176999
15,ENSG00000166839.11,64911902,15-64892293-C-A,rs1719273,1,C,A,64892293,19609,64715294,65108510,176999
15,ENSG00000128923.6,58771302,15-58770945-C-T,rs17269439,1,C,T,58770945,357,58574694,58967910,196251
15,ENSG00000128923.6,58771302,15-58770945-C-G,rs17269439,1,C,G,58770945,357,58574694,58967910,196251
15,ENSG00000128923.6,58771302,15-58770945-C-A,rs17269439,1,C,A,58770945,357,58574694,58967910,196251
15,ENSG00000140391.9,77071109,15-77083841-C-A,rs17466257,-1,C,A,77083841,12732,76874501,77267717,209340
15,ENSG00000259494.1,88467388,15-88270901-G-A,rs17765281,-1,G,A,88270901,196487,88270780,88663996,121
15,ENSG00000166946.8,43185403,15-43287025-C-G,rs17779494,1,C,G,43287025,101622,42988795,43382011,298230
15,ENSG00000166946.8,43185403,15-43287025-C-T,rs17779494,1,C,T,43287025,101622,42988795,43382011,298230
15,ENSG00000172349.11,81196879,15-81293903-T-C,rs17875577,1,T,C,81293903,97024,81000271,81393487,293632
15,ENSG00000172349.11,81196879,15-81293903-T-G,rs17875577,1,T,G,81293903,97024,81000271,81393487,293632
15,ENSG00000172345.8,81324141,15-81293903-T-C,rs17875577,-1,T,C,81293903,30238,81127533,81520749,166370
15,ENSG00000172345.8,81324141,15-81293903-T-G,rs17875577,-1,T,G,81293903,30238,81127533,81520749,166370
15,ENSG00000138594.8,51829653,15-51814104-G-T,rs2009972,1,G,T,51814104,15549,51633045,52026261,181059
15,ENSG00000138594.8,51829653,15-51814104-G-A,rs2009972,1,G,A,51814104,15549,51633045,52026261,181059
15,ENSG00000140280.9,51737655,15-51814104-G-T,rs2009972,-1,G,T,51814104,76449,51541047,51934263,273057
15,ENSG00000140280.9,51737655,15-51814104-G-A,rs2009972,-1,G,A,51814104,76449,51541047,51934263,273057
15,ENSG00000157823.11,89893994,15-89889294-G-T,rs2043880,-1,G,T,89889294,4700,89697386,90090602,191908
15,ENSG00000157823.11,89893994,15-89889294-G-A,rs2043880,-1,G,A,89889294,4700,89697386,90090602,191908
15,ENSG00000157823.11,89893994,15-89889294-G-C,rs2043880,-1,G,C,89889294,4700,89697386,90090602,191908
15,ENSG00000169609.8,83011639,15-82973032-A-C,rs2046070,-1,A,C,82973032,38607,82815031,83208247,158001
15,ENSG00000169609.8,83011639,15-82973032-A-G,rs2046070,-1,A,G,82973032,38607,82815031,83208247,158001
15,ENSG00000169609.8,83011639,15-82973032-A-T,rs2046070,-1,A,T,82973032,38607,82815031,83208247,158001
15,ENSG00000140521.6,89334824,15-89323923-A-C,rs2072267,-1,A,C,89323923,10901,89138216,89531432,185707
15,ENSG00000140521.6,89334824,15-89323923-A-G,rs2072267,-1,A,G,89323923,10901,89138216,89531432,185707
15,ENSG00000128739.15,24954987,15-24920629-A-G,rs2075814,1,A,G,24920629,34358,24758379,25151595,162250
15,ENSG00000259330.1,40323692,15-40330740-A-C,rs2118960,1,A,C,40330740,7048,40127084,40520300,203656
15,ENSG00000259330.1,40323692,15-40330740-A-G,rs2118960,1,A,G,40330740,7048,40127084,40520300,203656
15,ENSG00000259330.1,40323692,15-40330740-A-T,rs2118960,1,A,T,40330740,7048,40127084,40520300,203656
15,ENSG00000166813.10,89655467,15-89521408-C-G,rs2218128,-1,C,G,89521408,134059,89458859,89852075,62549
15,ENSG00000137875.4,52112775,15-52109736-A-G,rs2231297,-1,A,G,52109736,3039,51916167,52309383,193569
15,ENSG00000174197.12,41660405,15-41573290-C-G,rs2246444,1,C,G,41573290,87115,41463797,41857013,109493
15,ENSG00000174197.12,41660405,15-41573290-C-T,rs2246444,1,C,T,41573290,87115,41463797,41857013,109493
15,ENSG00000174197.12,41660405,15-41573290-C-A,rs2246444,1,C,A,41573290,87115,41463797,41857013,109493
15,ENSG00000176454.8,34367196,15-34357430-G-A,rs2279685,-1,G,A,34357430,9766,34170588,34563804,186842
15,ENSG00000140545.10,88913379,15-88899375-C-G,rs2280214,-1,C,G,88899375,14004,88716771,89109987,182604
15,ENSG00000140545.10,88913379,15-88899375-C-T,rs2280214,-1,C,T,88899375,14004,88716771,89109987,182604
15,ENSG00000184984.8,33968497,15-33950279-C-T,rs2339349,1,C,T,33950279,18218,33771889,34165105,178390
15,ENSG00000069956.7,52019219,15-52075611-C-A,rs2414127,1,C,A,52075611,56392,51822611,52215827,253000
15,ENSG00000069956.7,52019219,15-52075611-C-T,rs2414127,1,C,T,52075611,56392,51822611,52215827,253000
15,ENSG00000140553.11,90935285,15-90812255-G-A,rs2532105,1,G,A,90812255,123030,90738677,91131893,73578
15,ENSG00000140553.11,90935285,15-90812255-G-C,rs2532105,1,G,C,90812255,123030,90738677,91131893,73578
15,ENSG00000104112.4,51681503,15-51687940-A-T,rs2622767,1,A,T,51687940,6437,51484895,51878111,203045
15,ENSG00000104112.4,51681503,15-51687940-A-G,rs2622767,1,A,G,51687940,6437,51484895,51878111,203045
15,ENSG00000255529.3,57706714,15-57562472-G-A,rs2635387,1,G,A,57562472,144242,57510106,57903322,52366
15,ENSG00000138587.5,56465137,15-56296021-T-A,rs2725840,-1,T,A,56296021,169116,56268529,56661745,27492
15,ENSG00000103978.10,42273433,15-42359484-A-C,rs28364363,-1,A,C,42359484,86051,42076825,42470041,282659
15,ENSG00000159433.7,42575606,15-42397120-C-T,rs28364469,1,C,T,42397120,178486,42378998,42772214,18122
15,ENSG00000137822.8,43371101,15-43528225-C-T,rs28438815,1,C,T,43528225,157124,43174493,43567709,353732
15,ENSG00000137822.8,43371101,15-43528225-C-A,rs28438815,1,C,A,43528225,157124,43174493,43567709,353732
15,ENSG00000172575.6,38564814,15-38565861-T-C,rs28438860,-1,T,C,38565861,1047,38368206,38761422,197655
15,ENSG00000140284.6,50182196,15-50140888-T-G,rs28566671,1,T,G,50140888,41308,49985588,50378804,155300
15,ENSG00000140284.6,50182196,15-50140888-T-C,rs28566671,1,T,C,50140888,41308,49985588,50378804,155300
15,ENSG00000185033.10,90201330,15-90149821-A-T,rs2970353,1,A,T,90149821,51509,90004722,90397938,145099
15,ENSG00000185033.10,90201330,15-90149821-A-G,rs2970353,1,A,G,90149821,51509,90004722,90397938,145099
15,ENSG00000185033.10,90201330,15-90149821-A-C,rs2970353,1,A,C,90149821,51509,90004722,90397938,145099
15,ENSG00000140471.12,100602184,15-100727844-A-G,rs304130,-1,A,G,100727844,125660,100405576,100798792,322268
15,ENSG00000140403.7,78264562,15-78270761-A-C,rs3169166,1,A,C,78270761,6199,78067954,78461170,202807
15,ENSG00000140403.7,78264562,15-78270761-A-G,rs3169166,1,A,G,78270761,6199,78067954,78461170,202807
15,ENSG00000137806.4,41402496,15-41396968-C-A,rs3204853,-1,C,A,41396968,5528,41205888,41599104,191080
15,ENSG00000137806.4,41402496,15-41396968-C-T,rs3204853,-1,C,T,41396968,5528,41205888,41599104,191080
15,ENSG00000137806.4,41402496,15-41396968-C-G,rs3204853,-1,C,G,41396968,5528,41205888,41599104,191080
15,ENSG00000169758.8,76059985,15-75942616-C-A,rs335719,1,C,A,75942616,117369,75863377,76256593,79239
15,ENSG00000169758.8,76059985,15-75942616-C-G,rs335719,1,C,G,75942616,117369,75863377,76256593,79239
15,ENSG00000169752.12,76012424,15-75943008-C-T,rs335720,-1,C,T,75943008,69416,75815816,76209032,127192
15,ENSG00000169752.12,76012424,15-75943008-C-G,rs335720,-1,C,G,75943008,69416,75815816,76209032,127192
15,ENSG00000140368.8,76995126,15-77019664-A-G,rs34192860,1,A,G,77019664,24538,76798518,77191734,221146
15,ENSG00000140368.8,76995126,15-77019664-A-C,rs34192860,1,A,C,77019664,24538,76798518,77191734,221146
15,ENSG00000028528.10,64095982,15-64127175-G-T,rs34257057,1,G,T,64127175,31193,63899374,64292590,227801
15,ENSG00000167173.13,75201882,15-75008020-C-A,rs34820454,1,C,A,75008020,193862,75005274,75398490,2746
15,ENSG00000167173.13,75201882,15-75008020-C-T,rs34820454,1,C,T,75008020,193862,75005274,75398490,2746
15,ENSG00000171262.7,38454127,15-38354495-G-A,rs35490364,1,G,A,38354495,99632,38257519,38650735,96976
15,ENSG00000168806.6,43330573,15-43330067-C-G,rs3742970,-1,C,G,43330067,506,43133965,43527181,196102
15,ENSG00000168806.6,43330573,15-43330067-C-A,rs3742970,-1,C,A,43330067,506,43133965,43527181,196102
15,ENSG00000166133.12,40569299,15-40458541-A-G,rs3743143,1,A,G,40458541,110758,40372691,40765907,85850
15,ENSG00000250021.2,89912882,15-89871410-C-T,rs3759831,-1,C,T,89871410,41472,89716274,90109490,155136
15,ENSG00000250021.2,89912882,15-89871410-C-G,rs3759831,-1,C,G,89871410,41472,89716274,90109490,155136
15,ENSG00000184716.9,43800220,15-43799188-G-C,rs3784275,-1,G,C,43799188,1032,43603612,43996828,195576
15,ENSG00000184716.9,43800220,15-43799188-G-A,rs3784275,-1,G,A,43799188,1032,43603612,43996828,195576
15,ENSG00000242028.1,43800599,15-43799188-G-C,rs3784275,1,G,C,43799188,1411,43603991,43997207,195197
15,ENSG00000242028.1,43800599,15-43799188-G-A,rs3784275,1,G,A,43799188,1411,43603991,43997207,195197
15,ENSG00000128886.7,43776966,15-43799188-G-C,rs3784275,-1,G,C,43799188,22222,43580358,43973574,218830
15,ENSG00000128886.7,43776966,15-43799188-G-A,rs3784275,-1,G,A,43799188,22222,43580358,43973574,218830
15,ENSG00000140264.14,43792320,15-43799188-G-C,rs3784275,1,G,C,43799188,6868,43595712,43988928,203476
15,ENSG00000140264.14,43792320,15-43799188-G-A,rs3784275,1,G,A,43799188,6868,43595712,43988928,203476
15,ENSG00000136425.8,78131445,15-78127969-T-C,rs3784330,-1,T,C,78127969,3476,77934837,78328053,193132
15,ENSG00000183476.8,78092561,15-78127969-T-C,rs3784330,1,T,C,78127969,35408,77895953,78289169,232016
15,ENSG00000171763.13,45402336,15-45402120-G-C,rs3809472,1,G,C,45402120,216,45205728,45598944,196392
15,ENSG00000171763.13,45402336,15-45402120-G-T,rs3809472,1,G,T,45402120,216,45205728,45598944,196392
15,ENSG00000140259.6,43824690,15-43824788-C-T,rs3816792,-1,C,T,43824788,98,43628082,44021298,196706
15,ENSG00000166411.9,78149362,15-78171144-G-A,rs3825847,1,G,A,78171144,21782,77952754,78345970,218390
15,ENSG00000178718.5,74956772,15-75026141-G-A,rs3850093,-1,G,A,75026141,69369,74760164,75153380,265977
15,ENSG00000181026.12,88621340,15-88710319-T-C,rs4293349,1,T,C,88710319,88979,88424732,88817948,285587
15,ENSG00000185115.4,29269822,15-29298675-G-A,rs4436748,-1,G,A,29298675,28853,29073214,29466430,225461
15,ENSG00000188266.9,78507577,15-78395583-C-T,rs4516196,1,C,T,78395583,111994,78310969,78704185,84614
15,ENSG00000169684.9,78565520,15-78395583-C-T,rs4516196,1,C,T,78395583,169937,78368912,78762128,26671
15,ENSG00000172183.10,88639016,15-88722088-G-A,rs4534816,1,G,A,88722088,83072,88442408,88835624,279680
15,ENSG00000103642.7,63121861,15-63115191-C-G,rs4774476,1,C,G,63115191,6670,62925253,63318469,189938
15,ENSG00000103642.7,63121861,15-63115191-C-A,rs4774476,1,C,A,63115191,6670,62925253,63318469,189938
15,ENSG00000103642.7,63121861,15-63115191-C-T,rs4774476,1,C,T,63115191,6670,62925253,63318469,189938
15,ENSG00000069943.5,55319222,15-55353463-A-C,rs4774766,1,A,C,55353463,34241,55122614,55515830,230849
15,ENSG00000069943.5,55319222,15-55353463-A-T,rs4774766,1,A,T,55353463,34241,55122614,55515830,230849
15,ENSG00000069943.5,55319222,15-55353463-A-G,rs4774766,1,A,G,55353463,34241,55122614,55515830,230849
15,ENSG00000185088.8,63157477,15-63019781-T-C,rs4775601,-1,T,C,63019781,137696,62960869,63354085,58912
15,ENSG00000172379.13,80404382,15-80356654-C-T,rs4778786,1,C,T,80356654,47728,80207774,80600990,148880
15,ENSG00000185418.10,101724473,15-101643133-T-A,rs479913,-1,T,A,101643133,81340,101527865,101921081,115268
15,ENSG00000140459.11,74367646,15-74370924-C-A,rs4886595,-1,C,A,74370924,3278,74171038,74564254,199886
15,ENSG00000140459.11,74367646,15-74370924-C-T,rs4886595,-1,C,T,74370924,3278,74171038,74564254,199886
15,ENSG00000140459.11,74367646,15-74370924-C-G,rs4886595,-1,C,G,74370924,3278,74171038,74564254,199886
15,ENSG00000137841.7,40307935,15-40305028-G-A,rs4924450,-1,G,A,40305028,2907,40111327,40504543,193701
15,ENSG00000103994.10,42491141,15-42479102-T-C,rs4924682,-1,T,C,42479102,12039,42294533,42687749,184569
15,ENSG00000166821.4,89690754,15-89674066-C-T,rs4932138,-1,C,T,89674066,16688,89494146,89887362,179920
15,ENSG00000166821.4,89690754,15-89674066-C-A,rs4932138,-1,C,A,89674066,16688,89494146,89887362,179920
15,ENSG00000131871.9,101277485,15-101127021-T-C,rs4965789,-1,T,C,101127021,150464,101080877,101474093,46144
15,ENSG00000131871.9,101277485,15-101127021-T-A,rs4965789,-1,T,A,101127021,150464,101080877,101474093,46144
15,ENSG00000131871.9,101277485,15-101127021-T-G,rs4965789,-1,T,G,101127021,150464,101080877,101474093,46144
15,ENSG00000136383.6,84817356,15-84914744-C-T,rs4980346,1,C,T,84914744,97388,84620748,85013964,293996
15,ENSG00000179335.14,74615836,15-74722228-T-C,rs4986879,1,T,C,74722228,106392,74419228,74812444,303000
15,ENSG00000179151.7,74696024,15-74722228-T-C,rs4986879,-1,T,C,74722228,26204,74499416,74892632,222812
15,ENSG00000069966.14,52191392,15-52180454-T-G,rs55860410,-1,T,G,52180454,10938,51994784,52388000,185670
15,ENSG00000188869.8,81374213,15-81224224-A-G,rs55889255,-1,A,G,81224224,149989,81177605,81570821,46619
15,ENSG00000187446.7,41231268,15-41135666-C-T,rs561821,1,C,T,41135666,95602,41034660,41427876,101006
15,ENSG00000168803.10,43330672,15-43309390-C-G,rs56321238,1,C,G,43309390,21282,43134064,43527280,175326
15,ENSG00000159289.6,74082550,15-73994588-C-T,rs5742914,-1,C,T,73994588,87962,73885942,74279158,108646
15,ENSG00000159289.6,74082550,15-73994588-C-A,rs5742914,-1,C,A,73994588,87962,73885942,74279158,108646
15,ENSG00000137767.9,45635029,15-45643195-C-A,rs594516,1,C,A,45643195,8166,45438421,45831637,204774
15,ENSG00000136371.5,79897014,15-79883674-T-C,rs60269787,-1,T,C,79883674,13340,79700406,80093622,183268
15,ENSG00000259332.2,79923744,15-79883674-T-C,rs60269787,-1,T,C,79883674,40070,79727136,80120352,156538
15,ENSG00000174442.7,66505326,15-66315577-C-T,rs62011715,1,C,T,66315577,189749,66308718,66701934,6859
15,ENSG00000103599.15,67254786,15-67263767-C-G,rs62014647,1,C,G,67263767,8981,67058178,67451394,205589
15,ENSG00000067141.11,73052463,15-73144739-C-T,rs62016850,1,C,T,73144739,92276,72855855,73249071,288884
15,ENSG00000067141.11,73052463,15-73144739-C-A,rs62016850,1,C,A,73144739,92276,72855855,73249071,288884
15,ENSG00000067225.11,72231190,15-72206600-T-C,rs62026270,-1,T,C,72206600,24590,72034582,72427798,172018
15,ENSG00000128928.4,40405795,15-40269689-A-C,rs6492939,1,A,C,40269689,136106,40209187,40602403,60502
15,ENSG00000156958.10,49170247,15-49351722-C-G,rs6493363,1,C,G,49351722,181475,48973639,49366855,378083
15,ENSG00000156958.10,49170247,15-49351722-C-T,rs6493363,1,C,T,49351722,181475,48973639,49366855,378083
15,ENSG00000138617.10,65286883,15-65228685-A-G,rs6494513,-1,A,G,65228685,58198,65090275,65483491,138410
15,ENSG00000138617.10,65286883,15-65228685-A-T,rs6494513,-1,A,T,65228685,58198,65090275,65483491,138410
15,ENSG00000128891.11,40565042,15-40553398-A-C,rs6582,-1,A,C,40553398,11644,40368434,40761650,184964
15,ENSG00000128891.11,40565042,15-40553398-A-G,rs6582,-1,A,G,40553398,11644,40368434,40761650,184964
15,ENSG00000128891.11,40565042,15-40553398-A-T,rs6582,-1,A,T,40553398,11644,40368434,40761650,184964
15,ENSG00000080644.10,78620996,15-78571130-T-C,rs667282,-1,T,C,78571130,49866,78424388,78817604,146742
15,ENSG00000137880.4,40764068,15-40616498-C-T,rs7161938,1,C,T,40616498,147570,40567460,40960676,49038
15,ENSG00000129003.11,62060447,15-61921734-G-A,rs7164933,-1,G,A,61921734,138713,61863839,62257055,57895
15,ENSG00000129003.11,62060447,15-61921734-G-T,rs7164933,-1,G,T,61921734,138713,61863839,62257055,57895
15,ENSG00000166557.8,79311112,15-79189701-G-T,rs7165189,1,G,T,79189701,121411,79114504,79507720,75197
15,ENSG00000166557.8,79311112,15-79189701-G-A,rs7165189,1,G,A,79189701,121411,79114504,79507720,75197
15,ENSG00000166557.8,79311112,15-79189701-G-C,rs7165189,1,G,C,79189701,121411,79114504,79507720,75197
15,ENSG00000104093.8,51622771,15-51458649-G-A,rs7165887,-1,G,A,51458649,164122,51426163,51819379,32486
15,ENSG00000103657.8,63833948,15-63876448-C-T,rs7169989,-1,C,T,63876448,42500,63637340,64030556,239108
15,ENSG00000136378.9,78811464,15-78741147-T-C,rs7176070,-1,T,C,78741147,70317,78614856,79008072,126291
15,ENSG00000136378.9,78811464,15-78741147-T-G,rs7176070,-1,T,G,78741147,70317,78614856,79008072,126291
15,ENSG00000136378.9,78811464,15-78741147-T-A,rs7176070,-1,T,A,78741147,70317,78614856,79008072,126291
15,ENSG00000169105.6,40470984,15-40433360-T-C,rs7176449,1,T,C,40433360,37624,40274376,40667592,158984
15,ENSG00000074696.7,65530463,15-65706364-T-A,rs7176565,1,T,A,65706364,175901,65333855,65727071,372509
15,ENSG00000074696.7,65530463,15-65706364-T-C,rs7176565,1,T,C,65706364,175901,65333855,65727071,372509
15,ENSG00000169612.3,82986210,15-83064153-G-T,rs7177462,1,G,T,83064153,77943,82789602,83182818,274551
15,ENSG00000169612.3,82986210,15-83064153-G-A,rs7177462,1,G,A,83064153,77943,82789602,83182818,274551
15,ENSG00000159459.7,43106038,15-42944507-C-A,rs7178732,-1,C,A,42944507,161531,42909430,43302646,35077
15,ENSG00000103723.8,82709875,15-82845921-C-G,rs7178859,-1,C,G,82845921,136046,82513267,82906483,332654
15,ENSG00000103723.8,82709875,15-82845921-C-T,rs7178859,-1,C,T,82845921,136046,82513267,82906483,332654
15,ENSG00000188089.9,42051190,15-42032281-T-A,rs7179219,-1,T,A,42032281,18909,41854582,42247798,177699
15,ENSG00000140464.14,73994716,15-74050989-A-G,rs723434,1,A,G,74050989,56273,73798108,74191324,252881
15,ENSG00000131876.12,101295248,15-101111318-C-A,rs72633251,-1,C,A,101111318,183930,101098640,101491856,12678
15,ENSG00000188626.5,28712421,15-28833959-C-T,rs72714162,-1,C,T,28833959,121538,28515813,28909029,318146
15,ENSG00000184508.6,90932549,15-90976616-C-T,rs72759311,-1,C,T,90976616,44067,90735941,91129157,240675
15,ENSG00000184508.6,90932549,15-90976616-C-G,rs72759311,-1,C,G,90976616,44067,90735941,91129157,240675
15,ENSG00000170113.11,22786644,15-22964676-T-C,rs7403282,1,T,C,22964676,178032,22590036,22983252,374640
15,ENSG00000170113.11,22786644,15-22964676-T-A,rs7403282,1,T,A,22964676,178032,22590036,22983252,374640
15,ENSG00000170113.11,22786644,15-22964676-T-G,rs7403282,1,T,G,22964676,178032,22590036,22983252,374640
15,ENSG00000166073.4,39920266,15-39944364-G-A,rs74501688,-1,G,A,39944364,24098,39723658,40116874,220706
15,ENSG00000166073.4,39920266,15-39944364-G-C,rs74501688,-1,G,C,39944364,24098,39723658,40116874,220706
15,ENSG00000177971.6,75640224,15-75620358-C-T,rs74845979,-1,C,T,75620358,19866,75443616,75836832,176742
15,ENSG00000047346.8,52679388,15-52811706-T-C,rs7496443,-1,T,C,52811706,132318,52482780,52875996,328926
15,ENSG00000131873.5,101252048,15-101163370-G-T,rs75054387,-1,G,T,101163370,88678,101055440,101448656,107930
15,ENSG00000170236.10,50546666,15-50418631-C-G,rs75830155,-1,C,G,50418631,128035,50350058,50743274,68573
15,ENSG00000074603.14,65517689,15-65385704-G-A,rs75957309,-1,G,A,65385704,131985,65321081,65714297,64623
15,ENSG00000069974.10,55289813,15-55217315-C-G,rs76059106,-1,C,G,55217315,72498,55093205,55486421,124110
15,ENSG00000069667.11,61229302,15-61070315-A-G,rs76435117,-1,A,G,61070315,158987,61032694,61425910,37621
15,ENSG00000167196.9,75903878,15-76017267-C-T,rs76614553,1,C,T,76017267,113389,75707270,76100486,309997
15,ENSG00000167196.9,75903878,15-76017267-C-A,rs76614553,1,C,A,76017267,113389,75707270,76100486,309997
15,ENSG00000182253.10,99105080,15-99118115-C-A,rs77358683,1,C,A,99118115,13035,98908472,99301688,209643
15,ENSG00000138621.7,75023590,15-75012413-C-T,rs78434425,1,C,T,75012413,11177,74826982,75220198,185431
15,ENSG00000188659.5,82262818,15-82151483-C-A,rs78664413,1,C,A,82151483,111335,82066210,82459426,85273
15,ENSG00000188659.5,82262818,15-82151483-C-T,rs78664413,1,C,T,82151483,111335,82066210,82459426,85273
15,ENSG00000128833.8,52295804,15-52276610-G-C,rs80072979,-1,G,C,52276610,19194,52099196,52492412,177414
15,ENSG00000128833.8,52295804,15-52276610-G-A,rs80072979,-1,G,A,52276610,19194,52099196,52492412,177414
15,ENSG00000182117.4,34343136,15-34320130-C-T,rs8025057,-1,C,T,34320130,23006,34146528,34539744,173602
15,ENSG00000136381.8,78438216,15-78325571-T-A,rs8027394,1,T,A,78325571,112645,78241608,78634824,83963
15,ENSG00000136381.8,78438216,15-78325571-T-C,rs8027394,1,T,C,78325571,112645,78241608,78634824,83963
15,ENSG00000128849.9,57376505,15-57456781-A-G,rs8028787,1,A,G,57456781,80276,57179897,57573113,276884
15,ENSG00000176463.8,91853708,15-92024507-G-A,rs8029024,1,G,A,92024507,170799,91657100,92050316,367407
15,ENSG00000176463.8,91853708,15-92024507-G-C,rs8029024,1,G,C,92024507,170799,91657100,92050316,367407
15,ENSG00000182511.7,90884504,15-90875067-T-A,rs8032315,1,T,A,90875067,9437,90687896,91081112,187171
15,ENSG00000182511.7,90884504,15-90875067-T-C,rs8032315,1,T,C,90875067,9437,90687896,91081112,187171
15,ENSG00000184254.10,100879831,15-100828306-G-A,rs8033826,1,G,A,100828306,51525,100683223,101076439,145083
15,ENSG00000166823.5,89751249,15-89784576-A-G,rs8035089,-1,A,G,89784576,33327,89554641,89947857,229935
15,ENSG00000182774.6,82540457,15-82550590-G-A,rs803686,-1,G,A,82550590,10133,82343849,82737065,206741
15,ENSG00000182774.6,82540457,15-82550590-G-C,rs803686,-1,G,C,82550590,10133,82343849,82737065,206741
15,ENSG00000137812.13,40594249,15-40622992-A-G,rs8040502,1,A,G,40622992,28743,40397641,40790857,225351
15,ENSG00000169857.3,34039204,15-33989422-T-C,rs8042524,-1,T,C,33989422,49782,33842596,34235812,146826
15,ENSG00000169857.3,34039204,15-33989422-T-A,rs8042524,-1,T,A,33989422,49782,33842596,34235812,146826
15,ENSG00000140451.8,64825647,15-64858638-G-A,rs832882,-1,G,A,64858638,32991,64629039,65022255,229599
15,ENSG00000140451.8,64825647,15-64858638-G-C,rs832882,-1,G,C,64858638,32991,64629039,65022255,229599
15,ENSG00000140474.7,74843156,15-74836160-T-C,rs9210,-1,T,C,74836160,6996,74646548,75039764,189612
15,ENSG00000140474.7,74843156,15-74836160-T-A,rs9210,-1,T,A,74836160,6996,74646548,75039764,189612
15,ENSG00000159556.5,76336773,15-76203891-G-A,rs937732,1,G,A,76203891,132882,76140165,76533381,63726
15,ENSG00000159556.5,76336773,15-76203891-G-C,rs937732,1,G,C,76203891,132882,76140165,76533381,63726
15,ENSG00000104093.8,51622771,15-51679727-T-C,rs1017678,-1,T,C,51679727,56956,51426163,51819379,253564
15,ENSG00000183476.8,78092561,15-78105804-G-C,rs10456,1,G,C,78105804,13243,77895953,78289169,209851
15,ENSG00000183476.8,78092561,15-78105804-G-A,rs10456,1,G,A,78105804,13243,77895953,78289169,209851
15,ENSG00000150667.6,39782841,15-39787962-A-G,rs10520152,-1,A,G,39787962,5121,39586233,39979449,201729
15,ENSG00000166839.11,64911902,15-65021558-C-T,rs111388106,1,C,T,65021558,109656,64715294,65108510,306264
15,ENSG00000140263.9,45023195,15-44916471-G-A,rs111769507,1,G,A,44916471,106724,44826587,45219803,89884
15,ENSG00000166797.6,64093838,15-64126198-G-A,rs1130603,-1,G,A,64126198,32360,63897230,64290446,228968
15,ENSG00000166797.6,64093838,15-64126198-G-C,rs1130603,-1,G,C,64126198,32360,63897230,64290446,228968
15,ENSG00000103932.6,41544257,15-41588144-G-A,rs11629490,-1,G,A,41588144,43887,41347649,41740865,240495
15,ENSG00000103932.6,41544257,15-41588144-G-T,rs11629490,-1,G,T,41588144,43887,41347649,41740865,240495
15,ENSG00000140534.9,89575469,15-89555523-C-T,rs11629542,1,C,T,89555523,19946,89378861,89772077,176662
15,ENSG00000140534.9,89575469,15-89555523-C-G,rs11629542,1,C,G,89555523,19946,89378861,89772077,176662
15,ENSG00000140459.11,74367646,15-74345526-A-G,rs11632698,-1,A,G,74345526,22120,74171038,74564254,174488
15,ENSG00000140459.11,74367646,15-74345526-A-C,rs11632698,-1,A,C,74345526,22120,74171038,74564254,174488
15,ENSG00000140459.11,74367646,15-74345526-A-T,rs11632698,-1,A,T,74345526,22120,74171038,74564254,174488
15,ENSG00000172349.11,81196879,15-81269018-T-C,rs11633024,1,T,C,81269018,72139,81000271,81393487,268747
15,ENSG00000136381.8,78438216,15-78299935-C-G,rs11635324,1,C,G,78299935,138281,78241608,78634824,58327
15,ENSG00000136381.8,78438216,15-78299935-C-T,rs11635324,1,C,T,78299935,138281,78241608,78634824,58327
15,ENSG00000169371.9,75625725,15-75506965-G-A,rs11638974,-1,G,A,75506965,118760,75429117,75822333,77848
15,ENSG00000169371.9,75625725,15-75506965-G-C,rs11638974,-1,G,C,75506965,118760,75429117,75822333,77848
15,ENSG00000136404.11,83107645,15-83158544-T-C,rs116957980,1,T,C,83158544,50899,82911037,83304253,247507
15,ENSG00000092439.8,50686797,15-50682811-T-C,rs117035204,-1,T,C,50682811,3986,50490189,50883405,192622
15,ENSG00000166819.7,89679367,15-89605263-A-G,rs117485236,-1,A,G,89605263,74104,89482759,89875975,122504
15,ENSG00000166819.7,89679367,15-89605263-A-C,rs117485236,-1,A,C,89605263,74104,89482759,89875975,122504
15,ENSG00000140511.7,88895544,15-89091528-C-T,rs117875077,-1,C,T,89091528,195984,88698936,89092152,392592
15,ENSG00000183208.8,90234209,15-90325777-T-C,rs11854123,1,T,C,90325777,91568,90037601,90430817,288176
15,ENSG00000183208.8,90234209,15-90325777-T-A,rs11854123,1,T,A,90325777,91568,90037601,90430817,288176
15,ENSG00000137834.9,66702236,15-66774225-C-T,rs11858577,1,C,T,66774225,71989,66505628,66898844,268597
15,ENSG00000137877.8,41894053,15-41853738-G-T,rs1197660,-1,G,T,41853738,40315,41697445,42090661,156293
15,ENSG00000137877.8,41894053,15-41853738-G-A,rs1197660,-1,G,A,41853738,40315,41697445,42090661,156293
15,ENSG00000137877.8,41894053,15-41853738-G-C,rs1197660,-1,G,C,41853738,40315,41697445,42090661,156293
15,ENSG00000103811.10,78945046,15-78939136-T-G,rs12148472,-1,T,G,78939136,5910,78748438,79141654,190698
15,ENSG00000103811.10,78945046,15-78939136-T-C,rs12148472,-1,T,C,78939136,5910,78748438,79141654,190698
15,ENSG00000169926.5,31326835,15-31177951-T-A,rs1223886,1,T,A,31177951,148884,31130227,31523443,47724
15,ENSG00000169926.5,31326835,15-31177951-T-G,rs1223886,1,T,G,31177951,148884,31130227,31523443,47724
15,ENSG00000169926.5,31326835,15-31177951-T-C,rs1223886,1,T,C,31177951,148884,31130227,31523443,47724
15,ENSG00000092531.5,42495634,15-42569164-C-T,rs12439377,1,C,T,42569164,73530,42299026,42692242,270138
15,ENSG00000136425.8,78131445,15-78115151-T-C,rs12440984,-1,T,C,78115151,16294,77934837,78328053,180314
15,ENSG00000182253.10,99105080,15-99166034-T-C,rs12442235,1,T,C,99166034,60954,98908472,99301688,257562
15,ENSG00000140563.10,94231561,15-94047915-A-G,rs12443435,1,A,G,94047915,183646,94034953,94428169,12962
15,ENSG00000140563.10,94231561,15-94047915-A-T,rs12443435,1,A,T,94047915,183646,94034953,94428169,12962
15,ENSG00000169612.3,82986210,15-82852284-C-G,rs1256429,1,C,G,82852284,133926,82789602,83182818,62682
15,ENSG00000169612.3,82986210,15-82852284-C-T,rs1256429,1,C,T,82852284,133926,82789602,83182818,62682
15,ENSG00000175265.13,34437808,15-34378923-A-T,rs12593958,-1,A,T,34378923,58885,34241200,34634416,137723
15,ENSG00000175265.13,34437808,15-34378923-A-C,rs12593958,-1,A,C,34378923,58885,34241200,34634416,137723
15,ENSG00000166762.11,43648844,15-43801729-T-C,rs12702,-1,T,C,43801729,152885,43452236,43845452,349493
15,ENSG00000169032.4,66386912,15-66549487-A-G,rs12901894,1,A,G,66549487,162575,66190304,66583520,359183
15,ENSG00000166912.11,30991628,15-31060780-C-T,rs12902840,-1,C,T,31060780,69152,30795020,31188236,265760
15,ENSG00000182718.11,60397986,15-60397796-G-T,rs12904906,-1,G,T,60397796,190,60201378,60594594,196418
15,ENSG00000182718.11,60397986,15-60397796-G-C,rs12904906,-1,G,C,60397796,190,60201378,60594594,196418
15,ENSG00000186073.7,36579626,15-36577993-G-A,rs12912029,1,G,A,36577993,1633,36383018,36776234,194975
15,ENSG00000103591.8,67254661,15-67138214-T-C,rs12914140,-1,T,C,67138214,116447,67058053,67451269,80161
15,ENSG00000140479.12,101489707,15-101390413-T-C,rs12917106,-1,T,C,101390413,99294,101293099,101686315,97314
15,ENSG00000187446.7,41231268,15-41371698-A-G,rs13379756,1,A,G,41371698,140430,41034660,41427876,337038
15,ENSG00000187446.7,41231268,15-41371698-A-C,rs13379756,1,A,C,41371698,140430,41034660,41427876,337038
15,ENSG00000174442.7,66505326,15-66680537-G-A,rs1371781,1,G,A,66680537,175211,66308718,66701934,371819
15,ENSG00000176454.8,34367196,15-34366218-G-C,rs1390425,-1,G,C,34366218,978,34170588,34563804,195630
15,ENSG00000176454.8,34367196,15-34366218-G-T,rs1390425,-1,G,T,34366218,978,34170588,34563804,195630
15,ENSG00000168781.14,43590208,15-43527252-A-C,rs147141458,-1,A,C,43527252,62956,43393600,43786816,133652
15,ENSG00000168781.14,43590208,15-43527252-A-G,rs147141458,-1,A,G,43527252,62956,43393600,43786816,133652
15,ENSG00000156642.12,73633389,15-73641377-A-G,rs1564492,-1,A,G,73641377,7988,73436781,73829997,204596
15,ENSG00000166823.5,89751249,15-89773018-G-C,rs16943576,-1,G,C,89773018,21769,89554641,89947857,218377
15,ENSG00000028528.10,64095982,15-64088949-G-T,rs16947748,1,G,T,64088949,7033,63899374,64292590,189575
15,ENSG00000028528.10,64095982,15-64088949-G-A,rs16947748,1,G,A,64088949,7033,63899374,64292590,189575
15,ENSG00000069966.14,52191392,15-52204736-C-T,rs16964764,-1,C,T,52204736,13344,51994784,52388000,209952
15,ENSG00000140382.10,77420888,15-77379776-C-A,rs16968809,1,C,A,77379776,41112,77224280,77617496,155496
15,ENSG00000140382.10,77420888,15-77379776-C-T,rs16968809,1,C,T,77379776,41112,77224280,77617496,155496
15,ENSG00000140199.7,34337781,15-34325112-T-C,rs17236847,-1,T,C,34325112,12669,34141173,34534389,183939
15,ENSG00000140368.8,76995126,15-77083841-C-A,rs17466257,1,C,A,77083841,88715,76798518,77191734,285323
15,ENSG00000041357.11,78540444,15-78661443-C-T,rs17487514,1,C,T,78661443,120999,78343836,78737052,317607
15,ENSG00000041357.11,78540444,15-78661443-C-G,rs17487514,1,C,G,78661443,120999,78343836,78737052,317607
15,ENSG00000166503.4,83207823,15-83053307-A-G,rs17507300,-1,A,G,83053307,154516,83011215,83404431,42092
15,ENSG00000137806.4,41402496,15-41491616-A-G,rs1757463,-1,A,G,41491616,89120,41205888,41599104,285728
15,ENSG00000197361.4,63597387,15-63675307-A-G,rs17772465,1,A,G,63675307,77920,63400779,63793995,274528
15,ENSG00000172345.8,81324141,15-81311952-A-T,rs17875563,-1,A,T,81311952,12189,81127533,81520749,184419
15,ENSG00000172345.8,81324141,15-81311952-A-C,rs17875563,-1,A,C,81311952,12189,81127533,81520749,184419
15,ENSG00000140284.6,50182196,15-50236217-C-A,rs1802536,1,C,A,50236217,54021,49985588,50378804,250629
15,ENSG00000140284.6,50182196,15-50236217-C-T,rs1802536,1,C,T,50236217,54021,49985588,50378804,250629
15,ENSG00000140416.14,63042747,15-63020433-G-A,rs1873147,1,G,A,63020433,22314,62846139,63239355,174294
15,ENSG00000185418.10,101724473,15-101693057-G-A,rs1908160,-1,G,A,101693057,31416,101527865,101921081,165192
15,ENSG00000185418.10,101724473,15-101693057-G-C,rs1908160,-1,G,C,101693057,31416,101527865,101921081,165192
15,ENSG00000185418.10,101724473,15-101693057-G-T,rs1908160,-1,G,T,101693057,31416,101527865,101921081,165192
15,ENSG00000197535.9,52528880,15-52419447-C-T,rs1972160,-1,C,T,52419447,109433,52332272,52725488,87175
15,ENSG00000197535.9,52528880,15-52419447-C-A,rs1972160,-1,C,A,52419447,109433,52332272,52725488,87175
15,ENSG00000185634.7,48963919,15-48859206-C-T,rs1974961,-1,C,T,48859206,104713,48767311,49160527,91895
15,ENSG00000185634.7,48963919,15-48859206-C-G,rs1974961,-1,C,G,48859206,104713,48767311,49160527,91895
15,ENSG00000131871.9,101277485,15-101148500-C-T,rs2045161,-1,C,T,101148500,128985,101080877,101474093,67623
15,ENSG00000179335.14,74615836,15-74749000-T-G,rs2069526,1,T,G,74749000,133164,74419228,74812444,329772
15,ENSG00000103642.7,63121861,15-63230994-A-G,rs2166114,1,A,G,63230994,109133,62925253,63318469,305741
15,ENSG00000103642.7,63121861,15-63230994-A-T,rs2166114,1,A,T,63230994,109133,62925253,63318469,305741
15,ENSG00000104154.5,45522755,15-45646463-A-G,rs2218309,-1,A,G,45646463,123708,45326147,45719363,320316
15,ENSG00000104154.5,45522755,15-45646463-A-T,rs2218309,-1,A,T,45646463,123708,45326147,45719363,320316
15,ENSG00000183655.10,85794925,15-85734837-C-T,rs2241266,-1,C,T,85734837,60088,85598317,85991533,136520
15,ENSG00000183655.10,85794925,15-85734837-C-G,rs2241266,-1,C,G,85734837,60088,85598317,85991533,136520
15,ENSG00000166716.5,84748592,15-84935465-C-T,rs2242047,1,C,T,84935465,186873,84551984,84945200,383481
15,ENSG00000140403.7,78264562,15-78292764-C-T,rs2280364,1,C,T,78292764,28202,78067954,78461170,224810
15,ENSG00000138621.7,75023590,15-75018053-T-G,rs2289582,1,T,G,75018053,5537,74826982,75220198,191071
15,ENSG00000138621.7,75023590,15-75018053-T-A,rs2289582,1,T,A,75018053,5537,74826982,75220198,191071
15,ENSG00000138621.7,75023590,15-75018053-T-C,rs2289582,1,T,C,75018053,5537,74826982,75220198,191071
15,ENSG00000140474.7,74843156,15-74850420-T-G,rs2305668,-1,T,G,74850420,7264,74646548,75039764,203872
15,ENSG00000196391.6,90352284,15-90166313-G-A,rs2352054,1,G,A,90166313,185971,90155676,90548892,10637
15,ENSG00000104055.10,43266928,15-43375702-T-C,rs2412781,-1,T,C,43375702,108774,43070320,43463536,305382
15,ENSG00000136378.9,78811464,15-78752523-C-G,rs2589373,-1,C,G,78752523,58941,78614856,79008072,137667
15,ENSG00000136378.9,78811464,15-78752523-C-T,rs2589373,-1,C,T,78752523,58941,78614856,79008072,137667
15,ENSG00000136378.9,78811464,15-78752523-C-A,rs2589373,-1,C,A,78752523,58941,78614856,79008072,137667
15,ENSG00000103852.8,99249581,15-99216752-A-G,rs2623184,-1,A,G,99216752,32829,99052973,99446189,163779
15,ENSG00000182511.7,90884504,15-90897977-C-T,rs2677737,1,C,T,90897977,13473,90687896,91081112,210081
15,ENSG00000182511.7,90884504,15-90897977-C-G,rs2677737,1,C,G,90897977,13473,90687896,91081112,210081
15,ENSG00000169857.3,34039204,15-34039581-G-A,rs2684941,-1,G,A,34039581,377,33842596,34235812,196985
15,ENSG00000169857.3,34039204,15-34039581-G-C,rs2684941,-1,G,C,34039581,377,33842596,34235812,196985
15,ENSG00000137770.9,44427629,15-44249489-C-T,rs2696097,1,C,T,44249489,178140,44231021,44624237,18468
15,ENSG00000137770.9,44427629,15-44249489-C-G,rs2696097,1,C,G,44249489,178140,44231021,44624237,18468
15,ENSG00000137767.9,45635029,15-45659353-A-G,rs2733250,1,A,G,45659353,24324,45438421,45831637,220932
15,ENSG00000103978.10,42273433,15-42406093-C-T,rs28364510,-1,C,T,42406093,132660,42076825,42470041,329268
15,ENSG00000103978.10,42273433,15-42406093-C-G,rs28364510,-1,C,G,42406093,132660,42076825,42470041,329268
15,ENSG00000185088.8,63157477,15-63156806-G-C,rs28377261,-1,G,C,63156806,671,62960869,63354085,195937
15,ENSG00000185088.8,63157477,15-63156806-G-A,rs28377261,-1,G,A,63156806,671,62960869,63354085,195937
15,ENSG00000197299.5,90717346,15-90770086-T-C,rs28385043,1,T,C,90770086,52740,90520738,90913954,249348
15,ENSG00000137875.4,52112775,15-52155317-G-A,rs28437132,-1,G,A,52155317,42542,51916167,52309383,239150
15,ENSG00000104043.10,50119233,15-50140888-T-C,rs28566671,-1,T,C,50140888,21655,49922625,50315841,218263
15,ENSG00000104043.10,50119233,15-50140888-T-G,rs28566671,-1,T,G,50140888,21655,49922625,50315841,218263
15,ENSG00000185442.6,92655775,15-92633263-G-A,rs285754,-1,G,A,92633263,22512,92459167,92852383,174096
15,ENSG00000137822.8,43371101,15-43296690-C-A,rs28594657,1,C,A,43296690,74411,43174493,43567709,122197
15,ENSG00000137822.8,43371101,15-43296690-C-T,rs28594657,1,C,T,43296690,74411,43174493,43567709,122197
15,ENSG00000137842.2,43133586,15-43046953-C-A,rs28605464,1,C,A,43046953,86633,42936978,43330194,109975
15,ENSG00000137764.14,67542703,15-67614616-G-A,rs2899726,1,G,A,67614616,71913,67346095,67739311,268521
15,ENSG00000185043.6,90233941,15-90149821-A-T,rs2970353,-1,A,T,90149821,84120,90037333,90430549,112488
15,ENSG00000185043.6,90233941,15-90149821-A-G,rs2970353,-1,A,G,90149821,84120,90037333,90430549,112488
15,ENSG00000185043.6,90233941,15-90149821-A-C,rs2970353,-1,A,C,90149821,84120,90037333,90430549,112488
15,ENSG00000140471.12,100602184,15-100723964-G-C,rs304125,-1,G,C,100723964,121780,100405576,100798792,318388
15,ENSG00000180979.5,42548793,15-42543858-A-T,rs34359922,-1,A,T,42543858,4935,42352185,42745401,191673
15,ENSG00000180979.5,42548793,15-42543858-A-G,rs34359922,-1,A,G,42543858,4935,42352185,42745401,191673
15,ENSG00000183475.8,100602589,15-100536916-G-A,rs34734667,1,G,A,100536916,65673,100405981,100799197,130935
15,ENSG00000170113.11,22786644,15-22752734-T-C,rs35698504,1,T,C,22752734,33910,22590036,22983252,162698
15,ENSG00000068305.12,99565984,15-99712498-G-C,rs3730059,1,G,C,99712498,146514,99369376,99762592,343122
15,ENSG00000068305.12,99565984,15-99712498-G-A,rs3730059,1,G,A,99712498,146514,99369376,99762592,343122
15,ENSG00000184508.6,90932549,15-91017952-C-T,rs3743445,-1,C,T,91017952,85403,90735941,91129157,282011
15,ENSG00000184508.6,90932549,15-91017952-C-G,rs3743445,-1,C,G,91017952,85403,90735941,91129157,282011
15,ENSG00000136383.6,84817356,15-84641323-G-C,rs3748373,1,G,C,84641323,176033,84620748,85013964,20575
15,ENSG00000136383.6,84817356,15-84641323-G-A,rs3748373,1,G,A,84641323,176033,84620748,85013964,20575
15,ENSG00000137841.7,40307935,15-40306093-C-T,rs3784399,-1,C,T,40306093,1842,40111327,40504543,194766
15,ENSG00000183578.5,51094906,15-51083632-T-G,rs3803369,-1,T,G,51083632,11274,50898298,51291514,185334
15,ENSG00000183578.5,51094906,15-51083632-T-A,rs3803369,-1,T,A,51083632,11274,50898298,51291514,185334
15,ENSG00000183578.5,51094906,15-51083632-T-C,rs3803369,-1,T,C,51083632,11274,50898298,51291514,185334
15,ENSG00000103723.8,82709875,15-82831014-G-T,rs3814281,-1,G,T,82831014,121139,82513267,82906483,317747
15,ENSG00000103723.8,82709875,15-82831014-G-A,rs3814281,-1,G,A,82831014,121139,82513267,82906483,317747
15,ENSG00000140265.8,43371043,15-43523801-C-T,rs3862138,-1,C,T,43523801,152758,43174435,43567651,349366
15,ENSG00000198794.7,74995563,15-75026311-A-G,rs3910748,1,A,G,75026311,30748,74798955,75192171,227356
15,ENSG00000186628.8,82806069,15-82788672-C-T,rs4260027,-1,C,T,82788672,17397,82609461,83002677,179211
15,ENSG00000138615.4,65211473,15-65300413-A-G,rs4315292,-1,A,G,65300413,88940,65014865,65408081,285548
15,ENSG00000138615.4,65211473,15-65300413-A-T,rs4315292,-1,A,T,65300413,88940,65014865,65408081,285548
15,ENSG00000033800.9,68054315,15-67943308-C-T,rs44410,1,C,T,67943308,111007,67857707,68250923,85601
15,ENSG00000128833.8,52295804,15-52489059-A-G,rs4774625,-1,A,G,52489059,193255,52099196,52492412,389863
15,ENSG00000166938.8,66293568,15-66280354-A-C,rs4776774,1,A,C,66280354,13214,66096960,66490176,183394
15,ENSG00000166938.8,66293568,15-66280354-A-G,rs4776774,1,A,G,66280354,13214,66096960,66490176,183394
15,ENSG00000140545.10,88913379,15-88908973-G-C,rs4932450,-1,G,C,88908973,4406,88716771,89109987,192202
15,ENSG00000140545.10,88913379,15-88908973-G-A,rs4932450,-1,G,A,88908973,4406,88716771,89109987,192202
15,ENSG00000166821.4,89690754,15-89631201-C-T,rs55892115,-1,C,T,89631201,59553,89494146,89887362,137055
15,ENSG00000166821.4,89690754,15-89631201-C-A,rs55892115,-1,C,A,89631201,59553,89494146,89887362,137055
15,ENSG00000166821.4,89690754,15-89631201-C-G,rs55892115,-1,C,G,89631201,59553,89494146,89887362,137055
15,ENSG00000174444.9,66504855,15-66491040-G-A,rs56366941,-1,G,A,66491040,13815,66308247,66701463,182793
15,ENSG00000174444.9,66504855,15-66491040-G-T,rs56366941,-1,G,T,66491040,13815,66308247,66701463,182793
15,ENSG00000169410.4,75579315,15-75645913-T-A,rs59366264,-1,T,A,75645913,66598,75382707,75775923,263206
15,ENSG00000169410.4,75579315,15-75645913-T-G,rs59366264,-1,T,G,75645913,66598,75382707,75775923,263206
15,ENSG00000140465.8,74725528,15-74813508-G-A,rs61166890,-1,G,A,74813508,87980,74528920,74922136,284588
15,ENSG00000167202.6,78077711,15-78044961-C-T,rs61732053,-1,C,T,78044961,32750,77881103,78274319,163858
15,ENSG00000167202.6,78077711,15-78044961-C-G,rs61732053,-1,C,G,78044961,32750,77881103,78274319,163858
15,ENSG00000134160.8,31101725,15-31131902-A-C,rs62038949,-1,A,C,31131902,30177,30905117,31298333,226785
15,ENSG00000156970.7,40161069,15-40039001-C-A,rs62621371,1,C,A,40039001,122068,39964461,40357677,74540
15,ENSG00000156970.7,40161069,15-40039001-C-T,rs62621371,1,C,T,40039001,122068,39964461,40357677,74540
15,ENSG00000184984.8,33968497,15-34064787-G-T,rs643827,1,G,T,34064787,96290,33771889,34165105,292898
15,ENSG00000184984.8,33968497,15-34064787-G-A,rs643827,1,G,A,34064787,96290,33771889,34165105,292898
15,ENSG00000184984.8,33968497,15-34064787-G-C,rs643827,1,G,C,34064787,96290,33771889,34165105,292898
15,ENSG00000103966.5,41972557,15-41921473-C-T,rs6493012,-1,C,T,41921473,51084,41775949,42169165,145524
15,ENSG00000166140.12,40807089,15-40813728-T-G,rs690347,1,T,G,40813728,6639,40610481,41003697,203247
15,ENSG00000166140.12,40807089,15-40813728-T-A,rs690347,1,T,A,40813728,6639,40610481,41003697,203247
15,ENSG00000169330.4,79432336,15-79326290-A-C,rs7163643,1,A,C,79326290,106046,79235728,79628944,90562
15,ENSG00000169330.4,79432336,15-79326290-A-T,rs7163643,1,A,T,79326290,106046,79235728,79628944,90562
15,ENSG00000169330.4,79432336,15-79326290-A-G,rs7163643,1,A,G,79326290,106046,79235728,79628944,90562
15,ENSG00000103657.8,63833948,15-63890192-A-G,rs7164126,-1,A,G,63890192,56244,63637340,64030556,252852
15,ENSG00000140323.4,40358219,15-40361837-A-T,rs7165012,1,A,T,40361837,3618,40161611,40554827,200226
15,ENSG00000140323.4,40358219,15-40361837-A-G,rs7165012,1,A,G,40361837,3618,40161611,40554827,200226
15,ENSG00000140323.4,40358219,15-40361837-A-C,rs7165012,1,A,C,40361837,3618,40161611,40554827,200226
15,ENSG00000166411.9,78149362,15-78142722-C-G,rs7165154,1,C,G,78142722,6640,77952754,78345970,189968
15,ENSG00000259332.2,79923744,15-79834133-C-T,rs7166109,-1,C,T,79834133,89611,79727136,80120352,106997
15,ENSG00000128872.5,51751597,15-51725899-A-C,rs7174616,1,A,C,51725899,25698,51554989,51948205,170910
15,ENSG00000140463.9,72686207,15-72819376-T-A,rs7178889,1,T,A,72819376,133169,72489599,72882815,329777
15,ENSG00000140463.9,72686207,15-72819376-T-C,rs7178889,1,T,C,72819376,133169,72489599,72882815,329777
15,ENSG00000140307.6,59657515,15-59532154-G-T,rs7181403,-1,G,T,59532154,125361,59460907,59854123,71247
15,ENSG00000140307.6,59657515,15-59532154-G-A,rs7181403,-1,G,A,59532154,125361,59460907,59854123,71247
15,ENSG00000104067.11,29822468,15-29738128-T-C,rs7183108,-1,T,C,29738128,84340,29625860,30019076,112268
15,ENSG00000104067.11,29822468,15-29738128-T-G,rs7183108,-1,T,G,29738128,84340,29625860,30019076,112268
15,ENSG00000104067.11,29822468,15-29738128-T-A,rs7183108,-1,T,A,29738128,84340,29625860,30019076,112268
15,ENSG00000103994.10,42491141,15-42480407-T-C,rs72711747,-1,T,C,42480407,10734,42294533,42687749,185874
15,ENSG00000167178.10,74130586,15-73959174-C-T,rs72745376,1,C,T,73959174,171412,73933978,74327194,25196
15,ENSG00000196547.9,90903302,15-90976616-C-T,rs72759311,1,C,T,90976616,73314,90706694,91099910,269922
15,ENSG00000196547.9,90903302,15-90976616-C-G,rs72759311,1,C,G,90976616,73314,90706694,91099910,269922
15,ENSG00000064726.5,83067252,15-82896041-A-C,rs7496832,-1,A,C,82896041,171211,82870644,83263860,25397
15,ENSG00000182636.4,23687305,15-23703424-G-A,rs7497973,-1,G,A,23703424,16119,23490697,23883913,212727
15,ENSG00000069974.10,55289813,15-55098373-C-T,rs75442458,-1,C,T,55098373,191440,55093205,55486421,5168
15,ENSG00000138617.10,65286883,15-65234463-A-C,rs755115,-1,A,C,65234463,52420,65090275,65483491,144188
15,ENSG00000138617.10,65286883,15-65234463-A-T,rs755115,-1,A,T,65234463,52420,65090275,65483491,144188
15,ENSG00000103742.6,65422947,15-65385704-G-A,rs75957309,-1,G,A,65385704,37243,65226339,65619555,159365
15,ENSG00000188779.6,67825509,15-67944411-G-C,rs76164334,1,G,C,67944411,118902,67628901,68022117,315510
15,ENSG00000188779.6,67825509,15-67944411-G-A,rs76164334,1,G,A,67944411,118902,67628901,68022117,315510
15,ENSG00000173548.8,75647912,15-75697715-C-T,rs76807356,1,C,T,75697715,49803,75451304,75844520,246411
15,ENSG00000140598.9,82262734,15-82102311-C-T,rs76996690,-1,C,T,82102311,160423,82066126,82459342,36185
15,ENSG00000167196.9,75903878,15-75863252-C-T,rs78890153,1,C,T,75863252,40626,75707270,76100486,155982
15,ENSG00000104081.9,40108879,15-40075804-A-G,rs79281969,-1,A,G,40075804,33075,39912271,40305487,163533
15,ENSG00000188659.5,82262818,15-82114009-C-T,rs79764646,1,C,T,82114009,148809,82066210,82459426,47799
15,ENSG00000181026.12,88621340,15-88621800-T-C,rs8024058,1,T,C,88621800,460,88424732,88817948,197068
15,ENSG00000181026.12,88621340,15-88621800-T-A,rs8024058,1,T,A,88621800,460,88424732,88817948,197068
15,ENSG00000182175.9,93089211,15-93083263-T-C,rs80242818,-1,T,C,93083263,5948,92892603,93285819,190660
15,ENSG00000261652.2,55408495,15-55361393-A-G,rs8027135,1,A,G,55361393,47102,55211887,55605103,149506
15,ENSG00000157470.7,59438186,15-59624708-A-G,rs8028337,1,A,G,59624708,186522,59241578,59634794,383130
15,ENSG00000140406.2,81000923,15-80888640-G-A,rs8028511,1,G,A,80888640,112283,80804315,81197531,84325
15,ENSG00000198901.9,90994535,15-91119486-T-C,rs8034560,-1,T,C,91119486,124951,90797927,91191143,321559
15,ENSG00000138604.4,69160635,15-69117654-T-C,rs8035692,1,T,C,69117654,42981,68964027,69357243,153627
15,ENSG00000172575.6,38564814,15-38591164-A-C,rs8036582,-1,A,C,38591164,26350,38368206,38761422,222958
15,ENSG00000172575.6,38564814,15-38591164-A-G,rs8036582,-1,A,G,38591164,26350,38368206,38761422,222958
15,ENSG00000172575.6,38564814,15-38591164-A-T,rs8036582,-1,A,T,38591164,26350,38368206,38761422,222958
15,ENSG00000159433.7,42575606,15-42694939-C-T,rs8039217,1,C,T,42694939,119333,42378998,42772214,315941
15,ENSG00000159433.7,42575606,15-42694939-C-A,rs8039217,1,C,A,42694939,119333,42378998,42772214,315941
15,ENSG00000156232.5,82809628,15-82851830-G-A,rs899746,1,G,A,82851830,42202,82613020,83006236,238810
15,ENSG00000140443.9,98648539,15-98717374-A-T,rs907813,1,A,T,98717374,68835,98451931,98845147,265443
15,ENSG00000140443.9,98648539,15-98717374-A-G,rs907813,1,A,G,98717374,68835,98451931,98845147,265443
15,ENSG00000140443.9,98648539,15-98717374-A-C,rs907813,1,A,C,98717374,68835,98451931,98845147,265443
15,ENSG00000136371.5,79897014,15-79919554-A-G,rs934136,-1,A,G,79919554,22540,79700406,80093622,219148
15,ENSG00000178802.12,74890042,15-74839618-A-G,rs936227,1,A,G,74839618,50424,74693434,75086650,146184
15,ENSG00000166946.8,43185403,15-43251498-A-G,rs9652444,1,A,G,43251498,66095,42988795,43382011,262703
15,ENSG00000171763.13,45402336,15-45448014-T-A,rs9806724,1,T,A,45448014,45678,45205728,45598944,242286
15,ENSG00000171763.13,45402336,15-45448014-T-C,rs9806724,1,T,C,45448014,45678,45205728,45598944,242286
15,ENSG00000177971.6,75640224,15-75635376-G-A,rs9920028,-1,G,A,75635376,4848,75443616,75836832,191760
15,ENSG00000177971.6,75640224,15-75635376-G-C,rs9920028,-1,G,C,75635376,4848,75443616,75836832,191760
15,ENSG00000128891.11,40565042,15-40456519-C-T,rs9972363,-1,C,T,40456519,108523,40368434,40761650,88085
15,ENSG00000128891.11,40565042,15-40456519-C-G,rs9972363,-1,C,G,40456519,108523,40368434,40761650,88085
15,ENSG00000069869.11,55993612,15-56092441-G-C,rs9972586,-1,G,C,56092441,98829,55797004,56190220,295437
15,ENSG00000069869.11,55993612,15-56092441-G-A,rs9972586,-1,G,A,56092441,98829,55797004,56190220,295437
15,ENSG00000103995.8,48811069,15-48880120-T-G,rs10519197,-1,T,G,48880120,69051,48614461,49007677,265659
15,ENSG00000041357.11,78540444,15-78521704-G-C,rs10519203,1,G,C,78521704,18740,78343836,78737052,177868
15,ENSG00000041357.11,78540444,15-78521704-G-T,rs10519203,1,G,T,78521704,18740,78343836,78737052,177868
15,ENSG00000041357.11,78540444,15-78521704-G-A,rs10519203,1,G,A,78521704,18740,78343836,78737052,177868
15,ENSG00000138613.9,63277605,15-63308677-T-C,rs10519204,1,T,C,63308677,31072,63080997,63474213,227680
15,ENSG00000137806.4,41402496,15-41341872-C-T,rs10851404,-1,C,T,41341872,60624,41205888,41599104,135984
15,ENSG00000137806.4,41402496,15-41341872-C-G,rs10851404,-1,C,G,41341872,60624,41205888,41599104,135984
15,ENSG00000137806.4,41402496,15-41341872-C-A,rs10851404,-1,C,A,41341872,60624,41205888,41599104,135984
15,ENSG00000171262.7,38454127,15-38555562-A-C,rs11073337,1,A,C,38555562,101435,38257519,38650735,298043
15,ENSG00000181991.11,88467708,15-88567604-C-T,rs11073790,1,C,T,88567604,99896,88271100,88664316,296504
15,ENSG00000181991.11,88467708,15-88567604-C-A,rs11073790,1,C,A,88567604,99896,88271100,88664316,296504
15,ENSG00000140534.9,89575469,15-89646817-A-C,rs1110060,1,A,C,89646817,71348,89378861,89772077,267956
15,ENSG00000140534.9,89575469,15-89646817-A-T,rs1110060,1,A,T,89646817,71348,89378861,89772077,267956
15,ENSG00000140534.9,89575469,15-89646817-A-G,rs1110060,1,A,G,89646817,71348,89378861,89772077,267956
15,ENSG00000140332.11,70097917,15-70241118-T-G,rs11631012,-1,T,G,70241118,143201,69901309,70294525,339809
15,ENSG00000140332.11,70097917,15-70241118-T-C,rs11631012,-1,T,C,70241118,143201,69901309,70294525,339809
15,ENSG00000140332.11,70097917,15-70241118-T-A,rs11631012,-1,T,A,70241118,143201,69901309,70294525,339809
15,ENSG00000172345.8,81324141,15-81269018-T-C,rs11633024,-1,T,C,81269018,55123,81127533,81520749,141485
15,ENSG00000136379.7,80695310,15-80753784-A-T,rs11633987,1,A,T,80753784,58474,80498702,80891918,255082
15,ENSG00000136379.7,80695310,15-80753784-A-G,rs11633987,1,A,G,80753784,58474,80498702,80891918,255082
15,ENSG00000169371.9,75625725,15-75626854-G-A,rs11634828,-1,G,A,75626854,1129,75429117,75822333,197737
15,ENSG00000137767.9,45635029,15-45654433-T-C,rs11637833,1,T,C,45654433,19404,45438421,45831637,216012
15,ENSG00000157823.11,89893994,15-89852047-A-G,rs11637921,-1,A,G,89852047,41947,89697386,90090602,154661
15,ENSG00000166503.4,83207823,15-83158544-T-C,rs116957980,-1,T,C,83158544,49279,83011215,83404431,147329
15,ENSG00000255529.3,57706714,15-57823447-G-A,rs117293196,1,G,A,57823447,116733,57510106,57903322,313341
15,ENSG00000255529.3,57706714,15-57823447-G-C,rs117293196,1,G,C,57823447,116733,57510106,57903322,313341
15,ENSG00000255529.3,57706714,15-57823447-G-T,rs117293196,1,G,T,57823447,116733,57510106,57903322,313341
15,ENSG00000188779.6,67825509,15-67938195-G-C,rs117397768,1,G,C,67938195,112686,67628901,68022117,309294
15,ENSG00000188779.6,67825509,15-67938195-G-A,rs117397768,1,G,A,67938195,112686,67628901,68022117,309294
15,ENSG00000104131.8,44537147,15-44576305-T-C,rs118156341,1,T,C,44576305,39158,44340539,44733755,235766
15,ENSG00000166912.11,30991628,15-30954451-A-G,rs11852722,-1,A,G,30954451,37177,30795020,31188236,159431
15,ENSG00000103855.12,73684383,15-73572800-G-T,rs11854267,1,G,T,73572800,111583,73487775,73880991,85025
15,ENSG00000156232.5,82809628,15-82627794-A-T,rs11855735,1,A,T,82627794,181834,82613020,83006236,14774
15,ENSG00000104140.6,40874234,15-40866390-C-G,rs11856227,-1,C,G,40866390,7844,40677626,41070842,188764
15,ENSG00000169758.8,76059985,15-76176740-G-A,rs11856244,1,G,A,76176740,116755,75863377,76256593,313363
15,ENSG00000166821.4,89690754,15-89530308-C-T,rs11857014,-1,C,T,89530308,160446,89494146,89887362,36162
15,ENSG00000198838.6,33310967,15-33414389-A-G,rs11858356,1,A,G,33414389,103422,33114359,33507575,300030
15,ENSG00000166035.6,58431991,15-58522863-C-A,rs12324536,1,C,A,58522863,90872,58235383,58628599,287480
15,ENSG00000166035.6,58431991,15-58522863-C-T,rs12324536,1,C,T,58522863,90872,58235383,58628599,287480
15,ENSG00000069974.10,55289813,15-55232591-G-T,rs12324775,-1,G,T,55232591,57222,55093205,55486421,139386
15,ENSG00000069974.10,55289813,15-55232591-G-A,rs12324775,-1,G,A,55232591,57222,55093205,55486421,139386
15,ENSG00000259417.2,80252213,15-80233577-A-G,rs12439411,-1,A,G,80233577,18636,80055605,80448821,177972
15,ENSG00000259417.2,80252213,15-80233577-A-C,rs12439411,-1,A,C,80233577,18636,80055605,80448821,177972
15,ENSG00000259417.2,80252213,15-80233577-A-T,rs12439411,-1,A,T,80233577,18636,80055605,80448821,177972
15,ENSG00000140471.12,100602184,15-100584624-C-T,rs12441485,-1,C,T,100584624,17560,100405576,100798792,179048
15,ENSG00000168781.14,43590208,15-43748767-T-G,rs12443084,-1,T,G,43748767,158559,43393600,43786816,355167
15,ENSG00000168781.14,43590208,15-43748767-T-A,rs12443084,-1,T,A,43748767,158559,43393600,43786816,355167
15,ENSG00000137842.2,43133586,15-43148458-G-A,rs12594277,1,G,A,43148458,14872,42936978,43330194,211480
15,ENSG00000188501.7,66565497,15-66635903-T-C,rs12902785,-1,T,C,66635903,70406,66368889,66762105,267014
15,ENSG00000181827.10,56243879,15-56361927-G-C,rs12905782,-1,G,C,56361927,118048,56047271,56440487,314656
15,ENSG00000181827.10,56243879,15-56361927-G-T,rs12905782,-1,G,T,56361927,118048,56047271,56440487,314656
15,ENSG00000181827.10,56243879,15-56361927-G-A,rs12905782,-1,G,A,56361927,118048,56047271,56440487,314656
15,ENSG00000069943.5,55319222,15-55514020-A-G,rs12907462,1,A,G,55514020,194798,55122614,55515830,391406
15,ENSG00000069943.5,55319222,15-55514020-A-C,rs12907462,1,A,C,55514020,194798,55122614,55515830,391406
15,ENSG00000166557.8,79311112,15-79277864-A-T,rs12910135,1,A,T,79277864,33248,79114504,79507720,163360
15,ENSG00000166557.8,79311112,15-79277864-A-G,rs12910135,1,A,G,79277864,33248,79114504,79507720,163360
15,ENSG00000178718.5,74956772,15-74958700-C-G,rs12912343,-1,C,G,74958700,1928,74760164,75153380,198536
15,ENSG00000136381.8,78438216,15-78336614-T-C,rs12913251,1,T,C,78336614,101602,78241608,78634824,95006
15,ENSG00000196547.9,90903302,15-90877322-C-T,rs12917264,1,C,T,90877322,25980,90706694,91099910,170628
15,ENSG00000064726.5,83067252,15-83039333-C-T,rs13329195,-1,C,T,83039333,27919,82870644,83263860,168689
15,ENSG00000128881.11,42920778,15-42854796-G-T,rs13380157,-1,G,T,42854796,65982,42724170,43117386,130626
15,ENSG00000128881.11,42920778,15-42854796-G-A,rs13380157,-1,G,A,42854796,65982,42724170,43117386,130626
15,ENSG00000241839.4,64841915,15-64848321-A-G,rs1352093,1,A,G,64848321,6406,64645307,65038523,203014
15,ENSG00000184508.6,90932549,15-90981818-C-A,rs142416384,-1,C,A,90981818,49269,90735941,91129157,245877
15,ENSG00000184508.6,90932549,15-90981818-C-T,rs142416384,-1,C,T,90981818,49269,90735941,91129157,245877
15,ENSG00000184508.6,90932549,15-90981818-C-G,rs142416384,-1,C,G,90981818,49269,90735941,91129157,245877
15,ENSG00000169612.3,82986210,15-82825523-T-C,rs146479592,1,T,C,82825523,160687,82789602,83182818,35921
15,ENSG00000136425.8,78131445,15-78205251-T-A,rs1554377,-1,T,A,78205251,73806,77934837,78328053,270414
15,ENSG00000136425.8,78131445,15-78205251-T-C,rs1554377,-1,T,C,78205251,73806,77934837,78328053,270414
15,ENSG00000140511.7,88895544,15-88840623-C-A,rs16942324,-1,C,A,88840623,54921,88698936,89092152,141687
15,ENSG00000166825.9,89814852,15-89841629-T-C,rs16943645,-1,T,C,89841629,26777,89618244,90011460,223385
15,ENSG00000104055.10,43266928,15-43247919-C-A,rs16957511,-1,C,A,43247919,19009,43070320,43463536,177599
15,ENSG00000156642.12,73633389,15-73729788-T-C,rs16958188,-1,T,C,73729788,96399,73436781,73829997,293007
15,ENSG00000156642.12,73633389,15-73729788-T-A,rs16958188,-1,T,A,73729788,96399,73436781,73829997,293007
15,ENSG00000198794.7,74995563,15-75138635-C-T,rs16966775,1,C,T,75138635,143072,74798955,75192171,339680
15,ENSG00000198794.7,74995563,15-75138635-C-G,rs16966775,1,C,G,75138635,143072,74798955,75192171,339680
15,ENSG00000198794.7,74995563,15-75138635-C-A,rs16966775,1,C,A,75138635,143072,74798955,75192171,339680
15,ENSG00000140319.6,40039181,15-40080930-C-T,rs16970325,-1,C,T,40080930,41749,39842573,40235789,238357
15,ENSG00000140320.7,40440953,15-40589070-C-T,rs16970844,1,C,T,40589070,148117,40244345,40637561,344725
15,ENSG00000137857.11,45129994,15-45168224-A-G,rs1706816,1,A,G,45168224,38230,44933386,45326602,234838
15,ENSG00000259494.1,88467388,15-88277808-T-C,rs17184851,-1,T,C,88277808,189580,88270780,88663996,7028
15,ENSG00000178741.7,74938073,15-75013923-C-T,rs17421513,-1,C,T,75013923,75850,74741465,75134681,272458
15,ENSG00000103723.8,82709875,15-82558175-G-A,rs17507216,-1,G,A,82558175,151700,82513267,82906483,44908
15,ENSG00000136404.11,83107645,15-83053307-A-G,rs17507300,1,A,G,83053307,54338,82911037,83304253,142270
15,ENSG00000138600.5,50765706,15-50747694-T-C,rs17599340,-1,T,C,50747694,18012,50569098,50962314,178596
15,ENSG00000128833.8,52295804,15-52412181-A-G,rs17707717,-1,A,G,52412181,116377,52099196,52492412,312985
15,ENSG00000197535.9,52528880,15-52510881-C-T,rs17708103,-1,C,T,52510881,17999,52332272,52725488,178609
15,ENSG00000172349.11,81196879,15-81297107-G-A,rs17875502,1,G,A,81297107,100228,81000271,81393487,296836
15,ENSG00000183475.8,100602589,15-100721721-C-T,rs1867039,1,C,T,100721721,119132,100405981,100799197,315740
15,ENSG00000183475.8,100602589,15-100721721-C-G,rs1867039,1,C,G,100721721,119132,100405981,100799197,315740
15,ENSG00000198146.4,34988287,15-34962395-A-T,rs2060810,-1,A,T,34962395,25892,34791679,35184895,170716
15,ENSG00000198146.4,34988287,15-34962395-A-G,rs2060810,-1,A,G,34962395,25892,34791679,35184895,170716
15,ENSG00000198146.4,34988287,15-34962395-A-C,rs2060810,-1,A,C,34962395,25892,34791679,35184895,170716
15,ENSG00000197299.5,90717346,15-90884967-T-C,rs2071382,1,T,C,90884967,167621,90520738,90913954,364229
15,ENSG00000197299.5,90717346,15-90884967-T-A,rs2071382,1,T,A,90884967,167621,90520738,90913954,364229
15,ENSG00000182774.6,82540457,15-82654937-C-T,rs2099259,-1,C,T,82654937,114480,82343849,82737065,311088
15,ENSG00000140525.13,89243979,15-89248285-A-T,rs2108600,1,A,T,89248285,4306,89047371,89440587,200914
15,ENSG00000140525.13,89243979,15-89248285-A-G,rs2108600,1,A,G,89248285,4306,89047371,89440587,200914
15,ENSG00000138587.5,56465137,15-56639568-A-G,rs2170463,-1,A,G,56639568,174431,56268529,56661745,371039
15,ENSG00000137841.7,40307935,15-40276622-C-A,rs2242119,-1,C,A,40276622,31313,40111327,40504543,165295
15,ENSG00000137841.7,40307935,15-40276622-C-T,rs2242119,-1,C,T,40276622,31313,40111327,40504543,165295
15,ENSG00000137841.7,40307935,15-40276622-C-G,rs2242119,-1,C,G,40276622,31313,40111327,40504543,165295
15,ENSG00000128951.7,48331429,15-48249830-G-T,rs2279366,1,G,T,48249830,81599,48134821,48528037,115009
15,ENSG00000128951.7,48331429,15-48249830-G-C,rs2279366,1,G,C,48249830,81599,48134821,48528037,115009
15,ENSG00000128951.7,48331429,15-48249830-G-A,rs2279366,1,G,A,48249830,81599,48134821,48528037,115009
15,ENSG00000140521.6,89334824,15-89292997-G-T,rs2283432,-1,G,T,89292997,41827,89138216,89531432,154781
15,ENSG00000140521.6,89334824,15-89292997-G-A,rs2283432,-1,G,A,89292997,41827,89138216,89531432,154781
15,ENSG00000140521.6,89334824,15-89292997-G-C,rs2283432,-1,G,C,89292997,41827,89138216,89531432,154781
15,ENSG00000171989.4,59206843,15-59195731-C-G,rs2306786,1,C,G,59195731,11112,59010235,59403451,185496
15,ENSG00000171989.4,59206843,15-59195731-C-A,rs2306786,1,C,A,59195731,11112,59010235,59403451,185496
15,ENSG00000137834.9,66702236,15-66578630-C-T,rs2414908,1,C,T,66578630,123606,66505628,66898844,73002
15,ENSG00000129028.4,70892433,15-70915612-G-A,rs2415100,-1,G,A,70915612,23179,70695825,71089041,219787
15,ENSG00000140374.11,76311469,15-76181919-T-G,rs2469560,-1,T,G,76181919,129550,76114861,76508077,67058
15,ENSG00000178802.12,74890042,15-74735539-C-A,rs2472297,1,C,A,74735539,154503,74693434,75086650,42105
15,ENSG00000178802.12,74890042,15-74735539-C-T,rs2472297,1,C,T,74735539,154503,74693434,75086650,42105
15,ENSG00000131871.9,101277485,15-101431183-T-C,rs2643356,-1,T,C,101431183,153698,101080877,101474093,350306
15,ENSG00000131871.9,101277485,15-101431183-T-G,rs2643356,-1,T,G,101431183,153698,101080877,101474093,350306
15,ENSG00000131871.9,101277485,15-101431183-T-A,rs2643356,-1,T,A,101431183,153698,101080877,101474093,350306
15,ENSG00000188089.9,42051190,15-42019256-T-A,rs2724935,-1,T,A,42019256,31934,41854582,42247798,164674
15,ENSG00000188089.9,42051190,15-42019256-T-G,rs2724935,-1,T,G,42019256,31934,41854582,42247798,164674
15,ENSG00000137825.6,41493874,15-41374518-A-G,rs28463309,1,A,G,41374518,119356,41297266,41690482,77252
15,ENSG00000186073.7,36579626,15-36491612-C-T,rs28483239,1,C,T,36491612,88014,36383018,36776234,108594
15,ENSG00000173548.8,75647912,15-75800649-G-A,rs28571916,1,G,A,75800649,152737,75451304,75844520,349345
15,ENSG00000168803.10,43330672,15-43296690-C-T,rs28594657,1,C,T,43296690,33982,43134064,43527280,162626
15,ENSG00000168803.10,43330672,15-43296690-C-A,rs28594657,1,C,A,43296690,33982,43134064,43527280,162626
15,ENSG00000167004.7,43746438,15-43785360-C-T,rs28697876,1,C,T,43785360,38922,43549830,43943046,235530
15,ENSG00000159433.7,42575606,15-42525828-T-A,rs2899058,1,T,A,42525828,49778,42378998,42772214,146830
15,ENSG00000159433.7,42575606,15-42525828-T-C,rs2899058,1,T,C,42525828,49778,42378998,42772214,146830
15,ENSG00000140284.6,50182196,15-50074713-G-A,rs2899453,1,G,A,50074713,107483,49985588,50378804,89125
15,ENSG00000140284.6,50182196,15-50074713-G-C,rs2899453,1,G,C,50074713,107483,49985588,50378804,89125
15,ENSG00000159556.5,76336773,15-76193195-A-G,rs2957037,1,A,G,76193195,143578,76140165,76533381,53030
15,ENSG00000159556.5,76336773,15-76193195-A-C,rs2957037,1,A,C,76193195,143578,76140165,76533381,53030
15,ENSG00000138592.8,50424405,15-50531091-T-C,rs3109898,1,T,C,50531091,106686,50227797,50621013,303294
15,ENSG00000182718.11,60397986,15-60224546-T-A,rs338420,-1,T,A,60224546,173440,60201378,60594594,23168
15,ENSG00000182718.11,60397986,15-60224546-T-C,rs338420,-1,T,C,60224546,173440,60201378,60594594,23168
15,ENSG00000182718.11,60397986,15-60224546-T-G,rs338420,-1,T,G,60224546,173440,60201378,60594594,23168
15,ENSG00000140545.10,88913379,15-88912537-C-G,rs34239095,-1,C,G,88912537,842,88716771,89109987,195766
15,ENSG00000103707.5,65029639,15-65004923-C-T,rs34636936,-1,C,T,65004923,24716,64833031,65226247,171892
15,ENSG00000104081.9,40108879,15-40254996-G-A,rs34855281,-1,G,A,40254996,146117,39912271,40305487,342725
15,ENSG00000166947.6,43221018,15-43081731-T-C,rs35900502,-1,T,C,43081731,139287,43024410,43417626,57321
15,ENSG00000166947.6,43221018,15-43081731-T-A,rs35900502,-1,T,A,43081731,139287,43024410,43417626,57321
15,ENSG00000140563.10,94231561,15-94325538-C-G,rs35920993,1,C,G,94325538,93977,94034953,94428169,290585
15,ENSG00000140563.10,94231561,15-94325538-C-A,rs35920993,1,C,A,94325538,93977,94034953,94428169,290585
15,ENSG00000140563.10,94231561,15-94325538-C-T,rs35920993,1,C,T,94325538,93977,94034953,94428169,290585
15,ENSG00000183578.5,51094906,15-51002798-G-T,rs3743045,-1,G,T,51002798,92108,50898298,51291514,104500
15,ENSG00000183578.5,51094906,15-51002798-G-A,rs3743045,-1,G,A,51002798,92108,50898298,51291514,104500
15,ENSG00000140497.11,74873365,15-74830515-C-T,rs3743487,-1,C,T,74830515,42850,74676757,75069973,153758
15,ENSG00000183655.10,85794925,15-85717469-C-T,rs3765096,-1,C,T,85717469,77456,85598317,85991533,119152
15,ENSG00000092439.8,50686797,15-50500677-G-A,rs3803373,-1,G,A,50500677,186120,50490189,50883405,10488
15,ENSG00000067221.9,73992295,15-73990539-C-T,rs3816197,-1,C,T,73990539,1756,73795687,74188903,194852
15,ENSG00000166965.8,90954884,15-90921318-T-C,rs41470046,1,T,C,90921318,33566,90758276,91151492,163042
15,ENSG00000138615.4,65211473,15-65070697-C-T,rs4238400,-1,C,T,65070697,140776,65014865,65408081,55832
15,ENSG00000138615.4,65211473,15-65070697-C-A,rs4238400,-1,C,A,65070697,140776,65014865,65408081,55832
15,ENSG00000137869.8,51338596,15-51534321-A-G,rs4462537,-1,A,G,51534321,195725,51141988,51535204,392333
15,ENSG00000137869.8,51338596,15-51534321-A-T,rs4462537,-1,A,T,51534321,195725,51141988,51535204,392333
15,ENSG00000067141.11,73052463,15-72954813-A-T,rs4468585,1,A,T,72954813,97650,72855855,73249071,98958
15,ENSG00000067141.11,73052463,15-72954813-A-G,rs4468585,1,A,G,72954813,97650,72855855,73249071,98958
15,ENSG00000140564.5,90868588,15-90875361-A-G,rs4526996,1,A,G,90875361,6773,90671980,91065196,203381
15,ENSG00000184254.10,100879831,15-100900850-T-A,rs4646675,1,T,A,100900850,21019,100683223,101076439,217627
15,ENSG00000184254.10,100879831,15-100900850-T-C,rs4646675,1,T,C,100900850,21019,100683223,101076439,217627
15,ENSG00000069869.11,55993612,15-55917970-G-T,rs4774833,-1,G,T,55917970,75642,55797004,56190220,120966
15,ENSG00000069869.11,55993612,15-55917970-G-A,rs4774833,-1,G,A,55917970,75642,55797004,56190220,120966
15,ENSG00000069966.14,52191392,15-52206163-G-C,rs4776016,-1,G,C,52206163,14771,51994784,52388000,211379
15,ENSG00000069966.14,52191392,15-52206163-G-A,rs4776016,-1,G,A,52206163,14771,51994784,52388000,211379
15,ENSG00000174444.9,66504855,15-66592637-T-C,rs4776304,-1,T,C,66592637,87782,66308247,66701463,284390
15,ENSG00000140157.10,22838666,15-22878147-A-T,rs4778455,1,A,T,22878147,39481,22642058,23035274,236089
15,ENSG00000140157.10,22838666,15-22878147-A-G,rs4778455,1,A,G,22878147,39481,22642058,23035274,236089
15,ENSG00000188659.5,82262818,15-82245013-A-C,rs4778672,1,A,C,82245013,17805,82066210,82459426,178803
15,ENSG00000169609.8,83011639,15-82999711-T-C,rs4842859,-1,T,C,82999711,11928,82815031,83208247,184680
15,ENSG00000169609.8,83011639,15-82999711-T-G,rs4842859,-1,T,G,82999711,11928,82815031,83208247,184680
15,ENSG00000169609.8,83011639,15-82999711-T-A,rs4842859,-1,T,A,82999711,11928,82815031,83208247,184680
15,ENSG00000137877.8,41894053,15-41827395-C-T,rs4924576,-1,C,T,41827395,66658,41697445,42090661,129950
15,ENSG00000137877.8,41894053,15-41827395-C-G,rs4924576,-1,C,G,41827395,66658,41697445,42090661,129950
15,ENSG00000137877.8,41894053,15-41827395-C-A,rs4924576,-1,C,A,41827395,66658,41697445,42090661,129950
15,ENSG00000197361.4,63597387,15-63589732-T-C,rs4984303,1,T,C,63589732,7655,63400779,63793995,188953
15,ENSG00000197361.4,63597387,15-63589732-T-A,rs4984303,1,T,A,63589732,7655,63400779,63793995,188953
15,ENSG00000185551.8,96330700,15-96433472-C-T,rs4984547,1,C,T,96433472,102772,96134092,96527308,299380
15,ENSG00000185551.8,96330700,15-96433472-C-A,rs4984547,1,C,A,96433472,102772,96134092,96527308,299380
15,ENSG00000156218.8,83654123,15-83824899-T-C,rs5015595,1,T,C,83824899,170776,83457515,83850731,367384
15,ENSG00000156218.8,83654123,15-83824899-T-A,rs5015595,1,T,A,83824899,170776,83457515,83850731,367384
15,ENSG00000156218.8,83654123,15-83824899-T-G,rs5015595,1,T,G,83824899,170776,83457515,83850731,367384
15,ENSG00000140265.8,43371043,15-43509826-C-A,rs506120,-1,C,A,43509826,138783,43174435,43567651,335391
15,ENSG00000140265.8,43371043,15-43509826-C-G,rs506120,-1,C,G,43509826,138783,43174435,43567651,335391
15,ENSG00000140265.8,43371043,15-43509826-C-T,rs506120,-1,C,T,43509826,138783,43174435,43567651,335391
15,ENSG00000103932.6,41544257,15-41420738-C-G,rs62001419,-1,C,G,41420738,123519,41347649,41740865,73089
15,ENSG00000103932.6,41544257,15-41420738-C-A,rs62001419,-1,C,A,41420738,123519,41347649,41740865,73089
15,ENSG00000075131.5,66356685,15-66315577-C-T,rs62011715,-1,C,T,66315577,41108,66160077,66553293,155500
15,ENSG00000103657.8,63833948,15-63863320-G-A,rs62023084,-1,G,A,63863320,29372,63637340,64030556,225980
15,ENSG00000140553.11,90935285,15-90941029-G-A,rs62026692,1,G,A,90941029,5744,90738677,91131893,202352
15,ENSG00000140368.8,76995126,15-76988181-C-T,rs62027296,1,C,T,76988181,6945,76798518,77191734,189663
15,ENSG00000167173.13,75201882,15-75172710-G-C,rs6495163,1,G,C,75172710,29172,75005274,75398490,167436
15,ENSG00000167173.13,75201882,15-75172710-G-A,rs6495163,1,G,A,75172710,29172,75005274,75398490,167436
15,ENSG00000103888.10,80779370,15-80882203-G-A,rs6495528,1,G,A,80882203,102833,80582762,80975978,299441
15,ENSG00000117899.6,80989819,15-80908355-T-C,rs6495533,-1,T,C,80908355,81464,80793211,81186427,115144
15,ENSG00000140548.5,90001324,15-90094960-T-C,rs6496622,1,T,C,90094960,93636,89804716,90197932,290244
15,ENSG00000170776.14,85380603,15-85413397-C-A,rs6497117,1,C,A,85413397,32794,85183995,85577211,229402
15,ENSG00000170776.14,85380603,15-85413397-C-G,rs6497117,1,C,G,85413397,32794,85183995,85577211,229402
15,ENSG00000170776.14,85380603,15-85413397-C-T,rs6497117,1,C,T,85413397,32794,85183995,85577211,229402
15,ENSG00000242866.3,43618800,15-43798656-T-G,rs654276,-1,T,G,43798656,179856,43422192,43815408,376464
15,ENSG00000242866.3,43618800,15-43798656-T-C,rs654276,-1,T,C,43798656,179856,43422192,43815408,376464
15,ENSG00000242866.3,43618800,15-43798656-T-A,rs654276,-1,T,A,43798656,179856,43422192,43815408,376464
15,ENSG00000136371.5,79897014,15-79843787-A-C,rs685487,-1,A,C,79843787,53227,79700406,80093622,143381
15,ENSG00000136371.5,79897014,15-79843787-A-G,rs685487,-1,A,G,79843787,53227,79700406,80093622,143381
15,ENSG00000168806.6,43330573,15-43327875-A-C,rs7048,-1,A,C,43327875,2698,43133965,43527181,193910
15,ENSG00000137817.11,72272554,15-72216943-G-A,rs71395068,-1,G,A,72216943,55611,72075946,72469162,140997
15,ENSG00000159322.11,72783758,15-72629225-C-T,rs71397261,-1,C,T,72629225,154533,72587150,72980366,42075
15,ENSG00000140323.4,40358219,15-40270054-C-G,rs7162220,1,C,G,40270054,88165,40161611,40554827,108443
15,ENSG00000140323.4,40358219,15-40270054-C-A,rs7162220,1,C,A,40270054,88165,40161611,40554827,108443
15,ENSG00000140416.14,63042747,15-63146987-C-T,rs7162825,1,C,T,63146987,104240,62846139,63239355,300848
15,ENSG00000128928.4,40405795,15-40361837-A-C,rs7165012,1,A,C,40361837,43958,40209187,40602403,152650
15,ENSG00000128928.4,40405795,15-40361837-A-T,rs7165012,1,A,T,40361837,43958,40209187,40602403,152650
15,ENSG00000128928.4,40405795,15-40361837-A-G,rs7165012,1,A,G,40361837,43958,40209187,40602403,152650
15,ENSG00000128918.9,58065711,15-58260407-T-C,rs7165301,-1,T,C,58260407,194696,57869103,58262319,391304
15,ENSG00000103852.8,99249581,15-99132394-G-C,rs7167599,-1,G,C,99132394,117187,99052973,99446189,79421
15,ENSG00000103811.10,78945046,15-78836547-G-C,rs7168915,-1,G,C,78836547,108499,78748438,79141654,88109
15,ENSG00000103811.10,78945046,15-78836547-G-A,rs7168915,-1,G,A,78836547,108499,78748438,79141654,88109
15,ENSG00000185418.10,101724473,15-101602444-A-G,rs7169834,-1,A,G,101602444,122029,101527865,101921081,74579
15,ENSG00000140527.10,89690811,15-89683716-C-A,rs7169981,1,C,A,89683716,7095,89494203,89887419,189513
15,ENSG00000140527.10,89690811,15-89683716-C-T,rs7169981,1,C,T,89683716,7095,89494203,89887419,189513
15,ENSG00000172575.6,38564814,15-38618343-G-T,rs7173588,-1,G,T,38618343,53529,38368206,38761422,250137
15,ENSG00000136378.9,78811464,15-78858944-G-A,rs7174727,-1,G,A,78858944,47480,78614856,79008072,244088
15,ENSG00000136378.9,78811464,15-78858944-G-C,rs7174727,-1,G,C,78858944,47480,78614856,79008072,244088
15,ENSG00000188467.6,48120990,15-48301054-T-G,rs7174935,1,T,G,48301054,180064,47924382,48317598,376672
15,ENSG00000140406.2,81000923,15-81140108-G-T,rs7175033,1,G,T,81140108,139185,80804315,81197531,335793
15,ENSG00000140406.2,81000923,15-81140108-G-A,rs7175033,1,G,A,81140108,139185,80804315,81197531,335793
15,ENSG00000259332.2,79923744,15-79865700-A-C,rs7177659,-1,A,C,79865700,58044,79727136,80120352,138564
15,ENSG00000103740.5,78234565,15-78100015-G-A,rs7182113,-1,G,A,78100015,134550,78037957,78431173,62058
15,ENSG00000187446.7,41231268,15-41046071-C-T,rs7182660,1,C,T,41046071,185197,41034660,41427876,11411
15,ENSG00000166145.9,40844048,15-40867107-C-T,rs72735657,1,C,T,40867107,23059,40647440,41040656,219667
15,ENSG00000128973.7,68229728,15-68403450-G-A,rs72745265,-1,G,A,68403450,173722,68033120,68426336,370330
15,ENSG00000182253.10,99105080,15-99281840-G-A,rs72758808,1,G,A,99281840,176760,98908472,99301688,373368
15,ENSG00000185043.6,90233941,15-90170718-G-T,rs73473569,-1,G,T,90170718,63223,90037333,90430549,133385
15,ENSG00000185043.6,90233941,15-90170718-G-A,rs73473569,-1,G,A,90170718,63223,90037333,90430549,133385
15,ENSG00000229474.2,44711323,15-44528165-G-C,rs74405840,-1,G,C,44528165,183158,44514715,44907931,13450
15,ENSG00000166949.10,67065602,15-67142737-G-A,rs745103,1,G,A,67142737,77135,66868994,67262210,273743
15,ENSG00000166949.10,67065602,15-67142737-G-T,rs745103,1,G,T,67142737,77135,66868994,67262210,273743
15,ENSG00000166710.11,44711517,15-44642057-T-G,rs75231500,1,T,G,44642057,69460,44514909,44908125,127148
15,ENSG00000166710.11,44711517,15-44642057-T-C,rs75231500,1,T,C,44642057,69460,44514909,44908125,127148
15,ENSG00000188095.3,89776332,15-89914675-G-A,rs75287267,1,G,A,89914675,138343,89579724,89972940,334951
15,ENSG00000246922.4,65115200,15-65064448-T-C,rs75833994,-1,T,C,65064448,50752,64918592,65311808,145856
15,ENSG00000128917.5,40929340,15-40979859-G-A,rs76495904,1,G,A,40979859,50519,40732732,41125948,247127
15,ENSG00000169926.5,31326835,15-31145508-C-T,rs76711855,1,C,T,31145508,181327,31130227,31523443,15281
15,ENSG00000092470.7,43827002,15-44007228-A-T,rs77207316,1,A,T,44007228,180226,43630394,44023610,376834
15,ENSG00000092470.7,43827002,15-44007228-A-G,rs77207316,1,A,G,44007228,180226,43630394,44023610,376834
15,ENSG00000172183.10,88639016,15-88536489-G-A,rs78488722,1,G,A,88536489,102527,88442408,88835624,94081
15,ENSG00000167202.6,78077711,15-78235233-G-A,rs78565759,-1,G,A,78235233,157522,77881103,78274319,354130
15,ENSG00000166797.6,64093838,15-64234123-A-C,rs79079416,-1,A,C,64234123,140285,63897230,64290446,336893
15,ENSG00000104047.10,49621048,15-49720206-G-A,rs8024469,1,G,A,49720206,99158,49424440,49817656,295766
15,ENSG00000103978.10,42273433,15-42148607-A-G,rs80260937,-1,A,G,42148607,124826,42076825,42470041,71782
15,ENSG00000104164.5,45587379,15-45695808-C-T,rs8026116,1,C,T,45695808,108429,45390771,45783987,305037
15,ENSG00000104164.5,45587379,15-45695808-C-G,rs8026116,1,C,G,45695808,108429,45390771,45783987,305037
15,ENSG00000259330.1,40323692,15-40249253-A-G,rs8029043,1,A,G,40249253,74439,40127084,40520300,122169
15,ENSG00000259330.1,40323692,15-40249253-A-T,rs8029043,1,A,T,40249253,74439,40127084,40520300,122169
15,ENSG00000166192.10,72118403,15-71950842-G-A,rs8032280,1,G,A,71950842,167561,71921795,72315011,29047
15,ENSG00000140598.9,82262734,15-82095586-A-G,rs8033451,-1,A,G,82095586,167148,82066126,82459342,29460
15,ENSG00000140598.9,82262734,15-82095586-A-C,rs8033451,-1,A,C,82095586,167148,82066126,82459342,29460
15,ENSG00000261652.2,55408495,15-55488020-G-A,rs8034213,1,G,A,55488020,79525,55211887,55605103,276133
15,ENSG00000169330.4,79432336,15-79321882-A-G,rs8037898,1,A,G,79321882,110454,79235728,79628944,86154
15,ENSG00000169330.4,79432336,15-79321882-A-C,rs8037898,1,A,C,79321882,110454,79235728,79628944,86154
15,ENSG00000169330.4,79432336,15-79321882-A-T,rs8037898,1,A,T,79321882,110454,79235728,79628944,86154
15,ENSG00000184277.8,101652381,15-101561555-A-T,rs8038697,-1,A,T,101561555,90826,101455773,101848989,105782
15,ENSG00000184277.8,101652381,15-101561555-A-G,rs8038697,-1,A,G,101561555,90826,101455773,101848989,105782
15,ENSG00000184277.8,101652381,15-101561555-A-C,rs8038697,-1,A,C,101561555,90826,101455773,101848989,105782
15,ENSG00000179151.7,74696024,15-74759278-C-A,rs8038819,-1,C,A,74759278,63254,74499416,74892632,259862
15,ENSG00000166938.8,66293568,15-66263816-A-G,rs8040520,1,A,G,66263816,29752,66096960,66490176,166856
15,ENSG00000185033.10,90201330,15-90143029-G-C,rs908045,1,G,C,90143029,58301,90004722,90397938,138307
15,ENSG00000185033.10,90201330,15-90143029-G-T,rs908045,1,G,T,90143029,58301,90004722,90397938,138307
15,ENSG00000074696.7,65530463,15-65555584-G-A,rs919999,1,G,A,65555584,25121,65333855,65727071,221729
15,ENSG00000182768.7,90265672,15-90266401-G-T,rs9635390,1,G,T,90266401,729,90069064,90462280,197337
15,ENSG00000182768.7,90265672,15-90266401-G-A,rs9635390,1,G,A,90266401,729,90069064,90462280,197337
15,ENSG00000140403.7,78264562,15-78373969-A-T,rs9920189,1,A,T,78373969,109407,78067954,78461170,306015
15,ENSG00000140403.7,78264562,15-78373969-A-C,rs9920189,1,A,C,78373969,109407,78067954,78461170,306015
15,ENSG00000166823.5,89751249,15-89711569-C-A,rs9920376,-1,C,A,89711569,39680,89554641,89947857,156928
15,ENSG00000166823.5,89751249,15-89711569-C-T,rs9920376,-1,C,T,89711569,39680,89554641,89947857,156928
15,ENSG00000128829.6,39934115,15-40086266-A-T,rs998713,1,A,T,40086266,152151,39737507,40130723,348759
15,ENSG00000128829.6,39934115,15-40086266-A-C,rs998713,1,A,C,40086266,152151,39737507,40130723,348759
15,ENSG00000128829.6,39934115,15-40086266-A-G,rs998713,1,A,G,40086266,152151,39737507,40130723,348759
14,ENSG00000126214.14,103629211,14-103574964-C-A,rs10129298,1,C,A,103574964,54247,103432603,103825819,142361
14,ENSG00000157379.9,24299780,14-24291558-G-A,rs10134537,-1,G,A,24291558,8222,24103172,24496388,188386
14,ENSG00000178974.4,55271421,14-55348214-T-C,rs10134838,1,T,C,55348214,76793,55074813,55468029,273401
14,ENSG00000178974.4,55271421,14-55348214-T-A,rs10134838,1,T,A,55348214,76793,55074813,55468029,273401
14,ENSG00000151327.7,35046272,14-35048404-G-C,rs10136692,1,G,C,35048404,2132,34849664,35242880,198740
14,ENSG00000151327.7,35046272,14-35048404-G-A,rs10136692,1,G,A,35048404,2132,34849664,35242880,198740
14,ENSG00000165948.6,94081310,14-94106085-T-C,rs10139429,1,T,C,94106085,24775,93884702,94277918,221383
14,ENSG00000165948.6,94081310,14-94106085-T-G,rs10139429,1,T,G,94106085,24775,93884702,94277918,221383
14,ENSG00000100721.6,95714125,14-95684228-A-G,rs10141005,-1,A,G,95684228,29897,95517517,95910733,166711
14,ENSG00000119684.11,75051467,14-75058746-G-T,rs10142770,-1,G,T,75058746,7279,74854859,75248075,203887
14,ENSG00000119684.11,75051467,14-75058746-G-A,rs10142770,-1,G,A,75058746,7279,74854859,75248075,203887
14,ENSG00000092203.7,21477195,14-21439685-G-T,rs10143061,1,G,T,21439685,37510,21280587,21673803,159098
14,ENSG00000092203.7,21477195,14-21439685-G-C,rs10143061,1,G,C,21439685,37510,21280587,21673803,159098
14,ENSG00000092203.7,21477195,14-21439685-G-A,rs10143061,1,G,A,21439685,37510,21280587,21673803,159098
14,ENSG00000214274.5,20688764,14-20737520-C-T,rs10144370,1,C,T,20737520,48756,20492156,20885372,245364
14,ENSG00000196943.7,24299850,14-24211928-T-C,rs10144791,1,T,C,24211928,87922,24103242,24496458,108686
14,ENSG00000100441.5,24429954,14-24429988-C-T,rs10146759,1,C,T,24429988,34,24233346,24626562,196642
14,ENSG00000100441.5,24429954,14-24429988-C-G,rs10146759,1,C,G,24429988,34,24233346,24626562,196642
14,ENSG00000184304.10,29927847,14-29847927-A-G,rs10147856,-1,A,G,29847927,79920,29731239,30124455,116688
14,ENSG00000184304.10,29927847,14-29847927-A-T,rs10147856,-1,A,T,29847927,79920,29731239,30124455,116688
14,ENSG00000129484.9,20343635,14-20361807-C-A,rs10148359,1,C,A,20361807,18172,20147027,20540243,214780
14,ENSG00000100483.8,50116572,14-50123160-G-C,rs10151119,-1,G,C,50123160,6588,49919964,50313180,203196
14,ENSG00000100483.8,50116572,14-50123160-G-T,rs10151119,-1,G,T,50123160,6588,49919964,50313180,203196
14,ENSG00000100483.8,50116572,14-50123160-G-A,rs10151119,-1,G,A,50123160,6588,49919964,50313180,203196
14,ENSG00000139910.15,26598033,14-26544822-T-C,rs10151855,-1,T,C,26544822,53211,26401425,26794641,143397
14,ENSG00000139910.15,26598033,14-26544822-T-G,rs10151855,-1,T,G,26544822,53211,26401425,26794641,143397
14,ENSG00000100632.6,69398299,14-69322186-A-T,rs1016692,-1,A,T,69322186,76113,69201691,69594907,120495
14,ENSG00000100632.6,69398299,14-69322186-A-C,rs1016692,-1,A,C,69322186,76113,69201691,69594907,120495
14,ENSG00000100632.6,69398299,14-69322186-A-G,rs1016692,-1,A,G,69322186,76113,69201691,69594907,120495
14,ENSG00000072110.9,68979302,14-68985371-A-G,rs10220411,-1,A,G,68985371,6069,68782694,69175910,202677
14,ENSG00000119682.10,74713080,14-74716536-G-A,rs10438025,-1,G,A,74716536,3456,74516472,74909688,200064
14,ENSG00000139985.4,70452174,14-70593927-C-T,rs10483831,1,C,T,70593927,141753,70255566,70648782,338361
14,ENSG00000071246.5,76761468,14-76715959-C-T,rs10483877,1,C,T,76715959,45509,76564860,76958076,151099
14,ENSG00000139990.13,69153119,14-69083045-C-T,rs10498527,-1,C,T,69083045,70074,68956511,69349727,126534
14,ENSG00000129562.5,22589224,14-22589178-G-C,rs1051101,-1,G,C,22589178,46,22392616,22785832,196562
14,ENSG00000129562.5,22589224,14-22589178-G-T,rs1051101,-1,G,T,22589178,46,22392616,22785832,196562
14,ENSG00000129562.5,22589224,14-22589178-G-A,rs1051101,-1,G,A,22589178,46,22392616,22785832,196562
14,ENSG00000081181.3,67619920,14-67677474-A-C,rs1059238,1,A,C,67677474,57554,67423312,67816528,254162
14,ENSG00000081181.3,67619920,14-67677474-A-T,rs1059238,1,A,T,67677474,57554,67423312,67816528,254162
14,ENSG00000081181.3,67619920,14-67677474-A-G,rs1059238,1,A,G,67677474,57554,67423312,67816528,254162
14,ENSG00000197119.7,100306444,14-100302826-C-A,rs1059264,-1,C,A,100302826,3618,100109836,100503052,192990
14,ENSG00000197119.7,100306444,14-100302826-C-G,rs1059264,-1,C,G,100302826,3618,100109836,100503052,192990
14,ENSG00000197119.7,100306444,14-100302826-C-T,rs1059264,-1,C,T,100302826,3618,100109836,100503052,192990
14,ENSG00000100664.6,103334237,14-103324708-T-A,rs1079298,1,T,A,103324708,9529,103137629,103530845,187079
14,ENSG00000100664.6,103334237,14-103324708-T-C,rs1079298,1,T,C,103324708,9529,103137629,103530845,187079
14,ENSG00000198252.7,52730166,14-52770503-G-T,rs10873061,1,G,T,52770503,40337,52533558,52926774,236945
14,ENSG00000198252.7,52730166,14-52770503-G-A,rs10873061,1,G,A,52770503,40337,52533558,52926774,236945
14,ENSG00000087299.6,50312229,14-50272767-A-T,rs11157734,-1,A,T,50272767,39462,50115621,50508837,157146
14,ENSG00000087299.6,50312229,14-50272767-A-C,rs11157734,-1,A,C,50272767,39462,50115621,50508837,157146
14,ENSG00000258289.2,64914455,14-64933351-C-T,rs11158569,1,C,T,64933351,18896,64717847,65111063,215504
14,ENSG00000257365.2,64986895,14-64933351-C-T,rs11158569,1,C,T,64933351,53544,64790287,65183503,143064
14,ENSG00000140006.7,63641871,14-63688708-T-C,rs113338490,-1,T,C,63688708,46837,63445263,63838479,243445
14,ENSG00000092010.10,24136194,14-24137907-A-G,rs11574509,1,A,G,24137907,1713,23939586,24332802,198321
14,ENSG00000092010.10,24136194,14-24137907-A-C,rs11574509,1,A,C,24137907,1713,23939586,24332802,198321
14,ENSG00000177465.4,73591873,14-73627771-C-T,rs11621630,1,C,T,73627771,35898,73395265,73788481,232506
14,ENSG00000165804.9,21098655,14-21077514-G-A,rs11621987,-1,G,A,21077514,21141,20902047,21295263,175467
14,ENSG00000182512.4,95535050,14-95532127-T-A,rs11623011,1,T,A,95532127,2923,95338442,95731658,193685
14,ENSG00000182512.4,95535050,14-95532127-T-C,rs11623011,1,T,C,95532127,2923,95338442,95731658,193685
14,ENSG00000165555.5,77423523,14-77446519-A-C,rs11623826,-1,A,C,77446519,22996,77226915,77620131,219604
14,ENSG00000165555.5,77423523,14-77446519-A-T,rs11623826,-1,A,T,77446519,22996,77226915,77620131,219604
14,ENSG00000165555.5,77423523,14-77446519-A-G,rs11623826,-1,A,G,77446519,22996,77226915,77620131,219604
14,ENSG00000100433.11,88323269,14-88256030-A-G,rs11625811,-1,A,G,88256030,67239,88126661,88519877,129369
14,ENSG00000139998.9,64972336,14-65013490-T-C,rs11627382,-1,T,C,65013490,41154,64775728,65168944,237762
14,ENSG00000139998.9,64972336,14-65013490-T-A,rs11627382,-1,T,A,65013490,41154,64775728,65168944,237762
14,ENSG00000080815.13,73136507,14-73255067-C-T,rs11628713,1,C,T,73255067,118560,72939899,73333115,315168
14,ENSG00000155463.7,22766688,14-22725709-C-T,rs11629374,1,C,T,22725709,40979,22570080,22963296,155629
14,ENSG00000198133.4,67488721,14-67572172-C-T,rs116547943,-1,C,T,67572172,83451,67292113,67685329,280059
14,ENSG00000134001.7,67360328,14-67383660-G-A,rs116606923,1,G,A,67383660,23332,67163720,67556936,219940
14,ENSG00000169413.2,20781268,14-20815103-G-T,rs117312991,1,G,T,20815103,33835,20584660,20977876,230443
14,ENSG00000196792.6,31026379,14-31044811-C-T,rs117642945,-1,C,T,31044811,18432,30829771,31222987,215040
14,ENSG00000099814.8,104865268,14-104918911-G-A,rs117723806,1,G,A,104918911,53643,104668660,105061876,250251
14,ENSG00000183576.8,99480859,14-99385405-C-T,rs117842008,-1,C,T,99385405,95454,99284251,99677467,101154
14,ENSG00000170270.4,93207065,14-93087371-A-G,rs11845823,-1,A,G,93087371,119694,93010457,93403673,76914
14,ENSG00000165929.8,91867536,14-91765281-G-T,rs11845931,-1,G,T,91765281,102255,91670928,92064144,94353
14,ENSG00000165929.8,91867536,14-91765281-G-A,rs11845931,-1,G,A,91765281,102255,91670928,92064144,94353
14,ENSG00000042088.9,89955927,14-89791691-G-A,rs11848140,1,G,A,89791691,164236,89759319,90152535,32372
14,ENSG00000184887.9,105248533,14-105280460-C-G,rs11850884,1,C,G,105280460,31927,105051925,105445141,228535
14,ENSG00000184887.9,105248533,14-105280460-C-T,rs11850884,1,C,T,105280460,31927,105051925,105445141,228535
14,ENSG00000139946.5,56118411,14-55985805-T-C,rs1188160,1,T,C,55985805,132606,55921803,56315019,64002
14,ENSG00000139946.5,56118411,14-55985805-T-A,rs1188160,1,T,A,55985805,132606,55921803,56315019,64002
14,ENSG00000139946.5,56118411,14-55985805-T-G,rs1188160,1,T,G,55985805,132606,55921803,56315019,64002
14,ENSG00000119698.7,94174322,14-94346805-A-T,rs12101216,1,A,T,94346805,172483,93977714,94370930,369091
14,ENSG00000100836.6,23321457,14-23305857-G-C,rs12147021,1,G,C,23305857,15600,23124849,23518065,181008
14,ENSG00000100836.6,23321457,14-23305857-G-A,rs12147021,1,G,A,23305857,15600,23124849,23518065,181008
14,ENSG00000198668.6,90397029,14-90382760-G-C,rs12147703,1,G,C,90382760,14269,90200421,90593637,182339
14,ENSG00000198668.6,90397029,14-90382760-G-A,rs12147703,1,G,A,90382760,14269,90200421,90593637,182339
14,ENSG00000179841.7,64465499,14-64536287-G-A,rs12432891,1,G,A,64536287,70788,64268891,64662107,267396
14,ENSG00000179841.7,64465499,14-64536287-G-T,rs12432891,1,G,T,64536287,70788,64268891,64662107,267396
14,ENSG00000184227.3,73537143,14-73571367-G-A,rs12433922,1,G,A,73571367,34224,73340535,73733751,230832
14,ENSG00000100592.10,59188667,14-59264527-C-T,rs1253005,1,C,T,59264527,75860,58992059,59385275,272468
14,ENSG00000100592.10,59188667,14-59264527-C-A,rs1253005,1,C,A,59264527,75860,58992059,59385275,272468
14,ENSG00000126790.7,59484408,14-59486229-A-G,rs1253107,-1,A,G,59486229,1821,59287800,59681016,198429
14,ENSG00000140009.14,64294371,14-64267309-G-C,rs1256044,-1,G,C,64267309,27062,64097763,64490979,169546
14,ENSG00000140009.14,64294371,14-64267309-G-A,rs1256044,-1,G,A,64267309,27062,64097763,64490979,169546
14,ENSG00000140009.14,64294371,14-64267309-G-T,rs1256044,-1,G,T,64267309,27062,64097763,64490979,169546
14,ENSG00000131323.10,102777449,14-102764421-G-C,rs12588969,1,G,C,102764421,13028,102580841,102974057,183580
14,ENSG00000131323.10,102777449,14-102764421-G-T,rs12588969,1,G,T,102764421,13028,102580841,102974057,183580
14,ENSG00000131323.10,102777449,14-102764421-G-A,rs12588969,1,G,A,102764421,13028,102580841,102974057,183580
14,ENSG00000165943.4,93184897,14-93179363-A-G,rs1263373,-1,A,G,93179363,5534,92988289,93381505,191074
14,ENSG00000165943.4,93184897,14-93179363-A-T,rs1263373,-1,A,T,93179363,5534,92988289,93381505,191074
14,ENSG00000152315.4,90061994,14-89875494-A-C,rs1286939,1,A,C,89875494,186500,89865386,90258602,10108
14,ENSG00000152315.4,90061994,14-89875494-A-T,rs1286939,1,A,T,89875494,186500,89865386,90258602,10108
14,ENSG00000152315.4,90061994,14-89875494-A-G,rs1286939,1,A,G,89875494,186500,89865386,90258602,10108
14,ENSG00000155465.13,22815435,14-22803905-T-C,rs12884337,-1,T,C,22803905,11530,22618827,23012043,185078
14,ENSG00000155465.13,22815435,14-22803905-T-A,rs12884337,-1,T,A,22803905,11530,22618827,23012043,185078
14,ENSG00000165959.5,95319908,14-95345207-C-T,rs12884539,-1,C,T,95345207,25299,95123300,95516516,221907
14,ENSG00000100478.10,31025649,14-30891075-C-A,rs12884979,1,C,A,30891075,134574,30829041,31222257,62034
14,ENSG00000100478.10,31025649,14-30891075-C-T,rs12884979,1,C,T,30891075,134574,30829041,31222257,62034
14,ENSG00000213983.5,23567791,14-23552973-C-T,rs12886523,-1,C,T,23552973,14818,23371183,23764399,181790
14,ENSG00000119669.3,77028708,14-76959734-G-A,rs12889775,-1,G,A,76959734,68974,76832100,77225316,127634
14,ENSG00000119669.3,77028708,14-76959734-G-T,rs12889775,-1,G,T,76959734,68974,76832100,77225316,127634
14,ENSG00000133985.2,70641916,14-70656805-A-G,rs12895136,1,A,G,70656805,14889,70445308,70838524,211497
14,ENSG00000087301.4,52552505,14-52369781-T-C,rs1458113,-1,T,C,52369781,182724,52355897,52749113,13884
14,ENSG00000087301.4,52552505,14-52369781-T-A,rs1458113,-1,T,A,52369781,182724,52355897,52749113,13884
14,ENSG00000119699.3,75981995,14-75982578-G-A,rs146047341,-1,G,A,75982578,583,75785387,76178603,197191
14,ENSG00000119699.3,75981995,14-75982578-G-C,rs146047341,-1,G,C,75982578,583,75785387,76178603,197191
14,ENSG00000140105.11,100375347,14-100341818-G-T,rs1570305,-1,G,T,100341818,33529,100178739,100571955,163079
14,ENSG00000140105.11,100375347,14-100341818-G-A,rs1570305,-1,G,A,100341818,33529,100178739,100571955,163079
14,ENSG00000140105.11,100375347,14-100341818-G-C,rs1570305,-1,G,C,100341818,33529,100178739,100571955,163079
14,ENSG00000100612.8,60165398,14-60102773-G-A,rs160228,-1,G,A,60102773,62625,59968790,60362006,133983
14,ENSG00000100612.8,60165398,14-60102773-G-C,rs160228,-1,G,C,60102773,62625,59968790,60362006,133983
14,ENSG00000100949.10,24271597,14-24325699-C-T,rs17102928,-1,C,T,24325699,54102,24074989,24468205,250710
14,ENSG00000100906.6,35404749,14-35368009-C-G,rs17103257,-1,C,G,35368009,36740,35208141,35601357,159868
14,ENSG00000100906.6,35404749,14-35368009-C-A,rs17103257,-1,C,A,35368009,36740,35208141,35601357,159868
14,ENSG00000165548.5,77181798,14-77066572-C-G,rs17105279,1,C,G,77066572,115226,76985190,77378406,81382
14,ENSG00000100678.14,70188951,14-70184477-T-C,rs17107951,-1,T,C,70184477,4474,69992343,70385559,192134
14,ENSG00000165355.7,39432433,14-39402962-T-C,rs17109203,-1,T,C,39402962,29471,39235825,39629041,167137
14,ENSG00000119707.9,73058534,14-72905313-C-G,rs17122159,1,C,G,72905313,153221,72861926,73255142,43387
14,ENSG00000119707.9,73058534,14-72905313-C-T,rs17122159,1,C,T,72905313,153221,72861926,73255142,43387
14,ENSG00000119599.12,72926464,14-72905313-C-G,rs17122159,1,C,G,72905313,21151,72729856,73123072,175457
14,ENSG00000119599.12,72926464,14-72905313-C-T,rs17122159,1,C,T,72905313,21151,72729856,73123072,175457
14,ENSG00000100804.14,23034900,14-23025025-C-T,rs17125731,-1,C,T,23025025,9875,22838292,23231508,186733
14,ENSG00000136319.6,20305951,14-20395652-G-A,rs1713417,-1,G,A,20395652,89701,20109343,20502559,286309
14,ENSG00000129566.7,20413501,14-20413368-T-C,rs1713434,-1,T,C,20413368,133,20216893,20610109,196475
14,ENSG00000129566.7,20413501,14-20413368-T-A,rs1713434,-1,T,A,20413368,133,20216893,20610109,196475
14,ENSG00000139908.10,24205696,14-24177263-T-C,rs17199551,1,T,C,24177263,28433,24009088,24402304,168175
14,ENSG00000139908.10,24205696,14-24177263-T-G,rs17199551,1,T,G,24177263,28433,24009088,24402304,168175
14,ENSG00000119718.5,75002921,14-75047125-G-A,rs175080,1,G,A,75047125,44204,74806313,75199529,240812
14,ENSG00000213920.4,24216066,14-24210800-G-A,rs17693590,-1,G,A,24210800,5266,24019458,24412674,191342
14,ENSG00000100593.12,77498816,14-77472234-C-T,rs17751424,-1,C,T,77472234,26582,77302208,77695424,170026
14,ENSG00000100593.12,77498816,14-77472234-C-A,rs17751424,-1,C,A,77472234,26582,77302208,77695424,170026
14,ENSG00000139899.6,24429668,14-24432227-C-T,rs17795094,-1,C,T,24432227,2559,24233060,24626276,199167
14,ENSG00000133962.3,91732086,14-91842981-A-G,rs1884840,-1,A,G,91842981,110895,91535478,91928694,307503
14,ENSG00000100744.10,96363526,14-96389657-A-C,rs1899588,1,A,C,96389657,26131,96166918,96560134,222739
14,ENSG00000100504.11,50944483,14-50879841-G-C,rs1953877,-1,G,C,50879841,64642,50747875,51141091,131966
14,ENSG00000100504.11,50944483,14-50879841-G-T,rs1953877,-1,G,T,50879841,64642,50747875,51141091,131966
14,ENSG00000100504.11,50944483,14-50879841-G-A,rs1953877,-1,G,A,50879841,64642,50747875,51141091,131966
14,ENSG00000100445.11,24442776,14-24511286-A-G,rs1956917,-1,A,G,24511286,68510,24246168,24639384,265118
14,ENSG00000100445.11,24442776,14-24511286-A-C,rs1956917,-1,A,C,24511286,68510,24246168,24639384,265118
14,ENSG00000100445.11,24442776,14-24511286-A-T,rs1956917,-1,A,T,24511286,68510,24246168,24639384,265118
14,ENSG00000092009.6,24508265,14-24510221-A-G,rs1956920,-1,A,G,24510221,1956,24311657,24704873,198564
14,ENSG00000100453.7,24634190,14-24670208-T-C,rs1957521,-1,T,C,24670208,36018,24437582,24830798,232626
14,ENSG00000100453.7,24634190,14-24670208-T-A,rs1957521,-1,T,A,24670208,36018,24437582,24830798,232626
14,ENSG00000073712.9,52951050,14-52923330-T-A,rs1958025,-1,T,A,52923330,27720,52754442,53147658,168888
14,ENSG00000165934.8,92121969,14-92277386-C-G,rs1971459,1,C,G,92277386,155417,91925361,92318577,352025
14,ENSG00000165934.8,92121969,14-92277386-C-T,rs1971459,1,C,T,92277386,155417,91925361,92318577,352025
14,ENSG00000165934.8,92121969,14-92277386-C-A,rs1971459,1,C,A,92277386,155417,91925361,92318577,352025
14,ENSG00000070269.9,56579798,14-56774732-A-C,rs198230,1,A,C,56774732,194934,56383190,56776406,391542
14,ENSG00000070269.9,56579798,14-56774732-A-T,rs198230,1,A,T,56774732,194934,56383190,56776406,391542
14,ENSG00000119640.4,75064024,14-75152415-T-A,rs2098297,-1,T,A,75152415,88391,74867416,75260632,284999
14,ENSG00000119640.4,75064024,14-75152415-T-G,rs2098297,-1,T,G,75152415,88391,74867416,75260632,284999
14,ENSG00000157326.14,23953770,14-24020396-T-G,rs2146432,1,T,G,24020396,66626,23757162,24150378,263234
14,ENSG00000100526.13,54397007,14-54408796-A-G,rs2179896,1,A,G,54408796,11789,54200399,54593615,208397
14,ENSG00000100526.13,54397007,14-54408796-A-T,rs2179896,1,A,T,54408796,11789,54200399,54593615,208397
14,ENSG00000100461.12,22919149,14-23026034-C-T,rs2230087,-1,C,T,23026034,106885,22722541,23115757,303493
14,ENSG00000089775.6,64503838,14-64468652-A-C,rs2230490,-1,A,C,64468652,35186,64307230,64700446,161422
14,ENSG00000183828.8,105181312,14-105167162-G-T,rs2239282,-1,G,T,105167162,14150,104984704,105377920,182458
14,ENSG00000183828.8,105181312,14-105167162-G-A,rs2239282,-1,G,A,105167162,14150,104984704,105377920,182458
14,ENSG00000183828.8,105181312,14-105167162-G-C,rs2239282,-1,G,C,105167162,14150,104984704,105377920,182458
14,ENSG00000256053.2,103562960,14-103517957-G-T,rs2246490,1,G,T,103517957,45003,103366352,103759568,151605
14,ENSG00000256053.2,103562960,14-103517957-G-C,rs2246490,1,G,C,103517957,45003,103366352,103759568,151605
14,ENSG00000100815.6,92040059,14-91932944-C-A,rs2256767,-1,C,A,91932944,107115,91843451,92236667,89493
14,ENSG00000100815.6,92040059,14-91932944-C-T,rs2256767,-1,C,T,91932944,107115,91843451,92236667,89493
14,ENSG00000140092.10,91947694,14-91873564-C-T,rs2267990,-1,C,T,91873564,74130,91751086,92144302,122478
14,ENSG00000140092.10,91947694,14-91873564-C-G,rs2267990,-1,C,G,91873564,74130,91751086,92144302,122478
14,ENSG00000100596.2,77616637,14-77557371-A-G,rs2272588,-1,A,G,77557371,59266,77420029,77813245,137342
14,ENSG00000100596.2,77616637,14-77557371-A-T,rs2272588,-1,A,T,77557371,59266,77420029,77813245,137342
14,ENSG00000100596.2,77616637,14-77557371-A-C,rs2272588,-1,A,C,77557371,59266,77420029,77813245,137342
14,ENSG00000119632.3,94129604,14-94129652-T-C,rs2273514,-1,T,C,94129652,48,93932996,94326212,196656
14,ENSG00000255526.1,24232352,14-24213631-G-C,rs2295319,-1,G,C,24213631,18721,24035744,24428960,177887
14,ENSG00000255526.1,24232352,14-24213631-G-A,rs2295319,-1,G,A,24213631,18721,24035744,24428960,177887
14,ENSG00000213231.7,95686426,14-95670438-C-T,rs2296310,1,C,T,95670438,15988,95489818,95883034,180620
14,ENSG00000213231.7,95686426,14-95670438-C-A,rs2296310,1,C,A,95670438,15988,95489818,95883034,180620
14,ENSG00000090061.12,99481409,14-99336128-C-T,rs2400632,1,C,T,99336128,145281,99284801,99678017,51327
14,ENSG00000129559.8,24232367,14-24252695-A-G,rs2748531,-1,A,G,24252695,20328,24035759,24428975,216936
14,ENSG00000196405.7,100065422,14-100193629-A-G,rs2757526,1,A,G,100193629,128207,99868814,100262030,324815
14,ENSG00000196405.7,100065422,14-100193629-A-T,rs2757526,1,A,T,100193629,128207,99868814,100262030,324815
14,ENSG00000100883.7,34982992,14-35167405-A-C,rs28723612,1,A,C,35167405,184413,34786384,35179600,381021
14,ENSG00000165502.6,49620626,14-49619845-C-T,rs3007030,-1,C,T,49619845,781,49424018,49817234,195827
14,ENSG00000168282.3,49620799,14-49619845-C-T,rs3007030,1,C,T,49619845,954,49424191,49817407,195654
14,ENSG00000092094.5,20454812,14-20454835-C-G,rs3120064,-1,C,G,20454835,23,20258204,20651420,196631
14,ENSG00000092094.5,20454812,14-20454835-C-A,rs3120064,-1,C,A,20454835,23,20258204,20651420,196631
14,ENSG00000181803.3,20641691,14-20769067-A-G,rs34072148,-1,A,G,20769067,127376,20445083,20838299,323984
14,ENSG00000092098.10,24147498,14-24258855-G-A,rs34597632,1,G,A,24258855,111357,23950890,24344106,307965
14,ENSG00000050130.12,59484517,14-59483958-A-T,rs34741399,1,A,T,59483958,559,59287909,59681125,196049
14,ENSG00000050130.12,59484517,14-59483958-A-C,rs34741399,1,A,C,59483958,559,59287909,59681125,196049
14,ENSG00000100485.7,50231578,14-50343672-C-G,rs3783415,-1,C,G,50343672,112094,50034970,50428186,308702
14,ENSG00000100485.7,50231578,14-50343672-C-A,rs3783415,-1,C,A,50343672,112094,50034970,50428186,308702
14,ENSG00000119650.8,75985763,14-75972811-C-T,rs3917172,1,C,T,75972811,12952,75789155,76182371,183656
14,ENSG00000183092.11,100587417,14-100549043-T-C,rs4073738,-1,T,C,100549043,38374,100390809,100784025,158234
14,ENSG00000183092.11,100587417,14-100549043-T-G,rs4073738,-1,T,G,100549043,38374,100390809,100784025,158234
14,ENSG00000184986.6,105526583,14-105533894-G-A,rs4075105,1,G,A,105533894,7311,105329975,105723191,203919
14,ENSG00000133943.14,91114073,14-91114928-T-C,rs41299205,1,T,C,91114928,855,90917465,91310681,197463
14,ENSG00000066739.7,96363341,14-96397990-A-G,rs41301765,-1,A,G,96397990,34649,96166733,96559949,231257
14,ENSG00000179454.7,44961947,14-44982834-A-G,rs4141578,-1,A,G,44982834,20887,44765339,45158555,217495
14,ENSG00000100625.6,60724351,14-60906341-G-T,rs4151342,-1,G,T,60906341,181990,60527743,60920959,378598
14,ENSG00000186469.4,51860612,14-51849521-G-A,rs4243583,1,G,A,51849521,11091,51664004,52057220,185517
14,ENSG00000139921.8,51240247,14-51256822-G-A,rs4261445,1,G,A,51256822,16575,51043639,51436855,213183
14,ENSG00000119614.2,74239449,14-74285327-G-A,rs45446193,1,G,A,74285327,45878,74042841,74436057,242486
14,ENSG00000196663.10,102362941,14-102210392-G-A,rs45508291,1,G,A,102210392,152549,102166333,102559549,44059
14,ENSG00000136305.6,24307977,14-24290803-G-A,rs4568,-1,G,A,24290803,17174,24111369,24504585,179434
14,ENSG00000053770.7,57268971,14-57135810-T-G,rs4901766,1,T,G,57135810,133161,57072363,57465579,63447
14,ENSG00000151838.6,59576812,14-59664148-C-G,rs4901951,-1,C,G,59664148,87336,59380204,59773420,283944
14,ENSG00000151838.6,59576812,14-59664148-C-T,rs4901951,-1,C,T,59664148,87336,59380204,59773420,283944
14,ENSG00000139988.5,67701886,14-67575779-A-T,rs4902491,1,A,T,67575779,126107,67505278,67898494,70501
14,ENSG00000139988.5,67701886,14-67575779-A-G,rs4902491,1,A,G,67575779,126107,67505278,67898494,70501
14,ENSG00000100564.4,67600268,14-67585166-G-T,rs4902494,-1,G,T,67585166,15102,67403660,67796876,181506
14,ENSG00000170468.5,73490933,14-73609231-T-C,rs4903128,1,T,C,73609231,118298,73294325,73687541,314906
14,ENSG00000170468.5,73490933,14-73609231-T-G,rs4903128,1,T,G,73609231,118298,73294325,73687541,314906
14,ENSG00000170468.5,73490933,14-73609231-T-A,rs4903128,1,T,A,73609231,118298,73294325,73687541,314906
14,ENSG00000119723.10,73950302,14-73984612-C-T,rs4903164,1,C,T,73984612,34310,73753694,74146910,230918
14,ENSG00000198894.3,77098258,14-77130055-C-T,rs4903544,1,C,T,77130055,31797,76901650,77294866,228405
14,ENSG00000198894.3,77098258,14-77130055-C-G,rs4903544,1,C,G,77130055,31797,76901650,77294866,228405
14,ENSG00000140030.4,88005135,14-87972104-G-T,rs4904408,1,G,T,87972104,33031,87808527,88201743,163577
14,ENSG00000140030.4,88005135,14-87972104-G-A,rs4904408,1,G,A,87972104,33031,87808527,88201743,163577
14,ENSG00000140030.4,88005135,14-87972104-G-C,rs4904408,1,G,C,87972104,33031,87808527,88201743,163577
14,ENSG00000089737.10,94081202,14-94088017-A-T,rs4905157,-1,A,T,94088017,6815,93884594,94277810,203423
14,ENSG00000089737.10,94081202,14-94088017-A-C,rs4905157,-1,A,C,94088017,6815,93884594,94277810,203423
14,ENSG00000089902.7,102592649,14-102742816-A-G,rs4906254,1,A,G,102742816,150167,102396041,102789257,346775
14,ENSG00000089902.7,102592649,14-102742816-A-C,rs4906254,1,A,C,102742816,150167,102396041,102789257,346775
14,ENSG00000092199.12,21269442,14-21305304-A-T,rs4981368,-1,A,T,21305304,35862,21072834,21466050,232470
14,ENSG00000092199.12,21269442,14-21305304-A-G,rs4981368,-1,A,G,21305304,35862,21072834,21466050,232470
14,ENSG00000185271.6,20436166,14-20430758-A-G,rs4982086,-1,A,G,20430758,5408,20239558,20632774,191200
14,ENSG00000165801.5,21070304,14-21073878-C-T,rs4982405,1,C,T,21073878,3574,20873696,21266912,200182
14,ENSG00000185347.12,105491246,14-105628023-T-C,rs4983481,1,T,C,105628023,136777,105294638,105687854,333385
14,ENSG00000185347.12,105491246,14-105628023-T-G,rs4983481,1,T,G,105628023,136777,105294638,105687854,333385
14,ENSG00000185347.12,105491246,14-105628023-T-A,rs4983481,1,T,A,105628023,136777,105294638,105687854,333385
14,ENSG00000187105.4,73558947,14-73676315-T-A,rs56277391,-1,T,A,73676315,117368,73362339,73755555,313976
14,ENSG00000187105.4,73558947,14-73676315-T-C,rs56277391,-1,T,C,73676315,117368,73362339,73755555,313976
14,ENSG00000157227.8,22836585,14-22808684-G-T,rs56714188,1,G,T,22808684,27901,22639977,23033193,168707
14,ENSG00000092108.15,30622319,14-30770901-C-T,rs61976746,1,C,T,30770901,148582,30425711,30818927,345190
14,ENSG00000156127.6,75522469,14-75386068-T-C,rs61979226,1,T,C,75386068,136401,75325861,75719077,60207
14,ENSG00000165410.10,34714593,14-34716139-A-G,rs6571678,-1,A,G,34716139,1546,34517985,34911201,198154
14,ENSG00000100557.5,57493857,14-57497274-G-A,rs6573152,-1,G,A,57497274,3417,57297249,57690465,200025
14,ENSG00000176903.3,73714384,14-73696147-T-C,rs6574138,-1,T,C,73696147,18237,73517776,73910992,178371
14,ENSG00000100591.3,77458093,14-77280504-C-G,rs71413457,1,C,G,77280504,177589,77261485,77654701,19019
14,ENSG00000092051.10,23578790,14-23665826-T-C,rs71414000,-1,T,C,23665826,87036,23382182,23775398,283644
14,ENSG00000092020.6,35121990,14-35063764-A-C,rs7142489,-1,A,C,35063764,58226,34925382,35318598,138382
14,ENSG00000092020.6,35121990,14-35063764-A-G,rs7142489,-1,A,G,35063764,58226,34925382,35318598,138382
14,ENSG00000092020.6,35121990,14-35063764-A-T,rs7142489,-1,A,T,35063764,58226,34925382,35318598,138382
14,ENSG00000125375.10,50312324,14-50336009-A-C,rs7148089,1,A,C,50336009,23685,50115716,50508932,220293
14,ENSG00000176473.9,100376485,14-100479705-A-G,rs7148655,1,A,G,100479705,103220,100179877,100573093,299828
14,ENSG00000176473.9,100376485,14-100479705-A-T,rs7148655,1,A,T,100479705,103220,100179877,100573093,299828
14,ENSG00000092295.7,24263177,14-24260894-A-C,rs7151201,-1,A,C,24260894,2283,24066569,24459785,194325
14,ENSG00000119673.10,73569213,14-73561413-T-C,rs7151745,1,T,C,73561413,7800,73372605,73765821,188808
14,ENSG00000119673.10,73569213,14-73561413-T-A,rs7151745,1,T,A,73561413,7800,73372605,73765821,188808
14,ENSG00000119673.10,73569213,14-73561413-T-G,rs7151745,1,T,G,73561413,7800,73372605,73765821,188808
14,ENSG00000183648.3,92121706,14-92122763-T-C,rs7155717,-1,T,C,92122763,1057,91925098,92318314,197665
14,ENSG00000183648.3,92121706,14-92122763-T-A,rs7155717,-1,T,A,92122763,1057,91925098,92318314,197665
14,ENSG00000197776.3,49693120,14-49739055-A-G,rs7156717,1,A,G,49739055,45935,49496512,49889728,242543
14,ENSG00000126215.9,103715451,14-103611274-T-C,rs7157116,-1,T,C,103611274,104177,103518843,103912059,92431
14,ENSG00000100714.9,64388353,14-64534491-G-A,rs7160634,1,G,A,64534491,146138,64191745,64584961,342746
14,ENSG00000203485.7,104689618,14-104879461-G-A,rs72700172,1,G,A,104879461,189843,104493010,104886226,386451
14,ENSG00000175699.8,93997301,14-93975915-T-G,rs72700358,1,T,G,93975915,21386,93800693,94193909,175222
14,ENSG00000175699.8,93997301,14-93975915-T-A,rs72700358,1,T,A,93975915,21386,93800693,94193909,175222
14,ENSG00000100628.6,93976570,14-93975915-T-G,rs72700358,-1,T,G,93975915,655,93779962,94173178,195953
14,ENSG00000100628.6,93976570,14-93975915-T-A,rs72700358,-1,T,A,93975915,655,93779962,94173178,195953
14,ENSG00000023608.4,61762420,14-61762964-C-T,rs72714597,1,C,T,61762964,544,61565812,61959028,197152
14,ENSG00000023608.4,61762420,14-61762964-C-A,rs72714597,1,C,A,61762964,544,61565812,61959028,197152
14,ENSG00000140057.4,96392128,14-96273326-G-T,rs75170279,1,G,T,96273326,118802,96195520,96588736,77806
14,ENSG00000140057.4,96392128,14-96273326-G-A,rs75170279,1,G,A,96273326,118802,96195520,96588736,77806
14,ENSG00000179627.9,104801101,14-104844539-C-A,rs75232889,1,C,A,104844539,43438,104604493,104997709,240046
14,ENSG00000179627.9,104801101,14-104844539-C-T,rs75232889,1,C,T,104844539,43438,104604493,104997709,240046
14,ENSG00000100650.10,69767142,14-69863457-T-C,rs77366387,1,T,C,69863457,96315,69570534,69963750,292923
14,ENSG00000187630.9,23988929,14-23989543-G-C,rs77491846,1,G,C,23989543,614,23792321,24185537,197222
14,ENSG00000187630.9,23988929,14-23989543-G-A,rs77491846,1,G,A,23989543,614,23792321,24185537,197222
14,ENSG00000187630.9,23988929,14-23989543-G-T,rs77491846,1,G,T,23989543,614,23792321,24185537,197222
14,ENSG00000015133.13,91417820,14-91536899-A-G,rs77541482,-1,A,G,91536899,119079,91221212,91614428,315687
14,ENSG00000015133.13,91417820,14-91536899-A-C,rs77541482,-1,A,C,91536899,119079,91221212,91614428,315687
14,ENSG00000156411.5,103921529,14-103905923-G-A,rs78021316,-1,G,A,103905923,15606,103724921,104118137,181002
14,ENSG00000054983.11,87993182,14-87992401-C-T,rs78187751,-1,C,T,87992401,781,87796574,88189790,195827
14,ENSG00000179933.4,23095505,14-23095803-C-T,rs8003631,1,C,T,23095803,298,22898897,23292113,196906
14,ENSG00000119689.10,74881916,14-74760395-T-G,rs8003660,1,T,G,74760395,121521,74685308,75078524,75087
14,ENSG00000119689.10,74881916,14-74760395-T-A,rs8003660,1,T,A,74760395,121521,74685308,75078524,75087
14,ENSG00000119689.10,74881916,14-74760395-T-C,rs8003660,1,T,C,74760395,121521,74685308,75078524,75087
14,ENSG00000089916.12,76151922,14-76226500-C-T,rs8007339,1,C,T,76226500,74578,75955314,76348530,271186
14,ENSG00000063761.11,77800109,14-77892615-G-A,rs8009834,1,G,A,77892615,92506,77603501,77996717,289114
14,ENSG00000100908.9,24141591,14-24139938-T-C,rs8010715,-1,T,C,24139938,1653,23944983,24338199,194955
14,ENSG00000100439.6,22598300,14-22599022-T-C,rs8011143,1,T,C,22599022,722,22401692,22794908,197330
14,ENSG00000100462.11,22929376,14-22778478-T-C,rs8013531,-1,T,C,22778478,150898,22732768,23125984,45710
14,ENSG00000232070.4,21101103,14-20978068-G-T,rs8016111,1,G,T,20978068,123035,20904495,21297711,73573
14,ENSG00000232070.4,21101103,14-20978068-G-C,rs8016111,1,G,C,20978068,123035,20904495,21297711,73573
14,ENSG00000119608.7,74876145,14-74771558-T-C,rs8016513,-1,T,C,74771558,104587,74679537,75072753,92021
14,ENSG00000140043.6,73851831,14-73852011-A-C,rs8020267,1,A,C,73852011,180,73655223,74048439,196788
14,ENSG00000140043.6,73851831,14-73852011-A-G,rs8020267,1,A,G,73852011,180,73655223,74048439,196788
14,ENSG00000140043.6,73851831,14-73852011-A-T,rs8020267,1,A,T,73852011,180,73655223,74048439,196788
14,ENSG00000100505.9,51095105,14-51224810-T-C,rs8021773,-1,T,C,51224810,129705,50898497,51291713,326313
14,ENSG00000140044.8,75428022,14-75551071-G-A,rs8022514,1,G,A,75551071,123049,75231414,75624630,319657
14,ENSG00000205659.5,74084956,14-74154583-T-A,rs8022546,1,T,A,74154583,69627,73888348,74281564,266235
14,ENSG00000205659.5,74084956,14-74154583-T-C,rs8022546,1,T,C,74154583,69627,73888348,74281564,266235
14,ENSG00000205659.5,74084956,14-74154583-T-G,rs8022546,1,T,G,74154583,69627,73888348,74281564,266235
14,ENSG00000100580.7,77377094,14-77359403-A-C,rs8022676,-1,A,C,77359403,17691,77180486,77573702,178917
14,ENSG00000092036.12,22957090,14-22979659-T-C,rs941724,-1,T,C,22979659,22569,22760482,23153698,219177
14,ENSG00000184990.8,104753147,14-104714640-G-A,rs9672065,1,G,A,104714640,38507,104556539,104949755,158101
14,ENSG00000139974.11,60981245,14-60943772-G-A,rs975182,1,G,A,60943772,37473,60784637,61177853,159135
14,ENSG00000139974.11,60981245,14-60943772-G-T,rs975182,1,G,T,60943772,37473,60784637,61177853,159135
14,ENSG00000139974.11,60981245,14-60943772-G-C,rs975182,1,G,C,60943772,37473,60784637,61177853,159135
14,ENSG00000100600.9,92748627,14-92704648-C-T,rs9791,-1,C,T,92704648,43979,92552019,92945235,152629
14,ENSG00000165943.4,93184897,14-93174103-C-T,rs10130904,-1,C,T,93174103,10794,92988289,93381505,185814
14,ENSG00000100564.4,67600268,14-67599127-G-C,rs10131404,-1,G,C,67599127,1141,67403660,67796876,195467
14,ENSG00000100564.4,67600268,14-67599127-G-A,rs10131404,-1,G,A,67599127,1141,67403660,67796876,195467
14,ENSG00000140104.9,104985788,14-105075694-C-T,rs10134401,1,C,T,105075694,89906,104789180,105182396,286514
14,ENSG00000136305.6,24307977,14-24291558-G-A,rs10134537,-1,G,A,24291558,16419,24111369,24504585,180189
14,ENSG00000165410.10,34714593,14-34722332-A-T,rs10135305,-1,A,T,34722332,7739,34517985,34911201,204347
14,ENSG00000165410.10,34714593,14-34722332-A-G,rs10135305,-1,A,G,34722332,7739,34517985,34911201,204347
14,ENSG00000165410.10,34714593,14-34722332-A-C,rs10135305,-1,A,C,34722332,7739,34517985,34911201,204347
14,ENSG00000042317.12,88385657,14-88348674-A-C,rs10135523,1,A,C,88348674,36983,88189049,88582265,159625
14,ENSG00000100505.9,51095105,14-51204299-G-T,rs10135768,-1,G,T,51204299,109194,50898497,51291713,305802
14,ENSG00000100505.9,51095105,14-51204299-G-A,rs10135768,-1,G,A,51204299,109194,50898497,51291713,305802
14,ENSG00000139998.9,64972336,14-64910892-G-A,rs10136659,-1,G,A,64910892,61444,64775728,65168944,135164
14,ENSG00000139998.9,64972336,14-64910892-G-T,rs10136659,-1,G,T,64910892,61444,64775728,65168944,135164
14,ENSG00000139880.14,23057520,14-23086863-A-T,rs10140923,-1,A,T,23086863,29343,22860912,23254128,225951
14,ENSG00000139880.14,23057520,14-23086863-A-G,rs10140923,-1,A,G,23086863,29343,22860912,23254128,225951
14,ENSG00000197102.6,101964573,14-102006912-T-C,rs10142230,1,T,C,102006912,42339,101767965,102161181,238947
14,ENSG00000119632.3,94129604,14-94127580-G-A,rs10145627,-1,G,A,94127580,2024,93932996,94326212,194584
14,ENSG00000119699.3,75981995,14-76010903-C-A,rs10146195,-1,C,A,76010903,28908,75785387,76178603,225516
14,ENSG00000119699.3,75981995,14-76010903-C-T,rs10146195,-1,C,T,76010903,28908,75785387,76178603,225516
14,ENSG00000119699.3,75981995,14-76010903-C-G,rs10146195,-1,C,G,76010903,28908,75785387,76178603,225516
14,ENSG00000100445.11,24442776,14-24429988-C-G,rs10146759,-1,C,G,24429988,12788,24246168,24639384,183820
14,ENSG00000100445.11,24442776,14-24429988-C-T,rs10146759,-1,C,T,24429988,12788,24246168,24639384,183820
14,ENSG00000092330.11,24242623,14-24243087-T-G,rs10148135,-1,T,G,24243087,464,24046015,24439231,197072
14,ENSG00000119673.10,73569213,14-73610781-C-T,rs10150828,1,C,T,73610781,41568,73372605,73765821,238176
14,ENSG00000183484.7,105065430,14-105034423-T-A,rs10150848,-1,T,A,105034423,31007,104868822,105262038,165601
14,ENSG00000183484.7,105065430,14-105034423-T-G,rs10150848,-1,T,G,105034423,31007,104868822,105262038,165601
14,ENSG00000100614.13,60249221,14-60246469-C-T,rs10151922,1,C,T,60246469,2752,60052613,60445829,193856
14,ENSG00000140030.4,88005135,14-88088911-T-A,rs10498616,1,T,A,88088911,83776,87808527,88201743,280384
14,ENSG00000215271.5,23286132,14-23277060-C-T,rs1057119,-1,C,T,23277060,9072,23089524,23482740,187536
14,ENSG00000215271.5,23286132,14-23277060-C-G,rs1057119,-1,C,G,23277060,9072,23089524,23482740,187536
14,ENSG00000183576.8,99480859,14-99346876-T-C,rs1078608,-1,T,C,99346876,133983,99284251,99677467,62625
14,ENSG00000183576.8,99480859,14-99346876-T-A,rs1078608,-1,T,A,99346876,133983,99284251,99677467,62625
14,ENSG00000183576.8,99480859,14-99346876-T-G,rs1078608,-1,T,G,99346876,133983,99284251,99677467,62625
14,ENSG00000197119.7,100306444,14-100300327-G-T,rs10873515,-1,G,T,100300327,6117,100109836,100503052,190491
14,ENSG00000197119.7,100306444,14-100300327-G-C,rs10873515,-1,G,C,100300327,6117,100109836,100503052,190491
14,ENSG00000197119.7,100306444,14-100300327-G-A,rs10873515,-1,G,A,100300327,6117,100109836,100503052,190491
14,ENSG00000179454.7,44961947,14-44829411-T-C,rs111272844,-1,T,C,44829411,132536,44765339,45158555,64072
14,ENSG00000119718.5,75002921,14-74922371-G-A,rs11159109,1,G,A,74922371,80550,74806313,75199529,116058
14,ENSG00000129472.7,21476959,14-21530079-C-T,rs1122695,-1,C,T,21530079,53120,21280351,21673567,249728
14,ENSG00000100678.14,70188951,14-70038552-C-A,rs1156447,-1,C,A,70038552,150399,69992343,70385559,46209
14,ENSG00000133983.9,70359683,14-70513707-G-T,rs11624424,-1,G,T,70513707,154024,70163075,70556291,350632
14,ENSG00000133983.9,70359683,14-70513707-G-A,rs11624424,-1,G,A,70513707,154024,70163075,70556291,350632
14,ENSG00000100908.9,24141591,14-24108267-G-T,rs11629199,-1,G,T,24108267,33324,23944983,24338199,163284
14,ENSG00000100908.9,24141591,14-24108267-G-C,rs11629199,-1,G,C,24108267,33324,23944983,24338199,163284
14,ENSG00000139921.8,51240247,14-51219902-G-T,rs11629336,1,G,T,51219902,20345,51043639,51436855,176263
14,ENSG00000198133.4,67488721,14-67462640-G-A,rs116409848,-1,G,A,67462640,26081,67292113,67685329,170527
14,ENSG00000169413.2,20781268,14-20747674-G-C,rs116985083,1,G,C,20747674,33594,20584660,20977876,163014
14,ENSG00000169413.2,20781268,14-20747674-G-T,rs116985083,1,G,T,20747674,33594,20584660,20977876,163014
14,ENSG00000183828.8,105181312,14-105067083-G-A,rs117324809,-1,G,A,105067083,114229,104984704,105377920,82379
14,ENSG00000100916.8,35826338,14-35810337-G-A,rs117370132,1,G,A,35810337,16001,35629730,36022946,180607
14,ENSG00000139988.5,67701886,14-67544269-C-T,rs118148639,1,C,T,67544269,157617,67505278,67898494,38991
14,ENSG00000119608.7,74876145,14-74872747-A-G,rs11851433,-1,A,G,74872747,3398,74679537,75072753,193210
14,ENSG00000196405.7,100065422,14-100085064-A-G,rs1190976,1,A,G,100085064,19642,99868814,100262030,216250
14,ENSG00000133985.2,70641916,14-70662782-C-T,rs1205236,1,C,T,70662782,20866,70445308,70838524,217474
14,ENSG00000198805.6,20469406,14-20489274-T-C,rs12147450,1,T,C,20489274,19868,20272798,20666014,216476
14,ENSG00000100804.14,23034900,14-23007377-T-C,rs12431472,-1,T,C,23007377,27523,22838292,23231508,169085
14,ENSG00000073712.9,52951050,14-53001531-G-C,rs12435886,-1,G,C,53001531,50481,52754442,53147658,247089
14,ENSG00000073712.9,52951050,14-53001531-G-A,rs12435886,-1,G,A,53001531,50481,52754442,53147658,247089
14,ENSG00000100592.10,59188667,14-59296987-A-G,rs1253021,1,A,G,59296987,108320,58992059,59385275,304928
14,ENSG00000179008.4,60486063,14-60437039-G-T,rs1254319,-1,G,T,60437039,49024,60289455,60682671,147584
14,ENSG00000179008.4,60486063,14-60437039-G-A,rs1254319,-1,G,A,60437039,49024,60289455,60682671,147584
14,ENSG00000131323.10,102777449,14-102784666-C-G,rs12586226,1,C,G,102784666,7217,102580841,102974057,203825
14,ENSG00000131323.10,102777449,14-102784666-C-T,rs12586226,1,C,T,102784666,7217,102580841,102974057,203825
14,ENSG00000170270.4,93207065,14-93180064-T-C,rs1270629,-1,T,C,93180064,27001,93010457,93403673,169607
14,ENSG00000100852.8,32077304,14-32009038-A-T,rs12717214,1,A,T,32009038,68266,31880696,32273912,128342
14,ENSG00000100852.8,32077304,14-32009038-A-G,rs12717214,1,A,G,32009038,68266,31880696,32273912,128342
14,ENSG00000165502.6,49620626,14-49500929-T-C,rs12879001,-1,T,C,49500929,119697,49424018,49817234,76911
14,ENSG00000197930.8,52695558,14-52644817-C-T,rs12880534,-1,C,T,52644817,50741,52498950,52892166,145867
14,ENSG00000197930.8,52695558,14-52644817-C-G,rs12880534,-1,C,G,52644817,50741,52498950,52892166,145867
14,ENSG00000092096.10,23352912,14-23343028-G-C,rs12882406,-1,G,C,23343028,9884,23156304,23549520,186724
14,ENSG00000157227.8,22836585,14-22803905-T-A,rs12884337,1,T,A,22803905,32680,22639977,23033193,163928
14,ENSG00000157227.8,22836585,14-22803905-T-C,rs12884337,1,T,C,22803905,32680,22639977,23033193,163928
14,ENSG00000172590.13,22829887,14-22803905-T-A,rs12884337,1,T,A,22803905,25982,22633279,23026495,170626
14,ENSG00000172590.13,22829887,14-22803905-T-C,rs12884337,1,T,C,22803905,25982,22633279,23026495,170626
14,ENSG00000126215.9,103715451,14-103628983-G-A,rs12884809,-1,G,A,103628983,86468,103518843,103912059,110140
14,ENSG00000126215.9,103715451,14-103628983-G-T,rs12884809,-1,G,T,103628983,86468,103518843,103912059,110140
14,ENSG00000198208.6,74923260,14-74764134-A-G,rs12885527,-1,A,G,74764134,159126,74726652,75119868,37482
14,ENSG00000126775.8,55411830,14-55539596-C-T,rs12886742,-1,C,T,55539596,127766,55215222,55608438,324374
14,ENSG00000183648.3,92121706,14-92122344-G-A,rs12886834,-1,G,A,92122344,638,91925098,92318314,197246
14,ENSG00000183648.3,92121706,14-92122344-G-C,rs12886834,-1,G,C,92122344,638,91925098,92318314,197246
14,ENSG00000165782.6,20461434,14-20489607-A-G,rs12891826,-1,A,G,20489607,28173,20264826,20658042,224781
14,ENSG00000170054.10,94476197,14-94628581-G-A,rs17091175,-1,G,A,94628581,152384,94279589,94672805,348992
14,ENSG00000165959.5,95319908,14-95261968-A-G,rs17091981,-1,A,G,95261968,57940,95123300,95516516,138668
14,ENSG00000165959.5,95319908,14-95261968-A-T,rs17091981,-1,A,T,95261968,57940,95123300,95516516,138668
14,ENSG00000053770.7,57268971,14-57298911-A-C,rs17093069,1,A,C,57298911,29940,57072363,57465579,226548
14,ENSG00000053770.7,57268971,14-57298911-A-T,rs17093069,1,A,T,57298911,29940,57072363,57465579,226548
14,ENSG00000070367.11,57268905,14-57403936-C-T,rs17093196,-1,C,T,57403936,135031,57072297,57465513,331639
14,ENSG00000070367.11,57268905,14-57403936-C-G,rs17093196,-1,C,G,57403936,135031,57072297,57465513,331639
14,ENSG00000227051.4,96039362,14-95844427-C-T,rs17093506,1,C,T,95844427,194935,95842754,96235970,1673
14,ENSG00000100867.10,23636364,14-23652122-G-A,rs17095582,1,G,A,23652122,15758,23439756,23832972,212366
14,ENSG00000092051.10,23578790,14-23657855-G-A,rs17095687,-1,G,A,23657855,79065,23382182,23775398,275673
14,ENSG00000119688.14,74302934,14-74268054-T-C,rs17098984,-1,T,C,74268054,34880,74106326,74499542,161728
14,ENSG00000119688.14,74302934,14-74268054-T-G,rs17098984,-1,T,G,74268054,34880,74106326,74499542,161728
14,ENSG00000187790.6,45135930,14-45314343-T-C,rs17115982,1,T,C,45314343,178413,44939322,45332538,375021
14,ENSG00000119599.12,72926464,14-73008768-C-T,rs17123359,1,C,T,73008768,82304,72729856,73123072,278912
14,ENSG00000133962.3,91732086,14-91813639-T-G,rs17127600,-1,T,G,91813639,81553,91535478,91928694,278161
14,ENSG00000156030.8,73760303,14-73699974-A-G,rs17129444,-1,A,G,73699974,60329,73563695,73956911,136279
14,ENSG00000165792.11,20989980,14-20810311-G-T,rs17182151,1,G,T,20810311,179669,20793372,21186588,16939
14,ENSG00000165792.11,20989980,14-20810311-G-A,rs17182151,1,G,A,20810311,179669,20793372,21186588,16939
14,ENSG00000255526.1,24232352,14-24197845-C-T,rs17184526,-1,C,T,24197845,34507,24035744,24428960,162101
14,ENSG00000100722.12,88563037,14-88685048-C-G,rs17204164,1,C,G,88685048,122011,88366429,88759645,318619
14,ENSG00000100722.12,88563037,14-88685048-C-A,rs17204164,1,C,A,88685048,122011,88366429,88759645,318619
14,ENSG00000181619.10,59465380,14-59433397-G-A,rs17255752,-1,G,A,59433397,31983,59268772,59661988,164625
14,ENSG00000213231.7,95686426,14-95673747-G-A,rs1748932,1,G,A,95673747,12679,95489818,95883034,183929
14,ENSG00000182512.4,95535050,14-95526094-C-T,rs17756537,1,C,T,95526094,8956,95338442,95731658,187652
14,ENSG00000100433.11,88323269,14-88185618-C-T,rs17762463,-1,C,T,88185618,137651,88126661,88519877,58957
14,ENSG00000131966.6,58200149,14-58211339-G-A,rs17832891,1,G,A,58211339,11190,58003541,58396757,207798
14,ENSG00000131966.6,58200149,14-58211339-G-C,rs17832891,1,G,C,58211339,11190,58003541,58396757,207798
14,ENSG00000131966.6,58200149,14-58211339-G-T,rs17832891,1,G,T,58211339,11190,58003541,58396757,207798
14,ENSG00000258289.2,64914455,14-64942378-C-T,rs17880758,1,C,T,64942378,27923,64717847,65111063,224531
14,ENSG00000258289.2,64914455,14-64942378-C-G,rs17880758,1,C,G,64942378,27923,64717847,65111063,224531
14,ENSG00000165617.8,58637962,14-58702602-C-G,rs1846834,1,C,G,58702602,64640,58441354,58834570,261248
14,ENSG00000140022.4,81400324,14-81563073-C-T,rs1885600,-1,C,T,81563073,162749,81203716,81596932,359357
14,ENSG00000020577.9,54567128,14-54638123-G-T,rs1886460,1,G,T,54638123,70995,54370520,54763736,267603
14,ENSG00000020577.9,54567128,14-54638123-G-C,rs1886460,1,G,C,54638123,70995,54370520,54763736,267603
14,ENSG00000020577.9,54567128,14-54638123-G-A,rs1886460,1,G,A,54638123,70995,54370520,54763736,267603
14,ENSG00000213903.4,24311502,14-24505826-C-A,rs1951133,1,C,A,24505826,194324,24114894,24508110,390932
14,ENSG00000213903.4,24311502,14-24505826-C-G,rs1951133,1,C,G,24505826,194324,24114894,24508110,390932
14,ENSG00000213903.4,24311502,14-24505826-C-T,rs1951133,1,C,T,24505826,194324,24114894,24508110,390932
14,ENSG00000126790.7,59484408,14-59545801-C-T,rs1956356,-1,C,T,59545801,61393,59287800,59681016,258001
14,ENSG00000184304.10,29927847,14-29857762-C-G,rs1958990,-1,C,G,29857762,70085,29731239,30124455,126523
14,ENSG00000184304.10,29927847,14-29857762-C-T,rs1958990,-1,C,T,29857762,70085,29731239,30124455,126523
14,ENSG00000165929.8,91867536,14-91864475-G-T,rs2052204,-1,G,T,91864475,3061,91670928,92064144,193547
14,ENSG00000165929.8,91867536,14-91864475-G-A,rs2052204,-1,G,A,91864475,3061,91670928,92064144,193547
14,ENSG00000129473.5,23306833,14-23126512-A-G,rs2236135,1,A,G,23126512,180321,23110225,23503441,16287
14,ENSG00000119640.4,75064024,14-74949297-C-T,rs2268614,-1,C,T,74949297,114727,74867416,75260632,81881
14,ENSG00000119640.4,75064024,14-74949297-C-A,rs2268614,-1,C,A,74949297,114727,74867416,75260632,81881
14,ENSG00000139899.6,24429668,14-24429545-G-A,rs2273629,-1,G,A,24429545,123,24233060,24626276,196485
14,ENSG00000139899.6,24429668,14-24429545-G-C,rs2273629,-1,G,C,24429545,123,24233060,24626276,196485
14,ENSG00000176473.9,100376485,14-100376562-G-A,rs2273802,1,G,A,100376562,77,100179877,100573093,196685
14,ENSG00000257365.2,64986895,14-64805062-G-A,rs2277503,1,G,A,64805062,181833,64790287,65183503,14775
14,ENSG00000100596.2,77616637,14-77549554-C-T,rs2284230,-1,C,T,77549554,67083,77420029,77813245,129525
14,ENSG00000165948.6,94081310,14-94102430-C-G,rs2295217,1,C,G,94102430,21120,93884702,94277918,217728
14,ENSG00000165948.6,94081310,14-94102430-C-A,rs2295217,1,C,A,94102430,21120,93884702,94277918,217728
14,ENSG00000165948.6,94081310,14-94102430-C-T,rs2295217,1,C,T,94102430,21120,93884702,94277918,217728
14,ENSG00000213906.4,24310140,14-24210671-C-T,rs2295322,1,C,T,24210671,99469,24113532,24506748,97139
14,ENSG00000166170.9,103562657,14-103563455-G-A,rs2296483,-1,G,A,103563455,798,103366049,103759265,197406
14,ENSG00000166170.9,103562657,14-103563455-G-T,rs2296483,-1,G,T,103563455,798,103366049,103759265,197406
14,ENSG00000092036.12,22957090,14-23003226-T-C,rs2331896,-1,T,C,23003226,46136,22760482,23153698,242744
14,ENSG00000187630.9,23988929,14-23985715-C-T,rs2332152,1,C,T,23985715,3214,23792321,24185537,193394
14,ENSG00000187630.9,23988929,14-23985715-C-G,rs2332152,1,C,G,23985715,3214,23792321,24185537,193394
14,ENSG00000157326.14,23953770,14-23985715-C-T,rs2332152,1,C,T,23985715,31945,23757162,24150378,228553
14,ENSG00000157326.14,23953770,14-23985715-C-G,rs2332152,1,C,G,23985715,31945,23757162,24150378,228553
14,ENSG00000140092.10,91947694,14-91888773-C-G,rs2430353,-1,C,G,91888773,58921,91751086,92144302,137687
14,ENSG00000140092.10,91947694,14-91888773-C-A,rs2430353,-1,C,A,91888773,58921,91751086,92144302,137687
14,ENSG00000099814.8,104865268,14-104871466-C-T,rs28427389,1,C,T,104871466,6198,104668660,105061876,202806
14,ENSG00000176903.3,73714384,14-73752265-T-C,rs2878733,-1,T,C,73752265,37881,73517776,73910992,234489
14,ENSG00000129566.7,20413501,14-20356535-C-T,rs3093936,-1,C,T,20356535,56966,20216893,20610109,139642
14,ENSG00000170779.10,105021083,14-105010321-T-C,rs3204173,-1,T,C,105010321,10762,104824475,105217691,185846
14,ENSG00000136319.6,20305951,14-20286553-G-A,rs3209531,-1,G,A,20286553,19398,20109343,20502559,177210
14,ENSG00000196497.10,24188816,14-24341164-T-C,rs3212243,-1,T,C,24341164,152348,23992208,24385424,348956
14,ENSG00000100714.9,64388353,14-64491920-A-G,rs35062852,1,A,G,64491920,103567,64191745,64584961,300175
14,ENSG00000184990.8,104753147,14-104757516-T-C,rs35165446,1,T,C,104757516,4369,104556539,104949755,200977
14,ENSG00000092098.10,24147498,14-24260481-C-T,rs35755034,1,C,T,24260481,112983,23950890,24344106,309591
14,ENSG00000092098.10,24147498,14-24260481-C-G,rs35755034,1,C,G,24260481,112983,23950890,24344106,309591
14,ENSG00000165501.11,49598940,14-49527305-G-T,rs36023440,1,G,T,49527305,71635,49402332,49795548,124973
14,ENSG00000100865.10,102362890,14-102307923-G-A,rs3759558,-1,G,A,102307923,54967,102166282,102559498,141641
14,ENSG00000100883.7,34982992,14-34868159-T-G,rs3783315,1,T,G,34868159,114833,34786384,35179600,81775
14,ENSG00000100600.9,92748627,14-92711055-C-T,rs3783933,-1,C,T,92711055,37572,92552019,92945235,159036
14,ENSG00000139908.10,24205696,14-24232826-G-T,rs3814815,1,G,T,24232826,27130,24009088,24402304,223738
14,ENSG00000139908.10,24205696,14-24232826-G-A,rs3814815,1,G,A,24232826,27130,24009088,24402304,223738
14,ENSG00000157379.9,24299780,14-24270961-C-A,rs3825585,-1,C,A,24270961,28819,24103172,24496388,167789
14,ENSG00000157379.9,24299780,14-24270961-C-G,rs3825585,-1,C,G,24270961,28819,24103172,24496388,167789
14,ENSG00000100580.7,77377094,14-77468244-T-C,rs3825694,-1,T,C,77468244,91150,77180486,77573702,287758
14,ENSG00000181803.3,20641691,14-20743156-C-T,rs3827903,-1,C,T,20743156,101465,20445083,20838299,298073
14,ENSG00000129484.9,20343635,14-20264016-C-G,rs3938669,1,C,G,20264016,79619,20147027,20540243,116989
14,ENSG00000129484.9,20343635,14-20264016-C-A,rs3938669,1,C,A,20264016,79619,20147027,20540243,116989
14,ENSG00000092094.5,20454812,14-20445548-G-A,rs4429194,-1,G,A,20445548,9264,20258204,20651420,187344
14,ENSG00000092094.5,20454812,14-20445548-G-C,rs4429194,-1,G,C,20445548,9264,20258204,20651420,187344
14,ENSG00000151748.7,50668306,14-50721406-G-A,rs4534750,-1,G,A,50721406,53100,50471698,50864914,249708
14,ENSG00000186469.4,51860612,14-51829703-A-C,rs4901159,1,A,C,51829703,30909,51664004,52057220,165699
14,ENSG00000186469.4,51860612,14-51829703-A-T,rs4901159,1,A,T,51829703,30909,51664004,52057220,165699
14,ENSG00000186469.4,51860612,14-51829703-A-G,rs4901159,1,A,G,51829703,30909,51664004,52057220,165699
14,ENSG00000177465.4,73591873,14-73609231-T-A,rs4903128,1,T,A,73609231,17358,73395265,73788481,213966
14,ENSG00000177465.4,73591873,14-73609231-T-C,rs4903128,1,T,C,73609231,17358,73395265,73788481,213966
14,ENSG00000177465.4,73591873,14-73609231-T-G,rs4903128,1,T,G,73609231,17358,73395265,73788481,213966
14,ENSG00000119669.3,77028708,14-76963725-G-C,rs4903522,-1,G,C,76963725,64983,76832100,77225316,131625
14,ENSG00000165555.5,77423523,14-77527815-G-T,rs4903591,-1,G,T,77527815,104292,77226915,77620131,300900
14,ENSG00000165555.5,77423523,14-77527815-G-A,rs4903591,-1,G,A,77527815,104292,77226915,77620131,300900
14,ENSG00000165555.5,77423523,14-77527815-G-C,rs4903591,-1,G,C,77527815,104292,77226915,77620131,300900
14,ENSG00000063761.11,77800109,14-77869596-A-T,rs4903661,1,A,T,77869596,69487,77603501,77996717,266095
14,ENSG00000063761.11,77800109,14-77869596-A-G,rs4903661,1,A,G,77869596,69487,77603501,77996717,266095
14,ENSG00000155465.13,22815435,14-22808794-G-A,rs4982676,-1,G,A,22808794,6641,22618827,23012043,189967
14,ENSG00000140009.14,64294371,14-64233098-C-T,rs4986938,-1,C,T,64233098,61273,64097763,64490979,135335
14,ENSG00000071246.5,76761468,14-76841481-G-A,rs5014291,1,G,A,76841481,80013,76564860,76958076,276621
14,ENSG00000129562.5,22589224,14-22587217-C-A,rs5742743,-1,C,A,22587217,2007,22392616,22785832,194601
14,ENSG00000129562.5,22589224,14-22587217-C-T,rs5742743,-1,C,T,22587217,2007,22392616,22785832,194601
14,ENSG00000179627.9,104801101,14-104682730-A-C,rs59766306,1,A,C,104682730,118371,104604493,104997709,78237
14,ENSG00000179627.9,104801101,14-104682730-A-G,rs59766306,1,A,G,104682730,118371,104604493,104997709,78237
14,ENSG00000183092.11,100587417,14-100641937-C-T,rs61993017,-1,C,T,100641937,54520,100390809,100784025,251128
14,ENSG00000166165.7,103522830,14-103362789-C-A,rs62006960,-1,C,A,103362789,160041,103326222,103719438,36567
14,ENSG00000092295.7,24263177,14-24266155-G-C,rs6573653,-1,G,C,24266155,2978,24066569,24459785,199586
14,ENSG00000100450.6,24609685,14-24418823-A-G,rs6573793,-1,A,G,24418823,190862,24413077,24806293,5746
14,ENSG00000100450.6,24609685,14-24418823-A-C,rs6573793,-1,A,C,24418823,190862,24413077,24806293,5746
14,ENSG00000054983.11,87993182,14-88011069-C-G,rs6574978,-1,C,G,88011069,17887,87796574,88189790,214495
14,ENSG00000054983.11,87993182,14-88011069-C-A,rs6574978,-1,C,A,88011069,17887,87796574,88189790,214495
14,ENSG00000054983.11,87993182,14-88011069-C-T,rs6574978,-1,C,T,88011069,17887,87796574,88189790,214495
14,ENSG00000087302.4,51989546,14-52028763-C-G,rs7144523,1,C,G,52028763,39217,51792938,52186154,235825
14,ENSG00000087302.4,51989546,14-52028763-C-T,rs7144523,1,C,T,52028763,39217,51792938,52186154,235825
14,ENSG00000133935.6,75660876,14-75552441-A-G,rs7145649,-1,A,G,75552441,108435,75464268,75857484,88173
14,ENSG00000100612.8,60165398,14-60223913-A-C,rs7150940,-1,A,C,60223913,58515,59968790,60362006,255123
14,ENSG00000185650.7,68793067,14-68741052-G-A,rs7152120,-1,G,A,68741052,52015,68596459,68989675,144593
14,ENSG00000100628.6,93976570,14-93814731-T-C,rs7157081,-1,T,C,93814731,161839,93779962,94173178,34769
14,ENSG00000139914.6,24130659,14-24049930-T-C,rs7157257,1,T,C,24049930,80729,23934051,24327267,115879
14,ENSG00000196943.7,24299850,14-24248585-C-T,rs7158744,1,C,T,24248585,51265,24103242,24496458,145343
14,ENSG00000100522.4,52791607,14-52707466-G-A,rs7160609,-1,G,A,52707466,84141,52594999,52988215,112467
14,ENSG00000050130.12,59484517,14-59608600-A-T,rs726462,1,A,T,59608600,124083,59287909,59681125,320691
14,ENSG00000050130.12,59484517,14-59608600-A-C,rs726462,1,A,C,59608600,124083,59287909,59681125,320691
14,ENSG00000100485.7,50231578,14-50145739-C-A,rs726798,-1,C,A,50145739,85839,50034970,50428186,110769
14,ENSG00000100485.7,50231578,14-50145739-C-G,rs726798,-1,C,G,50145739,85839,50034970,50428186,110769
14,ENSG00000100485.7,50231578,14-50145739-C-T,rs726798,-1,C,T,50145739,85839,50034970,50428186,110769
14,ENSG00000100629.11,80941738,14-80933749-T-A,rs72693043,-1,T,A,80933749,7989,80745130,81138346,188619
14,ENSG00000100629.11,80941738,14-80933749-T-C,rs72693043,-1,T,C,80933749,7989,80745130,81138346,188619
14,ENSG00000151838.6,59576812,14-59566300-A-G,rs72714041,-1,A,G,59566300,10512,59380204,59773420,186096
14,ENSG00000151838.6,59576812,14-59566300-A-T,rs72714041,-1,A,T,59566300,10512,59380204,59773420,186096
14,ENSG00000126814.6,60981079,14-60989241-A-G,rs72723914,-1,A,G,60989241,8162,60784471,61177687,204770
14,ENSG00000027075.9,61321579,14-61295175-A-G,rs72725885,1,A,G,61295175,26404,61124971,61518187,170204
14,ENSG00000029364.7,69398692,14-69525177-A-T,rs7350750,1,A,T,69525177,126485,69202084,69595300,323093
14,ENSG00000029364.7,69398692,14-69525177-A-G,rs7350750,1,A,G,69525177,126485,69202084,69595300,323093
14,ENSG00000165389.6,34462240,14-34377603-T-C,rs74046048,-1,T,C,34377603,84637,34265632,34658848,111971
14,ENSG00000232070.4,21101103,14-21102114-T-A,rs745696,1,T,A,21102114,1011,20904495,21297711,197619
14,ENSG00000232070.4,21101103,14-21102114-T-G,rs745696,1,T,G,21102114,1011,20904495,21297711,197619
14,ENSG00000232070.4,21101103,14-21102114-T-C,rs745696,1,T,C,21102114,1011,20904495,21297711,197619
14,ENSG00000081181.3,67619920,14-67583774-C-T,rs75288035,1,C,T,67583774,36146,67423312,67816528,160462
14,ENSG00000100744.10,96363526,14-96317079-G-A,rs76710123,1,G,A,96317079,46447,96166918,96560134,150161
14,ENSG00000133943.14,91114073,14-91108136-G-T,rs76920016,1,G,T,91108136,5937,90917465,91310681,190671
14,ENSG00000196663.10,102362941,14-102429567-G-A,rs77694582,1,G,A,102429567,66626,102166333,102559549,263234
14,ENSG00000119636.11,74019349,14-73950293-G-T,rs78801603,1,G,T,73950293,69056,73822741,74215957,127552
14,ENSG00000100721.6,95714125,14-95696081-G-A,rs78986913,-1,G,A,95696081,18044,95517517,95910733,178564
14,ENSG00000165548.5,77181798,14-77159225-G-A,rs79934998,1,G,A,77159225,22573,76985190,77378406,174035
14,ENSG00000185100.5,104724229,14-104716554-G-C,rs80022508,1,G,C,104716554,7675,104527621,104920837,188933
14,ENSG00000185100.5,104724229,14-104716554-G-A,rs80022508,1,G,A,104716554,7675,104527621,104920837,188933
14,ENSG00000089775.6,64503838,14-64441933-A-G,rs8003567,-1,A,G,64441933,61905,64307230,64700446,134703
14,ENSG00000176438.7,95516650,14-95444800-C-T,rs8007302,-1,C,T,95444800,71850,95320042,95713258,124758
14,ENSG00000139974.11,60981245,14-61121731-C-A,rs80106619,1,C,A,61121731,140486,60784637,61177853,337094
14,ENSG00000054690.9,67533290,14-67692552-C-T,rs80140987,1,C,T,67692552,159262,67336682,67729898,355870
14,ENSG00000100814.12,20333279,14-20330456-C-T,rs8016586,-1,C,T,20330456,2823,20136671,20529887,193785
14,ENSG00000165801.5,21070304,14-21069908-C-A,rs8019890,1,C,A,21069908,396,20873696,21266912,196212
14,ENSG00000119725.10,73886859,14-73852011-A-G,rs8020267,1,A,G,73852011,34848,73690251,74083467,161760
14,ENSG00000119725.10,73886859,14-73852011-A-T,rs8020267,1,A,T,73852011,34848,73690251,74083467,161760
14,ENSG00000119725.10,73886859,14-73852011-A-C,rs8020267,1,A,C,73852011,34848,73690251,74083467,161760
14,ENSG00000156127.6,75522469,14-75551071-G-A,rs8022514,1,G,A,75551071,28602,75325861,75719077,225210
14,ENSG00000119682.10,74713080,14-74643734-G-A,rs888417,-1,G,A,74643734,69346,74516472,74909688,127262
14,ENSG00000150527.11,39233915,14-39183198-A-G,rs9322995,1,A,G,39183198,50717,39037307,39430523,145891
14,ENSG00000015133.13,91417820,14-91238844-G-C,rs933528,-1,G,C,91238844,178976,91221212,91614428,17632
14,ENSG00000015133.13,91417820,14-91238844-G-A,rs933528,-1,G,A,91238844,178976,91221212,91614428,17632
14,ENSG00000140044.8,75428022,14-75335815-C-T,rs9671843,1,C,T,75335815,92207,75231414,75624630,104401
14,ENSG00000092010.10,24136194,14-24108807-C-T,rs973639,1,C,T,24108807,27387,23939586,24332802,169221
14,ENSG00000100968.9,24368184,14-24385486-G-C,rs10131172,1,G,C,24385486,17302,24171576,24564792,213910
14,ENSG00000100968.9,24368184,14-24385486-G-T,rs10131172,1,G,T,24385486,17302,24171576,24564792,213910
14,ENSG00000100968.9,24368184,14-24385486-G-A,rs10131172,1,G,A,24385486,17302,24171576,24564792,213910
14,ENSG00000165555.5,77423523,14-77378249-T-A,rs10133824,-1,T,A,77378249,45274,77226915,77620131,151334
14,ENSG00000139899.6,24429668,14-24434948-A-G,rs10134603,-1,A,G,24434948,5280,24233060,24626276,201888
14,ENSG00000181803.3,20641691,14-20514750-G-A,rs10139456,-1,G,A,20514750,126941,20445083,20838299,69667
14,ENSG00000196405.7,100065422,14-99986323-C-A,rs10141997,1,C,A,99986323,79099,99868814,100262030,117509
14,ENSG00000100647.7,69611596,14-69794309-T-G,rs10146486,1,T,G,69794309,182713,69414988,69808204,379321
14,ENSG00000100647.7,69611596,14-69794309-T-C,rs10146486,1,T,C,69794309,182713,69414988,69808204,379321
14,ENSG00000119655.4,74493305,14-74505305-A-G,rs10146812,-1,A,G,74505305,12000,74296697,74689913,208608
14,ENSG00000119655.4,74493305,14-74505305-A-T,rs10146812,-1,A,T,74505305,12000,74296697,74689913,208608
14,ENSG00000183648.3,92121706,14-92101525-A-G,rs10150904,-1,A,G,92101525,20181,91925098,92318314,176427
14,ENSG00000165355.7,39432433,14-39299939-A-G,rs10162564,-1,A,G,39299939,132494,39235825,39629041,64114
14,ENSG00000081177.12,69191498,14-69322186-A-G,rs1016692,1,A,G,69322186,130688,68994890,69388106,327296
14,ENSG00000081177.12,69191498,14-69322186-A-T,rs1016692,1,A,T,69322186,130688,68994890,69388106,327296
14,ENSG00000081177.12,69191498,14-69322186-A-C,rs1016692,1,A,C,69322186,130688,68994890,69388106,327296
14,ENSG00000075413.12,103385415,14-103343121-G-A,rs10178,1,G,A,103343121,42294,103188807,103582023,154314
14,ENSG00000075413.12,103385415,14-103343121-G-T,rs10178,1,G,T,103343121,42294,103188807,103582023,154314
14,ENSG00000100632.6,69398299,14-69319346-A-G,rs1026385,-1,A,G,69319346,78953,69201691,69594907,117655
14,ENSG00000100632.6,69398299,14-69319346-A-T,rs1026385,-1,A,T,69319346,78953,69201691,69594907,117655
14,ENSG00000100632.6,69398299,14-69319346-A-C,rs1026385,-1,A,C,69319346,78953,69201691,69594907,117655
14,ENSG00000197045.7,54488980,14-54337502-G-C,rs10450919,-1,G,C,54337502,151478,54292372,54685588,45130
14,ENSG00000197045.7,54488980,14-54337502-G-A,rs10450919,-1,G,A,54337502,151478,54292372,54685588,45130
14,ENSG00000197045.7,54488980,14-54337502-G-T,rs10450919,-1,G,T,54337502,151478,54292372,54685588,45130
14,ENSG00000185650.7,68793067,14-68653046-G-T,rs10483817,-1,G,T,68653046,140021,68596459,68989675,56587
14,ENSG00000133985.2,70641916,14-70672024-G-C,rs1050651,1,G,C,70672024,30108,70445308,70838524,226716
14,ENSG00000100580.7,77377094,14-77462182-A-C,rs1061638,-1,A,C,77462182,85088,77180486,77573702,281696
14,ENSG00000100580.7,77377094,14-77462182-A-T,rs1061638,-1,A,T,77462182,85088,77180486,77573702,281696
14,ENSG00000100580.7,77377094,14-77462182-A-G,rs1061638,-1,A,G,77462182,85088,77180486,77573702,281696
14,ENSG00000133983.9,70359683,14-70318598-C-T,rs11158855,-1,C,T,70318598,41085,70163075,70556291,155523
14,ENSG00000183092.11,100587417,14-100500224-C-T,rs11160590,-1,C,T,100500224,87193,100390809,100784025,109415
14,ENSG00000183092.11,100587417,14-100500224-C-A,rs11160590,-1,C,A,100500224,87193,100390809,100784025,109415
14,ENSG00000182400.10,39170333,14-39142041-T-C,rs114629800,-1,T,C,39142041,28292,38973725,39366941,168316
14,ENSG00000119723.10,73950302,14-73993392-C-T,rs11621114,1,C,T,73993392,43090,73753694,74146910,239698
14,ENSG00000100596.2,77616637,14-77572280-C-T,rs11624959,-1,C,T,77572280,44357,77420029,77813245,152251
14,ENSG00000089775.6,64503838,14-64457259-G-A,rs11627387,-1,G,A,64457259,46579,64307230,64700446,150029
14,ENSG00000092096.10,23352912,14-23305902-G-A,rs118050704,-1,G,A,23305902,47010,23156304,23549520,149598
14,ENSG00000169413.2,20781268,14-20791876-A-G,rs11847602,1,A,G,20791876,10608,20584660,20977876,207216
14,ENSG00000066455.7,92794305,14-92800235-A-C,rs11847677,1,A,C,92800235,5930,92597697,92990913,202538
14,ENSG00000125378.10,53956825,14-53766035-A-G,rs11848222,-1,A,G,53766035,190790,53760217,54153433,5818
14,ENSG00000129484.9,20343635,14-20188060-T-C,rs1188565,1,T,C,20188060,155575,20147027,20540243,41033
14,ENSG00000129484.9,20343635,14-20188060-T-A,rs1188565,1,T,A,20188060,155575,20147027,20540243,41033
14,ENSG00000165782.6,20461434,14-20489274-T-C,rs12147450,-1,T,C,20489274,27840,20264826,20658042,224448
14,ENSG00000100599.10,92513781,14-92339985-T-C,rs12432529,1,T,C,92339985,173796,92317173,92710389,22812
14,ENSG00000151327.7,35046272,14-34894809-T-A,rs12590112,1,T,A,34894809,151463,34849664,35242880,45145
14,ENSG00000151327.7,35046272,14-34894809-T-C,rs12590112,1,T,C,34894809,151463,34849664,35242880,45145
14,ENSG00000053770.7,57268971,14-57350498-T-C,rs12884744,1,T,C,57350498,81527,57072363,57465579,278135
14,ENSG00000168398.5,96204839,14-96139026-G-A,rs12884816,1,G,A,96139026,65813,96008231,96401447,130795
14,ENSG00000168398.5,96204839,14-96139026-G-C,rs12884816,1,G,C,96139026,65813,96008231,96401447,130795
14,ENSG00000186469.4,51860612,14-51867485-A-G,rs12885784,1,A,G,51867485,6873,51664004,52057220,203481
14,ENSG00000186469.4,51860612,14-51867485-A-T,rs12885784,1,A,T,51867485,6873,51664004,52057220,203481
14,ENSG00000165948.6,94081310,14-94108534-A-G,rs12886562,1,A,G,94108534,27224,93884702,94277918,223832
14,ENSG00000198805.6,20469406,14-20489607-A-G,rs12891826,1,A,G,20489607,20201,20272798,20666014,216809
14,ENSG00000072110.9,68979302,14-68874043-G-T,rs1475034,-1,G,T,68874043,105259,68782694,69175910,91349
14,ENSG00000073712.9,52951050,14-52988769-C-A,rs1537128,-1,C,A,52988769,37719,52754442,53147658,234327
14,ENSG00000100865.10,102362890,14-102331718-G-T,rs1543540,-1,G,T,102331718,31172,102166282,102559498,165436
14,ENSG00000100865.10,102362890,14-102331718-G-A,rs1543540,-1,G,A,102331718,31172,102166282,102559498,165436
14,ENSG00000087302.4,51989546,14-52048194-T-C,rs1566129,1,T,C,52048194,58648,51792938,52186154,255256
14,ENSG00000087302.4,51989546,14-52048194-T-A,rs1566129,1,T,A,52048194,58648,51792938,52186154,255256
14,ENSG00000198894.3,77098258,14-77094135-A-G,rs158123,1,A,G,77094135,4123,76901650,77294866,192485
14,ENSG00000213231.7,95686426,14-95674812-C-T,rs17093221,1,C,T,95674812,11614,95489818,95883034,184994
14,ENSG00000092148.7,31207793,14-31086377-G-C,rs17097715,-1,G,C,31086377,121416,31011185,31404401,75192
14,ENSG00000129480.8,31457506,14-31447491-C-T,rs17097896,-1,C,T,31447491,10015,31260898,31654114,186593
14,ENSG00000129480.8,31457506,14-31447491-C-G,rs17097896,-1,C,G,31447491,10015,31260898,31654114,186593
14,ENSG00000256053.2,103562960,14-103450579-C-T,rs17101620,1,C,T,103450579,112381,103366352,103759568,84227
14,ENSG00000100714.9,64388353,14-64326863-T-C,rs17101774,1,T,C,64326863,61490,64191745,64584961,135118
14,ENSG00000198807.7,36661860,14-36822155-T-C,rs17105423,1,T,C,36822155,160295,36465252,36858468,356903
14,ENSG00000100591.3,77458093,14-77455706-T-C,rs17105811,1,T,C,77455706,2387,77261485,77654701,194221
14,ENSG00000179454.7,44961947,14-45085938-A-G,rs17115809,-1,A,G,45085938,123991,44765339,45158555,320599
14,ENSG00000100433.11,88323269,14-88202156-A-G,rs17124250,-1,A,G,88202156,121113,88126661,88519877,75495
14,ENSG00000087303.11,52069059,14-52018479-G-A,rs17124893,-1,G,A,52018479,50580,51872451,52265667,146028
14,ENSG00000087303.11,52069059,14-52018479-G-C,rs17124893,-1,G,C,52018479,50580,51872451,52265667,146028
14,ENSG00000125384.6,52314312,14-52391597-C-T,rs17125464,1,C,T,52391597,77285,52117704,52510920,273893
14,ENSG00000131979.13,54902826,14-54877161-T-C,rs17128050,-1,T,C,54877161,25665,54706218,55099434,170943
14,ENSG00000131979.13,54902826,14-54877161-T-A,rs17128050,-1,T,A,54877161,25665,54706218,55099434,170943
14,ENSG00000100721.6,95714125,14-95682872-T-G,rs1748951,-1,T,G,95682872,31253,95517517,95910733,165355
14,ENSG00000100721.6,95714125,14-95682872-T-A,rs1748951,-1,T,A,95682872,31253,95517517,95910733,165355
14,ENSG00000119638.7,75127048,14-75003743-C-G,rs175041,-1,C,G,75003743,123305,74930440,75323656,73303
14,ENSG00000119638.7,75127048,14-75003743-C-A,rs175041,-1,C,A,75003743,123305,74930440,75323656,73303
14,ENSG00000119638.7,75127048,14-75003743-C-T,rs175041,-1,C,T,75003743,123305,74930440,75323656,73303
14,ENSG00000070269.9,56579798,14-56728364-A-G,rs1754758,1,A,G,56728364,148566,56383190,56776406,345174
14,ENSG00000100916.8,35826338,14-35762840-A-G,rs17764207,1,A,G,35762840,63498,35629730,36022946,133110
14,ENSG00000182512.4,95535050,14-95546128-A-G,rs17835086,1,A,G,95546128,11078,95338442,95731658,207686
14,ENSG00000257365.2,64986895,14-64942378-C-G,rs17880758,1,C,G,64942378,44517,64790287,65183503,152091
14,ENSG00000257365.2,64986895,14-64942378-C-T,rs17880758,1,C,T,64942378,44517,64790287,65183503,152091
14,ENSG00000119669.3,77028708,14-77031632-C-A,rs183266,-1,C,A,77031632,2924,76832100,77225316,199532
14,ENSG00000119669.3,77028708,14-77031632-C-G,rs183266,-1,C,G,77031632,2924,76832100,77225316,199532
14,ENSG00000092051.10,23578790,14-23668943-A-C,rs1885593,-1,A,C,23668943,90153,23382182,23775398,286761
14,ENSG00000092051.10,23578790,14-23668943-A-G,rs1885593,-1,A,G,23668943,90153,23382182,23775398,286761
14,ENSG00000165949.8,94110736,14-94103451-C-T,rs1950346,1,C,T,94103451,7285,93914128,94307344,189323
14,ENSG00000131323.10,102777449,14-102818542-A-G,rs1956160,1,A,G,102818542,41093,102580841,102974057,237701
14,ENSG00000131323.10,102777449,14-102818542-A-T,rs1956160,1,A,T,102818542,41093,102580841,102974057,237701
14,ENSG00000119698.7,94174322,14-94349784-G-A,rs1956174,1,G,A,94349784,175462,93977714,94370930,372070
14,ENSG00000119698.7,94174322,14-94349784-G-C,rs1956174,1,G,C,94349784,175462,93977714,94370930,372070
14,ENSG00000176153.10,64942745,14-64902611-C-T,rs1957416,-1,C,T,64902611,40134,64746137,65139353,156474
14,ENSG00000165389.6,34462240,14-34363239-A-T,rs1958584,-1,A,T,34363239,99001,34265632,34658848,97607
14,ENSG00000165389.6,34462240,14-34363239-A-G,rs1958584,-1,A,G,34363239,99001,34265632,34658848,97607
14,ENSG00000165389.6,34462240,14-34363239-A-C,rs1958584,-1,A,C,34363239,99001,34265632,34658848,97607
14,ENSG00000063761.11,77800109,14-77625076-A-G,rs2037933,1,A,G,77625076,175033,77603501,77996717,21575
14,ENSG00000133962.3,91732086,14-91864475-G-A,rs2052204,-1,G,A,91864475,132389,91535478,91928694,328997
14,ENSG00000133962.3,91732086,14-91864475-G-T,rs2052204,-1,G,T,91864475,132389,91535478,91928694,328997
14,ENSG00000119718.5,75002921,14-74821815-A-G,rs2058918,1,A,G,74821815,181106,74806313,75199529,15502
14,ENSG00000232070.4,21101103,14-21249741-T-C,rs2065093,1,T,C,21249741,148638,20904495,21297711,345246
14,ENSG00000232070.4,21101103,14-21249741-T-A,rs2065093,1,T,A,21249741,148638,20904495,21297711,345246
14,ENSG00000176903.3,73714384,14-73729983-T-C,rs2075025,-1,T,C,73729983,15599,73517776,73910992,212207
14,ENSG00000176903.3,73714384,14-73729983-T-A,rs2075025,-1,T,A,73729983,15599,73517776,73910992,212207
14,ENSG00000177465.4,73591873,14-73562994-A-G,rs2108465,1,A,G,73562994,28879,73395265,73788481,167729
14,ENSG00000177465.4,73591873,14-73562994-A-C,rs2108465,1,A,C,73562994,28879,73395265,73788481,167729
14,ENSG00000198252.7,52730166,14-52769010-G-T,rs2274275,1,G,T,52769010,38844,52533558,52926774,235452
14,ENSG00000157379.9,24299780,14-24291049-C-T,rs2295310,-1,C,T,24291049,8731,24103172,24496388,187877
14,ENSG00000157379.9,24299780,14-24291049-C-G,rs2295310,-1,C,G,24291049,8731,24103172,24496388,187877
14,ENSG00000140009.14,64294371,14-64414176-A-T,rs2357694,-1,A,T,64414176,119805,64097763,64490979,316413
14,ENSG00000140009.14,64294371,14-64414176-A-G,rs2357694,-1,A,G,64414176,119805,64097763,64490979,316413
14,ENSG00000140009.14,64294371,14-64414176-A-C,rs2357694,-1,A,C,64414176,119805,64097763,64490979,316413
14,ENSG00000140092.10,91947694,14-91856072-T-C,rs2402076,-1,T,C,91856072,91622,91751086,92144302,104986
14,ENSG00000140092.10,91947694,14-91856072-T-A,rs2402076,-1,T,A,91856072,91622,91751086,92144302,104986
14,ENSG00000142208.11,104795748,14-104780652-C-G,rs2494739,-1,C,G,104780652,15096,104599140,104992356,181512
14,ENSG00000142208.11,104795748,14-104780652-C-T,rs2494739,-1,C,T,104780652,15096,104599140,104992356,181512
14,ENSG00000258289.2,64914455,14-64836533-T-C,rs2649196,1,T,C,64836533,77922,64717847,65111063,118686
14,ENSG00000258289.2,64914455,14-64836533-T-G,rs2649196,1,T,G,64836533,77922,64717847,65111063,118686
14,ENSG00000139977.8,57390586,14-57572874-T-C,rs268804,1,T,C,57572874,182288,57193978,57587194,378896
14,ENSG00000165792.11,20989980,14-20991923-T-C,rs2771346,1,T,C,20991923,1943,20793372,21186588,198551
14,ENSG00000185567.6,104978374,14-104989924-G-A,rs2819465,-1,G,A,104989924,11550,104781766,105174982,208158
14,ENSG00000119640.4,75064024,14-75048990-C-T,rs28756980,-1,C,T,75048990,15034,74867416,75260632,181574
14,ENSG00000119640.4,75064024,14-75048990-C-G,rs28756980,-1,C,G,75048990,15034,74867416,75260632,181574
14,ENSG00000170348.4,75176612,14-75047123-T-C,rs28756992,-1,T,C,75047123,129489,74980004,75373220,67119
14,ENSG00000165501.11,49598940,14-49618693-G-C,rs2985698,1,G,C,49618693,19753,49402332,49795548,216361
14,ENSG00000165501.11,49598940,14-49618693-G-A,rs2985698,1,G,A,49618693,19753,49402332,49795548,216361
14,ENSG00000165501.11,49598940,14-49618693-G-T,rs2985698,1,G,T,49618693,19753,49402332,49795548,216361
14,ENSG00000179841.7,64465499,14-64368800-A-G,rs2987981,1,A,G,64368800,96699,64268891,64662107,99909
14,ENSG00000100906.6,35404749,14-35405648-T-C,rs3138053,-1,T,C,35405648,899,35208141,35601357,197507
14,ENSG00000140104.9,104985788,14-105010321-T-C,rs3204173,1,T,C,105010321,24533,104789180,105182396,221141
14,ENSG00000213920.4,24216066,14-24238273-G-T,rs34354104,-1,G,T,24238273,22207,24019458,24412674,218815
14,ENSG00000213920.4,24216066,14-24238273-G-A,rs34354104,-1,G,A,24238273,22207,24019458,24412674,218815
14,ENSG00000100442.6,45134481,14-45231029-A-C,rs34842824,-1,A,C,45231029,96548,44937873,45331089,293156
14,ENSG00000129562.5,22589224,14-22552342-G-A,rs365517,-1,G,A,22552342,36882,22392616,22785832,159726
14,ENSG00000012983.6,50532569,14-50339383-G-A,rs3783418,-1,G,A,50339383,193186,50335961,50729177,3422
14,ENSG00000012983.6,50532569,14-50339383-G-C,rs3783418,-1,G,C,50339383,193186,50335961,50729177,3422
14,ENSG00000100605.10,93115925,14-93010384-T-C,rs3783910,-1,T,C,93010384,105541,92919317,93312533,91067
14,ENSG00000100605.10,93115925,14-93010384-T-A,rs3783910,-1,T,A,93010384,105541,92919317,93312533,91067
14,ENSG00000100605.10,93115925,14-93010384-T-G,rs3783910,-1,T,G,93010384,105541,92919317,93312533,91067
14,ENSG00000071246.5,76761468,14-76768421-C-T,rs3783996,1,C,T,76768421,6953,76564860,76958076,203561
14,ENSG00000198668.6,90397029,14-90406669-T-G,rs3814843,1,T,G,90406669,9640,90200421,90593637,206248
14,ENSG00000198668.6,90397029,14-90406669-T-A,rs3814843,1,T,A,90406669,9640,90200421,90593637,206248
14,ENSG00000215277.4,23237936,14-23386111-G-A,rs382872,1,G,A,23386111,148175,23041328,23434544,344783
14,ENSG00000215277.4,23237936,14-23386111-G-C,rs382872,1,G,C,23386111,148175,23041328,23434544,344783
14,ENSG00000126790.7,59484408,14-59390859-T-A,rs3850302,-1,T,A,59390859,93549,59287800,59681016,103059
14,ENSG00000126790.7,59484408,14-59390859-T-C,rs3850302,-1,T,C,59390859,93549,59287800,59681016,103059
14,ENSG00000100744.10,96363526,14-96384774-C-T,rs4006,1,C,T,96384774,21248,96166918,96560134,217856
14,ENSG00000054983.11,87993182,14-87967316-T-A,rs413420,-1,T,A,87967316,25866,87796574,88189790,170742
14,ENSG00000054983.11,87993182,14-87967316-T-C,rs413420,-1,T,C,87967316,25866,87796574,88189790,170742
14,ENSG00000165502.6,49620626,14-49641944-T-C,rs41345247,-1,T,C,49641944,21318,49424018,49817234,217926
14,ENSG00000166428.8,104924879,14-104945363-A-G,rs4264326,1,A,G,104945363,20484,104728271,105121487,217092
14,ENSG00000100814.12,20333279,14-20325734-C-A,rs45451995,-1,C,A,20325734,7545,20136671,20529887,189063
14,ENSG00000100814.12,20333279,14-20325734-C-T,rs45451995,-1,C,T,20325734,7545,20136671,20529887,189063
14,ENSG00000119608.7,74876145,14-74719747-G-A,rs4903260,-1,G,A,74719747,156398,74679537,75072753,40210
14,ENSG00000165801.5,21070304,14-21067372-C-A,rs4982403,1,C,A,21067372,2932,20873696,21266912,193676
14,ENSG00000165801.5,21070304,14-21067372-C-T,rs4982403,1,C,T,21067372,2932,20873696,21266912,193676
14,ENSG00000129465.11,24339991,14-24434078-A-T,rs4982912,-1,A,T,24434078,94087,24143383,24536599,290695
14,ENSG00000129465.11,24339991,14-24434078-A-C,rs4982912,-1,A,C,24434078,94087,24143383,24536599,290695
14,ENSG00000129465.11,24339991,14-24434078-A-G,rs4982912,-1,A,G,24434078,94087,24143383,24536599,290695
14,ENSG00000179627.9,104801101,14-104680242-A-C,rs4983522,1,A,C,104680242,120859,104604493,104997709,75749
14,ENSG00000100739.6,96256210,14-96241120-A-T,rs5224,1,A,T,96241120,15090,96059602,96452818,181518
14,ENSG00000100739.6,96256210,14-96241120-A-C,rs5224,1,A,C,96241120,15090,96059602,96452818,181518
14,ENSG00000100739.6,96256210,14-96241120-A-G,rs5224,1,A,G,96241120,15090,96059602,96452818,181518
14,ENSG00000213145.5,105486886,14-105476010-C-G,rs55662446,1,C,G,105476010,10876,105290278,105683494,185732
14,ENSG00000100949.10,24271597,14-24095963-A-G,rs55733026,-1,A,G,24095963,175634,24074989,24468205,20974
14,ENSG00000032219.14,58298555,14-58186762-A-C,rs56759383,1,A,C,58186762,111793,58101947,58495163,84815
14,ENSG00000154001.8,63543377,14-63567762-T-C,rs56898919,-1,T,C,63567762,24385,63346769,63739985,220993
14,ENSG00000154001.8,63543377,14-63567762-T-A,rs56898919,-1,T,A,63567762,24385,63346769,63739985,220993
14,ENSG00000006432.10,70809513,14-70865550-C-T,rs58788626,-1,C,T,70865550,56037,70612905,71006121,252645
14,ENSG00000006432.10,70809513,14-70865550-C-G,rs58788626,-1,C,G,70865550,56037,70612905,71006121,252645
14,ENSG00000139998.9,64972336,14-64976718-A-G,rs61160081,-1,A,G,64976718,4382,64775728,65168944,200990
14,ENSG00000184227.3,73537143,14-73573757-T-C,rs61987140,1,T,C,73573757,36614,73340535,73733751,233222
14,ENSG00000185215.4,103123461,14-103146225-T-G,rs6575944,1,T,G,103146225,22764,102926853,103320069,219372
14,ENSG00000088808.11,103847575,14-103762209-A-G,rs6575997,-1,A,G,103762209,85366,103650967,104044183,111242
14,ENSG00000119599.12,72926464,14-73076609-A-C,rs7144160,1,A,C,73076609,150145,72729856,73123072,346753
14,ENSG00000119599.12,72926464,14-73076609-A-T,rs7144160,1,A,T,73076609,150145,72729856,73123072,346753
14,ENSG00000126775.8,55411830,14-55435824-G-A,rs7149317,-1,G,A,55435824,23994,55215222,55608438,220602
14,ENSG00000100592.10,59188667,14-59310881-A-G,rs7149497,1,A,G,59310881,122214,58992059,59385275,318822
14,ENSG00000100592.10,59188667,14-59310881-A-C,rs7149497,1,A,C,59310881,122214,58992059,59385275,318822
14,ENSG00000197555.5,71320476,14-71284403-C-T,rs7155371,1,C,T,71284403,36073,71123868,71517084,160535
14,ENSG00000198208.6,74923260,14-74921480-C-G,rs7156590,-1,C,G,74921480,1780,74726652,75119868,194828
14,ENSG00000198208.6,74923260,14-74921480-C-T,rs7156590,-1,C,T,74921480,1780,74726652,75119868,194828
14,ENSG00000140105.11,100375347,14-100489859-G-A,rs7156672,-1,G,A,100489859,114512,100178739,100571955,311120
14,ENSG00000119673.10,73569213,14-73712097-C-T,rs7182,1,C,T,73712097,142884,73372605,73765821,339492
14,ENSG00000187630.9,23988929,14-23989767-A-G,rs72692116,1,A,G,23989767,838,23792321,24185537,197446
14,ENSG00000166126.6,102922663,14-103112491-A-G,rs72706644,1,A,G,103112491,189828,102726055,103119271,386436
14,ENSG00000165943.4,93184897,14-93369923-G-A,rs72708599,-1,G,A,93369923,185026,92988289,93381505,381634
14,ENSG00000185024.10,105301001,14-105299987-G-C,rs72711565,-1,G,C,105299987,1014,105104393,105497609,195594
14,ENSG00000185024.10,105301001,14-105299987-G-A,rs72711565,-1,G,A,105299987,1014,105104393,105497609,195594
14,ENSG00000183484.7,105065430,14-104970494-C-T,rs73357587,-1,C,T,104970494,94936,104868822,105262038,101672
14,ENSG00000185271.6,20436166,14-20251262-A-G,rs73581370,-1,A,G,20251262,184904,20239558,20632774,11704
14,ENSG00000070182.12,64879907,14-64755499-G-A,rs74058210,-1,G,A,64755499,124408,64683299,65076515,72200
14,ENSG00000011114.10,93333036,14-93435512-C-T,rs74072880,-1,C,T,93435512,102476,93136428,93529644,299084
14,ENSG00000139985.4,70452174,14-70484517-A-G,rs7493545,1,A,G,70484517,32343,70255566,70648782,228951
14,ENSG00000139985.4,70452174,14-70484517-A-C,rs7493545,1,A,C,70484517,32343,70255566,70648782,228951
14,ENSG00000100564.4,67600268,14-67538430-T-C,rs753683,-1,T,C,67538430,61838,67403660,67796876,134770
14,ENSG00000054690.9,67533290,14-67427391-C-T,rs75452946,1,C,T,67427391,105899,67336682,67729898,90709
14,ENSG00000119689.10,74881916,14-74935171-C-T,rs75897219,1,C,T,74935171,53255,74685308,75078524,249863
14,ENSG00000166166.7,103529196,14-103656146-A-G,rs76314289,1,A,G,103656146,126950,103332588,103725804,323558
14,ENSG00000015133.13,91417820,14-91285642-A-G,rs76612086,-1,A,G,91285642,132178,91221212,91614428,64430
14,ENSG00000168282.3,49620799,14-49480609-T-C,rs76881004,1,T,C,49480609,140190,49424191,49817407,56418
14,ENSG00000168282.3,49620799,14-49480609-T-A,rs76881004,1,T,A,49480609,140190,49424191,49817407,56418
14,ENSG00000080815.13,73136507,14-73008065-G-A,rs78182676,1,G,A,73008065,128442,72939899,73333115,68166
14,ENSG00000140030.4,88005135,14-87992401-C-T,rs78187751,1,C,T,87992401,12734,87808527,88201743,183874
14,ENSG00000176438.7,95516650,14-95436723-A-C,rs78849563,-1,A,C,95436723,79927,95320042,95713258,116681
14,ENSG00000100941.4,39175254,14-39002321-A-G,rs78875157,1,A,G,39002321,172933,38978646,39371862,23675
14,ENSG00000165410.10,34714593,14-34715335-T-C,rs8005490,-1,T,C,34715335,742,34517985,34911201,197350
14,ENSG00000126787.8,55191585,14-55198077-T-G,rs8009660,-1,T,G,55198077,6492,54994977,55388193,203100
14,ENSG00000092009.6,24508265,14-24691957-C-T,rs8009836,-1,C,T,24691957,183692,24311657,24704873,380300
14,ENSG00000009830.6,77320883,14-77482223-A-G,rs8010861,-1,A,G,77482223,161340,77124275,77517491,357948
14,ENSG00000205476.4,99604207,14-99585602-G-A,rs8015948,-1,G,A,99585602,18605,99407599,99800815,178003
14,ENSG00000139921.8,51240247,14-51045115-G-T,rs8018259,1,G,T,51045115,195132,51043639,51436855,1476
14,ENSG00000139946.5,56118411,14-56299376-T-G,rs8018553,1,T,G,56299376,180965,55921803,56315019,377573
14,ENSG00000151445.10,77457601,14-77506926-A-G,rs8021886,-1,A,G,77506926,49325,77260993,77654209,245933
14,ENSG00000100628.6,93976570,14-93837018-G-A,rs8023077,-1,G,A,93837018,139552,93779962,94173178,57056
14,ENSG00000136319.6,20305951,14-20379043-A-G,rs938887,-1,A,G,20379043,73092,20109343,20502559,269700
14,ENSG00000197249.8,94388602,14-94365679-T-C,rs941595,-1,T,C,94365679,22923,94191994,94585210,173685
14,ENSG00000100852.8,32077304,14-31984418-A-G,rs944463,1,A,G,31984418,92886,31880696,32273912,103722
14,ENSG00000100852.8,32077304,14-31984418-A-C,rs944463,1,A,C,31984418,92886,31880696,32273912,103722
14,ENSG00000100505.9,51095105,14-51115673-T-C,rs9672122,-1,T,C,51115673,20568,50898497,51291713,217176
14,ENSG00000100664.6,103334237,14-103255911-C-A,rs9743995,1,C,A,103255911,78326,103137629,103530845,118282
14,ENSG00000100664.6,103334237,14-103255911-C-G,rs9743995,1,C,G,103255911,78326,103137629,103530845,118282
14,ENSG00000100664.6,103334237,14-103255911-C-T,rs9743995,1,C,T,103255911,78326,103137629,103530845,118282
13,ENSG00000186184.11,27621892,13-27625231-T-A,rs10492487,1,T,A,27625231,3339,27425284,27818500,199947
13,ENSG00000151287.12,102773786,13-102788397-C-T,rs111300036,-1,C,T,102788397,14611,102577178,102970394,211219
13,ENSG00000185950.7,109786583,13-109893359-C-T,rs111919531,-1,C,T,109893359,106776,109589975,109983191,303384
13,ENSG00000185950.7,109786583,13-109893359-C-A,rs111919531,-1,C,A,109893359,106776,109589975,109983191,303384
13,ENSG00000150403.13,113491021,13-113487333-T-C,rs112470560,1,T,C,113487333,3688,113294413,113687629,192920
13,ENSG00000136167.8,46182177,13-46126507-G-A,rs11342,-1,G,A,46126507,55670,45985569,46378785,140938
13,ENSG00000136167.8,46182177,13-46126507-G-T,rs11342,-1,G,T,46126507,55670,45985569,46378785,140938
13,ENSG00000136167.8,46182177,13-46126507-G-C,rs11342,-1,G,C,46126507,55670,45985569,46378785,140938
13,ENSG00000139842.10,113209613,13-113326272-G-A,rs113680829,1,G,A,113326272,116659,113013005,113406221,313267
13,ENSG00000139746.10,79406255,13-79314341-T-C,rs1155848,-1,T,C,79314341,91914,79209647,79602863,104694
13,ENSG00000205863.4,23897006,13-23900585-G-A,rs11617793,-1,G,A,23900585,3579,23700398,24093614,200187
13,ENSG00000165416.9,52652836,13-52735754-C-T,rs11619426,1,C,T,52735754,82918,52456228,52849444,279526
13,ENSG00000120685.13,39038089,13-38997676-G-A,rs117116799,-1,G,A,38997676,40413,38841481,39234697,156195
13,ENSG00000150401.10,113490711,13-113452876-G-A,rs11839059,-1,G,A,113452876,37835,113294103,113687319,158773
13,ENSG00000120697.4,36999340,13-37093871-G-C,rs1199960,-1,G,C,37093871,94531,36802732,37195948,291139
13,ENSG00000120697.4,36999340,13-37093871-G-T,rs1199960,-1,G,T,37093871,94531,36802732,37195948,291139
13,ENSG00000120697.4,36999340,13-37093871-G-A,rs1199960,-1,G,A,37093871,94531,36802732,37195948,291139
13,ENSG00000187676.6,31199975,13-31240181-T-C,rs12428887,1,T,C,31240181,40206,31003367,31396583,236814
13,ENSG00000125247.11,100674795,13-100717017-C-A,rs1283211,-1,C,A,100717017,42222,100478187,100871403,238830
13,ENSG00000125247.11,100674795,13-100717017-C-G,rs1283211,-1,C,G,100717017,42222,100478187,100871403,238830
13,ENSG00000125247.11,100674795,13-100717017-C-T,rs1283211,-1,C,T,100717017,42222,100478187,100871403,238830
13,ENSG00000151773.6,43879740,13-43872681-A-G,rs12853286,-1,A,G,43872681,7059,43683132,44076348,189549
13,ENSG00000151773.6,43879740,13-43872681-A-C,rs12853286,-1,A,C,43872681,7059,43683132,44076348,189549
13,ENSG00000179630.5,43879904,13-43901378-G-T,rs1373903,1,G,T,43901378,21474,43683296,44076512,218082
13,ENSG00000189403.9,30465936,13-30480029-A-G,rs1467719,-1,A,G,30480029,14093,30269328,30662544,210701
13,ENSG00000189403.9,30465936,13-30480029-A-C,rs1467719,-1,A,C,30480029,14093,30269328,30662544,210701
13,ENSG00000125257.9,95301451,13-95236428-T-C,rs16950824,-1,T,C,95236428,65023,95104843,95498059,131585
13,ENSG00000125257.9,95301451,13-95236428-T-A,rs16950824,-1,T,A,95236428,65023,95104843,95498059,131585
13,ENSG00000088387.12,98978064,13-99018725-A-G,rs16956240,-1,A,G,99018725,40661,98781456,99174672,237269
13,ENSG00000174405.8,108215536,13-108184034-C-A,rs16972098,-1,C,A,108184034,31502,108018928,108412144,165106
13,ENSG00000174405.8,108215536,13-108184034-C-T,rs16972098,-1,C,T,108184034,31502,108018928,108412144,165106
13,ENSG00000120675.4,43023586,13-43023570-C-T,rs17553284,1,C,T,43023570,16,42826978,43220194,196592
13,ENSG00000102781.9,30307551,13-30311086-A-G,rs185694,-1,A,G,30311086,3535,30110943,30504159,200143
13,ENSG00000150457.6,21061586,13-21033621-G-A,rs1887895,-1,G,A,21033621,27965,20864978,21258194,168643
13,ENSG00000169508.6,99307399,13-99366033-A-G,rs1923896,-1,A,G,99366033,58634,99110791,99504007,255242
13,ENSG00000136141.9,46553170,13-46578807-T-C,rs2005053,1,T,C,46578807,25637,46356562,46749778,222245
13,ENSG00000136141.9,46553170,13-46578807-T-A,rs2005053,1,T,A,46578807,25637,46356562,46749778,222245
13,ENSG00000139835.8,113364130,13-113357874-G-T,rs2018093,-1,G,T,113357874,6256,113167522,113560738,190352
13,ENSG00000139835.8,113364130,13-113357874-G-C,rs2018093,-1,G,C,113357874,6256,113167522,113560738,190352
13,ENSG00000126226.14,113208669,13-113235160-C-A,rs2287250,-1,C,A,113235160,26491,113012061,113405277,223099
13,ENSG00000126226.14,113208669,13-113235160-C-T,rs2287250,-1,C,T,113235160,26491,113012061,113405277,223099
13,ENSG00000126231.8,113158648,13-113245883-G-A,rs2302756,1,G,A,113245883,87235,112962040,113355256,283843
13,ENSG00000126231.8,113158648,13-113245883-G-C,rs2302756,1,G,C,113245883,87235,112962040,113355256,283843
13,ENSG00000139618.9,32315508,13-32336191-T-C,rs2320236,1,T,C,32336191,20683,32118900,32512116,217291
13,ENSG00000122042.9,29850617,13-29799201-A-T,rs2388244,-1,A,T,29799201,51416,29654009,30047225,145192
13,ENSG00000122042.9,29850617,13-29799201-A-G,rs2388244,-1,A,G,29799201,51416,29654009,30047225,145192
13,ENSG00000132958.12,19503279,13-19507967-A-G,rs2451086,-1,A,G,19507967,4688,19306671,19699887,201296
13,ENSG00000068650.12,112690038,13-112781013-G-A,rs282625,1,G,A,112781013,90975,112493430,112886646,287583
13,ENSG00000102760.12,41457550,13-41522908-A-G,rs348218,1,A,G,41522908,65358,41260942,41654158,261966
13,ENSG00000102760.12,41457550,13-41522908-A-T,rs348218,1,A,T,41522908,65358,41260942,41654158,261966
13,ENSG00000133116.6,33016423,13-33004274-C-T,rs367243,1,C,T,33004274,12149,32819815,33213031,184459
13,ENSG00000169062.8,114281601,13-114298948-G-A,rs3752107,1,G,A,114298948,17347,114084993,114478209,213955
13,ENSG00000123179.8,49691486,13-49691973-T-C,rs3809325,-1,T,C,49691973,487,49494878,49888094,197095
13,ENSG00000123179.8,49691486,13-49691973-T-A,rs3809325,-1,T,A,49691973,487,49494878,49888094,197095
13,ENSG00000123179.8,49691486,13-49691973-T-G,rs3809325,-1,T,G,49691973,487,49494878,49888094,197095
13,ENSG00000136153.13,75636330,13-75622731-C-T,rs3818355,1,C,T,75622731,13599,75439722,75832938,183009
13,ENSG00000139832.3,110561722,13-110471908-G-C,rs4284503,-1,G,C,110471908,89814,110365114,110758330,106794
13,ENSG00000139832.3,110561722,13-110471908-G-A,rs4284503,-1,G,A,110471908,89814,110365114,110758330,106794
13,ENSG00000102543.10,49247925,13-49334044-T-G,rs4444233,1,T,G,49334044,86119,49051317,49444533,282727
13,ENSG00000102543.10,49247925,13-49334044-T-C,rs4444233,1,T,C,49334044,86119,49051317,49444533,282727
13,ENSG00000184226.10,67230336,13-67262271-A-G,rs4614602,-1,A,G,67262271,31935,67033728,67426944,228543
13,ENSG00000184226.10,67230336,13-67262271-A-T,rs4614602,-1,A,T,67262271,31935,67033728,67426944,228543
13,ENSG00000153495.6,111320642,13-111302287-G-A,rs4773341,1,G,A,111302287,18355,111124034,111517250,178253
13,ENSG00000102547.13,49444064,13-49445240-T-A,rs4942830,-1,T,A,49445240,1176,49247456,49640672,197784
13,ENSG00000139517.6,27620529,13-27617758-T-C,rs498432,-1,T,C,27617758,2771,27423921,27817137,193837
13,ENSG00000139517.6,27620529,13-27617758-T-G,rs498432,-1,T,G,27617758,2771,27423921,27817137,193837
13,ENSG00000139517.6,27620529,13-27617758-T-A,rs498432,-1,T,A,27617758,2771,27423921,27817137,193837
13,ENSG00000136144.7,49585558,13-49608515-A-T,rs5007254,-1,A,T,49608515,22957,49388950,49782166,219565
13,ENSG00000136144.7,49585558,13-49608515-A-G,rs5007254,-1,A,G,49608515,22957,49388950,49782166,219565
13,ENSG00000139505.9,25287488,13-25420938-A-G,rs514065,-1,A,G,25420938,133450,25090880,25484096,330058
13,ENSG00000102606.11,111115310,13-111308757-G-A,rs60947504,1,G,A,111308757,193447,110918702,111311918,390055
13,ENSG00000023516.7,42272152,13-42124149-A-G,rs614000,1,A,G,42124149,148003,42075544,42468760,48605
13,ENSG00000133119.8,33818149,13-33685452-G-C,rs61945512,1,G,C,33685452,132697,33621541,34014757,63911
13,ENSG00000134905.10,110706116,13-110700764-C-T,rs61971615,-1,C,T,110700764,5352,110509508,110902724,191256
13,ENSG00000102753.5,49792682,13-49691674-G-C,rs6561557,-1,G,C,49691674,101008,49596074,49989290,95600
13,ENSG00000102753.5,49792682,13-49691674-G-A,rs6561557,-1,G,A,49691674,101008,49596074,49989290,95600
13,ENSG00000139508.10,28718970,13-28719905-G-C,rs66964313,-1,G,C,28719905,935,28522362,28915578,197543
13,ENSG00000120696.7,41194569,13-41144691-T-G,rs687410,-1,T,G,41144691,49878,40997961,41391177,146730
13,ENSG00000120696.7,41194569,13-41144691-T-A,rs687410,-1,T,A,41144691,49878,40997961,41391177,146730
13,ENSG00000120696.7,41194569,13-41144691-T-C,rs687410,-1,T,C,41144691,49878,40997961,41391177,146730
13,ENSG00000178695.4,76886405,13-76947217-T-C,rs700367,-1,T,C,76947217,60812,76689797,77083013,257420
13,ENSG00000134901.7,102798976,13-102952482-C-T,rs7322462,-1,C,T,102952482,153506,102602368,102995584,350114
13,ENSG00000151846.6,25096136,13-25135329-T-A,rs7325122,1,T,A,25135329,39193,24899528,25292744,235801
13,ENSG00000151846.6,25096136,13-25135329-T-G,rs7325122,1,T,G,25135329,39193,24899528,25292744,235801
13,ENSG00000165572.6,41132802,13-41263019-T-C,rs7325843,-1,T,C,41263019,130217,40936194,41329410,326825
13,ENSG00000136169.11,49444274,13-49518350-T-G,rs7329078,1,T,G,49518350,74076,49247666,49640882,270684
13,ENSG00000136169.11,49444274,13-49518350-T-C,rs7329078,1,T,C,49518350,74076,49247666,49640882,270684
13,ENSG00000136169.11,49444274,13-49518350-T-A,rs7329078,1,T,A,49518350,74076,49247666,49640882,270684
13,ENSG00000134873.4,95552720,13-95470832-T-G,rs7335697,1,T,G,95470832,81888,95356112,95749328,114720
13,ENSG00000102743.8,40789611,13-40779161-G-C,rs7337312,1,G,C,40779161,10450,40593003,40986219,186158
13,ENSG00000102743.8,40789611,13-40779161-G-A,rs7337312,1,G,A,40779161,10450,40593003,40986219,186158
13,ENSG00000121743.3,20161052,13-20161167-C-G,rs73444434,-1,C,G,20161167,115,19964444,20357660,196723
13,ENSG00000121743.3,20161052,13-20161167-C-T,rs73444434,-1,C,T,20161167,115,19964444,20357660,196723
13,ENSG00000213995.5,110615545,13-110639697-A-C,rs7394,1,A,C,110639697,24152,110418937,110812153,220760
13,ENSG00000213995.5,110615545,13-110639697-A-G,rs7394,1,A,G,110639697,24152,110418937,110812153,220760
13,ENSG00000183087.9,113864076,13-113882481-G-A,rs7490083,-1,G,A,113882481,18405,113667468,114060684,215013
13,ENSG00000173988.7,46211943,13-46202584-G-A,rs77210954,1,G,A,46202584,9359,46015335,46408551,187249
13,ENSG00000126217.15,112969214,13-112976094-G-A,rs78105344,1,G,A,112976094,6880,112772606,113165822,203488
13,ENSG00000126216.8,112588153,13-112467126-A-G,rs79416796,-1,A,G,112467126,121027,112391545,112784761,75581
13,ENSG00000102786.9,51453036,13-51338060-C-T,rs79458946,-1,C,T,51338060,114976,51256428,51649644,81632
13,ENSG00000102786.9,51453036,13-51338060-C-A,rs79458946,-1,C,A,51338060,114976,51256428,51649644,81632
13,ENSG00000139597.11,32428130,13-32283544-C-T,rs7981590,-1,C,T,32283544,144586,32231522,32624738,52022
13,ENSG00000139597.11,32428130,13-32283544-C-A,rs7981590,-1,C,A,32283544,144586,32231522,32624738,52022
13,ENSG00000118939.10,75549791,13-75596377-A-C,rs7982613,1,A,C,75596377,46586,75353183,75746399,243194
13,ENSG00000118939.10,75549791,13-75596377-A-G,rs7982613,1,A,G,75596377,46586,75353183,75746399,243194
13,ENSG00000118939.10,75549791,13-75596377-A-T,rs7982613,1,A,T,75596377,46586,75353183,75746399,243194
13,ENSG00000165474.5,20192938,13-20194005-A-T,rs7987144,-1,A,T,20194005,1067,19996330,20389546,197675
13,ENSG00000165474.5,20192938,13-20194005-A-G,rs7987144,-1,A,G,20194005,1067,19996330,20389546,197675
13,ENSG00000165474.5,20192938,13-20194005-A-C,rs7987144,-1,A,C,20194005,1067,19996330,20389546,197675
13,ENSG00000139668.5,51584462,13-51768763-A-G,rs7991634,1,A,G,51768763,184301,51387854,51781070,380909
13,ENSG00000139668.5,51584462,13-51768763-A-C,rs7991634,1,A,C,51768763,184301,51387854,51781070,380909
13,ENSG00000130177.10,114234897,13-114242913-T-G,rs7994573,1,T,G,114242913,8016,114038289,114431505,204624
13,ENSG00000130177.10,114234897,13-114242913-T-C,rs7994573,1,T,C,114242913,8016,114038289,114431505,204624
13,ENSG00000130177.10,114234897,13-114242913-T-A,rs7994573,1,T,A,114242913,8016,114038289,114431505,204624
13,ENSG00000136143.7,48001273,13-47992487-G-C,rs7997802,-1,G,C,47992487,8786,47804665,48197881,187822
13,ENSG00000136143.7,48001273,13-47992487-G-A,rs7997802,-1,G,A,47992487,8786,47804665,48197881,187822
13,ENSG00000136143.7,48001273,13-47992487-G-T,rs7997802,-1,G,T,47992487,8786,47804665,48197881,187822
13,ENSG00000122034.8,27424619,13-27425320-T-C,rs7998978,1,T,C,27425320,701,27228011,27621227,197309
13,ENSG00000122034.8,27424619,13-27425320-T-A,rs7998978,1,T,A,27425320,701,27228011,27621227,197309
13,ENSG00000136161.7,48533080,13-48591739-G-A,rs8002098,-1,G,A,48591739,58659,48336472,48729688,255267
13,ENSG00000152207.3,48653929,13-48591739-G-A,rs8002098,1,G,A,48591739,62190,48457321,48850537,134418
13,ENSG00000080618.8,46105033,13-46067550-A-G,rs9316180,-1,A,G,46067550,37483,45908425,46301641,159125
13,ENSG00000080618.8,46105033,13-46067550-A-C,rs9316180,-1,A,C,46067550,37483,45908425,46301641,159125
13,ENSG00000102445.13,46387252,13-46397645-A-T,rs9316202,-1,A,T,46397645,10393,46190644,46583860,207001
13,ENSG00000102445.13,46387252,13-46397645-A-C,rs9316202,-1,A,C,46397645,10393,46190644,46583860,207001
13,ENSG00000132950.14,19863649,13-19900631-G-A,rs9506395,-1,G,A,19900631,36982,19667041,20060257,233590
13,ENSG00000132950.14,19863649,13-19900631-G-C,rs9506395,-1,G,C,19900631,36982,19667041,20060257,233590
13,ENSG00000032742.12,20567157,13-20572093-A-T,rs9509284,1,A,T,20572093,4936,20370549,20763765,201544
13,ENSG00000032742.12,20567157,13-20572093-A-G,rs9509284,1,A,G,20572093,4936,20370549,20763765,201544
13,ENSG00000180776.11,21459303,13-21432937-G-A,rs9509700,-1,G,A,21432937,26366,21262695,21655911,170242
13,ENSG00000027001.7,23889400,13-23808832-T-G,rs9510867,-1,T,G,23808832,80568,23692792,24086008,116040
13,ENSG00000134864.5,100588789,13-100672024-C-T,rs9513782,-1,C,T,100672024,83235,100392181,100785397,279843
13,ENSG00000134864.5,100588789,13-100672024-C-A,rs9513782,-1,C,A,100672024,83235,100392181,100785397,279843
13,ENSG00000102572.9,98577107,13-98529393-A-G,rs9517337,-1,A,G,98529393,47714,98380499,98773715,148894
13,ENSG00000102572.9,98577107,13-98529393-A-C,rs9517337,-1,A,C,98529393,47714,98380499,98773715,148894
13,ENSG00000136146.8,48095104,13-48240853-G-A,rs9526464,-1,G,A,48240853,145749,47898496,48291712,342357
13,ENSG00000102554.7,73059005,13-73065233-G-A,rs9530143,1,G,A,73065233,6228,72862397,73255613,202836
13,ENSG00000133106.10,42992241,13-42996885-A-T,rs9533339,-1,A,T,42996885,4644,42795633,43188849,201252
13,ENSG00000133106.10,42992241,13-42996885-A-C,rs9533339,-1,A,C,42996885,4644,42795633,43188849,201252
13,ENSG00000133106.10,42992241,13-42996885-A-G,rs9533339,-1,A,G,42996885,4644,42795633,43188849,201252
13,ENSG00000120658.8,43786972,13-43762643-T-C,rs9533609,-1,T,C,43762643,24329,43590364,43983580,172279
13,ENSG00000120658.8,43786972,13-43762643-T-G,rs9533609,-1,T,G,43762643,24329,43590364,43983580,172279
13,ENSG00000152213.3,49628507,13-49620258-G-A,rs9535274,1,G,A,49620258,8249,49431899,49825115,188359
13,ENSG00000136108.8,52455478,13-52456430-G-A,rs9536079,1,G,A,52456430,952,52258870,52652086,197560
13,ENSG00000136108.8,52455478,13-52456430-G-T,rs9536079,1,G,T,52456430,952,52258870,52652086,197560
13,ENSG00000134882.11,99200854,13-99267651-G-A,rs9554579,1,G,A,99267651,66797,99004246,99397462,263405
13,ENSG00000134882.11,99200854,13-99267651-G-C,rs9554579,1,G,C,99267651,66797,99004246,99397462,263405
13,ENSG00000152749.7,94601857,13-94584571-A-T,rs9556403,1,A,T,94584571,17286,94405249,94798465,179322
13,ENSG00000152749.7,94601857,13-94584571-A-G,rs9556403,1,A,G,94584571,17286,94405249,94798465,179322
13,ENSG00000186009.3,113658198,13-113609816-C-T,rs9577593,-1,C,T,113609816,48382,113461590,113854806,148226
13,ENSG00000150456.5,20773961,13-20747115-C-T,rs9578313,-1,C,T,20747115,26846,20577353,20970569,169762
13,ENSG00000182957.8,24160720,13-24299200-A-G,rs9580925,1,A,G,24299200,138480,23964112,24357328,335088
13,ENSG00000102699.5,24512778,13-24490516-C-A,rs9581073,-1,C,A,24490516,22262,24316170,24709386,174346
13,ENSG00000175198.9,100089093,13-99990007-G-A,rs9585310,1,G,A,99990007,99086,99892485,100285701,97522
13,ENSG00000120659.10,42574152,13-42458457-C-G,rs9594759,1,C,G,42458457,115695,42377544,42770760,80913
13,ENSG00000120659.10,42574152,13-42458457-C-T,rs9594759,1,C,T,42458457,115695,42377544,42770760,80913
13,ENSG00000253309.2,51339691,13-51268377-A-C,rs9596491,1,A,C,51268377,71314,51143083,51536299,125294
13,ENSG00000253309.2,51339691,13-51268377-A-G,rs9596491,1,A,G,51268377,71314,51143083,51536299,125294
13,ENSG00000165487.8,21604170,13-21509207-G-T,rs9634371,-1,G,T,21509207,94963,21407562,21800778,101645
13,ENSG00000165487.8,21604170,13-21509207-G-A,rs9634371,-1,G,A,21509207,94963,21407562,21800778,101645
13,ENSG00000165487.8,21604170,13-21509207-G-C,rs9634371,-1,G,C,21509207,94963,21407562,21800778,101645
13,ENSG00000122034.8,27424619,13-27473132-A-G,rs1006353,1,A,G,27473132,48513,27228011,27621227,245121
13,ENSG00000122034.8,27424619,13-27473132-A-C,rs1006353,1,A,C,27473132,48513,27228011,27621227,245121
13,ENSG00000136158.5,80341126,13-80462870-G-A,rs10454664,-1,G,A,80462870,121744,80144518,80537734,318352
13,ENSG00000102699.5,24512778,13-24435347-C-G,rs1050110,-1,C,G,24435347,77431,24316170,24709386,119177
13,ENSG00000174405.8,108215536,13-108236565-G-A,rs11069725,-1,G,A,108236565,21029,108018928,108412144,217637
13,ENSG00000130177.10,114234897,13-114317862-T-C,rs11147327,1,T,C,114317862,82965,114038289,114431505,279573
13,ENSG00000120675.4,43023586,13-42984664-A-G,rs11147895,1,A,G,42984664,38922,42826978,43220194,157686
13,ENSG00000120675.4,43023586,13-42984664-A-T,rs11147895,1,A,T,42984664,38922,42826978,43220194,157686
13,ENSG00000133101.4,36432495,13-36511536-C-T,rs111710500,1,C,T,36511536,79041,36235887,36629103,275649
13,ENSG00000183087.9,113864076,13-113805304-A-G,rs111801150,-1,A,G,113805304,58772,113667468,114060684,137836
13,ENSG00000150459.6,21140514,13-21080450-G-A,rs117320926,1,G,A,21080450,60064,20943906,21337122,136544
13,ENSG00000150893.9,38687077,13-38871014-A-C,rs117899494,1,A,C,38871014,183937,38490469,38883685,380545
13,ENSG00000253710.1,52012398,13-52126334-A-G,rs12146904,1,A,G,52126334,113936,51815790,52209006,310544
13,ENSG00000253710.1,52012398,13-52126334-A-T,rs12146904,1,A,T,52126334,113936,51815790,52209006,310544
13,ENSG00000136144.7,49585558,13-49541268-A-C,rs12429621,-1,A,C,49541268,44290,49388950,49782166,152318
13,ENSG00000125247.11,100674795,13-100650462-G-T,rs1283224,-1,G,T,100650462,24333,100478187,100871403,172275
13,ENSG00000125247.11,100674795,13-100650462-G-A,rs1283224,-1,G,A,100650462,24333,100478187,100871403,172275
13,ENSG00000125247.11,100674795,13-100650462-G-C,rs1283224,-1,G,C,100650462,24333,100478187,100871403,172275
13,ENSG00000179399.9,91398621,13-91433032-C-T,rs12863915,1,C,T,91433032,34411,91202013,91595229,231019
13,ENSG00000179399.9,91398621,13-91433032-C-G,rs12863915,1,C,G,91433032,34411,91202013,91595229,231019
13,ENSG00000179399.9,91398621,13-91433032-C-A,rs12863915,1,C,A,91433032,34411,91202013,91595229,231019
13,ENSG00000102445.13,46387252,13-46334263-T-C,rs12865017,-1,T,C,46334263,52989,46190644,46583860,143619
13,ENSG00000102445.13,46387252,13-46334263-T-A,rs12865017,-1,T,A,46334263,52989,46190644,46583860,143619
13,ENSG00000136108.8,52455478,13-52429772-A-G,rs12870706,1,A,G,52429772,25706,52258870,52652086,170902
13,ENSG00000134901.7,102798976,13-102908429-G-T,rs12871511,-1,G,T,102908429,109453,102602368,102995584,306061
13,ENSG00000122033.9,27450564,13-27515408-G-A,rs12872402,-1,G,A,27515408,64844,27253956,27647172,261452
13,ENSG00000121741.10,19958727,13-19997867-T-G,rs12877070,1,T,G,19997867,39140,19762119,20155335,235748
13,ENSG00000120659.10,42574152,13-42378867-G-A,rs1475248,1,G,A,42378867,195285,42377544,42770760,1323
13,ENSG00000136104.10,50909791,13-50811286-G-A,rs1570603,1,G,A,50811286,98505,50713183,51106399,98103
13,ENSG00000134874.13,95644706,13-95754834-A-G,rs16951334,-1,A,G,95754834,110128,95448098,95841314,306736
13,ENSG00000125266.5,106535662,13-106644457-C-A,rs16968951,-1,C,A,106644457,108795,106339054,106732270,305403
13,ENSG00000023516.7,42272152,13-42291061-C-G,rs17063155,1,C,G,42291061,18909,42075544,42468760,215517
13,ENSG00000005812.6,77027159,13-77111898-T-C,rs17067210,-1,T,C,77111898,84739,76830551,77223767,281347
13,ENSG00000136111.8,75482169,13-75297194-G-T,rs17325351,-1,G,T,75297194,184975,75285561,75678777,11633
13,ENSG00000151835.9,23433702,13-23497183-A-G,rs17390122,-1,A,G,23497183,63481,23237094,23630310,260089
13,ENSG00000179630.5,43879904,13-43898099-C-T,rs17462017,1,C,T,43898099,18195,43683296,44076512,214803
13,ENSG00000102781.9,30307551,13-30240825-G-A,rs202095,-1,G,A,30240825,66726,30110943,30504159,129882
13,ENSG00000165487.8,21604170,13-21574294-A-G,rs2185884,-1,A,G,21574294,29876,21407562,21800778,166732
13,ENSG00000152213.3,49628507,13-49552246-G-A,rs2274278,1,G,A,49552246,76261,49431899,49825115,120347
13,ENSG00000152213.3,49628507,13-49552246-G-T,rs2274278,1,G,T,49552246,76261,49431899,49825115,120347
13,ENSG00000169508.6,99307399,13-99372616-G-A,rs2296046,-1,G,A,99372616,65217,99110791,99504007,261825
13,ENSG00000088451.6,94596152,13-94629042-A-G,rs2298055,-1,A,G,94629042,32890,94399544,94792760,229498
13,ENSG00000102572.9,98577107,13-98411391-G-A,rs2389314,-1,G,A,98411391,165716,98380499,98773715,30892
13,ENSG00000213995.5,110615545,13-110493574-T-C,rs2391834,1,T,C,110493574,121971,110418937,110812153,74637
13,ENSG00000213995.5,110615545,13-110493574-T-A,rs2391834,1,T,A,110493574,121971,110418937,110812153,74637
13,ENSG00000150456.5,20773961,13-20826162-T-C,rs2585898,-1,T,C,20826162,52201,20577353,20970569,248809
13,ENSG00000120658.8,43786972,13-43676223-A-C,rs2771404,-1,A,C,43676223,110749,43590364,43983580,85859
13,ENSG00000120658.8,43786972,13-43676223-A-G,rs2771404,-1,A,G,43676223,110749,43590364,43983580,85859
13,ENSG00000083635.7,44989471,13-44852786-C-A,rs28459441,-1,C,A,44852786,136685,44792863,45186079,59923
13,ENSG00000088448.9,110915069,13-110790613-T-A,rs328801,-1,T,A,110790613,124456,110718461,111111677,72152
13,ENSG00000088448.9,110915069,13-110790613-T-G,rs328801,-1,T,G,110790613,124456,110718461,111111677,72152
13,ENSG00000088448.9,110915069,13-110790613-T-C,rs328801,-1,T,C,110790613,124456,110718461,111111677,72152
13,ENSG00000123191.9,52011450,13-51896349-C-T,rs3803203,-1,C,T,51896349,115101,51814842,52208058,81507
13,ENSG00000123191.9,52011450,13-51896349-C-A,rs3803203,-1,C,A,51896349,115101,51814842,52208058,81507
13,ENSG00000132952.7,30617920,13-30736835-T-C,rs4075132,1,T,C,30736835,118915,30421312,30814528,315523
13,ENSG00000136161.7,48533080,13-48482598-C-G,rs4151636,-1,C,G,48482598,50482,48336472,48729688,146126
13,ENSG00000134899.12,102846032,13-102906418-T-C,rs4408399,1,T,C,102906418,60386,102649424,103042640,256994
13,ENSG00000134899.12,102846032,13-102906418-T-A,rs4408399,1,T,A,102906418,60386,102649424,103042640,256994
13,ENSG00000121742.11,20232319,13-20383091-G-A,rs4633549,-1,G,A,20383091,150772,20035711,20428927,347380
13,ENSG00000121742.11,20232319,13-20383091-G-T,rs4633549,-1,G,T,20383091,150772,20035711,20428927,347380
13,ENSG00000102554.7,73059005,13-73024438-T-A,rs4883921,1,T,A,73024438,34567,72862397,73255613,162041
13,ENSG00000102554.7,73059005,13-73024438-T-G,rs4883921,1,T,G,73024438,34567,72862397,73255613,162041
13,ENSG00000102554.7,73059005,13-73024438-T-C,rs4883921,1,T,C,73024438,34567,72862397,73255613,162041
13,ENSG00000187676.6,31199975,13-31261238-G-C,rs4943289,1,G,C,31261238,61263,31003367,31396583,257871
13,ENSG00000187676.6,31199975,13-31261238-G-A,rs4943289,1,G,A,31261238,61263,31003367,31396583,257871
13,ENSG00000187676.6,31199975,13-31261238-G-T,rs4943289,1,G,T,31261238,61263,31003367,31396583,257871
13,ENSG00000136141.9,46553170,13-46499207-T-C,rs539843,1,T,C,46499207,53963,46356562,46749778,142645
13,ENSG00000198033.5,19181824,13-19148661-G-C,rs548387,-1,G,C,19148661,33163,18985216,19378432,163445
13,ENSG00000133116.6,33016423,13-33036014-T-G,rs577912,1,T,G,33036014,19591,32819815,33213031,216199
13,ENSG00000174032.11,45418373,13-45530714-C-T,rs62637564,-1,C,T,45530714,112341,45221765,45614981,308949
13,ENSG00000122035.6,27270830,13-27305300-T-C,rs6491201,1,T,C,27305300,34470,27074222,27467438,231078
13,ENSG00000122035.6,27270830,13-27305300-T-A,rs6491201,1,T,A,27305300,34470,27074222,27467438,231078
13,ENSG00000133121.14,33285755,13-33188636-G-A,rs703232,-1,G,A,33188636,97119,33089147,33482363,99489
13,ENSG00000133121.14,33285755,13-33188636-G-C,rs703232,-1,G,C,33188636,97119,33089147,33482363,99489
13,ENSG00000139508.10,28718970,13-28677171-G-A,rs73160094,-1,G,A,28677171,41799,28522362,28915578,154809
13,ENSG00000118939.10,75549791,13-75593005-G-C,rs7317250,1,G,C,75593005,43214,75353183,75746399,239822
13,ENSG00000118939.10,75549791,13-75593005-G-A,rs7317250,1,G,A,75593005,43214,75353183,75746399,239822
13,ENSG00000102760.12,41457550,13-41463799-C-T,rs7326471,1,C,T,41463799,6249,41260942,41654158,202857
13,ENSG00000102760.12,41457550,13-41463799-C-G,rs7326471,1,C,G,41463799,6249,41260942,41654158,202857
13,ENSG00000169062.8,114281601,13-114287680-T-C,rs7327124,1,T,C,114287680,6079,114084993,114478209,202687
13,ENSG00000136156.7,48233206,13-48357843-T-C,rs7329938,1,T,C,48357843,124637,48036598,48429814,321245
13,ENSG00000152207.3,48653929,13-48682367-C-A,rs7330144,1,C,A,48682367,28438,48457321,48850537,225046
13,ENSG00000152207.3,48653929,13-48682367-C-T,rs7330144,1,C,T,48682367,28438,48457321,48850537,225046
13,ENSG00000136146.8,48095104,13-48092625-C-T,rs7332363,-1,C,T,48092625,2479,47898496,48291712,194129
13,ENSG00000136146.8,48095104,13-48092625-C-A,rs7332363,-1,C,A,48092625,2479,47898496,48291712,194129
13,ENSG00000136146.8,48095104,13-48092625-C-G,rs7332363,-1,C,G,48092625,2479,47898496,48291712,194129
13,ENSG00000102595.12,96053401,13-96036394-C-G,rs7334508,-1,C,G,96036394,17007,95856793,96250009,179601
13,ENSG00000153495.6,111320642,13-111125666-C-T,rs7335920,1,C,T,111125666,194976,111124034,111517250,1632
13,ENSG00000204899.5,72727629,13-72718106-C-T,rs7337938,-1,C,T,72718106,9523,72531021,72924237,187085
13,ENSG00000204899.5,72727629,13-72718106-C-A,rs7337938,-1,C,A,72718106,9523,72531021,72924237,187085
13,ENSG00000204899.5,72727629,13-72718106-C-G,rs7337938,-1,C,G,72718106,9523,72531021,72924237,187085
13,ENSG00000139597.11,32428130,13-32572361-A-G,rs7339139,-1,A,G,32572361,144231,32231522,32624738,340839
13,ENSG00000186184.11,27621892,13-27591404-G-T,rs74605989,1,G,T,27591404,30488,27425284,27818500,166120
13,ENSG00000132958.12,19503279,13-19650062-G-A,rs75390100,-1,G,A,19650062,146783,19306671,19699887,343391
13,ENSG00000132958.12,19503279,13-19650062-G-T,rs75390100,-1,G,T,19650062,146783,19306671,19699887,343391
13,ENSG00000126226.14,113208669,13-113062785-C-A,rs76087203,-1,C,A,113062785,145884,113012061,113405277,50724
13,ENSG00000139517.6,27620529,13-27583898-G-C,rs76900683,-1,G,C,27583898,36631,27423921,27817137,159977
13,ENSG00000027001.7,23889400,13-23748241-C-T,rs78411439,-1,C,T,23748241,141159,23692792,24086008,55449
13,ENSG00000102755.5,28495128,13-28305915-G-A,rs78547573,-1,G,A,28305915,189213,28298520,28691736,7395
13,ENSG00000102606.11,111115310,13-111228468-G-A,rs7982732,1,G,A,111228468,113158,110918702,111311918,309766
13,ENSG00000244754.3,32538782,13-32471502-G-T,rs798274,-1,G,T,32471502,67280,32342174,32735390,129328
13,ENSG00000244754.3,32538782,13-32471502-G-C,rs798274,-1,G,C,32471502,67280,32342174,32735390,129328
13,ENSG00000244754.3,32538782,13-32471502-G-A,rs798274,-1,G,A,32471502,67280,32342174,32735390,129328
13,ENSG00000123179.8,49691486,13-49767039-T-A,rs7987502,-1,T,A,49767039,75553,49494878,49888094,272161
13,ENSG00000123179.8,49691486,13-49767039-T-C,rs7987502,-1,T,C,49767039,75553,49494878,49888094,272161
13,ENSG00000133106.10,42992241,13-42949965-G-C,rs7989235,-1,G,C,42949965,42276,42795633,43188849,154332
13,ENSG00000133106.10,42992241,13-42949965-G-A,rs7989235,-1,G,A,42949965,42276,42795633,43188849,154332
13,ENSG00000133112.12,45341183,13-45448574-A-T,rs7995340,-1,A,T,45448574,107391,45144575,45537791,303999
13,ENSG00000133112.12,45341183,13-45448574-A-C,rs7995340,-1,A,C,45448574,107391,45144575,45537791,303999
13,ENSG00000102738.6,40771190,13-40944696-G-A,rs8000575,-1,G,A,40944696,173506,40574582,40967798,370114
13,ENSG00000102738.6,40771190,13-40944696-G-T,rs8000575,-1,G,T,40944696,173506,40574582,40967798,370114
13,ENSG00000102738.6,40771190,13-40944696-G-C,rs8000575,-1,G,C,40944696,173506,40574582,40967798,370114
13,ENSG00000139618.9,32315508,13-32172985-C-A,rs916732,1,C,A,32172985,142523,32118900,32512116,54085
13,ENSG00000139618.9,32315508,13-32172985-C-T,rs916732,1,C,T,32172985,142523,32118900,32512116,54085
13,ENSG00000178695.4,76886405,13-76777935-G-A,rs9318444,-1,G,A,76777935,108470,76689797,77083013,88138
13,ENSG00000126216.8,112588153,13-112620037-C-G,rs942919,-1,C,G,112620037,31884,112391545,112784761,228492
13,ENSG00000126216.8,112588153,13-112620037-C-T,rs942919,-1,C,T,112620037,31884,112391545,112784761,228492
13,ENSG00000126216.8,112588153,13-112620037-C-A,rs942919,-1,C,A,112620037,31884,112391545,112784761,228492
13,ENSG00000165474.5,20192938,13-20150146-G-A,rs9509058,-1,G,A,20150146,42792,19996330,20389546,153816
13,ENSG00000032742.12,20567157,13-20565895-T-C,rs9509282,1,T,C,20565895,1262,20370549,20763765,195346
13,ENSG00000205863.4,23897006,13-23868707-C-T,rs9510917,-1,C,T,23868707,28299,23700398,24093614,168309
13,ENSG00000205863.4,23897006,13-23868707-C-A,rs9510917,-1,C,A,23868707,28299,23700398,24093614,168309
13,ENSG00000205863.4,23897006,13-23868707-C-G,rs9510917,-1,C,G,23868707,28299,23700398,24093614,168309
13,ENSG00000134864.5,100588789,13-100565420-G-C,rs9513762,-1,G,C,100565420,23369,100392181,100785397,173239
13,ENSG00000134864.5,100588789,13-100565420-G-A,rs9513762,-1,G,A,100565420,23369,100392181,100785397,173239
13,ENSG00000139832.3,110561722,13-110557066-C-T,rs9521840,-1,C,T,110557066,4656,110365114,110758330,191952
13,ENSG00000151773.6,43879740,13-44010833-C-A,rs9525901,-1,C,A,44010833,131093,43683132,44076348,327701
13,ENSG00000151773.6,43879740,13-44010833-C-T,rs9525901,-1,C,T,44010833,131093,43683132,44076348,327701
13,ENSG00000151773.6,43879740,13-44010833-C-G,rs9525901,-1,C,G,44010833,131093,43683132,44076348,327701
13,ENSG00000189167.6,32315363,13-32309446-G-A,rs9526072,-1,G,A,32309446,5917,32118755,32511971,190691
13,ENSG00000189167.6,32315363,13-32309446-G-C,rs9526072,-1,G,C,32309446,5917,32118755,32511971,190691
13,ENSG00000102763.9,41961109,13-42080053-G-A,rs9532991,-1,G,A,42080053,118944,41764501,42157717,315552
13,ENSG00000102753.5,49792682,13-49620258-G-A,rs9535274,-1,G,A,49620258,172424,49596074,49989290,24184
13,ENSG00000136169.11,49444274,13-49620258-G-A,rs9535274,1,G,A,49620258,175984,49247666,49640882,372592
13,ENSG00000102786.9,51453036,13-51259465-C-T,rs9535628,-1,C,T,51259465,193571,51256428,51649644,3037
13,ENSG00000120693.9,36920238,13-37005343-C-G,rs9547717,-1,C,G,37005343,85105,36723630,37116846,281713
13,ENSG00000120693.9,36920238,13-37005343-C-A,rs9547717,-1,C,A,37005343,85105,36723630,37116846,281713
13,ENSG00000120693.9,36920238,13-37005343-C-T,rs9547717,-1,C,T,37005343,85105,36723630,37116846,281713
13,ENSG00000134873.4,95552720,13-95365787-G-A,rs9556473,1,G,A,95365787,186933,95356112,95749328,9675
13,ENSG00000134873.4,95552720,13-95365787-G-T,rs9556473,1,G,T,95365787,186933,95356112,95749328,9675
13,ENSG00000120697.4,36999340,13-37019287-T-C,rs9566175,-1,T,C,37019287,19947,36802732,37195948,216555
13,ENSG00000126231.8,113158648,13-113229943-G-A,rs9577217,1,G,A,113229943,71295,112962040,113355256,267903
13,ENSG00000139835.8,113364130,13-113206586-G-A,rs9577481,-1,G,A,113206586,157544,113167522,113560738,39064
13,ENSG00000152193.7,78659155,13-78582375-C-T,rs9593344,-1,C,T,78582375,76780,78462547,78855763,119828
13,ENSG00000186009.3,113658198,13-113503763-G-A,rs9805651,-1,G,A,113503763,154435,113461590,113854806,42173
13,ENSG00000186009.3,113658198,13-113503763-G-T,rs9805651,-1,G,T,113503763,154435,113461590,113854806,42173
13,ENSG00000134897.9,102799119,13-102861594-A-G,rs1047769,1,A,G,102861594,62475,102602511,102995727,259083
13,ENSG00000173988.7,46211943,13-46053304-A-G,rs1087,1,A,G,46053304,158639,46015335,46408551,37969
13,ENSG00000173988.7,46211943,13-46053304-A-T,rs1087,1,A,T,46053304,158639,46015335,46408551,37969
13,ENSG00000173988.7,46211943,13-46053304-A-C,rs1087,1,A,C,46053304,158639,46015335,46408551,37969
13,ENSG00000132950.14,19863649,13-19762834-G-A,rs112534345,-1,G,A,19762834,100815,19667041,20060257,95793
13,ENSG00000150403.13,113491021,13-113671269-G-A,rs113303775,1,G,A,113671269,180248,113294413,113687629,376856
13,ENSG00000134905.10,110706116,13-110515871-C-T,rs11617144,-1,C,T,110515871,190245,110509508,110902724,6363
13,ENSG00000139514.7,29595688,13-29598614-G-T,rs11618507,-1,G,T,29598614,2926,29399080,29792296,199534
13,ENSG00000136100.7,52450634,13-52316832-C-T,rs116886428,-1,C,T,52316832,133802,52254026,52647242,62806
13,ENSG00000134884.8,106568137,13-106631504-C-T,rs117675794,-1,C,T,106631504,63367,106371529,106764745,259975
13,ENSG00000136159.2,48037726,13-48082417-G-A,rs11841517,1,G,A,48082417,44691,47841118,48234334,241299
13,ENSG00000139508.10,28718970,13-28612345-C-T,rs11843285,-1,C,T,28612345,106625,28522362,28915578,89983
13,ENSG00000102524.6,108269718,13-108163933-A-T,rs11843941,1,A,T,108163933,105785,108073110,108466326,90823
13,ENSG00000102524.6,108269718,13-108163933-A-G,rs11843941,1,A,G,108163933,105785,108073110,108466326,90823
13,ENSG00000136144.7,49585558,13-49568459-A-G,rs12431331,-1,A,G,49568459,17099,49388950,49782166,179509
13,ENSG00000136144.7,49585558,13-49568459-A-C,rs12431331,-1,A,C,49568459,17099,49388950,49782166,179509
13,ENSG00000136144.7,49585558,13-49568459-A-T,rs12431331,-1,A,T,49568459,17099,49388950,49782166,179509
13,ENSG00000150456.5,20773961,13-20782309-C-T,rs12867715,-1,C,T,20782309,8348,20577353,20970569,204956
13,ENSG00000150456.5,20773961,13-20782309-C-A,rs12867715,-1,C,A,20782309,8348,20577353,20970569,204956
13,ENSG00000023516.7,42272152,13-42378941-C-G,rs1359201,1,C,G,42378941,106789,42075544,42468760,303397
13,ENSG00000023516.7,42272152,13-42378941-C-T,rs1359201,1,C,T,42378941,106789,42075544,42468760,303397
13,ENSG00000023516.7,42272152,13-42378941-C-A,rs1359201,1,C,A,42378941,106789,42075544,42468760,303397
13,ENSG00000152192.5,78603552,13-78701658-A-G,rs1359536,-1,A,G,78701658,98106,78406944,78800160,294714
13,ENSG00000152213.3,49628507,13-49630839-C-A,rs147120792,1,C,A,49630839,2332,49431899,49825115,198940
13,ENSG00000152213.3,49628507,13-49630839-C-T,rs147120792,1,C,T,49630839,2332,49431899,49825115,198940
13,ENSG00000136143.7,48001273,13-47884796-T-C,rs1555722,-1,T,C,47884796,116477,47804665,48197881,80131
13,ENSG00000102780.11,42048648,13-42006234-C-T,rs17062712,1,C,T,42006234,42414,41852040,42245256,154194
13,ENSG00000005810.12,77327094,13-77357842-A-G,rs17067555,-1,A,G,77357842,30748,77130486,77523702,227356
13,ENSG00000136122.10,72727923,13-72588889-C-T,rs17089576,1,C,T,72588889,139034,72531315,72924531,57574
13,ENSG00000125247.11,100674795,13-100489617-A-T,rs17493763,-1,A,T,100489617,185178,100478187,100871403,11430
13,ENSG00000125247.11,100674795,13-100489617-A-G,rs17493763,-1,A,G,100489617,185178,100478187,100871403,11430
13,ENSG00000125247.11,100674795,13-100489617-A-C,rs17493763,-1,A,C,100489617,185178,100478187,100871403,11430
13,ENSG00000179630.5,43879904,13-43984909-A-T,rs1822970,1,A,T,43984909,105005,43683296,44076512,301613
13,ENSG00000179630.5,43879904,13-43984909-A-G,rs1822970,1,A,G,43984909,105005,43683296,44076512,301613
13,ENSG00000133104.7,36346394,13-36371456-C-A,rs1886857,-1,C,A,36371456,25062,36149786,36543002,221670
13,ENSG00000133104.7,36346394,13-36371456-C-T,rs1886857,-1,C,T,36371456,25062,36149786,36543002,221670
13,ENSG00000133104.7,36346394,13-36371456-C-G,rs1886857,-1,C,G,36371456,25062,36149786,36543002,221670
13,ENSG00000102445.13,46387252,13-46481702-A-T,rs1998556,-1,A,T,46481702,94450,46190644,46583860,291058
13,ENSG00000102445.13,46387252,13-46481702-A-C,rs1998556,-1,A,C,46481702,94450,46190644,46583860,291058
13,ENSG00000134864.5,100588789,13-100575231-T-C,rs2066014,-1,T,C,100575231,13558,100392181,100785397,183050
13,ENSG00000134864.5,100588789,13-100575231-T-A,rs2066014,-1,T,A,100575231,13558,100392181,100785397,183050
13,ENSG00000133116.6,33016423,13-33023795-T-C,rs211243,1,T,C,33023795,7372,32819815,33213031,203980
13,ENSG00000139675.10,52642431,13-52764655-T-G,rs2214422,1,T,G,52764655,122224,52445823,52839039,318832
13,ENSG00000153531.7,113453488,13-113537810-A-G,rs2259573,-1,A,G,113537810,84322,113256880,113650096,280930
13,ENSG00000136098.10,52159597,13-52135802-A-C,rs2296351,-1,A,C,52135802,23795,51962989,52356205,172813
13,ENSG00000136098.10,52159597,13-52135802-A-T,rs2296351,-1,A,T,52135802,23795,51962989,52356205,172813
13,ENSG00000151773.6,43879740,13-43874798-C-T,rs2305100,-1,C,T,43874798,4942,43683132,44076348,191666
13,ENSG00000136169.11,49444274,13-49546299-G-T,rs2407697,1,G,T,49546299,102025,49247666,49640882,298633
13,ENSG00000136169.11,49444274,13-49546299-G-A,rs2407697,1,G,A,49546299,102025,49247666,49640882,298633
13,ENSG00000136169.11,49444274,13-49546299-G-C,rs2407697,1,G,C,49546299,102025,49247666,49640882,298633
13,ENSG00000126217.15,112969214,13-112963563-C-T,rs2993346,1,C,T,112963563,5651,112772606,113165822,190957
13,ENSG00000174015.5,45702320,13-45590981-T-A,rs3014932,1,T,A,45590981,111339,45505712,45898928,85269
13,ENSG00000174015.5,45702320,13-45590981-T-C,rs3014932,1,T,C,45590981,111339,45505712,45898928,85269
13,ENSG00000182957.8,24160720,13-24304328-A-G,rs3803218,1,A,G,24304328,143608,23964112,24357328,340216
13,ENSG00000152749.7,94601857,13-94601666-T-A,rs3897473,1,T,A,94601666,191,94405249,94798465,196417
13,ENSG00000152749.7,94601857,13-94601666-T-G,rs3897473,1,T,G,94601666,191,94405249,94798465,196417
13,ENSG00000174405.8,108215536,13-108191138-G-A,rs4144383,-1,G,A,108191138,24398,108018928,108412144,172210
13,ENSG00000174405.8,108215536,13-108191138-G-T,rs4144383,-1,G,T,108191138,24398,108018928,108412144,172210
13,ENSG00000174405.8,108215536,13-108191138-G-C,rs4144383,-1,G,C,108191138,24398,108018928,108412144,172210
13,ENSG00000125257.9,95301451,13-95246257-C-T,rs4148439,-1,C,T,95246257,55194,95104843,95498059,141414
13,ENSG00000165475.9,20525857,13-20474430-G-A,rs4770041,-1,G,A,20474430,51427,20329249,20722465,145181
13,ENSG00000088387.12,98978064,13-98940726-C-A,rs4772162,-1,C,A,98940726,37338,98781456,99174672,159270
13,ENSG00000088387.12,98978064,13-98940726-C-T,rs4772162,-1,C,T,98940726,37338,98781456,99174672,159270
13,ENSG00000088387.12,98978064,13-98940726-C-G,rs4772162,-1,C,G,98940726,37338,98781456,99174672,159270
13,ENSG00000213995.5,110615545,13-110592745-A-T,rs4773225,1,A,T,110592745,22800,110418937,110812153,173808
13,ENSG00000213995.5,110615545,13-110592745-A-G,rs4773225,1,A,G,110592745,22800,110418937,110812153,173808
13,ENSG00000213995.5,110615545,13-110592745-A-C,rs4773225,1,A,C,110592745,22800,110418937,110812153,173808
13,ENSG00000139835.8,113364130,13-113369310-G-A,rs4907625,-1,G,A,113369310,5180,113167522,113560738,201788
13,ENSG00000120694.13,31161904,13-30967420-C-T,rs4942126,-1,C,T,30967420,194484,30965296,31358512,2124
13,ENSG00000102743.8,40789611,13-40723269-C-G,rs4943810,1,C,G,40723269,66342,40593003,40986219,130266
13,ENSG00000102743.8,40789611,13-40723269-C-A,rs4943810,1,C,A,40723269,66342,40593003,40986219,130266
13,ENSG00000102743.8,40789611,13-40723269-C-T,rs4943810,1,C,T,40723269,66342,40593003,40986219,130266
13,ENSG00000102699.5,24512778,13-24514056-T-C,rs6490945,-1,T,C,24514056,1278,24316170,24709386,197886
13,ENSG00000118939.10,75549791,13-75625284-T-C,rs67748130,1,T,C,75625284,75493,75353183,75746399,272101
13,ENSG00000139793.13,97222333,13-97218508-C-A,rs72637441,1,C,A,97218508,3825,97025725,97418941,192783
13,ENSG00000139793.13,97222333,13-97218508-C-G,rs72637441,1,C,G,97218508,3825,97025725,97418941,192783
13,ENSG00000133114.12,44989538,13-44901696-C-T,rs73179635,1,C,T,44901696,87842,44792930,45186146,108766
13,ENSG00000102805.8,76992081,13-76811826-C-G,rs7321723,1,C,G,76811826,180255,76795473,77188689,16353
13,ENSG00000102805.8,76992081,13-76811826-C-T,rs7321723,1,C,T,76811826,180255,76795473,77188689,16353
13,ENSG00000133112.12,45341183,13-45390657-C-T,rs7322491,-1,C,T,45390657,49474,45144575,45537791,246082
13,ENSG00000120675.4,43023586,13-43117155-G-T,rs7325480,1,G,T,43117155,93569,42826978,43220194,290177
13,ENSG00000136104.10,50909791,13-50899917-T-C,rs7332076,1,T,C,50899917,9874,50713183,51106399,186734
13,ENSG00000136104.10,50909791,13-50899917-T-A,rs7332076,1,T,A,50899917,9874,50713183,51106399,186734
13,ENSG00000139515.5,27920000,13-27945240-C-T,rs7333200,1,C,T,27945240,25240,27723392,28116608,221848
13,ENSG00000139515.5,27920000,13-27945240-C-A,rs7333200,1,C,A,27945240,25240,27723392,28116608,221848
13,ENSG00000139737.14,77697687,13-77699555-A-G,rs7337726,1,A,G,77699555,1868,77501079,77894295,198476
13,ENSG00000136141.9,46553170,13-46640736-C-T,rs74076759,1,C,T,46640736,87566,46356562,46749778,284174
13,ENSG00000133121.14,33285755,13-33195359-C-G,rs74714752,-1,C,G,33195359,90396,33089147,33482363,106212
13,ENSG00000133121.14,33285755,13-33195359-C-T,rs74714752,-1,C,T,33195359,90396,33089147,33482363,106212
13,ENSG00000205863.4,23897006,13-23822464-A-G,rs75674138,-1,A,G,23822464,74542,23700398,24093614,122066
13,ENSG00000102755.5,28495128,13-28313526-C-A,rs75768087,-1,C,A,28313526,181602,28298520,28691736,15006
13,ENSG00000102755.5,28495128,13-28313526-C-T,rs75768087,-1,C,T,28313526,181602,28298520,28691736,15006
13,ENSG00000126231.8,113158648,13-113062785-C-A,rs76087203,1,C,A,113062785,95863,112962040,113355256,100745
13,ENSG00000150457.6,21061586,13-21233129-C-T,rs76628495,-1,C,T,21233129,171543,20864978,21258194,368151
13,ENSG00000150457.6,21061586,13-21233129-C-A,rs76628495,-1,C,A,21233129,171543,20864978,21258194,368151
13,ENSG00000065150.12,97953675,13-97966282-T-G,rs77876173,1,T,G,97966282,12607,97757067,98150283,209215
13,ENSG00000130177.10,114234897,13-114202747-T-C,rs7987202,1,T,C,114202747,32150,114038289,114431505,164458
13,ENSG00000130177.10,114234897,13-114202747-T-G,rs7987202,1,T,G,114202747,32150,114038289,114431505,164458
13,ENSG00000121743.3,20161052,13-20187210-C-A,rs7987302,-1,C,A,20187210,26158,19964444,20357660,222766
13,ENSG00000121743.3,20161052,13-20187210-C-T,rs7987302,-1,C,T,20187210,26158,19964444,20357660,222766
13,ENSG00000150401.10,113490711,13-113391958-C-T,rs7993462,-1,C,T,113391958,98753,113294103,113687319,97855
13,ENSG00000150459.6,21140514,13-21253654-C-T,rs7995010,1,C,T,21253654,113140,20943906,21337122,309748
13,ENSG00000150459.6,21140514,13-21253654-C-G,rs7995010,1,C,G,21253654,113140,20943906,21337122,309748
13,ENSG00000136146.8,48095104,13-48214854-A-G,rs7998964,-1,A,G,48214854,119750,47898496,48291712,316358
13,ENSG00000186184.11,27621892,13-27569092-A-G,rs8002697,1,A,G,27569092,52800,27425284,27818500,143808
13,ENSG00000186184.11,27621892,13-27569092-A-T,rs8002697,1,A,T,27569092,52800,27425284,27818500,143808
13,ENSG00000102678.6,21671073,13-21750516-T-A,rs80139898,1,T,A,21750516,79443,21474465,21867681,276051
13,ENSG00000102678.6,21671073,13-21750516-T-C,rs80139898,1,T,C,21750516,79443,21474465,21867681,276051
13,ENSG00000102796.6,51804163,13-51839852-A-T,rs9285180,-1,A,T,51839852,35689,51607555,52000771,232297
13,ENSG00000102796.6,51804163,13-51839852-A-G,rs9285180,-1,A,G,51839852,35689,51607555,52000771,232297
13,ENSG00000132952.7,30617920,13-30772118-C-T,rs9315054,1,C,T,30772118,154198,30421312,30814528,350806
13,ENSG00000123200.11,46052746,13-46126650-T-C,rs9316183,-1,T,C,46126650,73904,45856138,46249354,270512
13,ENSG00000127863.11,23570412,13-23663696-C-T,rs9510799,1,C,T,23663696,93284,23373804,23767020,289892
13,ENSG00000127863.11,23570412,13-23663696-C-G,rs9510799,1,C,G,23663696,93284,23373804,23767020,289892
13,ENSG00000152484.9,27171811,13-27346474-T-C,rs9512637,-1,T,C,27346474,174663,26975203,27368419,371271
13,ENSG00000152484.9,27171811,13-27346474-T-G,rs9512637,-1,T,G,27346474,174663,26975203,27368419,371271
13,ENSG00000132958.12,19503279,13-19390579-A-G,rs9512911,-1,A,G,19390579,112700,19306671,19699887,83908
13,ENSG00000132958.12,19503279,13-19390579-A-T,rs9512911,-1,A,T,19390579,112700,19306671,19699887,83908
13,ENSG00000136156.7,48233206,13-48240853-G-A,rs9526464,1,G,A,48240853,7647,48036598,48429814,204255
13,ENSG00000133106.10,42992241,13-42981034-A-G,rs9533332,-1,A,G,42981034,11207,42795633,43188849,185401
13,ENSG00000139684.8,46797161,13-46887599-A-G,rs9534507,-1,A,G,46887599,90438,46600553,46993769,287046
13,ENSG00000123191.9,52011450,13-51866590-C-T,rs9535779,-1,C,T,51866590,144860,51814842,52208058,51748
13,ENSG00000204899.5,72727629,13-72640011-G-A,rs9543032,-1,G,A,72640011,87618,72531021,72924237,108990
13,ENSG00000126216.8,112588153,13-112584356-C-T,rs9550155,-1,C,T,112584356,3797,112391545,112784761,192811
13,ENSG00000126216.8,112588153,13-112584356-C-A,rs9550155,-1,C,A,112584356,3797,112391545,112784761,192811
13,ENSG00000102781.9,30307551,13-30241695-A-T,rs9550539,-1,A,T,30241695,65856,30110943,30504159,130752
13,ENSG00000102781.9,30307551,13-30241695-A-G,rs9550539,-1,A,G,30241695,65856,30110943,30504159,130752
13,ENSG00000189403.9,30465936,13-30505878-A-G,rs9551929,-1,A,G,30505878,39942,30269328,30662544,236550
13,ENSG00000189403.9,30465936,13-30505878-A-T,rs9551929,-1,A,T,30505878,39942,30269328,30662544,236550
13,ENSG00000122034.8,27424619,13-27414899-G-C,rs9554029,1,G,C,27414899,9720,27228011,27621227,186888
13,ENSG00000122034.8,27424619,13-27414899-G-A,rs9554029,1,G,A,27414899,9720,27228011,27621227,186888
13,ENSG00000139832.3,110561722,13-110470785-T-C,rs9555706,-1,T,C,110470785,90937,110365114,110758330,105671
13,ENSG00000139832.3,110561722,13-110470785-T-A,rs9555706,-1,T,A,110470785,90937,110365114,110758330,105671
13,ENSG00000139832.3,110561722,13-110470785-T-G,rs9555706,-1,T,G,110470785,90937,110365114,110758330,105671
13,ENSG00000102763.9,41961109,13-41885328-G-A,rs9562360,-1,G,A,41885328,75781,41764501,42157717,120827
13,ENSG00000102547.13,49444064,13-49584006-T-C,rs9568269,-1,T,C,49584006,139942,49247456,49640672,336550
13,ENSG00000123179.8,49691486,13-49749613-A-G,rs9568319,-1,A,G,49749613,58127,49494878,49888094,254735
13,ENSG00000123179.8,49691486,13-49749613-A-C,rs9568319,-1,A,C,49749613,58127,49494878,49888094,254735
13,ENSG00000122033.9,27450564,13-27492590-C-T,rs9579088,-1,C,T,27492590,42026,27253956,27647172,238634
13,ENSG00000185950.7,109786583,13-109890070-A-C,rs9583438,-1,A,C,109890070,103487,109589975,109983191,300095
13,ENSG00000102572.9,98577107,13-98466746-T-G,rs9584855,-1,T,G,98466746,110361,98380499,98773715,86247
13,ENSG00000102606.11,111115310,13-111179542-G-A,rs9588373,1,G,A,111179542,64232,110918702,111311918,260840
13,ENSG00000120659.10,42574152,13-42423131-C-A,rs9594751,1,C,A,42423131,151021,42377544,42770760,45587
13,ENSG00000120659.10,42574152,13-42423131-C-T,rs9594751,1,C,T,42423131,151021,42377544,42770760,45587
12,ENSG00000123415.9,54188985,12-54179559-T-C,rs10161263,-1,T,C,54179559,9426,53992377,54385593,187182
12,ENSG00000089053.7,121352411,12-121341857-G-A,rs10400462,-1,G,A,121341857,10554,121155803,121549019,186054
12,ENSG00000176422.9,56468578,12-56471256-G-T,rs1043011,1,G,T,56471256,2678,56271970,56665186,199286
12,ENSG00000110811.13,6828407,12-6839528-A-G,rs1047776,1,A,G,6839528,11121,6631799,7025015,207729
12,ENSG00000110811.13,6828407,12-6839528-A-T,rs1047776,1,A,T,6839528,11121,6631799,7025015,207729
12,ENSG00000183150.3,12696183,12-12663163-C-T,rs10492239,-1,C,T,12663163,33020,12499575,12892791,163588
12,ENSG00000183150.3,12696183,12-12663163-C-A,rs10492239,-1,C,A,12663163,33020,12499575,12892791,163588
12,ENSG00000180574.3,10505890,12-10695201-A-G,rs10492348,1,A,G,10695201,189311,10309282,10702498,385919
12,ENSG00000123096.6,26195573,12-26336024-G-A,rs1049382,1,G,A,26336024,140451,25998965,26392181,337059
12,ENSG00000183160.7,108598084,12-108679562-C-A,rs10507231,-1,C,A,108679562,81478,108401476,108794692,278086
12,ENSG00000183160.7,108598084,12-108679562-C-T,rs10507231,-1,C,T,108679562,81478,108401476,108794692,278086
12,ENSG00000139044.6,459939,12-553672-T-G,rs1056008,1,T,G,553672,93733,263331,656547,290341
12,ENSG00000139044.6,459939,12-553672-T-C,rs1056008,1,T,C,553672,93733,263331,656547,290341
12,ENSG00000139044.6,459939,12-553672-T-A,rs1056008,1,T,A,553672,93733,263331,656547,290341
12,ENSG00000135093.7,109052576,12-109087930-T-G,rs1059262,1,T,G,109087930,35354,108855968,109249184,231962
12,ENSG00000111328.2,123271856,12-123321672-C-T,rs1060105,-1,C,T,123321672,49816,123075248,123468464,246424
12,ENSG00000155957.10,66169996,12-66066014-A-G,rs10735933,-1,A,G,66066014,103982,65973388,66366604,92626
12,ENSG00000119242.4,123972831,12-123899403-T-A,rs10744163,-1,T,A,123899403,73428,123776223,124169439,123180
12,ENSG00000119242.4,123972831,12-123899403-T-G,rs10744163,-1,T,G,123899403,73428,123776223,124169439,123180
12,ENSG00000119242.4,123972831,12-123899403-T-C,rs10744163,-1,T,C,123899403,73428,123776223,124169439,123180
12,ENSG00000177192.8,131929276,12-131839239-G-A,rs10751699,1,G,A,131839239,90037,131732668,132125884,106571
12,ENSG00000177192.8,131929276,12-131839239-G-T,rs10751699,1,G,T,131839239,90037,131732668,132125884,106571
12,ENSG00000133704.4,30695869,12-30740941-T-C,rs10771762,-1,T,C,30740941,45072,30499261,30892477,241680
12,ENSG00000139351.10,101739462,12-101689424-A-T,rs10778139,-1,A,T,101689424,50038,101542854,101936070,146570
12,ENSG00000139351.10,101739462,12-101689424-A-G,rs10778139,-1,A,G,101689424,50038,101542854,101936070,146570
12,ENSG00000139351.10,101739462,12-101689424-A-C,rs10778139,-1,A,C,101689424,50038,101542854,101936070,146570
12,ENSG00000111666.5,101697640,12-101689424-A-T,rs10778139,1,A,T,101689424,8216,101501032,101894248,188392
12,ENSG00000111666.5,101697640,12-101689424-A-G,rs10778139,1,A,G,101689424,8216,101501032,101894248,188392
12,ENSG00000111666.5,101697640,12-101689424-A-C,rs10778139,1,A,C,101689424,8216,101501032,101894248,188392
12,ENSG00000136003.11,108562596,12-108546125-T-G,rs10778643,1,T,G,108546125,16471,108365988,108759204,180137
12,ENSG00000136003.11,108562596,12-108546125-T-A,rs10778643,1,T,A,108546125,16471,108365988,108759204,180137
12,ENSG00000136003.11,108562596,12-108546125-T-C,rs10778643,1,T,C,108546125,16471,108365988,108759204,180137
12,ENSG00000123395.10,52069978,12-52068035-G-A,rs10783487,1,G,A,52068035,1943,51873370,52266586,194665
12,ENSG00000123395.10,52069978,12-52068035-G-T,rs10783487,1,G,T,52068035,1943,51873370,52266586,194665
12,ENSG00000110987.4,122021884,12-121863393-A-G,rs10840624,1,A,G,121863393,158491,121825276,122218492,38117
12,ENSG00000123106.6,28190456,12-28102768-T-G,rs10843094,1,T,G,28102768,87688,27993848,28387064,108920
12,ENSG00000123106.6,28190456,12-28102768-T-C,rs10843094,1,T,C,28102768,87688,27993848,28387064,108920
12,ENSG00000023697.8,15911332,12-15943059-C-G,rs10846256,1,C,G,15943059,31727,15714724,16107940,228335
12,ENSG00000023697.8,15911332,12-15943059-C-T,rs10846256,1,C,T,15943059,31727,15714724,16107940,228335
12,ENSG00000011105.7,3077379,12-3081470-G-A,rs10848786,1,G,A,3081470,4091,2880771,3273987,200699
12,ENSG00000010292.7,6494102,12-6531101-G-T,rs10849485,1,G,T,6531101,36999,6297494,6690710,233607
12,ENSG00000010292.7,6494102,12-6531101-G-A,rs10849485,1,G,A,6531101,36999,6297494,6690710,233607
12,ENSG00000180263.9,95217467,12-95322218-T-C,rs10859872,-1,T,C,95322218,104751,95020859,95414075,301359
12,ENSG00000214029.3,133130274,12-133160725-G-C,rs10870587,-1,G,C,133160725,30451,132933666,133326882,227059
12,ENSG00000139620.8,48682238,12-48739942-C-A,rs10875867,-1,C,A,48739942,57704,48485630,48878846,254312
12,ENSG00000139620.8,48682238,12-48739942-C-T,rs10875867,-1,C,T,48739942,57704,48485630,48878846,254312
12,ENSG00000135390.12,53676083,12-53672959-T-C,rs10876481,-1,T,C,53672959,3124,53479475,53872691,193484
12,ENSG00000197728.5,56041918,12-56007301-G-T,rs10876864,1,G,T,56007301,34617,55845310,56238526,161991
12,ENSG00000197728.5,56041918,12-56007301-G-A,rs10876864,1,G,A,56007301,34617,55845310,56238526,161991
12,ENSG00000123297.11,57782787,12-57771302-C-A,rs10877013,1,C,A,57771302,11485,57586179,57979395,185123
12,ENSG00000123297.11,57782787,12-57771302-C-G,rs10877013,1,C,G,57771302,11485,57586179,57979395,185123
12,ENSG00000123297.11,57782787,12-57771302-C-T,rs10877013,1,C,T,57771302,11485,57586179,57979395,185123
12,ENSG00000089250.13,117361626,12-117258359-G-A,rs1093329,-1,G,A,117258359,103267,117165018,117558234,93341
12,ENSG00000089250.13,117361626,12-117258359-G-T,rs1093329,-1,G,T,117258359,103267,117165018,117558234,93341
12,ENSG00000089250.13,117361626,12-117258359-G-C,rs1093329,-1,G,C,117258359,103267,117165018,117558234,93341
12,ENSG00000158023.5,121918592,12-121918387-G-T,rs11043242,1,G,T,121918387,205,121721984,122115200,196403
12,ENSG00000158023.5,121918592,12-121918387-G-C,rs11043242,1,G,C,121918387,205,121721984,122115200,196403
12,ENSG00000158023.5,121918592,12-121918387-G-A,rs11043242,1,G,A,121918387,205,121721984,122115200,196403
12,ENSG00000111711.4,21501789,12-21525172-G-A,rs11046104,1,G,A,21525172,23383,21305181,21698397,219991
12,ENSG00000111711.4,21501789,12-21525172-G-C,rs11046104,1,G,C,21525172,23383,21305181,21698397,219991
12,ENSG00000029153.10,27332836,12-27452505-G-A,rs11049015,1,G,A,27452505,119669,27136228,27529444,316277
12,ENSG00000110841.8,27524206,12-27585783-T-C,rs11049058,1,T,C,27585783,61577,27327598,27720814,258185
12,ENSG00000139131.8,32755897,12-32747042-T-C,rs11052215,-1,T,C,32747042,8855,32559289,32952505,187753
12,ENSG00000172243.13,10130199,12-10131112-T-C,rs11053624,-1,T,C,10131112,913,9933591,10326807,197521
12,ENSG00000188026.7,123533719,12-123645377-C-A,rs11057315,-1,C,A,123645377,111658,123337111,123730327,308266
12,ENSG00000006831.9,1691070,12-1529589-C-T,rs11061820,1,C,T,1529589,161481,1494462,1887678,35127
12,ENSG00000006831.9,1691070,12-1529589-C-G,rs11061820,1,C,G,1529589,161481,1494462,1887678,35127
12,ENSG00000006831.9,1691070,12-1529589-C-A,rs11061820,1,C,A,1529589,161481,1494462,1887678,35127
12,ENSG00000171823.6,1594581,12-1552787-C-G,rs11061846,-1,C,G,1552787,41794,1397973,1791189,154814
12,ENSG00000171823.6,1594581,12-1552787-C-T,rs11061846,-1,C,T,1552787,41794,1397973,1791189,154814
12,ENSG00000130038.5,3753109,12-3749908-G-A,rs11062786,-1,G,A,3749908,3201,3556501,3949717,193407
12,ENSG00000130038.5,3753109,12-3749908-G-C,rs11062786,-1,G,C,3749908,3201,3556501,3949717,193407
12,ENSG00000073614.6,389320,12-487446-C-A,rs11063222,-1,C,A,487446,98126,192712,585928,294734
12,ENSG00000073614.6,389320,12-487446-C-T,rs11063222,-1,C,T,487446,98126,192712,585928,294734
12,ENSG00000010278.6,6200400,12-6253196-A-G,rs11064111,1,A,G,6253196,52796,6003792,6397008,249404
12,ENSG00000089693.6,6753141,12-6757661-T-G,rs11064369,-1,T,G,6757661,4520,6556533,6949749,201128
12,ENSG00000089693.6,6753141,12-6757661-T-A,rs11064369,-1,T,A,6757661,4520,6556533,6949749,201128
12,ENSG00000111725.5,119668133,12-119709120-G-A,rs11064881,1,G,A,119709120,40987,119471525,119864741,237595
12,ENSG00000089041.11,121132876,12-121052717-C-T,rs11065406,1,C,T,121052717,80159,120936268,121329484,116449
12,ENSG00000198270.6,112013165,12-111996348-C-G,rs11066118,-1,C,G,111996348,16817,111816557,112209773,179791
12,ENSG00000198270.6,112013165,12-111996348-C-T,rs11066118,-1,C,T,111996348,16817,111816557,112209773,179791
12,ENSG00000176834.9,118104011,12-118057080-C-A,rs11068793,-1,C,A,118057080,46931,117907403,118300619,149677
12,ENSG00000111252.5,111405923,12-111448480-G-A,rs1107853,1,G,A,111448480,42557,111209315,111602531,239165
12,ENSG00000111252.5,111405923,12-111448480-G-T,rs1107853,1,G,T,111448480,42557,111209315,111602531,239165
12,ENSG00000177889.5,93441947,12-93468886-G-C,rs11107041,-1,G,C,93468886,26939,93245339,93638555,223547
12,ENSG00000120860.6,102061991,12-102021478-T-C,rs11111134,-1,T,C,102021478,40513,101865383,102258599,156095
12,ENSG00000120860.6,102061991,12-102021478-T-A,rs11111134,-1,T,A,102021478,40513,101865383,102258599,156095
12,ENSG00000136045.5,107685799,12-107662819-G-A,rs11113426,1,G,A,107662819,22980,107489191,107882407,173628
12,ENSG00000165899.6,80099537,12-80243202-G-A,rs11114364,1,G,A,80243202,143665,79902929,80296145,340273
12,ENSG00000112787.7,132490151,12-132469613-G-C,rs11147102,1,G,C,132469613,20538,132293543,132686759,176070
12,ENSG00000112787.7,132490151,12-132469613-G-A,rs11147102,1,G,A,132469613,20538,132293543,132686759,176070
12,ENSG00000112787.7,132490151,12-132469613-G-T,rs11147102,1,G,T,132469613,20538,132293543,132686759,176070
12,ENSG00000167535.3,48818496,12-48811851-T-C,rs11168749,1,T,C,48811851,6645,48621888,49015104,189963
12,ENSG00000167550.6,49069979,12-49091590-C-T,rs11168854,-1,C,T,49091590,21611,48873371,49266587,218219
12,ENSG00000167550.6,49069979,12-49091590-C-G,rs11168854,-1,C,G,49091590,21611,48873371,49266587,218219
12,ENSG00000167552.8,49189080,12-49126866-G-A,rs11168871,-1,G,A,49126866,62214,48992472,49385688,134394
12,ENSG00000181929.6,49018776,12-49161631-G-A,rs11168898,-1,G,A,49161631,142855,48822168,49215384,339463
12,ENSG00000181929.6,49018776,12-49161631-G-C,rs11168898,-1,G,C,49161631,142855,48822168,49215384,339463
12,ENSG00000151176.3,113358587,12-113410518-G-C,rs111711423,1,G,C,113410518,51931,113161979,113555195,248539
12,ENSG00000151176.3,113358587,12-113410518-G-A,rs111711423,1,G,A,113410518,51931,113161979,113555195,248539
12,ENSG00000182199.6,57229711,12-57253591-G-A,rs11172135,1,G,A,57253591,23880,57033103,57426319,220488
12,ENSG00000090376.4,66189214,12-66186955-G-A,rs11176082,1,G,A,66186955,2259,65992606,66385822,194349
12,ENSG00000090376.4,66189214,12-66186955-G-T,rs11176082,1,G,T,66186955,2259,65992606,66385822,194349
12,ENSG00000166226.7,69585459,12-69434901-G-C,rs11177669,1,G,C,69434901,150558,69388851,69782067,46050
12,ENSG00000166226.7,69585459,12-69434901-G-A,rs11177669,1,G,A,69434901,150558,69388851,69782067,46050
12,ENSG00000161791.9,49707405,12-49556468-C-G,rs113209368,-1,C,G,49556468,150937,49510797,49904013,45671
12,ENSG00000139714.8,121669654,12-121576865-C-G,rs113467236,-1,C,G,121576865,92789,121473046,121866262,103819
12,ENSG00000174718.7,31959415,12-31973718-C-T,rs113925411,1,C,T,31973718,14303,31762807,32156023,210911
12,ENSG00000111057.6,52949118,12-52876467-C-T,rs115234364,1,C,T,52876467,72651,52752510,53145726,123957
12,ENSG00000182544.6,53252095,12-53205921-C-T,rs11574529,1,C,T,53205921,46174,53055487,53448703,150434
12,ENSG00000135476.7,53268299,12-53205921-C-T,rs11574529,1,C,T,53205921,62378,53071691,53464907,134230
12,ENSG00000139263.7,58920504,12-58924023-A-G,rs11611254,-1,A,G,58924023,3519,58723896,59117112,200127
12,ENSG00000139289.7,76031776,12-76171719-G-A,rs11611315,-1,G,A,76171719,139943,75835168,76228384,336551
12,ENSG00000111196.5,10613609,12-10612901-C-T,rs116702057,-1,C,T,10612901,708,10417001,10810217,195900
12,ENSG00000188735.7,121712752,12-121788623-A-T,rs1168667,1,A,T,121788623,75871,121516144,121909360,272479
12,ENSG00000188735.7,121712752,12-121788623-A-G,rs1168667,1,A,G,121788623,75871,121516144,121909360,272479
12,ENSG00000165935.5,27466810,12-27475674-C-T,rs117144045,1,C,T,27475674,8864,27270202,27663418,205472
12,ENSG00000165935.5,27466810,12-27475674-C-A,rs117144045,1,C,A,27475674,8864,27270202,27663418,205472
12,ENSG00000070019.3,14696599,12-14634711-C-T,rs117452271,-1,C,T,14634711,61888,14499991,14893207,134720
12,ENSG00000126746.12,6689375,12-6676779-T-C,rs117471807,-1,T,C,6676779,12596,6492767,6885983,184012
12,ENSG00000139168.3,42326094,12-42176456-T-C,rs117503242,-1,T,C,42176456,149638,42129486,42522702,46970
12,ENSG00000179295.10,112418947,12-112592827-G-T,rs117529015,1,G,T,112592827,173880,112222339,112615555,370488
12,ENSG00000179295.10,112418947,12-112592827-G-A,rs117529015,1,G,A,112592827,173880,112222339,112615555,370488
12,ENSG00000060982.10,24949101,12-24956385-G-A,rs117800976,-1,G,A,24956385,7284,24752493,25145709,203892
12,ENSG00000110871.9,120529158,12-120491660-G-A,rs117807066,-1,G,A,120491660,37498,120332550,120725766,159110
12,ENSG00000110871.9,120529158,12-120491660-G-T,rs117807066,-1,G,T,120491660,37498,120332550,120725766,159110
12,ENSG00000135517.5,56454657,12-56487830-G-A,rs117867773,-1,G,A,56487830,33173,56258049,56651265,229781
12,ENSG00000177990.7,63668493,12-63786089-G-T,rs11829078,-1,G,T,63786089,117596,63471885,63865101,314204
12,ENSG00000061273.12,47819903,12-47763920-C-T,rs11830537,-1,C,T,47763920,55983,47623295,48016511,140625
12,ENSG00000135114.7,121039242,12-121043262-T-G,rs11830846,-1,T,G,121043262,4020,120842634,121235850,200628
12,ENSG00000121749.11,71839759,12-71838406-A-G,rs11831622,1,A,G,71838406,1353,71643151,72036367,195255
12,ENSG00000121749.11,71839759,12-71838406-A-C,rs11831622,1,A,C,71838406,1353,71643151,72036367,195255
12,ENSG00000166598.7,103930410,12-103757782-T-A,rs11834389,1,T,A,103757782,172628,103733802,104127018,23980
12,ENSG00000166598.7,103930410,12-103757782-T-C,rs11834389,1,T,C,103757782,172628,103733802,104127018,23980
12,ENSG00000111186.8,1629231,12-1534947-G-A,rs12049927,1,G,A,1534947,94284,1432623,1825839,102324
12,ENSG00000256436.1,11031407,12-10997434-G-T,rs12226919,-1,G,T,10997434,33973,10834799,11228015,162635
12,ENSG00000256436.1,11031407,12-10997434-G-A,rs12226919,-1,G,A,10997434,33973,10834799,11228015,162635
12,ENSG00000256436.1,11031407,12-10997434-G-C,rs12226919,-1,G,C,10997434,33973,10834799,11228015,162635
12,ENSG00000212124.2,11022620,12-10997434-G-T,rs12226919,-1,G,T,10997434,25186,10826012,11219228,171422
12,ENSG00000212124.2,11022620,12-10997434-G-A,rs12226919,-1,G,A,10997434,25186,10826012,11219228,171422
12,ENSG00000212124.2,11022620,12-10997434-G-C,rs12226919,-1,G,C,10997434,25186,10826012,11219228,171422
12,ENSG00000173208.3,39619803,12-39604342-T-A,rs12227668,-1,T,A,39604342,15461,39423195,39816411,181147
12,ENSG00000173208.3,39619803,12-39604342-T-C,rs12227668,-1,T,C,39604342,15461,39423195,39816411,181147
12,ENSG00000136052.5,104958290,12-104890795-T-C,rs12296700,-1,T,C,104890795,67495,104761682,105154898,129113
12,ENSG00000135506.11,57694132,12-57785358-G-A,rs12306667,1,G,A,57785358,91226,57497524,57890740,287834
12,ENSG00000211584.8,47773238,12-47858356-G-A,rs12308082,1,G,A,47858356,85118,47576630,47969846,281726
12,ENSG00000089692.3,6772520,12-6588187-G-A,rs12310569,1,G,A,6588187,184333,6575912,6969128,12275
12,ENSG00000070018.4,12267044,12-12165556-T-C,rs12316043,-1,T,C,12165556,101488,12070436,12463652,95120
12,ENSG00000180481.6,75391089,12-75379684-G-A,rs12369556,1,G,A,75379684,11405,75194481,75587697,185203
12,ENSG00000118307.12,25195160,12-25177517-C-T,rs12423443,-1,C,T,25177517,17643,24998552,25391768,178965
12,ENSG00000118307.12,25195160,12-25177517-C-A,rs12423443,-1,C,A,25177517,17643,24998552,25391768,178965
12,ENSG00000057704.6,94650557,12-94823160-C-T,rs12580507,-1,C,T,94823160,172603,94453949,94847165,369211
12,ENSG00000092841.13,56158359,12-56265075-T-G,rs1274500,1,T,G,56265075,106716,55961751,56354967,303324
12,ENSG00000196387.4,133080923,12-132913877-T-A,rs1278607,1,T,A,132913877,167046,132884315,133277531,29562
12,ENSG00000196387.4,133080923,12-132913877-T-C,rs1278607,1,T,C,132913877,167046,132884315,133277531,29562
12,ENSG00000139410.10,113422380,12-113430906-A-C,rs12817952,1,A,C,113430906,8526,113225772,113618988,205134
12,ENSG00000064763.5,29149278,12-29144056-T-C,rs12825454,1,T,C,29144056,5222,28952670,29345886,191386
12,ENSG00000139218.12,45990574,12-45992065-C-T,rs12828693,-1,C,T,45992065,1491,45793966,46187182,198099
12,ENSG00000170442.6,52274645,12-52318711-G-A,rs13377620,1,G,A,52318711,44066,52078037,52471253,240674
12,ENSG00000087470.12,32679301,12-32756912-T-C,rs1454932,1,T,C,32756912,77611,32482693,32875909,274219
12,ENSG00000166888.4,57111362,12-57140687-G-C,rs1466535,-1,G,C,57140687,29325,56914754,57307970,225933
12,ENSG00000166888.4,57111362,12-57140687-G-A,rs1466535,-1,G,A,57140687,29325,56914754,57307970,225933
12,ENSG00000151229.7,40106081,12-40113336-A-T,rs1482287,-1,A,T,40113336,7255,39909473,40302689,203863
12,ENSG00000151229.7,40106081,12-40113336-A-G,rs1482287,-1,A,G,40113336,7255,39909473,40302689,203863
12,ENSG00000078246.10,2890891,12-3052194-A-G,rs148964538,1,A,G,3052194,161303,2694283,3087499,357911
12,ENSG00000078246.10,2890891,12-3052194-A-C,rs148964538,1,A,C,3052194,161303,2694283,3087499,357911
12,ENSG00000172322.8,9971409,12-9961876-G-A,rs1535651,1,G,A,9961876,9533,9774801,10168017,187075
12,ENSG00000172322.8,9971409,12-9961876-G-T,rs1535651,1,G,T,9961876,9533,9774801,10168017,187075
12,ENSG00000166886.8,57089114,12-57032181-C-T,rs1552245,1,C,T,57032181,56933,56892506,57285722,139675
12,ENSG00000139537.6,48904133,12-48862015-G-C,rs1565933,1,G,C,48862015,42118,48707525,49100741,154490
12,ENSG00000127329.9,70637429,12-70490716-G-A,rs1603228,-1,G,A,70490716,146713,70440821,70834037,49895
12,ENSG00000139083.5,11649674,12-11754465-C-T,rs16907207,1,C,T,11754465,104791,11453066,11846282,301399
12,ENSG00000139132.9,32399558,12-32364432-A-C,rs16919801,1,A,C,32364432,35126,32202950,32596166,161482
12,ENSG00000139323.9,89526047,12-89360300-G-A,rs17016739,-1,G,A,89360300,165747,89329439,89722655,30861
12,ENSG00000139323.9,89526047,12-89360300-G-C,rs17016739,-1,G,C,89360300,165747,89329439,89722655,30861
12,ENSG00000255150.1,104303739,12-104354534-A-C,rs17035376,1,A,C,104354534,50795,104107131,104500347,247403
12,ENSG00000170581.8,56360107,12-56273820-T-G,rs17118439,-1,T,G,56273820,86287,56163499,56556715,110321
12,ENSG00000170581.8,56360107,12-56273820-T-C,rs17118439,-1,T,C,56273820,86287,56163499,56556715,110321
12,ENSG00000177627.5,48482498,12-48361859-A-G,rs17122920,1,A,G,48361859,120639,48285890,48679106,75969
12,ENSG00000139428.5,109573504,12-109591945-T-A,rs17183465,-1,T,A,109591945,18441,109376896,109770112,215049
12,ENSG00000084444.9,13044381,12-13090234-A-G,rs17212998,1,A,G,13090234,45853,12847773,13240989,242461
12,ENSG00000079387.9,48106079,12-48213229-G-T,rs17225261,-1,G,T,48213229,107150,47909471,48302687,303758
12,ENSG00000079387.9,48106079,12-48213229-G-A,rs17225261,-1,G,A,48213229,107150,47909471,48302687,303758
12,ENSG00000165714.6,12357078,12-12468633-T-G,rs17312055,1,T,G,12468633,111555,12160470,12553686,308163
12,ENSG00000135439.6,57738742,12-57676062-A-G,rs17455386,-1,A,G,57676062,62680,57542134,57935350,133928
12,ENSG00000135437.5,55720393,12-55644976-T-A,rs17511746,1,T,A,55644976,75417,55523785,55917001,121191
12,ENSG00000135437.5,55720393,12-55644976-T-G,rs17511746,1,T,G,55644976,75417,55523785,55917001,121191
12,ENSG00000196935.4,63844700,12-63845481-A-G,rs17708810,1,A,G,63845481,781,63648092,64041308,197389
12,ENSG00000197757.7,54028440,12-54221088-C-T,rs17779936,1,C,T,54221088,192648,53831832,54225048,389256
12,ENSG00000173598.9,93377925,12-93397457-A-G,rs17790482,1,A,G,93397457,19532,93181317,93574533,216140
12,ENSG00000174527.4,109347903,12-109197029-A-G,rs17848802,1,A,G,109197029,150874,109151295,109544511,45734
12,ENSG00000135447.10,54588659,12-54562960-A-G,rs1795814,-1,A,G,54562960,25699,54392051,54785267,170909
12,ENSG00000123360.7,54549601,12-54562960-A-G,rs1795814,1,A,G,54562960,13359,54352993,54746209,209967
12,ENSG00000255398.2,122716811,12-122716221-T-A,rs1798192,-1,T,A,122716221,590,122520203,122913419,196018
12,ENSG00000255398.2,122716811,12-122716221-T-C,rs1798192,-1,T,C,122716221,590,122520203,122913419,196018
12,ENSG00000255398.2,122716811,12-122716221-T-G,rs1798192,-1,T,G,122716221,590,122520203,122913419,196018
12,ENSG00000182782.6,122703357,12-122716221-T-A,rs1798192,-1,T,A,122716221,12864,122506749,122899965,209472
12,ENSG00000182782.6,122703357,12-122716221-T-C,rs1798192,-1,T,C,122716221,12864,122506749,122899965,209472
12,ENSG00000182782.6,122703357,12-122716221-T-G,rs1798192,-1,T,G,122716221,12864,122506749,122899965,209472
12,ENSG00000213809.4,10390041,12-10409490-A-C,rs1841958,-1,A,C,10409490,19449,10193433,10586649,216057
12,ENSG00000089127.7,112906962,12-112938526-C-G,rs1859331,1,C,G,112938526,31564,112710354,113103570,228172
12,ENSG00000089127.7,112906962,12-112938526-C-T,rs1859331,1,C,T,112938526,31564,112710354,113103570,228172
12,ENSG00000089127.7,112906962,12-112938526-C-A,rs1859331,1,C,A,112938526,31564,112710354,113103570,228172
12,ENSG00000175189.2,57434784,12-57625414-C-G,rs1871415,1,C,G,57625414,190630,57238176,57631392,387238
12,ENSG00000175189.2,57434784,12-57625414-C-T,rs1871415,1,C,T,57625414,190630,57238176,57631392,387238
12,ENSG00000152944.4,27022558,12-27028866-G-T,rs1872193,1,G,T,27028866,6308,26825950,27219166,202916
12,ENSG00000152944.4,27022558,12-27028866-G-C,rs1872193,1,G,C,27028866,6308,26825950,27219166,202916
12,ENSG00000152944.4,27022558,12-27028866-G-A,rs1872193,1,G,A,27028866,6308,26825950,27219166,202916
12,ENSG00000188906.9,40224997,12-40158615-T-C,rs1873613,1,T,C,40158615,66382,40028389,40421605,130226
12,ENSG00000205707.5,25195237,12-25090181-G-C,rs1908946,1,G,C,25090181,105056,24998629,25391845,91552
12,ENSG00000205707.5,25195237,12-25090181-G-A,rs1908946,1,G,A,25090181,105056,24998629,25391845,91552
12,ENSG00000215021.3,6970664,12-6787028-A-G,rs1922452,-1,A,G,6787028,183636,6774056,7167272,12972
12,ENSG00000215021.3,6970664,12-6787028-A-T,rs1922452,-1,A,T,6787028,183636,6774056,7167272,12972
12,ENSG00000215021.3,6970664,12-6787028-A-C,rs1922452,-1,A,C,6787028,183636,6774056,7167272,12972
12,ENSG00000177084.9,132687342,12-132856587-T-A,rs2062163,-1,T,A,132856587,169245,132490734,132883950,365853
12,ENSG00000177084.9,132687342,12-132856587-T-C,rs2062163,-1,T,C,132856587,169245,132490734,132883950,365853
12,ENSG00000089220.3,118136124,12-118137291-T-C,rs2088702,1,T,C,118137291,1167,117939516,118332732,197775
12,ENSG00000089220.3,118136124,12-118137291-T-A,rs2088702,1,T,A,118137291,1167,117939516,118332732,197775
12,ENSG00000089220.3,118136124,12-118137291-T-G,rs2088702,1,T,G,118137291,1167,117939516,118332732,197775
12,ENSG00000139433.4,109880541,12-109888648-G-A,rs2111540,-1,G,A,109888648,8107,109683933,110077149,204715
12,ENSG00000004478.5,2794970,12-2654835-G-C,rs216046,1,G,C,2654835,140135,2598362,2991578,56473
12,ENSG00000004478.5,2794970,12-2654835-G-A,rs216046,1,G,A,2654835,140135,2598362,2991578,56473
12,ENSG00000135424.10,55707904,12-55729581-G-A,rs2231462,-1,G,A,55729581,21677,55511296,55904512,218285
12,ENSG00000170439.5,55681736,12-55729581-G-A,rs2231462,1,G,A,55729581,47845,55485128,55878344,244453
12,ENSG00000135441.3,55716046,12-55729581-G-A,rs2231462,1,G,A,55729581,13535,55519438,55912654,210143
12,ENSG00000135404.6,55729009,12-55729581-G-A,rs2231462,-1,G,A,55729581,572,55532401,55925617,197180
12,ENSG00000110799.9,6124670,12-6078499-G-C,rs2238104,-1,G,C,6078499,46171,5928062,6321278,150437
12,ENSG00000110799.9,6124670,12-6078499-G-T,rs2238104,-1,G,T,6078499,46171,5928062,6321278,150437
12,ENSG00000139192.7,6452042,12-6461373-A-T,rs2244083,1,A,T,6461373,9331,6255434,6648650,205939
12,ENSG00000111254.2,4649051,12-4636147-C-A,rs2267546,-1,C,A,4636147,12904,4452443,4845659,183704
12,ENSG00000111254.2,4649051,12-4636147-C-T,rs2267546,-1,C,T,4636147,12904,4452443,4845659,183704
12,ENSG00000139219.12,48004476,12-47982508-G-C,rs2276454,-1,G,C,47982508,21968,47807868,48201084,174640
12,ENSG00000139219.12,48004476,12-47982508-G-A,rs2276454,-1,G,A,47982508,21968,47807868,48201084,174640
12,ENSG00000176915.10,132761832,12-132922180-A-C,rs2279314,-1,A,C,132922180,160348,132565224,132958440,356956
12,ENSG00000176915.10,132761832,12-132922180-A-G,rs2279314,-1,A,G,132922180,160348,132565224,132958440,356956
12,ENSG00000176915.10,132761832,12-132922180-A-T,rs2279314,-1,A,T,132922180,160348,132565224,132958440,356956
12,ENSG00000258102.1,116559381,12-116716457-C-T,rs2279695,1,C,T,116716457,157076,116362773,116755989,353684
12,ENSG00000258102.1,116559381,12-116716457-C-A,rs2279695,1,C,A,116716457,157076,116362773,116755989,353684
12,ENSG00000121380.7,12070939,12-12071609-C-G,rs2287154,1,C,G,12071609,670,11874331,12267547,197278
12,ENSG00000121380.7,12070939,12-12071609-C-T,rs2287154,1,C,T,12071609,670,11874331,12267547,197278
12,ENSG00000110851.7,107761137,12-107696741-A-G,rs2287214,-1,A,G,107696741,64396,107564529,107957745,132212
12,ENSG00000135679.15,68808177,12-68824258-T-A,rs2291857,1,T,A,68824258,16081,68611569,69004785,212689
12,ENSG00000135679.15,68808177,12-68824258-T-C,rs2291857,1,T,C,68824258,16081,68611569,69004785,212689
12,ENSG00000135679.15,68808177,12-68824258-T-G,rs2291857,1,T,G,68824258,16081,68611569,69004785,212689
12,ENSG00000188596.3,96489577,12-96571437-G-A,rs2368079,1,G,A,96571437,81860,96292969,96686185,278468
12,ENSG00000151239.9,43806317,12-43884686-A-G,rs2407782,-1,A,G,43884686,78369,43609709,44002925,274977
12,ENSG00000151239.9,43806317,12-43884686-A-C,rs2407782,-1,A,C,43884686,78369,43609709,44002925,274977
12,ENSG00000151239.9,43806317,12-43884686-A-T,rs2407782,-1,A,T,43884686,78369,43609709,44002925,274977
12,ENSG00000184752.8,95003697,12-95033935-C-G,rs249171,-1,C,G,95033935,30238,94807089,95200305,226846
12,ENSG00000184752.8,95003697,12-95033935-C-A,rs249171,-1,C,A,95033935,30238,94807089,95200305,226846
12,ENSG00000076248.4,109097597,12-109108309-C-T,rs2515913,1,C,T,109108309,10712,108900989,109294205,207320
12,ENSG00000139190.11,6470677,12-6453587-A-G,rs2532501,-1,A,G,6453587,17090,6274069,6667285,179518
12,ENSG00000204954.5,103957215,12-103954652-A-C,rs2576975,-1,A,C,103954652,2563,103760607,104153823,194045
12,ENSG00000204954.5,103957215,12-103954652-A-G,rs2576975,-1,A,G,103954652,2563,103760607,104153823,194045
12,ENSG00000087494.10,27972733,12-27855858-T-C,rs258402,-1,T,C,27855858,116875,27776125,28169341,79733
12,ENSG00000255374.1,11092313,12-11053618-A-G,rs2597994,-1,A,G,11053618,38695,10895705,11288921,157913
12,ENSG00000111325.12,122975220,12-122817633-G-C,rs2656815,1,G,C,122817633,157587,122778612,123171828,39021
12,ENSG00000111325.12,122975220,12-122817633-G-A,rs2656815,1,G,A,122817633,157587,122778612,123171828,39021
12,ENSG00000139223.1,48472559,12-48530644-G-T,rs2705141,1,G,T,48530644,58085,48275951,48669167,254693
12,ENSG00000139223.1,48472559,12-48530644-G-C,rs2705141,1,G,C,48530644,58085,48275951,48669167,254693
12,ENSG00000139223.1,48472559,12-48530644-G-A,rs2705141,1,G,A,48530644,58085,48275951,48669167,254693
12,ENSG00000150977.9,123436684,12-123427242-A-G,rs28466887,-1,A,G,123427242,9442,123240076,123633292,187166
12,ENSG00000150977.9,123436684,12-123427242-A-C,rs28466887,-1,A,C,123427242,9442,123240076,123633292,187166
12,ENSG00000150977.9,123436684,12-123427242-A-T,rs28466887,-1,A,T,123427242,9442,123240076,123633292,187166
12,ENSG00000196531.6,56725299,12-56720316-A-T,rs2926743,-1,A,T,56720316,4983,56528691,56921907,191625
12,ENSG00000196531.6,56725299,12-56720316-A-C,rs2926743,-1,A,C,56720316,4983,56528691,56921907,191625
12,ENSG00000196531.6,56725299,12-56720316-A-G,rs2926743,-1,A,G,56720316,4983,56528691,56921907,191625
12,ENSG00000175970.6,120710458,12-120725051-T-A,rs2948149,1,T,A,120725051,14593,120513850,120907066,211201
12,ENSG00000175970.6,120710458,12-120725051-T-G,rs2948149,1,T,G,120725051,14593,120513850,120907066,211201
12,ENSG00000161800.8,50025494,12-49896945-A-G,rs297935,-1,A,G,49896945,128549,49828886,50222102,68059
12,ENSG00000161800.8,50025494,12-49896945-A-T,rs297935,-1,A,T,49896945,128549,49828886,50222102,68059
12,ENSG00000161800.8,50025494,12-49896945-A-C,rs297935,-1,A,C,49896945,128549,49828886,50222102,68059
12,ENSG00000118971.3,4273762,12-4279366-A-G,rs3217812,1,A,G,4279366,5604,4077154,4470370,202212
12,ENSG00000178878.7,12785659,12-12726123-G-A,rs34323,1,G,A,12726123,59536,12589051,12982267,137072
12,ENSG00000174989.7,116910950,12-117027459-C-T,rs3741466,1,C,T,117027459,116509,116714342,117107558,313117
12,ENSG00000089060.6,113335109,12-113208231-G-A,rs3741991,-1,G,A,113208231,126878,113138501,113531717,69730
12,ENSG00000139372.10,103965872,12-103979822-G-T,rs3751209,1,G,T,103979822,13950,103769264,104162480,210558
12,ENSG00000139372.10,103965872,12-103979822-G-C,rs3751209,1,G,C,103979822,13950,103769264,104162480,210558
12,ENSG00000139372.10,103965872,12-103979822-G-A,rs3751209,1,G,A,103979822,13950,103769264,104162480,210558
12,ENSG00000166896.3,57941567,12-57941843-A-C,rs3751325,1,A,C,57941843,276,57744959,58138175,196884
12,ENSG00000166896.3,57941567,12-57941843-A-G,rs3751325,1,A,G,57941843,276,57744959,58138175,196884
12,ENSG00000166896.3,57941567,12-57941843-A-T,rs3751325,1,A,T,57941843,276,57744959,58138175,196884
12,ENSG00000174456.7,110048522,12-110011934-A-G,rs3759385,-1,A,G,110011934,36588,109851914,110245130,160020
12,ENSG00000134287.4,48957487,12-48965097-G-A,rs3782353,-1,G,A,48965097,7610,48760879,49154095,204218
12,ENSG00000166130.10,98644788,12-98677245-T-G,rs3815997,-1,T,G,98677245,32457,98448180,98841396,229065
12,ENSG00000166130.10,98644788,12-98677245-T-C,rs3815997,-1,T,C,98677245,32457,98448180,98841396,229065
12,ENSG00000134548.5,21526296,12-21569080-C-T,rs3816655,1,C,T,21569080,42784,21329688,21722904,239392
12,ENSG00000170515.7,56104559,12-56286961-C-T,rs3816804,1,C,T,56286961,182402,55907951,56301167,379010
12,ENSG00000139370.6,128823958,12-128794719-G-C,rs3825181,-1,G,C,128794719,29239,128627350,129020566,167369
12,ENSG00000139370.6,128823958,12-128794719-G-A,rs3825181,-1,G,A,128794719,29239,128627350,129020566,167369
12,ENSG00000139370.6,128823958,12-128794719-G-T,rs3825181,-1,G,T,128794719,29239,128627350,129020566,167369
12,ENSG00000257218.1,120446444,12-120538568-T-C,rs4102203,1,T,C,120538568,92124,120249836,120643052,288732
12,ENSG00000151065.9,2004457,12-1988550-T-G,rs4141130,-1,T,G,1988550,15907,1807849,2201065,180701
12,ENSG00000151065.9,2004457,12-1988550-T-C,rs4141130,-1,T,C,1988550,15907,1807849,2201065,180701
12,ENSG00000151065.9,2004457,12-1988550-T-A,rs4141130,-1,T,A,1988550,15907,1807849,2201065,180701
12,ENSG00000183395.4,102197833,12-102005576-T-C,rs4272832,-1,T,C,102005576,192257,102001225,102394441,4351
12,ENSG00000111321.5,6384162,12-6391677-G-T,rs4301834,1,G,T,6391677,7515,6187554,6580770,204123
12,ENSG00000111321.5,6384162,12-6391677-G-C,rs4301834,1,G,C,6391677,7515,6187554,6580770,204123
12,ENSG00000111321.5,6384162,12-6391677-G-A,rs4301834,1,G,A,6391677,7515,6187554,6580770,204123
12,ENSG00000167566.11,49828413,12-49773119-G-A,rs4473012,-1,G,A,49773119,55294,49631805,50025021,141314
12,ENSG00000033030.9,122500932,12-122504688-A-G,rs4758660,-1,A,G,122504688,3756,122304324,122697540,200364
12,ENSG00000033030.9,122500932,12-122504688-A-C,rs4758660,-1,A,C,122504688,3756,122304324,122697540,200364
12,ENSG00000076067.6,56521820,12-56525050-T-C,rs4759247,1,T,C,56525050,3230,56325212,56718428,199838
12,ENSG00000076067.6,56521820,12-56525050-T-A,rs4759247,1,T,A,56525050,3230,56325212,56718428,199838
12,ENSG00000076067.6,56521820,12-56525050-T-G,rs4759247,1,T,G,56525050,3230,56325212,56718428,199838
12,ENSG00000172789.2,54033050,12-54085283-C-A,rs4759330,1,C,A,54085283,52233,53836442,54229658,248841
12,ENSG00000172789.2,54033050,12-54085283-C-G,rs4759330,1,C,G,54085283,52233,53836442,54229658,248841
12,ENSG00000130787.8,122835457,12-122797985-G-T,rs4759393,1,G,T,122797985,37472,122638849,123032065,159136
12,ENSG00000130787.8,122835457,12-122797985-G-A,rs4759393,1,G,A,122797985,37472,122638849,123032065,159136
12,ENSG00000130787.8,122835457,12-122797985-G-C,rs4759393,1,G,C,122797985,37472,122638849,123032065,159136
12,ENSG00000111452.8,130953907,12-131091457-C-T,rs4759542,1,C,T,131091457,137550,130757299,131150515,334158
12,ENSG00000136048.9,101877580,12-101805189-T-A,rs4764820,1,T,A,101805189,72391,101680972,102074188,124217
12,ENSG00000136048.9,101877580,12-101805189-T-G,rs4764820,1,T,G,101805189,72391,101680972,102074188,124217
12,ENSG00000136048.9,101877580,12-101805189-T-C,rs4764820,1,T,C,101805189,72391,101680972,102074188,124217
12,ENSG00000197905.4,2959397,12-2836804-C-T,rs4765999,1,C,T,2836804,122593,2762789,3156005,74015
12,ENSG00000111245.8,110920579,12-110921908-G-C,rs4766517,-1,G,C,110921908,1329,110723971,111117187,197937
12,ENSG00000111245.8,110920579,12-110921908-G-T,rs4766517,-1,G,T,110921908,1329,110723971,111117187,197937
12,ENSG00000174600.9,108339311,12-108319807-A-C,rs4964249,-1,A,C,108319807,19504,108142703,108535919,177104
12,ENSG00000174600.9,108339311,12-108319807-A-T,rs4964249,-1,A,T,108319807,19504,108142703,108535919,177104
12,ENSG00000110880.6,108731518,12-108794139-G-A,rs4964758,-1,G,A,108794139,62621,108534910,108928126,259229
12,ENSG00000151948.7,128853478,12-128856681-G-C,rs513831,1,G,C,128856681,3203,128656870,129050086,199811
12,ENSG00000151948.7,128853478,12-128856681-G-A,rs513831,1,G,A,128856681,3203,128656870,129050086,199811
12,ENSG00000111671.5,6873303,12-6847298-C-T,rs5446,-1,C,T,6847298,26005,6676695,7069911,170603
12,ENSG00000111671.5,6873303,12-6847298-C-A,rs5446,-1,C,A,6847298,26005,6676695,7069911,170603
12,ENSG00000166908.12,57591192,12-57459552-A-G,rs55852335,1,A,G,57459552,131640,57394584,57787800,64968
12,ENSG00000134291.7,47963596,12-47994319-G-A,rs55921916,1,G,A,47994319,30723,47766988,48160204,227331
12,ENSG00000064102.9,26937981,12-26983693-G-A,rs56054487,-1,G,A,26983693,45712,26741373,27134589,242320
12,ENSG00000064102.9,26937981,12-26983693-G-T,rs56054487,-1,G,T,26983693,45712,26741373,27134589,242320
12,ENSG00000089163.4,120302321,12-120325034-A-G,rs5634,1,A,G,120325034,22713,120105713,120498929,219321
12,ENSG00000185163.5,132144319,12-132141098-C-T,rs57037358,-1,C,T,132141098,3221,131947711,132340927,193387
12,ENSG00000175548.4,38316774,12-38369968-C-T,rs57227976,1,C,T,38369968,53194,38120166,38513382,249802
12,ENSG00000111445.9,118016703,12-118025540-T-C,rs5745862,1,T,C,118025540,8837,117820095,118213311,205445
12,ENSG00000123358.14,52051442,12-52142353-T-C,rs58806906,1,T,C,52142353,90911,51854834,52248050,287519
12,ENSG00000127337.2,69359743,12-69358420-A-G,rs589448,1,A,G,69358420,1323,69163135,69556351,195285
12,ENSG00000197653.10,123762301,12-123838534-G-A,rs60509888,1,G,A,123838534,76233,123565693,123958909,272841
12,ENSG00000166578.4,113221094,12-113151957-A-G,rs61738692,-1,A,G,113151957,69137,113024486,113417702,127471
12,ENSG00000212126.3,10986912,12-10936035-T-G,rs61912262,-1,T,G,10936035,50877,10790304,11183520,145731
12,ENSG00000176894.5,132687587,12-132499853-C-A,rs61952071,1,C,A,132499853,187734,132490979,132884195,8874
12,ENSG00000176894.5,132687587,12-132499853-C-T,rs61952071,1,C,T,132499853,187734,132490979,132884195,8874
12,ENSG00000135124.9,121210129,12-121111820-C-T,rs651221,1,C,T,121111820,98309,121013521,121406737,98299
12,ENSG00000134283.12,42326167,12-42292387-A-T,rs6582394,1,A,T,42292387,33780,42129559,42522775,162828
12,ENSG00000134283.12,42326167,12-42292387-A-G,rs6582394,1,A,G,42292387,33780,42129559,42522775,162828
12,ENSG00000182379.9,57216794,12-57033189-A-C,rs697223,1,A,C,57033189,183605,57020186,57413402,13003
12,ENSG00000182379.9,57216794,12-57033189-A-T,rs697223,1,A,T,57033189,183605,57020186,57413402,13003
12,ENSG00000182379.9,57216794,12-57033189-A-G,rs697223,1,A,G,57033189,183605,57020186,57413402,13003
12,ENSG00000047621.7,4538469,12-4387114-G-A,rs7131744,-1,G,A,4387114,151355,4341861,4735077,45253
12,ENSG00000171792.5,2877223,12-2883891-C-T,rs7134422,1,C,T,2883891,6668,2680615,3073831,203276
12,ENSG00000110876.8,108633894,12-108640091-G-T,rs7136041,-1,G,T,108640091,6197,108437286,108830502,202805
12,ENSG00000110876.8,108633894,12-108640091-G-A,rs7136041,-1,G,A,108640091,6197,108437286,108830502,202805
12,ENSG00000110876.8,108633894,12-108640091-G-C,rs7136041,-1,G,C,108640091,6197,108437286,108830502,202805
12,ENSG00000175727.7,122078756,12-122055478-A-T,rs7137049,1,A,T,122055478,23278,121882148,122275364,173330
12,ENSG00000175727.7,122078756,12-122055478-A-C,rs7137049,1,A,C,122055478,23278,121882148,122275364,173330
12,ENSG00000111554.10,68332362,12-68283125-A-C,rs7138823,-1,A,C,68283125,49237,68135754,68528970,147371
12,ENSG00000111554.10,68332362,12-68283125-A-T,rs7138823,-1,A,T,68283125,49237,68135754,68528970,147371
12,ENSG00000111554.10,68332362,12-68283125-A-G,rs7138823,-1,A,G,68283125,49237,68135754,68528970,147371
12,ENSG00000178449.2,50112236,12-50145636-T-G,rs7138945,1,T,G,50145636,33400,49915628,50308844,230008
12,ENSG00000178449.2,50112236,12-50145636-T-C,rs7138945,1,T,C,50145636,33400,49915628,50308844,230008
12,ENSG00000136051.9,105107731,12-105060477-C-A,rs7299166,1,C,A,105060477,47254,104911123,105304339,149354
12,ENSG00000102189.11,92929295,12-93031018-G-A,rs7300208,-1,G,A,93031018,101723,92732687,93125903,298331
12,ENSG00000110934.5,51324174,12-51248759-A-G,rs7305016,-1,A,G,51248759,75415,51127566,51520782,121193
12,ENSG00000179195.9,123973215,12-124157819-C-G,rs7306792,1,C,G,124157819,184604,123776607,124169823,381212
12,ENSG00000179195.9,123973215,12-124157819-C-T,rs7306792,1,C,T,124157819,184604,123776607,124169823,381212
12,ENSG00000002016.11,949694,12-941088-G-T,rs7311151,-1,G,T,941088,8606,753086,1146302,188002
12,ENSG00000002016.11,949694,12-941088-G-C,rs7311151,-1,G,C,941088,8606,753086,1146302,188002
12,ENSG00000002016.11,949694,12-941088-G-A,rs7311151,-1,G,A,941088,8606,753086,1146302,188002
12,ENSG00000197837.3,14771131,12-14681274-G-A,rs7311859,-1,G,A,14681274,89857,14574523,14967739,106751
12,ENSG00000111644.3,6647432,12-6719809-A-G,rs7312263,-1,A,G,6719809,72377,6450824,6844040,268985
12,ENSG00000139193.3,6444955,12-6440585-T-C,rs7312492,1,T,C,6440585,4370,6248347,6641563,192238
12,ENSG00000139193.3,6444955,12-6440585-T-G,rs7312492,1,T,G,6440585,4370,6248347,6641563,192238
12,ENSG00000139193.3,6444955,12-6440585-T-A,rs7312492,1,T,A,6440585,4370,6248347,6641563,192238
12,ENSG00000173451.2,71664301,12-71836723-G-C,rs73140665,1,G,C,71836723,172422,71467693,71860909,369030
12,ENSG00000173451.2,71664301,12-71836723-G-A,rs73140665,1,G,A,71836723,172422,71467693,71860909,369030
12,ENSG00000139438.5,109713825,12-109641162-C-T,rs73200449,1,C,T,109641162,72663,109517217,109910433,123945
12,ENSG00000110906.8,109477300,12-109673762-A-G,rs73202426,-1,A,G,109673762,196462,109280692,109673908,393070
12,ENSG00000167272.6,120581402,12-120601262-T-G,rs73405639,-1,T,G,120601262,19860,120384794,120778010,216468
12,ENSG00000167272.6,120581402,12-120601262-T-A,rs73405639,-1,T,A,120601262,19860,120384794,120778010,216468
12,ENSG00000079337.10,47758880,12-47748368-G-A,rs734706,-1,G,A,47748368,10512,47562272,47955488,186096
12,ENSG00000079337.10,47758880,12-47748368-G-C,rs734706,-1,G,C,47748368,10512,47562272,47955488,186096
12,ENSG00000004700.11,21501635,12-21640900-T-C,rs74459792,-1,T,C,21640900,139265,21305027,21698243,335873
12,ENSG00000110881.6,50057596,12-50175479-A-G,rs74493606,1,A,G,50175479,117883,49860988,50254204,314491
12,ENSG00000169372.7,93677375,12-93854521-A-T,rs74679374,1,A,T,93854521,177146,93480767,93873983,373754
12,ENSG00000169372.7,93677375,12-93854521-A-G,rs74679374,1,A,G,93854521,177146,93480767,93873983,373754
12,ENSG00000184271.11,51218062,12-51207618-T-C,rs74820207,-1,T,C,51207618,10444,51021454,51414670,186164
12,ENSG00000139344.3,95943331,12-95944219-A-G,rs7486703,1,A,G,95944219,888,95746723,96139939,197496
12,ENSG00000139344.3,95943331,12-95944219-A-C,rs7486703,1,A,C,95944219,888,95746723,96139939,197496
12,ENSG00000139344.3,95943331,12-95944219-A-T,rs7486703,1,A,T,95944219,888,95746723,96139939,197496
12,ENSG00000111424.6,47904994,12-47768697-A-T,rs7488942,-1,A,T,47768697,136297,47708386,48101602,60311
12,ENSG00000111424.6,47904994,12-47768697-A-G,rs7488942,-1,A,G,47768697,136297,47708386,48101602,60311
12,ENSG00000110888.12,30754514,12-30629601-T-C,rs75560605,-1,T,C,30629601,124913,30557906,30951122,71695
12,ENSG00000174236.2,27696447,12-27699051-C-T,rs76851022,1,C,T,27699051,2604,27499839,27893055,199212
12,ENSG00000174236.2,27696447,12-27699051-C-G,rs76851022,1,C,G,27699051,2604,27499839,27893055,199212
12,ENSG00000257594.1,89524796,12-89570834-G-A,rs76967749,-1,G,A,89570834,46038,89328188,89721404,242646
12,ENSG00000111602.7,56449426,12-56428594-T-A,rs774027,-1,T,A,56428594,20832,56252818,56646034,175776
12,ENSG00000111602.7,56449426,12-56428594-T-C,rs774027,-1,T,C,56428594,20832,56252818,56646034,175776
12,ENSG00000111602.7,56449426,12-56428594-T-G,rs774027,-1,T,G,56428594,20832,56252818,56646034,175776
12,ENSG00000166987.9,57522824,12-57584957-C-T,rs775251,1,C,T,57584957,62133,57326216,57719432,258741
12,ENSG00000127325.13,69699303,12-69648659-A-T,rs776175,-1,A,T,69648659,50644,69502695,69895911,145964
12,ENSG00000170545.11,51270415,12-51174165-A-G,rs77629257,-1,A,G,51174165,96250,51073807,51467023,100358
12,ENSG00000111653.15,6663119,12-6472368-C-G,rs78299246,-1,C,G,6472368,190751,6466511,6859727,5857
12,ENSG00000135643.4,70366290,12-70336421-G-A,rs7953935,1,G,A,70336421,29869,70169682,70562898,166739
12,ENSG00000134532.10,23949670,12-23788764-A-G,rs7956324,-1,A,G,23788764,160906,23753062,24146278,35702
12,ENSG00000111728.5,22334707,12-22454680-T-G,rs7957294,-1,T,G,22454680,119973,22138099,22531315,316581
12,ENSG00000064115.6,27014384,12-26977232-C-A,rs7958443,-1,C,A,26977232,37152,26817776,27210992,159456
12,ENSG00000168778.7,123671113,12-123678203-G-A,rs7958693,1,G,A,123678203,7090,123474505,123867721,203698
12,ENSG00000183735.5,64452120,12-64511253-T-C,rs7959278,1,T,C,64511253,59133,64255512,64648728,255741
12,ENSG00000182993.3,14803670,12-14802768-T-A,rs7959540,1,T,A,14802768,902,14607062,15000278,195706
12,ENSG00000182993.3,14803670,12-14802768-T-C,rs7959540,1,T,C,14802768,902,14607062,15000278,195706
12,ENSG00000177875.3,48183644,12-48183230-C-T,rs7962569,1,C,T,48183230,414,47987036,48380252,196194
12,ENSG00000010379.10,262836,12-407055-C-T,rs7968644,-1,C,T,407055,144219,66228,459444,340827
12,ENSG00000255837.1,10998304,12-10921169-C-A,rs7968647,-1,C,A,10921169,77135,10801696,11194912,119473
12,ENSG00000255837.1,10998304,12-10921169-C-G,rs7968647,-1,C,G,10921169,77135,10801696,11194912,119473
12,ENSG00000255837.1,10998304,12-10921169-C-T,rs7968647,-1,C,T,10921169,77135,10801696,11194912,119473
12,ENSG00000082805.12,991223,12-1016309-A-T,rs7974686,1,A,T,1016309,25086,794615,1187831,221694
12,ENSG00000082805.12,991223,12-1016309-A-G,rs7974686,1,A,G,1016309,25086,794615,1187831,221694
12,ENSG00000198015.7,93467514,12-93505751-C-T,rs7976441,1,C,T,93505751,38237,93270906,93664122,234845
12,ENSG00000198015.7,93467514,12-93505751-C-G,rs7976441,1,C,G,93505751,38237,93270906,93664122,234845
12,ENSG00000118308.10,25052706,12-25091449-A-G,rs7977670,1,A,G,25091449,38743,24856098,25249314,235351
12,ENSG00000123384.9,57128483,12-57207605-C-G,rs7977876,1,C,G,57207605,79122,56931875,57325091,275730
12,ENSG00000123384.9,57128483,12-57207605-C-T,rs7977876,1,C,T,57207605,79122,56931875,57325091,275730
12,ENSG00000123384.9,57128483,12-57207605-C-A,rs7977876,1,C,A,57207605,79122,56931875,57325091,275730
12,ENSG00000111639.3,6493262,12-6496039-T-C,rs7978461,-1,T,C,6496039,2777,6296654,6689870,199385
12,ENSG00000013583.4,13000265,12-13049874-A-G,rs7978762,-1,A,G,13049874,49609,12803657,13196873,246217
12,ENSG00000013503.4,106357748,12-106294710-T-C,rs7980757,1,T,C,106294710,63038,106161140,106554356,133570
12,ENSG00000187778.9,49568142,12-49535007-A-G,rs80011486,-1,A,G,49535007,33135,49371534,49764750,163473
12,ENSG00000151491.7,15789388,12-15871738-T-C,rs80071063,-1,T,C,15871738,82350,15592780,15985996,278958
12,ENSG00000198040.6,133037509,12-133107735-G-T,rs905224,1,G,T,133107735,70226,132840901,133234117,266834
12,ENSG00000174243.4,48852163,12-48755642-C-A,rs953672,-1,C,A,48755642,96521,48655555,49048771,100087
12,ENSG00000174243.4,48852163,12-48755642-C-T,rs953672,-1,C,T,48755642,96521,48655555,49048771,100087
12,ENSG00000167778.4,53079390,12-53098715-T-C,rs9658605,-1,T,C,53098715,19325,52882782,53275998,215933
12,ENSG00000151079.6,4809176,12-4828426-G-T,rs972883,1,G,T,4828426,19250,4612568,5005784,215858
12,ENSG00000151079.6,4809176,12-4828426-G-A,rs972883,1,G,A,4828426,19250,4612568,5005784,215858
12,ENSG00000151079.6,4809176,12-4828426-G-C,rs972883,1,G,C,4828426,19250,4612568,5005784,215858
12,ENSG00000127311.5,66302493,12-66297169-C-T,rs974349,1,C,T,66297169,5324,66105885,66499101,191284
12,ENSG00000139133.2,34022496,12-34218201-A-G,rs10083007,1,A,G,34218201,195705,33825888,34219104,392313
12,ENSG00000136044.7,105236174,12-105309263-G-A,rs10083061,-1,G,A,105309263,73089,105039566,105432782,269697
12,ENSG00000139044.6,459939,12-544818-T-G,rs1008587,1,T,G,544818,84879,263331,656547,281487
12,ENSG00000139044.6,459939,12-544818-T-C,rs1008587,1,T,C,544818,84879,263331,656547,281487
12,ENSG00000182993.3,14803670,12-14798407-A-G,rs1012682,1,A,G,14798407,5263,14607062,15000278,191345
12,ENSG00000196387.4,133080923,12-132924025-G-T,rs10357,1,G,T,132924025,156898,132884315,133277531,39710
12,ENSG00000184574.4,6635959,12-6638129-G-A,rs1045553,-1,G,A,6638129,2170,6439351,6832567,198778
12,ENSG00000111361.7,123633686,12-123621401-C-T,rs1050443,-1,C,T,123621401,12285,123437078,123830294,184323
12,ENSG00000178449.2,50112236,12-50021918-C-T,rs10506290,1,C,T,50021918,90318,49915628,50308844,106290
12,ENSG00000181418.7,48999375,12-48836252-T-G,rs1057908,-1,T,G,48836252,163123,48802767,49195983,33485
12,ENSG00000181418.7,48999375,12-48836252-T-C,rs1057908,-1,T,C,48836252,163123,48802767,49195983,33485
12,ENSG00000181418.7,48999375,12-48836252-T-A,rs1057908,-1,T,A,48836252,163123,48802767,49195983,33485
12,ENSG00000110958.10,56688284,12-56597278-T-C,rs1064244,-1,T,C,56597278,91006,56491676,56884892,105602
12,ENSG00000180481.6,75391089,12-75467307-G-A,rs10732759,1,G,A,75467307,76218,75194481,75587697,272826
12,ENSG00000180481.6,75391089,12-75467307-G-C,rs10732759,1,G,C,75467307,76218,75194481,75587697,272826
12,ENSG00000111331.7,112938474,12-112942203-G-C,rs10735079,1,G,C,112942203,3729,112741866,113135082,200337
12,ENSG00000111331.7,112938474,12-112942203-G-A,rs10735079,1,G,A,112942203,3729,112741866,113135082,200337
12,ENSG00000087494.10,27972733,12-27814346-C-A,rs10743609,-1,C,A,27814346,158387,27776125,28169341,38221
12,ENSG00000087494.10,27972733,12-27814346-C-T,rs10743609,-1,C,T,27814346,158387,27776125,28169341,38221
12,ENSG00000133704.4,30695869,12-30651739-T-G,rs10743727,-1,T,G,30651739,44130,30499261,30892477,152478
12,ENSG00000133704.4,30695869,12-30651739-T-A,rs10743727,-1,T,A,30651739,44130,30499261,30892477,152478
12,ENSG00000139324.7,88142307,12-87953423-G-C,rs10745469,1,G,C,87953423,188884,87945699,88338915,7724
12,ENSG00000139324.7,88142307,12-87953423-G-A,rs10745469,1,G,A,87953423,188884,87945699,88338915,7724
12,ENSG00000139324.7,88142307,12-87953423-G-T,rs10745469,1,G,T,87953423,188884,87945699,88338915,7724
12,ENSG00000111262.4,4909905,12-5049401-G-C,rs10774297,1,G,C,5049401,139496,4713297,5106513,336104
12,ENSG00000135114.7,121039242,12-121038620-A-G,rs10774580,-1,A,G,121038620,622,120842634,121235850,195986
12,ENSG00000135114.7,121039242,12-121038620-A-T,rs10774580,-1,A,T,121038620,622,120842634,121235850,195986
12,ENSG00000166598.7,103930410,12-103893299-G-A,rs10778301,1,G,A,103893299,37111,103733802,104127018,159497
12,ENSG00000166896.3,57941567,12-57964158-C-T,rs10783861,1,C,T,57964158,22591,57744959,58138175,219199
12,ENSG00000111196.5,10613609,12-10622596-T-C,rs1078437,-1,T,C,10622596,8987,10417001,10810217,205595
12,ENSG00000118308.10,25052706,12-25074481-C-T,rs10842459,1,C,T,25074481,21775,24856098,25249314,218383
12,ENSG00000118308.10,25052706,12-25074481-C-G,rs10842459,1,C,G,25074481,21775,24856098,25249314,218383
12,ENSG00000010295.13,6556042,12-6611629-A-G,rs10849492,-1,A,G,6611629,55587,6359434,6752650,252195
12,ENSG00000089041.11,121132876,12-121120620-T-C,rs10849846,1,T,C,121120620,12256,120936268,121329484,184352
12,ENSG00000135124.9,121210129,12-121230451-T-C,rs10849860,1,T,C,121230451,20322,121013521,121406737,216930
12,ENSG00000179295.10,112418947,12-112312032-A-C,rs10850027,1,A,C,112312032,106915,112222339,112615555,89693
12,ENSG00000122965.6,113966325,12-113906258-A-G,rs10850237,-1,A,G,113906258,60067,113769717,114162933,136541
12,ENSG00000088992.13,117099416,12-117111934-A-C,rs10850762,-1,A,C,117111934,12518,116902808,117296024,209126
12,ENSG00000139344.3,95943331,12-95981904-T-C,rs10859995,1,T,C,95981904,38573,95746723,96139939,235181
12,ENSG00000139344.3,95943331,12-95981904-T-A,rs10859995,1,T,A,95981904,38573,95746723,96139939,235181
12,ENSG00000139344.3,95943331,12-95981904-T-G,rs10859995,1,T,G,95981904,38573,95746723,96139939,235181
12,ENSG00000059758.3,96400439,12-96353932-T-C,rs10860021,-1,T,C,96353932,46507,96203831,96597047,150101
12,ENSG00000120860.6,102061991,12-102203924-C-G,rs10860845,-1,C,G,102203924,141933,101865383,102258599,338541
12,ENSG00000120860.6,102061991,12-102203924-C-A,rs10860845,-1,C,A,102203924,141933,101865383,102258599,338541
12,ENSG00000255150.1,104303739,12-104283168-A-C,rs10861185,1,A,C,104283168,20571,104107131,104500347,176037
12,ENSG00000255150.1,104303739,12-104283168-A-G,rs10861185,1,A,G,104283168,20571,104107131,104500347,176037
12,ENSG00000136052.5,104958290,12-104865466-C-A,rs10861282,-1,C,A,104865466,92824,104761682,105154898,103784
12,ENSG00000151135.5,106955907,12-106929137-T-C,rs10861679,1,T,C,106929137,26770,106759299,107152515,169838
12,ENSG00000139219.12,48004476,12-47845347-C-T,rs10875692,-1,C,T,47845347,159129,47807868,48201084,37479
12,ENSG00000139219.12,48004476,12-47845347-C-G,rs10875692,-1,C,G,47845347,159129,47807868,48201084,37479
12,ENSG00000139223.1,48472559,12-48597854-T-C,rs10875841,1,T,C,48597854,125295,48275951,48669167,321903
12,ENSG00000139223.1,48472559,12-48597854-T-A,rs10875841,1,T,A,48597854,125295,48275951,48669167,321903
12,ENSG00000066084.7,50504985,12-50512622-C-T,rs10876044,1,C,T,50512622,7637,50308377,50701593,204245
12,ENSG00000196531.6,56725299,12-56782391-C-G,rs10876920,-1,C,G,56782391,57092,56528691,56921907,253700
12,ENSG00000196531.6,56725299,12-56782391-C-T,rs10876920,-1,C,T,56782391,57092,56528691,56921907,253700
12,ENSG00000123297.11,57782787,12-57668884-C-T,rs10876993,1,C,T,57668884,113903,57586179,57979395,82705
12,ENSG00000123297.11,57782787,12-57668884-C-G,rs10876993,1,C,G,57668884,113903,57586179,57979395,82705
12,ENSG00000135506.11,57694132,12-57709809-A-G,rs10877008,1,A,G,57709809,15677,57497524,57890740,212285
12,ENSG00000111711.4,21501789,12-21508574-A-G,rs11046091,1,A,G,21508574,6785,21305181,21698397,203393
12,ENSG00000123095.4,26125037,12-26272088-T-C,rs11048444,-1,T,C,26272088,147051,25928429,26321645,343659
12,ENSG00000172243.13,10130199,12-10076682-T-G,rs11053572,-1,T,G,10076682,53517,9933591,10326807,143091
12,ENSG00000172243.13,10130199,12-10076682-T-C,rs11053572,-1,T,C,10076682,53517,9933591,10326807,143091
12,ENSG00000013583.4,13000265,12-13019390-A-G,rs11055200,-1,A,G,13019390,19125,12803657,13196873,215733
12,ENSG00000150990.3,124989131,12-124927529-T-A,rs11057913,-1,T,A,124927529,61602,124792523,125185739,135006
12,ENSG00000150990.3,124989131,12-124927529-T-C,rs11057913,-1,T,C,124927529,61602,124792523,125185739,135006
12,ENSG00000139722.2,122896124,12-122912014-A-G,rs11060703,-1,A,G,122912014,15890,122699516,123092732,212498
12,ENSG00000130787.8,122835457,12-122912014-A-G,rs11060703,1,A,G,122912014,76557,122638849,123032065,273165
12,ENSG00000151062.8,1918652,12-2066446-G-A,rs11062100,-1,G,A,2066446,147794,1722044,2115260,344402
12,ENSG00000111328.2,123271856,12-123142469-T-C,rs1106241,-1,T,C,123142469,129387,123075248,123468464,67221
12,ENSG00000111328.2,123271856,12-123142469-T-A,rs1106241,-1,T,A,123142469,129387,123075248,123468464,67221
12,ENSG00000110799.9,6124670,12-6236926-A-G,rs11064099,-1,A,G,6236926,112256,5928062,6321278,308864
12,ENSG00000111640.8,6534517,12-6471210-A-G,rs11064213,1,A,G,6471210,63307,6337909,6731125,133301
12,ENSG00000167272.6,120581402,12-120403829-A-G,rs11065102,-1,A,G,120403829,177573,120384794,120778010,19035
12,ENSG00000122971.4,120725826,12-120674626-T-C,rs11065202,1,T,C,120674626,51200,120529218,120922434,145408
12,ENSG00000089053.7,121352411,12-121382889-G-C,rs11065546,-1,G,C,121382889,30478,121155803,121549019,227086
12,ENSG00000089053.7,121352411,12-121382889-G-A,rs11065546,-1,G,A,121382889,30478,121155803,121549019,227086
12,ENSG00000111231.3,110468257,12-110338184-A-G,rs11065630,-1,A,G,110338184,130073,110271649,110664865,66535
12,ENSG00000111245.8,110920579,12-110913635-T-A,rs11065769,-1,T,A,110913635,6944,110723971,111117187,189664
12,ENSG00000111245.8,110920579,12-110913635-T-G,rs11065769,-1,T,G,110913635,6944,110723971,111117187,189664
12,ENSG00000179941.5,76348415,12-76286580-G-A,rs11106529,-1,G,A,76286580,61835,76151807,76545023,134773
12,ENSG00000057704.6,94650557,12-94787404-G-A,rs11107713,-1,G,A,94787404,136847,94453949,94847165,333455
12,ENSG00000028203.12,95217807,12-95323721-T-C,rs11107979,1,T,C,95323721,105914,95021199,95414415,302522
12,ENSG00000111145.3,96194375,12-96257301-T-C,rs11108447,1,T,C,96257301,62926,95997767,96390983,259534
12,ENSG00000136048.9,101877580,12-101933531-T-A,rs11111093,1,T,A,101933531,55951,101680972,102074188,252559
12,ENSG00000136048.9,101877580,12-101933531-T-C,rs11111093,1,T,C,101933531,55951,101680972,102074188,252559
12,ENSG00000111696.7,103841234,12-103924568-C-T,rs11111846,-1,C,T,103924568,83334,103644626,104037842,279942
12,ENSG00000111727.7,104064531,12-104061412-A-G,rs11111881,1,A,G,104061412,3119,103867923,104261139,193489
12,ENSG00000235162.4,105330691,12-105473229-G-A,rs11112542,1,G,A,105473229,142538,105134083,105527299,339146
12,ENSG00000136026.9,106248020,12-106241790-G-A,rs11112913,-1,G,A,106241790,6230,106051412,106444628,190378
12,ENSG00000110851.7,107761137,12-107662819-G-A,rs11113426,-1,G,A,107662819,98318,107564529,107957745,98290
12,ENSG00000072609.10,132887605,12-132921288-A-G,rs11147164,-1,A,G,132921288,33683,132690997,133084213,230291
12,ENSG00000167548.10,49060794,12-49161631-G-A,rs11168898,-1,G,A,49161631,100837,48864186,49257402,297445
12,ENSG00000167548.10,49060794,12-49161631-G-C,rs11168898,-1,G,C,49161631,100837,48864186,49257402,297445
12,ENSG00000139644.7,49741557,12-49813343-T-G,rs11169162,1,T,G,49813343,71786,49544949,49938165,268394
12,ENSG00000139644.7,49741557,12-49813343-T-C,rs11169162,1,T,C,49813343,71786,49544949,49938165,268394
12,ENSG00000123353.5,55818041,12-55799449-A-C,rs11171681,1,A,C,55799449,18592,55621433,56014649,178016
12,ENSG00000185633.6,57237104,12-57342432-C-T,rs11172171,-1,C,T,57342432,105328,57040496,57433712,301936
12,ENSG00000173208.3,39619803,12-39808761-C-T,rs11173669,-1,C,T,39808761,188958,39423195,39816411,385566
12,ENSG00000111530.6,67269358,12-67436492-A-C,rs11176735,1,A,C,67436492,167134,67072750,67465966,363742
12,ENSG00000127325.13,69699303,12-69688978-G-A,rs11177794,-1,G,A,69688978,10325,69502695,69895911,186283
12,ENSG00000180881.14,75326498,12-75479381-G-A,rs11180540,-1,G,A,75479381,152883,75129890,75523106,349491
12,ENSG00000180881.14,75326498,12-75479381-G-C,rs11180540,-1,G,C,75479381,152883,75129890,75523106,349491
12,ENSG00000111666.5,101697640,12-101699976-G-A,rs1124605,1,G,A,101699976,2336,101501032,101894248,198944
12,ENSG00000111666.5,101697640,12-101699976-G-T,rs1124605,1,G,T,101699976,2336,101501032,101894248,198944
12,ENSG00000111666.5,101697640,12-101699976-G-C,rs1124605,1,G,C,101699976,2336,101501032,101894248,198944
12,ENSG00000135503.7,51951699,12-51963575-T-A,rs113063332,1,T,A,51963575,11876,51755091,52148307,208484
12,ENSG00000135503.7,51951699,12-51963575-T-G,rs113063332,1,T,G,51963575,11876,51755091,52148307,208484
12,ENSG00000183955.8,123384132,12-123484470-C-T,rs11497311,1,C,T,123484470,100338,123187524,123580740,296946
12,ENSG00000111481.5,54325131,12-54174806-A-G,rs11611943,1,A,G,54174806,150325,54128523,54521739,46283
12,ENSG00000166578.4,113221094,12-113047794-G-A,rs11614358,-1,G,A,113047794,173300,113024486,113417702,23308
12,ENSG00000161835.6,52006946,12-52009252-C-T,rs11614892,1,C,T,52009252,2306,51810338,52203554,198914
12,ENSG00000120820.8,104050187,12-104063767-G-A,rs116207492,-1,G,A,104063767,13580,103853579,104246795,210188
12,ENSG00000196876.6,51591233,12-51597438-T-C,rs117421828,1,T,C,51597438,6205,51394625,51787841,202813
12,ENSG00000176422.9,56468578,12-56487830-G-A,rs117867773,1,G,A,56487830,19252,56271970,56665186,215860
12,ENSG00000063046.12,53006456,12-52986052-A-G,rs118154970,1,A,G,52986052,20404,52809848,53203064,176204
12,ENSG00000110906.8,109477300,12-109642825-G-T,rs11832371,-1,G,T,109642825,165525,109280692,109673908,362133
12,ENSG00000110906.8,109477300,12-109642825-G-A,rs11832371,-1,G,A,109642825,165525,109280692,109673908,362133
12,ENSG00000060140.4,10674052,12-10657719-A-G,rs11837154,-1,A,G,10657719,16333,10477444,10870660,180275
12,ENSG00000136051.9,105107731,12-105212394-G-A,rs1196761,1,G,A,105212394,104663,104911123,105304339,301271
12,ENSG00000089693.6,6753141,12-6757986-G-T,rs12229492,-1,G,T,6757986,4845,6556533,6949749,201453
12,ENSG00000089693.6,6753141,12-6757986-G-A,rs12229492,-1,G,A,6757986,4845,6556533,6949749,201453
12,ENSG00000188906.9,40224997,12-40228988-C-T,rs12230685,1,C,T,40228988,3991,40028389,40421605,200599
12,ENSG00000174989.7,116910950,12-117004499-G-A,rs12299065,1,G,A,117004499,93549,116714342,117107558,290157
12,ENSG00000111424.6,47904994,12-47858356-G-A,rs12308082,-1,G,A,47858356,46638,47708386,48101602,149970
12,ENSG00000139428.5,109573504,12-109645420-G-T,rs12309873,-1,G,T,109645420,71916,109376896,109770112,268524
12,ENSG00000139428.5,109573504,12-109645420-G-A,rs12309873,-1,G,A,109645420,71916,109376896,109770112,268524
12,ENSG00000135127.6,119989236,12-120169835-G-A,rs12311126,1,G,A,120169835,180599,119792628,120185844,377207
12,ENSG00000177990.7,63668493,12-63560520-C-T,rs12314553,-1,C,T,63560520,107973,63471885,63865101,88635
12,ENSG00000139350.7,96907257,12-96894316-T-G,rs12319243,1,T,G,96894316,12941,96710649,97103865,183667
12,ENSG00000139350.7,96907257,12-96894316-T-C,rs12319243,1,T,C,96894316,12941,96710649,97103865,183667
12,ENSG00000166130.10,98644788,12-98583137-G-T,rs12367211,-1,G,T,98583137,61651,98448180,98841396,134957
12,ENSG00000134285.6,48925492,12-48925017-G-C,rs12424638,-1,G,C,48925017,475,48728884,49122100,196133
12,ENSG00000134285.6,48925492,12-48925017-G-A,rs12424638,-1,G,A,48925017,475,48728884,49122100,196133
12,ENSG00000179104.3,82686906,12-82707535-T-C,rs12426166,1,T,C,82707535,20629,82490298,82883514,217237
12,ENSG00000110921.7,109573794,12-109677899-C-T,rs12426962,1,C,T,109677899,104105,109377186,109770402,300713
12,ENSG00000110921.7,109573794,12-109677899-C-G,rs12426962,1,C,G,109677899,104105,109377186,109770402,300713
12,ENSG00000155957.10,66169996,12-66161753-C-T,rs12578801,-1,C,T,66161753,8243,65973388,66366604,188365
12,ENSG00000005175.5,47706030,12-47901350-C-T,rs12581281,-1,C,T,47901350,195320,47509422,47902638,391928
12,ENSG00000089157.11,120201111,12-120178003-G-A,rs12581892,-1,G,A,120178003,23108,120004503,120397719,173500
12,ENSG00000130037.3,5043879,12-4858367-T-C,rs12582063,1,T,C,4858367,185512,4847271,5240487,11096
12,ENSG00000084444.9,13044381,12-12953576-C-T,rs1291371,1,C,T,12953576,90805,12847773,13240989,105803
12,ENSG00000084444.9,13044381,12-12953576-C-G,rs1291371,1,C,G,12953576,90805,12847773,13240989,105803
12,ENSG00000151148.8,109477634,12-109644426-G-A,rs1344541,1,G,A,109644426,166792,109281026,109674242,363400
12,ENSG00000076555.10,109116587,12-109105679-C-T,rs1368557,1,C,T,109105679,10908,108919979,109313195,185700
12,ENSG00000076555.10,109116587,12-109105679-C-A,rs1368557,1,C,A,109105679,10908,108919979,109313195,185700
12,ENSG00000139352.3,102957674,12-103069363-C-T,rs1401995,1,C,T,103069363,111689,102761066,103154282,308297
12,ENSG00000139352.3,102957674,12-103069363-C-A,rs1401995,1,C,A,103069363,111689,102761066,103154282,308297
12,ENSG00000037897.12,57772105,12-57686042-T-C,rs1479498,-1,T,C,57686042,86063,57575497,57968713,110545
12,ENSG00000155974.7,66679076,12-66599088-T-C,rs1493481,-1,T,C,66599088,79988,66482468,66875684,116620
12,ENSG00000155974.7,66679076,12-66599088-T-A,rs1493481,-1,T,A,66599088,79988,66482468,66875684,116620
12,ENSG00000134291.7,47963596,12-47954569-C-G,rs1541408,1,C,G,47954569,9027,47766988,48160204,187581
12,ENSG00000111639.3,6493262,12-6565889-T-A,rs1558333,-1,T,A,6565889,72627,6296654,6689870,269235
12,ENSG00000111639.3,6493262,12-6565889-T-G,rs1558333,-1,T,G,6565889,72627,6296654,6689870,269235
12,ENSG00000111371.10,46269043,12-46183958-A-C,rs15750,-1,A,C,46183958,85085,46072435,46465651,111523
12,ENSG00000111371.10,46269043,12-46183958-A-T,rs15750,-1,A,T,46183958,85085,46072435,46465651,111523
12,ENSG00000111371.10,46269043,12-46183958-A-G,rs15750,-1,A,G,46183958,85085,46072435,46465651,111523
12,ENSG00000179088.10,103495968,12-103581871-A-G,rs1593812,-1,A,G,103581871,85903,103299360,103692576,282511
12,ENSG00000139278.5,75480755,12-75569132-A-G,rs1627431,1,A,G,75569132,88377,75284147,75677363,284985
12,ENSG00000139278.5,75480755,12-75569132-A-T,rs1627431,1,A,T,75569132,88377,75284147,75677363,284985
12,ENSG00000123096.6,26195573,12-26056581-T-C,rs16929973,1,T,C,26056581,138992,25998965,26392181,57616
12,ENSG00000174456.7,110048522,12-109914556-G-A,rs16940680,-1,G,A,109914556,133966,109851914,110245130,62642
12,ENSG00000022840.9,120534356,12-120398422-C-T,rs16950118,1,C,T,120398422,135934,120337748,120730964,60674
12,ENSG00000197728.5,56041918,12-56018703-T-G,rs1701704,1,T,G,56018703,23215,55845310,56238526,173393
12,ENSG00000197728.5,56041918,12-56018703-T-A,rs1701704,1,T,A,56018703,23215,55845310,56238526,173393
12,ENSG00000012504.9,100473866,12-100545006-G-A,rs17030306,1,G,A,100545006,71140,100277258,100670474,267748
12,ENSG00000150977.9,123436684,12-123429150-T-A,rs1706477,-1,T,A,123429150,7534,123240076,123633292,189074
12,ENSG00000150977.9,123436684,12-123429150-T-C,rs1706477,-1,T,C,123429150,7534,123240076,123633292,189074
12,ENSG00000150977.9,123436684,12-123429150-T-G,rs1706477,-1,T,G,123429150,7534,123240076,123633292,189074
12,ENSG00000139289.7,76031776,12-75847358-C-T,rs17115813,-1,C,T,75847358,184418,75835168,76228384,12190
12,ENSG00000135424.10,55707904,12-55685681-C-G,rs17117860,-1,C,G,55685681,22223,55511296,55904512,174385
12,ENSG00000135424.10,55707904,12-55685681-C-A,rs17117860,-1,C,A,55685681,22223,55511296,55904512,174385
12,ENSG00000135404.6,55729009,12-55685681-C-G,rs17117860,-1,C,G,55685681,43328,55532401,55925617,153280
12,ENSG00000135404.6,55729009,12-55685681-C-A,rs17117860,-1,C,A,55685681,43328,55532401,55925617,153280
12,ENSG00000135392.10,55829587,12-55953422-C-T,rs17118141,-1,C,T,55953422,123835,55632979,56026195,320443
12,ENSG00000139651.8,53180722,12-53104143-C-G,rs17123210,1,C,G,53104143,76579,52984114,53377330,120029
12,ENSG00000151164.14,110502331,12-110328962-A-G,rs17187412,1,A,G,110328962,173369,110305723,110698939,23239
12,ENSG00000158023.5,121918592,12-121909706-T-G,rs1720035,1,T,G,121909706,8886,121721984,122115200,187722
12,ENSG00000158023.5,121918592,12-121909706-T-A,rs1720035,1,T,A,121909706,8886,121721984,122115200,187722
12,ENSG00000171759.4,102917244,12-102847292-T-C,rs1722387,-1,T,C,102847292,69952,102720636,103113852,126656
12,ENSG00000050426.9,51048327,12-51063451-C-T,rs17229232,1,C,T,51063451,15124,50851719,51244935,211732
12,ENSG00000111325.12,122975220,12-123091195-A-C,rs1727307,1,A,C,123091195,115975,122778612,123171828,312583
12,ENSG00000111325.12,122975220,12-123091195-A-T,rs1727307,1,A,T,123091195,115975,122778612,123171828,312583
12,ENSG00000111325.12,122975220,12-123091195-A-G,rs1727307,1,A,G,123091195,115975,122778612,123171828,312583
12,ENSG00000257594.1,89524796,12-89389271-T-C,rs17363231,-1,T,C,89389271,135525,89328188,89721404,61083
12,ENSG00000139574.6,53507484,12-53412871-C-G,rs17695156,-1,C,G,53412871,94613,53310876,53704092,101995
12,ENSG00000139574.6,53507484,12-53412871-C-T,rs17695156,-1,C,T,53412871,94613,53310876,53704092,101995
12,ENSG00000170442.6,52274645,12-52298423-C-T,rs17706759,1,C,T,52298423,23778,52078037,52471253,220386
12,ENSG00000139055.2,14938537,12-14802967-G-A,rs17821751,-1,G,A,14802967,135570,14741929,15135145,61038
12,ENSG00000139168.3,42326094,12-42411228-T-A,rs1796360,-1,T,A,42411228,85134,42129486,42522702,281742
12,ENSG00000139168.3,42326094,12-42411228-T-C,rs1796360,-1,T,C,42411228,85134,42129486,42522702,281742
12,ENSG00000188375.3,31792298,12-31790771-G-A,rs1797738,-1,G,A,31790771,1527,31595690,31988906,195081
12,ENSG00000188375.3,31792298,12-31790771-G-C,rs1797738,-1,G,C,31790771,1527,31595690,31988906,195081
12,ENSG00000166986.8,57488068,12-57530648-A-C,rs1802914,1,A,C,57530648,42580,57291460,57684676,239188
12,ENSG00000166986.8,57488068,12-57530648-A-G,rs1802914,1,A,G,57530648,42580,57291460,57684676,239188
12,ENSG00000139173.4,43836081,12-43811215-T-G,rs1816854,1,T,G,43811215,24866,43639473,44032689,171742
12,ENSG00000139173.4,43836081,12-43811215-T-C,rs1816854,1,T,C,43811215,24866,43639473,44032689,171742
12,ENSG00000161800.8,50025494,12-50182363-G-C,rs1862044,-1,G,C,50182363,156869,49828886,50222102,353477
12,ENSG00000161800.8,50025494,12-50182363-G-T,rs1862044,-1,G,T,50182363,156869,49828886,50222102,353477
12,ENSG00000161800.8,50025494,12-50182363-G-A,rs1862044,-1,G,A,50182363,156869,49828886,50222102,353477
12,ENSG00000010610.5,6789528,12-6776244-G-A,rs1882545,1,G,A,6776244,13284,6592920,6986136,183324
12,ENSG00000205426.5,52291534,12-52301846-C-T,rs1894033,-1,C,T,52301846,10312,52094926,52488142,206920
12,ENSG00000121318.2,10826358,12-10850855-A-C,rs1972571,-1,A,C,10850855,24497,10629750,11022966,221105
12,ENSG00000121318.2,10826358,12-10850855-A-T,rs1972571,-1,A,T,10850855,24497,10629750,11022966,221105
12,ENSG00000121318.2,10826358,12-10850855-A-G,rs1972571,-1,A,G,10850855,24497,10629750,11022966,221105
12,ENSG00000060709.8,130716299,12-130716756-T-C,rs1997235,-1,T,C,130716756,457,130519691,130912907,197065
12,ENSG00000135093.7,109052576,12-109224174-T-A,rs2075258,1,T,A,109224174,171598,108855968,109249184,368206
12,ENSG00000135093.7,109052576,12-109224174-T-C,rs2075258,1,T,C,109224174,171598,108855968,109249184,368206
12,ENSG00000182870.8,132329589,12-132493479-A-G,rs2141776,-1,A,G,132493479,163890,132132981,132526197,360498
12,ENSG00000089127.7,112906962,12-112905570-C-G,rs2158390,1,C,G,112905570,1392,112710354,113103570,195216
12,ENSG00000123415.9,54188985,12-54182016-C-A,rs2233921,-1,C,A,54182016,6969,53992377,54385593,189639
12,ENSG00000167550.6,49069979,12-49050762-G-A,rs2241726,-1,G,A,49050762,19217,48873371,49266587,177391
12,ENSG00000139190.11,6470677,12-6458621-T-C,rs2243750,-1,T,C,6458621,12056,6274069,6667285,184552
12,ENSG00000013503.4,106357748,12-106414276-A-T,rs2249162,1,A,T,106414276,56528,106161140,106554356,253136
12,ENSG00000013503.4,106357748,12-106414276-A-G,rs2249162,1,A,G,106414276,56528,106161140,106554356,253136
12,ENSG00000157837.10,120904358,12-120971439-G-A,rs2254779,-1,G,A,120971439,67081,120707750,121100966,263689
12,ENSG00000174527.4,109347903,12-109201716-G-A,rs2284691,1,G,A,109201716,146187,109151295,109544511,50421
12,ENSG00000174236.2,27696447,12-27664142-A-G,rs2288227,1,A,G,27664142,32305,27499839,27893055,164303
12,ENSG00000170473.12,55927894,12-55839734-G-A,rs2291267,-1,G,A,55839734,88160,55731286,56124502,108448
12,ENSG00000139726.6,122752824,12-122854811-C-A,rs2292137,1,C,A,122854811,101987,122556216,122949432,298595
12,ENSG00000139726.6,122752824,12-122854811-C-G,rs2292137,1,C,G,122854811,101987,122556216,122949432,298595
12,ENSG00000139579.7,56224342,12-56134334-A-G,rs2292237,1,A,G,56134334,90008,56027734,56420950,106600
12,ENSG00000139579.7,56224342,12-56134334-A-C,rs2292237,1,A,C,56134334,90008,56027734,56420950,106600
12,ENSG00000170439.5,55681736,12-55697833-A-G,rs2293412,1,A,G,55697833,16097,55485128,55878344,212705
12,ENSG00000170439.5,55681736,12-55697833-A-T,rs2293412,1,A,T,55697833,16097,55485128,55878344,212705
12,ENSG00000170439.5,55681736,12-55697833-A-C,rs2293412,1,A,C,55697833,16097,55485128,55878344,212705
12,ENSG00000176915.10,132761832,12-132565935-G-A,rs2323982,-1,G,A,132565935,195897,132565224,132958440,711
12,ENSG00000179195.9,123973215,12-123783734-G-C,rs2340692,1,G,C,123783734,189481,123776607,124169823,7127
12,ENSG00000179195.9,123973215,12-123783734-G-A,rs2340692,1,G,A,123783734,189481,123776607,124169823,7127
12,ENSG00000111181.8,214157,12-136662-A-C,rs2368834,-1,A,C,136662,77495,17549,410765,119113
12,ENSG00000111181.8,214157,12-136662-A-G,rs2368834,-1,A,G,136662,77495,17549,410765,119113
12,ENSG00000111186.8,1629231,12-1535719-A-G,rs2369856,1,A,G,1535719,93512,1432623,1825839,103096
12,ENSG00000170456.10,31591136,12-31636497-G-C,rs2374165,-1,G,C,31636497,45361,31394528,31787744,241969
12,ENSG00000170456.10,31591136,12-31636497-G-A,rs2374165,-1,G,A,31636497,45361,31394528,31787744,241969
12,ENSG00000166908.12,57591192,12-57723572-T-C,rs238516,1,T,C,57723572,132380,57394584,57787800,328988
12,ENSG00000166908.12,57591192,12-57723572-T-A,rs238516,1,T,A,57723572,132380,57394584,57787800,328988
12,ENSG00000166908.12,57591192,12-57723572-T-G,rs238516,1,T,G,57723572,132380,57394584,57787800,328988
12,ENSG00000167535.3,48818496,12-48832960-A-C,rs2453472,1,A,C,48832960,14464,48621888,49015104,211072
12,ENSG00000174243.4,48852163,12-48854831-G-A,rs2453481,-1,G,A,48854831,2668,48655555,49048771,199276
12,ENSG00000170855.3,120446384,12-120317249-T-G,rs2522132,-1,T,G,120317249,129135,120249776,120642992,67473
12,ENSG00000139192.7,6452042,12-6479806-A-C,rs2532514,1,A,C,6479806,27764,6255434,6648650,224372
12,ENSG00000139192.7,6452042,12-6479806-A-T,rs2532514,1,A,T,6479806,27764,6255434,6648650,224372
12,ENSG00000204954.5,103957215,12-104006821-G-A,rs2629793,-1,G,A,104006821,49606,103760607,104153823,246214
12,ENSG00000110911.10,51026384,12-51167273-C-G,rs2640518,-1,C,G,51167273,140889,50829776,51222992,337497
12,ENSG00000110911.10,51026384,12-51167273-C-T,rs2640518,-1,C,T,51167273,140889,50829776,51222992,337497
12,ENSG00000135423.8,56488161,12-56469986-G-C,rs2657880,-1,G,C,56469986,18175,56291553,56684769,178433
12,ENSG00000127311.5,66302493,12-66286522-C-T,rs2870780,1,C,T,66286522,15971,66105885,66499101,180637
12,ENSG00000127311.5,66302493,12-66286522-C-A,rs2870780,1,C,A,66286522,15971,66105885,66499101,180637
12,ENSG00000111671.5,6873303,12-6789890-A-G,rs28989523,-1,A,G,6789890,83413,6676695,7069911,113195
12,ENSG00000133687.10,29783942,12-29768510-G-A,rs302317,-1,G,A,29768510,15432,29587334,29980550,181176
12,ENSG00000110841.8,27524206,12-27529047-G-T,rs306651,1,G,T,27529047,4841,27327598,27720814,201449
12,ENSG00000110841.8,27524206,12-27529047-G-A,rs306651,1,G,A,27529047,4841,27327598,27720814,201449
12,ENSG00000135441.3,55716046,12-55721994-C-A,rs3138141,1,C,A,55721994,5948,55519438,55912654,202556
12,ENSG00000121749.11,71839759,12-71732067-A-C,rs34207834,1,A,C,71732067,107692,71643151,72036367,88916
12,ENSG00000186815.8,113221464,12-113364383-G-A,rs34593969,1,G,A,113364383,142919,113024856,113418072,339527
12,ENSG00000119242.4,123972831,12-123845764-C-T,rs34934281,-1,C,T,123845764,127067,123776223,124169439,69541
12,ENSG00000111358.7,123633829,12-123475134-G-A,rs36084544,1,G,A,123475134,158695,123437221,123830437,37913
12,ENSG00000196917.4,122730844,12-122585671-G-T,rs36117464,-1,G,T,122585671,145173,122534236,122927452,51435
12,ENSG00000196917.4,122730844,12-122585671-G-A,rs36117464,-1,G,A,122585671,145173,122534236,122927452,51435
12,ENSG00000130921.3,123233436,12-123221415-C-A,rs36121382,1,C,A,123221415,12021,123036828,123430044,184587
12,ENSG00000130921.3,123233436,12-123221415-C-T,rs36121382,1,C,T,123221415,12021,123036828,123430044,184587
12,ENSG00000139364.6,125186386,12-125012509-G-A,rs3751184,1,G,A,125012509,173877,124989778,125382994,22731
12,ENSG00000167566.11,49828413,12-49950079-A-G,rs3759126,-1,A,G,49950079,121666,49631805,50025021,318274
12,ENSG00000167566.11,49828413,12-49950079-A-C,rs3759126,-1,A,C,49950079,121666,49631805,50025021,318274
12,ENSG00000186666.4,49843106,12-49911498-A-C,rs376401,-1,A,C,49911498,68392,49646498,50039714,265000
12,ENSG00000123360.7,54549601,12-54574117-C-G,rs3782411,1,C,G,54574117,24516,54352993,54746209,221124
12,ENSG00000123360.7,54549601,12-54574117-C-T,rs3782411,1,C,T,54574117,24516,54352993,54746209,221124
12,ENSG00000111602.7,56449426,12-56450565-C-T,rs3809125,-1,C,T,56450565,1139,56252818,56646034,197747
12,ENSG00000123395.10,52069978,12-51899716-G-A,rs3847859,1,G,A,51899716,170262,51873370,52266586,26346
12,ENSG00000129317.10,43758790,12-43770654-T-C,rs4251467,-1,T,C,43770654,11864,43562182,43955398,208472
12,ENSG00000139174.6,42589746,12-42674441-C-G,rs4315147,-1,C,G,42674441,84695,42393138,42786354,281303
12,ENSG00000139174.6,42589746,12-42674441-C-T,rs4315147,-1,C,T,42674441,84695,42393138,42786354,281303
12,ENSG00000166888.4,57111362,12-57095865-C-T,rs4559,-1,C,T,57095865,15497,56914754,57307970,181111
12,ENSG00000132341.5,130872066,12-130740258-T-C,rs4759771,1,T,C,130740258,131808,130675458,131068674,64800
12,ENSG00000139620.8,48682238,12-48850564-G-A,rs4760635,-1,G,A,48850564,168326,48485630,48878846,364934
12,ENSG00000123358.14,52051442,12-52169382-A-C,rs4762058,1,A,C,52169382,117940,51854834,52248050,314548
12,ENSG00000123358.14,52051442,12-52169382-A-T,rs4762058,1,A,T,52169382,117940,51854834,52248050,314548
12,ENSG00000111445.9,118016703,12-118029748-A-G,rs4767654,1,A,G,118029748,13045,117820095,118213311,209653
12,ENSG00000197653.10,123762301,12-123841430-T-A,rs4930729,1,T,A,123841430,79129,123565693,123958909,275737
12,ENSG00000197653.10,123762301,12-123841430-T-G,rs4930729,1,T,G,123841430,79129,123565693,123958909,275737
12,ENSG00000084112.8,108857583,12-108810035-G-A,rs4964759,-1,G,A,108810035,47548,108660975,109054191,149060
12,ENSG00000084112.8,108857583,12-108810035-G-T,rs4964759,-1,G,T,108810035,47548,108660975,109054191,149060
12,ENSG00000257218.1,120446444,12-120473983-G-A,rs540520,1,G,A,120473983,27539,120249836,120643052,224147
12,ENSG00000257218.1,120446444,12-120473983-G-C,rs540520,1,G,C,120473983,27539,120249836,120643052,224147
12,ENSG00000010626.10,6904822,12-6847298-C-T,rs5446,1,C,T,6847298,57524,6708214,7101430,139084
12,ENSG00000010626.10,6904822,12-6847298-C-A,rs5446,1,C,A,6847298,57524,6708214,7101430,139084
12,ENSG00000110811.13,6828407,12-6847298-C-T,rs5446,1,C,T,6847298,18891,6631799,7025015,215499
12,ENSG00000110811.13,6828407,12-6847298-C-A,rs5446,1,C,A,6847298,18891,6631799,7025015,215499
12,ENSG00000182196.8,122980681,12-122813355-C-T,rs55716280,1,C,T,122813355,167326,122784073,123177289,29282
12,ENSG00000178498.11,57604824,12-57481184-A-G,rs569092,1,A,G,57481184,123640,57408216,57801432,72968
12,ENSG00000178498.11,57604824,12-57481184-A-T,rs569092,1,A,T,57481184,123640,57408216,57801432,72968
12,ENSG00000134548.5,21526296,12-21569719-A-G,rs6487241,1,A,G,21569719,43423,21329688,21722904,240031
12,ENSG00000134548.5,21526296,12-21569719-A-T,rs6487241,1,A,T,21569719,43423,21329688,21722904,240031
12,ENSG00000134548.5,21526296,12-21569719-A-C,rs6487241,1,A,C,21569719,43423,21329688,21722904,240031
12,ENSG00000139112.6,10212877,12-10366107-G-A,rs6488285,1,G,A,10366107,153230,10016269,10409485,349838
12,ENSG00000139697.5,123364847,12-123309475-T-A,rs6488867,-1,T,A,123309475,55372,123168239,123561455,141236
12,ENSG00000139697.5,123364847,12-123309475-T-G,rs6488867,-1,T,G,123309475,55372,123168239,123561455,141236
12,ENSG00000139697.5,123364847,12-123309475-T-C,rs6488867,-1,T,C,123309475,55372,123168239,123561455,141236
12,ENSG00000111644.3,6647432,12-6534150-T-G,rs6489721,-1,T,G,6534150,113282,6450824,6844040,83326
12,ENSG00000111644.3,6647432,12-6534150-T-A,rs6489721,-1,T,A,6534150,113282,6450824,6844040,83326
12,ENSG00000111644.3,6647432,12-6534150-T-C,rs6489721,-1,T,C,6534150,113282,6450824,6844040,83326
12,ENSG00000127337.2,69359743,12-69344359-G-A,rs689415,1,G,A,69344359,15384,69163135,69556351,181224
12,ENSG00000135452.5,57745039,12-57713053-A-G,rs701006,1,A,G,57713053,31986,57548431,57941647,164622
12,ENSG00000229117.4,56116633,12-56041628-G-C,rs705704,1,G,C,56041628,75005,55920025,56313241,121603
12,ENSG00000229117.4,56116633,12-56041628-G-A,rs705704,1,G,A,56041628,75005,55920025,56313241,121603
12,ENSG00000133639.3,92145846,12-92112156-T-C,rs709240,-1,T,C,92112156,33690,91949238,92342454,162918
12,ENSG00000133639.3,92145846,12-92112156-T-G,rs709240,-1,T,G,92112156,33690,91949238,92342454,162918
12,ENSG00000133639.3,92145846,12-92112156-T-A,rs709240,-1,T,A,92112156,33690,91949238,92342454,162918
12,ENSG00000188596.3,96489577,12-96660187-T-C,rs7131786,1,T,C,96660187,170610,96292969,96686185,367218
12,ENSG00000188596.3,96489577,12-96660187-T-G,rs7131786,1,T,G,96660187,170610,96292969,96686185,367218
12,ENSG00000182782.6,122703357,12-122728193-A-G,rs7131791,-1,A,G,122728193,24836,122506749,122899965,221444
12,ENSG00000089159.10,120265730,12-120429193-A-G,rs7132474,-1,A,G,120429193,163463,120069122,120462338,360071
12,ENSG00000089159.10,120265730,12-120429193-A-C,rs7132474,-1,A,C,120429193,163463,120069122,120462338,360071
12,ENSG00000111335.8,112978519,12-113151096-A-G,rs7136744,1,A,G,113151096,172577,112781911,113175127,369185
12,ENSG00000127329.9,70637429,12-70792964-T-G,rs7137586,-1,T,G,70792964,155535,70440821,70834037,352143
12,ENSG00000177627.5,48482498,12-48443237-G-A,rs7139348,1,G,A,48443237,39261,48285890,48679106,157347
12,ENSG00000177627.5,48482498,12-48443237-G-C,rs7139348,1,G,C,48443237,39261,48285890,48679106,157347
12,ENSG00000078246.10,2890891,12-2752165-C-T,rs71458014,1,C,T,2752165,138726,2694283,3087499,57882
12,ENSG00000139725.2,121793688,12-121756826-C-T,rs7294817,-1,C,T,121756826,36862,121597080,121990296,159746
12,ENSG00000178878.7,12785659,12-12678634-C-T,rs7299416,1,C,T,12678634,107025,12589051,12982267,89583
12,ENSG00000013588.5,12891562,12-12789599-C-A,rs7301360,1,C,A,12789599,101963,12694954,13088170,94645
12,ENSG00000171681.8,14365682,12-14313042-C-G,rs7302221,1,C,G,14313042,52640,14169074,14562290,143968
12,ENSG00000171681.8,14365682,12-14313042-C-T,rs7302221,1,C,T,14313042,52640,14169074,14562290,143968
12,ENSG00000168778.7,123671113,12-123595373-A-G,rs7303554,1,A,G,123595373,75740,123474505,123867721,120868
12,ENSG00000110881.6,50057596,12-50079594-G-A,rs7305558,1,G,A,50079594,21998,49860988,50254204,218606
12,ENSG00000139405.8,113185721,12-113156910-C-T,rs7309187,1,C,T,113156910,28811,112989113,113382329,167797
12,ENSG00000076067.6,56521820,12-56541868-G-A,rs7310284,1,G,A,56541868,20048,56325212,56718428,216656
12,ENSG00000134551.7,10929236,12-11012152-G-C,rs7315843,1,G,C,11012152,82916,10732628,11125844,279524
12,ENSG00000134551.7,10929236,12-11012152-G-A,rs7315843,1,G,A,11012152,82916,10732628,11125844,279524
12,ENSG00000111215.5,10849475,12-11012152-G-C,rs7315843,-1,G,C,11012152,162677,10652867,11046083,359285
12,ENSG00000111215.5,10849475,12-11012152-G-A,rs7315843,-1,G,A,11012152,162677,10652867,11046083,359285
12,ENSG00000184752.8,95003697,12-95004272-G-A,rs7316005,-1,G,A,95004272,575,94807089,95200305,197183
12,ENSG00000111725.5,119668133,12-119615482-A-G,rs73221243,1,A,G,119615482,52651,119471525,119864741,143957
12,ENSG00000136040.4,94148577,12-94153695-A-C,rs73222637,1,A,C,94153695,5118,93951969,94345185,201726
12,ENSG00000185163.5,132144319,12-132173241-C-G,rs7485855,-1,C,G,132173241,28922,131947711,132340927,225530
12,ENSG00000185163.5,132144319,12-132173241-C-T,rs7485855,-1,C,T,132173241,28922,131947711,132340927,225530
12,ENSG00000173598.9,93377925,12-93557831-C-G,rs7488123,1,C,G,93557831,179906,93181317,93574533,376514
12,ENSG00000173598.9,93377925,12-93557831-C-T,rs7488123,1,C,T,93557831,179906,93181317,93574533,376514
12,ENSG00000079337.10,47758880,12-47768697-A-G,rs7488942,-1,A,G,47768697,9817,47562272,47955488,206425
12,ENSG00000079337.10,47758880,12-47768697-A-T,rs7488942,-1,A,T,47768697,9817,47562272,47955488,206425
12,ENSG00000205323.4,55817724,12-55706813-C-T,rs75366241,-1,C,T,55706813,110911,55621116,56014332,85697
12,ENSG00000172322.8,9971409,12-9999116-G-A,rs76016091,1,G,A,9999116,27707,9774801,10168017,224315
12,ENSG00000139629.9,51391406,12-51242203-G-A,rs76909895,-1,G,A,51242203,149203,51194798,51588014,47405
12,ENSG00000111046.3,80707634,12-80739141-A-G,rs77188279,1,A,G,80739141,31507,80511026,80904242,228115
12,ENSG00000135446.11,57752310,12-57824144-C-T,rs78073833,-1,C,T,57824144,71834,57555702,57948918,268442
12,ENSG00000111364.9,123602099,12-123572622-C-T,rs786452,1,C,T,123572622,29477,123405491,123798707,167131
12,ENSG00000177875.3,48183644,12-48201099-T-G,rs79054759,1,T,G,48201099,17455,47987036,48380252,214063
12,ENSG00000177875.3,48183644,12-48201099-T-C,rs79054759,1,T,C,48201099,17455,47987036,48380252,214063
12,ENSG00000133858.11,71663848,12-71597075-G-A,rs79241756,-1,G,A,71597075,66773,71467240,71860456,129835
12,ENSG00000111726.8,22046218,12-21923239-G-A,rs79461374,1,G,A,21923239,122979,21849610,22242826,73629
12,ENSG00000151490.9,15322508,12-15167225-G-A,rs79555850,1,G,A,15167225,155283,15125900,15519116,41325
12,ENSG00000151490.9,15322508,12-15167225-G-C,rs79555850,1,G,C,15167225,155283,15125900,15519116,41325
12,ENSG00000180263.9,95217467,12-95197483-T-C,rs7956604,-1,T,C,95197483,19984,95020859,95414075,176624
12,ENSG00000180263.9,95217467,12-95197483-T-G,rs7956604,-1,T,G,95197483,19984,95020859,95414075,176624
12,ENSG00000180263.9,95217467,12-95197483-T-A,rs7956604,-1,T,A,95197483,19984,95020859,95414075,176624
12,ENSG00000111653.15,6663119,12-6645025-A-T,rs7959658,-1,A,T,6645025,18094,6466511,6859727,178514
12,ENSG00000111653.15,6663119,12-6645025-A-G,rs7959658,-1,A,G,6645025,18094,6466511,6859727,178514
12,ENSG00000139131.8,32755897,12-32786669-T-C,rs7960630,-1,T,C,32786669,30772,32559289,32952505,227380
12,ENSG00000089163.4,120302321,12-120282235-T-A,rs7960743,1,T,A,120282235,20086,120105713,120498929,176522
12,ENSG00000089163.4,120302321,12-120282235-T-G,rs7960743,1,T,G,120282235,20086,120105713,120498929,176522
12,ENSG00000089163.4,120302321,12-120282235-T-C,rs7960743,1,T,C,120282235,20086,120105713,120498929,176522
12,ENSG00000090376.4,66189214,12-66090549-G-C,rs7966543,1,G,C,66090549,98665,65992606,66385822,97943
12,ENSG00000090376.4,66189214,12-66090549-G-A,rs7966543,1,G,A,66090549,98665,65992606,66385822,97943
12,ENSG00000090376.4,66189214,12-66090549-G-T,rs7966543,1,G,T,66090549,98665,65992606,66385822,97943
12,ENSG00000111252.5,111405923,12-111555908-C-T,rs7969300,1,C,T,111555908,149985,111209315,111602531,346593
12,ENSG00000111252.5,111405923,12-111555908-C-G,rs7969300,1,C,G,111555908,149985,111209315,111602531,346593
12,ENSG00000211584.8,47773238,12-47921683-C-A,rs7970472,1,C,A,47921683,148445,47576630,47969846,345053
12,ENSG00000211584.8,47773238,12-47921683-C-T,rs7970472,1,C,T,47921683,148445,47576630,47969846,345053
12,ENSG00000179256.2,14814182,12-14740163-T-C,rs7970697,-1,T,C,14740163,74019,14617574,15010790,122589
12,ENSG00000134287.4,48957487,12-48917004-C-A,rs79716342,-1,C,A,48917004,40483,48760879,49154095,156125
12,ENSG00000111321.5,6384162,12-6381577-T-C,rs7972647,1,T,C,6381577,2585,6187554,6580770,194023
12,ENSG00000110900.10,30926748,12-30915263-G-A,rs7975877,1,G,A,30915263,11485,30730140,31123356,185123
12,ENSG00000110900.10,30926748,12-30915263-G-T,rs7975877,1,G,T,30915263,11485,30730140,31123356,185123
12,ENSG00000171823.6,1594581,12-1527964-T-G,rs7977125,-1,T,G,1527964,66617,1397973,1791189,129991
12,ENSG00000089250.13,117361626,12-117324894-C-G,rs816293,-1,C,G,117324894,36732,117165018,117558234,159876
12,ENSG00000089250.13,117361626,12-117324894-C-A,rs816293,-1,C,A,117324894,36732,117165018,117558234,159876
12,ENSG00000253719.2,74537835,12-74634342-T-A,rs822810,1,T,A,74634342,96507,74341227,74734443,293115
12,ENSG00000253719.2,74537835,12-74634342-T-G,rs822810,1,T,G,74634342,96507,74341227,74734443,293115
12,ENSG00000253719.2,74537835,12-74634342-T-C,rs822810,1,T,C,74634342,96507,74341227,74734443,293115
12,ENSG00000110987.4,122021884,12-121961047-A-C,rs830127,1,A,C,121961047,60837,121825276,122218492,135771
12,ENSG00000110987.4,122021884,12-121961047-A-G,rs830127,1,A,G,121961047,60837,121825276,122218492,135771
12,ENSG00000110987.4,122021884,12-121961047-A-T,rs830127,1,A,T,121961047,60837,121825276,122218492,135771
12,ENSG00000139537.6,48904133,12-48970608-G-C,rs833843,1,G,C,48970608,66475,48707525,49100741,263083
12,ENSG00000139537.6,48904133,12-48970608-G-A,rs833843,1,G,A,48970608,66475,48707525,49100741,263083
12,ENSG00000152944.4,27022558,12-27128393-A-T,rs841647,1,A,T,27128393,105835,26825950,27219166,302443
12,ENSG00000152944.4,27022558,12-27128393-A-C,rs841647,1,A,C,27128393,105835,26825950,27219166,302443
12,ENSG00000152944.4,27022558,12-27128393-A-G,rs841647,1,A,G,27128393,105835,26825950,27219166,302443
12,ENSG00000165714.6,12357078,12-12475285-T-C,rs888197,1,T,C,12475285,118207,12160470,12553686,314815
12,ENSG00000111266.4,12562863,12-12463469-T-C,rs918115,-1,T,C,12463469,99394,12366255,12759471,97214
12,ENSG00000139410.10,113422380,12-113360907-T-A,rs9668121,1,T,A,113360907,61473,113225772,113618988,135135
12,ENSG00000139410.10,113422380,12-113360907-T-C,rs9668121,1,T,C,113360907,61473,113225772,113618988,135135
12,ENSG00000111254.2,4649051,12-4607406-C-A,rs997373,-1,C,A,4607406,41645,4452443,4845659,154963
12,ENSG00000165891.10,77065569,12-77071741-G-A,rs998377,-1,G,A,77071741,6172,76868961,77262177,202780
12,ENSG00000165891.10,77065569,12-77071741-G-T,rs998377,-1,G,T,77071741,6172,76868961,77262177,202780
12,ENSG00000010278.6,6200400,12-6182726-A-G,rs998908,1,A,G,6182726,17674,6003792,6397008,178934
12,ENSG00000010278.6,6200400,12-6182726-A-T,rs998908,1,A,T,6182726,17674,6003792,6397008,178934
12,ENSG00000087502.12,29381172,12-29282682-T-A,rs1006410,-1,T,A,29282682,98490,29184564,29577780,98118
12,ENSG00000087502.12,29381172,12-29282682-T-C,rs1006410,-1,T,C,29282682,98490,29184564,29577780,98118
12,ENSG00000052126.9,19129733,12-19029838-A-G,rs1018298,1,A,G,19029838,99895,18933125,19326341,96713
12,ENSG00000177119.11,45216095,12-45179028-A-G,rs1025092,1,A,G,45179028,37067,45019487,45412703,159541
12,ENSG00000166130.10,98644788,12-98613845-C-T,rs1048906,-1,C,T,98613845,30943,98448180,98841396,165665
12,ENSG00000111291.4,12950384,12-12851477-A-G,rs10505769,-1,A,G,12851477,98907,12753776,13146992,97701
12,ENSG00000111653.15,6663119,12-6748123-G-C,rs1050629,-1,G,C,6748123,85004,6466511,6859727,281612
12,ENSG00000111653.15,6663119,12-6748123-G-A,rs1050629,-1,G,A,6748123,85004,6466511,6859727,281612
12,ENSG00000111666.5,101697640,12-101640342-T-C,rs10507134,1,T,C,101640342,57298,101501032,101894248,139310
12,ENSG00000111666.5,101697640,12-101640342-T-G,rs10507134,1,T,G,101640342,57298,101501032,101894248,139310
12,ENSG00000111666.5,101697640,12-101640342-T-A,rs10507134,1,T,A,101640342,57298,101501032,101894248,139310
12,ENSG00000204954.5,103957215,12-103851268-G-A,rs10507170,-1,G,A,103851268,105947,103760607,104153823,90661
12,ENSG00000180574.3,10505890,12-10359063-C-G,rs10743886,1,C,G,10359063,146827,10309282,10702498,49781
12,ENSG00000180574.3,10505890,12-10359063-C-T,rs10743886,1,C,T,10359063,146827,10309282,10702498,49781
12,ENSG00000048540.9,16606162,12-16453923-C-A,rs10744125,-1,C,A,16453923,152239,16409554,16802770,44369
12,ENSG00000121318.2,10826358,12-10892913-T-G,rs10772380,-1,T,G,10892913,66555,10629750,11022966,263163
12,ENSG00000121318.2,10826358,12-10892913-T-C,rs10772380,-1,T,C,10892913,66555,10629750,11022966,263163
12,ENSG00000013503.4,106357748,12-106428876-C-A,rs10778470,1,C,A,106428876,71128,106161140,106554356,267736
12,ENSG00000110911.10,51026384,12-50850097-A-T,rs10783395,-1,A,T,50850097,176287,50829776,51222992,20321
12,ENSG00000110911.10,51026384,12-50850097-A-G,rs10783395,-1,A,G,50850097,176287,50829776,51222992,20321
12,ENSG00000123104.7,26833194,12-26998747-A-G,rs10842825,-1,A,G,26998747,165553,26636586,27029802,362161
12,ENSG00000136052.5,104958290,12-105037031-T-C,rs10861313,-1,T,C,105037031,78741,104761682,105154898,275349
12,ENSG00000136051.9,105107731,12-105283146-C-G,rs10861371,1,C,G,105283146,175415,104911123,105304339,372023
12,ENSG00000090615.7,132828869,12-132898785-T-C,rs10870538,-1,T,C,132898785,69916,132632261,133025477,266524
12,ENSG00000151229.7,40106081,12-40064338-T-G,rs10878050,-1,T,G,40064338,41743,39909473,40302689,154865
12,ENSG00000090376.4,66189214,12-66053125-T-A,rs10878370,1,T,A,66053125,136089,65992606,66385822,60519
12,ENSG00000090376.4,66189214,12-66053125-T-G,rs10878370,1,T,G,66053125,136089,65992606,66385822,60519
12,ENSG00000090376.4,66189214,12-66053125-T-C,rs10878370,1,T,C,66053125,136089,65992606,66385822,60519
12,ENSG00000155957.10,66169996,12-66164037-T-G,rs10878389,-1,T,G,66164037,5959,65973388,66366604,190649
12,ENSG00000127337.2,69359743,12-69401076-G-A,rs10878976,1,G,A,69401076,41333,69163135,69556351,237941
12,ENSG00000134283.12,42326167,12-42327023-G-T,rs10880288,1,G,T,42327023,856,42129559,42522775,197464
12,ENSG00000064102.9,26937981,12-26881980-G-A,rs11048761,-1,G,A,26881980,56001,26741373,27134589,140607
12,ENSG00000064102.9,26937981,12-26881980-G-T,rs11048761,-1,G,T,26881980,56001,26741373,27134589,140607
12,ENSG00000133704.4,30695869,12-30782372-C-T,rs11051081,-1,C,T,30782372,86503,30499261,30892477,283111
12,ENSG00000084444.9,13044381,12-13178997-C-T,rs11055270,1,C,T,13178997,134616,12847773,13240989,331224
12,ENSG00000084444.9,13044381,12-13178997-C-G,rs11055270,1,C,G,13178997,134616,12847773,13240989,331224
12,ENSG00000168778.7,123671113,12-123657115-C-T,rs11057322,1,C,T,123657115,13998,123474505,123867721,182610
12,ENSG00000119242.4,123972831,12-123896746-A-T,rs11057388,-1,A,T,123896746,76085,123776223,124169439,120523
12,ENSG00000119242.4,123972831,12-123896746-A-G,rs11057388,-1,A,G,123896746,76085,123776223,124169439,120523
12,ENSG00000139192.7,6452042,12-6467555-C-A,rs11064210,1,C,A,6467555,15513,6255434,6648650,212121
12,ENSG00000139192.7,6452042,12-6467555-C-T,rs11064210,1,C,T,6467555,15513,6255434,6648650,212121
12,ENSG00000111652.4,6724046,12-6556153-A-C,rs11064253,1,A,C,6556153,167893,6527438,6920654,28715
12,ENSG00000111725.5,119668133,12-119515726-C-T,rs11064820,1,C,T,119515726,152407,119471525,119864741,44201
12,ENSG00000089041.11,121132876,12-120962402-T-C,rs11065374,1,T,C,120962402,170474,120936268,121329484,26134
12,ENSG00000135124.9,121210129,12-121141854-C-T,rs11065450,1,C,T,121141854,68275,121013521,121406737,128333
12,ENSG00000135124.9,121210129,12-121141854-C-A,rs11065450,1,C,A,121141854,68275,121013521,121406737,128333
12,ENSG00000139428.5,109573504,12-109414094-C-T,rs11066523,-1,C,T,109414094,159410,109376896,109770112,37198
12,ENSG00000139428.5,109573504,12-109414094-C-A,rs11066523,-1,C,A,109414094,159410,109376896,109770112,37198
12,ENSG00000110906.8,109477300,12-109556403-C-G,rs11067233,-1,C,G,109556403,79103,109280692,109673908,275711
12,ENSG00000028203.12,95217807,12-95308609-T-C,rs11107973,1,T,C,95308609,90802,95021199,95414415,287410
12,ENSG00000171759.4,102917244,12-102891265-A-T,rs11111419,-1,A,T,102891265,25979,102720636,103113852,170629
12,ENSG00000161791.9,49707405,12-49752676-G-A,rs11169141,-1,G,A,49752676,45271,49510797,49904013,241879
12,ENSG00000111602.7,56449426,12-56477530-G-C,rs11171862,-1,G,C,56477530,28104,56252818,56646034,224712
12,ENSG00000111602.7,56449426,12-56477530-G-A,rs11171862,-1,G,A,56477530,28104,56252818,56646034,224712
12,ENSG00000134294.9,46372773,12-46216030-G-A,rs111744632,-1,G,A,46216030,156743,46176165,46569381,39865
12,ENSG00000166226.7,69585459,12-69437922-C-A,rs11177670,1,C,A,69437922,147537,69388851,69782067,49071
12,ENSG00000127325.13,69699303,12-69627916-A-G,rs11177758,-1,A,G,69627916,71387,69502695,69895911,125221
12,ENSG00000127325.13,69699303,12-69627916-A-T,rs11177758,-1,A,T,69627916,71387,69502695,69895911,125221
12,ENSG00000127325.13,69699303,12-69627916-A-C,rs11177758,-1,A,C,69627916,71387,69502695,69895911,125221
12,ENSG00000121749.11,71839759,12-72016299-G-C,rs11179050,1,G,C,72016299,176540,71643151,72036367,373148
12,ENSG00000121749.11,71839759,12-72016299-G-A,rs11179050,1,G,A,72016299,176540,71643151,72036367,373148
12,ENSG00000135677.4,64759406,12-64881988-A-C,rs1147085,-1,A,C,64881988,122582,64562798,64956014,319190
12,ENSG00000135677.4,64759406,12-64881988-A-T,rs1147085,-1,A,T,64881988,122582,64562798,64956014,319190
12,ENSG00000135677.4,64759406,12-64881988-A-G,rs1147085,-1,A,G,64881988,122582,64562798,64956014,319190
12,ENSG00000111252.5,111405923,12-111320279-C-T,rs114719470,1,C,T,111320279,85644,111209315,111602531,110964
12,ENSG00000184271.11,51218062,12-51064071-G-C,rs11542510,-1,G,C,51064071,153991,51021454,51414670,42617
12,ENSG00000184271.11,51218062,12-51064071-G-A,rs11542510,-1,G,A,51064071,153991,51021454,51414670,42617
12,ENSG00000183735.5,64452120,12-64338514-A-G,rs11609829,1,A,G,64338514,113606,64255512,64648728,83002
12,ENSG00000183735.5,64452120,12-64338514-A-T,rs11609829,1,A,T,64338514,113606,64255512,64648728,83002
12,ENSG00000179256.2,14814182,12-14822787-C-T,rs11610238,-1,C,T,14822787,8605,14617574,15010790,205213
12,ENSG00000111321.5,6384162,12-6393576-G-A,rs11616188,1,G,A,6393576,9414,6187554,6580770,206022
12,ENSG00000013583.4,13000265,12-12994494-C-T,rs117471888,-1,C,T,12994494,5771,12803657,13196873,190837
12,ENSG00000135679.15,68808177,12-68944858-G-C,rs117743406,1,G,C,68944858,136681,68611569,69004785,333289
12,ENSG00000135679.15,68808177,12-68944858-G-A,rs117743406,1,G,A,68944858,136681,68611569,69004785,333289
12,ENSG00000174989.7,116910950,12-117013440-A-G,rs117961053,1,A,G,117013440,102490,116714342,117107558,299098
12,ENSG00000084112.8,108857583,12-109043597-A-C,rs11829521,-1,A,C,109043597,186014,108660975,109054191,382622
12,ENSG00000139410.10,113422380,12-113434639-A-G,rs11831330,1,A,G,113434639,12259,113225772,113618988,208867
12,ENSG00000151148.8,109477634,12-109406873-A-C,rs11835066,1,A,C,109406873,70761,109281026,109674242,125847
12,ENSG00000151148.8,109477634,12-109406873-A-G,rs11835066,1,A,G,109406873,70761,109281026,109674242,125847
12,ENSG00000060982.10,24949101,12-25061197-T-C,rs12228264,-1,T,C,25061197,112096,24752493,25145709,308704
12,ENSG00000060982.10,24949101,12-25061197-T-A,rs12228264,-1,T,A,25061197,112096,24752493,25145709,308704
12,ENSG00000177990.7,63668493,12-63671518-T-A,rs12231958,-1,T,A,63671518,3025,63471885,63865101,199633
12,ENSG00000177990.7,63668493,12-63671518-T-C,rs12231958,-1,T,C,63671518,3025,63471885,63865101,199633
12,ENSG00000177990.7,63668493,12-63671518-T-G,rs12231958,-1,T,G,63671518,3025,63471885,63865101,199633
12,ENSG00000135114.7,121039242,12-120972095-C-T,rs12310166,-1,C,T,120972095,67147,120842634,121235850,129461
12,ENSG00000184574.4,6635959,12-6588187-G-A,rs12310569,-1,G,A,6588187,47772,6439351,6832567,148836
12,ENSG00000181929.6,49018776,12-49093000-T-C,rs12310622,-1,T,C,49093000,74224,48822168,49215384,270832
12,ENSG00000110841.8,27524206,12-27552779-A-G,rs12366631,1,A,G,27552779,28573,27327598,27720814,225181
12,ENSG00000257218.1,120446444,12-120544814-C-G,rs12369178,1,C,G,120544814,98370,120249836,120643052,294978
12,ENSG00000257218.1,120446444,12-120544814-C-T,rs12369178,1,C,T,120544814,98370,120249836,120643052,294978
12,ENSG00000111711.4,21501789,12-21354211-T-C,rs12369820,1,T,C,21354211,147578,21305181,21698397,49030
12,ENSG00000111335.8,112978519,12-112986653-C-T,rs12422608,1,C,T,112986653,8134,112781911,113175127,204742
12,ENSG00000151067.14,2052987,12-1955500-T-C,rs12423058,1,T,C,1955500,97487,1856379,2249595,99121
12,ENSG00000139636.11,49110847,12-48925017-G-C,rs12424638,-1,G,C,48925017,185830,48914239,49307455,10778
12,ENSG00000139636.11,49110847,12-48925017-G-A,rs12424638,-1,G,A,48925017,185830,48914239,49307455,10778
12,ENSG00000111186.8,1629231,12-1624880-G-A,rs12426085,1,G,A,1624880,4351,1432623,1825839,192257
12,ENSG00000111667.9,6852150,12-6739726-G-T,rs12427243,1,G,T,6739726,112424,6655542,7048758,84184
12,ENSG00000111667.9,6852150,12-6739726-G-A,rs12427243,1,G,A,6739726,112424,6655542,7048758,84184
12,ENSG00000110881.6,50057596,12-49899307-C-A,rs12578162,1,C,A,49899307,158289,49860988,50254204,38319
12,ENSG00000197728.5,56041918,12-56045425-A-G,rs12580100,1,A,G,56045425,3507,55845310,56238526,200115
12,ENSG00000229117.4,56116633,12-56045425-A-G,rs12580100,1,A,G,56045425,71208,55920025,56313241,125400
12,ENSG00000120860.6,102061991,12-101929489-G-C,rs12582545,-1,G,C,101929489,132502,101865383,102258599,64106
12,ENSG00000177627.5,48482498,12-48567461-T-G,rs12582811,1,T,G,48567461,84963,48285890,48679106,281571
12,ENSG00000177981.5,48157515,12-47965011-C-G,rs12721420,-1,C,G,47965011,192504,47960907,48354123,4104
12,ENSG00000177981.5,48157515,12-47965011-C-T,rs12721420,-1,C,T,47965011,192504,47960907,48354123,4104
12,ENSG00000198040.6,133037509,12-132913877-T-A,rs1278607,1,T,A,132913877,123632,132840901,133234117,72976
12,ENSG00000198040.6,133037509,12-132913877-T-C,rs1278607,1,T,C,132913877,123632,132840901,133234117,72976
12,ENSG00000010292.7,6494102,12-6600779-G-A,rs12816349,1,G,A,6600779,106677,6297494,6690710,303285
12,ENSG00000135424.10,55707904,12-55723916-C-A,rs13193,-1,C,A,55723916,16012,55511296,55904512,212620
12,ENSG00000135424.10,55707904,12-55723916-C-G,rs13193,-1,C,G,55723916,16012,55511296,55904512,212620
12,ENSG00000122970.11,110124357,12-110071656-G-A,rs13313219,1,G,A,110071656,52701,109927749,110320965,143907
12,ENSG00000170473.12,55927894,12-55804652-T-C,rs13378024,-1,T,C,55804652,123242,55731286,56124502,73366
12,ENSG00000170473.12,55927894,12-55804652-T-A,rs13378024,-1,T,A,55804652,123242,55731286,56124502,73366
12,ENSG00000111696.7,103841234,12-103844051-T-G,rs1370780,-1,T,G,103844051,2817,103644626,104037842,199425
12,ENSG00000111696.7,103841234,12-103844051-T-C,rs1370780,-1,T,C,103844051,2817,103644626,104037842,199425
12,ENSG00000023697.8,15911332,12-15984962-T-C,rs1450981,1,T,C,15984962,73630,15714724,16107940,270238
12,ENSG00000118307.12,25195160,12-25052787-T-G,rs1497258,-1,T,G,25052787,142373,24998552,25391768,54235
12,ENSG00000118307.12,25195160,12-25052787-T-C,rs1497258,-1,T,C,25052787,142373,24998552,25391768,54235
12,ENSG00000130779.13,122422669,12-122504232-A-G,rs1499681,-1,A,G,122504232,81563,122226061,122619277,278171
12,ENSG00000135392.10,55829587,12-55641345-A-T,rs1534232,-1,A,T,55641345,188242,55632979,56026195,8366
12,ENSG00000135392.10,55829587,12-55641345-A-C,rs1534232,-1,A,C,55641345,188242,55632979,56026195,8366
12,ENSG00000110931.12,121296709,12-121354289-T-C,rs1617736,-1,T,C,121354289,57580,121100101,121493317,254188
12,ENSG00000110931.12,121296709,12-121354289-T-A,rs1617736,-1,T,A,121354289,57580,121100101,121493317,254188
12,ENSG00000089053.7,121352411,12-121354289-T-C,rs1617736,-1,T,C,121354289,1878,121155803,121549019,198486
12,ENSG00000089053.7,121352411,12-121354289-T-A,rs1617736,-1,T,A,121354289,1878,121155803,121549019,198486
12,ENSG00000111254.2,4649051,12-4602071-T-G,rs16931572,-1,T,G,4602071,46980,4452443,4845659,149628
12,ENSG00000151176.3,113358587,12-113440586-T-G,rs16934262,1,T,G,113440586,81999,113161979,113555195,278607
12,ENSG00000174456.7,110048522,12-109936977-G-A,rs16940707,-1,G,A,109936977,111545,109851914,110245130,85063
12,ENSG00000111344.7,113135761,12-113244225-T-A,rs16942667,-1,T,A,113244225,108464,112939153,113332369,305072
12,ENSG00000111344.7,113135761,12-113244225-T-C,rs16942667,-1,T,C,113244225,108464,112939153,113332369,305072
12,ENSG00000180481.6,75391089,12-75502908-A-C,rs1697752,1,A,C,75502908,111819,75194481,75587697,308427
12,ENSG00000179104.3,82686906,12-82809963-G-T,rs17009997,1,G,T,82809963,123057,82490298,82883514,319665
12,ENSG00000259075.1,89526198,12-89400809-T-C,rs17016837,-1,T,C,89400809,125389,89329590,89722806,71219
12,ENSG00000171310.6,104456948,12-104315967-G-A,rs17035358,1,G,A,104315967,140981,104260340,104653556,55627
12,ENSG00000135437.5,55720393,12-55629199-T-G,rs17117817,1,T,G,55629199,91194,55523785,55917001,105414
12,ENSG00000135469.9,56266942,12-56208214-G-A,rs17118378,1,G,A,56208214,58728,56070334,56463550,137880
12,ENSG00000111057.6,52949118,12-52813655-G-T,rs17119475,1,G,T,52813655,135463,52752510,53145726,61145
12,ENSG00000111057.6,52949118,12-52813655-G-C,rs17119475,1,G,C,52813655,135463,52752510,53145726,61145
12,ENSG00000111057.6,52949118,12-52813655-G-A,rs17119475,1,G,A,52813655,135463,52752510,53145726,61145
12,ENSG00000155974.7,66679076,12-66572221-T-C,rs17181487,-1,T,C,66572221,106855,66482468,66875684,89753
12,ENSG00000205426.5,52291534,12-52194345-C-T,rs17653752,-1,C,T,52194345,97189,52094926,52488142,99419
12,ENSG00000139433.4,109880541,12-109916731-C-T,rs17680262,-1,C,T,109916731,36190,109683933,110077149,232798
12,ENSG00000139433.4,109880541,12-109916731-C-G,rs17680262,-1,C,G,109916731,36190,109683933,110077149,232798
12,ENSG00000204856.7,110468845,12-110656649-C-T,rs17682012,1,C,T,110656649,187804,110272237,110665453,384412
12,ENSG00000078237.4,4321213,12-4353432-T-C,rs17700406,1,T,C,4353432,32219,4124605,4517821,228827
12,ENSG00000078237.4,4321213,12-4353432-T-A,rs17700406,1,T,A,4353432,32219,4124605,4517821,228827
12,ENSG00000130038.5,3753109,12-3750283-G-A,rs17836356,-1,G,A,3750283,2826,3556501,3949717,193782
12,ENSG00000175197.5,57520514,12-57530648-A-G,rs1802914,-1,A,G,57530648,10134,57323906,57717122,206742
12,ENSG00000175197.5,57520514,12-57530648-A-C,rs1802914,-1,A,C,57530648,10134,57323906,57717122,206742
12,ENSG00000111245.8,110920579,12-110851890-G-T,rs1858887,-1,G,T,110851890,68689,110723971,111117187,127919
12,ENSG00000111245.8,110920579,12-110851890-G-A,rs1858887,-1,G,A,110851890,68689,110723971,111117187,127919
12,ENSG00000111087.4,57459785,12-57625414-C-T,rs1871415,1,C,T,57625414,165629,57263177,57656393,362237
12,ENSG00000111087.4,57459785,12-57625414-C-G,rs1871415,1,C,G,57625414,165629,57263177,57656393,362237
12,ENSG00000086598.4,123584552,12-123721649-T-G,rs1878077,1,T,G,123721649,137097,123387944,123781160,333705
12,ENSG00000086598.4,123584552,12-123721649-T-A,rs1878077,1,T,A,123721649,137097,123387944,123781160,333705
12,ENSG00000086598.4,123584552,12-123721649-T-C,rs1878077,1,T,C,123721649,137097,123387944,123781160,333705
12,ENSG00000166578.4,113221094,12-113062323-G-A,rs1902953,-1,G,A,113062323,158771,113024486,113417702,37837
12,ENSG00000139112.6,10212877,12-10024398-A-G,rs1979592,1,A,G,10024398,188479,10016269,10409485,8129
12,ENSG00000111790.9,26938470,12-27104833-G-A,rs2003380,1,G,A,27104833,166363,26741862,27135078,362971
12,ENSG00000013588.5,12891562,12-13036813-C-T,rs2087052,1,C,T,13036813,145251,12694954,13088170,341859
12,ENSG00000139354.6,100573684,12-100677849-G-T,rs2114923,1,G,T,100677849,104165,100377076,100770292,300773
12,ENSG00000139354.6,100573684,12-100677849-G-C,rs2114923,1,G,C,100677849,104165,100377076,100770292,300773
12,ENSG00000139354.6,100573684,12-100677849-G-A,rs2114923,1,G,A,100677849,104165,100377076,100770292,300773
12,ENSG00000139726.6,122752824,12-122769991-A-G,rs2154,1,A,G,122769991,17167,122556216,122949432,213775
12,ENSG00000139726.6,122752824,12-122769991-A-T,rs2154,1,A,T,122769991,17167,122556216,122949432,213775
12,ENSG00000089163.4,120302321,12-120250322-T-G,rs2239208,1,T,G,120250322,51999,120105713,120498929,144609
12,ENSG00000089163.4,120302321,12-120250322-T-A,rs2239208,1,T,A,120250322,51999,120105713,120498929,144609
12,ENSG00000089163.4,120302321,12-120250322-T-C,rs2239208,1,T,C,120250322,51999,120105713,120498929,144609
12,ENSG00000050426.9,51048327,12-51005267-T-A,rs224589,1,T,A,51005267,43060,50851719,51244935,153548
12,ENSG00000050426.9,51048327,12-51005267-T-C,rs224589,1,T,C,51005267,43060,50851719,51244935,153548
12,ENSG00000050426.9,51048327,12-51005267-T-G,rs224589,1,T,G,51005267,43060,50851719,51244935,153548
12,ENSG00000255150.1,104303739,12-104445465-G-T,rs2254711,1,G,T,104445465,141726,104107131,104500347,338334
12,ENSG00000255150.1,104303739,12-104445465-G-A,rs2254711,1,G,A,104445465,141726,104107131,104500347,338334
12,ENSG00000255150.1,104303739,12-104445465-G-C,rs2254711,1,G,C,104445465,141726,104107131,104500347,338334
12,ENSG00000166881.5,57078791,12-57048355-A-G,rs2270737,-1,A,G,57048355,30436,56882183,57275399,166172
12,ENSG00000110958.10,56688284,12-56752285-T-G,rs2277339,-1,T,G,56752285,64001,56491676,56884892,260609
12,ENSG00000110958.10,56688284,12-56752285-T-A,rs2277339,-1,T,A,56752285,64001,56491676,56884892,260609
12,ENSG00000139626.9,53207251,12-53103914-A-G,rs2280699,-1,A,G,53103914,103337,53010643,53403859,93271
12,ENSG00000110799.9,6124670,12-6065563-G-A,rs2283332,-1,G,A,6065563,59107,5928062,6321278,137501
12,ENSG00000110799.9,6124670,12-6065563-G-C,rs2283332,-1,G,C,6065563,59107,5928062,6321278,137501
12,ENSG00000139579.7,56224342,12-56420869-G-A,rs2291739,1,G,A,56420869,196527,56027734,56420950,393135
12,ENSG00000139579.7,56224342,12-56420869-G-C,rs2291739,1,G,C,56420869,196527,56027734,56420950,393135
12,ENSG00000170627.5,54473602,12-54584141-T-G,rs2292490,-1,T,G,54584141,110539,54276994,54670210,307147
12,ENSG00000170627.5,54473602,12-54584141-T-A,rs2292490,-1,T,A,54584141,110539,54276994,54670210,307147
12,ENSG00000167272.6,120581402,12-120579461-C-A,rs2301456,-1,C,A,120579461,1941,120384794,120778010,194667
12,ENSG00000167272.6,120581402,12-120579461-C-T,rs2301456,-1,C,T,120579461,1941,120384794,120778010,194667
12,ENSG00000123106.6,28190456,12-28084361-G-T,rs231210,1,G,T,28084361,106095,27993848,28387064,90513
12,ENSG00000111348.4,14961601,12-15039880-A-G,rs2417414,-1,A,G,15039880,78279,14764993,15158209,274887
12,ENSG00000136044.7,105236174,12-105096145-C-T,rs2440693,-1,C,T,105096145,140029,105039566,105432782,56579
12,ENSG00000134287.4,48957487,12-48831975-C-T,rs2453471,-1,C,T,48831975,125512,48760879,49154095,71096
12,ENSG00000135144.3,113056730,12-113107069-C-T,rs2468355,1,C,T,113107069,50339,112860122,113253338,246947
12,ENSG00000135144.3,113056730,12-113107069-C-G,rs2468355,1,C,G,113107069,50339,112860122,113253338,246947
12,ENSG00000170855.3,120446384,12-120333354-A-G,rs2522136,-1,A,G,120333354,113030,120249776,120642992,83578
12,ENSG00000139343.6,95858952,12-96041102-C-T,rs2540482,1,C,T,96041102,182150,95662344,96055560,378758
12,ENSG00000087448.5,27780233,12-27852721-G-A,rs258396,1,G,A,27852721,72488,27583625,27976841,269096
12,ENSG00000136026.9,106248020,12-106237017-G-T,rs2649718,-1,G,T,106237017,11003,106051412,106444628,185605
12,ENSG00000136026.9,106248020,12-106237017-G-C,rs2649718,-1,G,C,106237017,11003,106051412,106444628,185605
12,ENSG00000136026.9,106248020,12-106237017-G-A,rs2649718,-1,G,A,106237017,11003,106051412,106444628,185605
12,ENSG00000076067.6,56521820,12-56535910-C-T,rs2657896,1,C,T,56535910,14090,56325212,56718428,210698
12,ENSG00000198001.8,43758951,12-43604023-T-A,rs277248,1,T,A,43604023,154928,43562343,43955559,41680
12,ENSG00000198001.8,43758951,12-43604023-T-G,rs277248,1,T,G,43604023,154928,43562343,43955559,41680
12,ENSG00000198001.8,43758951,12-43604023-T-C,rs277248,1,T,C,43604023,154928,43562343,43955559,41680
12,ENSG00000188026.7,123533719,12-123427242-A-T,rs28466887,-1,A,T,123427242,106477,123337111,123730327,90131
12,ENSG00000188026.7,123533719,12-123427242-A-G,rs28466887,-1,A,G,123427242,106477,123337111,123730327,90131
12,ENSG00000188026.7,123533719,12-123427242-A-C,rs28466887,-1,A,C,123427242,106477,123337111,123730327,90131
12,ENSG00000111328.2,123271856,12-123427242-A-T,rs28466887,-1,A,T,123427242,155386,123075248,123468464,351994
12,ENSG00000111328.2,123271856,12-123427242-A-G,rs28466887,-1,A,G,123427242,155386,123075248,123468464,351994
12,ENSG00000111328.2,123271856,12-123427242-A-C,rs28466887,-1,A,C,123427242,155386,123075248,123468464,351994
12,ENSG00000150977.9,123436684,12-123433046-A-C,rs28531860,-1,A,C,123433046,3638,123240076,123633292,192970
12,ENSG00000150977.9,123436684,12-123433046-A-G,rs28531860,-1,A,G,123433046,3638,123240076,123633292,192970
12,ENSG00000134532.10,23949670,12-23997507-G-C,rs2900528,-1,G,C,23997507,47837,23753062,24146278,244445
12,ENSG00000135414.5,55743122,12-55725049-G-A,rs3138134,1,G,A,55725049,18073,55546514,55939730,178535
12,ENSG00000135404.6,55729009,12-55722099-T-C,rs3138139,-1,T,C,55722099,6910,55532401,55925617,189698
12,ENSG00000212126.3,10986912,12-10834637-C-T,rs34059605,-1,C,T,10834637,152275,10790304,11183520,44333
12,ENSG00000212126.3,10986912,12-10834637-C-A,rs34059605,-1,C,A,10834637,152275,10790304,11183520,44333
12,ENSG00000178878.7,12785659,12-12717761-T-C,rs34330,1,T,C,12717761,67898,12589051,12982267,128710
12,ENSG00000166860.2,57006546,12-57154581-T-C,rs34574998,-1,T,C,57154581,148035,56809938,57203154,344643
12,ENSG00000110944.4,56338884,12-56433969-A-G,rs34697596,1,A,G,56433969,95085,56142276,56535492,291693
12,ENSG00000151065.9,2004457,12-1955436-T-C,rs34730825,-1,T,C,1955436,49021,1807849,2201065,147587
12,ENSG00000065361.7,56080165,12-56137837-C-T,rs35807059,1,C,T,56137837,57672,55883557,56276773,254280
12,ENSG00000065361.7,56080165,12-56137837-C-G,rs35807059,1,C,G,56137837,57672,55883557,56276773,254280
12,ENSG00000167588.7,50104008,12-49911431-G-T,rs368305,1,G,T,49911431,192577,49907400,50300616,4031
12,ENSG00000167588.7,50104008,12-49911431-G-A,rs368305,1,G,A,49911431,192577,49907400,50300616,4031
12,ENSG00000167588.7,50104008,12-49911431-G-C,rs368305,1,G,C,49911431,192577,49907400,50300616,4031
12,ENSG00000139620.8,48682238,12-48654955-G-A,rs3741628,-1,G,A,48654955,27283,48485630,48878846,169325
12,ENSG00000139620.8,48682238,12-48654955-G-T,rs3741628,-1,G,T,48654955,27283,48485630,48878846,169325
12,ENSG00000122966.9,119877320,12-119686892-T-C,rs3742046,-1,T,C,119686892,190428,119680712,120073928,6180
12,ENSG00000029153.10,27332836,12-27385722-A-G,rs3751221,1,A,G,27385722,52886,27136228,27529444,249494
12,ENSG00000029153.10,27332836,12-27385722-A-C,rs3751221,1,A,C,27385722,52886,27136228,27529444,249494
12,ENSG00000165714.6,12357078,12-12465493-C-G,rs3751261,1,C,G,12465493,108415,12160470,12553686,305023
12,ENSG00000165714.6,12357078,12-12465493-C-T,rs3751261,1,C,T,12465493,108415,12160470,12553686,305023
12,ENSG00000176422.9,56468578,12-56562429-T-A,rs3759091,1,T,A,56562429,93851,56271970,56665186,290459
12,ENSG00000176422.9,56468578,12-56562429-T-G,rs3759091,1,T,G,56562429,93851,56271970,56665186,290459
12,ENSG00000176422.9,56468578,12-56562429-T-C,rs3759091,1,T,C,56562429,93851,56271970,56665186,290459
12,ENSG00000010278.6,6200400,12-6306828-T-C,rs3759322,1,T,C,6306828,106428,6003792,6397008,303036
12,ENSG00000122965.6,113966325,12-113821920-C-T,rs3782422,-1,C,T,113821920,144405,113769717,114162933,52203
12,ENSG00000122965.6,113966325,12-113821920-C-A,rs3782422,-1,C,A,113821920,144405,113769717,114162933,52203
12,ENSG00000213782.3,12813346,12-12992523-C-T,rs3782568,1,C,T,12992523,179177,12616738,13009954,375785
12,ENSG00000213782.3,12813346,12-12992523-C-A,rs3782568,1,C,A,12992523,179177,12616738,13009954,375785
12,ENSG00000166886.8,57089114,12-57059089-T-C,rs3803017,1,T,C,57059089,30025,56892506,57285722,166583
12,ENSG00000171823.6,1594581,12-1616955-C-T,rs3809268,-1,C,T,1616955,22374,1397973,1791189,218982
12,ENSG00000118600.6,63779909,12-63897344-C-A,rs3851606,1,C,A,63897344,117435,63583301,63976517,314043
12,ENSG00000118600.6,63779909,12-63897344-C-T,rs3851606,1,C,T,63897344,117435,63583301,63976517,314043
12,ENSG00000139372.10,103965872,12-103969832-C-T,rs4135054,1,C,T,103969832,3960,103769264,104162480,200568
12,ENSG00000111641.6,6568291,12-6385344-C-T,rs41393248,-1,C,T,6385344,182947,6371683,6764899,13661
12,ENSG00000102189.11,92929295,12-92943408-G-A,rs4529920,-1,G,A,92943408,14113,92732687,93125903,210721
12,ENSG00000102189.11,92929295,12-92943408-G-C,rs4529920,-1,G,C,92943408,14113,92732687,93125903,210721
12,ENSG00000102189.11,92929295,12-92943408-G-T,rs4529920,-1,G,T,92943408,14113,92732687,93125903,210721
12,ENSG00000166896.3,57941567,12-57832121-T-C,rs4760171,1,T,C,57832121,109446,57744959,58138175,87162
12,ENSG00000166896.3,57941567,12-57832121-T-A,rs4760171,1,T,A,57832121,109446,57744959,58138175,87162
12,ENSG00000151948.7,128853478,12-128842826-G-A,rs4760524,1,G,A,128842826,10652,128656870,129050086,185956
12,ENSG00000171681.8,14365682,12-14275184-G-A,rs4764074,1,G,A,14275184,90498,14169074,14562290,106110
12,ENSG00000089693.6,6753141,12-6770036-T-A,rs4764622,-1,T,A,6770036,16895,6556533,6949749,213503
12,ENSG00000089693.6,6753141,12-6770036-T-G,rs4764622,-1,T,G,6770036,16895,6556533,6949749,213503
12,ENSG00000089693.6,6753141,12-6770036-T-C,rs4764622,-1,T,C,6770036,16895,6556533,6949749,213503
12,ENSG00000011105.7,3077379,12-3083861-C-T,rs4766042,1,C,T,3083861,6482,2880771,3273987,203090
12,ENSG00000011105.7,3077379,12-3083861-C-G,rs4766042,1,C,G,3083861,6482,2880771,3273987,203090
12,ENSG00000172322.8,9971409,12-9968689-C-A,rs479809,1,C,A,9968689,2720,9774801,10168017,193888
12,ENSG00000063046.12,53006456,12-53037083-T-C,rs4919699,1,T,C,53037083,30627,52809848,53203064,227235
12,ENSG00000063046.12,53006456,12-53037083-T-A,rs4919699,1,T,A,53037083,30627,52809848,53203064,227235
12,ENSG00000111665.6,6851286,12-6716993-C-T,rs55677006,-1,C,T,6716993,134293,6654678,7047894,62315
12,ENSG00000111665.6,6851286,12-6716993-C-G,rs55677006,-1,C,G,6716993,134293,6654678,7047894,62315
12,ENSG00000183395.4,102197833,12-102363228-C-T,rs55680094,-1,C,T,102363228,165395,102001225,102394441,362003
12,ENSG00000182782.6,122703357,12-122813355-C-T,rs55716280,-1,C,T,122813355,109998,122506749,122899965,306606
12,ENSG00000130783.9,122774572,12-122813355-C-T,rs55716280,1,C,T,122813355,38783,122577964,122971180,235391
12,ENSG00000176894.5,132687587,12-132677497-T-C,rs5744750,1,T,C,132677497,10090,132490979,132884195,186518
12,ENSG00000255398.2,122716811,12-122672004-T-A,rs598322,-1,T,A,122672004,44807,122520203,122913419,151801
12,ENSG00000255398.2,122716811,12-122672004-T-C,rs598322,-1,T,C,122672004,44807,122520203,122913419,151801
12,ENSG00000255398.2,122716811,12-122672004-T-G,rs598322,-1,T,G,122672004,44807,122520203,122913419,151801
12,ENSG00000002016.11,949694,12-972489-A-G,rs61917242,-1,A,G,972489,22795,753086,1146302,219403
12,ENSG00000121380.7,12070939,12-11894540-T-C,rs61921366,1,T,C,11894540,176399,11874331,12267547,20209
12,ENSG00000186666.4,49843106,12-50031663-C-T,rs61926112,-1,C,T,50031663,188557,49646498,50039714,385165
12,ENSG00000150991.9,124914650,12-125042088-T-C,rs61943926,-1,T,C,125042088,127438,124718042,125111258,324046
12,ENSG00000111726.8,22046218,12-22054730-T-G,rs6487267,1,T,G,22054730,8512,21849610,22242826,205120
12,ENSG00000111726.8,22046218,12-22054730-T-C,rs6487267,1,T,C,22054730,8512,21849610,22242826,205120
12,ENSG00000111728.5,22334707,12-22411548-A-G,rs6487303,-1,A,G,22411548,76841,22138099,22531315,273449
12,ENSG00000111728.5,22334707,12-22411548-A-T,rs6487303,-1,A,T,22411548,76841,22138099,22531315,273449
12,ENSG00000110900.10,30926748,12-30986334-C-T,rs6487954,1,C,T,30986334,59586,30730140,31123356,256194
12,ENSG00000060138.8,10723323,12-10559934-T-C,rs6488306,-1,T,C,10559934,163389,10526715,10919931,33219
12,ENSG00000212128.2,10909562,12-10966520-T-G,rs6488331,-1,T,G,10966520,56958,10712954,11106170,253566
12,ENSG00000212128.2,10909562,12-10966520-T-A,rs6488331,-1,T,A,10966520,56958,10712954,11106170,253566
12,ENSG00000212128.2,10909562,12-10966520-T-C,rs6488331,-1,T,C,10966520,56958,10712954,11106170,253566
12,ENSG00000175970.6,120710458,12-120613482-A-T,rs6490296,1,A,T,120613482,96976,120513850,120907066,99632
12,ENSG00000175970.6,120710458,12-120613482-A-C,rs6490296,1,A,C,120613482,96976,120513850,120907066,99632
12,ENSG00000175970.6,120710458,12-120613482-A-G,rs6490296,1,A,G,120613482,96976,120513850,120907066,99632
12,ENSG00000110934.5,51324174,12-51360586-A-G,rs6580827,-1,A,G,51360586,36412,51127566,51520782,233020
12,ENSG00000110934.5,51324174,12-51360586-A-T,rs6580827,-1,A,T,51360586,36412,51127566,51520782,233020
12,ENSG00000123395.10,52069978,12-51884562-T-C,rs706830,1,T,C,51884562,185416,51873370,52266586,11192
12,ENSG00000111145.3,96194375,12-96192843-G-A,rs7132101,1,G,A,96192843,1532,95997767,96390983,195076
12,ENSG00000139200.7,6700815,12-6568437-A-G,rs71445110,-1,A,G,6568437,132378,6504207,6897423,64230
12,ENSG00000139044.6,459939,12-555328-G-A,rs71447498,1,G,A,555328,95389,263331,656547,291997
12,ENSG00000185482.3,57251187,12-57093994-G-C,rs71461312,-1,G,C,57093994,157193,57054579,57447795,39415
12,ENSG00000213809.4,10390041,12-10494567-C-T,rs7295241,-1,C,T,10494567,104526,10193433,10586649,301134
12,ENSG00000159335.9,6766363,12-6745677-A-T,rs7296292,1,A,T,6745677,20686,6569755,6962971,175922
12,ENSG00000159335.9,6766363,12-6745677-A-G,rs7296292,1,A,G,6745677,20686,6569755,6962971,175922
12,ENSG00000012822.9,53727452,12-53923935-G-A,rs7297554,-1,G,A,53923935,196483,53530844,53924060,393091
12,ENSG00000012822.9,53727452,12-53923935-G-C,rs7297554,-1,G,C,53923935,196483,53530844,53924060,393091
12,ENSG00000187109.8,76084685,12-76019714-G-A,rs7297654,-1,G,A,76019714,64971,75888077,76281293,131637
12,ENSG00000187109.8,76084685,12-76019714-G-T,rs7297654,-1,G,T,76019714,64971,75888077,76281293,131637
12,ENSG00000057704.6,94650557,12-94594711-C-G,rs7301498,-1,C,G,94594711,55846,94453949,94847165,140762
12,ENSG00000057704.6,94650557,12-94594711-C-A,rs7301498,-1,C,A,94594711,55846,94453949,94847165,140762
12,ENSG00000134551.7,10929236,12-10998431-T-C,rs7301545,1,T,C,10998431,69195,10732628,11125844,265803
12,ENSG00000134551.7,10929236,12-10998431-T-A,rs7301545,1,T,A,10998431,69195,10732628,11125844,265803
12,ENSG00000134551.7,10929236,12-10998431-T-G,rs7301545,1,T,G,10998431,69195,10732628,11125844,265803
12,ENSG00000087494.10,27972733,12-27852908-C-T,rs7304170,-1,C,T,27852908,119825,27776125,28169341,76783
12,ENSG00000161800.8,50025494,12-49947682-T-C,rs7305290,-1,T,C,49947682,77812,49828886,50222102,118796
12,ENSG00000139344.3,95943331,12-95988866-A-G,rs7308827,1,A,G,95988866,45535,95746723,96139939,242143
12,ENSG00000073060.9,124863864,12-124939956-A-C,rs7309029,-1,A,C,124939956,76092,124667256,125060472,272700
12,ENSG00000073060.9,124863864,12-124939956-A-G,rs7309029,-1,A,G,124939956,76092,124667256,125060472,272700
12,ENSG00000073060.9,124863864,12-124939956-A-T,rs7309029,-1,A,T,124939956,76092,124667256,125060472,272700
12,ENSG00000123095.4,26125037,12-26053556-A-G,rs7309394,-1,A,G,26053556,71481,25928429,26321645,125127
12,ENSG00000123095.4,26125037,12-26053556-A-C,rs7309394,-1,A,C,26053556,71481,25928429,26321645,125127
12,ENSG00000175189.2,57434784,12-57319441-C-T,rs73121803,1,C,T,57319441,115343,57238176,57631392,81265
12,ENSG00000139190.11,6470677,12-6440585-T-C,rs7312492,-1,T,C,6440585,30092,6274069,6667285,166516
12,ENSG00000139190.11,6470677,12-6440585-T-A,rs7312492,-1,T,A,6440585,30092,6274069,6667285,166516
12,ENSG00000139190.11,6470677,12-6440585-T-G,rs7312492,-1,T,G,6440585,30092,6274069,6667285,166516
12,ENSG00000110848.4,9760901,12-9876915-T-A,rs7313246,-1,T,A,9876915,116014,9564293,9957509,312622
12,ENSG00000110848.4,9760901,12-9876915-T-C,rs7313246,-1,T,C,9876915,116014,9564293,9957509,312622
12,ENSG00000255837.1,10998304,12-11119593-T-A,rs7313683,-1,T,A,11119593,121289,10801696,11194912,317897
12,ENSG00000255837.1,10998304,12-11119593-T-G,rs7313683,-1,T,G,11119593,121289,10801696,11194912,317897
12,ENSG00000255837.1,10998304,12-11119593-T-C,rs7313683,-1,T,C,11119593,121289,10801696,11194912,317897
12,ENSG00000111707.7,118376555,12-118458665-A-G,rs7316050,1,A,G,118458665,82110,118179947,118573163,278718
12,ENSG00000111707.7,118376555,12-118458665-A-T,rs7316050,1,A,T,118458665,82110,118179947,118573163,278718
12,ENSG00000184967.2,132144457,12-132220238-G-A,rs73166871,1,G,A,132220238,75781,131947849,132341065,272389
12,ENSG00000110851.7,107761137,12-107685408-G-A,rs744266,-1,G,A,107685408,75729,107564529,107957745,120879
12,ENSG00000064115.6,27014384,12-26876810-A-C,rs74571560,-1,A,C,26876810,137574,26817776,27210992,59034
12,ENSG00000151079.6,4809176,12-4809744-A-T,rs758533,1,A,T,4809744,568,4612568,5005784,197176
12,ENSG00000151079.6,4809176,12-4809744-A-G,rs758533,1,A,G,4809744,568,4612568,5005784,197176
12,ENSG00000127311.5,66302493,12-66442403-T-C,rs76103439,1,T,C,66442403,139910,66105885,66499101,336518
12,ENSG00000171840.7,663445,12-509472-G-A,rs76241792,-1,G,A,509472,153973,466837,860053,42635
12,ENSG00000182870.8,132329589,12-132302412-C-G,rs76635593,-1,C,G,132302412,27177,132132981,132526197,169431
12,ENSG00000182870.8,132329589,12-132302412-C-T,rs76635593,-1,C,T,132302412,27177,132132981,132526197,169431
12,ENSG00000070019.3,14696599,12-14749688-G-A,rs76736003,-1,G,A,14749688,53089,14499991,14893207,249697
12,ENSG00000130787.8,122835457,12-122803766-T-A,rs77422670,1,T,A,122803766,31691,122638849,123032065,164917
12,ENSG00000130787.8,122835457,12-122803766-T-G,rs77422670,1,T,G,122803766,31691,122638849,123032065,164917
12,ENSG00000130787.8,122835457,12-122803766-T-C,rs77422670,1,T,C,122803766,31691,122638849,123032065,164917
12,ENSG00000139269.2,57455307,12-57625712-C-G,rs774894,1,C,G,57625712,170405,57258699,57651915,367013
12,ENSG00000139269.2,57455307,12-57625712-C-A,rs774894,1,C,A,57625712,170405,57258699,57651915,367013
12,ENSG00000139269.2,57455307,12-57625712-C-T,rs774894,1,C,T,57625712,170405,57258699,57651915,367013
12,ENSG00000111325.12,122975220,12-122854588-T-A,rs78501984,1,T,A,122854588,120632,122778612,123171828,75976
12,ENSG00000111325.12,122975220,12-122854588-T-G,rs78501984,1,T,G,122854588,120632,122778612,123171828,75976
12,ENSG00000111325.12,122975220,12-122854588-T-C,rs78501984,1,T,C,122854588,120632,122778612,123171828,75976
12,ENSG00000180881.14,75326498,12-75250898-C-T,rs78689356,-1,C,T,75250898,75600,75129890,75523106,121008
12,ENSG00000184992.9,124993645,12-125112845-A-G,rs7954882,1,A,G,125112845,119200,124797037,125190253,315808
12,ENSG00000184992.9,124993645,12-125112845-A-T,rs7954882,1,A,T,125112845,119200,124797037,125190253,315808
12,ENSG00000050438.9,51424831,12-51385537-C-G,rs7955523,1,C,G,51385537,39294,51228223,51621439,157314
12,ENSG00000050438.9,51424831,12-51385537-C-T,rs7955523,1,C,T,51385537,39294,51228223,51621439,157314
12,ENSG00000139722.2,122896124,12-122889778-A-G,rs7956122,-1,A,G,122889778,6346,122699516,123092732,190262
12,ENSG00000136045.5,107685799,12-107575375-T-C,rs7957506,1,T,C,107575375,110424,107489191,107882407,86184
12,ENSG00000111371.10,46269043,12-46175664-A-G,rs7958854,-1,A,G,46175664,93379,46072435,46465651,103229
12,ENSG00000135441.3,55716046,12-55713907-T-C,rs7959622,1,T,C,55713907,2139,55519438,55912654,194469
12,ENSG00000179195.9,123973215,12-124152553-T-G,rs7961727,1,T,G,124152553,179338,123776607,124169823,375946
12,ENSG00000198015.7,93467514,12-93391758-G-T,rs7964255,1,G,T,93391758,75756,93270906,93664122,120852
12,ENSG00000198015.7,93467514,12-93391758-G-A,rs7964255,1,G,A,93391758,75756,93270906,93664122,120852
12,ENSG00000198015.7,93467514,12-93391758-G-C,rs7964255,1,G,C,93391758,75756,93270906,93664122,120852
12,ENSG00000135407.6,57818734,12-57983284-C-A,rs7964378,-1,C,A,57983284,164550,57622126,58015342,361158
12,ENSG00000135407.6,57818734,12-57983284-C-T,rs7964378,-1,C,T,57983284,164550,57622126,58015342,361158
12,ENSG00000139531.7,55997276,12-56186042-C-T,rs79659813,1,C,T,56186042,188766,55800668,56193884,385374
12,ENSG00000139531.7,55997276,12-56186042-C-G,rs79659813,1,C,G,56186042,188766,55800668,56193884,385374
12,ENSG00000198270.6,112013165,12-112145643-A-C,rs79680080,-1,A,C,112145643,132478,111816557,112209773,329086
12,ENSG00000176915.10,132761832,12-132602494-G-A,rs7971908,-1,G,A,132602494,159338,132565224,132958440,37270
12,ENSG00000176915.10,132761832,12-132602494-G-C,rs7971908,-1,G,C,132602494,159338,132565224,132958440,37270
12,ENSG00000070018.4,12267044,12-12085113-C-T,rs7972613,-1,C,T,12085113,181931,12070436,12463652,14677
12,ENSG00000070018.4,12267044,12-12085113-C-A,rs7972613,-1,C,A,12085113,181931,12070436,12463652,14677
12,ENSG00000070018.4,12267044,12-12085113-C-G,rs7972613,-1,C,G,12085113,181931,12070436,12463652,14677
12,ENSG00000023734.6,15882387,12-15736802-G-A,rs7972816,1,G,A,15736802,145585,15685779,16078995,51023
12,ENSG00000184752.8,95003697,12-94967935-C-G,rs7974156,-1,C,G,94967935,35762,94807089,95200305,160846
12,ENSG00000184752.8,95003697,12-94967935-C-T,rs7974156,-1,C,T,94967935,35762,94807089,95200305,160846
12,ENSG00000167535.3,48818496,12-48797209-T-C,rs7975385,1,T,C,48797209,21287,48621888,49015104,175321
12,ENSG00000120868.9,98645290,12-98629196-T-A,rs7978134,1,T,A,98629196,16094,98448682,98841898,180514
12,ENSG00000120868.9,98645290,12-98629196-T-C,rs7978134,1,T,C,98629196,16094,98448682,98841898,180514
12,ENSG00000120868.9,98645290,12-98629196-T-G,rs7978134,1,T,G,98629196,16094,98448682,98841898,180514
12,ENSG00000255374.1,11092313,12-11225664-C-T,rs80325732,-1,C,T,11225664,133351,10895705,11288921,329959
12,ENSG00000111196.5,10613609,12-10622218-A-C,rs897880,-1,A,C,10622218,8609,10417001,10810217,205217
12,ENSG00000111196.5,10613609,12-10622218-A-G,rs897880,-1,A,G,10622218,8609,10417001,10810217,205217
12,ENSG00000183283.9,51238826,12-51359113-G-A,rs907347,1,G,A,51359113,120287,51042218,51435434,316895
12,ENSG00000183283.9,51238826,12-51359113-G-C,rs907347,1,G,C,51359113,120287,51042218,51435434,316895
12,ENSG00000139168.3,42326094,12-42507393-C-T,rs921530,-1,C,T,42507393,181299,42129486,42522702,377907
12,ENSG00000139168.3,42326094,12-42507393-C-A,rs921530,-1,C,A,42507393,181299,42129486,42522702,377907
12,ENSG00000174236.2,27696447,12-27699497-T-C,rs929952,1,T,C,27699497,3050,27499839,27893055,199658
12,ENSG00000166598.7,103930410,12-103926431-G-A,rs9308316,1,G,A,103926431,3979,103733802,104127018,192629
12,ENSG00000166598.7,103930410,12-103926431-G-C,rs9308316,1,G,C,103926431,3979,103733802,104127018,192629
12,ENSG00000167566.11,49828413,12-49896240-T-C,rs956864,-1,T,C,49896240,67827,49631805,50025021,264435
12,ENSG00000167566.11,49828413,12-49896240-T-A,rs956864,-1,T,A,49896240,67827,49631805,50025021,264435
12,ENSG00000176834.9,118104011,12-118073921-C-T,rs9668527,-1,C,T,118073921,30090,117907403,118300619,166518
12,ENSG00000139370.6,128823958,12-128797293-A-G,rs9738836,-1,A,G,128797293,26665,128627350,129020566,169943
11,ENSG00000174791.6,66336434,11-66322561-C-A,rs10219183,-1,C,A,66322561,13873,66139826,66533042,182735
11,ENSG00000175634.8,67428494,11-67435355-G-T,rs10274,1,G,T,67435355,6861,67231886,67625102,203469
11,ENSG00000175634.8,67428494,11-67435355-G-A,rs10274,1,G,A,67435355,6861,67231886,67625102,203469
11,ENSG00000162105.9,71252577,11-71255951-C-T,rs10431158,-1,C,T,71255951,3374,71055969,71449185,199982
11,ENSG00000148926.5,10305073,11-10213811-T-C,rs10500722,1,T,C,10213811,91262,10108465,10501681,105346
11,ENSG00000148926.5,10305073,11-10213811-T-A,rs10500722,1,T,A,10213811,91262,10108465,10501681,105346
11,ENSG00000148926.5,10305073,11-10213811-T-G,rs10500722,1,T,G,10213811,91262,10108465,10501681,105346
11,ENSG00000110777.7,111379275,11-111350829-C-T,rs10502141,-1,C,T,111350829,28446,111182667,111575883,168162
11,ENSG00000110777.7,111379275,11-111350829-C-A,rs10502141,-1,C,A,111350829,28446,111182667,111575883,168162
11,ENSG00000160588.5,118252365,11-118254910-T-C,rs1056562,-1,T,C,118254910,2545,118055757,118448973,199153
11,ENSG00000160588.5,118252365,11-118254910-T-G,rs1056562,-1,T,G,118254910,2545,118055757,118448973,199153
11,ENSG00000142102.11,289126,11-295527-T-C,rs1060819,1,T,C,295527,6401,92518,485734,203009
11,ENSG00000149084.7,43680738,11-43856384-C-A,rs1061810,1,C,A,43856384,175646,43484130,43877346,372254
11,ENSG00000148943.7,27506769,11-27499124-T-G,rs10767644,-1,T,G,27499124,7645,27310161,27703377,188963
11,ENSG00000148943.7,27506769,11-27499124-T-C,rs10767644,-1,T,C,27499124,7645,27310161,27703377,188963
11,ENSG00000166199.8,43880831,11-43915395-T-G,rs10768994,1,T,G,43915395,34564,43684223,44077439,231172
11,ENSG00000166199.8,43880831,11-43915395-T-C,rs10768994,1,T,C,43915395,34564,43684223,44077439,231172
11,ENSG00000150768.10,112025408,11-112089809-T-C,rs10789859,1,T,C,112089809,64401,111828800,112222016,261009
11,ENSG00000154134.10,124865432,11-124877437-A-G,rs10790713,1,A,G,124877437,12005,124668824,125062040,208613
11,ENSG00000254470.2,65780976,11-65791795-A-G,rs10791824,-1,A,G,65791795,10819,65584368,65977584,207427
11,ENSG00000254470.2,65780976,11-65791795-A-C,rs10791824,-1,A,C,65791795,10819,65584368,65977584,207427
11,ENSG00000254470.2,65780976,11-65791795-A-T,rs10791824,-1,A,T,65791795,10819,65584368,65977584,207427
11,ENSG00000172818.5,65787063,11-65791795-A-G,rs10791824,1,A,G,65791795,4732,65590455,65983671,201340
11,ENSG00000172818.5,65787063,11-65791795-A-C,rs10791824,1,A,C,65791795,4732,65590455,65983671,201340
11,ENSG00000172818.5,65787063,11-65791795-A-T,rs10791824,1,A,T,65791795,4732,65590455,65983671,201340
11,ENSG00000159063.7,78139626,11-78094190-G-A,rs10793282,-1,G,A,78094190,45436,77943018,78336234,151172
11,ENSG00000205531.6,2992329,11-2860483-T-C,rs10832839,-1,T,C,2860483,131846,2795721,3188937,64762
11,ENSG00000205531.6,2992329,11-2860483-T-A,rs10832839,-1,T,A,2860483,131846,2795721,3188937,64762
11,ENSG00000205531.6,2992329,11-2860483-T-G,rs10832839,-1,T,G,2860483,131846,2795721,3188937,64762
11,ENSG00000179119.9,18634342,11-18624121-T-C,rs10832956,-1,T,C,18624121,10221,18437734,18830950,186387
11,ENSG00000179119.9,18634342,11-18624121-T-A,rs10832956,-1,T,A,18624121,10221,18437734,18830950,186387
11,ENSG00000179119.9,18634342,11-18624121-T-G,rs10832956,-1,T,G,18624121,10221,18437734,18830950,186387
11,ENSG00000129173.6,19240945,11-19187503-T-C,rs10833071,-1,T,C,19187503,53442,19044337,19437553,143166
11,ENSG00000176148.10,33039572,11-33029004-G-A,rs10836006,1,G,A,33029004,10568,32842964,33236180,186040
11,ENSG00000135387.14,34051731,11-33974250-A-G,rs10836136,1,A,G,33974250,77481,33855123,34248339,119127
11,ENSG00000025434.14,47257996,11-47253513-G-C,rs10838681,1,G,C,47253513,4483,47061388,47454604,192125
11,ENSG00000025434.14,47257996,11-47253513-G-A,rs10838681,1,G,A,47253513,4483,47061388,47454604,192125
11,ENSG00000166387.6,7513999,11-7507459-G-A,rs10839795,1,G,A,7507459,6540,7317391,7710607,190068
11,ENSG00000166387.6,7513999,11-7507459-G-T,rs10839795,1,G,T,7507459,6540,7317391,7710607,190068
11,ENSG00000166387.6,7513999,11-7507459-G-C,rs10839795,1,G,C,7507459,6540,7317391,7710607,190068
11,ENSG00000166436.10,8682665,11-8680289-C-T,rs10840106,-1,C,T,8680289,2376,8486057,8879273,194232
11,ENSG00000166436.10,8682665,11-8680289-C-A,rs10840106,-1,C,A,8680289,2376,8486057,8879273,194232
11,ENSG00000180425.6,114400511,11-114262912-G-C,rs10891639,-1,G,C,114262912,137599,114203903,114597119,59009
11,ENSG00000180425.6,114400511,11-114262912-G-T,rs10891639,-1,G,T,114262912,137599,114203903,114597119,59009
11,ENSG00000172927.3,69294155,11-69253571-A-T,rs10896453,1,A,T,69253571,40584,69097547,69490763,156024
11,ENSG00000172927.3,69294155,11-69253571-A-G,rs10896453,1,A,G,69253571,40584,69097547,69490763,156024
11,ENSG00000186660.13,58579063,11-58599088-A-G,rs10896795,1,A,G,58599088,20025,58382455,58775671,216633
11,ENSG00000255151.1,59086307,11-59105487-C-T,rs10896919,1,C,T,59105487,19180,58889699,59282915,215788
11,ENSG00000255151.1,59086307,11-59105487-C-A,rs10896919,1,C,A,59105487,19180,58889699,59282915,215788
11,ENSG00000137501.11,85811141,11-85787404-C-T,rs10898402,-1,C,T,85787404,23737,85614533,86007749,172871
11,ENSG00000137501.11,85811141,11-85787404-C-G,rs10898402,-1,C,G,85787404,23737,85614533,86007749,172871
11,ENSG00000021300.7,73646581,11-73654650-C-T,rs10898929,1,C,T,73654650,8069,73449973,73843189,204677
11,ENSG00000137513.5,78574864,11-78579305-G-A,rs10899559,-1,G,A,78579305,4441,78378256,78771472,201049
11,ENSG00000177595.12,805231,11-810882-G-T,rs10902222,-1,G,T,810882,5651,608623,1001839,202259
11,ENSG00000177595.12,805231,11-810882-G-C,rs10902222,-1,G,C,810882,5651,608623,1001839,202259
11,ENSG00000149231.7,96389912,11-96388691-C-T,rs11021568,-1,C,T,96388691,1221,96193304,96586520,195387
11,ENSG00000149231.7,96389912,11-96388691-C-A,rs11021568,-1,C,A,96388691,1221,96193304,96586520,195387
11,ENSG00000110328.5,11622005,11-11613202-A-C,rs11021956,-1,A,C,11613202,8803,11425397,11818613,187805
11,ENSG00000186104.6,14892231,11-14839971-T-G,rs11023350,-1,T,G,14839971,52260,14695623,15088839,144348
11,ENSG00000110619.12,3057423,11-3228599-G-C,rs11026040,-1,G,C,3228599,171176,2860815,3254031,367784
11,ENSG00000110619.12,3057423,11-3228599-G-T,rs11026040,-1,G,T,3228599,171176,2860815,3254031,367784
11,ENSG00000110619.12,3057423,11-3228599-G-A,rs11026040,-1,G,A,3228599,171176,2860815,3254031,367784
11,ENSG00000171714.10,22193085,11-22318628-A-G,rs11026507,1,A,G,22318628,125543,21996477,22389693,322151
11,ENSG00000205213.8,27472790,11-27330437-G-A,rs11029950,-1,G,A,27330437,142353,27276182,27669398,54255
11,ENSG00000166352.10,36594502,11-36600045-A-G,rs11033705,1,A,G,36600045,5543,36397894,36791110,202151
11,ENSG00000132256.14,5685074,11-5668773-C-G,rs11038642,-1,C,G,5668773,16301,5488466,5881682,180307
11,ENSG00000132256.14,5685074,11-5668773-C-T,rs11038642,-1,C,T,5668773,16301,5488466,5881682,180307
11,ENSG00000121653.6,45885651,11-45852713-A-G,rs11038689,1,A,G,45852713,32938,45689043,46082259,163670
11,ENSG00000175224.10,46617553,11-46564231-A-G,rs11038919,1,A,G,46564231,53322,46420945,46814161,143286
11,ENSG00000184956.11,1036718,11-1006874-G-T,rs111317734,-1,G,T,1006874,29844,840110,1233326,166764
11,ENSG00000151364.11,78023276,11-78101741-G-A,rs111908986,-1,G,A,78101741,78465,77826668,78219884,275073
11,ENSG00000110660.9,107858787,11-107864776-G-A,rs11212411,-1,G,A,107864776,5989,107662179,108055395,202597
11,ENSG00000178202.8,108498384,11-108555063-T-A,rs11212704,-1,T,A,108555063,56679,108301776,108694992,253287
11,ENSG00000178202.8,108498384,11-108555063-T-C,rs11212704,-1,T,C,108555063,56679,108301776,108694992,253287
11,ENSG00000150782.7,112164094,11-112174177-G-T,rs11214110,-1,G,T,112174177,10083,111967486,112360702,206691
11,ENSG00000160593.12,118225011,11-118242196-G-A,rs11216829,-1,G,A,118242196,17185,118028403,118421619,213793
11,ENSG00000118096.3,118565931,11-118540709-A-C,rs11216886,-1,A,C,118540709,25222,118369323,118762539,171386
11,ENSG00000134955.7,125063305,11-125052872-G-A,rs11219878,1,G,A,125052872,10433,124866697,125259913,186175
11,ENSG00000198331.6,125887668,11-125957452-A-T,rs11220285,1,A,T,125957452,69784,125691060,126084276,266392
11,ENSG00000198331.6,125887668,11-125957452-A-G,rs11220285,1,A,G,125957452,69784,125691060,126084276,266392
11,ENSG00000149328.9,134331988,11-134230605-G-A,rs11223731,1,G,A,134230605,101383,134135380,134528596,95225
11,ENSG00000149328.9,134331988,11-134230605-G-C,rs11223731,1,G,C,134230605,101383,134135380,134528596,95225
11,ENSG00000213445.4,65638101,11-65811201-C-A,rs11227306,1,C,A,65811201,173100,65441493,65834709,369708
11,ENSG00000172803.12,65833963,11-65856268-A-G,rs11227332,1,A,G,65856268,22305,65637355,66030571,218913
11,ENSG00000175115.7,66070272,11-66061524-T-C,rs11227394,1,T,C,66061524,8748,65873664,66266880,187860
11,ENSG00000174165.3,66546048,11-66506601-T-C,rs11227501,-1,T,C,66506601,39447,66349440,66742656,157161
11,ENSG00000173653.3,66843441,11-66908802-C-T,rs11227623,1,C,T,66908802,65361,66646833,67040049,261969
11,ENSG00000173653.3,66843441,11-66908802-C-A,rs11227623,1,C,A,66908802,65361,66646833,67040049,261969
11,ENSG00000197629.4,59212927,11-59252946-C-A,rs11229889,-1,C,A,59252946,40019,59016319,59409535,236627
11,ENSG00000197629.4,59212927,11-59252946-C-T,rs11229889,-1,C,T,59252946,40019,59016319,59409535,236627
11,ENSG00000167985.2,61430124,11-61588016-G-A,rs11230745,1,G,A,61588016,157892,61233516,61626732,354500
11,ENSG00000162188.5,62707676,11-62626973-G-A,rs11231166,1,G,A,62626973,80703,62511068,62904284,115905
11,ENSG00000151500.9,134253352,11-134253534-G-T,rs112372624,-1,G,T,134253534,182,134056744,134449960,196790
11,ENSG00000151500.9,134253352,11-134253534-G-A,rs112372624,-1,G,A,134253534,182,134056744,134449960,196790
11,ENSG00000151500.9,134253352,11-134253534-G-C,rs112372624,-1,G,C,134253534,182,134056744,134449960,196790
11,ENSG00000151498.6,134253568,11-134253534-G-T,rs112372624,1,G,T,134253534,34,134056960,134450176,196574
11,ENSG00000151498.6,134253568,11-134253534-G-A,rs112372624,1,G,A,134253534,34,134056960,134450176,196574
11,ENSG00000151498.6,134253568,11-134253534-G-C,rs112372624,1,G,C,134253534,34,134056960,134450176,196574
11,ENSG00000214063.6,842852,11-843461-T-C,rs11246328,1,T,C,843461,609,646244,1039460,197217
11,ENSG00000214063.6,842852,11-843461-T-G,rs11246328,1,T,G,843461,609,646244,1039460,197217
11,ENSG00000189057.6,59107237,11-59228160-G-A,rs113715342,1,G,A,59228160,120923,58910629,59303845,317531
11,ENSG00000181333.11,94021354,11-94129327-A-G,rs1138800,1,A,G,94129327,107973,93824746,94217962,304581
11,ENSG00000181333.11,94021354,11-94129327-A-C,rs1138800,1,A,C,94129327,107973,93824746,94217962,304581
11,ENSG00000149480.2,62601865,11-62611329-T-C,rs11553576,-1,T,C,62611329,9464,62405257,62798473,206072
11,ENSG00000149480.2,62601865,11-62611329-T-G,rs11553576,-1,T,G,62611329,9464,62405257,62798473,206072
11,ENSG00000076043.5,114439467,11-114335657-G-T,rs11559525,1,G,T,114335657,103810,114242859,114636075,92798
11,ENSG00000076043.5,114439467,11-114335657-G-C,rs11559525,1,G,C,114335657,103810,114242859,114636075,92798
11,ENSG00000165457.8,72216794,11-72396144-G-A,rs1160142,1,G,A,72396144,179350,72020186,72413402,375958
11,ENSG00000051009.5,6234636,11-6143157-T-C,rs11602249,-1,T,C,6143157,91479,6038028,6431244,105129
11,ENSG00000110367.5,118791164,11-118917188-A-C,rs11602400,-1,A,C,118917188,126024,118594556,118987772,322632
11,ENSG00000110367.5,118791164,11-118917188-A-T,rs11602400,-1,A,T,118917188,126024,118594556,118987772,322632
11,ENSG00000110711.4,67483026,11-67463284-C-A,rs11603236,1,C,A,67463284,19742,67286418,67679634,176866
11,ENSG00000110711.4,67483026,11-67463284-C-T,rs11603236,1,C,T,67463284,19742,67286418,67679634,176866
11,ENSG00000177666.11,818914,11-934594-C-T,rs11605562,1,C,T,934594,115680,622306,1015522,312288
11,ENSG00000158555.10,75525941,11-75513855-T-G,rs11606662,-1,T,G,75513855,12086,75329333,75722549,184522
11,ENSG00000173486.8,64241095,11-64196475-T-A,rs11607165,1,T,A,64196475,44620,64044487,64437703,151988
11,ENSG00000173486.8,64241095,11-64196475-T-G,rs11607165,1,T,G,64196475,44620,64044487,64437703,151988
11,ENSG00000166900.10,59755376,11-59678027-A-G,rs11607283,1,A,G,59678027,77349,59558768,59951984,119259
11,ENSG00000184384.8,96343195,11-96341369-A-C,rs117349218,-1,A,C,96341369,1826,96146587,96539803,194782
11,ENSG00000130413.11,8594228,11-8594339-C-T,rs117610728,-1,C,T,8594339,111,8397620,8790836,196719
11,ENSG00000150776.12,112074299,11-112118899-G-A,rs117711499,1,G,A,112118899,44600,111877691,112270907,241208
11,ENSG00000185101.8,442011,11-460303-T-C,rs11821341,-1,T,C,460303,18292,245403,638619,214900
11,ENSG00000244242.1,1750595,11-1751975-G-A,rs11822872,-1,G,A,1751975,1380,1553987,1947203,197988
11,ENSG00000174669.7,66371760,11-66330851-G-T,rs11823140,-1,G,T,66330851,40909,66175152,66568368,155699
11,ENSG00000174669.7,66371760,11-66330851-G-A,rs11823140,-1,G,A,66330851,40909,66175152,66568368,155699
11,ENSG00000180720.6,46391776,11-46366474-G-A,rs11827702,-1,G,A,46366474,25302,46195168,46588384,171306
11,ENSG00000149792.4,65122321,11-65129981-C-T,rs1206196,1,C,T,65129981,7660,64925713,65318929,204268
11,ENSG00000149792.4,65122321,11-65129981-C-G,rs1206196,1,C,G,65129981,7660,64925713,65318929,204268
11,ENSG00000149201.5,86374887,11-86216391-G-A,rs12223670,1,G,A,86216391,158496,86178279,86571495,38112
11,ENSG00000152404.10,107457825,11-107269351-G-A,rs12224337,-1,G,A,107269351,188474,107261217,107654433,8134
11,ENSG00000152404.10,107457825,11-107269351-G-T,rs12224337,-1,G,T,107269351,188474,107261217,107654433,8134
11,ENSG00000133789.10,9664077,11-9615307-A-G,rs12273601,1,A,G,9615307,48770,9467469,9860685,147838
11,ENSG00000132259.8,6239089,11-6234754-C-T,rs12274456,1,C,T,6234754,4335,6042481,6435697,192273
11,ENSG00000110013.8,124673739,11-124836453-A-T,rs12281572,-1,A,T,124836453,162714,124477131,124870347,359322
11,ENSG00000110013.8,124673739,11-124836453-A-G,rs12281572,-1,A,G,124836453,162714,124477131,124870347,359322
11,ENSG00000162191.8,62679073,11-62508481-C-G,rs12281651,-1,C,G,62508481,170592,62482465,62875681,26016
11,ENSG00000162191.8,62679073,11-62508481-C-A,rs12281651,-1,C,A,62508481,170592,62482465,62875681,26016
11,ENSG00000182261.3,7965447,11-7932241-G-A,rs12286065,-1,G,A,7932241,33206,7768839,8162055,163402
11,ENSG00000110693.11,16356546,11-16458790-A-G,rs12289034,-1,A,G,16458790,102244,16159938,16553154,298852
11,ENSG00000110693.11,16356546,11-16458790-A-T,rs12289034,-1,A,T,16458790,102244,16159938,16553154,298852
11,ENSG00000149196.10,86302240,11-86326654-T-A,rs12295985,1,T,A,86326654,24414,86105632,86498848,221022
11,ENSG00000165458.8,72224767,11-72180140-A-G,rs12361490,1,A,G,72180140,44627,72028159,72421375,151981
11,ENSG00000165458.8,72224767,11-72180140-A-C,rs12361490,1,A,C,72180140,44627,72028159,72421375,151981
11,ENSG00000150316.7,94973556,11-94995735-T-C,rs12363872,-1,T,C,94995735,22179,94776948,95170164,218787
11,ENSG00000150316.7,94973556,11-94995735-T-A,rs12363872,-1,T,A,94995735,22179,94776948,95170164,218787
11,ENSG00000186280.5,94973709,11-94995735-T-C,rs12363872,1,T,C,94995735,22026,94777101,95170317,218634
11,ENSG00000186280.5,94973709,11-94995735-T-A,rs12363872,1,T,A,94995735,22026,94777101,95170317,218634
11,ENSG00000049449.3,32091074,11-32083127-G-A,rs12364816,1,G,A,32083127,7947,31894466,32287682,188661
11,ENSG00000137497.12,72080542,11-72236225-G-A,rs12417459,-1,G,A,72236225,155683,71883934,72277150,352291
11,ENSG00000181074.3,5754243,11-5710352-C-T,rs12417798,1,C,T,5710352,43891,5557635,5950851,152717
11,ENSG00000131620.12,70078317,11-70222486-A-G,rs12419801,1,A,G,70222486,144169,69881709,70274925,340777
11,ENSG00000129084.13,14520386,11-14699666-A-G,rs12419818,-1,A,G,14699666,179280,14323778,14716994,375888
11,ENSG00000149485.10,61817003,11-61864838-A-G,rs12577276,-1,A,G,61864838,47835,61620395,62013611,244443
11,ENSG00000149577.9,117178743,11-117210993-A-G,rs1263499,1,A,G,117210993,32250,116982135,117375351,228858
11,ENSG00000160683.4,118883892,11-118998737-T-C,rs12786333,1,T,C,118998737,114845,118687284,119080500,311453
11,ENSG00000171631.10,73272338,11-73267993-A-G,rs12790447,1,A,G,73267993,4345,73075730,73468946,192263
11,ENSG00000166793.6,57649912,11-57646470-C-A,rs12793139,-1,C,A,57646470,3442,57453304,57846520,193166
11,ENSG00000166793.6,57649912,11-57646470-C-G,rs12793139,-1,C,G,57646470,3442,57453304,57846520,193166
11,ENSG00000183161.3,22625823,11-22597220-C-A,rs12796724,-1,C,A,22597220,28603,22429215,22822431,168005
11,ENSG00000151376.10,86672636,11-86865379-C-T,rs12796995,-1,C,T,86865379,192743,86476028,86869244,389351
11,ENSG00000151376.10,86672636,11-86865379-C-A,rs12796995,-1,C,A,86865379,192743,86476028,86869244,389351
11,ENSG00000099834.13,624955,11-621795-G-A,rs12801890,-1,G,A,621795,3160,428347,821563,193448
11,ENSG00000099834.13,624955,11-621795-G-T,rs12801890,-1,G,T,621795,3160,428347,821563,193448
11,ENSG00000080854.9,133956968,11-133941177-A-G,rs12804787,-1,A,G,133941177,15791,133760360,134153576,180817
11,ENSG00000134780.5,61680391,11-61503723-T-C,rs12805182,1,T,C,61503723,176668,61483783,61876999,19940
11,ENSG00000134780.5,61680391,11-61503723-T-G,rs12805182,1,T,G,61503723,176668,61483783,61876999,19940
11,ENSG00000048649.9,77820722,11-77969353-G-C,rs12807406,-1,G,C,77969353,148631,77624114,78017330,345239
11,ENSG00000048649.9,77820722,11-77969353-G-T,rs12807406,-1,G,T,77969353,148631,77624114,78017330,345239
11,ENSG00000133318.9,63681500,11-63507296-T-G,rs1404504,1,T,G,63507296,174204,63484892,63878108,22404
11,ENSG00000151502.5,134224671,11-134388248-A-C,rs1440483,1,A,C,134388248,163577,134028063,134421279,360185
11,ENSG00000151502.5,134224671,11-134388248-A-T,rs1440483,1,A,T,134388248,163577,134028063,134421279,360185
11,ENSG00000149054.10,6926426,11-6926908-T-C,rs1491823,1,T,C,6926908,482,6729818,7123034,197090
11,ENSG00000149054.10,6926426,11-6926908-T-G,rs1491823,1,T,G,6926908,482,6729818,7123034,197090
11,ENSG00000170748.5,7088998,11-6926908-T-C,rs1491823,1,T,C,6926908,162090,6892390,7285606,34518
11,ENSG00000170748.5,7088998,11-6926908-T-G,rs1491823,1,T,G,6926908,162090,6892390,7285606,34518
11,ENSG00000188124.2,6771976,11-6926908-T-C,rs1491823,-1,T,C,6926908,154932,6575368,6968584,351540
11,ENSG00000188124.2,6771976,11-6926908-T-G,rs1491823,-1,T,G,6926908,154932,6575368,6968584,351540
11,ENSG00000110057.3,68004097,11-68148226-G-A,rs1547890,-1,G,A,68148226,144129,67807489,68200705,340737
11,ENSG00000109929.5,121292771,11-121289351-C-A,rs1560409,1,C,A,121289351,3420,121096163,121489379,193188
11,ENSG00000109929.5,121292771,11-121289351-C-G,rs1560409,1,C,G,121289351,3420,121096163,121489379,193188
11,ENSG00000174871.6,66278175,11-66313700-A-T,rs1621469,1,A,T,66313700,35525,66081567,66474783,232133
11,ENSG00000174871.6,66278175,11-66313700-A-C,rs1621469,1,A,C,66313700,35525,66081567,66474783,232133
11,ENSG00000110628.9,2902278,11-2921363-G-A,rs1661052,1,G,A,2921363,19085,2705670,3098886,215693
11,ENSG00000110628.9,2902278,11-2921363-G-T,rs1661052,1,G,T,2921363,19085,2705670,3098886,215693
11,ENSG00000166444.12,8810674,11-8865550-A-T,rs16906256,-1,A,T,8865550,54876,8614066,9007282,251484
11,ENSG00000166444.12,8810674,11-8865550-A-G,rs16906256,-1,A,G,8865550,54876,8614066,9007282,251484
11,ENSG00000148925.5,13463222,11-13289254-C-A,rs16912563,-1,C,A,13289254,173968,13266614,13659830,22640
11,ENSG00000184937.8,32435539,11-32599401-C-T,rs16923443,-1,C,T,32599401,163862,32238931,32632147,360470
11,ENSG00000135378.3,32829927,11-32670601-T-C,rs16923515,1,T,C,32670601,159326,32633319,33026535,37282
11,ENSG00000154127.5,122655722,11-122708696-C-T,rs17126767,1,C,T,122708696,52974,122459114,122852330,249582
11,ENSG00000151702.11,128694072,11-128850330-T-C,rs17137971,1,T,C,128850330,156258,128497464,128890680,352866
11,ENSG00000168060.9,65058553,11-64895755-C-T,rs17146441,-1,C,T,64895755,162798,64861945,65255161,33810
11,ENSG00000168060.9,65058553,11-64895755-C-A,rs17146441,-1,C,A,64895755,162798,64861945,65255161,33810
11,ENSG00000179431.5,35618460,11-35610704-A-G,rs17296905,1,A,G,35610704,7756,35421852,35815068,188852
11,ENSG00000110108.3,60914158,11-61062162-G-T,rs175121,1,G,T,61062162,148004,60717550,61110766,344612
11,ENSG00000168000.9,62707424,11-62536350-C-T,rs17664979,-1,C,T,62536350,171074,62510816,62904032,25534
11,ENSG00000168000.9,62707424,11-62536350-C-A,rs17664979,-1,C,A,62536350,171074,62510816,62904032,25534
11,ENSG00000109861.8,88337736,11-88170838-A-C,rs17753199,-1,A,C,88170838,166898,88141128,88534344,29710
11,ENSG00000256269.2,119084881,11-119067274-G-A,rs1784461,1,G,A,119067274,17607,118888273,119281489,179001
11,ENSG00000162231.7,62805440,11-62897684-G-T,rs1785940,-1,G,T,62897684,92244,62608832,63002048,288852
11,ENSG00000172893.10,71448393,11-71423920-C-T,rs1792284,-1,C,T,71423920,24473,71251785,71645001,172135
11,ENSG00000020922.7,94493844,11-94493786-C-T,rs1805363,-1,C,T,94493786,58,94297236,94690452,196550
11,ENSG00000020922.7,94493844,11-94493786-C-G,rs1805363,-1,C,G,94493786,58,94297236,94690452,196550
11,ENSG00000020922.7,94493844,11-94493786-C-A,rs1805363,-1,C,A,94493786,58,94297236,94690452,196550
11,ENSG00000184545.6,1572271,11-1598629-C-G,rs1809667,-1,C,G,1598629,26358,1375663,1768879,222966
11,ENSG00000184545.6,1572271,11-1598629-C-A,rs1809667,-1,C,A,1598629,26358,1375663,1768879,222966
11,ENSG00000074266.10,86244753,11-86228905-C-T,rs1874694,1,C,T,86228905,15848,86048145,86441361,180760
11,ENSG00000076053.6,114400666,11-114298591-T-C,rs1894030,1,T,C,114298591,102075,114204058,114597274,94533
11,ENSG00000109927.5,121101243,11-121036773-G-A,rs2000525,1,G,A,121036773,64470,120904635,121297851,132138
11,ENSG00000175575.8,73876999,11-73900304-G-C,rs2067912,1,G,C,73900304,23305,73680391,74073607,219913
11,ENSG00000110665.7,2301918,11-2302298-T-A,rs2074021,-1,T,A,2302298,380,2105310,2498526,196988
11,ENSG00000110665.7,2301918,11-2302298-T-C,rs2074021,-1,T,C,2302298,380,2105310,2498526,196988
11,ENSG00000064201.10,2302013,11-2302298-T-A,rs2074021,1,T,A,2302298,285,2105405,2498621,196893
11,ENSG00000064201.10,2302013,11-2302298-T-C,rs2074021,1,T,C,2302298,285,2105405,2498621,196893
11,ENSG00000110455.9,44066270,11-44066439-G-T,rs2074038,1,G,T,44066439,169,43869662,44262878,196777
11,ENSG00000110719.4,68039025,11-68049469-A-G,rs2075609,1,A,G,68049469,10444,67842417,68235633,207052
11,ENSG00000110719.4,68039025,11-68049469-A-T,rs2075609,1,A,T,68049469,10444,67842417,68235633,207052
11,ENSG00000110721.6,68121388,11-68049469-A-G,rs2075609,-1,A,G,68049469,71919,67924780,68317996,124689
11,ENSG00000110721.6,68121388,11-68049469-A-T,rs2075609,-1,A,T,68049469,71919,67924780,68317996,124689
11,ENSG00000019102.7,124752255,11-124748043-A-C,rs2075713,-1,A,C,124748043,4212,124555647,124948863,192396
11,ENSG00000198561.8,57761802,11-57645499-C-T,rs2076895,1,C,T,57645499,116303,57565194,57958410,80305
11,ENSG00000177103.8,117797216,11-117816697-G-T,rs2077620,-1,G,T,117816697,19481,117600608,117993824,216089
11,ENSG00000184232.3,120211032,11-120155892-G-A,rs2084897,1,G,A,120155892,55140,120014424,120407640,141468
11,ENSG00000166435.10,74949091,11-74948888-G-T,rs2119028,-1,G,T,74948888,203,74752483,75145699,196405
11,ENSG00000166435.10,74949091,11-74948888-G-A,rs2119028,-1,G,A,74948888,203,74752483,75145699,196405
11,ENSG00000070081.9,17276739,11-17277843-T-A,rs214082,1,T,A,17277843,1104,17080131,17473347,197712
11,ENSG00000070081.9,17276739,11-17277843-T-C,rs214082,1,T,C,17277843,1104,17080131,17473347,197712
11,ENSG00000070081.9,17276739,11-17277843-T-G,rs214082,1,T,G,17277843,1104,17080131,17473347,197712
11,ENSG00000188211.4,17351800,11-17221242-G-A,rs214910,1,G,A,17221242,130558,17155192,17548408,66050
11,ENSG00000149564.7,124762290,11-124730862-A-T,rs2155109,-1,A,T,124730862,31428,124565682,124958898,165180
11,ENSG00000149564.7,124762290,11-124730862-A-G,rs2155109,-1,A,G,124730862,31428,124565682,124958898,165180
11,ENSG00000247595.2,18599789,11-18628846-T-C,rs2166519,1,T,C,18628846,29057,18403181,18796397,225665
11,ENSG00000166002.2,93543391,11-93526612-G-T,rs2198797,-1,G,T,93526612,16779,93346783,93739999,179829
11,ENSG00000166002.2,93543391,11-93526612-G-A,rs2198797,-1,G,A,93526612,16779,93346783,93739999,179829
11,ENSG00000149781.8,64206721,11-64197133-C-T,rs2236647,1,C,T,64197133,9588,64010113,64403329,187020
11,ENSG00000185475.3,62787402,11-62787770-A-G,rs2241908,1,A,G,62787770,368,62590794,62984010,196976
11,ENSG00000110344.5,118359600,11-118359644-C-T,rs2276419,1,C,T,118359644,44,118162992,118556208,196652
11,ENSG00000174080.6,66568606,11-66478380-G-A,rs2282640,-1,G,A,66478380,90226,66371998,66765214,106382
11,ENSG00000174080.6,66568606,11-66478380-G-T,rs2282640,-1,G,T,66478380,90226,66371998,66765214,106382
11,ENSG00000179057.9,18726188,11-18707103-T-C,rs2289965,-1,T,C,18707103,19085,18529580,18922796,177523
11,ENSG00000187726.4,73951026,11-73968187-A-T,rs2306818,1,A,T,73968187,17161,73754418,74147634,213769
11,ENSG00000187726.4,73951026,11-73968187-A-G,rs2306818,1,A,G,73968187,17161,73754418,74147634,213769
11,ENSG00000110171.12,6473941,11-6464439-A-G,rs2344827,-1,A,G,6464439,9502,6277333,6670549,187106
11,ENSG00000132286.6,6481501,11-6528774-A-G,rs2344828,1,A,G,6528774,47273,6284893,6678109,243881
11,ENSG00000132286.6,6481501,11-6528774-A-C,rs2344828,1,A,C,6528774,47273,6284893,6678109,243881
11,ENSG00000132286.6,6481501,11-6528774-A-T,rs2344828,1,A,T,6528774,47273,6284893,6678109,243881
11,ENSG00000168496.3,61792911,11-61603417-C-G,rs2429863,1,C,G,61603417,189494,61596303,61989519,7114
11,ENSG00000168496.3,61792911,11-61603417-C-T,rs2429863,1,C,T,61603417,189494,61596303,61989519,7114
11,ENSG00000162129.7,72434531,11-72284595-C-T,rs2508201,-1,C,T,72284595,149936,72237923,72631139,46672
11,ENSG00000162129.7,72434531,11-72284595-C-A,rs2508201,-1,C,A,72284595,149936,72237923,72631139,46672
11,ENSG00000149218.4,95089846,11-95096350-G-C,rs2509814,1,G,C,95096350,6504,94893238,95286454,203112
11,ENSG00000149218.4,95089846,11-95096350-G-T,rs2509814,1,G,T,95096350,6504,94893238,95286454,203112
11,ENSG00000162174.8,62337448,11-62331263-T-A,rs2513747,1,T,A,62331263,6185,62140840,62534056,190423
11,ENSG00000162174.8,62337448,11-62331263-T-C,rs2513747,1,T,C,62331263,6185,62140840,62534056,190423
11,ENSG00000167797.3,67508162,11-67648719-C-T,rs2514037,-1,C,T,67648719,140557,67311554,67704770,337165
11,ENSG00000166340.9,6619422,11-6489014-A-G,rs2555162,-1,A,G,6489014,130408,6422814,6816030,66200
11,ENSG00000110723.6,108593768,11-108574809-A-C,rs2640749,-1,A,C,108574809,18959,108397160,108790376,177649
11,ENSG00000110723.6,108593768,11-108574809-A-G,rs2640749,-1,A,G,108574809,18959,108397160,108790376,177649
11,ENSG00000166796.7,18412318,11-18438761-C-A,rs2643856,1,C,A,18438761,26443,18215710,18608926,223051
11,ENSG00000166796.7,18412318,11-18438761-C-T,rs2643856,1,C,T,18438761,26443,18215710,18608926,223051
11,ENSG00000166796.7,18412318,11-18438761-C-G,rs2643856,1,C,G,18438761,26443,18215710,18608926,223051
11,ENSG00000134809.4,57530754,11-57560094-C-G,rs2649650,-1,C,G,57560094,29340,57334146,57727362,225948
11,ENSG00000134809.4,57530754,11-57560094-C-T,rs2649650,-1,C,T,57560094,29340,57334146,57727362,225948
11,ENSG00000214872.4,57537595,11-57545281-G-A,rs2649659,1,G,A,57545281,7686,57340987,57734203,204294
11,ENSG00000132254.7,6481331,11-6612529-G-A,rs2659862,-1,G,A,6612529,131198,6284723,6677939,327806
11,ENSG00000181830.5,45805149,11-45771472-T-A,rs2666890,1,T,A,45771472,33677,45608541,46001757,162931
11,ENSG00000181830.5,45805149,11-45771472-T-G,rs2666890,1,T,G,45771472,33677,45608541,46001757,162931
11,ENSG00000137714.2,110429948,11-110409700-C-A,rs2724422,1,C,A,110409700,20248,110233340,110626556,176360
11,ENSG00000178105.4,108665069,11-108767061-G-T,rs2726888,1,G,T,108767061,101992,108468461,108861677,298600
11,ENSG00000135372.4,34105629,11-34206759-G-C,rs2746633,1,G,C,34206759,101130,33909021,34302237,297738
11,ENSG00000135372.4,34105629,11-34206759-G-A,rs2746633,1,G,A,34206759,101130,33909021,34302237,297738
11,ENSG00000110435.6,34916618,11-35006528-C-T,rs2762965,1,C,T,35006528,89910,34720010,35113226,286518
11,ENSG00000110435.6,34916618,11-35006528-C-G,rs2762965,1,C,G,35006528,89910,34720010,35113226,286518
11,ENSG00000148985.14,3808560,11-3755141-C-T,rs276892,1,C,T,3755141,53419,3611952,4005168,143189
11,ENSG00000173113.2,64317559,11-64266276-T-C,rs28395880,-1,T,C,64266276,51283,64120951,64514167,145325
11,ENSG00000126432.9,64318121,11-64266276-T-C,rs28395880,1,T,C,64266276,51845,64121513,64514729,144763
11,ENSG00000177697.12,832952,11-834098-C-T,rs28681202,1,C,T,834098,1146,636344,1029560,197754
11,ENSG00000177697.12,832952,11-834098-C-G,rs28681202,1,C,G,834098,1146,636344,1029560,197754
11,ENSG00000177697.12,832952,11-834098-C-A,rs28681202,1,C,A,834098,1146,636344,1029560,197754
11,ENSG00000014138.4,65261962,11-65324138-G-A,rs2904967,1,G,A,65324138,62176,65065354,65458570,258784
11,ENSG00000014138.4,65261962,11-65324138-G-C,rs2904967,1,G,C,65324138,62176,65065354,65458570,258784
11,ENSG00000149089.7,34916379,11-34872619-G-C,rs2915232,-1,G,C,34872619,43760,34719771,35112987,152848
11,ENSG00000149089.7,34916379,11-34872619-G-A,rs2915232,-1,G,A,34872619,43760,34719771,35112987,152848
11,ENSG00000109920.7,47767341,11-47913171-G-A,rs2950888,-1,G,A,47913171,145830,47570733,47963949,342438
11,ENSG00000185187.7,414999,11-406473-A-T,rs3087588,-1,A,T,406473,8526,218391,611607,188082
11,ENSG00000185187.7,414999,11-406473-A-G,rs3087588,-1,A,G,406473,8526,218391,611607,188082
11,ENSG00000185187.7,414999,11-406473-A-C,rs3087588,-1,A,C,406473,8526,218391,611607,188082
11,ENSG00000171067.6,68271973,11-68298566-G-A,rs312018,-1,G,A,68298566,26593,68075365,68468581,223201
11,ENSG00000137700.10,119030906,11-118895659-G-C,rs3136698,-1,G,C,118895659,135247,118834298,119227514,61361
11,ENSG00000137700.10,119030906,11-118895659-G-A,rs3136698,-1,G,A,118895659,135247,118834298,119227514,61361
11,ENSG00000166349.5,36568007,11-36464757-G-A,rs331435,1,G,A,36464757,103250,36371399,36764615,93358
11,ENSG00000133794.12,13277790,11-13267797-G-A,rs34369393,1,G,A,13267797,9993,13081182,13474398,186615
11,ENSG00000149115.9,57324952,11-57346635-G-T,rs34572680,-1,G,T,57346635,21683,57128344,57521560,218291
11,ENSG00000149115.9,57324952,11-57346635-G-A,rs34572680,-1,G,A,57346635,21683,57128344,57521560,218291
11,ENSG00000214756.2,62665312,11-62602774-C-T,rs34709729,1,C,T,62602774,62538,62468704,62861920,134070
11,ENSG00000165434.4,74398433,11-74336698-T-A,rs36014178,-1,T,A,74336698,61735,74201825,74595041,134873
11,ENSG00000078124.6,76860918,11-76796238-C-T,rs3740772,1,C,T,76796238,64680,76664310,77057526,131928
11,ENSG00000166452.7,8911189,11-8925403-G-A,rs3751068,1,G,A,8925403,14214,8714581,9107797,210822
11,ENSG00000166452.7,8911189,11-8925403-G-T,rs3751068,1,G,T,8925403,14214,8714581,9107797,210822
11,ENSG00000166452.7,8911189,11-8925403-G-C,rs3751068,1,G,C,8925403,14214,8714581,9107797,210822
11,ENSG00000177542.6,798281,11-616865-G-A,rs3758650,-1,G,A,616865,181416,601673,994889,15192
11,ENSG00000177542.6,798281,11-616865-G-T,rs3758650,-1,G,T,616865,181416,601673,994889,15192
11,ENSG00000177042.9,695816,11-616865-G-A,rs3758650,1,G,A,616865,78951,499208,892424,117657
11,ENSG00000177042.9,695816,11-616865-G-T,rs3758650,1,G,T,616865,78951,499208,892424,117657
11,ENSG00000177600.4,809967,11-636399-T-C,rs3758653,1,T,C,636399,173568,613359,1006575,23040
11,ENSG00000198851.5,118304730,11-118266156-G-A,rs3759005,1,G,A,118266156,38574,118108122,118501338,158034
11,ENSG00000198851.5,118304730,11-118266156-G-T,rs3759005,1,G,T,118266156,38574,118108122,118501338,158034
11,ENSG00000149548.9,124954202,11-124954170-C-T,rs3809054,1,C,T,124954170,32,124757594,125150810,196576
11,ENSG00000149548.9,124954202,11-124954170-C-G,rs3809054,1,C,G,124954170,32,124757594,125150810,196576
11,ENSG00000168439.11,64186171,11-64266083-C-T,rs3815362,1,C,T,64266083,79912,63989563,64382779,276520
11,ENSG00000074319.6,18526942,11-18502943-G-T,rs3925781,-1,G,T,18502943,23999,18330334,18723550,172609
11,ENSG00000074319.6,18526942,11-18502943-G-A,rs3925781,-1,G,A,18502943,23999,18330334,18723550,172609
11,ENSG00000166788.5,18106082,11-18119895-C-T,rs4052539,-1,C,T,18119895,13813,17909474,18302690,210421
11,ENSG00000166788.5,18106082,11-18119895-C-G,rs4052539,-1,C,G,18119895,13813,17909474,18302690,210421
11,ENSG00000205339.5,9384652,11-9307196-T-C,rs4282978,1,T,C,9307196,77456,9188044,9581260,119152
11,ENSG00000205339.5,9384652,11-9307196-T-G,rs4282978,1,T,G,9307196,77456,9188044,9581260,119152
11,ENSG00000205339.5,9384652,11-9307196-T-A,rs4282978,1,T,A,9307196,77456,9188044,9581260,119152
11,ENSG00000154146.6,124739942,11-124732967-A-T,rs4337053,1,A,T,124732967,6975,124543334,124936550,189633
11,ENSG00000154146.6,124739942,11-124732967-A-G,rs4337053,1,A,G,124732967,6975,124543334,124936550,189633
11,ENSG00000213619.4,47579074,11-47389400-T-A,rs4752993,1,T,A,47389400,189674,47382466,47775682,6934
11,ENSG00000213619.4,47579074,11-47389400-T-G,rs4752993,1,T,G,47389400,189674,47382466,47775682,6934
11,ENSG00000213619.4,47579074,11-47389400-T-C,rs4752993,1,T,C,47389400,189674,47382466,47775682,6934
11,ENSG00000134571.6,47352702,11-47407014-C-G,rs4752999,-1,C,G,47407014,54312,47156094,47549310,250920
11,ENSG00000134571.6,47352702,11-47407014-C-T,rs4752999,-1,C,T,47407014,54312,47156094,47549310,250920
11,ENSG00000019485.8,45146639,11-45288859-C-T,rs4755306,1,C,T,45288859,142220,44950031,45343247,338828
11,ENSG00000019485.8,45146639,11-45288859-C-A,rs4755306,1,C,A,45288859,142220,44950031,45343247,338828
11,ENSG00000019485.8,45146639,11-45288859-C-G,rs4755306,1,C,G,45288859,142220,44950031,45343247,338828
11,ENSG00000188487.6,15114923,11-15142915-G-A,rs4757293,1,G,A,15142915,27992,14918315,15311531,224600
11,ENSG00000175467.9,65961734,11-65775268-G-A,rs489574,1,G,A,65775268,186466,65765126,66158342,10142
11,ENSG00000133805.10,10455264,11-10540593-T-G,rs4909942,1,T,G,10540593,85329,10258656,10651872,281937
11,ENSG00000133805.10,10455264,11-10540593-T-A,rs4909942,1,T,A,10540593,85329,10258656,10651872,281937
11,ENSG00000166478.5,9461012,11-9507776-A-G,rs4910471,1,A,G,9507776,46764,9264404,9657620,243372
11,ENSG00000197798.4,126211782,11-126282721-G-T,rs4937114,1,G,T,126282721,70939,126015174,126408390,267547
11,ENSG00000197798.4,126211782,11-126282721-G-A,rs4937114,1,G,A,126282721,70939,126015174,126408390,267547
11,ENSG00000110080.13,126355686,11-126358764-T-C,rs4937122,1,T,C,126358764,3078,126159078,126552294,199686
11,ENSG00000110080.13,126355686,11-126358764-T-G,rs4937122,1,T,G,126358764,3078,126159078,126552294,199686
11,ENSG00000156738.13,60455847,11-60464852-A-G,rs4939364,1,A,G,60464852,9005,60259239,60652455,205613
11,ENSG00000156738.13,60455847,11-60464852-A-T,rs4939364,1,A,T,60464852,9005,60259239,60652455,205613
11,ENSG00000214517.4,74171289,11-74070669-G-T,rs4944036,1,G,T,74070669,100620,73974681,74367897,95988
11,ENSG00000214517.4,74171289,11-74070669-G-A,rs4944036,1,G,A,74070669,100620,73974681,74367897,95988
11,ENSG00000184524.5,790090,11-780827-C-T,rs4963156,-1,C,T,780827,9263,593482,986698,187345
11,ENSG00000173992.4,66593185,11-66595526-A-T,rs498045,1,A,T,66595526,2341,66396577,66789793,198949
11,ENSG00000173992.4,66593185,11-66595526-A-G,rs498045,1,A,G,66595526,2341,66396577,66789793,198949
11,ENSG00000173992.4,66593185,11-66595526-A-C,rs498045,1,A,C,66595526,2341,66396577,66789793,198949
11,ENSG00000162337.7,68312591,11-68326825-T-C,rs499511,1,T,C,68326825,14234,68115983,68509199,210842
11,ENSG00000172757.7,65858180,11-65869802-A-G,rs501630,-1,A,G,65869802,11622,65661572,66054788,208230
11,ENSG00000137486.12,75351661,11-75340189-A-T,rs504683,-1,A,T,75340189,11472,75155053,75548269,185136
11,ENSG00000137486.12,75351661,11-75340189-A-G,rs504683,-1,A,G,75340189,11472,75155053,75548269,185136
11,ENSG00000142082.10,236342,11-219089-T-A,rs511744,-1,T,A,219089,17253,39734,432950,179355
11,ENSG00000142082.10,236342,11-219089-T-C,rs511744,-1,T,C,219089,17253,39734,432950,179355
11,ENSG00000110324.4,117986394,11-117848165-G-A,rs512481,1,G,A,117848165,138229,117789786,118183002,58379
11,ENSG00000123901.3,94401419,11-94415646-C-T,rs516037,-1,C,T,94415646,14227,94204811,94598027,210835
11,ENSG00000123901.3,94401419,11-94415646-C-G,rs516037,-1,C,G,94415646,14227,94204811,94598027,210835
11,ENSG00000156599.6,57668114,11-57732662-A-G,rs527140,1,A,G,57732662,64548,57471506,57864722,261156
11,ENSG00000137731.8,117824744,11-117792194-C-A,rs528431,-1,C,A,117792194,32550,117628136,118021352,164058
11,ENSG00000160695.8,119067818,11-119076924-C-T,rs540261,1,C,T,119076924,9106,118871210,119264426,205714
11,ENSG00000162222.8,62728486,11-62712374-T-G,rs549312,1,T,G,62712374,16112,62531878,62925094,180496
11,ENSG00000162222.8,62728486,11-62712374-T-A,rs549312,1,T,A,62712374,16112,62531878,62925094,180496
11,ENSG00000162222.8,62728486,11-62712374-T-C,rs549312,1,T,C,62712374,16112,62531878,62925094,180496
11,ENSG00000162241.8,65382646,11-65202952-C-T,rs552403,-1,C,T,65202952,179694,65186038,65579254,16914
11,ENSG00000162241.8,65382646,11-65202952-C-A,rs552403,-1,C,A,65202952,179694,65186038,65579254,16914
11,ENSG00000166471.6,9314593,11-9253372-G-A,rs55962227,-1,G,A,9253372,61221,9117985,9511201,135387
11,ENSG00000166257.4,123654624,11-123655588-G-A,rs56037734,-1,G,A,123655588,964,123458016,123851232,197572
11,ENSG00000099849.10,560970,11-480016-G-A,rs56060013,1,G,A,480016,80954,364362,757578,115654
11,ENSG00000196655.5,119018766,11-119023577-A-G,rs569,1,A,G,119023577,4811,118822158,119215374,201419
11,ENSG00000196655.5,119018766,11-119023577-A-T,rs569,1,A,T,119023577,4811,118822158,119215374,201419
11,ENSG00000068976.8,64759974,11-64747034-A-T,rs569602,-1,A,T,64747034,12940,64563366,64956582,183668
11,ENSG00000068976.8,64759974,11-64747034-A-C,rs569602,-1,A,C,64747034,12940,64563366,64956582,183668
11,ENSG00000068976.8,64759974,11-64747034-A-G,rs569602,-1,A,G,64747034,12940,64563366,64956582,183668
11,ENSG00000149591.11,117199370,11-117198345-A-T,rs585849,1,A,T,117198345,1025,117002762,117395978,195583
11,ENSG00000149591.11,117199370,11-117198345-A-G,rs585849,1,A,G,117198345,1025,117002762,117395978,195583
11,ENSG00000110074.6,126269154,11-126211441-T-C,rs587891,1,T,C,126211441,57713,126072546,126465762,138895
11,ENSG00000110074.6,126269154,11-126211441-T-A,rs587891,1,T,A,126211441,57713,126072546,126465762,138895
11,ENSG00000110074.6,126269154,11-126211441-T-G,rs587891,1,T,G,126211441,57713,126072546,126465762,138895
11,ENSG00000166439.5,74748849,11-74912966-C-A,rs590105,1,C,A,74912966,164117,74552241,74945457,360725
11,ENSG00000129158.5,18013047,11-18039853-T-C,rs591556,-1,T,C,18039853,26806,17816439,18209655,223414
11,ENSG00000110063.4,126304060,11-126287084-C-G,rs595022,1,C,G,126287084,16976,126107452,126500668,179632
11,ENSG00000110063.4,126304060,11-126287084-C-T,rs595022,1,C,T,126287084,16976,126107452,126500668,179632
11,ENSG00000121236.13,5596637,11-5599055-C-T,rs59650010,1,C,T,5599055,2418,5400029,5793245,199026
11,ENSG00000175602.2,65890673,11-65882303-A-G,rs604630,1,A,G,65882303,8370,65694065,66087281,188238
11,ENSG00000175602.2,65890673,11-65882303-A-T,rs604630,1,A,T,65882303,8370,65694065,66087281,188238
11,ENSG00000149418.5,130159782,11-130182004-C-T,rs60745822,1,C,T,130182004,22222,129963174,130356390,218830
11,ENSG00000134627.7,94567368,11-94602964-T-C,rs608972,1,T,C,94602964,35596,94370760,94763976,232204
11,ENSG00000134627.7,94567368,11-94602964-T-A,rs608972,1,T,A,94602964,35596,94370760,94763976,232204
11,ENSG00000196371.2,94543921,11-94602964-T-C,rs608972,1,T,C,94602964,59043,94347313,94740529,255651
11,ENSG00000196371.2,94543921,11-94602964-T-A,rs608972,1,T,A,94602964,59043,94347313,94740529,255651
11,ENSG00000075239.9,108121567,11-108213786-G-A,rs609557,1,G,A,108213786,92219,107924959,108318175,288827
11,ENSG00000075239.9,108121567,11-108213786-G-T,rs609557,1,G,T,108213786,92219,107924959,108318175,288827
11,ENSG00000175592.3,65900388,11-65779386-A-C,rs610037,-1,A,C,65779386,121002,65703780,66096996,75606
11,ENSG00000175592.3,65900388,11-65779386-A-T,rs610037,-1,A,T,65779386,121002,65703780,66096996,75606
11,ENSG00000175592.3,65900388,11-65779386-A-G,rs610037,-1,A,G,65779386,121002,65703780,66096996,75606
11,ENSG00000181649.5,2929420,11-2977392-G-A,rs61871243,-1,G,A,2977392,47972,2732812,3126028,244580
11,ENSG00000166441.8,8682792,11-8683981-C-G,rs61875926,1,C,G,8683981,1189,8486184,8879400,197797
11,ENSG00000177685.10,827919,11-827713-A-T,rs61876746,1,A,T,827713,206,631311,1024527,196402
11,ENSG00000177685.10,827919,11-827713-A-C,rs61876746,1,A,C,827713,206,631311,1024527,196402
11,ENSG00000023191.11,507242,11-526356-G-A,rs61877777,-1,G,A,526356,19114,310634,703850,215722
11,ENSG00000181924.6,73876846,11-73961529-C-A,rs622064,-1,C,A,73961529,84683,73680238,74073454,281291
11,ENSG00000110375.2,118956298,11-118958232-A-G,rs623500,1,A,G,118958232,1934,118759690,119152906,198542
11,ENSG00000166004.9,93661682,11-93760236-T-C,rs624883,1,T,C,93760236,98554,93465074,93858290,295162
11,ENSG00000149743.9,64226186,11-64121821-C-T,rs627055,-1,C,T,64121821,104365,64029578,64422794,92243
11,ENSG00000197345.7,68903832,11-68899730-A-C,rs636049,-1,A,C,68899730,4102,68707224,69100440,192506
11,ENSG00000197345.7,68903832,11-68899730-A-T,rs636049,-1,A,T,68899730,4102,68707224,69100440,192506
11,ENSG00000162139.5,74988933,11-75012511-A-C,rs639768,1,A,C,75012511,23578,74792325,75185541,220186
11,ENSG00000162139.5,74988933,11-75012511-A-G,rs639768,1,A,G,75012511,23578,74792325,75185541,220186
11,ENSG00000162139.5,74988933,11-75012511-A-T,rs639768,1,A,T,75012511,23578,74792325,75185541,220186
11,ENSG00000142089.9,320860,11-305619-T-C,rs6421984,-1,T,C,305619,15241,124252,517468,181367
11,ENSG00000132740.4,68903891,11-68914185-A-G,rs646586,1,A,G,68914185,10294,68707283,69100499,206902
11,ENSG00000132740.4,68903891,11-68914185-A-T,rs646586,1,A,T,68914185,10294,68707283,69100499,206902
11,ENSG00000109881.11,27363215,11-27201945-A-G,rs6484271,-1,A,G,27201945,161270,27166607,27559823,35338
11,ENSG00000182919.9,93741672,11-93743600-G-A,rs652961,1,G,A,93743600,1928,93545064,93938280,198536
11,ENSG00000172500.8,65888471,11-65888811-G-A,rs656980,-1,G,A,65888811,340,65691863,66085079,196948
11,ENSG00000175536.6,74493724,11-74388847-T-A,rs658126,-1,T,A,74388847,104877,74297116,74690332,91731
11,ENSG00000175536.6,74493724,11-74388847-T-C,rs658126,-1,T,C,74388847,104877,74297116,74690332,91731
11,ENSG00000149292.11,113314583,11-113322075-C-T,rs6589371,1,C,T,113322075,7492,113117975,113511191,204100
11,ENSG00000171219.8,64844653,11-65034795-G-A,rs6591869,-1,G,A,65034795,190142,64648045,65041261,386750
11,ENSG00000171219.8,64844653,11-65034795-G-C,rs6591869,-1,G,C,65034795,190142,64648045,65041261,386750
11,ENSG00000137509.5,82900430,11-83089329-G-A,rs6592099,-1,G,A,83089329,188899,82703822,83097038,385507
11,ENSG00000033327.8,78417820,11-78560568-A-G,rs6592792,-1,A,G,78560568,142748,78221212,78614428,339356
11,ENSG00000033327.8,78417820,11-78560568-A-C,rs6592792,-1,A,C,78560568,142748,78221212,78614428,339356
11,ENSG00000033327.8,78417820,11-78560568-A-T,rs6592792,-1,A,T,78560568,142748,78221212,78614428,339356
11,ENSG00000185522.4,560738,11-656523-C-T,rs6598007,-1,C,T,656523,95785,364130,757346,292393
11,ENSG00000185201.10,307816,11-330630-G-A,rs6598040,1,G,A,330630,22814,111208,504424,219422
11,ENSG00000175567.3,73982843,11-73978059-G-A,rs660339,-1,G,A,73978059,4784,73786235,74179451,191824
11,ENSG00000152558.10,102452765,11-102493788-C-T,rs668660,-1,C,T,102493788,41023,102256157,102649373,237631
11,ENSG00000239306.3,66616630,11-66638599-A-C,rs670900,1,A,C,66638599,21969,66420022,66813238,218577
11,ENSG00000239306.3,66616630,11-66638599-A-T,rs670900,1,A,T,66638599,21969,66420022,66813238,218577
11,ENSG00000109919.4,47642559,11-47500005-C-T,rs67132220,-1,C,T,47500005,142554,47445951,47839167,54054
11,ENSG00000148935.6,22666611,11-22668658-T-C,rs680436,1,T,C,22668658,2047,22470003,22863219,198655
11,ENSG00000151704.11,128867296,11-128802686-A-C,rs687326,-1,A,C,128802686,64610,128670688,129063904,131998
11,ENSG00000172543.3,65879837,11-65885838-T-A,rs694994,1,T,A,65885838,6001,65683229,66076445,202609
11,ENSG00000172543.3,65879837,11-65885838-T-C,rs694994,1,T,C,65885838,6001,65683229,66076445,202609
11,ENSG00000176485.6,63614433,11-63604248-C-T,rs7101608,-1,C,T,63604248,10185,63417825,63811041,186423
11,ENSG00000176485.6,63614433,11-63604248-C-A,rs7101608,-1,C,A,63604248,10185,63417825,63811041,186423
11,ENSG00000176485.6,63614433,11-63604248-C-G,rs7101608,-1,C,G,63604248,10185,63417825,63811041,186423
11,ENSG00000167799.5,67629937,11-67630204-G-C,rs7102670,-1,G,C,67630204,267,67433329,67826545,196875
11,ENSG00000167799.5,67629937,11-67630204-G-A,rs7102670,-1,G,A,67630204,267,67433329,67826545,196875
11,ENSG00000173457.6,64246943,11-64248812-G-C,rs7111278,-1,G,C,64248812,1869,64050335,64443551,198477
11,ENSG00000173457.6,64246943,11-64248812-G-T,rs7111278,-1,G,T,64248812,1869,64050335,64443551,198477
11,ENSG00000173457.6,64246943,11-64248812-G-A,rs7111278,-1,G,A,64248812,1869,64050335,64443551,198477
11,ENSG00000213593.5,57712593,11-57585182-T-G,rs7112126,1,T,G,57585182,127411,57515985,57909201,69197
11,ENSG00000205126.2,44047981,11-44148709-G-A,rs7114988,1,G,A,44148709,100728,43851373,44244589,297336
11,ENSG00000043039.4,129375848,11-129552610-C-T,rs7115279,1,C,T,129552610,176762,129179240,129572456,373370
11,ENSG00000043039.4,129375848,11-129552610-C-A,rs7115279,1,C,A,129552610,176762,129179240,129572456,373370
11,ENSG00000110218.4,94128841,11-94114157-G-C,rs7116300,1,G,C,94114157,14684,93932233,94325449,181924
11,ENSG00000110218.4,94128841,11-94114157-G-A,rs7116300,1,G,A,94114157,14684,93932233,94325449,181924
11,ENSG00000254997.2,71548420,11-71566552-A-C,rs7120471,1,A,C,71566552,18132,71351812,71745028,214740
11,ENSG00000173621.7,66857064,11-66895260-G-A,rs7122539,1,G,A,66895260,38196,66660456,67053672,234804
11,ENSG00000173621.7,66857064,11-66895260-G-C,rs7122539,1,G,C,66895260,38196,66660456,67053672,234804
11,ENSG00000135363.7,33892076,11-33936158-T-C,rs7124698,-1,T,C,33936158,44082,33695468,34088684,240690
11,ENSG00000175581.9,73787874,11-73672337-T-C,rs7126049,1,T,C,73672337,115537,73591266,73984482,81071
11,ENSG00000137726.10,117876658,11-118021855-T-C,rs7127135,-1,T,C,118021855,145197,117680050,118073266,341805
11,ENSG00000109944.5,122882759,11-122877881-T-G,rs7129743,1,T,G,122877881,4878,122686151,123079367,191730
11,ENSG00000109944.5,122882759,11-122877881-T-C,rs7129743,1,T,C,122877881,4878,122686151,123079367,191730
11,ENSG00000132275.6,6603616,11-6522831-A-G,rs72897893,-1,A,G,6522831,80785,6407008,6800224,115823
11,ENSG00000173511.5,64234584,11-64409140-A-G,rs72927945,1,A,G,64409140,174556,64037976,64431192,371164
11,ENSG00000023445.8,102317484,11-102311320-G-A,rs72978207,1,G,A,102311320,6164,102120876,102514092,190444
11,ENSG00000183134.4,60855950,11-60754411-C-A,rs73495012,-1,C,A,60754411,101539,60659342,61052558,95069
11,ENSG00000183134.4,60855950,11-60754411-C-G,rs73495012,-1,C,G,60754411,101539,60659342,61052558,95069
11,ENSG00000077514.3,74592582,11-74701829-G-A,rs74551717,1,G,A,74701829,109247,74395974,74789190,305855
11,ENSG00000077514.3,74592582,11-74701829-G-T,rs74551717,1,G,T,74701829,109247,74395974,74789190,305855
11,ENSG00000077514.3,74592582,11-74701829-G-C,rs74551717,1,G,C,74701829,109247,74395974,74789190,305855
11,ENSG00000182272.7,369499,11-324368-G-A,rs7480758,1,G,A,324368,45131,172891,566107,151477
11,ENSG00000150787.3,112226428,11-112217820-A-G,rs74874911,1,A,G,112217820,8608,112029820,112423036,188000
11,ENSG00000149043.11,1834990,11-1675639-G-A,rs75162634,1,G,A,1675639,159351,1638382,2031598,37257
11,ENSG00000166961.10,60756867,11-60831746-C-G,rs76197319,1,C,G,60831746,74879,60560259,60953475,271487
11,ENSG00000072952.12,10693755,11-10640584-C-T,rs76288654,-1,C,T,10640584,53171,10497147,10890363,143437
11,ENSG00000161328.10,537527,11-721570-C-T,rs7635,1,C,T,721570,184043,340919,734135,380651
11,ENSG00000161328.10,537527,11-721570-C-G,rs7635,1,C,G,721570,184043,340919,734135,380651
11,ENSG00000149573.3,118264297,11-118233261-C-T,rs76675432,-1,C,T,118233261,31036,118067689,118460905,165572
11,ENSG00000121691.4,34438934,11-34438170-G-A,rs769214,1,G,A,34438170,764,34242326,34635542,195844
11,ENSG00000023171.9,123430269,11-123604606-G-A,rs77082103,1,G,A,123604606,174337,123233661,123626877,370945
11,ENSG00000177830.13,910810,11-804027-G-A,rs77173309,-1,G,A,804027,106783,714202,1107418,89825
11,ENSG00000158636.11,76445025,11-76604385-G-A,rs77251009,1,G,A,76604385,159360,76248417,76641633,355968
11,ENSG00000158636.11,76445025,11-76604385-G-T,rs77251009,1,G,T,76604385,159360,76248417,76641633,355968
11,ENSG00000110492.9,46381669,11-46205504-G-A,rs77496299,1,G,A,46205504,176165,46185061,46578277,20443
11,ENSG00000110492.9,46381669,11-46205504-G-C,rs77496299,1,G,C,46205504,176165,46185061,46578277,20443
11,ENSG00000179331.2,107928448,11-107974064-C-T,rs77885862,1,C,T,107974064,45616,107731840,108125056,242224
11,ENSG00000118363.7,74949266,11-75008854-G-A,rs78205254,1,G,A,75008854,59588,74752658,75145874,256196
11,ENSG00000135362.9,36296288,11-36401151-C-A,rs78731804,1,C,A,36401151,104863,36099680,36492896,301471
11,ENSG00000135362.9,36296288,11-36401151-C-T,rs78731804,1,C,T,36401151,104863,36099680,36492896,301471
11,ENSG00000084207.11,67583812,11-67579272-T-C,rs7927381,1,T,C,67579272,4540,67387204,67780420,192068
11,ENSG00000084207.11,67583812,11-67579272-T-A,rs7927381,1,T,A,67579272,4540,67387204,67780420,192068
11,ENSG00000084207.11,67583812,11-67579272-T-G,rs7927381,1,T,G,67579272,4540,67387204,67780420,192068
11,ENSG00000064199.2,124673904,11-124673907-T-G,rs7927406,1,T,G,124673907,3,124477296,124870512,196611
11,ENSG00000064199.2,124673904,11-124673907-T-A,rs7927406,1,T,A,124673907,3,124477296,124870512,196611
11,ENSG00000064199.2,124673904,11-124673907-T-C,rs7927406,1,T,C,124673907,3,124477296,124870512,196611
11,ENSG00000166959.3,60699612,11-60636365-G-A,rs7927860,1,G,A,60636365,63247,60503004,60896220,133361
11,ENSG00000170209.4,113387779,11-113546386-T-C,rs79330444,1,T,C,113546386,158607,113191171,113584387,355215
11,ENSG00000149050.5,7020346,11-6976354-C-A,rs7933973,-1,C,A,6976354,43992,6823738,7216954,152616
11,ENSG00000158077.4,7020479,11-6976354-C-A,rs7933973,1,C,A,6976354,44125,6823871,7217087,152483
11,ENSG00000129757.8,2885775,11-2901861-T-C,rs7934793,-1,T,C,2901861,16086,2689167,3082383,212694
11,ENSG00000129757.8,2885775,11-2901861-T-G,rs7934793,-1,T,G,2901861,16086,2689167,3082383,212694
11,ENSG00000070047.6,576470,11-577534-G-A,rs7936397,1,G,A,577534,1064,379862,773078,197672
11,ENSG00000132274.10,5689790,11-5697482-C-T,rs7936676,1,C,T,5697482,7692,5493182,5886398,204300
11,ENSG00000026508.11,35139171,11-35292752-G-C,rs7937731,1,G,C,35292752,153581,34942563,35335779,350189
11,ENSG00000026508.11,35139171,11-35292752-G-A,rs7937731,1,G,A,35292752,153581,34942563,35335779,350189
11,ENSG00000026508.11,35139171,11-35292752-G-T,rs7937731,1,G,T,35292752,153581,34942563,35335779,350189
11,ENSG00000175518.5,5516699,11-5620771-T-A,rs7939159,-1,T,A,5620771,104072,5320091,5713307,300680
11,ENSG00000175518.5,5516699,11-5620771-T-C,rs7939159,-1,T,C,5620771,104072,5320091,5713307,300680
11,ENSG00000149187.12,47553132,11-47702386-A-C,rs7939420,-1,A,C,47702386,149254,47356524,47749740,345862
11,ENSG00000149187.12,47553132,11-47702386-A-G,rs7939420,-1,A,G,47702386,149254,47356524,47749740,345862
11,ENSG00000183801.3,7485506,11-7505878-T-C,rs7943470,1,T,C,7505878,20372,7288898,7682114,216980
11,ENSG00000214290.3,111298546,11-111327051-C-T,rs7944798,1,C,T,111327051,28505,111101938,111495154,225113
11,ENSG00000152219.4,30323104,11-30309649-C-G,rs7947001,1,C,G,30309649,13455,30126496,30519712,183153
11,ENSG00000137474.12,77128246,11-77155541-G-A,rs79579240,1,G,A,77155541,27295,76931638,77324854,223903
11,ENSG00000110429.8,33774520,11-33792629-G-A,rs79708249,-1,G,A,33792629,18109,33577912,33971128,214717
11,ENSG00000150764.9,111937343,11-112109680-A-T,rs79763567,1,A,T,112109680,172337,111740735,112133951,368945
11,ENSG00000241233.1,71538025,11-71360229-C-T,rs79913732,1,C,T,71360229,177796,71341417,71734633,18812
11,ENSG00000176102.6,33161480,11-33310910-C-G,rs79950843,-1,C,G,33310910,149430,32964872,33358088,346038
11,ENSG00000176102.6,33161480,11-33310910-C-T,rs79950843,-1,C,T,33310910,149430,32964872,33358088,346038
11,ENSG00000255823.1,10509186,11-10629255-T-C,rs80172281,-1,T,C,10629255,120069,10312578,10705794,316677
11,ENSG00000137648.12,118077078,11-117908590-C-T,rs80264810,1,C,T,117908590,168488,117880470,118273686,28120
11,ENSG00000137648.12,118077078,11-117908590-C-A,rs80264810,1,C,A,117908590,168488,117880470,118273686,28120
11,ENSG00000165526.4,126211650,11-126290571-C-T,rs8177368,-1,C,T,126290571,78921,126015042,126408258,275529
11,ENSG00000132746.10,67674631,11-67583826-G-A,rs8191439,-1,G,A,67583826,90805,67478023,67871239,105803
11,ENSG00000110768.5,18322567,11-18272536-A-C,rs874957,1,A,C,18272536,50031,18125959,18519175,146577
11,ENSG00000110768.5,18322567,11-18272536-A-G,rs874957,1,A,G,18272536,50031,18125959,18519175,146577
11,ENSG00000109854.9,20363714,11-20488779-A-G,rs894752,1,A,G,20488779,125065,20167106,20560322,321673
11,ENSG00000110514.13,47270156,11-47238768-A-G,rs901746,1,A,G,47238768,31388,47073548,47466764,165220
11,ENSG00000110514.13,47270156,11-47238768-A-C,rs901746,1,A,C,47238768,31388,47073548,47466764,165220
11,ENSG00000110514.13,47270156,11-47238768-A-T,rs901746,1,A,T,47238768,31388,47073548,47466764,165220
11,ENSG00000168092.9,117144287,11-117188631-C-T,rs90192,1,C,T,117188631,44344,116947679,117340895,240952
11,ENSG00000162341.9,69048932,11-69101566-A-G,rs921675,1,A,G,69101566,52634,68852324,69245540,249242
11,ENSG00000162341.9,69048932,11-69101566-A-T,rs921675,1,A,T,69101566,52634,68852324,69245540,249242
11,ENSG00000177030.10,695222,11-683403-A-C,rs9328566,-1,A,C,683403,11819,498614,891830,184789
11,ENSG00000177030.10,695222,11-683403-A-G,rs9328566,-1,A,G,683403,11819,498614,891830,184789
11,ENSG00000172425.6,118527474,11-118494495-G-T,rs9332817,1,G,T,118494495,32979,118330866,118724082,163629
11,ENSG00000172425.6,118527474,11-118494495-G-C,rs9332817,1,G,C,118494495,32979,118330866,118724082,163629
11,ENSG00000072518.14,63839110,11-63876576-C-T,rs958333,1,C,T,63876576,37466,63642502,64035718,234074
11,ENSG00000180988.2,5808924,11-5809058-G-A,rs9630186,1,G,A,5809058,134,5612316,6005532,196742
11,ENSG00000123892.6,88175443,11-88174574-C-A,rs9666730,-1,C,A,88174574,869,87978835,88372051,195739
11,ENSG00000123892.6,88175443,11-88174574-C-T,rs9666730,-1,C,T,88174574,869,87978835,88372051,195739
11,ENSG00000156603.10,57712215,11-57881771-G-T,rs96894,-1,G,T,57881771,169556,57515607,57908823,366164
11,ENSG00000156603.10,57712215,11-57881771-G-A,rs96894,-1,G,A,57881771,169556,57515607,57908823,366164
11,ENSG00000156603.10,57712215,11-57881771-G-C,rs96894,-1,G,C,57881771,169556,57515607,57908823,366164
11,ENSG00000166436.10,8682665,11-8673283-G-A,rs10128597,-1,G,A,8673283,9382,8486057,8879273,187226
11,ENSG00000177963.7,207708,11-252942-G-A,rs1045577,1,G,A,252942,45234,11100,404316,241842
11,ENSG00000173432.6,18266264,11-18279407-G-A,rs1046615,1,G,A,18279407,13143,18069656,18462872,209751
11,ENSG00000182359.9,106077347,11-106076558-C-T,rs1047636,-1,C,T,106076558,789,105880739,106273955,195819
11,ENSG00000185085.2,62653302,11-62807115-C-A,rs10484,-1,C,A,62807115,153813,62456694,62849910,350421
11,ENSG00000137497.12,72080542,11-72203680-T-G,rs10501409,-1,T,G,72203680,123138,71883934,72277150,319746
11,ENSG00000149577.9,117178743,11-117169081-G-A,rs1060211,1,G,A,117169081,9662,116982135,117375351,186946
11,ENSG00000158077.4,7020479,11-6916293-C-T,rs10732224,1,C,T,6916293,104186,6823871,7217087,92422
11,ENSG00000158077.4,7020479,11-6916293-C-A,rs10732224,1,C,A,6916293,104186,6823871,7217087,92422
11,ENSG00000118096.3,118565931,11-118588554-A-G,rs10736492,-1,A,G,118588554,22623,118369323,118762539,219231
11,ENSG00000174669.7,66371760,11-66400420-G-A,rs10750787,-1,G,A,66400420,28660,66175152,66568368,225268
11,ENSG00000174669.7,66371760,11-66400420-G-C,rs10750787,-1,G,C,66400420,28660,66175152,66568368,225268
11,ENSG00000174669.7,66371760,11-66400420-G-T,rs10750787,-1,G,T,66400420,28660,66175152,66568368,225268
11,ENSG00000149231.7,96389912,11-96394221-C-T,rs10765805,-1,C,T,96394221,4309,96193304,96586520,200917
11,ENSG00000149231.7,96389912,11-96394221-C-A,rs10765805,-1,C,A,96394221,4309,96193304,96586520,200917
11,ENSG00000025434.14,47257996,11-47345820-C-G,rs10769255,1,C,G,47345820,87824,47061388,47454604,284432
11,ENSG00000025434.14,47257996,11-47345820-C-A,rs10769255,1,C,A,47345820,87824,47061388,47454604,284432
11,ENSG00000025434.14,47257996,11-47345820-C-T,rs10769255,1,C,T,47345820,87824,47061388,47454604,284432
11,ENSG00000180988.2,5808924,11-5940854-A-T,rs10769368,1,A,T,5940854,131930,5612316,6005532,328538
11,ENSG00000180988.2,5808924,11-5940854-A-G,rs10769368,1,A,G,5940854,131930,5612316,6005532,328538
11,ENSG00000160695.8,119067818,11-119102423-G-A,rs10790282,1,G,A,119102423,34605,118871210,119264426,231213
11,ENSG00000137642.7,121452314,11-121366663-T-G,rs10790445,1,T,G,121366663,85651,121255706,121648922,110957
11,ENSG00000137642.7,121452314,11-121366663-T-C,rs10790445,1,T,C,121366663,85651,121255706,121648922,110957
11,ENSG00000137642.7,121452314,11-121366663-T-A,rs10790445,1,T,A,121366663,85651,121255706,121648922,110957
11,ENSG00000166261.6,123741660,11-123675877-C-G,rs10790585,-1,C,G,123675877,65783,123545052,123938268,130825
11,ENSG00000166261.6,123741660,11-123675877-C-A,rs10790585,-1,C,A,123675877,65783,123545052,123938268,130825
11,ENSG00000126432.9,64318121,11-64339255-T-C,rs10792429,1,T,C,64339255,21134,64121513,64514729,217742
11,ENSG00000126432.9,64318121,11-64339255-T-A,rs10792429,1,T,A,64339255,21134,64121513,64514729,217742
11,ENSG00000137513.5,78574864,11-78567746-T-C,rs10793334,-1,T,C,78567746,7118,78378256,78771472,189490
11,ENSG00000110328.5,11622005,11-11639268-C-T,rs10831656,-1,C,T,11639268,17263,11425397,11818613,213871
11,ENSG00000183161.3,22625823,11-22569465-A-G,rs10833781,-1,A,G,22569465,56358,22429215,22822431,140250
11,ENSG00000149084.7,43680738,11-43833522-A-G,rs10838183,1,A,G,43833522,152784,43484130,43877346,349392
11,ENSG00000184232.3,120211032,11-120190085-G-T,rs10892547,1,G,T,120190085,20947,120014424,120407640,175661
11,ENSG00000134955.7,125063305,11-124926800-A-G,rs10893305,1,A,G,124926800,136505,124866697,125259913,60103
11,ENSG00000166689.9,17014414,11-16895672-T-C,rs11024074,-1,T,C,16895672,118742,16817806,17211022,77866
11,ENSG00000074319.6,18526942,11-18594626-G-A,rs11024727,-1,G,A,18594626,67684,18330334,18723550,264292
11,ENSG00000110628.9,2902278,11-2965859-C-G,rs11024771,1,C,G,2965859,63581,2705670,3098886,260189
11,ENSG00000110628.9,2902278,11-2965859-C-A,rs11024771,1,C,A,2965859,63581,2705670,3098886,260189
11,ENSG00000148985.14,3808560,11-3835646-A-G,rs11029997,1,A,G,3835646,27086,3611952,4005168,223694
11,ENSG00000167323.5,3855664,11-3848866-C-T,rs11030046,1,C,T,3848866,6798,3659056,4052272,189810
11,ENSG00000152219.4,30323104,11-30426940-C-T,rs11031075,1,C,T,30426940,103836,30126496,30519712,300444
11,ENSG00000135378.3,32829927,11-32829289-G-T,rs11032012,1,G,T,32829289,638,32633319,33026535,195970
11,ENSG00000085063.10,33736423,11-33777867-T-G,rs11032377,-1,T,G,33777867,41444,33539815,33933031,238052
11,ENSG00000085063.10,33736423,11-33777867-T-C,rs11032377,-1,T,C,33777867,41444,33539815,33933031,238052
11,ENSG00000121691.4,34438934,11-34426039-T-G,rs11032695,1,T,G,34426039,12895,34242326,34635542,183713
11,ENSG00000187479.4,43942637,11-43962194-G-A,rs11037757,1,G,A,43962194,19557,43746029,44139245,216165
11,ENSG00000121236.13,5596637,11-5589444-T-C,rs11038227,1,T,C,5589444,7193,5400029,5793245,189415
11,ENSG00000132274.10,5689790,11-5650393-A-C,rs11038546,1,A,C,5650393,39397,5493182,5886398,157211
11,ENSG00000132274.10,5689790,11-5650393-A-T,rs11038546,1,A,T,5650393,39397,5493182,5886398,157211
11,ENSG00000132274.10,5689790,11-5650393-A-G,rs11038546,1,A,G,5650393,39397,5493182,5886398,157211
11,ENSG00000175390.7,7987337,11-7983923-G-A,rs11041699,1,G,A,7983923,3414,7790729,8183945,193194
11,ENSG00000130413.11,8594228,11-8604270-T-G,rs11042008,-1,T,G,8604270,10042,8397620,8790836,206650
11,ENSG00000130413.11,8594228,11-8604270-T-A,rs11042008,-1,T,A,8604270,10042,8397620,8790836,206650
11,ENSG00000121671.7,45847475,11-45841801-C-T,rs111954517,1,C,T,45841801,5674,45650867,46044083,190934
11,ENSG00000186318.10,117316256,11-117360895-G-T,rs11216366,-1,G,T,117360895,44639,117119648,117512864,241247
11,ENSG00000137726.10,117876658,11-117877737-A-T,rs11216598,-1,A,T,117877737,1079,117680050,118073266,197687
11,ENSG00000137726.10,117876658,11-117877737-A-G,rs11216598,-1,A,G,117877737,1079,117680050,118073266,197687
11,ENSG00000110344.5,118359600,11-118369617-T-C,rs11216860,1,T,C,118369617,10017,118162992,118556208,206625
11,ENSG00000118181.5,119018343,11-119029653-G-A,rs11217128,-1,G,A,119029653,11310,118821735,119214951,207918
11,ENSG00000110080.13,126355686,11-126374057-G-A,rs11220462,1,G,A,126374057,18371,126159078,126552294,214979
11,ENSG00000175602.2,65890673,11-65771978-G-T,rs11227297,1,G,T,65771978,118695,65694065,66087281,77913
11,ENSG00000175602.2,65890673,11-65771978-G-C,rs11227297,1,G,C,65771978,118695,65694065,66087281,77913
11,ENSG00000175602.2,65890673,11-65771978-G-A,rs11227297,1,G,A,65771978,118695,65694065,66087281,77913
11,ENSG00000132740.4,68903891,11-68835878-T-C,rs11228377,1,T,C,68835878,68013,68707283,69100499,128595
11,ENSG00000110042.3,59172132,11-59252946-C-A,rs11229889,1,C,A,59252946,80814,58975524,59368740,277422
11,ENSG00000110042.3,59172132,11-59252946-C-T,rs11229889,1,C,T,59252946,80814,58975524,59368740,277422
11,ENSG00000181903.3,55662201,11-55522669-G-A,rs11230051,1,G,A,55522669,139532,55465593,55858809,57076
11,ENSG00000181903.3,55662201,11-55522669-G-C,rs11230051,1,G,C,55522669,139532,55465593,55858809,57076
11,ENSG00000149781.8,64206721,11-64085744-A-T,rs11231691,1,A,T,64085744,120977,64010113,64403329,75631
11,ENSG00000149781.8,64206721,11-64085744-A-G,rs11231691,1,A,G,64085744,120977,64010113,64403329,75631
11,ENSG00000173511.5,64234584,11-64279169-C-T,rs11231740,1,C,T,64279169,44585,64037976,64431192,241193
11,ENSG00000165490.8,82901736,11-82897848-T-C,rs11233366,1,T,C,82897848,3888,82705128,83098344,192720
11,ENSG00000165490.8,82901736,11-82897848-T-G,rs11233366,1,T,G,82897848,3888,82705128,83098344,192720
11,ENSG00000150672.11,85627344,11-85745199-C-T,rs11234397,-1,C,T,85745199,117855,85430736,85823952,314463
11,ENSG00000137501.11,85811141,11-85879998-C-T,rs11234457,-1,C,T,85879998,68857,85614533,86007749,265465
11,ENSG00000078124.6,76860918,11-76714401-G-A,rs11236894,1,G,A,76714401,146517,76664310,77057526,50091
11,ENSG00000087884.10,77821144,11-77993546-C-T,rs11237348,1,C,T,77993546,172402,77624536,78017752,369010
11,ENSG00000087884.10,77821144,11-77993546-C-G,rs11237348,1,C,G,77993546,172402,77624536,78017752,369010
11,ENSG00000214063.6,842852,11-906708-C-G,rs11246342,1,C,G,906708,63856,646244,1039460,260464
11,ENSG00000214063.6,842852,11-906708-C-A,rs11246342,1,C,A,906708,63856,646244,1039460,260464
11,ENSG00000151502.5,134224671,11-134299300-T-C,rs1146192,1,T,C,134299300,74629,134028063,134421279,271237
11,ENSG00000053918.10,2445008,11-2621854-A-G,rs11493163,1,A,G,2621854,176846,2248400,2641616,373454
11,ENSG00000133805.10,10455264,11-10512250-A-T,rs11553579,1,A,T,10512250,56986,10258656,10651872,253594
11,ENSG00000133805.10,10455264,11-10512250-A-G,rs11553579,1,A,G,10512250,56986,10258656,10651872,253594
11,ENSG00000150787.3,112226428,11-112295435-G-C,rs115537969,1,G,C,112295435,69007,112029820,112423036,265615
11,ENSG00000150787.3,112226428,11-112295435-G-A,rs115537969,1,G,A,112295435,69007,112029820,112423036,265615
11,ENSG00000198561.8,57761802,11-57797124-G-T,rs11570196,1,G,T,57797124,35322,57565194,57958410,231930
11,ENSG00000219435.3,64300358,11-64315335-C-T,rs11600990,1,C,T,64315335,14977,64103750,64496966,211585
11,ENSG00000197136.4,65615776,11-65443548-G-C,rs11605125,1,G,C,65443548,172228,65419168,65812384,24380
11,ENSG00000181333.11,94021354,11-94132981-T-G,rs11607757,1,T,G,94132981,111627,93824746,94217962,308235
11,ENSG00000110400.5,119729200,11-119702945-C-T,rs117236359,-1,C,T,119702945,26255,119532592,119925808,170353
11,ENSG00000175567.3,73982843,11-74003216-G-A,rs117552079,-1,G,A,74003216,20373,73786235,74179451,216981
11,ENSG00000176697.12,27700455,11-27614512-A-C,rs117571072,-1,A,C,27614512,85943,27503847,27897063,110665
11,ENSG00000142089.9,320860,11-315299-G-A,rs117685303,-1,G,A,315299,5561,124252,517468,191047
11,ENSG00000132275.6,6603616,11-6590363-T-C,rs117716565,-1,T,C,6590363,13253,6407008,6800224,183355
11,ENSG00000186280.5,94973709,11-94975727-C-A,rs117732556,1,C,A,94975727,2018,94777101,95170317,198626
11,ENSG00000149294.11,112961420,11-112906617-G-T,rs117966185,1,G,T,112906617,54803,112764812,113158028,141805
11,ENSG00000149294.11,112961420,11-112906617-G-C,rs117966185,1,G,C,112906617,54803,112764812,113158028,141805
11,ENSG00000149294.11,112961420,11-112906617-G-A,rs117966185,1,G,A,112906617,54803,112764812,113158028,141805
11,ENSG00000149564.7,124762290,11-124784120-A-G,rs11822687,-1,A,G,124784120,21830,124565682,124958898,218438
11,ENSG00000068831.13,64744142,11-64725417-C-T,rs11823239,-1,C,T,64725417,18725,64547534,64940750,177883
11,ENSG00000110717.6,68030681,11-68029774-T-C,rs11825872,1,T,C,68029774,907,67834073,68227289,195701
11,ENSG00000110700.2,17077667,11-17169987-T-C,rs11826763,-1,T,C,17169987,92320,16881059,17274275,288928
11,ENSG00000166340.9,6619422,11-6626391-T-G,rs11827437,-1,T,G,6626391,6969,6422814,6816030,203577
11,ENSG00000166340.9,6619422,11-6626391-T-C,rs11827437,-1,T,C,6626391,6969,6422814,6816030,203577
11,ENSG00000014138.4,65261962,11-65179387-T-A,rs1195968,1,T,A,65179387,82575,65065354,65458570,114033
11,ENSG00000014138.4,65261962,11-65179387-T-C,rs1195968,1,T,C,65179387,82575,65065354,65458570,114033
11,ENSG00000066336.7,47378547,11-47239709-G-A,rs11988,-1,G,A,47239709,138838,47181939,47575155,57770
11,ENSG00000066336.7,47378547,11-47239709-G-C,rs11988,-1,G,C,47239709,138838,47181939,47575155,57770
11,ENSG00000166199.8,43880831,11-43948609-C-T,rs12223994,1,C,T,43948609,67778,43684223,44077439,264386
11,ENSG00000166199.8,43880831,11-43948609-C-G,rs12223994,1,C,G,43948609,67778,43684223,44077439,264386
11,ENSG00000162298.11,65134519,11-65212536-G-C,rs12224555,-1,G,C,65212536,78017,64937911,65331127,274625
11,ENSG00000162298.11,65134519,11-65212536-G-A,rs12224555,-1,G,A,65212536,78017,64937911,65331127,274625
11,ENSG00000133789.10,9664077,11-9646281-A-G,rs12275368,1,A,G,9646281,17796,9467469,9860685,178812
11,ENSG00000080854.9,133956968,11-133969230-C-T,rs12278054,-1,C,T,133969230,12262,133760360,134153576,208870
11,ENSG00000137714.2,110429948,11-110470692-C-T,rs12280232,1,C,T,110470692,40744,110233340,110626556,237352
11,ENSG00000198730.3,10751246,11-10644014-C-T,rs12281392,1,C,T,10644014,107232,10554638,10947854,89376
11,ENSG00000179057.9,18726188,11-18698382-A-T,rs12282271,-1,A,T,18698382,27806,18529580,18922796,168802
11,ENSG00000179057.9,18726188,11-18698382-A-G,rs12282271,-1,A,G,18698382,27806,18529580,18922796,168802
11,ENSG00000167257.6,117232671,11-117280696-G-A,rs12282721,1,G,A,117280696,48025,117036063,117429279,244633
11,ENSG00000007372.14,31811322,11-31841814-T-C,rs12286701,-1,T,C,31841814,30492,31614714,32007930,227100
11,ENSG00000110013.8,124673739,11-124756946-C-T,rs12286824,-1,C,T,124756946,83207,124477131,124870347,279815
11,ENSG00000110013.8,124673739,11-124756946-C-G,rs12286824,-1,C,G,124756946,83207,124477131,124870347,279815
11,ENSG00000149548.9,124954202,11-124936564-G-A,rs12294326,1,G,A,124936564,17638,124757594,125150810,178970
11,ENSG00000167799.5,67629937,11-67612104-G-A,rs12295232,-1,G,A,67612104,17833,67433329,67826545,178775
11,ENSG00000019485.8,45146639,11-45140910-A-G,rs12296068,1,A,G,45140910,5729,44950031,45343247,190879
11,ENSG00000255151.1,59086307,11-59145689-C-T,rs12365972,1,C,T,59145689,59382,58889699,59282915,255990
11,ENSG00000137760.10,107565735,11-107506895-T-C,rs12419931,-1,T,C,107506895,58840,107369127,107762343,137768
11,ENSG00000137760.10,107565735,11-107506895-T-A,rs12419931,-1,T,A,107506895,58840,107369127,107762343,137768
11,ENSG00000133884.5,65333852,11-65214366-C-A,rs12420456,1,C,A,65214366,119486,65137244,65530460,77122
11,ENSG00000133884.5,65333852,11-65214366-C-T,rs12420456,1,C,T,65214366,119486,65137244,65530460,77122
11,ENSG00000180773.10,93197991,11-93131275-G-A,rs12420961,-1,G,A,93131275,66716,93001383,93394599,129892
11,ENSG00000197345.7,68903832,11-68857430-T-C,rs1249528,-1,T,C,68857430,46402,68707224,69100440,150206
11,ENSG00000197345.7,68903832,11-68857430-T-G,rs1249528,-1,T,G,68857430,46402,68707224,69100440,150206
11,ENSG00000178301.3,77589953,11-77594910-G-A,rs12577552,1,G,A,77594910,4957,77393345,77786561,201565
11,ENSG00000151500.9,134253352,11-134333644-T-C,rs1258854,-1,T,C,134333644,80292,134056744,134449960,276900
11,ENSG00000174080.6,66568606,11-66614046-T-A,rs12795774,-1,T,A,66614046,45440,66371998,66765214,242048
11,ENSG00000174080.6,66568606,11-66614046-T-C,rs12795774,-1,T,C,66614046,45440,66371998,66765214,242048
11,ENSG00000213445.4,65638101,11-65623846-G-A,rs12801636,1,G,A,65623846,14255,65441493,65834709,182353
11,ENSG00000213445.4,65638101,11-65623846-G-C,rs12801636,1,G,C,65623846,14255,65441493,65834709,182353
11,ENSG00000023191.11,507242,11-621795-G-A,rs12801890,-1,G,A,621795,114553,310634,703850,311161
11,ENSG00000023191.11,507242,11-621795-G-T,rs12801890,-1,G,T,621795,114553,310634,703850,311161
11,ENSG00000177685.10,827919,11-827955-G-A,rs12802515,1,G,A,827955,36,631311,1024527,196644
11,ENSG00000177685.10,827919,11-827955-G-C,rs12802515,1,G,C,827955,36,631311,1024527,196644
11,ENSG00000177685.10,827919,11-827955-G-T,rs12802515,1,G,T,827955,36,631311,1024527,196644
11,ENSG00000149054.10,6926426,11-6921464-C-G,rs12806437,1,C,G,6921464,4962,6729818,7123034,191646
11,ENSG00000149054.10,6926426,11-6921464-C-T,rs12806437,1,C,T,6921464,4962,6729818,7123034,191646
11,ENSG00000188124.2,6771976,11-6921464-C-G,rs12806437,-1,C,G,6921464,149488,6575368,6968584,346096
11,ENSG00000188124.2,6771976,11-6921464-C-T,rs12806437,-1,C,T,6921464,149488,6575368,6968584,346096
11,ENSG00000110025.7,65027439,11-65064557-C-T,rs1300836,1,C,T,65064557,37118,64830831,65224047,233726
11,ENSG00000110025.7,65027439,11-65064557-C-G,rs1300836,1,C,G,65064557,37118,64830831,65224047,233726
11,ENSG00000149289.6,110093392,11-110145179-C-A,rs1381466,1,C,A,110145179,51787,109896784,110290000,248395
11,ENSG00000149289.6,110093392,11-110145179-C-T,rs1381466,1,C,T,110145179,51787,109896784,110290000,248395
11,ENSG00000149289.6,110093392,11-110145179-C-G,rs1381466,1,C,G,110145179,51787,109896784,110290000,248395
11,ENSG00000159063.7,78139626,11-78038016-T-G,rs1470713,-1,T,G,78038016,101610,77943018,78336234,94998
11,ENSG00000159063.7,78139626,11-78038016-T-C,rs1470713,-1,T,C,78038016,101610,77943018,78336234,94998
11,ENSG00000169519.14,28108388,11-27954661-G-C,rs1525708,1,G,C,27954661,153727,27911780,28304996,42881
11,ENSG00000169519.14,28108388,11-27954661-G-A,rs1525708,1,G,A,27954661,153727,27911780,28304996,42881
11,ENSG00000152270.4,14643804,11-14513279-A-G,rs1548074,1,A,G,14513279,130525,14447196,14840412,66083
11,ENSG00000151702.11,128694072,11-128880227-G-A,rs1574128,1,G,A,128880227,186155,128497464,128890680,382763
11,ENSG00000174996.7,66257703,11-66313700-A-T,rs1621469,1,A,T,66313700,55997,66061095,66454311,252605
11,ENSG00000174996.7,66257703,11-66313700-A-C,rs1621469,1,A,C,66313700,55997,66061095,66454311,252605
11,ENSG00000175581.9,73787874,11-73851983-G-A,rs1670557,1,G,A,73851983,64109,73591266,73984482,260717
11,ENSG00000175581.9,73787874,11-73851983-G-C,rs1670557,1,G,C,73851983,64109,73591266,73984482,260717
11,ENSG00000175581.9,73787874,11-73851983-G-T,rs1670557,1,G,T,73851983,64109,73591266,73984482,260717
11,ENSG00000109854.9,20363714,11-20378716-C-T,rs16906178,1,C,T,20378716,15002,20167106,20560322,211610
11,ENSG00000109854.9,20363714,11-20378716-C-A,rs16906178,1,C,A,20378716,15002,20167106,20560322,211610
11,ENSG00000166313.11,6419094,11-6297436-A-G,rs16911672,-1,A,G,6297436,121658,6222486,6615702,74950
11,ENSG00000110218.4,94128841,11-94195821-C-A,rs16920030,1,C,A,94195821,66980,93932233,94325449,263588
11,ENSG00000162129.7,72434531,11-72551164-T-G,rs1695328,-1,T,G,72551164,116633,72237923,72631139,313241
11,ENSG00000162129.7,72434531,11-72551164-T-A,rs1695328,-1,T,A,72551164,116633,72237923,72631139,313241
11,ENSG00000023445.8,102317484,11-102183092-A-T,rs17097475,1,A,T,102183092,134392,102120876,102514092,62216
11,ENSG00000023445.8,102317484,11-102183092-A-C,rs17097475,1,A,C,102183092,134392,102120876,102514092,62216
11,ENSG00000023445.8,102317484,11-102183092-A-G,rs17097475,1,A,G,102183092,134392,102120876,102514092,62216
11,ENSG00000175564.8,74009085,11-74013403-C-T,rs17132572,-1,C,T,74013403,4318,73812477,74205693,200926
11,ENSG00000085741.6,76206502,11-76393041-C-T,rs17134821,-1,C,T,76393041,186539,76009894,76403110,383147
11,ENSG00000188997.3,78188626,11-78173068-A-G,rs17136321,-1,A,G,78173068,15558,77992018,78385234,181050
11,ENSG00000137509.5,82900430,11-83077397-C-G,rs17144544,-1,C,G,83077397,176967,82703822,83097038,373575
11,ENSG00000137509.5,82900430,11-83077397-C-T,rs17144544,-1,C,T,83077397,176967,82703822,83097038,373575
11,ENSG00000170322.9,129895578,11-129894862-A-G,rs1733455,-1,A,G,129894862,716,129698970,130092186,195892
11,ENSG00000156603.10,57712215,11-57529798-A-C,rs17453436,-1,A,C,57529798,182417,57515607,57908823,14191
11,ENSG00000134824.9,61828300,11-61824890-A-G,rs174566,1,A,G,61824890,3410,61631692,62024908,193198
11,ENSG00000134824.9,61828300,11-61824890-A-C,rs174566,1,A,C,61824890,3410,61631692,62024908,193198
11,ENSG00000075239.9,108121567,11-108053377-A-G,rs17617000,1,A,G,108053377,68190,107924959,108318175,128418
11,ENSG00000156599.6,57668114,11-57680853-C-T,rs1783980,1,C,T,57680853,12739,57471506,57864722,209347
11,ENSG00000156599.6,57668114,11-57680853-C-G,rs1783980,1,C,G,57680853,12739,57471506,57864722,209347
11,ENSG00000166793.6,57649912,11-57644677-C-G,rs1798177,-1,C,G,57644677,5235,57453304,57846520,191373
11,ENSG00000166793.6,57649912,11-57644677-C-T,rs1798177,-1,C,T,57644677,5235,57453304,57846520,191373
11,ENSG00000221968.4,61891545,11-61959966-C-G,rs1801390,-1,C,G,61959966,68421,61694937,62088153,265029
11,ENSG00000221968.4,61891545,11-61959966-C-T,rs1801390,-1,C,T,61959966,68421,61694937,62088153,265029
11,ENSG00000132109.8,4393702,11-4419462-T-C,rs1823633,-1,T,C,4419462,25760,4197094,4590310,222368
11,ENSG00000132109.8,4393702,11-4419462-T-A,rs1823633,-1,T,A,4419462,25760,4197094,4590310,222368
11,ENSG00000110063.4,126304060,11-126290792-A-C,rs1893352,1,A,C,126290792,13268,126107452,126500668,183340
11,ENSG00000110063.4,126304060,11-126290792-A-G,rs1893352,1,A,G,126290792,13268,126107452,126500668,183340
11,ENSG00000179532.7,6497280,11-6447096-T-C,rs1906656,1,T,C,6447096,50184,6300672,6693888,146424
11,ENSG00000172500.8,65888471,11-65859230-C-T,rs1939212,-1,C,T,65859230,29241,65691863,66085079,167367
11,ENSG00000172500.8,65888471,11-65859230-C-G,rs1939212,-1,C,G,65859230,29241,65691863,66085079,167367
11,ENSG00000152558.10,102452765,11-102487376-C-A,rs1943783,-1,C,A,102487376,34611,102256157,102649373,231219
11,ENSG00000152558.10,102452765,11-102487376-C-T,rs1943783,-1,C,T,102487376,34611,102256157,102649373,231219
11,ENSG00000118369.8,78188919,11-77994490-C-G,rs2016147,1,C,G,77994490,194429,77992311,78385527,2179
11,ENSG00000118369.8,78188919,11-77994490-C-A,rs2016147,1,C,A,77994490,194429,77992311,78385527,2179
11,ENSG00000149091.10,46347463,11-46433248-G-A,rs2029378,1,G,A,46433248,85785,46150855,46544071,282393
11,ENSG00000205126.2,44047981,11-44004328-G-T,rs2074048,1,G,T,44004328,43653,43851373,44244589,152955
11,ENSG00000205126.2,44047981,11-44004328-G-A,rs2074048,1,G,A,44004328,43653,43851373,44244589,152955
11,ENSG00000188211.4,17351800,11-17400313-A-G,rs2074311,1,A,G,17400313,48513,17155192,17548408,245121
11,ENSG00000188211.4,17351800,11-17400313-A-T,rs2074311,1,A,T,17400313,48513,17155192,17548408,245121
11,ENSG00000172927.3,69294155,11-69137972-G-A,rs2123765,1,G,A,69137972,156183,69097547,69490763,40425
11,ENSG00000166002.2,93543391,11-93355990-G-T,rs2124559,-1,G,T,93355990,187401,93346783,93739999,9207
11,ENSG00000110696.4,16738647,11-16802189-G-T,rs216489,1,G,T,16802189,63542,16542039,16935255,260150
11,ENSG00000110696.4,16738647,11-16802189-G-A,rs216489,1,G,A,16802189,63542,16542039,16935255,260150
11,ENSG00000214026.6,1947332,11-1959960-G-A,rs217235,1,G,A,1959960,12628,1750724,2143940,209236
11,ENSG00000205213.8,27472790,11-27649363-T-C,rs2203877,-1,T,C,27649363,176573,27276182,27669398,373181
11,ENSG00000137673.4,102530747,11-102625267-T-C,rs2245803,-1,T,C,102625267,94520,102334139,102727355,291128
11,ENSG00000137673.4,102530747,11-102625267-T-G,rs2245803,-1,T,G,102625267,94520,102334139,102727355,291128
11,ENSG00000137673.4,102530747,11-102625267-T-A,rs2245803,-1,T,A,102625267,94520,102334139,102727355,291128
11,ENSG00000166796.7,18412318,11-18395321-A-G,rs2249631,1,A,G,18395321,16997,18215710,18608926,179611
11,ENSG00000166796.7,18412318,11-18395321-A-C,rs2249631,1,A,C,18395321,16997,18215710,18608926,179611
11,ENSG00000149292.11,113314583,11-113359878-C-T,rs2276070,1,C,T,113359878,45295,113117975,113511191,241903
11,ENSG00000165905.12,45922656,11-45902146-A-G,rs2280331,1,A,G,45902146,20510,45726048,46119264,176098
11,ENSG00000165905.12,45922656,11-45902146-A-C,rs2280331,1,A,C,45902146,20510,45726048,46119264,176098
11,ENSG00000165905.12,45922656,11-45902146-A-T,rs2280331,1,A,T,45902146,20510,45726048,46119264,176098
11,ENSG00000174576.4,66421035,11-66410481-C-T,rs2282530,1,C,T,66410481,10554,66224427,66617643,186054
11,ENSG00000151117.3,18698779,11-18707103-T-C,rs2289965,1,T,C,18707103,8324,18502171,18895387,204932
11,ENSG00000175356.8,9091599,11-9145567-C-A,rs2291840,-1,C,A,9145567,53968,8894991,9288207,250576
11,ENSG00000175356.8,9091599,11-9145567-C-T,rs2291840,-1,C,T,9145567,53968,8894991,9288207,250576
11,ENSG00000173992.4,66593185,11-66514624-G-A,rs2298806,1,G,A,66514624,78561,66396577,66789793,118047
11,ENSG00000134809.4,57530754,11-57445588-G-T,rs2439450,-1,G,T,57445588,85166,57334146,57727362,111442
11,ENSG00000134809.4,57530754,11-57445588-G-C,rs2439450,-1,G,C,57445588,85166,57334146,57727362,111442
11,ENSG00000134809.4,57530754,11-57445588-G-A,rs2439450,-1,G,A,57445588,85166,57334146,57727362,111442
11,ENSG00000162174.8,62337448,11-62316436-C-T,rs2463833,1,C,T,62316436,21012,62140840,62534056,175596
11,ENSG00000151498.6,134253568,11-134307381-C-T,rs2510356,1,C,T,134307381,53813,134056960,134450176,250421
11,ENSG00000110031.8,58575856,11-58593181-A-G,rs2510558,-1,A,G,58593181,17325,58379248,58772464,213933
11,ENSG00000110422.7,33257381,11-33249236-A-C,rs267442,1,A,C,33249236,8145,33060773,33453989,188463
11,ENSG00000110422.7,33257381,11-33249236-A-G,rs267442,1,A,G,33249236,8145,33060773,33453989,188463
11,ENSG00000110422.7,33257381,11-33249236-A-T,rs267442,1,A,T,33249236,8145,33060773,33453989,188463
11,ENSG00000110435.6,34916618,11-34880331-G-T,rs2915228,1,G,T,34880331,36287,34720010,35113226,160321
11,ENSG00000110435.6,34916618,11-34880331-G-C,rs2915228,1,G,C,34880331,36287,34720010,35113226,160321
11,ENSG00000110435.6,34916618,11-34880331-G-A,rs2915228,1,G,A,34880331,36287,34720010,35113226,160321
11,ENSG00000187049.5,61392587,11-61481911-C-A,rs3019200,1,C,A,61481911,89324,61195979,61589195,285932
11,ENSG00000187049.5,61392587,11-61481911-C-G,rs3019200,1,C,G,61481911,89324,61195979,61589195,285932
11,ENSG00000187049.5,61392587,11-61481911-C-T,rs3019200,1,C,T,61481911,89324,61195979,61589195,285932
11,ENSG00000109861.8,88337736,11-88175178-C-G,rs302647,-1,C,G,88175178,162558,88141128,88534344,34050
11,ENSG00000166105.11,134276379,11-134279180-A-G,rs3132810,1,A,G,134279180,2801,134079771,134472987,199409
11,ENSG00000258659.1,5625001,11-5518916-T-C,rs317779,1,T,C,5518916,106085,5428393,5821609,90523
11,ENSG00000172425.6,118527474,11-118341956-C-T,rs3181261,1,C,T,118341956,185518,118330866,118724082,11090
11,ENSG00000176340.3,63974620,11-64000925-T-G,rs320156,1,T,G,64000925,26305,63778012,64171228,222913
11,ENSG00000176340.3,63974620,11-64000925-T-C,rs320156,1,T,C,64000925,26305,63778012,64171228,222913
11,ENSG00000110455.9,44066270,11-44067802-G-A,rs33952257,1,G,A,44067802,1532,43869662,44262878,198140
11,ENSG00000110455.9,44066270,11-44067802-G-T,rs33952257,1,G,T,44067802,1532,43869662,44262878,198140
11,ENSG00000172613.3,67391986,11-67382636-A-G,rs34087937,1,A,G,67382636,9350,67195378,67588594,187258
11,ENSG00000110514.13,47270156,11-47285079-C-G,rs35233100,1,C,G,47285079,14923,47073548,47466764,211531
11,ENSG00000110514.13,47270156,11-47285079-C-T,rs35233100,1,C,T,47285079,14923,47073548,47466764,211531
11,ENSG00000049449.3,32091074,11-32119953-A-T,rs35511729,1,A,T,32119953,28879,31894466,32287682,225487
11,ENSG00000049449.3,32091074,11-32119953-A-G,rs35511729,1,A,G,32119953,28879,31894466,32287682,225487
11,ENSG00000049449.3,32091074,11-32119953-A-C,rs35511729,1,A,C,32119953,28879,31894466,32287682,225487
11,ENSG00000185187.7,414999,11-403545-C-T,rs35828848,-1,C,T,403545,11454,218391,611607,185154
11,ENSG00000110721.6,68121388,11-68041801-C-T,rs36027301,-1,C,T,68041801,79587,67924780,68317996,117021
11,ENSG00000110721.6,68121388,11-68041801-C-G,rs36027301,-1,C,G,68041801,79587,67924780,68317996,117021
11,ENSG00000165912.10,47186434,11-47350047-C-T,rs3729986,-1,C,T,47350047,163613,46989826,47383042,360221
11,ENSG00000149743.9,64226186,11-64363808-T-C,rs3782101,-1,T,C,64363808,137622,64029578,64422794,334230
11,ENSG00000154134.10,124865432,11-124954085-C-T,rs3809055,1,C,T,124954085,88653,124668824,125062040,285261
11,ENSG00000142102.11,289126,11-290233-A-T,rs3809109,1,A,T,290233,1107,92518,485734,197715
11,ENSG00000142102.11,289126,11-290233-A-G,rs3809109,1,A,G,290233,1107,92518,485734,197715
11,ENSG00000150782.7,112164094,11-112228687-T-C,rs3819331,-1,T,C,112228687,64593,111967486,112360702,261201
11,ENSG00000175518.5,5516699,11-5634003-G-A,rs3824951,-1,G,A,5634003,117304,5320091,5713307,313912
11,ENSG00000110107.4,60906585,11-60868754-T-G,rs3888242,-1,T,G,60868754,37831,60709977,61103193,158777
11,ENSG00000110107.4,60906585,11-60868754-T-C,rs3888242,-1,T,C,60868754,37831,60709977,61103193,158777
11,ENSG00000180425.6,114400511,11-114221819-C-T,rs398055,-1,C,T,114221819,178692,114203903,114597119,17916
11,ENSG00000180425.6,114400511,11-114221819-C-G,rs398055,-1,C,G,114221819,178692,114203903,114597119,17916
11,ENSG00000177595.12,805231,11-723429-C-T,rs4078520,-1,C,T,723429,81802,608623,1001839,114806
11,ENSG00000214517.4,74171289,11-74341219-C-A,rs41349744,1,C,A,74341219,169930,73974681,74367897,366538
11,ENSG00000214517.4,74171289,11-74341219-C-G,rs41349744,1,C,G,74341219,169930,73974681,74367897,366538
11,ENSG00000177105.9,3840959,11-3864840-T-C,rs4243965,-1,T,C,3864840,23881,3644351,4037567,220489
11,ENSG00000134910.7,125592852,11-125513851-G-A,rs4344501,1,G,A,125513851,79001,125396244,125789460,117607
11,ENSG00000174684.5,66347629,11-66309732-A-G,rs4390351,-1,A,G,66309732,37897,66151021,66544237,158711
11,ENSG00000166257.4,123654624,11-123697613-G-T,rs4430519,-1,G,T,123697613,42989,123458016,123851232,239597
11,ENSG00000110619.12,3057423,11-2887735-A-G,rs450563,-1,A,G,2887735,169688,2860815,3254031,26920
11,ENSG00000137491.9,75151107,11-75060433-T-C,rs4531492,1,T,C,75060433,90674,74954499,75347715,105934
11,ENSG00000137491.9,75151107,11-75060433-T-G,rs4531492,1,T,G,75060433,90674,74954499,75347715,105934
11,ENSG00000137491.9,75151107,11-75060433-T-A,rs4531492,1,T,A,75060433,90674,74954499,75347715,105934
11,ENSG00000161328.10,537527,11-536284-A-T,rs45473693,1,A,T,536284,1243,340919,734135,195365
11,ENSG00000161328.10,537527,11-536284-A-G,rs45473693,1,A,G,536284,1243,340919,734135,195365
11,ENSG00000177054.9,19117168,11-19182856-A-G,rs45549043,1,A,G,19182856,65688,18920560,19313776,262296
11,ENSG00000150776.12,112074299,11-111993877-C-T,rs45579845,1,C,T,111993877,80422,111877691,112270907,116186
11,ENSG00000177103.8,117797216,11-117786201-G-A,rs4603339,-1,G,A,117786201,11015,117600608,117993824,185593
11,ENSG00000175334.3,66002503,11-65956820-C-A,rs470192,1,C,A,65956820,45683,65805895,66199111,150925
11,ENSG00000175334.3,66002503,11-65956820-C-G,rs470192,1,C,G,65956820,45683,65805895,66199111,150925
11,ENSG00000175334.3,66002503,11-65956820-C-T,rs470192,1,C,T,65956820,45683,65805895,66199111,150925
11,ENSG00000166086.7,134069072,11-134100666-G-A,rs470461,1,G,A,134100666,31594,133872464,134265680,228202
11,ENSG00000166012.10,93741495,11-93604018-T-A,rs4753482,-1,T,A,93604018,137477,93544887,93938103,59131
11,ENSG00000166012.10,93741495,11-93604018-T-C,rs4753482,-1,T,C,93604018,137477,93544887,93938103,59131
11,ENSG00000166012.10,93741495,11-93604018-T-G,rs4753482,-1,T,G,93604018,137477,93544887,93938103,59131
11,ENSG00000204397.3,105045335,11-105150774-A-T,rs4755086,-1,A,T,105150774,105439,104848727,105241943,302047
11,ENSG00000204397.3,105045335,11-105150774-A-G,rs4755086,-1,A,G,105150774,105439,104848727,105241943,302047
11,ENSG00000110768.5,18322567,11-18291406-G-A,rs4757638,1,G,A,18291406,31161,18125959,18519175,165447
11,ENSG00000110768.5,18322567,11-18291406-G-T,rs4757638,1,G,T,18291406,31161,18125959,18519175,165447
11,ENSG00000183801.3,7485506,11-7522020-T-G,rs4757997,1,T,G,7522020,36514,7288898,7682114,233122
11,ENSG00000183801.3,7485506,11-7522020-T-A,rs4757997,1,T,A,7522020,36514,7288898,7682114,233122
11,ENSG00000255561.2,111879165,11-112018930-C-T,rs476581,-1,C,T,112018930,139765,111682557,112075773,336373
11,ENSG00000255561.2,111879165,11-112018930-C-G,rs476581,-1,C,G,112018930,139765,111682557,112075773,336373
11,ENSG00000214872.4,57537595,11-57720688-G-A,rs480933,1,G,A,57720688,183093,57340987,57734203,379701
11,ENSG00000214872.4,57537595,11-57720688-G-T,rs480933,1,G,T,57720688,183093,57340987,57734203,379701
11,ENSG00000142082.10,236342,11-253390-G-A,rs491007,-1,G,A,253390,17048,39734,432950,213656
11,ENSG00000162341.9,69048932,11-69049761-C-A,rs4930259,1,C,A,69049761,829,68852324,69245540,197437
11,ENSG00000162341.9,69048932,11-69049761-C-G,rs4930259,1,C,G,69049761,829,68852324,69245540,197437
11,ENSG00000162341.9,69048932,11-69049761-C-T,rs4930259,1,C,T,69049761,829,68852324,69245540,197437
11,ENSG00000196655.5,119018766,11-118975864-T-C,rs4938604,1,T,C,118975864,42902,118822158,119215374,153706
11,ENSG00000177030.10,695222,11-656845-G-C,rs4963126,-1,G,C,656845,38377,498614,891830,158231
11,ENSG00000177030.10,695222,11-656845-G-A,rs4963126,-1,G,A,656845,38377,498614,891830,158231
11,ENSG00000173113.2,64317559,11-64417263-T-C,rs4963222,-1,T,C,64417263,99704,64120951,64514167,296312
11,ENSG00000149503.8,62124011,11-62271929-C-A,rs4963488,1,C,A,62271929,147918,61927403,62320619,344526
11,ENSG00000149503.8,62124011,11-62271929-C-G,rs4963488,1,C,G,62271929,147918,61927403,62320619,344526
11,ENSG00000149503.8,62124011,11-62271929-C-T,rs4963488,1,C,T,62271929,147918,61927403,62320619,344526
11,ENSG00000189057.6,59107237,11-58924574-T-C,rs497559,1,T,C,58924574,182663,58910629,59303845,13945
11,ENSG00000020922.7,94493844,11-94492754-C-A,rs497763,-1,C,A,94492754,1090,94297236,94690452,195518
11,ENSG00000020922.7,94493844,11-94492754-C-T,rs497763,-1,C,T,94492754,1090,94297236,94690452,195518
11,ENSG00000168061.8,65041210,11-65026488-A-G,rs500464,1,A,G,65026488,14722,64844602,65237818,181886
11,ENSG00000166435.10,74949091,11-74962225-A-C,rs529488,-1,A,C,74962225,13134,74752483,75145699,209742
11,ENSG00000166435.10,74949091,11-74962225-A-G,rs529488,-1,A,G,74962225,13134,74752483,75145699,209742
11,ENSG00000137731.8,117824744,11-117822540-T-C,rs529623,-1,T,C,117822540,2204,117628136,118021352,194404
11,ENSG00000197580.7,112175512,11-112062631-C-A,rs534753,1,C,A,112062631,112881,111978904,112372120,83727
11,ENSG00000137486.12,75351661,11-75491891-G-A,rs550957,-1,G,A,75491891,140230,75155053,75548269,336838
11,ENSG00000173825.6,65354751,11-65279991-G-A,rs55760428,1,G,A,65279991,74760,65158143,65551359,121848
11,ENSG00000166439.5,74748849,11-74781797-T-G,rs558303,1,T,G,74781797,32948,74552241,74945457,229556
11,ENSG00000110660.9,107858787,11-107803469-C-A,rs562592,-1,C,A,107803469,55318,107662179,108055395,141290
11,ENSG00000110660.9,107858787,11-107803469-C-T,rs562592,-1,C,T,107803469,55318,107662179,108055395,141290
11,ENSG00000120457.6,128891356,11-128918422-G-A,rs56398738,1,G,A,128918422,27066,128694748,129087964,223674
11,ENSG00000110723.6,108593768,11-108569703-A-G,rs57968532,-1,A,G,108569703,24065,108397160,108790376,172543
11,ENSG00000172818.5,65787063,11-65740134-T-C,rs603509,1,T,C,65740134,46929,65590455,65983671,149679
11,ENSG00000172818.5,65787063,11-65740134-T-A,rs603509,1,T,A,65740134,46929,65590455,65983671,149679
11,ENSG00000173039.12,65662916,11-65707640-A-G,rs605952,-1,A,G,65707640,44724,65466308,65859524,241332
11,ENSG00000173486.8,64241095,11-64116555-C-T,rs614035,1,C,T,64116555,124540,64044487,64437703,72068
11,ENSG00000173486.8,64241095,11-64116555-C-G,rs614035,1,C,G,64116555,124540,64044487,64437703,72068
11,ENSG00000099834.13,624955,11-526356-G-A,rs61877777,-1,G,A,526356,98599,428347,821563,98009
11,ENSG00000182704.5,76783356,11-76628267-G-A,rs61893484,1,G,A,76628267,155089,76586748,76979964,41519
11,ENSG00000182704.5,76783356,11-76628267-G-C,rs61893484,1,G,C,76628267,155089,76586748,76979964,41519
11,ENSG00000182704.5,76783356,11-76628267-G-T,rs61893484,1,G,T,76628267,155089,76586748,76979964,41519
11,ENSG00000132744.3,67650730,11-67652857-G-C,rs61894522,-1,G,C,67652857,2127,67454122,67847338,198735
11,ENSG00000132744.3,67650730,11-67652857-G-A,rs61894522,-1,G,A,67652857,2127,67454122,67847338,198735
11,ENSG00000149428.12,119057205,11-118911513-T-C,rs61900138,-1,T,C,118911513,145692,118860597,119253813,50916
11,ENSG00000149428.12,119057205,11-118911513-T-A,rs61900138,-1,T,A,118911513,145692,118860597,119253813,50916
11,ENSG00000165434.4,74398433,11-74576672-C-T,rs61901536,-1,C,T,74576672,178239,74201825,74595041,374847
11,ENSG00000170209.4,113387779,11-113566966-C-A,rs61902850,1,C,A,113566966,179187,113191171,113584387,375795
11,ENSG00000160613.7,117232073,11-117155339-A-G,rs61905477,-1,A,G,117155339,76734,117035465,117428681,119874
11,ENSG00000173327.3,65614221,11-65498698-A-G,rs619586,-1,A,G,65498698,115523,65417613,65810829,81085
11,ENSG00000173327.3,65614221,11-65498698-A-T,rs619586,-1,A,T,65498698,115523,65417613,65810829,81085
11,ENSG00000149218.4,95089846,11-95080336-T-C,rs622175,1,T,C,95080336,9510,94893238,95286454,187098
11,ENSG00000149218.4,95089846,11-95080336-T-A,rs622175,1,T,A,95080336,9510,94893238,95286454,187098
11,ENSG00000149218.4,95089846,11-95080336-T-G,rs622175,1,T,G,95080336,9510,94893238,95286454,187098
11,ENSG00000172803.12,65833963,11-65895768-T-C,rs622614,1,T,C,65895768,61805,65637355,66030571,258413
11,ENSG00000172803.12,65833963,11-65895768-T-A,rs622614,1,T,A,65895768,61805,65637355,66030571,258413
11,ENSG00000172803.12,65833963,11-65895768-T-G,rs622614,1,T,G,65895768,61805,65637355,66030571,258413
11,ENSG00000137648.12,118077078,11-118124982-A-T,rs626562,1,A,T,118124982,47904,117880470,118273686,244512
11,ENSG00000137648.12,118077078,11-118124982-A-G,rs626562,1,A,G,118124982,47904,117880470,118273686,244512
11,ENSG00000137648.12,118077078,11-118124982-A-C,rs626562,1,A,C,118124982,47904,117880470,118273686,244512
11,ENSG00000110108.3,60914158,11-60791572-C-A,rs630084,1,C,A,60791572,122586,60717550,61110766,74022
11,ENSG00000183134.4,60855950,11-60829105-G-A,rs632089,-1,G,A,60829105,26845,60659342,61052558,169763
11,ENSG00000158555.10,75525941,11-75541831-T-G,rs633473,-1,T,G,75541831,15890,75329333,75722549,212498
11,ENSG00000179431.5,35618460,11-35603320-T-C,rs645052,1,T,C,35603320,15140,35421852,35815068,181468
11,ENSG00000171219.8,64844653,11-64826921-T-G,rs647145,-1,T,G,64826921,17732,64648045,65041261,178876
11,ENSG00000171219.8,64844653,11-64826921-T-A,rs647145,-1,T,A,64826921,17732,64648045,65041261,178876
11,ENSG00000171219.8,64844653,11-64826921-T-C,rs647145,-1,T,C,64826921,17732,64648045,65041261,178876
11,ENSG00000110375.2,118956298,11-118941803-C-G,rs647769,1,C,G,118941803,14495,118759690,119152906,182113
11,ENSG00000110375.2,118956298,11-118941803-C-T,rs647769,1,C,T,118941803,14495,118759690,119152906,182113
11,ENSG00000214290.3,111298546,11-111296832-A-T,rs6589218,1,A,T,111296832,1714,111101938,111495154,194894
11,ENSG00000214290.3,111298546,11-111296832-A-C,rs6589218,1,A,C,111296832,1714,111101938,111495154,194894
11,ENSG00000214290.3,111298546,11-111296832-A-G,rs6589218,1,A,G,111296832,1714,111101938,111495154,194894
11,ENSG00000149591.11,117199370,11-117127082-C-T,rs6589597,1,C,T,117127082,72288,117002762,117395978,124320
11,ENSG00000173621.7,66857064,11-66908519-A-C,rs6591226,1,A,C,66908519,51455,66660456,67053672,248063
11,ENSG00000173621.7,66857064,11-66908519-A-G,rs6591226,1,A,G,66908519,51455,66660456,67053672,248063
11,ENSG00000174885.8,278407,11-254010-T-C,rs6598054,1,T,C,254010,24397,81799,475015,172211
11,ENSG00000174885.8,278407,11-254010-T-G,rs6598054,1,T,G,254010,24397,81799,475015,172211
11,ENSG00000171533.6,75669038,11-75632484-G-A,rs663515,-1,G,A,75632484,36554,75472430,75865646,160054
11,ENSG00000175575.8,73876999,11-73786315-C-T,rs66610247,1,C,T,73786315,90684,73680391,74073607,105924
11,ENSG00000182919.9,93741672,11-93777638-C-G,rs66797025,1,C,G,93777638,35966,93545064,93938280,232574
11,ENSG00000133328.3,63563379,11-63566746-G-T,rs673767,-1,G,T,63566746,3367,63366771,63759987,199975
11,ENSG00000133328.3,63563379,11-63566746-G-A,rs673767,-1,G,A,63566746,3367,63366771,63759987,199975
11,ENSG00000084207.11,67583812,11-67520372-A-C,rs687058,1,A,C,67520372,63440,67387204,67780420,133168
11,ENSG00000084207.11,67583812,11-67520372-A-T,rs687058,1,A,T,67520372,63440,67387204,67780420,133168
11,ENSG00000085733.11,70398529,11-70436523-A-T,rs6894,1,A,T,70436523,37994,70201921,70595137,234602
11,ENSG00000085733.11,70398529,11-70436523-A-C,rs6894,1,A,C,70436523,37994,70201921,70595137,234602
11,ENSG00000149782.7,64251530,11-64113253-C-T,rs693984,1,C,T,64113253,138277,64054922,64448138,58331
11,ENSG00000150433.5,125111626,11-125097259-G-T,rs7030,-1,G,T,125097259,14367,124915018,125308234,182241
11,ENSG00000172543.3,65879837,11-65827349-T-A,rs7102454,1,T,A,65827349,52488,65683229,66076445,144120
11,ENSG00000172543.3,65879837,11-65827349-T-C,rs7102454,1,T,C,65827349,52488,65683229,66076445,144120
11,ENSG00000176102.6,33161480,11-33019792-C-T,rs7105777,-1,C,T,33019792,141688,32964872,33358088,54920
11,ENSG00000149196.10,86302240,11-86348381-T-C,rs7106664,1,T,C,86348381,46141,86105632,86498848,242749
11,ENSG00000149196.10,86302240,11-86348381-T-A,rs7106664,1,T,A,86348381,46141,86105632,86498848,242749
11,ENSG00000014216.9,65181928,11-65306061-C-T,rs7108941,1,C,T,65306061,124133,64985320,65378536,320741
11,ENSG00000149262.10,77994668,11-77986205-G-C,rs7110670,-1,G,C,77986205,8463,77798060,78191276,188145
11,ENSG00000149262.10,77994668,11-77986205-G-A,rs7110670,-1,G,A,77986205,8463,77798060,78191276,188145
11,ENSG00000186642.8,72674422,11-72629722-G-A,rs7111188,-1,G,A,72629722,44700,72477814,72871030,151908
11,ENSG00000186642.8,72674422,11-72629722-G-T,rs7111188,-1,G,T,72629722,44700,72477814,72871030,151908
11,ENSG00000064199.2,124673904,11-124629970-G-T,rs7112299,1,G,T,124629970,43934,124477296,124870512,152674
11,ENSG00000064199.2,124673904,11-124629970-G-A,rs7112299,1,G,A,124629970,43934,124477296,124870512,152674
11,ENSG00000064199.2,124673904,11-124629970-G-C,rs7112299,1,G,C,124629970,43934,124477296,124870512,152674
11,ENSG00000072952.12,10693755,11-10575534-G-C,rs7115310,-1,G,C,10575534,118221,10497147,10890363,78387
11,ENSG00000072952.12,10693755,11-10575534-G-A,rs7115310,-1,G,A,10575534,118221,10497147,10890363,78387
11,ENSG00000149089.7,34916379,11-34879576-A-G,rs7118017,-1,A,G,34879576,36803,34719771,35112987,159805
11,ENSG00000176148.10,33039572,11-33180993-G-A,rs7118193,1,G,A,33180993,141421,32842964,33236180,338029
11,ENSG00000165917.5,47449136,11-47603494-C-T,rs7123576,-1,C,T,47603494,154358,47252528,47645744,350966
11,ENSG00000165917.5,47449136,11-47603494-C-A,rs7123576,-1,C,A,47603494,154358,47252528,47645744,350966
11,ENSG00000166004.9,93661682,11-93544100-C-T,rs7126188,1,C,T,93544100,117582,93465074,93858290,79026
11,ENSG00000074266.10,86244753,11-86237429-C-T,rs7128259,1,C,T,86237429,7324,86048145,86441361,189284
11,ENSG00000149050.5,7020346,11-6920640-T-C,rs7128685,-1,T,C,6920640,99706,6823738,7216954,96902
11,ENSG00000149179.8,46936761,11-46807345-A-G,rs7129622,1,A,G,46807345,129416,46740153,47133369,67192
11,ENSG00000185522.4,560738,11-541462-C-T,rs72841219,-1,C,T,541462,19276,364130,757346,177332
11,ENSG00000185101.8,442011,11-443587-C-G,rs72848748,-1,C,G,443587,1576,245403,638619,198184
11,ENSG00000185101.8,442011,11-443587-C-T,rs72848748,-1,C,T,443587,1576,245403,638619,198184
11,ENSG00000255823.1,10509186,11-10496971-T-C,rs72857486,-1,T,C,10496971,12215,10312578,10705794,184393
11,ENSG00000110315.2,10541187,11-10579849-T-C,rs72861083,-1,T,C,10579849,38662,10344579,10737795,235270
11,ENSG00000134627.7,94567368,11-94598254-T-G,rs72965817,1,T,G,94598254,30886,94370760,94763976,227494
11,ENSG00000196371.2,94543921,11-94598254-T-G,rs72965817,1,T,G,94598254,54333,94347313,94740529,250941
11,ENSG00000183020.7,925870,11-951558-C-G,rs7394744,1,C,G,951558,25688,729262,1122478,222296
11,ENSG00000183020.7,925870,11-951558-C-T,rs7394744,1,C,T,951558,25688,729262,1122478,222296
11,ENSG00000177951.12,207399,11-331326-C-G,rs7395319,-1,C,G,331326,123927,10791,404007,320535
11,ENSG00000177951.12,207399,11-331326-C-T,rs7395319,-1,C,T,331326,123927,10791,404007,320535
11,ENSG00000177106.9,706231,11-551405-G-A,rs7396875,1,G,A,551405,154826,509623,902839,41782
11,ENSG00000177106.9,706231,11-551405-G-C,rs7396875,1,G,C,551405,154826,509623,902839,41782
11,ENSG00000148943.7,27506769,11-27592200-T-A,rs74425542,-1,T,A,27592200,85431,27310161,27703377,282039
11,ENSG00000160593.12,118225011,11-118300570-T-C,rs7479373,-1,T,C,118300570,75559,118028403,118421619,272167
11,ENSG00000184363.5,394209,11-394897-G-A,rs7480979,1,G,A,394897,688,197601,590817,197296
11,ENSG00000181649.5,2929420,11-3046128-G-T,rs74937625,-1,G,T,3046128,116708,2732812,3126028,313316
11,ENSG00000181649.5,2929420,11-3046128-G-A,rs74937625,-1,G,A,3046128,116708,2732812,3126028,313316
11,ENSG00000129757.8,2885775,11-3046128-G-T,rs74937625,-1,G,T,3046128,160353,2689167,3082383,356961
11,ENSG00000129757.8,2885775,11-3046128-G-A,rs74937625,-1,G,A,3046128,160353,2689167,3082383,356961
11,ENSG00000175550.3,65919426,11-65959884-G-A,rs75132850,1,G,A,65959884,40458,65722818,66116034,237066
11,ENSG00000166483.5,9573670,11-9464020-C-T,rs75952642,1,C,T,9464020,109650,9377062,9770278,86958
11,ENSG00000173442.7,65576053,11-65569387-C-G,rs75956291,1,C,G,65569387,6666,65379445,65772661,189942
11,ENSG00000173442.7,65576053,11-65569387-C-T,rs75956291,1,C,T,65569387,6666,65379445,65772661,189942
11,ENSG00000175348.6,8964442,11-9005402-T-A,rs76060406,-1,T,A,9005402,40960,8767834,9161050,237568
11,ENSG00000175348.6,8964442,11-9005402-T-G,rs76060406,-1,T,G,9005402,40960,8767834,9161050,237568
11,ENSG00000175348.6,8964442,11-9005402-T-C,rs76060406,-1,T,C,9005402,40960,8767834,9161050,237568
11,ENSG00000168014.11,74171002,11-74011274-C-T,rs76646689,-1,C,T,74011274,159728,73974394,74367610,36880
11,ENSG00000110395.3,119206339,11-119193862-G-C,rs76799613,1,G,C,119193862,12477,119009731,119402947,184131
11,ENSG00000110395.3,119206339,11-119193862-G-A,rs76799613,1,G,A,119193862,12477,119009731,119402947,184131
11,ENSG00000149201.5,86374887,11-86493096-G-T,rs77901674,1,G,T,86493096,118209,86178279,86571495,314817
11,ENSG00000185475.3,62787402,11-62907759-G-A,rs77909007,1,G,A,62907759,120357,62590794,62984010,316965
11,ENSG00000149489.4,62613257,11-62646190-C-T,rs78278641,1,C,T,62646190,32933,62416649,62809865,229541
11,ENSG00000172409.5,57657762,11-57730834-A-G,rs78459567,1,A,G,57730834,73072,57461154,57854370,269680
11,ENSG00000177830.13,910810,11-895596-C-T,rs78744412,-1,C,T,895596,15214,714202,1107418,181394
11,ENSG00000167987.5,61161426,11-61063095-T-A,rs7925904,-1,T,A,61063095,98331,60964818,61358034,98277
11,ENSG00000167987.5,61161426,11-61063095-T-C,rs7925904,-1,T,C,61063095,98331,60964818,61358034,98277
11,ENSG00000197601.7,13668668,11-13634539-G-A,rs7927727,1,G,A,13634539,34129,13472060,13865276,162479
11,ENSG00000110002.10,124115450,11-124156395-C-T,rs7929877,1,C,T,124156395,40945,123918842,124312058,237553
11,ENSG00000132259.8,6239089,11-6302831-C-T,rs7930238,1,C,T,6302831,63742,6042481,6435697,260350
11,ENSG00000132259.8,6239089,11-6302831-C-A,rs7930238,1,C,A,6302831,63742,6042481,6435697,260350
11,ENSG00000132259.8,6239089,11-6302831-C-G,rs7930238,1,C,G,6302831,63742,6042481,6435697,260350
11,ENSG00000173599.9,66958383,11-66914163-T-G,rs7935749,-1,T,G,66914163,44220,66761775,67154991,152388
11,ENSG00000173599.9,66958383,11-66914163-T-C,rs7935749,-1,T,C,66914163,44220,66761775,67154991,152388
11,ENSG00000166788.5,18106082,11-18189267-G-A,rs7936382,-1,G,A,18189267,83185,17909474,18302690,279793
11,ENSG00000019102.7,124752255,11-124778591-C-A,rs7937766,-1,C,A,124778591,26336,124555647,124948863,222944
11,ENSG00000019102.7,124752255,11-124778591-C-T,rs7937766,-1,C,T,124778591,26336,124555647,124948863,222944
11,ENSG00000177697.12,832952,11-890405-T-C,rs7940112,1,T,C,890405,57453,636344,1029560,254061
11,ENSG00000177697.12,832952,11-890405-T-G,rs7940112,1,T,G,890405,57453,636344,1029560,254061
11,ENSG00000110429.8,33774520,11-33904428-T-C,rs7941248,-1,T,C,33904428,129908,33577912,33971128,326516
11,ENSG00000166452.7,8911189,11-9017378-T-C,rs7941341,1,T,C,9017378,106189,8714581,9107797,302797
11,ENSG00000064201.10,2302013,11-2294174-G-A,rs7941928,1,G,A,2294174,7839,2105405,2498621,188769
11,ENSG00000064201.10,2302013,11-2294174-G-T,rs7941928,1,G,T,2294174,7839,2105405,2498621,188769
11,ENSG00000110665.7,2301918,11-2294174-G-A,rs7941928,-1,G,A,2294174,7744,2105310,2498526,188864
11,ENSG00000110665.7,2301918,11-2294174-G-T,rs7941928,-1,G,T,2294174,7744,2105310,2498526,188864
11,ENSG00000176485.6,63614433,11-63784387-C-T,rs7943981,-1,C,T,63784387,169954,63417825,63811041,366562
11,ENSG00000176485.6,63614433,11-63784387-C-G,rs7943981,-1,C,G,63784387,169954,63417825,63811041,366562
11,ENSG00000166444.12,8810674,11-8795729-A-T,rs7944560,-1,A,T,8795729,14945,8614066,9007282,181663
11,ENSG00000186652.5,57390650,11-57396505-C-A,rs7945326,-1,C,A,57396505,5855,57194042,57587258,202463
11,ENSG00000186652.5,57390650,11-57396505-C-T,rs7945326,-1,C,T,57396505,5855,57194042,57587258,202463
11,ENSG00000166575.10,87037934,11-87180098-C-T,rs7946112,1,C,T,87180098,142164,86841326,87234542,338772
11,ENSG00000110777.7,111379275,11-111322382-G-A,rs7946656,-1,G,A,111322382,56893,111182667,111575883,139715
11,ENSG00000162337.7,68312591,11-68171381-A-C,rs7949511,1,A,C,68171381,141210,68115983,68509199,55398
11,ENSG00000109920.7,47767341,11-47610843-A-G,rs7952214,-1,A,G,47610843,156498,47570733,47963949,40110
11,ENSG00000158636.11,76445025,11-76641322-C-T,rs79602083,1,C,T,76641322,196297,76248417,76641633,392905
11,ENSG00000162105.9,71252577,11-71304004-C-A,rs79854874,-1,C,A,71304004,51427,71055969,71449185,248035
11,ENSG00000162105.9,71252577,11-71304004-C-T,rs79854874,-1,C,T,71304004,51427,71055969,71449185,248035
11,ENSG00000166801.11,59142856,11-59302837-T-C,rs80143522,1,T,C,59302837,159981,58946248,59339464,356589
11,ENSG00000174165.3,66546048,11-66532044-A-G,rs8432,-1,A,G,66532044,14004,66349440,66742656,182604
11,ENSG00000130592.9,1853084,11-1852842-G-A,rs907611,1,G,A,1852842,242,1656476,2049692,196366
11,ENSG00000109944.5,122882759,11-122963670-C-T,rs930982,1,C,T,122963670,80911,122686151,123079367,277519
11,ENSG00000109944.5,122882759,11-122963670-C-G,rs930982,1,C,G,122963670,80911,122686151,123079367,277519
11,ENSG00000174871.6,66278175,11-66224537-T-C,rs9326370,1,T,C,66224537,53638,66081567,66474783,142970
11,ENSG00000160588.5,118252365,11-118447464-G-T,rs9332755,-1,G,T,118447464,195099,118055757,118448973,391707
11,ENSG00000149582.10,118531192,11-118521851-G-A,rs9332865,1,G,A,118521851,9341,118334584,118727800,187267
11,ENSG00000213465.3,65014160,11-65083833-C-T,rs947799,1,C,T,65083833,69673,64817552,65210768,266281
11,ENSG00000213465.3,65014160,11-65083833-C-G,rs947799,1,C,G,65083833,69673,64817552,65210768,266281
11,ENSG00000110237.3,73308276,11-73369360-A-T,rs947837,1,A,T,73369360,61084,73111668,73504884,257692
11,ENSG00000110237.3,73308276,11-73369360-A-G,rs947837,1,A,G,73369360,61084,73111668,73504884,257692
11,ENSG00000110074.6,126269154,11-126423293-G-C,rs948054,1,G,C,126423293,154139,126072546,126465762,350747
11,ENSG00000110074.6,126269154,11-126423293-G-A,rs948054,1,G,A,126423293,154139,126072546,126465762,350747
11,ENSG00000110074.6,126269154,11-126423293-G-T,rs948054,1,G,T,126423293,154139,126072546,126465762,350747
11,ENSG00000076043.5,114439467,11-114317742-C-T,rs949370,1,C,T,114317742,121725,114242859,114636075,74883
11,ENSG00000181074.3,5754243,11-5738230-T-C,rs9665780,1,T,C,5738230,16013,5557635,5950851,180595
11,ENSG00000131620.12,70078317,11-70111811-A-T,rs9666157,1,A,T,70111811,33494,69881709,70274925,230102
11,ENSG00000131620.12,70078317,11-70111811-A-G,rs9666157,1,A,G,70111811,33494,69881709,70274925,230102
11,ENSG00000131620.12,70078317,11-70111811-A-C,rs9666157,1,A,C,70111811,33494,69881709,70274925,230102
11,ENSG00000185201.10,307816,11-308065-T-A,rs9704108,1,T,A,308065,249,111208,504424,196857
11,ENSG00000185201.10,307816,11-308065-T-G,rs9704108,1,T,G,308065,249,111208,504424,196857
11,ENSG00000185201.10,307816,11-308065-T-C,rs9704108,1,T,C,308065,249,111208,504424,196857
11,ENSG00000184014.3,9265350,11-9163530-T-C,rs9888257,-1,T,C,9163530,101820,9068742,9461958,94788
11,ENSG00000214872.4,57537595,11-57599183-C-T,rs1005511,1,C,T,57599183,61588,57340987,57734203,258196
11,ENSG00000154134.10,124865432,11-124946092-T-C,rs10160759,1,T,C,124946092,80660,124668824,125062040,277268
11,ENSG00000154134.10,124865432,11-124946092-T-G,rs10160759,1,T,G,124946092,80660,124668824,125062040,277268
11,ENSG00000154134.10,124865432,11-124946092-T-A,rs10160759,1,T,A,124946092,80660,124668824,125062040,277268
11,ENSG00000149084.7,43680738,11-43587974-T-C,rs1023956,1,T,C,43587974,92764,43484130,43877346,103844
11,ENSG00000110756.12,18322140,11-18279407-G-A,rs1046615,-1,G,A,18279407,42733,18125532,18518748,153875
11,ENSG00000166313.11,6419094,11-6438796-C-A,rs10500671,-1,C,A,6438796,19702,6222486,6615702,216310
11,ENSG00000133794.12,13277790,11-13111621-C-T,rs10500772,1,C,T,13111621,166169,13081182,13474398,30439
11,ENSG00000166959.3,60699612,11-60753752-T-G,rs10736710,1,T,G,60753752,54140,60503004,60896220,250748
11,ENSG00000166012.10,93741495,11-93628657-A-G,rs10765617,-1,A,G,93628657,112838,93544887,93938103,83770
11,ENSG00000166012.10,93741495,11-93628657-A-C,rs10765617,-1,A,C,93628657,112838,93544887,93938103,83770
11,ENSG00000166012.10,93741495,11-93628657-A-T,rs10765617,-1,A,T,93628657,112838,93544887,93938103,83770
11,ENSG00000042429.5,93784282,11-93668027-A-G,rs10765620,1,A,G,93668027,116255,93587674,93980890,80353
11,ENSG00000110619.12,3057423,11-3240815-G-C,rs10766817,-1,G,C,3240815,183392,2860815,3254031,380000
11,ENSG00000110619.12,3057423,11-3240815-G-A,rs10766817,-1,G,A,3240815,183392,2860815,3254031,380000
11,ENSG00000180425.6,114400511,11-114396308-T-G,rs10790006,-1,T,G,114396308,4203,114203903,114597119,192405
11,ENSG00000180425.6,114400511,11-114396308-T-C,rs10790006,-1,T,C,114396308,4203,114203903,114597119,192405
11,ENSG00000109929.5,121292771,11-121321073-C-G,rs10790434,1,C,G,121321073,28302,121096163,121489379,224910
11,ENSG00000109929.5,121292771,11-121321073-C-A,rs10790434,1,C,A,121321073,28302,121096163,121489379,224910
11,ENSG00000074266.10,86244753,11-86117143-G-T,rs10792829,1,G,T,86117143,127610,86048145,86441361,68998
11,ENSG00000074266.10,86244753,11-86117143-G-A,rs10792829,1,G,A,86117143,127610,86048145,86441361,68998
11,ENSG00000182919.9,93741672,11-93688616-G-A,rs10831093,1,G,A,93688616,53056,93545064,93938280,143552
11,ENSG00000182919.9,93741672,11-93688616-G-C,rs10831093,1,G,C,93688616,53056,93545064,93938280,143552
11,ENSG00000129173.6,19240945,11-19185858-C-T,rs10833069,-1,C,T,19185858,55087,19044337,19437553,141521
11,ENSG00000180988.2,5808924,11-5823123-C-T,rs10838688,1,C,T,5823123,14199,5612316,6005532,210807
11,ENSG00000134574.7,47214974,11-47312973-G-A,rs10838689,1,G,A,47312973,97999,47018366,47411582,294607
11,ENSG00000149050.5,7020346,11-6936707-C-T,rs10839661,-1,C,T,6936707,83639,6823738,7216954,112969
11,ENSG00000149050.5,7020346,11-6936707-C-A,rs10839661,-1,C,A,6936707,83639,6823738,7216954,112969
11,ENSG00000188124.2,6771976,11-6942499-T-C,rs10839664,-1,T,C,6942499,170523,6575368,6968584,367131
11,ENSG00000188124.2,6771976,11-6942499-T-G,rs10839664,-1,T,G,6942499,170523,6575368,6968584,367131
11,ENSG00000133789.10,9664077,11-9579886-T-C,rs10840263,1,T,C,9579886,84191,9467469,9860685,112417
11,ENSG00000172425.6,118527474,11-118636350-T-C,rs10892249,1,T,C,118636350,108876,118330866,118724082,305484
11,ENSG00000214063.6,842852,11-845789-C-T,rs10902227,1,C,T,845789,2937,646244,1039460,199545
11,ENSG00000181333.11,94021354,11-94025727-C-T,rs11020631,1,C,T,94025727,4373,93824746,94217962,200981
11,ENSG00000181333.11,94021354,11-94025727-C-G,rs11020631,1,C,G,94025727,4373,93824746,94217962,200981
11,ENSG00000134627.7,94567368,11-94580064-A-G,rs11020839,1,A,G,94580064,12696,94370760,94763976,209304
11,ENSG00000186280.5,94973709,11-95030873-G-A,rs11021014,1,G,A,95030873,57164,94777101,95170317,253772
11,ENSG00000150316.7,94973556,11-95040995-G-A,rs11021021,-1,G,A,95040995,67439,94776948,95170164,264047
11,ENSG00000189431.5,13009316,11-13082847-G-C,rs11022637,1,G,C,13082847,73531,12812708,13205924,270139
11,ENSG00000189431.5,13009316,11-13082847-G-T,rs11022637,1,G,T,13082847,73531,12812708,13205924,270139
11,ENSG00000258659.1,5625001,11-5484534-C-T,rs11037733,1,C,T,5484534,140467,5428393,5821609,56141
11,ENSG00000132259.8,6239089,11-6252234-G-T,rs11040816,1,G,T,6252234,13145,6042481,6435697,209753
11,ENSG00000132259.8,6239089,11-6252234-G-A,rs11040816,1,G,A,6252234,13145,6042481,6435697,209753
11,ENSG00000132275.6,6603616,11-6600286-G-A,rs11040933,-1,G,A,6600286,3330,6407008,6800224,193278
11,ENSG00000132275.6,6603616,11-6600286-G-T,rs11040933,-1,G,T,6600286,3330,6407008,6800224,193278
11,ENSG00000132275.6,6603616,11-6600286-G-C,rs11040933,-1,G,C,6600286,3330,6407008,6800224,193278
11,ENSG00000166452.7,8911189,11-8926039-C-T,rs11042127,1,C,T,8926039,14850,8714581,9107797,211458
11,ENSG00000166452.7,8911189,11-8926039-C-G,rs11042127,1,C,G,8926039,14850,8714581,9107797,211458
11,ENSG00000110315.2,10541187,11-10732405-G-T,rs11042938,-1,G,T,10732405,191218,10344579,10737795,387826
11,ENSG00000110315.2,10541187,11-10732405-G-C,rs11042938,-1,G,C,10732405,191218,10344579,10737795,387826
11,ENSG00000110315.2,10541187,11-10732405-G-A,rs11042938,-1,G,A,10732405,191218,10344579,10737795,387826
11,ENSG00000076053.6,114400666,11-114341426-T-G,rs11214957,1,T,G,114341426,59240,114204058,114597274,137368
11,ENSG00000184232.3,120211032,11-120106917-C-T,rs11217695,1,C,T,120106917,104115,120014424,120407640,92493
11,ENSG00000173039.12,65662916,11-65771978-G-A,rs11227297,-1,G,A,65771978,109062,65466308,65859524,305670
11,ENSG00000173039.12,65662916,11-65771978-G-C,rs11227297,-1,G,C,65771978,109062,65466308,65859524,305670
11,ENSG00000173039.12,65662916,11-65771978-G-T,rs11227297,-1,G,T,65771978,109062,65466308,65859524,305670
11,ENSG00000172725.8,67443476,11-67592793-G-A,rs11227844,-1,G,A,67592793,149317,67246868,67640084,345925
11,ENSG00000172725.8,67443476,11-67592793-G-T,rs11227844,-1,G,T,67592793,149317,67246868,67640084,345925
11,ENSG00000054967.7,73376399,11-73197508-C-T,rs11235676,1,C,T,73197508,178891,73179791,73573007,17717
11,ENSG00000166435.10,74949091,11-75087883-C-T,rs11236323,-1,C,T,75087883,138792,74752483,75145699,335400
11,ENSG00000166435.10,74949091,11-75087883-C-A,rs11236323,-1,C,A,75087883,138792,74752483,75145699,335400
11,ENSG00000184524.5,790090,11-783512-A-C,rs11246311,-1,A,C,783512,6578,593482,986698,190030
11,ENSG00000149289.6,110093392,11-110027451-A-G,rs112990645,1,A,G,110027451,65941,109896784,110290000,130667
11,ENSG00000149499.6,62612775,11-62611329-T-G,rs11553576,-1,T,G,62611329,1446,62416167,62809383,195162
11,ENSG00000149499.6,62612775,11-62611329-T-C,rs11553576,-1,T,C,62611329,1446,62416167,62809383,195162
11,ENSG00000183161.3,22625823,11-22560630-T-C,rs11600520,-1,T,C,22560630,65193,22429215,22822431,131415
11,ENSG00000120451.6,130916479,11-130896330-T-C,rs11602545,-1,T,C,130896330,20149,130719871,131113087,176459
11,ENSG00000149743.9,64226186,11-64236371-G-T,rs11603042,-1,G,T,64236371,10185,64029578,64422794,206793
11,ENSG00000149743.9,64226186,11-64236371-G-A,rs11603042,-1,G,A,64236371,10185,64029578,64422794,206793
11,ENSG00000149743.9,64226186,11-64236371-G-C,rs11603042,-1,G,C,64236371,10185,64029578,64422794,206793
11,ENSG00000168010.6,72814411,11-72721940-G-A,rs11603334,1,G,A,72721940,92471,72617803,73011019,104137
11,ENSG00000168010.6,72814411,11-72721940-G-T,rs11603334,1,G,T,72721940,92471,72617803,73011019,104137
11,ENSG00000110046.7,64917209,11-64888597-G-A,rs11606204,-1,G,A,64888597,28612,64720601,65113817,167996
11,ENSG00000185187.7,414999,11-372169-A-G,rs116462225,-1,A,G,372169,42830,218391,611607,153778
11,ENSG00000184154.8,72080850,11-72191063-C-T,rs116588436,1,C,T,72191063,110213,71884242,72277458,306821
11,ENSG00000030066.8,47848467,11-47826943-G-T,rs116983862,-1,G,T,47826943,21524,47651859,48045075,175084
11,ENSG00000132744.3,67650730,11-67685514-G-T,rs117018931,-1,G,T,67685514,34784,67454122,67847338,231392
11,ENSG00000169519.14,28108388,11-27965973-G-A,rs117209400,1,G,A,27965973,142415,27911780,28304996,54193
11,ENSG00000177156.6,747464,11-796540-G-A,rs117220114,1,G,A,796540,49076,550856,944072,245684
11,ENSG00000188487.6,15114923,11-15107196-C-T,rs117273264,1,C,T,15107196,7727,14918315,15311531,188881
11,ENSG00000137674.3,102625332,11-102450397-C-A,rs117382339,-1,C,A,102450397,174935,102428724,102821940,21673
11,ENSG00000074319.6,18526942,11-18457116-A-G,rs117452260,-1,A,G,18457116,69826,18330334,18723550,126782
11,ENSG00000175352.6,9004001,11-9017374-C-T,rs117757897,-1,C,T,9017374,13373,8807393,9200609,209981
11,ENSG00000174851.9,66289143,11-66269093-C-T,rs117827012,-1,C,T,66269093,20050,66092535,66485751,176558
11,ENSG00000149548.9,124954202,11-125028629-T-C,rs11828896,1,T,C,125028629,74427,124757594,125150810,271035
11,ENSG00000014138.4,65261962,11-65070274-G-A,rs1196047,1,G,A,65070274,191688,65065354,65458570,4920
11,ENSG00000172818.5,65787063,11-65814108-C-G,rs1204772,1,C,G,65814108,27045,65590455,65983671,223653
11,ENSG00000172818.5,65787063,11-65814108-C-T,rs1204772,1,C,T,65814108,27045,65590455,65983671,223653
11,ENSG00000175115.7,66070272,11-65972863-G-C,rs1211380,1,G,C,65972863,97409,65873664,66266880,99199
11,ENSG00000175115.7,66070272,11-65972863-G-A,rs1211380,1,G,A,65972863,97409,65873664,66266880,99199
11,ENSG00000171067.6,68271973,11-68287556-A-G,rs12222446,-1,A,G,68287556,15583,68075365,68468581,212191
11,ENSG00000171067.6,68271973,11-68287556-A-C,rs12222446,-1,A,C,68287556,15583,68075365,68468581,212191
11,ENSG00000175518.5,5516699,11-5618037-G-A,rs12224326,-1,G,A,5618037,101338,5320091,5713307,297946
11,ENSG00000110665.7,2301918,11-2301792-C-T,rs12276847,-1,C,T,2301792,126,2105310,2498526,196482
11,ENSG00000110777.7,111379275,11-111494051-T-C,rs12281721,-1,T,C,111494051,114776,111182667,111575883,311384
11,ENSG00000150768.10,112025408,11-111916659-A-T,rs12284944,1,A,T,111916659,108749,111828800,112222016,87859
11,ENSG00000150768.10,112025408,11-111916659-A-G,rs12284944,1,A,G,111916659,108749,111828800,112222016,87859
11,ENSG00000184363.5,394209,11-573554-A-G,rs12286521,1,A,G,573554,179345,197601,590817,375953
11,ENSG00000172613.3,67391986,11-67265553-G-A,rs12286610,1,G,A,67265553,126433,67195378,67588594,70175
11,ENSG00000133812.10,10294219,11-10189686-A-C,rs12288275,-1,A,C,10189686,104533,10097611,10490827,92075
11,ENSG00000133812.10,10294219,11-10189686-A-G,rs12288275,-1,A,G,10189686,104533,10097611,10490827,92075
11,ENSG00000110328.5,11622005,11-11611166-C-T,rs12289244,-1,C,T,11611166,10839,11425397,11818613,185769
11,ENSG00000132740.4,68903891,11-68966752-C-T,rs12291142,1,C,T,68966752,62861,68707283,69100499,259469
11,ENSG00000175482.4,67353546,11-67294908-T-C,rs12291831,-1,T,C,67294908,58638,67156938,67550154,137970
11,ENSG00000166025.12,94768356,11-94934546-T-C,rs12293256,1,T,C,94934546,166190,94571748,94964964,362798
11,ENSG00000166025.12,94768356,11-94934546-T-G,rs12293256,1,T,G,94934546,166190,94571748,94964964,362798
11,ENSG00000186907.3,57460528,11-57647921-G-A,rs12294735,1,G,A,57647921,187393,57263920,57657136,384001
11,ENSG00000186907.3,57460528,11-57647921-G-T,rs12294735,1,G,T,57647921,187393,57263920,57657136,384001
11,ENSG00000137731.8,117824744,11-117804571-T-C,rs12364667,-1,T,C,117804571,20173,117628136,118021352,176435
11,ENSG00000137731.8,117824744,11-117804571-T-G,rs12364667,-1,T,G,117804571,20173,117628136,118021352,176435
11,ENSG00000121621.5,28108156,11-27991776-G-C,rs12417122,-1,G,C,27991776,116380,27911548,28304764,80228
11,ENSG00000121621.5,28108156,11-27991776-G-A,rs12417122,-1,G,A,27991776,116380,27911548,28304764,80228
11,ENSG00000186652.5,57390650,11-57343577-T-C,rs12419699,-1,T,C,57343577,47073,57194042,57587258,149535
11,ENSG00000110628.9,2902278,11-2875083-G-A,rs12786533,1,G,A,2875083,27195,2705670,3098886,169413
11,ENSG00000221968.4,61891545,11-62064606-T-C,rs12789400,-1,T,C,62064606,173061,61694937,62088153,369669
11,ENSG00000221968.4,61891545,11-62064606-T-G,rs12789400,-1,T,G,62064606,173061,61694937,62088153,369669
11,ENSG00000242689.1,58622665,11-58674430-C-A,rs12794523,1,C,A,58674430,51765,58426057,58819273,248373
11,ENSG00000177103.8,117797216,11-117791423-G-A,rs12795949,-1,G,A,117791423,5793,117600608,117993824,190815
11,ENSG00000174804.3,86955395,11-86844147-A-G,rs12797787,-1,A,G,86844147,111248,86758787,87152003,85360
11,ENSG00000183020.7,925870,11-1021099-C-T,rs12798548,1,C,T,1021099,95229,729262,1122478,291837
11,ENSG00000064201.10,2302013,11-2296721-C-T,rs12800998,1,C,T,2296721,5292,2105405,2498621,191316
11,ENSG00000167770.7,63986438,11-64091242-G-A,rs12805344,1,G,A,64091242,104804,63789830,64183046,301412
11,ENSG00000182704.5,76783356,11-76659143-G-C,rs1320644,1,G,C,76659143,124213,76586748,76979964,72395
11,ENSG00000182704.5,76783356,11-76659143-G-A,rs1320644,1,G,A,76659143,124213,76586748,76979964,72395
11,ENSG00000137486.12,75351661,11-75284067-A-C,rs1320709,-1,A,C,75284067,67594,75155053,75548269,129014
11,ENSG00000137486.12,75351661,11-75284067-A-G,rs1320709,-1,A,G,75284067,67594,75155053,75548269,129014
11,ENSG00000137486.12,75351661,11-75284067-A-T,rs1320709,-1,A,T,75284067,67594,75155053,75548269,129014
11,ENSG00000110002.10,124115450,11-124038427-G-T,rs140026196,1,G,T,124038427,77023,123918842,124312058,119585
11,ENSG00000110002.10,124115450,11-124038427-G-A,rs140026196,1,G,A,124038427,77023,123918842,124312058,119585
11,ENSG00000110002.10,124115450,11-124038427-G-C,rs140026196,1,G,C,124038427,77023,123918842,124312058,119585
11,ENSG00000158077.4,7020479,11-6942246-A-G,rs1491826,1,A,G,6942246,78233,6823871,7217087,118375
11,ENSG00000158077.4,7020479,11-6942246-A-C,rs1491826,1,A,C,6942246,78233,6823871,7217087,118375
11,ENSG00000158077.4,7020479,11-6942246-A-T,rs1491826,1,A,T,6942246,78233,6823871,7217087,118375
11,ENSG00000184743.8,63671376,11-63816359-A-G,rs150320958,-1,A,G,63816359,144983,63474768,63867984,341591
11,ENSG00000160588.5,118252365,11-118221299-T-C,rs1622928,-1,T,C,118221299,31066,118055757,118448973,165542
11,ENSG00000167985.2,61430124,11-61603381-A-G,rs1639892,1,A,G,61603381,173257,61233516,61626732,369865
11,ENSG00000167985.2,61430124,11-61603381-A-T,rs1639892,1,A,T,61603381,173257,61233516,61626732,369865
11,ENSG00000167985.2,61430124,11-61603381-A-C,rs1639892,1,A,C,61603381,173257,61233516,61626732,369865
11,ENSG00000175575.8,73876999,11-73904682-G-C,rs1670551,1,G,C,73904682,27683,73680391,74073607,224291
11,ENSG00000175575.8,73876999,11-73904682-G-A,rs1670551,1,G,A,73904682,27683,73680391,74073607,224291
11,ENSG00000254598.1,11353250,11-11289959-G-A,rs16909341,-1,G,A,11289959,63291,11156642,11549858,133317
11,ENSG00000254598.1,11353250,11-11289959-G-C,rs16909341,-1,G,C,11289959,63291,11156642,11549858,133317
11,ENSG00000109861.8,88337736,11-88368217-G-A,rs16913871,-1,G,A,88368217,30481,88141128,88534344,227089
11,ENSG00000196371.2,94543921,11-94587013-T-C,rs16920648,1,T,C,94587013,43092,94347313,94740529,239700
11,ENSG00000196371.2,94543921,11-94587013-T-G,rs16920648,1,T,G,94587013,43092,94347313,94740529,239700
11,ENSG00000179431.5,35618460,11-35433575-T-C,rs16927472,1,T,C,35433575,184885,35421852,35815068,11723
11,ENSG00000166689.9,17014414,11-16985595-G-A,rs16933753,-1,G,A,16985595,28819,16817806,17211022,167789
11,ENSG00000132274.10,5689790,11-5694870-T-C,rs16934565,1,T,C,5694870,5080,5493182,5886398,201688
11,ENSG00000166796.7,18412318,11-18488446-C-T,rs16935476,1,C,T,18488446,76128,18215710,18608926,272736
11,ENSG00000166323.8,108467529,11-108340068-A-G,rs17092269,-1,A,G,108340068,127461,108270921,108664137,69147
11,ENSG00000150455.8,126283093,11-126345924-C-T,rs171269,1,C,T,126345924,62831,126086485,126479701,259439
11,ENSG00000149269.5,77474094,11-77326354-A-T,rs17135547,-1,A,T,77326354,147740,77277486,77670702,48868
11,ENSG00000149269.5,77474094,11-77326354-A-G,rs17135547,-1,A,G,77326354,147740,77277486,77670702,48868
11,ENSG00000165494.5,83156988,11-83184615-A-C,rs17144746,1,A,C,83184615,27627,82960380,83353596,224235
11,ENSG00000165494.5,83156988,11-83184615-A-G,rs17144746,1,A,G,83184615,27627,82960380,83353596,224235
11,ENSG00000165494.5,83156988,11-83184615-A-T,rs17144746,1,A,T,83184615,27627,82960380,83353596,224235
11,ENSG00000213465.3,65014160,11-64870569-C-A,rs17146413,1,C,A,64870569,143591,64817552,65210768,53017
11,ENSG00000213465.3,65014160,11-64870569-C-T,rs17146413,1,C,T,64870569,143591,64817552,65210768,53017
11,ENSG00000185201.10,307816,11-243817-T-C,rs17156013,1,T,C,243817,63999,111208,504424,132609
11,ENSG00000165434.4,74398433,11-74438235-A-G,rs17310577,-1,A,G,74438235,39802,74201825,74595041,236410
11,ENSG00000174791.6,66336434,11-66224968-G-A,rs17494956,-1,G,A,66224968,111466,66139826,66533042,85142
11,ENSG00000181903.3,55662201,11-55669650-C-T,rs17498926,1,C,T,55669650,7449,55465593,55858809,204057
11,ENSG00000181903.3,55662201,11-55669650-C-A,rs17498926,1,C,A,55669650,7449,55465593,55858809,204057
11,ENSG00000110107.4,60906585,11-61061706-A-G,rs175119,-1,A,G,61061706,155121,60709977,61103193,351729
11,ENSG00000110107.4,60906585,11-61061706-A-T,rs175119,-1,A,T,61061706,155121,60709977,61103193,351729
11,ENSG00000152219.4,30323104,11-30354497-C-T,rs1765134,1,C,T,30354497,31393,30126496,30519712,228001
11,ENSG00000152219.4,30323104,11-30354497-C-G,rs1765134,1,C,G,30354497,31393,30126496,30519712,228001
11,ENSG00000152219.4,30323104,11-30354497-C-A,rs1765134,1,C,A,30354497,31393,30126496,30519712,228001
11,ENSG00000110723.6,108593768,11-108571256-A-C,rs17693972,-1,A,C,108571256,22512,108397160,108790376,174096
11,ENSG00000174080.6,66568606,11-66459713-G-C,rs1791687,-1,G,C,66459713,108893,66371998,66765214,87715
11,ENSG00000174080.6,66568606,11-66459713-G-T,rs1791687,-1,G,T,66459713,108893,66371998,66765214,87715
11,ENSG00000174080.6,66568606,11-66459713-G-A,rs1791687,-1,G,A,66459713,108893,66371998,66765214,87715
11,ENSG00000182791.3,66593063,11-66459713-G-C,rs1791687,-1,G,C,66459713,133350,66396455,66789671,63258
11,ENSG00000182791.3,66593063,11-66459713-G-T,rs1791687,-1,G,T,66459713,133350,66396455,66789671,63258
11,ENSG00000182791.3,66593063,11-66459713-G-A,rs1791687,-1,G,A,66459713,133350,66396455,66789671,63258
11,ENSG00000254986.2,66480434,11-66550352-G-A,rs1791690,1,G,A,66550352,69918,66283826,66677042,266526
11,ENSG00000248746.1,66546903,11-66560624-C-A,rs1815739,1,C,A,66560624,13721,66350295,66743511,210329
11,ENSG00000248746.1,66546903,11-66560624-C-T,rs1815739,1,C,T,66560624,13721,66350295,66743511,210329
11,ENSG00000134940.8,125680847,11-125609938-C-A,rs1834466,-1,C,A,125609938,70909,125484239,125877455,125699
11,ENSG00000134940.8,125680847,11-125609938-C-T,rs1834466,-1,C,T,125609938,70909,125484239,125877455,125699
11,ENSG00000134940.8,125680847,11-125609938-C-G,rs1834466,-1,C,G,125609938,70909,125484239,125877455,125699
11,ENSG00000005801.11,3379146,11-3344095-T-A,rs1858791,-1,T,A,3344095,35051,3182538,3575754,161557
11,ENSG00000005801.11,3379146,11-3344095-T-C,rs1858791,-1,T,C,3344095,35051,3182538,3575754,161557
11,ENSG00000166439.5,74748849,11-74708312-C-T,rs1944937,1,C,T,74708312,40537,74552241,74945457,156071
11,ENSG00000166439.5,74748849,11-74708312-C-A,rs1944937,1,C,A,74708312,40537,74552241,74945457,156071
11,ENSG00000166439.5,74748849,11-74708312-C-G,rs1944937,1,C,G,74708312,40537,74552241,74945457,156071
11,ENSG00000149485.10,61817003,11-61622381-G-C,rs198755,-1,G,C,61622381,194622,61620395,62013611,1986
11,ENSG00000149485.10,61817003,11-61622381-G-A,rs198755,-1,G,A,61622381,194622,61620395,62013611,1986
11,ENSG00000176485.6,63614433,11-63606176-C-T,rs2030731,-1,C,T,63606176,8257,63417825,63811041,188351
11,ENSG00000176485.6,63614433,11-63606176-C-G,rs2030731,-1,C,G,63606176,8257,63417825,63811041,188351
11,ENSG00000149089.7,34916379,11-34873553-T-C,rs2033359,-1,T,C,34873553,42826,34719771,35112987,153782
11,ENSG00000175567.3,73982843,11-74004497-G-A,rs2075577,-1,G,A,74004497,21654,73786235,74179451,218262
11,ENSG00000124942.7,62546806,11-62429955-C-A,rs2077224,-1,C,A,62429955,116851,62350198,62743414,79757
11,ENSG00000183340.5,96390013,11-96266123-G-A,rs2082705,1,G,A,96266123,123890,96193405,96586621,72718
11,ENSG00000149313.6,106077662,11-106056451-C-T,rs2155346,1,C,T,106056451,21211,105881054,106274270,175397
11,ENSG00000149292.11,113314583,11-113318201-T-C,rs2156486,1,T,C,113318201,3618,113117975,113511191,200226
11,ENSG00000149292.11,113314583,11-113318201-T-G,rs2156486,1,T,G,113318201,3618,113117975,113511191,200226
11,ENSG00000087884.10,77821144,11-77872220-G-A,rs2186564,1,G,A,77872220,51076,77624536,78017752,247684
11,ENSG00000181924.6,73876846,11-74041879-A-G,rs2272321,-1,A,G,74041879,165033,73680238,74073454,361641
11,ENSG00000172732.6,65860433,11-65998621-C-T,rs2276017,1,C,T,65998621,138188,65663825,66057041,334796
11,ENSG00000066336.7,47378547,11-47276650-C-T,rs2291119,-1,C,T,47276650,101897,47181939,47575155,94711
11,ENSG00000121691.4,34438934,11-34446301-T-A,rs2300182,1,T,A,34446301,7367,34242326,34635542,203975
11,ENSG00000110711.4,67483026,11-67439955-G-T,rs2302264,1,G,T,67439955,43071,67286418,67679634,153537
11,ENSG00000110711.4,67483026,11-67439955-G-A,rs2302264,1,G,A,67439955,43071,67286418,67679634,153537
11,ENSG00000110711.4,67483026,11-67439955-G-C,rs2302264,1,G,C,67439955,43071,67286418,67679634,153537
11,ENSG00000149380.7,74311640,11-74235886-T-C,rs2302509,-1,T,C,74235886,75754,74115032,74508248,120854
11,ENSG00000133818.8,14359183,11-14243433-C-A,rs2303974,-1,C,A,14243433,115750,14162575,14555791,80858
11,ENSG00000133818.8,14359183,11-14243433-C-T,rs2303974,-1,C,T,14243433,115750,14162575,14555791,80858
11,ENSG00000151498.6,134253568,11-134203124-A-T,rs2305379,1,A,T,134203124,50444,134056960,134450176,146164
11,ENSG00000151498.6,134253568,11-134203124-A-C,rs2305379,1,A,C,134203124,50444,134056960,134450176,146164
11,ENSG00000176340.3,63974620,11-63842893-A-G,rs2318126,1,A,G,63842893,131727,63778012,64171228,64881
11,ENSG00000176340.3,63974620,11-63842893-A-T,rs2318126,1,A,T,63842893,131727,63778012,64171228,64881
11,ENSG00000176340.3,63974620,11-63842893-A-C,rs2318126,1,A,C,63842893,131727,63778012,64171228,64881
11,ENSG00000187486.5,17388659,11-17527862-T-C,rs2355021,-1,T,C,17527862,139203,17192051,17585267,335811
11,ENSG00000187486.5,17388659,11-17527862-T-G,rs2355021,-1,T,G,17527862,139203,17192051,17585267,335811
11,ENSG00000110080.13,126355686,11-126341832-T-C,rs2401,1,T,C,126341832,13854,126159078,126552294,182754
11,ENSG00000172803.12,65833963,11-65638922-C-T,rs2509948,1,C,T,65638922,195041,65637355,66030571,1567
11,ENSG00000172803.12,65833963,11-65638922-C-A,rs2509948,1,C,A,65638922,195041,65637355,66030571,1567
11,ENSG00000149418.5,130159782,11-129965852-A-G,rs2512904,1,A,G,129965852,193930,129963174,130356390,2678
11,ENSG00000156599.6,57668114,11-57559973-C-A,rs2848624,1,C,A,57559973,108141,57471506,57864722,88467
11,ENSG00000156599.6,57668114,11-57559973-C-G,rs2848624,1,C,G,57559973,108141,57471506,57864722,88467
11,ENSG00000183134.4,60855950,11-61030231-T-C,rs2905524,-1,T,C,61030231,174281,60659342,61052558,370889
11,ENSG00000110435.6,34916618,11-34916718-C-T,rs2956109,1,C,T,34916718,100,34720010,35113226,196708
11,ENSG00000110435.6,34916618,11-34916718-C-G,rs2956109,1,C,G,34916718,100,34720010,35113226,196708
11,ENSG00000133895.9,64810551,11-64817515-C-T,rs2957154,-1,C,T,64817515,6964,64613943,65007159,203572
11,ENSG00000133895.9,64810551,11-64817515-C-G,rs2957154,-1,C,G,64817515,6964,64613943,65007159,203572
11,ENSG00000110446.4,60952176,11-61032629-C-T,rs3019536,-1,C,T,61032629,80453,60755568,61148784,277061
11,ENSG00000110446.4,60952176,11-61032629-C-G,rs3019536,-1,C,G,61032629,80453,60755568,61148784,277061
11,ENSG00000149243.10,75433203,11-75407114-A-G,rs3094304,-1,A,G,75407114,26089,75236595,75629811,170519
11,ENSG00000149273.8,75399518,11-75399545-A-C,rs3133187,1,A,C,75399545,27,75202910,75596126,196635
11,ENSG00000149273.8,75399518,11-75399545-A-T,rs3133187,1,A,T,75399545,27,75202910,75596126,196635
11,ENSG00000149273.8,75399518,11-75399545-A-G,rs3133187,1,A,G,75399545,27,75202910,75596126,196635
11,ENSG00000110455.9,44066270,11-44081627-G-T,rs3134909,1,G,T,44081627,15357,43869662,44262878,211965
11,ENSG00000110455.9,44066270,11-44081627-G-A,rs3134909,1,G,A,44081627,15357,43869662,44262878,211965
11,ENSG00000025434.14,47257996,11-47281724-T-C,rs326217,1,T,C,47281724,23728,47061388,47454604,220336
11,ENSG00000080854.9,133956968,11-133925122-G-C,rs329669,-1,G,C,133925122,31846,133760360,134153576,164762
11,ENSG00000080854.9,133956968,11-133925122-G-A,rs329669,-1,G,A,133925122,31846,133760360,134153576,164762
11,ENSG00000087365.8,66052364,11-65863890-C-G,rs34891773,1,C,G,65863890,188474,65855756,66248972,8134
11,ENSG00000087365.8,66052364,11-65863890-C-T,rs34891773,1,C,T,65863890,188474,65855756,66248972,8134
11,ENSG00000137474.12,77128246,11-77105449-G-A,rs34950930,1,G,A,77105449,22797,76931638,77324854,173811
11,ENSG00000185101.8,442011,11-492617-G-A,rs35255804,-1,G,A,492617,50606,245403,638619,247214
11,ENSG00000185101.8,442011,11-492617-G-C,rs35255804,-1,G,C,492617,50606,245403,638619,247214
11,ENSG00000148985.14,3808560,11-3702551-G-C,rs35404087,1,G,C,3702551,106009,3611952,4005168,90599
11,ENSG00000175581.9,73787874,11-73946396-C-T,rs35414679,1,C,T,73946396,158522,73591266,73984482,355130
11,ENSG00000168071.15,64340204,11-64344578-C-T,rs35864060,1,C,T,64344578,4374,64143596,64536812,200982
11,ENSG00000168071.15,64340204,11-64344578-C-A,rs35864060,1,C,A,64344578,4374,64143596,64536812,200982
11,ENSG00000179241.7,35944062,11-36107918-A-G,rs35967184,1,A,G,36107918,163856,35747454,36140670,360464
11,ENSG00000149182.9,47176879,11-47337495-G-A,rs3729952,-1,G,A,47337495,160616,46980271,47373487,357224
11,ENSG00000149328.9,134331988,11-134373553-C-T,rs3741098,1,C,T,134373553,41565,134135380,134528596,238173
11,ENSG00000110717.6,68030681,11-68016808-C-G,rs3751084,1,C,G,68016808,13873,67834073,68227289,182735
11,ENSG00000110717.6,68030681,11-68016808-C-T,rs3751084,1,C,T,68016808,13873,67834073,68227289,182735
11,ENSG00000181649.5,2929420,11-2924715-C-T,rs3764895,-1,C,T,2924715,4705,2732812,3126028,191903
11,ENSG00000149809.10,65111872,11-65124998-G-A,rs3782094,1,G,A,65124998,13126,64915264,65308480,209734
11,ENSG00000174915.7,450279,11-290233-A-T,rs3809109,1,A,T,290233,160046,253671,646887,36562
11,ENSG00000174915.7,450279,11-290233-A-G,rs3809109,1,A,G,290233,160046,253671,646887,36562
11,ENSG00000148925.5,13463222,11-13464358-A-G,rs3814236,-1,A,G,13464358,1136,13266614,13659830,197744
11,ENSG00000158555.10,75525941,11-75451709-A-G,rs3814715,-1,A,G,75451709,74232,75329333,75722549,122376
11,ENSG00000174871.6,66278175,11-66268508-T-C,rs3814739,1,T,C,66268508,9667,66081567,66474783,186941
11,ENSG00000174547.9,66438848,11-66365611-T-C,rs3867130,-1,T,C,66365611,73237,66242240,66635456,123371
11,ENSG00000174547.9,66438848,11-66365611-T-A,rs3867130,-1,T,A,66365611,73237,66242240,66635456,123371
11,ENSG00000205213.8,27472790,11-27333484-C-T,rs3929244,-1,C,T,27333484,139306,27276182,27669398,57302
11,ENSG00000166478.5,9461012,11-9440987-G-C,rs41369549,1,G,C,9440987,20025,9264404,9657620,176583
11,ENSG00000185085.2,62653302,11-62487822-G-A,rs41427449,-1,G,A,62487822,165480,62456694,62849910,31128
11,ENSG00000130413.11,8594228,11-8596003-C-T,rs4244804,-1,C,T,8596003,1775,8397620,8790836,198383
11,ENSG00000149554.7,125625163,11-125513851-G-A,rs4344501,1,G,A,125513851,111312,125428555,125821771,85296
11,ENSG00000179057.9,18726188,11-18715548-C-T,rs4424652,-1,C,T,18715548,10640,18529580,18922796,185968
11,ENSG00000179057.9,18726188,11-18715548-C-A,rs4424652,-1,C,A,18715548,10640,18529580,18922796,185968
11,ENSG00000150773.6,112074017,11-112175045-A-G,rs45439498,-1,A,G,112175045,101028,111877409,112270625,297636
11,ENSG00000176148.10,33039572,11-33045822-C-T,rs4561187,1,C,T,33045822,6250,32842964,33236180,202858
11,ENSG00000176148.10,33039572,11-33045822-C-G,rs4561187,1,C,G,33045822,6250,32842964,33236180,202858
11,ENSG00000134571.6,47352702,11-47210633-T-C,rs4567413,-1,T,C,47210633,142069,47156094,47549310,54539
11,ENSG00000134571.6,47352702,11-47210633-T-A,rs4567413,-1,T,A,47210633,142069,47156094,47549310,54539
11,ENSG00000213445.4,65638101,11-65586435-A-G,rs4601790,1,A,G,65586435,51666,65441493,65834709,144942
11,ENSG00000214290.3,111298546,11-111312432-A-G,rs4617622,1,A,G,111312432,13886,111101938,111495154,210494
11,ENSG00000214290.3,111298546,11-111312432-A-C,rs4617622,1,A,C,111312432,13886,111101938,111495154,210494
11,ENSG00000049449.3,32091074,11-32079735-A-C,rs477838,1,A,C,32079735,11339,31894466,32287682,185269
11,ENSG00000049449.3,32091074,11-32079735-A-G,rs477838,1,A,G,32079735,11339,31894466,32287682,185269
11,ENSG00000166889.11,59669037,11-59795309-C-T,rs477945,-1,C,T,59795309,126272,59472429,59865645,322880
11,ENSG00000109917.6,116788023,11-116612409-G-C,rs486020,-1,G,C,116612409,175614,116591415,116984631,20994
11,ENSG00000173113.2,64317559,11-64322402-C-T,rs4930702,-1,C,T,64322402,4843,64120951,64514167,201451
11,ENSG00000196323.5,130314917,11-130477295-G-T,rs4937523,-1,G,T,130477295,162378,130118309,130511525,358986
11,ENSG00000166736.7,113975108,11-114151181-G-A,rs4938076,1,G,A,114151181,176073,113778500,114171716,372681
11,ENSG00000196655.5,119018766,11-118939696-C-A,rs4938589,1,C,A,118939696,79070,118822158,119215374,117538
11,ENSG00000196655.5,119018766,11-118939696-C-T,rs4938589,1,C,T,118939696,79070,118822158,119215374,117538
11,ENSG00000167987.5,61161426,11-61052224-G-C,rs4939493,-1,G,C,61052224,109202,60964818,61358034,87406
11,ENSG00000167987.5,61161426,11-61052224-G-T,rs4939493,-1,G,T,61052224,109202,60964818,61358034,87406
11,ENSG00000149260.8,77066971,11-77094731-A-G,rs4945141,1,A,G,77094731,27760,76870363,77263579,224368
11,ENSG00000149260.8,77066971,11-77094731-A-C,rs4945141,1,A,C,77094731,27760,76870363,77263579,224368
11,ENSG00000182208.8,1486779,11-1344301-T-C,rs4963039,-1,T,C,1344301,142478,1290171,1683387,54130
11,ENSG00000149218.4,95089846,11-95144199-T-C,rs496397,1,T,C,95144199,54353,94893238,95286454,250961
11,ENSG00000149218.4,95089846,11-95144199-T-A,rs496397,1,T,A,95144199,54353,94893238,95286454,250961
11,ENSG00000110047.11,64878621,11-64806728-G-A,rs504195,-1,G,A,64806728,71893,64682013,65075229,124715
11,ENSG00000110047.11,64878621,11-64806728-G-C,rs504195,-1,G,C,64806728,71893,64682013,65075229,124715
11,ENSG00000197629.4,59212927,11-59066429-T-C,rs504789,-1,T,C,59066429,146498,59016319,59409535,50110
11,ENSG00000197629.4,59212927,11-59066429-T-G,rs504789,-1,T,G,59066429,146498,59016319,59409535,50110
11,ENSG00000197629.4,59212927,11-59066429-T-A,rs504789,-1,T,A,59066429,146498,59016319,59409535,50110
11,ENSG00000137747.9,117929402,11-117848165-G-A,rs512481,-1,G,A,117848165,81237,117732794,118126010,115371
11,ENSG00000110063.4,126304060,11-126196145-C-A,rs515917,1,C,A,126196145,107915,126107452,126500668,88693
11,ENSG00000110063.4,126304060,11-126196145-C-T,rs515917,1,C,T,126196145,107915,126107452,126500668,88693
11,ENSG00000204397.3,105045335,11-105023444-T-G,rs516286,-1,T,G,105023444,21891,104848727,105241943,174717
11,ENSG00000137501.11,85811141,11-85764802-A-C,rs521764,-1,A,C,85764802,46339,85614533,86007749,150269
11,ENSG00000137501.11,85811141,11-85764802-A-T,rs521764,-1,A,T,85764802,46339,85614533,86007749,150269
11,ENSG00000126432.9,64318121,11-64383519-C-A,rs523525,1,C,A,64383519,65398,64121513,64514729,262006
11,ENSG00000126432.9,64318121,11-64383519-C-G,rs523525,1,C,G,64383519,65398,64121513,64514729,262006
11,ENSG00000110104.5,60842113,11-60860110-C-T,rs533116,1,C,T,60860110,17997,60645505,61038721,214605
11,ENSG00000166788.5,18106082,11-18044116-G-T,rs546383,-1,G,T,18044116,61966,17909474,18302690,134642
11,ENSG00000151704.11,128867296,11-128815866-C-T,rs554341,-1,C,T,128815866,51430,128670688,129063904,145178
11,ENSG00000165526.4,126211650,11-126178889-G-T,rs561164,-1,G,T,126178889,32761,126015042,126408258,163847
11,ENSG00000165526.4,126211650,11-126178889-G-C,rs561164,-1,G,C,126178889,32761,126015042,126408258,163847
11,ENSG00000165526.4,126211650,11-126178889-G-A,rs561164,-1,G,A,126178889,32761,126015042,126408258,163847
11,ENSG00000166352.10,36594502,11-36433461-T-A,rs573465,1,T,A,36433461,161041,36397894,36791110,35567
11,ENSG00000166352.10,36594502,11-36433461-T-C,rs573465,1,T,C,36433461,161041,36397894,36791110,35567
11,ENSG00000197580.7,112175512,11-112147802-C-A,rs5744266,1,C,A,112147802,27710,111978904,112372120,168898
11,ENSG00000084234.11,130069894,11-130192806-G-A,rs577740,1,G,A,130192806,122912,129873286,130266502,319520
11,ENSG00000084234.11,130069894,11-130192806-G-C,rs577740,1,G,C,130192806,122912,129873286,130266502,319520
11,ENSG00000188486.3,119095465,11-119029700-T-G,rs58412813,-1,T,G,119029700,65765,118898857,119292073,130843
11,ENSG00000149257.8,75562253,11-75563105-G-A,rs590121,1,G,A,75563105,852,75365645,75758861,197460
11,ENSG00000149257.8,75562253,11-75563105-G-T,rs590121,1,G,T,75563105,852,75365645,75758861,197460
11,ENSG00000123892.6,88175443,11-88041616-T-A,rs594319,-1,T,A,88041616,133827,87978835,88372051,62781
11,ENSG00000123892.6,88175443,11-88041616-T-C,rs594319,-1,T,C,88041616,133827,87978835,88372051,62781
11,ENSG00000137509.5,82900430,11-82824312-C-T,rs597838,-1,C,T,82824312,76118,82703822,83097038,120490
11,ENSG00000173465.3,65570477,11-65740134-T-C,rs603509,1,T,C,65740134,169657,65373869,65767085,366265
11,ENSG00000173465.3,65570477,11-65740134-T-A,rs603509,1,T,A,65740134,169657,65373869,65767085,366265
11,ENSG00000173457.6,64246943,11-64249463-C-G,rs604203,-1,C,G,64249463,2520,64050335,64443551,199128
11,ENSG00000173457.6,64246943,11-64249463-C-T,rs604203,-1,C,T,64249463,2520,64050335,64443551,199128
11,ENSG00000173457.6,64246943,11-64249463-C-A,rs604203,-1,C,A,64249463,2520,64050335,64443551,199128
11,ENSG00000188997.3,78188626,11-78065865-A-T,rs606732,-1,A,T,78065865,122761,77992018,78385234,73847
11,ENSG00000188997.3,78188626,11-78065865-A-G,rs606732,-1,A,G,78065865,122761,77992018,78385234,73847
11,ENSG00000188070.7,63768775,11-63613500-A-T,rs615155,-1,A,T,63613500,155275,63572167,63965383,41333
11,ENSG00000188070.7,63768775,11-63613500-A-G,rs615155,-1,A,G,63613500,155275,63572167,63965383,41333
11,ENSG00000214026.6,1947332,11-1872809-C-T,rs61868780,1,C,T,1872809,74523,1750724,2143940,122085
11,ENSG00000214026.6,1947332,11-1872809-C-G,rs61868780,1,C,G,1872809,74523,1750724,2143940,122085
11,ENSG00000129158.5,18013047,11-17891623-C-T,rs61882440,-1,C,T,17891623,121424,17816439,18209655,75184
11,ENSG00000156603.10,57712215,11-57566420-A-G,rs61887019,-1,A,G,57566420,145795,57515607,57908823,50813
11,ENSG00000233436.2,57751819,11-57790917-C-T,rs61888910,-1,C,T,57790917,39098,57555211,57948427,235706
11,ENSG00000149231.7,96389912,11-96495843-G-A,rs618929,-1,G,A,96495843,105931,96193304,96586520,302539
11,ENSG00000158636.11,76445025,11-76641140-G-A,rs61893490,1,G,A,76641140,196115,76248417,76641633,392723
11,ENSG00000158636.11,76445025,11-76641140-G-T,rs61893490,1,G,T,76641140,196115,76248417,76641633,392723
11,ENSG00000110218.4,94128841,11-94103100-G-C,rs61905098,1,G,C,94103100,25741,93932233,94325449,170867
11,ENSG00000166086.7,134069072,11-134025840-T-C,rs61908451,1,T,C,134025840,43232,133872464,134265680,153376
11,ENSG00000149798.3,65314866,11-65210173-C-G,rs625750,1,C,G,65210173,104693,65118258,65511474,91915
11,ENSG00000149798.3,65314866,11-65210173-C-T,rs625750,1,C,T,65210173,104693,65118258,65511474,91915
11,ENSG00000198561.8,57761802,11-57834997-G-T,rs627145,1,G,T,57834997,73195,57565194,57958410,269803
11,ENSG00000198561.8,57761802,11-57834997-G-A,rs627145,1,G,A,57834997,73195,57565194,57958410,269803
11,ENSG00000110074.6,126269154,11-126372802-C-T,rs629882,1,C,T,126372802,103648,126072546,126465762,300256
11,ENSG00000159063.7,78139626,11-78078508-T-C,rs636141,-1,T,C,78078508,61118,77943018,78336234,135490
11,ENSG00000159063.7,78139626,11-78078508-T-G,rs636141,-1,T,G,78078508,61118,77943018,78336234,135490
11,ENSG00000160695.8,119067818,11-119061734-T-C,rs636283,1,T,C,119061734,6084,118871210,119264426,190524
11,ENSG00000160695.8,119067818,11-119061734-T-A,rs636283,1,T,A,119061734,6084,118871210,119264426,190524
11,ENSG00000151500.9,134253352,11-134071151-C-T,rs641501,-1,C,T,134071151,182201,134056744,134449960,14407
11,ENSG00000149489.4,62613257,11-62677326-T-G,rs644616,1,T,G,62677326,64069,62416649,62809865,260677
11,ENSG00000149489.4,62613257,11-62677326-T-C,rs644616,1,T,C,62677326,64069,62416649,62809865,260677
11,ENSG00000149489.4,62613257,11-62677326-T-A,rs644616,1,T,A,62677326,64069,62416649,62809865,260677
11,ENSG00000255823.1,10509186,11-10505075-G-T,rs6484336,-1,G,T,10505075,4111,10312578,10705794,192497
11,ENSG00000255823.1,10509186,11-10505075-G-A,rs6484336,-1,G,A,10505075,4111,10312578,10705794,192497
11,ENSG00000142102.11,289126,11-252851-A-G,rs6541,1,A,G,252851,36275,92518,485734,160333
11,ENSG00000134909.12,129192325,11-129091800-C-T,rs657820,-1,C,T,129091800,100525,128995717,129388933,96083
11,ENSG00000134909.12,129192325,11-129091800-C-G,rs657820,-1,C,G,129091800,100525,128995717,129388933,96083
11,ENSG00000121236.13,5596637,11-5625674-C-T,rs6578668,1,C,T,5625674,29037,5400029,5793245,225645
11,ENSG00000121236.13,5596637,11-5625674-C-G,rs6578668,1,C,G,5625674,29037,5400029,5793245,225645
11,ENSG00000109944.5,122882759,11-123030229-A-G,rs6589965,1,A,G,123030229,147470,122686151,123079367,344078
11,ENSG00000110077.10,60183083,11-60318291-G-T,rs6591564,-1,G,T,60318291,135208,59986475,60379691,331816
11,ENSG00000168061.8,65041210,11-65034795-G-C,rs6591869,1,G,C,65034795,6415,64844602,65237818,190193
11,ENSG00000168061.8,65041210,11-65034795-G-A,rs6591869,1,G,A,65034795,6415,64844602,65237818,190193
11,ENSG00000149196.10,86302240,11-86362093-A-G,rs6592289,1,A,G,86362093,59853,86105632,86498848,256461
11,ENSG00000149196.10,86302240,11-86362093-A-T,rs6592289,1,A,T,86362093,59853,86105632,86498848,256461
11,ENSG00000149196.10,86302240,11-86362093-A-C,rs6592289,1,A,C,86362093,59853,86105632,86498848,256461
11,ENSG00000174669.7,66371760,11-66307673-G-T,rs66974947,-1,G,T,66307673,64087,66175152,66568368,132521
11,ENSG00000174669.7,66371760,11-66307673-G-A,rs66974947,-1,G,A,66307673,64087,66175152,66568368,132521
11,ENSG00000174669.7,66371760,11-66307673-G-C,rs66974947,-1,G,C,66307673,64087,66175152,66568368,132521
11,ENSG00000175634.8,67428494,11-67508998-T-C,rs672432,1,T,C,67508998,80504,67231886,67625102,277112
11,ENSG00000175634.8,67428494,11-67508998-T-A,rs672432,1,T,A,67508998,80504,67231886,67625102,277112
11,ENSG00000064199.2,124673904,11-124696828-A-G,rs679810,1,A,G,124696828,22924,124477296,124870512,219532
11,ENSG00000064199.2,124673904,11-124696828-A-T,rs679810,1,A,T,124696828,22924,124477296,124870512,219532
11,ENSG00000151364.11,78023276,11-78085671-G-A,rs681717,-1,G,A,78085671,62395,77826668,78219884,259003
11,ENSG00000149294.11,112961420,11-112806238-T-A,rs685065,1,T,A,112806238,155182,112764812,113158028,41426
11,ENSG00000149294.11,112961420,11-112806238-T-C,rs685065,1,T,C,112806238,155182,112764812,113158028,41426
11,ENSG00000173511.5,64234584,11-64329761-A-G,rs694739,1,A,G,64329761,95177,64037976,64431192,291785
11,ENSG00000173511.5,64234584,11-64329761-A-T,rs694739,1,A,T,64329761,95177,64037976,64431192,291785
11,ENSG00000187726.4,73951026,11-73960775-A-T,rs699138,1,A,T,73960775,9749,73754418,74147634,206357
11,ENSG00000187726.4,73951026,11-73960775-A-C,rs699138,1,A,C,73960775,9749,73754418,74147634,206357
11,ENSG00000170322.9,129895578,11-130033446-G-A,rs7101516,-1,G,A,130033446,137868,129698970,130092186,334476
11,ENSG00000168000.9,62707424,11-62874527-T-G,rs7104190,-1,T,G,62874527,167103,62510816,62904032,363711
11,ENSG00000184937.8,32435539,11-32329881-C-T,rs7106353,-1,C,T,32329881,105658,32238931,32632147,90950
11,ENSG00000184937.8,32435539,11-32329881-C-A,rs7106353,-1,C,A,32329881,105658,32238931,32632147,90950
11,ENSG00000161328.10,537527,11-702097-T-C,rs7108216,1,T,C,702097,164570,340919,734135,361178
11,ENSG00000161328.10,537527,11-702097-T-A,rs7108216,1,T,A,702097,164570,340919,734135,361178
11,ENSG00000118096.3,118565931,11-118571519-G-A,rs7110984,-1,G,A,118571519,5588,118369323,118762539,202196
11,ENSG00000149054.10,6926426,11-6965195-C-T,rs7117376,1,C,T,6965195,38769,6729818,7123034,235377
11,ENSG00000135363.7,33892076,11-33940209-T-C,rs7119163,-1,T,C,33940209,48133,33695468,34088684,244741
11,ENSG00000133816.8,12110590,11-11993703-A-G,rs7121348,1,A,G,11993703,116887,11913982,12307198,79721
11,ENSG00000133816.8,12110590,11-11993703-A-C,rs7121348,1,A,C,11993703,116887,11913982,12307198,79721
11,ENSG00000036672.9,119381690,11-119351996-G-A,rs7122785,-1,G,A,119351996,29694,119185082,119578298,166914
11,ENSG00000175602.2,65890673,11-65881531-C-T,rs7122964,1,C,T,65881531,9142,65694065,66087281,187466
11,ENSG00000175602.2,65890673,11-65881531-C-A,rs7122964,1,C,A,65881531,9142,65694065,66087281,187466
11,ENSG00000172922.4,65720798,11-65881531-C-T,rs7122964,-1,C,T,65881531,160733,65524190,65917406,357341
11,ENSG00000172922.4,65720798,11-65881531-C-A,rs7122964,-1,C,A,65881531,160733,65524190,65917406,357341
11,ENSG00000137491.9,75151107,11-75109113-C-T,rs7124613,1,C,T,75109113,41994,74954499,75347715,154614
11,ENSG00000137720.3,111879541,11-111876573-A-G,rs7124696,1,A,G,111876573,2968,111682933,112076149,193640
11,ENSG00000154146.6,124739942,11-124928229-A-G,rs7129967,1,A,G,124928229,188287,124543334,124936550,384895
11,ENSG00000197345.7,68903832,11-68842675-G-A,rs7131462,-1,G,A,68842675,61157,68707224,69100440,135451
11,ENSG00000174807.3,66317044,11-66331852-C-T,rs71457711,-1,C,T,66331852,14808,66120436,66513652,211416
11,ENSG00000174807.3,66317044,11-66331852-C-A,rs71457711,-1,C,A,66331852,14808,66120436,66513652,211416
11,ENSG00000166394.10,7673500,11-7691101-G-A,rs72852406,-1,G,A,7691101,17601,7476892,7870108,214209
11,ENSG00000133805.10,10455264,11-10373688-T-C,rs72854736,1,T,C,10373688,81576,10258656,10651872,115032
11,ENSG00000167771.5,63917164,11-63881494-T-C,rs72934152,-1,T,C,63881494,35670,63720556,64113772,160938
11,ENSG00000134780.5,61680391,11-61539766-T-C,rs73496255,1,T,C,61539766,140625,61483783,61876999,55983
11,ENSG00000174775.12,535576,11-353222-A-G,rs7395929,-1,A,G,353222,182354,338968,732184,14254
11,ENSG00000174775.12,535576,11-353222-A-T,rs7395929,-1,A,T,353222,182354,338968,732184,14254
11,ENSG00000174775.12,535576,11-353222-A-C,rs7395929,-1,A,C,353222,182354,338968,732184,14254
11,ENSG00000184281.10,2400750,11-2300599-C-T,rs74048215,1,C,T,2300599,100151,2204142,2597358,96457
11,ENSG00000149428.12,119057205,11-119027609-G-A,rs741811,-1,G,A,119027609,29596,118860597,119253813,167012
11,ENSG00000023191.11,507242,11-680866-A-G,rs7483337,-1,A,G,680866,173624,310634,703850,370232
11,ENSG00000167799.5,67629937,11-67585782-G-A,rs749174,-1,G,A,67585782,44155,67433329,67826545,152453
11,ENSG00000131620.12,70078317,11-70106456-G-A,rs755016,1,G,A,70106456,28139,69881709,70274925,224747
11,ENSG00000131620.12,70078317,11-70106456-G-T,rs755016,1,G,T,70106456,28139,69881709,70274925,224747
11,ENSG00000131620.12,70078317,11-70106456-G-C,rs755016,1,G,C,70106456,28139,69881709,70274925,224747
11,ENSG00000110076.13,64723197,11-64852208-C-T,rs77241001,-1,C,T,64852208,129011,64526589,64919805,325619
11,ENSG00000110076.13,64723197,11-64852208-C-A,rs77241001,-1,C,A,64852208,129011,64526589,64919805,325619
11,ENSG00000142089.9,320860,11-312251-G-A,rs77537847,-1,G,A,312251,8609,124252,517468,187999
11,ENSG00000110448.6,61102489,11-61107729-C-T,rs77696239,1,C,T,61107729,5240,60905881,61299097,201848
11,ENSG00000182359.9,106077347,11-106160949-C-T,rs78190179,-1,C,T,106160949,83602,105880739,106273955,280210
11,ENSG00000181074.3,5754243,11-5698669-G-A,rs79135839,1,G,A,5698669,55574,5557635,5950851,141034
11,ENSG00000181074.3,5754243,11-5698669-G-C,rs79135839,1,G,C,5698669,55574,5557635,5950851,141034
11,ENSG00000185507.14,615950,11-440343-A-C,rs7924341,-1,A,C,440343,175607,419342,812558,21001
11,ENSG00000174516.10,66466905,11-66313299-C-A,rs7924580,1,C,A,66313299,153606,66270297,66663513,43002
11,ENSG00000174516.10,66466905,11-66313299-C-G,rs7924580,1,C,G,66313299,153606,66270297,66663513,43002
11,ENSG00000174516.10,66466905,11-66313299-C-T,rs7924580,1,C,T,66313299,153606,66270297,66663513,43002
11,ENSG00000177697.12,832952,11-820268-A-T,rs7925131,1,A,T,820268,12684,636344,1029560,183924
11,ENSG00000177697.12,832952,11-820268-A-G,rs7925131,1,A,G,820268,12684,636344,1029560,183924
11,ENSG00000174885.8,278407,11-353861-G-T,rs7930566,1,G,T,353861,75454,81799,475015,272062
11,ENSG00000174885.8,278407,11-353861-G-A,rs7930566,1,G,A,353861,75454,81799,475015,272062
11,ENSG00000110108.3,60914158,11-60758313-A-T,rs7930940,1,A,T,60758313,155845,60717550,61110766,40763
11,ENSG00000110108.3,60914158,11-60758313-A-G,rs7930940,1,A,G,60758313,155845,60717550,61110766,40763
11,ENSG00000110108.3,60914158,11-60758313-A-C,rs7930940,1,A,C,60758313,155845,60717550,61110766,40763
11,ENSG00000254470.2,65780976,11-65683549-G-T,rs7934036,-1,G,T,65683549,97427,65584368,65977584,99181
11,ENSG00000110324.4,117986394,11-118052643-G-A,rs7937145,1,G,A,118052643,66249,117789786,118183002,262857
11,ENSG00000110324.4,117986394,11-118052643-G-T,rs7937145,1,G,T,118052643,66249,117789786,118183002,262857
11,ENSG00000166800.5,18455856,11-18458768-A-G,rs7938977,1,A,G,18458768,2912,18259248,18652464,199520
11,ENSG00000137714.2,110429948,11-110472262-A-T,rs7939476,1,A,T,110472262,42314,110233340,110626556,238922
11,ENSG00000137714.2,110429948,11-110472262-A-C,rs7939476,1,A,C,110472262,42314,110233340,110626556,238922
11,ENSG00000148935.6,22666611,11-22839394-G-C,rs7940960,1,G,C,22839394,172783,22470003,22863219,369391
11,ENSG00000148935.6,22666611,11-22839394-G-T,rs7940960,1,G,T,22839394,172783,22470003,22863219,369391
11,ENSG00000165905.12,45922656,11-45759637-T-C,rs7941885,1,T,C,45759637,163019,45726048,46119264,33589
11,ENSG00000177685.10,827919,11-822622-A-G,rs7942159,1,A,G,822622,5297,631311,1024527,191311
11,ENSG00000177685.10,827919,11-822622-A-T,rs7942159,1,A,T,822622,5297,631311,1024527,191311
11,ENSG00000177595.12,805231,11-710139-G-A,rs7942569,-1,G,A,710139,95092,608623,1001839,101516
11,ENSG00000149256.10,79441030,11-79514984-G-T,rs7944323,-1,G,T,79514984,73954,79244422,79637638,270562
11,ENSG00000177030.10,695222,11-787679-G-T,rs7946354,-1,G,T,787679,92457,498614,891830,289065
11,ENSG00000177030.10,695222,11-787679-G-C,rs7946354,-1,G,C,787679,92457,498614,891830,289065
11,ENSG00000062282.8,75768778,11-75810890-G-A,rs7948305,1,G,A,75810890,42112,75572170,75965386,238720
11,ENSG00000020922.7,94493844,11-94366449-A-T,rs7950328,-1,A,T,94366449,127395,94297236,94690452,69213
11,ENSG00000020922.7,94493844,11-94366449-A-G,rs7950328,-1,A,G,94366449,127395,94297236,94690452,69213
11,ENSG00000137699.10,120138113,11-120104484-G-A,rs80079694,-1,G,A,120104484,33629,119941505,120334721,162979
11,ENSG00000166391.9,75717838,11-75835646-A-C,rs80191572,1,A,C,75835646,117808,75521230,75914446,314416
11,ENSG00000166391.9,75717838,11-75835646-A-G,rs80191572,1,A,G,75835646,117808,75521230,75914446,314416
11,ENSG00000170962.8,104164147,11-104105564-A-G,rs80218676,-1,A,G,104105564,58583,103967539,104360755,138025
11,ENSG00000170962.8,104164147,11-104105564-A-C,rs80218676,-1,A,C,104105564,58583,103967539,104360755,138025
11,ENSG00000214517.4,74171289,11-74076279-C-T,rs826063,1,C,T,74076279,95010,73974681,74367897,101598
11,ENSG00000085063.10,33736423,11-33723118-A-C,rs831629,-1,A,C,33723118,13305,33539815,33933031,183303
11,ENSG00000085063.10,33736423,11-33723118-A-G,rs831629,-1,A,G,33723118,13305,33539815,33933031,183303
11,ENSG00000085063.10,33736423,11-33723118-A-T,rs831629,-1,A,T,33723118,13305,33539815,33933031,183303
11,ENSG00000149557.6,125496265,11-125358630-A-C,rs840024,-1,A,C,125358630,137635,125299657,125692873,58973
11,ENSG00000149557.6,125496265,11-125358630-A-G,rs840024,-1,A,G,125358630,137635,125299657,125692873,58973
11,ENSG00000149557.6,125496265,11-125358630-A-T,rs840024,-1,A,T,125358630,137635,125299657,125692873,58973
11,ENSG00000160593.12,118225011,11-118157379-C-T,rs876479,-1,C,T,118157379,67632,118028403,118421619,128976
11,ENSG00000223609.3,5234483,11-5430688-G-A,rs883689,-1,G,A,5430688,196205,5037875,5431091,392813
11,ENSG00000166002.2,93543391,11-93481457-G-A,rs897555,-1,G,A,93481457,61934,93346783,93739999,134674
11,ENSG00000052841.9,43358920,11-43533426-C-T,rs900467,1,C,T,43533426,174506,43162312,43555528,371114
11,ENSG00000177951.12,207399,11-308716-C-T,rs909098,-1,C,T,308716,101317,10791,404007,297925
11,ENSG00000149781.8,64206721,11-64117815-C-T,rs947939,1,C,T,64117815,88906,64010113,64403329,107702
11,ENSG00000177042.9,695816,11-683443-T-A,rs9666056,1,T,A,683443,12373,499208,892424,184235
11,ENSG00000177042.9,695816,11-683443-T-C,rs9666056,1,T,C,683443,12373,499208,892424,184235
11,ENSG00000173442.7,65576053,11-65708345-C-A,rs9666878,1,C,A,65708345,132292,65379445,65772661,328900
11,ENSG00000148943.7,27506769,11-27541835-G-T,rs988712,-1,G,T,27541835,35066,27310161,27703377,231674
11,ENSG00000148943.7,27506769,11-27541835-G-A,rs988712,-1,G,A,27541835,35066,27310161,27703377,231674
10,ENSG00000175395.10,37976647,10-37929331-A-C,rs1005277,-1,A,C,37929331,47316,37780039,38173255,149292
10,ENSG00000122863.5,71964395,10-71985718-C-T,rs1006974,1,C,T,71985718,21323,71767787,72161003,217931
10,ENSG00000176244.6,15088776,10-15067545-G-A,rs10082455,-1,G,A,15067545,21231,14892168,15285384,175377
10,ENSG00000176244.6,15088776,10-15067545-G-C,rs10082455,-1,G,C,15067545,21231,14892168,15285384,175377
10,ENSG00000155265.5,97849843,10-97812539-T-C,rs1010006,1,T,C,97812539,37304,97653235,98046451,159304
10,ENSG00000107951.7,30349278,10-30302276-A-T,rs1011590,-1,A,T,30302276,47002,30152670,30545886,149606
10,ENSG00000107951.7,30349278,10-30302276-A-C,rs1011590,-1,A,C,30302276,47002,30152670,30545886,149606
10,ENSG00000107651.8,119892730,10-119711355-C-A,rs10466211,1,C,A,119711355,181375,119696122,120089338,15233
10,ENSG00000107651.8,119892730,10-119711355-C-T,rs10466211,1,C,T,119711355,181375,119696122,120089338,15233
10,ENSG00000172538.6,49134021,10-49098341-C-T,rs10508911,-1,C,T,49098341,35680,48937413,49330629,160928
10,ENSG00000151150.13,60389875,10-60565907-G-T,rs10509132,-1,G,T,60565907,176032,60193267,60586483,372640
10,ENSG00000151150.13,60389875,10-60565907-G-A,rs10509132,-1,G,A,60565907,176032,60193267,60586483,372640
10,ENSG00000148737.11,112950247,10-112936173-A-T,rs10509967,1,A,T,112936173,14074,112753639,113146855,182534
10,ENSG00000148737.11,112950247,10-112936173-A-G,rs10509967,1,A,G,112936173,14074,112753639,113146855,182534
10,ENSG00000148737.11,112950247,10-112936173-A-C,rs10509967,1,A,C,112936173,14074,112753639,113146855,182534
10,ENSG00000107672.8,121975217,10-121865675-T-C,rs10510102,-1,T,C,121865675,109542,121778609,122171825,87066
10,ENSG00000107679.9,122374708,10-122386196-T-C,rs10749467,1,T,C,122386196,11488,122178100,122571316,208096
10,ENSG00000187783.7,44911337,10-44902738-C-A,rs10751361,1,C,A,44902738,8599,44714729,45107945,188009
10,ENSG00000152457.13,14954096,10-15055617-G-A,rs10752349,-1,G,A,15055617,101521,14757488,15150704,298129
10,ENSG00000152457.13,14954096,10-15055617-G-T,rs10752349,-1,G,T,15055617,101521,14757488,15150704,298129
10,ENSG00000156574.5,70441681,10-70251639-G-C,rs10762354,-1,G,C,70251639,190042,70245073,70638289,6566
10,ENSG00000171160.12,97633500,10-97631529-G-A,rs10786360,-1,G,A,97631529,1971,97436892,97830108,194637
10,ENSG00000189129.8,80132730,10-80157952-A-G,rs1079242,1,A,G,80157952,25222,79936122,80329338,221830
10,ENSG00000047056.10,1056385,10-1096484-A-G,rs10794717,1,A,G,1096484,40099,859777,1252993,236707
10,ENSG00000122912.9,68527523,10-68503822-C-A,rs10823215,-1,C,A,68503822,23701,68330915,68724131,172907
10,ENSG00000122912.9,68527523,10-68503822-C-T,rs10823215,-1,C,T,68503822,23701,68330915,68724131,172907
10,ENSG00000151651.11,133276868,10-133151791-C-T,rs10857673,-1,C,T,133151791,125077,133080260,133473476,71531
10,ENSG00000151651.11,133276868,10-133151791-C-G,rs10857673,-1,C,G,133151791,125077,133080260,133473476,71531
10,ENSG00000174721.9,91909486,10-91900602-A-G,rs10881991,-1,A,G,91900602,8884,91712878,92106094,187724
10,ENSG00000176273.9,93893978,10-93905209-A-T,rs10882364,1,A,T,93905209,11231,93697370,94090586,207839
10,ENSG00000176273.9,93893978,10-93905209-A-C,rs10882364,1,A,C,93905209,11231,93697370,94090586,207839
10,ENSG00000176273.9,93893978,10-93905209-A-G,rs10882364,1,A,G,93905209,11231,93697370,94090586,207839
10,ENSG00000188649.6,95907975,10-95880785-T-C,rs10882680,1,T,C,95880785,27190,95711367,96104583,169418
10,ENSG00000188649.6,95907975,10-95880785-T-G,rs10882680,1,T,G,95880785,27190,95711367,96104583,169418
10,ENSG00000119977.13,95693927,10-95880785-T-C,rs10882680,-1,T,C,95880785,186858,95497319,95890535,383466
10,ENSG00000119977.13,95693927,10-95880785-T-G,rs10882680,-1,T,G,95880785,186858,95497319,95890535,383466
10,ENSG00000188690.7,125823258,10-125813778-T-C,rs10901446,-1,T,C,125813778,9480,125626650,126019866,187128
10,ENSG00000188690.7,125823258,10-125813778-T-G,rs10901446,-1,T,G,125813778,9480,125626650,126019866,187128
10,ENSG00000188690.7,125823258,10-125813778-T-A,rs10901446,-1,T,A,125813778,9480,125626650,126019866,187128
10,ENSG00000154473.11,123154402,10-123161441-T-C,rs10902883,1,T,C,123161441,7039,122957794,123351010,203647
10,ENSG00000165983.9,16437010,10-16443700-G-A,rs10904741,1,G,A,16443700,6690,16240402,16633618,203298
10,ENSG00000165983.9,16437010,10-16443700-G-T,rs10904741,1,G,T,16443700,6690,16240402,16633618,203298
10,ENSG00000165630.8,13586965,10-13591835-A-G,rs10906419,1,A,G,13591835,4870,13390357,13783573,201478
10,ENSG00000165630.8,13586965,10-13591835-A-T,rs10906419,1,A,T,13591835,4870,13390357,13783573,201478
10,ENSG00000165630.8,13586965,10-13591835-A-C,rs10906419,1,A,C,13591835,4870,13390357,13783573,201478
10,ENSG00000152465.11,15168693,10-15166012-A-G,rs10906845,-1,A,G,15166012,2681,14972085,15365301,193927
10,ENSG00000108091.10,59906556,10-59787183-T-C,rs10994008,-1,T,C,59787183,119373,59709948,60103164,77235
10,ENSG00000138311.11,62374369,10-62422860-C-T,rs10995153,1,C,T,62422860,48491,62177761,62570977,245099
10,ENSG00000180817.6,70233429,10-70197356-C-T,rs10999176,-1,C,T,70197356,36073,70036821,70430037,160535
10,ENSG00000120549.10,24209138,10-24378162-T-C,rs11014072,1,T,C,24378162,169024,24012530,24405746,365632
10,ENSG00000120549.10,24209138,10-24378162-T-G,rs11014072,1,T,G,24378162,169024,24012530,24405746,365632
10,ENSG00000120549.10,24209138,10-24378162-T-A,rs11014072,1,T,A,24378162,169024,24012530,24405746,365632
10,ENSG00000136754.12,26860958,10-26756603-A-C,rs11015266,-1,A,C,26756603,104355,26664350,27057566,92253
10,ENSG00000148803.7,133358019,10-133376925-T-C,rs11101722,-1,T,C,133376925,18906,133161411,133554627,215514
10,ENSG00000148824.12,133394157,10-133412537-G-C,rs11101744,1,G,C,133412537,18380,133197549,133590765,214988
10,ENSG00000185875.8,25016612,10-25106272-T-C,rs111238065,1,T,C,25106272,89660,24820004,25213220,286268
10,ENSG00000099256.12,24952606,10-25106272-T-C,rs111238065,-1,T,C,25106272,153666,24755998,25149214,350274
10,ENSG00000243660.3,43437111,10-43517605-C-T,rs1112958,1,C,T,43517605,80494,43240503,43633719,277102
10,ENSG00000152464.8,15097355,10-14936975-A-G,rs111386791,1,A,G,14936975,160380,14900747,15293963,36228
10,ENSG00000107864.8,92291078,10-92202367-T-G,rs11186852,-1,T,G,92202367,88711,92094470,92487686,107897
10,ENSG00000107864.8,92291078,10-92202367-T-C,rs11186852,-1,T,C,92202367,88711,92094470,92487686,107897
10,ENSG00000173145.7,94362939,10-94337109-T-C,rs11187883,-1,T,C,94337109,25830,94166331,94559547,170778
10,ENSG00000052749.9,97401340,10-97375458-T-A,rs11189172,-1,T,A,97375458,25882,97204732,97597948,170726
10,ENSG00000052749.9,97401340,10-97375458-T-C,rs11189172,-1,T,C,97375458,25882,97204732,97597948,170726
10,ENSG00000014919.7,99732127,10-99714742-T-C,rs11190255,-1,T,C,99714742,17385,99535519,99928735,179223
10,ENSG00000107882.7,102503972,10-102453745-C-T,rs11191291,1,C,T,102453745,50227,102307364,102700580,146381
10,ENSG00000214435.3,102869470,10-102866129-G-A,rs11191424,1,G,A,102866129,3341,102672862,103066078,193267
10,ENSG00000148841.10,104338465,10-104351331-C-T,rs11192019,-1,C,T,104351331,12866,104141857,104535073,209474
10,ENSG00000148841.10,104338465,10-104351331-C-G,rs11192019,-1,C,G,104351331,12866,104141857,104535073,209474
10,ENSG00000120051.10,104353833,10-104351331-C-T,rs11192019,1,C,T,104351331,2502,104157225,104550441,194106
10,ENSG00000120051.10,104353833,10-104351331-C-G,rs11192019,1,C,G,104351331,2502,104157225,104550441,194106
10,ENSG00000151923.12,119596964,10-119526418-A-G,rs11198999,-1,A,G,119526418,70546,119400356,119793572,126062
10,ENSG00000107551.13,44959802,10-44992854-A-G,rs11239303,1,A,G,44992854,33052,44763194,45156410,229660
10,ENSG00000107863.10,24723887,10-24857568-C-T,rs1124120,-1,C,T,24857568,133681,24527279,24920495,330289
10,ENSG00000107863.10,24723887,10-24857568-C-G,rs1124120,-1,C,G,24857568,133681,24527279,24920495,330289
10,ENSG00000107937.13,988434,10-1054260-A-G,rs11250243,1,A,G,1054260,65826,791826,1185042,262434
10,ENSG00000173848.13,5412557,10-5390868-G-A,rs11253152,1,G,A,5390868,21689,5215949,5609165,174919
10,ENSG00000108021.13,5684838,10-5528010-C-T,rs11253217,1,C,T,5528010,156828,5488230,5881446,39780
10,ENSG00000123243.10,7666966,10-7694941-C-A,rs11255291,-1,C,A,7694941,27975,7470358,7863574,224583
10,ENSG00000123243.10,7666966,10-7694941-C-T,rs11255291,-1,C,T,7694941,27975,7470358,7863574,224583
10,ENSG00000181192.7,12068954,10-11918603-A-G,rs11257426,1,A,G,11918603,150351,11872346,12265562,46257
10,ENSG00000181192.7,12068954,10-11918603-A-C,rs11257426,1,A,C,11918603,150351,11872346,12265562,46257
10,ENSG00000151461.13,12042809,10-11985328-T-C,rs11591630,-1,T,C,11985328,57481,11846201,12239417,139127
10,ENSG00000148444.9,22316388,10-22188569-G-A,rs11593316,1,G,A,22188569,127819,22119780,22512996,68789
10,ENSG00000165996.8,17617374,10-17699488-T-C,rs11593510,-1,T,C,17699488,82114,17420766,17813982,278722
10,ENSG00000136758.12,27154384,10-27198143-G-A,rs11598615,-1,G,A,27198143,43759,26957776,27350992,240367
10,ENSG00000136758.12,27154384,10-27198143-G-C,rs11598615,-1,G,C,27198143,43759,26957776,27350992,240367
10,ENSG00000128815.11,48684873,10-48687602-T-G,rs116977127,1,T,G,48687602,2729,48488265,48881481,199337
10,ENSG00000107929.9,931705,10-788507-C-T,rs117573051,-1,C,T,788507,143198,735097,1128313,53410
10,ENSG00000107854.5,91798426,10-91667684-G-A,rs118083231,1,G,A,91667684,130742,91601818,91995034,65866
10,ENSG00000107719.7,70478767,10-70480858-T-G,rs11818000,1,T,G,70480858,2091,70282159,70675375,198699
10,ENSG00000095464.8,93612537,10-93464068-T-C,rs12240900,1,T,C,93464068,148469,93415929,93809145,48139
10,ENSG00000177613.7,51699595,10-51705477-T-C,rs12246619,-1,T,C,51705477,5882,51502987,51896203,202490
10,ENSG00000184923.6,87225448,10-87404437-A-G,rs12251529,1,A,G,87404437,178989,87028840,87422056,375597
10,ENSG00000214562.5,87357744,10-87404437-A-G,rs12251529,1,A,G,87404437,46693,87161136,87554352,243301
10,ENSG00000204161.7,49188391,10-49207276-T-C,rs12253910,-1,T,C,49207276,18885,48991783,49384999,215493
10,ENSG00000196233.6,96832298,10-97014345-T-C,rs12254525,1,T,C,97014345,182047,96635690,97028906,378655
10,ENSG00000196233.6,96832298,10-97014345-T-A,rs12254525,1,T,A,97014345,182047,96635690,97028906,378655
10,ENSG00000107447.4,96304434,10-96306529-C-A,rs12260997,1,C,A,96306529,2095,96107826,96501042,198703
10,ENSG00000108094.9,35090341,10-35265126-T-C,rs12261843,-1,T,C,35265126,174785,34893733,35286949,371393
10,ENSG00000108094.9,35090341,10-35265126-T-G,rs12261843,-1,T,G,35265126,174785,34893733,35286949,371393
10,ENSG00000122859.4,69573422,10-69383865-T-C,rs12264809,-1,T,C,69383865,189557,69376814,69770030,7051
10,ENSG00000099282.4,69451465,10-69503508-C-T,rs1227969,1,C,T,69503508,52043,69254857,69648073,248651
10,ENSG00000198246.7,71319259,10-71313495-A-G,rs12412201,1,A,G,71313495,5764,71122651,71515867,190844
10,ENSG00000198246.7,71319259,10-71313495-A-C,rs12412201,1,A,C,71313495,5764,71122651,71515867,190844
10,ENSG00000198246.7,71319259,10-71313495-A-T,rs12412201,1,A,T,71313495,5764,71122651,71515867,190844
10,ENSG00000107562.12,44385097,10-44291899-C-G,rs12412655,-1,C,G,44291899,93198,44188489,44581705,103410
10,ENSG00000107562.12,44385097,10-44291899-C-A,rs12412655,-1,C,A,44291899,93198,44188489,44581705,103410
10,ENSG00000107954.6,103493705,10-103565017-C-T,rs12415501,1,C,T,103565017,71312,103297097,103690313,267920
10,ENSG00000165629.14,7788177,10-7812478-A-C,rs1244447,1,A,C,7812478,24301,7591569,7984785,220909
10,ENSG00000165629.14,7788177,10-7812478-A-G,rs1244447,1,A,G,7812478,24301,7591569,7984785,220909
10,ENSG00000138279.10,73414058,10-73240981-G-A,rs12573841,-1,G,A,73240981,173077,73217450,73610666,23531
10,ENSG00000138279.10,73414058,10-73240981-G-T,rs12573841,-1,G,T,73240981,173077,73217450,73610666,23531
10,ENSG00000148735.10,113751310,10-113724441-T-G,rs12769185,1,T,G,113724441,26869,113554702,113947918,169739
10,ENSG00000148468.11,15371289,10-15376176-G-C,rs12774367,-1,G,C,15376176,4887,15174681,15567897,201495
10,ENSG00000148468.11,15371289,10-15376176-G-A,rs12774367,-1,G,A,15376176,4887,15174681,15567897,201495
10,ENSG00000169826.6,43138445,10-43228767-C-T,rs12775743,1,C,T,43228767,90322,42941837,43335053,286930
10,ENSG00000075073.10,69416918,10-69401141-C-G,rs13139,-1,C,G,69401141,15777,69220310,69613526,180831
10,ENSG00000075073.10,69416918,10-69401141-C-T,rs13139,-1,C,T,69401141,15777,69220310,69613526,180831
10,ENSG00000119950.14,110207605,10-110213581-C-T,rs1342273,1,C,T,110213581,5976,110010997,110404213,202584
10,ENSG00000119950.14,110207605,10-110213581-C-G,rs1342273,1,C,G,110213581,5976,110010997,110404213,202584
10,ENSG00000119950.14,110207605,10-110213581-C-A,rs1342273,1,C,A,110213581,5976,110010997,110404213,202584
10,ENSG00000181915.3,62804720,10-62792847-G-A,rs1509966,1,G,A,62792847,11873,62608112,63001328,184735
10,ENSG00000181915.3,62804720,10-62792847-G-T,rs1509966,1,G,T,62792847,11873,62608112,63001328,184735
10,ENSG00000165650.7,117375440,10-117414434-T-C,rs1638665,-1,T,C,117414434,38994,117178832,117572048,235602
10,ENSG00000183621.9,31031937,10-31009396-G-A,rs1690624,-1,G,A,31009396,22541,30835329,31228545,174067
10,ENSG00000150867.7,22714578,10-22637200-T-G,rs16922539,-1,T,G,22637200,77378,22517970,22911186,119230
10,ENSG00000150867.7,22714578,10-22637200-T-A,rs16922539,-1,T,A,22637200,77378,22517970,22911186,119230
10,ENSG00000107738.12,71773520,10-71727370-A-G,rs16929266,-1,A,G,71727370,46150,71576912,71970128,150458
10,ENSG00000122359.11,80205537,10-80056378-T-C,rs17098169,-1,T,C,80056378,149159,80008929,80402145,47449
10,ENSG00000198873.8,119207571,10-119328387-T-C,rs17098718,1,T,C,119328387,120816,119010963,119404179,317424
10,ENSG00000155256.12,97737128,10-97574571-T-C,rs17108102,1,T,C,97574571,162557,97540520,97933736,34051
10,ENSG00000170430.9,129467241,10-129480146-G-T,rs1711667,1,G,T,129480146,12905,129270633,129663849,209513
10,ENSG00000170430.9,129467241,10-129480146-G-C,rs1711667,1,G,C,129480146,12905,129270633,129663849,209513
10,ENSG00000170430.9,129467241,10-129480146-G-A,rs1711667,1,G,A,129480146,12905,129270633,129663849,209513
10,ENSG00000151532.9,112447215,10-112464880-C-T,rs17129806,1,C,T,112464880,17665,112250607,112643823,214273
10,ENSG00000151532.9,112447215,10-112464880-C-A,rs17129806,1,C,A,112464880,17665,112250607,112643823,214273
10,ENSG00000151532.9,112447215,10-112464880-C-G,rs17129806,1,C,G,112464880,17665,112250607,112643823,214273
10,ENSG00000095585.10,96271569,10-96090854-G-A,rs17384909,-1,G,A,96090854,180715,96074961,96468177,15893
10,ENSG00000120008.10,120851362,10-120962691-T-C,rs17510528,1,T,C,120962691,111329,120654754,121047970,307937
10,ENSG00000165669.7,118342324,10-118458481-G-T,rs17575500,-1,G,T,118458481,116157,118145716,118538932,312765
10,ENSG00000165669.7,118342324,10-118458481-G-A,rs17575500,-1,G,A,118458481,116157,118145716,118538932,312765
10,ENSG00000120049.12,101843800,10-101961056-G-A,rs17699425,-1,G,A,101961056,117256,101647192,102040408,313864
10,ENSG00000096717.7,67884656,10-67863513-A-G,rs17712705,1,A,G,67863513,21143,67688048,68081264,175465
10,ENSG00000214413.2,110919180,10-110834149-A-G,rs17764171,-1,A,G,110834149,85031,110722572,111115788,111577
10,ENSG00000165646.7,117241114,10-117343960-A-T,rs181440,1,A,T,117343960,102846,117044506,117437722,299454
10,ENSG00000165646.7,117241114,10-117343960-A-C,rs181440,1,A,C,117343960,102846,117044506,117437722,299454
10,ENSG00000185303.9,79560407,10-79629844-C-T,rs1863889,-1,C,T,79629844,69437,79363799,79757015,266045
10,ENSG00000185303.9,79560407,10-79629844-C-A,rs1863889,-1,C,A,79629844,69437,79363799,79757015,266045
10,ENSG00000119917.8,89327997,10-89503830-T-A,rs188570,1,T,A,89503830,175833,89131389,89524605,372441
10,ENSG00000119917.8,89327997,10-89503830-T-C,rs188570,1,T,C,89503830,175833,89131389,89524605,372441
10,ENSG00000148908.10,119542719,10-119637764-G-T,rs196276,-1,G,T,119637764,95045,119346111,119739327,291653
10,ENSG00000148908.10,119542719,10-119637764-G-C,rs196276,-1,G,C,119637764,95045,119346111,119739327,291653
10,ENSG00000148908.10,119542719,10-119637764-G-A,rs196276,-1,G,A,119637764,95045,119346111,119739327,291653
10,ENSG00000171206.7,102644479,10-102538034-T-A,rs2031604,1,T,A,102538034,106445,102447871,102841087,90163
10,ENSG00000171206.7,102644479,10-102538034-T-C,rs2031604,1,T,C,102538034,106445,102447871,102841087,90163
10,ENSG00000138347.10,68109488,10-68162978-C-T,rs2087344,1,C,T,68162978,53490,67912880,68306096,250098
10,ENSG00000148843.7,103396626,10-103515668-T-A,rs2148021,1,T,A,103515668,119042,103200018,103593234,315650
10,ENSG00000148843.7,103396626,10-103515668-T-G,rs2148021,1,T,G,103515668,119042,103200018,103593234,315650
10,ENSG00000148483.7,17752201,10-17689273-T-C,rs2182158,1,T,C,17689273,62928,17555593,17948809,133680
10,ENSG00000119986.6,97687241,10-97806214-C-G,rs2185363,-1,C,G,97806214,118973,97490633,97883849,315581
10,ENSG00000214655.5,73785606,10-73909432-G-T,rs2227551,1,G,T,73909432,123826,73588998,73982214,320434
10,ENSG00000214655.5,73785606,10-73909432-G-C,rs2227551,1,G,C,73909432,123826,73588998,73982214,320434
10,ENSG00000148798.5,103277138,10-103450224-T-C,rs2232658,1,T,C,103450224,173086,103080530,103473746,369694
10,ENSG00000198879.6,7411034,10-7465842-A-C,rs2251868,-1,A,C,7465842,54808,7214426,7607642,251416
10,ENSG00000138326.12,78033863,10-78116597-G-C,rs2253909,1,G,C,78116597,82734,77837255,78230471,279342
10,ENSG00000138326.12,78033863,10-78116597-G-A,rs2253909,1,G,A,78116597,82734,77837255,78230471,279342
10,ENSG00000138326.12,78033863,10-78116597-G-T,rs2253909,1,G,T,78116597,82734,77837255,78230471,279342
10,ENSG00000138346.9,68471973,10-68341899-A-G,rs2273902,-1,A,G,68341899,130074,68275365,68668581,66534
10,ENSG00000059573.4,95656711,10-95637470-T-C,rs2275273,-1,T,C,95637470,19241,95460103,95853319,177367
10,ENSG00000059573.4,95656711,10-95637470-T-A,rs2275273,-1,T,A,95637470,19241,95460103,95853319,177367
10,ENSG00000171813.10,132397200,10-132337416-T-G,rs2295273,1,T,G,132337416,59784,132200592,132593808,136824
10,ENSG00000148814.13,132332193,10-132337416-T-G,rs2295273,1,T,G,132337416,5223,132135585,132528801,201831
10,ENSG00000138107.6,102502712,10-102488330-T-C,rs2296588,-1,T,C,102488330,14382,102306104,102699320,182226
10,ENSG00000185745.8,89392623,10-89224866-A-G,rs2297475,1,A,G,89224866,167757,89196015,89589231,28851
10,ENSG00000138134.7,88880245,10-88901941-A-G,rs2304803,1,A,G,88901941,21696,88683637,89076853,218304
10,ENSG00000176986.10,73744372,10-73746916-T-C,rs2306325,1,T,C,73746916,2544,73547764,73940980,199152
10,ENSG00000185532.8,51074487,10-51011383-T-A,rs2339684,1,T,A,51011383,63104,50877879,51271095,133504
10,ENSG00000185532.8,51074487,10-51011383-T-C,rs2339684,1,T,C,51011383,63104,50877879,51271095,133504
10,ENSG00000165678.13,84139509,10-84062549-G-T,rs2350140,1,G,T,84062549,76960,83942901,84336117,119648
10,ENSG00000166343.5,73433561,10-73627588-A-G,rs2395054,-1,A,G,73627588,194027,73236953,73630169,390635
10,ENSG00000198954.4,68988803,10-69005336-G-T,rs2487707,1,G,T,69005336,16533,68792195,69185411,213141
10,ENSG00000165732.7,68956170,10-69036167-C-T,rs2491032,1,C,T,69036167,79997,68759562,69152778,276605
10,ENSG00000165731.11,43077069,10-42952399-A-G,rs2506030,1,A,G,42952399,124670,42880461,43273677,71938
10,ENSG00000165731.11,43077069,10-42952399-A-C,rs2506030,1,A,C,42952399,124670,42880461,43273677,71938
10,ENSG00000165383.6,48914232,10-48917927-C-T,rs2663056,-1,C,T,48917927,3695,48717624,49110840,200303
10,ENSG00000107771.11,84328589,10-84516840-T-G,rs2784847,1,T,G,84516840,188251,84131981,84525197,384859
10,ENSG00000107771.11,84328589,10-84516840-T-C,rs2784847,1,T,C,84516840,188251,84131981,84525197,384859
10,ENSG00000165322.12,31928831,10-31762016-A-G,rs2797128,-1,A,G,31762016,166815,31732223,32125439,29793
10,ENSG00000055950.12,100987497,10-100986746-C-G,rs2863095,-1,C,G,100986746,751,100790889,101184105,195857
10,ENSG00000055950.12,100987497,10-100986746-C-T,rs2863095,-1,C,T,100986746,751,100790889,101184105,195857
10,ENSG00000138115.7,95069497,10-95238701-C-T,rs2901832,-1,C,T,95238701,169204,94872889,95266105,365812
10,ENSG00000156398.6,102714636,10-102727625-C-A,rs2902548,1,C,A,102727625,12989,102518028,102911244,209597
10,ENSG00000156398.6,102714636,10-102727625-C-T,rs2902548,1,C,T,102727625,12989,102518028,102911244,209597
10,ENSG00000156398.6,102714636,10-102727625-C-G,rs2902548,1,C,G,102727625,12989,102518028,102911244,209597
10,ENSG00000107798.11,89251775,10-89240182-T-C,rs2902563,-1,T,C,89240182,11593,89055167,89448383,185015
10,ENSG00000148835.9,103367976,10-103464955-A-C,rs2986025,1,A,C,103464955,96979,103171368,103564584,293587
10,ENSG00000148835.9,103367976,10-103464955-A-T,rs2986025,1,A,T,103464955,96979,103171368,103564584,293587
10,ENSG00000077420.9,26438341,10-26438525-G-A,rs2992333,1,G,A,26438525,184,26241733,26634949,196792
10,ENSG00000169740.8,43648881,10-43526321-G-T,rs2999241,-1,G,T,43526321,122560,43452273,43845489,74048
10,ENSG00000169740.8,43648881,10-43526321-G-C,rs2999241,-1,G,C,43526321,122560,43452273,43845489,74048
10,ENSG00000169740.8,43648881,10-43526321-G-A,rs2999241,-1,G,A,43526321,122560,43452273,43845489,74048
10,ENSG00000196793.8,43574616,10-43526384-T-A,rs2999242,-1,T,A,43526384,48232,43378008,43771224,148376
10,ENSG00000196793.8,43574616,10-43526384-T-C,rs2999242,-1,T,C,43526384,48232,43378008,43771224,148376
10,ENSG00000183128.7,103479240,10-103486526-A-C,rs3014187,-1,A,C,103486526,7286,103282632,103675848,203894
10,ENSG00000183128.7,103479240,10-103486526-A-T,rs3014187,-1,A,T,103486526,7286,103282632,103675848,203894
10,ENSG00000183128.7,103479240,10-103486526-A-G,rs3014187,-1,A,G,103486526,7286,103282632,103675848,203894
10,ENSG00000152778.7,89414568,10-89402920-C-T,rs303210,1,C,T,89402920,11648,89217960,89611176,184960
10,ENSG00000152778.7,89414568,10-89402920-C-G,rs303210,1,C,G,89402920,11648,89217960,89611176,184960
10,ENSG00000165672.5,119178812,10-119168032-T-C,rs3377,-1,T,C,119168032,10780,118982204,119375420,185828
10,ENSG00000165672.5,119178812,10-119168032-T-G,rs3377,-1,T,G,119168032,10780,118982204,119375420,185828
10,ENSG00000156510.9,69220332,10-69177133-T-G,rs34052666,1,T,G,69177133,43199,69023724,69416940,153409
10,ENSG00000078403.11,21534232,10-21633883-A-T,rs34600782,1,A,T,21633883,99651,21337624,21730840,296259
10,ENSG00000078403.11,21534232,10-21633883-A-G,rs34600782,1,A,G,21633883,99651,21337624,21730840,296259
10,ENSG00000168283.7,22321099,10-22132325-G-A,rs34737777,1,G,A,22132325,188774,22124491,22517707,7834
10,ENSG00000148429.7,11611650,10-11449116-A-G,rs35620397,-1,A,G,11449116,162534,11415042,11808258,34074
10,ENSG00000213390.4,97292637,10-97294006-G-A,rs35728874,-1,G,A,97294006,1369,97096029,97489245,197977
10,ENSG00000148450.8,23095579,10-23114988-C-A,rs35990418,1,C,A,23114988,19409,22898971,23292187,216017
10,ENSG00000107796.7,88952773,10-88991583-A-G,rs3740286,-1,A,G,88991583,38810,88756165,89149381,235418
10,ENSG00000107796.7,88952773,10-88991583-A-C,rs3740286,-1,A,C,88991583,38810,88756165,89149381,235418
10,ENSG00000107796.7,88952773,10-88991583-A-T,rs3740286,-1,A,T,88991583,38810,88756165,89149381,235418
10,ENSG00000107816.11,100999476,10-100987606-G-T,rs3740484,1,G,T,100987606,11870,100802868,101196084,184738
10,ENSG00000156521.9,70146700,10-70144239-T-G,rs3763735,-1,T,G,70144239,2461,69950092,70343308,194147
10,ENSG00000156521.9,70146700,10-70144239-T-C,rs3763735,-1,T,C,70144239,2461,69950092,70343308,194147
10,ENSG00000156521.9,70146700,10-70144239-T-A,rs3763735,-1,T,A,70144239,2461,69950092,70343308,194147
10,ENSG00000089876.7,125881292,10-125839698-T-C,rs3781058,-1,T,C,125839698,41594,125684684,126077900,155014
10,ENSG00000165879.7,97319271,10-97320828-C-G,rs3781373,1,C,G,97320828,1557,97122663,97515879,198165
10,ENSG00000165879.7,97319271,10-97320828-C-T,rs3781373,1,C,T,97320828,1557,97122663,97515879,198165
10,ENSG00000134463.10,11742382,10-11742089-T-C,rs3814626,1,T,C,11742089,293,11545774,11938990,196315
10,ENSG00000204020.4,88760020,10-88733777-C-T,rs406671,1,C,T,88733777,26243,88563412,88956628,170365
10,ENSG00000065154.7,124418923,10-124418937-A-C,rs4144117,-1,A,C,124418937,14,124222315,124615531,196622
10,ENSG00000065154.7,124418923,10-124418937-A-T,rs4144117,-1,A,T,124418937,14,124222315,124615531,196622
10,ENSG00000023839.6,99782640,10-99788711-G-A,rs4148386,1,G,A,99788711,6071,99586032,99979248,202679
10,ENSG00000138175.7,102714397,10-102666420-G-A,rs4244354,-1,G,A,102666420,47977,102517789,102911005,148631
10,ENSG00000165633.6,49115522,10-49135640-G-C,rs4338455,-1,G,C,49135640,20118,48918914,49312130,216726
10,ENSG00000119922.7,89302046,10-89352023-C-T,rs4378299,1,C,T,89352023,49977,89105438,89498654,246585
10,ENSG00000119922.7,89302046,10-89352023-C-G,rs4378299,1,C,G,89352023,49977,89105438,89498654,246585
10,ENSG00000026103.14,88990798,10-88999967-A-T,rs4406737,1,A,T,88999967,9169,88794190,89187406,205777
10,ENSG00000026103.14,88990798,10-88999967-A-G,rs4406737,1,A,G,88999967,9169,88794190,89187406,205777
10,ENSG00000148848.9,126388477,10-126308172-A-G,rs4420178,-1,A,G,126308172,80305,126191869,126585085,116303
10,ENSG00000148730.6,70404145,10-70422354-G-A,rs45450199,1,G,A,70422354,18209,70207537,70600753,214817
10,ENSG00000107537.9,13300064,10-13288402-T-C,rs473407,-1,T,C,13288402,11662,13103456,13496672,184946
10,ENSG00000107537.9,13300064,10-13288402-T-A,rs473407,-1,T,A,13288402,11662,13103456,13496672,184946
10,ENSG00000035403.10,73998116,10-73972686-T-A,rs4746162,1,T,A,73972686,25430,73801508,74194724,171178
10,ENSG00000035403.10,73998116,10-73972686-T-C,rs4746162,1,T,C,73972686,25430,73801508,74194724,171178
10,ENSG00000151640.7,132186948,10-132175870-A-T,rs4880339,1,A,T,132175870,11078,131990340,132383556,185530
10,ENSG00000151640.7,132186948,10-132175870-A-C,rs4880339,1,A,C,132175870,11078,131990340,132383556,185530
10,ENSG00000151640.7,132186948,10-132175870-A-G,rs4880339,1,A,G,132175870,11078,131990340,132383556,185530
10,ENSG00000067057.10,3067548,10-3105309-C-T,rs4881081,1,C,T,3105309,37761,2870940,3264156,234369
10,ENSG00000213341.4,100229596,10-100113011-A-G,rs4919425,-1,A,G,100113011,116585,100032988,100426204,80023
10,ENSG00000148690.9,93702592,10-93847792-T-A,rs4919587,-1,T,A,93847792,145200,93505984,93899200,341808
10,ENSG00000148690.9,93702592,10-93847792-T-G,rs4919587,-1,T,G,93847792,145200,93505984,93899200,341808
10,ENSG00000165512.4,45000923,10-45061204-T-C,rs4948942,1,T,C,45061204,60281,44804315,45197531,256889
10,ENSG00000119965.8,122954227,10-122933070-A-T,rs4980169,-1,A,T,122933070,21157,122757619,123150835,175451
10,ENSG00000119965.8,122954227,10-122933070-A-C,rs4980169,-1,A,C,122933070,21157,122757619,123150835,175451
10,ENSG00000119965.8,122954227,10-122933070-A-G,rs4980169,-1,A,G,122933070,21157,122757619,123150835,175451
10,ENSG00000241058.1,18651587,10-18539706-T-C,rs58225473,-1,T,C,18539706,111881,18454979,18848195,84727
10,ENSG00000241058.1,18651587,10-18539706-T-G,rs58225473,-1,T,G,18539706,111881,18454979,18848195,84727
10,ENSG00000148834.8,104254892,10-104269695-T-C,rs589007,1,T,C,104269695,14803,104058284,104451500,211411
10,ENSG00000048740.10,11017872,10-11176152-C-T,rs596417,1,C,T,11176152,158280,10821264,11214480,354888
10,ENSG00000048740.10,11017872,10-11176152-C-A,rs596417,1,C,A,11176152,158280,10821264,11214480,354888
10,ENSG00000180644.5,70602741,10-70664556-C-G,rs608234,-1,C,G,70664556,61815,70406133,70799349,258423
10,ENSG00000180644.5,70602741,10-70664556-C-T,rs608234,-1,C,T,70664556,61815,70406133,70799349,258423
10,ENSG00000075407.11,38094337,10-38057089-T-C,rs61858885,1,T,C,38057089,37248,37897729,38290945,159360
10,ENSG00000171314.6,97426191,10-97590676-C-T,rs61863261,1,C,T,97590676,164485,97229583,97622799,361093
10,ENSG00000171314.6,97426191,10-97590676-C-A,rs61863261,1,C,A,97590676,164485,97229583,97622799,361093
10,ENSG00000165730.10,68827531,10-68785522-G-A,rs61869871,1,G,A,68785522,42009,68630923,69024139,154599
10,ENSG00000172731.9,70382625,10-70348419-G-A,rs6480454,-1,G,A,70348419,34206,70186017,70579233,162402
10,ENSG00000165997.4,18659431,10-18538899-C-T,rs6482515,1,C,T,18538899,120532,18462823,18856039,76076
10,ENSG00000165997.4,18659431,10-18538899-C-G,rs6482515,1,C,G,18538899,120532,18462823,18856039,76076
10,ENSG00000165997.4,18659431,10-18538899-C-A,rs6482515,1,C,A,18538899,120532,18462823,18856039,76076
10,ENSG00000138185.11,95756163,10-95784756-G-C,rs6584027,1,G,C,95784756,28593,95559555,95952771,225201
10,ENSG00000138185.11,95756163,10-95784756-G-A,rs6584027,1,G,A,95784756,28593,95559555,95952771,225201
10,ENSG00000099204.12,114658275,10-114471861-T-G,rs6585284,-1,T,G,114471861,186414,114461667,114854883,10194
10,ENSG00000099204.12,114658275,10-114471861-T-C,rs6585284,-1,T,C,114471861,186414,114461667,114854883,10194
10,ENSG00000182022.12,124093598,10-124065861-T-C,rs6588750,-1,T,C,124065861,27737,123896990,124290206,168871
10,ENSG00000182022.12,124093598,10-124065861-T-A,rs6588750,-1,T,A,124065861,27737,123896990,124290206,168871
10,ENSG00000107959.9,3172782,10-3177602-A-T,rs6602036,-1,A,T,3177602,4820,2976174,3369390,201428
10,ENSG00000107959.9,3172782,10-3177602-A-G,rs6602036,-1,A,G,3177602,4820,2976174,3369390,201428
10,ENSG00000065665.15,12129677,10-12167753-T-C,rs6686,1,T,C,12167753,38076,11933069,12326285,234684
10,ENSG00000107521.13,98446935,10-98417112-C-T,rs701801,-1,C,T,98417112,29823,98250327,98643543,166785
10,ENSG00000119906.6,100912963,10-101007360-C-A,rs701836,1,C,A,101007360,94397,100716355,101109571,291005
10,ENSG00000119906.6,100912963,10-101007360-C-T,rs701836,1,C,T,101007360,94397,100716355,101109571,291005
10,ENSG00000148377.5,1025859,10-978274-T-C,rs7069123,-1,T,C,978274,47585,829251,1222467,149023
10,ENSG00000166321.9,73110455,10-73152246-T-C,rs7069878,1,T,C,73152246,41791,72913847,73307063,238399
10,ENSG00000198298.8,43606438,10-43575139-A-T,rs7075288,1,A,T,43575139,31299,43409830,43803046,165309
10,ENSG00000198298.8,43606438,10-43575139-A-C,rs7075288,1,A,C,43575139,31299,43409830,43803046,165309
10,ENSG00000198298.8,43606438,10-43575139-A-G,rs7075288,1,A,G,43575139,31299,43409830,43803046,165309
10,ENSG00000196968.4,73772276,10-73753039-C-A,rs7076525,1,C,A,73753039,19237,73575668,73968884,177371
10,ENSG00000196968.4,73772276,10-73753039-C-T,rs7076525,1,C,T,73753039,19237,73575668,73968884,177371
10,ENSG00000197889.4,14959388,10-14966555-A-G,rs7079652,1,A,G,14966555,7167,14762780,15155996,203775
10,ENSG00000165752.11,132307950,10-132336922-A-C,rs7085610,-1,A,C,132336922,28972,132111342,132504558,225580
10,ENSG00000107890.12,27100494,10-27103593-T-A,rs7087033,-1,T,A,27103593,3099,26903886,27297102,199707
10,ENSG00000107890.12,27100494,10-27103593-T-G,rs7087033,-1,T,G,27103593,3099,26903886,27297102,199707
10,ENSG00000107890.12,27100494,10-27103593-T-C,rs7087033,-1,T,C,27103593,3099,26903886,27297102,199707
10,ENSG00000172661.12,45727266,10-45652878-T-C,rs7091141,1,T,C,45652878,74388,45530658,45923874,122220
10,ENSG00000172661.12,45727266,10-45652878-T-G,rs7091141,1,T,G,45652878,74388,45530658,45923874,122220
10,ENSG00000165832.4,114938195,10-114970779-C-T,rs7092748,1,C,T,114970779,32584,114741587,115134803,229192
10,ENSG00000196072.6,100286680,10-100234724-T-C,rs7092983,-1,T,C,100234724,51956,100090072,100483288,144652
10,ENSG00000171811.7,132942570,10-132940068-T-C,rs7096772,-1,T,C,132940068,2502,132745962,133139178,194106
10,ENSG00000148634.10,68075283,10-68150809-G-C,rs7097584,-1,G,C,68150809,75526,67878675,68271891,272134
10,ENSG00000148634.10,68075283,10-68150809-G-T,rs7097584,-1,G,T,68150809,75526,67878675,68271891,272134
10,ENSG00000122952.11,56361259,10-56307366-T-C,rs7099218,-1,T,C,56307366,53893,56164651,56557867,142715
10,ENSG00000107614.16,17201672,10-17209431-C-T,rs7099222,-1,C,T,17209431,7759,17005064,17398280,204367
10,ENSG00000107614.16,17201672,10-17209431-C-G,rs7099222,-1,C,G,17209431,7759,17005064,17398280,204367
10,ENSG00000107614.16,17201672,10-17209431-C-A,rs7099222,-1,C,A,17209431,7759,17005064,17398280,204367
10,ENSG00000079332.7,70170514,10-70362053-T-C,rs7101097,-1,T,C,70362053,191539,69973906,70367122,388147
10,ENSG00000079332.7,70170514,10-70362053-T-G,rs7101097,-1,T,G,70362053,191539,69973906,70367122,388147
10,ENSG00000165733.6,42782795,10-42831179-A-C,rs7133,1,A,C,42831179,48384,42586187,42979403,244992
10,ENSG00000165733.6,42782795,10-42831179-A-G,rs7133,1,A,G,42831179,48384,42586187,42979403,244992
10,ENSG00000156113.13,77637808,10-77451311-G-C,rs71475659,-1,G,C,77451311,186497,77441200,77834416,10111
10,ENSG00000156113.13,77637808,10-77451311-G-A,rs71475659,-1,G,A,77451311,186497,77441200,77834416,10111
10,ENSG00000227345.3,49942027,10-49995520-A-G,rs72797724,-1,A,G,49995520,53493,49745419,50138635,250101
10,ENSG00000122884.7,73096866,10-73002410-G-A,rs72812259,-1,G,A,73002410,94456,72900258,73293474,102152
10,ENSG00000122884.7,73096866,10-73002410-G-C,rs72812259,-1,G,C,73002410,94456,72900258,73293474,102152
10,ENSG00000213551.3,73247255,10-73060688-C-A,rs72812263,-1,C,A,73060688,186567,73050647,73443863,10041
10,ENSG00000043591.4,114043866,10-114026852-G-T,rs72823015,1,G,T,114026852,17014,113847258,114240474,179594
10,ENSG00000165476.6,63521401,10-63618935-C-T,rs72840204,1,C,T,63618935,97534,63324793,63718009,294142
10,ENSG00000107862.4,102245532,10-102117790-C-T,rs72845615,1,C,T,102117790,127742,102048924,102442140,68866
10,ENSG00000225899.2,133626795,10-133456883-G-C,rs72868335,-1,G,C,133456883,169912,133430187,133823403,26696
10,ENSG00000198825.7,119726050,10-119635426-A-G,rs74157688,1,A,G,119635426,90624,119529442,119922658,105984
10,ENSG00000107611.9,17129811,10-17003668-T-C,rs76098511,-1,T,C,17003668,126143,16933203,17326419,70465
10,ENSG00000138316.6,70672506,10-70578123-C-T,rs76143452,1,C,T,70578123,94383,70475898,70869114,102225
10,ENSG00000185267.5,14838037,10-14869940-C-A,rs76797256,-1,C,A,14869940,31903,14641429,15034645,228511
10,ENSG00000165449.7,59709850,10-59707825-G-C,rs76953358,-1,G,C,59707825,2025,59513242,59906458,194583
10,ENSG00000148688.6,90871974,10-90926725-A-G,rs77310729,1,A,G,90926725,54751,90675366,91068582,251359
10,ENSG00000107949.11,125823546,10-125787124-C-T,rs78084887,1,C,T,125787124,36422,125626938,126020154,160186
10,ENSG00000107949.11,125823546,10-125787124-C-A,rs78084887,1,C,A,125787124,36422,125626938,126020154,160186
10,ENSG00000177283.4,35642296,10-35682739-C-T,rs78852685,-1,C,T,35682739,40443,35445688,35838904,237051
10,ENSG00000177283.4,35642296,10-35682739-C-G,rs78852685,-1,C,G,35682739,40443,35445688,35838904,237051
10,ENSG00000127884.4,133373354,10-133370917-C-A,rs7894051,-1,C,A,133370917,2437,133176746,133569962,194171
10,ENSG00000127884.4,133373354,10-133370917-C-G,rs7894051,-1,C,G,133370917,2437,133176746,133569962,194171
10,ENSG00000127884.4,133373354,10-133370917-C-T,rs7894051,-1,C,T,133370917,2437,133176746,133569962,194171
10,ENSG00000165406.9,45535371,10-45588052-G-A,rs7896175,-1,G,A,45588052,52681,45338763,45731979,249289
10,ENSG00000165406.9,45535371,10-45588052-G-T,rs7896175,-1,G,T,45588052,52681,45338763,45731979,249289
10,ENSG00000108010.7,130136391,10-130140618-A-G,rs7897193,1,A,G,130140618,4227,129939783,130332999,200835
10,ENSG00000155229.13,97498422,10-97588741-T-C,rs7897232,-1,T,C,97588741,90319,97301814,97695030,286927
10,ENSG00000148498.11,34815296,10-34786889-T-G,rs7897283,-1,T,G,34786889,28407,34618688,35011904,168201
10,ENSG00000095794.14,35126846,10-35097309-C-T,rs7897827,1,C,T,35097309,29537,34930238,35323454,167071
10,ENSG00000120594.9,19816432,10-19947342-G-A,rs7898627,1,G,A,19947342,130910,19619824,20013040,327518
10,ENSG00000182010.6,62268844,10-62258713-T-A,rs7905731,-1,T,A,62258713,10131,62072236,62465452,186477
10,ENSG00000182010.6,62268844,10-62258713-T-C,rs7905731,-1,T,C,62258713,10131,62072236,62465452,186477
10,ENSG00000182010.6,62268844,10-62258713-T-G,rs7905731,-1,T,G,62258713,10131,62072236,62465452,186477
10,ENSG00000012779.5,45374216,10-45336491-G-T,rs7906533,1,G,T,45336491,37725,45177608,45570824,158883
10,ENSG00000012779.5,45374216,10-45336491-G-A,rs7906533,1,G,A,45336491,37725,45177608,45570824,158883
10,ENSG00000165985.7,16521879,10-16514711-T-C,rs7909832,-1,T,C,16514711,7168,16325271,16718487,189440
10,ENSG00000256574.2,45315608,10-45373441-G-A,rs7913948,-1,G,A,45373441,57833,45119000,45512216,254441
10,ENSG00000095539.10,100972540,10-101044326-T-C,rs7921250,1,T,C,101044326,71786,100775932,101169148,268394
10,ENSG00000107554.10,100009947,10-99931871-G-C,rs7922447,-1,G,C,99931871,78076,99813339,100206555,118532
10,ENSG00000107554.10,100009947,10-99931871-G-T,rs7922447,-1,G,T,99931871,78076,99813339,100206555,118532
10,ENSG00000065809.8,14774897,10-14664762-A-G,rs7923154,-1,A,G,14664762,110135,14578289,14971505,86473
10,ENSG00000119927.9,112183765,10-112171675-G-T,rs79569343,-1,G,T,112171675,12090,111987157,112380373,184518
10,ENSG00000119927.9,112183765,10-112171675-G-A,rs79569343,-1,G,A,112171675,12090,111987157,112380373,184518
10,ENSG00000165813.11,114174203,10-114214494-C-T,rs79605080,-1,C,T,114214494,40291,113977595,114370811,236899
10,ENSG00000169129.8,114404502,10-114214494-C-T,rs79605080,-1,C,T,114214494,190008,114207894,114601110,6600
10,ENSG00000165507.7,44978809,10-44984028-G-T,rs79857424,-1,G,T,44984028,5219,44782201,45175417,201827
10,ENSG00000170759.10,32056425,10-32072287-G-C,rs806818,-1,G,C,32072287,15862,31859817,32253033,212470
10,ENSG00000170759.10,32056425,10-32072287-G-A,rs806818,-1,G,A,32072287,15862,31859817,32253033,212470
10,ENSG00000170759.10,32056425,10-32072287-G-T,rs806818,-1,G,T,32072287,15862,31859817,32253033,212470
10,ENSG00000150054.12,28303064,10-28330558-T-C,rs811496,-1,T,C,28330558,27494,28106456,28499672,224102
10,ENSG00000086475.9,13348293,10-13271567-T-A,rs825631,-1,T,A,13271567,76726,13151685,13544901,119882
10,ENSG00000086475.9,13348293,10-13271567-T-C,rs825631,-1,T,C,13271567,76726,13151685,13544901,119882
10,ENSG00000108219.8,80454166,10-80510276-G-C,rs882682,1,G,C,80510276,56110,80257558,80650774,252718
10,ENSG00000108219.8,80454166,10-80510276-G-A,rs882682,1,G,A,80510276,56110,80257558,80650774,252718
10,ENSG00000107902.9,124461823,10-124456396-G-C,rs908365,1,G,C,124456396,5427,124265215,124658431,191181
10,ENSG00000107902.9,124461823,10-124456396-G-T,rs908365,1,G,T,124456396,5427,124265215,124658431,191181
10,ENSG00000148484.12,16817424,10-16809409-C-A,rs921742,-1,C,A,16809409,8015,16620816,17014032,188593
10,ENSG00000148484.12,16817424,10-16809409-C-T,rs921742,-1,C,T,16809409,8015,16620816,17014032,188593
10,ENSG00000237489.2,130110830,10-130089055-G-T,rs942675,-1,G,T,130089055,21775,129914222,130307438,174833
10,ENSG00000237489.2,130110830,10-130089055-G-C,rs942675,-1,G,C,130089055,21775,129914222,130307438,174833
10,ENSG00000237489.2,130110830,10-130089055-G-A,rs942675,-1,G,A,130089055,21775,129914222,130307438,174833
10,ENSG00000155254.7,97713730,10-97734983-C-T,rs946779,1,C,T,97734983,21253,97517122,97910338,217861
10,ENSG00000166275.10,102854259,10-102863821-C-T,rs9527,1,C,T,102863821,9562,102657651,103050867,206170
10,ENSG00000150593.11,110871928,10-110843268-A-G,rs9633680,1,A,G,110843268,28660,110675320,111068536,167948
10,ENSG00000165813.11,114174203,10-114284605-T-C,rs1003441,-1,T,C,114284605,110402,113977595,114370811,307010
10,ENSG00000165813.11,114174203,10-114284605-T-A,rs1003441,-1,T,A,114284605,110402,113977595,114370811,307010
10,ENSG00000165813.11,114174203,10-114284605-T-G,rs1003441,-1,T,G,114284605,110402,113977595,114370811,307010
10,ENSG00000067064.6,1049119,10-1038420-T-A,rs10508204,-1,T,A,1038420,10699,852511,1245727,185909
10,ENSG00000067064.6,1049119,10-1038420-T-C,rs10508204,-1,T,C,1038420,10699,852511,1245727,185909
10,ENSG00000107796.7,88952773,10-88992155-T-A,rs10509561,-1,T,A,88992155,39382,88756165,89149381,235990
10,ENSG00000165985.7,16521879,10-16511356-A-G,rs1052708,-1,A,G,16511356,10523,16325271,16718487,186085
10,ENSG00000152465.11,15168693,10-15107981-C-T,rs1054657,-1,C,T,15107981,60712,14972085,15365301,135896
10,ENSG00000138180.10,93496612,10-93508872-T-A,rs10748603,1,T,A,93508872,12260,93300004,93693220,208868
10,ENSG00000138180.10,93496612,10-93508872-T-C,rs10748603,1,T,C,93508872,12260,93300004,93693220,208868
10,ENSG00000185745.8,89392623,10-89315502-A-G,rs10749605,1,A,G,89315502,77121,89196015,89589231,119487
10,ENSG00000185745.8,89392623,10-89315502-A-T,rs10749605,1,A,T,89315502,77121,89196015,89589231,119487
10,ENSG00000183128.7,103479240,10-103397371-A-C,rs10786751,-1,A,C,103397371,81869,103282632,103675848,114739
10,ENSG00000188690.7,125823258,10-125804845-A-G,rs10794023,-1,A,G,125804845,18413,125626650,126019866,178195
10,ENSG00000188690.7,125823258,10-125804845-A-C,rs10794023,-1,A,C,125804845,18413,125626650,126019866,178195
10,ENSG00000047056.10,1056385,10-1110225-T-G,rs10794720,1,T,G,1110225,53840,859777,1252993,250448
10,ENSG00000047056.10,1056385,10-1110225-T-A,rs10794720,1,T,A,1110225,53840,859777,1252993,250448
10,ENSG00000047056.10,1056385,10-1110225-T-C,rs10794720,1,T,C,1110225,53840,859777,1252993,250448
10,ENSG00000156574.5,70441681,10-70397693-G-A,rs10823535,-1,G,A,70397693,43988,70245073,70638289,152620
10,ENSG00000177283.4,35642296,10-35787846-C-T,rs10827540,-1,C,T,35787846,145550,35445688,35838904,342158
10,ENSG00000120594.9,19816432,10-19967314-A-T,rs10827912,1,A,T,19967314,150882,19619824,20013040,347490
10,ENSG00000120594.9,19816432,10-19967314-A-G,rs10827912,1,A,G,19967314,150882,19619824,20013040,347490
10,ENSG00000120594.9,19816432,10-19967314-A-C,rs10827912,1,A,C,19967314,150882,19619824,20013040,347490
10,ENSG00000077420.9,26438341,10-26456236-T-C,rs10829005,1,T,C,26456236,17895,26241733,26634949,214503
10,ENSG00000077420.9,26438341,10-26456236-T-G,rs10829005,1,T,G,26456236,17895,26241733,26634949,214503
10,ENSG00000095464.8,93612537,10-93510908-G-A,rs10882254,1,G,A,93510908,101629,93415929,93809145,94979
10,ENSG00000176273.9,93893978,10-93839932-G-A,rs10882356,1,G,A,93839932,54046,93697370,94090586,142562
10,ENSG00000176273.9,93893978,10-93839932-G-C,rs10882356,1,G,C,93839932,54046,93697370,94090586,142562
10,ENSG00000065613.9,103967140,10-103998912-A-G,rs10883960,1,A,G,103998912,31772,103770532,104163748,228380
10,ENSG00000203867.6,110644336,10-110828597-G-A,rs10885054,1,G,A,110828597,184261,110447728,110840944,380869
10,ENSG00000165646.7,117241114,10-117358998-T-C,rs10886062,1,T,C,117358998,117884,117044506,117437722,314492
10,ENSG00000165646.7,117241114,10-117358998-T-A,rs10886062,1,T,A,117358998,117884,117044506,117437722,314492
10,ENSG00000169813.11,43409186,10-43445450-T-C,rs10899803,-1,T,C,43445450,36264,43212578,43605794,232872
10,ENSG00000196793.8,43574616,10-43609596-G-A,rs10899836,-1,G,A,43609596,34980,43378008,43771224,231588
10,ENSG00000196793.8,43574616,10-43609596-G-C,rs10899836,-1,G,C,43609596,34980,43378008,43771224,231588
10,ENSG00000196793.8,43574616,10-43609596-G-T,rs10899836,-1,G,T,43609596,34980,43378008,43771224,231588
10,ENSG00000138161.8,122845857,10-122721527-T-C,rs10902851,-1,T,C,122721527,124330,122649249,123042465,72278
10,ENSG00000107614.16,17201672,10-17203213-A-G,rs10904906,-1,A,G,17203213,1541,17005064,17398280,198149
10,ENSG00000107614.16,17201672,10-17203213-A-C,rs10904906,-1,A,C,17203213,1541,17005064,17398280,198149
10,ENSG00000026025.8,17228241,10-17267905-C-T,rs10904913,1,C,T,17267905,39664,17031633,17424849,236272
10,ENSG00000123243.10,7666966,10-7667946-T-C,rs10905208,-1,T,C,7667946,980,7470358,7863574,197588
10,ENSG00000108091.10,59906556,10-59773809-C-A,rs10994002,-1,C,A,59773809,132747,59709948,60103164,63861
10,ENSG00000204147.5,50739936,10-50799874-A-G,rs10994507,1,A,G,50799874,59938,50543328,50936544,256546
10,ENSG00000204147.5,50739936,10-50799874-A-C,rs10994507,1,A,C,50799874,59938,50543328,50936544,256546
10,ENSG00000072422.11,60944185,10-60866719-T-C,rs10994551,-1,T,C,60866719,77466,60747577,61140793,119142
10,ENSG00000182010.6,62268844,10-62206628-A-G,rs10995086,-1,A,G,62206628,62216,62072236,62465452,134392
10,ENSG00000181915.3,62804720,10-62627348-C-T,rs10995238,1,C,T,62627348,177372,62608112,63001328,19236
10,ENSG00000168209.3,72273924,10-72330428-T-C,rs11000266,1,T,C,72330428,56504,72077316,72470532,253112
10,ENSG00000166348.12,73591342,10-73625224-T-A,rs11000723,-1,T,A,73625224,33882,73394734,73787950,230490
10,ENSG00000166348.12,73591342,10-73625224-T-G,rs11000723,-1,T,G,73625224,33882,73394734,73787950,230490
10,ENSG00000166348.12,73591342,10-73625224-T-C,rs11000723,-1,T,C,73625224,33882,73394734,73787950,230490
10,ENSG00000151151.5,58267894,10-58228315-T-A,rs11006086,-1,T,A,58228315,39579,58071286,58464502,157029
10,ENSG00000151151.5,58267894,10-58228315-T-C,rs11006086,-1,T,C,58228315,39579,58071286,58464502,157029
10,ENSG00000148498.11,34815296,10-34727647-T-C,rs11009892,-1,T,C,34727647,87649,34618688,35011904,108959
10,ENSG00000203772.6,133424625,10-133340345-C-T,rs11101699,-1,C,T,133340345,84280,133228017,133621233,112328
10,ENSG00000196233.6,96832298,10-96870959-C-T,rs11188957,1,C,T,96870959,38661,96635690,97028906,235269
10,ENSG00000138111.7,102461395,10-102461782-A-C,rs11191293,1,A,C,102461782,387,102264787,102658003,196995
10,ENSG00000138111.7,102461395,10-102461782-A-G,rs11191293,1,A,G,102461782,387,102264787,102658003,196995
10,ENSG00000173915.8,103396475,10-103296155-A-T,rs11191642,-1,A,T,103296155,100320,103199867,103593083,96288
10,ENSG00000173915.8,103396475,10-103296155-A-G,rs11191642,-1,A,G,103296155,100320,103199867,103593083,96288
10,ENSG00000119950.14,110207605,10-110373562-C-T,rs11195102,1,C,T,110373562,165957,110010997,110404213,362565
10,ENSG00000165806.12,113679912,10-113711257-T-G,rs11196446,1,T,G,113711257,31345,113483304,113876520,227953
10,ENSG00000165806.12,113679912,10-113711257-T-A,rs11196446,1,T,A,113711257,31345,113483304,113876520,227953
10,ENSG00000183605.10,119165714,10-119338778-C-T,rs11198886,-1,C,T,119338778,173064,118969106,119362322,369672
10,ENSG00000148600.10,84194537,10-84179275-G-A,rs11200905,1,G,A,84179275,15262,83997929,84391145,181346
10,ENSG00000173848.13,5412557,10-5488422-T-C,rs11253202,1,T,C,5488422,75865,5215949,5609165,272473
10,ENSG00000108176.8,67838188,10-67820348-C-T,rs112711956,-1,C,T,67820348,17840,67641580,68034796,178768
10,ENSG00000130640.8,133308872,10-133431074-C-T,rs114627280,-1,C,T,133431074,122202,133112264,133505480,318810
10,ENSG00000095794.14,35126846,10-35208018-G-C,rs1148247,1,G,C,35208018,81172,34930238,35323454,277780
10,ENSG00000095794.14,35126846,10-35208018-G-A,rs1148247,1,G,A,35208018,81172,34930238,35323454,277780
10,ENSG00000107874.5,102432574,10-102401718-A-C,rs11574852,-1,A,C,102401718,30856,102235966,102629182,165752
10,ENSG00000078403.11,21534232,10-21479997-T-G,rs11595807,1,T,G,21479997,54235,21337624,21730840,142373
10,ENSG00000078403.11,21534232,10-21479997-T-A,rs11595807,1,T,A,21479997,54235,21337624,21730840,142373
10,ENSG00000138119.11,93482334,10-93314655-A-G,rs11596560,-1,A,G,93314655,167679,93285726,93678942,28929
10,ENSG00000165449.7,59709850,10-59709780-T-C,rs1171614,-1,T,C,59709780,70,59513242,59906458,196538
10,ENSG00000165449.7,59709850,10-59709780-T-G,rs1171614,-1,T,G,59709780,70,59513242,59906458,196538
10,ENSG00000165449.7,59709850,10-59709780-T-A,rs1171614,-1,T,A,59709780,70,59513242,59906458,196538
10,ENSG00000023041.7,112446914,10-112335587-A-G,rs117934655,-1,A,G,112335587,111327,112250306,112643522,85281
10,ENSG00000151150.13,60389875,10-60485835-A-G,rs118052890,-1,A,G,60485835,95960,60193267,60586483,292568
10,ENSG00000165443.7,59176643,10-59313854-A-G,rs11812286,1,A,G,59313854,137211,58980035,59373251,333819
10,ENSG00000148690.9,93702592,10-93707177-G-T,rs11815061,-1,G,T,93707177,4585,93505984,93899200,201193
10,ENSG00000148690.9,93702592,10-93707177-G-A,rs11815061,-1,G,A,93707177,4585,93505984,93899200,201193
10,ENSG00000198105.7,37857610,10-37742055-G-A,rs11815066,-1,G,A,37742055,115555,37661002,38054218,81053
10,ENSG00000075073.10,69416918,10-69292444-C-T,rs11815833,-1,C,T,69292444,124474,69220310,69613526,72134
10,ENSG00000185267.5,14838037,10-14817921-T-C,rs11817170,-1,T,C,14817921,20116,14641429,15034645,176492
10,ENSG00000134460.9,6062367,10-6142269-G-A,rs11818885,-1,G,A,6142269,79902,5865759,6258975,276510
10,ENSG00000151923.12,119596964,10-119597684-A-G,rs12217200,-1,A,G,119597684,720,119400356,119793572,197328
10,ENSG00000148541.8,59362549,10-59343872-A-G,rs12240944,-1,A,G,59343872,18677,59165941,59559157,177931
10,ENSG00000227268.2,87863533,10-87746394-T-C,rs12249650,-1,T,C,87746394,117139,87666925,88060141,79469
10,ENSG00000089876.7,125881292,10-125806628-T-C,rs12251135,-1,T,C,125806628,74664,125684684,126077900,121944
10,ENSG00000198246.7,71319259,10-71334440-G-A,rs12252139,1,G,A,71334440,15181,71122651,71515867,211789
10,ENSG00000198915.7,43267065,10-43238832-C-T,rs12254612,-1,C,T,43238832,28233,43070457,43463673,168375
10,ENSG00000107902.9,124461823,10-124464426-C-A,rs12261656,1,C,A,124464426,2603,124265215,124658431,199211
10,ENSG00000107902.9,124461823,10-124464426-C-T,rs12261656,1,C,T,124464426,2603,124265215,124658431,199211
10,ENSG00000107902.9,124461823,10-124464426-C-G,rs12261656,1,C,G,124464426,2603,124265215,124658431,199211
10,ENSG00000148834.8,104254892,10-104272003-C-A,rs12261808,1,C,A,104272003,17111,104058284,104451500,213719
10,ENSG00000148834.8,104254892,10-104272003-C-T,rs12261808,1,C,T,104272003,17111,104058284,104451500,213719
10,ENSG00000121898.6,123891807,10-123766133-C-T,rs12266074,-1,C,T,123766133,125674,123695199,124088415,70934
10,ENSG00000095585.10,96271569,10-96228697-C-T,rs12357751,-1,C,T,96228697,42872,96074961,96468177,153736
10,ENSG00000148908.10,119542719,10-119526472-G-T,rs12413821,-1,G,T,119526472,16247,119346111,119739327,180361
10,ENSG00000214413.2,110919180,10-110817963-A-G,rs12413827,-1,A,G,110817963,101217,110722572,111115788,95391
10,ENSG00000148459.10,26697701,10-26682950-C-T,rs12415035,1,C,T,26682950,14751,26501093,26894309,181857
10,ENSG00000165879.7,97319271,10-97209311-G-A,rs1253407,1,G,A,97209311,109960,97122663,97515879,86648
10,ENSG00000180644.5,70602741,10-70473588-T-G,rs12572286,-1,T,G,70473588,129153,70406133,70799349,67455
10,ENSG00000134452.12,5890243,10-6035857-G-A,rs12722525,1,G,A,6035857,145614,5693635,6086851,342222
10,ENSG00000134452.12,5890243,10-6035857-G-C,rs12722525,1,G,C,6035857,145614,5693635,6086851,342222
10,ENSG00000122912.9,68527523,10-68572915-T-A,rs12773594,-1,T,A,68572915,45392,68330915,68724131,242000
10,ENSG00000165476.6,63521401,10-63605976-G-A,rs12779973,1,G,A,63605976,84575,63324793,63718009,281183
10,ENSG00000165476.6,63521401,10-63605976-G-C,rs12779973,1,G,C,63605976,84575,63324793,63718009,281183
10,ENSG00000128805.9,48605073,10-48557018-C-T,rs1345111,-1,C,T,48557018,48055,48408465,48801681,148553
10,ENSG00000119965.8,122954227,10-122815103-C-G,rs1417790,-1,C,G,122815103,139124,122757619,123150835,57484
10,ENSG00000119965.8,122954227,10-122815103-C-T,rs1417790,-1,C,T,122815103,139124,122757619,123150835,57484
10,ENSG00000148735.10,113751310,10-113633820-G-A,rs1419099,1,G,A,113633820,117490,113554702,113947918,79118
10,ENSG00000150054.12,28303064,10-28203719-C-T,rs1457177,-1,C,T,28203719,99345,28106456,28499672,97263
10,ENSG00000256574.2,45315608,10-45433374-C-T,rs1487562,-1,C,T,45433374,117766,45119000,45512216,314374
10,ENSG00000122863.5,71964395,10-72063261-A-G,rs1668172,1,A,G,72063261,98866,71767787,72161003,295474
10,ENSG00000108064.6,58385410,10-58391386-A-C,rs16912196,1,A,C,58391386,5976,58188802,58582018,202584
10,ENSG00000108064.6,58385410,10-58391386-A-T,rs16912196,1,A,T,58391386,5976,58188802,58582018,202584
10,ENSG00000108064.6,58385410,10-58391386-A-G,rs16912196,1,A,G,58391386,5976,58188802,58582018,202584
10,ENSG00000148730.6,70404145,10-70287257-G-A,rs16913394,1,G,A,70287257,116888,70207537,70600753,79720
10,ENSG00000107758.9,73496024,10-73407888-C-T,rs16930573,-1,C,T,73407888,88136,73299416,73692632,108472
10,ENSG00000107758.9,73496024,10-73407888-C-A,rs16930573,-1,C,A,73407888,88136,73299416,73692632,108472
10,ENSG00000204149.4,49988406,10-49830501-C-T,rs17010387,1,C,T,49830501,157905,49791798,50185014,38703
10,ENSG00000170324.13,48274696,10-48203400-G-C,rs17010723,-1,G,C,48203400,71296,48078088,48471304,125312
10,ENSG00000170324.13,48274696,10-48203400-G-A,rs17010723,-1,G,A,48203400,71296,48078088,48471304,125312
10,ENSG00000107521.13,98446935,10-98382397-G-A,rs17109597,-1,G,A,98382397,64538,98250327,98643543,132070
10,ENSG00000107521.13,98446935,10-98382397-G-C,rs17109597,-1,G,C,98382397,64538,98250327,98643543,132070
10,ENSG00000151474.13,14330924,10-14344296-G-A,rs17155084,-1,G,A,14344296,13372,14134316,14527532,209980
10,ENSG00000148516.15,31319216,10-31240211-C-T,rs17229928,1,C,T,31240211,79005,31122608,31515824,117603
10,ENSG00000148516.15,31319216,10-31240211-C-A,rs17229928,1,C,A,31240211,79005,31122608,31515824,117603
10,ENSG00000165983.9,16437010,10-16441792-A-G,rs17320049,1,A,G,16441792,4782,16240402,16633618,201390
10,ENSG00000052749.9,97401340,10-97445034-G-A,rs17415112,-1,G,A,97445034,43694,97204732,97597948,240302
10,ENSG00000099282.4,69451465,10-69477780-C-A,rs17569412,1,C,A,69477780,26315,69254857,69648073,222923
10,ENSG00000095739.6,28677521,10-28813069-T-A,rs1761994,1,T,A,28813069,135548,28480913,28874129,332156
10,ENSG00000095739.6,28677521,10-28813069-T-G,rs1761994,1,T,G,28813069,135548,28480913,28874129,332156
10,ENSG00000107882.7,102503972,10-102490521-A-G,rs17709610,1,A,G,102490521,13451,102307364,102700580,183157
10,ENSG00000213551.3,73247255,10-73242769-T-C,rs17738368,-1,T,C,73242769,4486,73050647,73443863,192122
10,ENSG00000165730.10,68827531,10-68717321-A-G,rs1782330,1,A,G,68717321,110210,68630923,69024139,86398
10,ENSG00000165730.10,68827531,10-68717321-A-T,rs1782330,1,A,T,68717321,110210,68630923,69024139,86398
10,ENSG00000165730.10,68827531,10-68717321-A-C,rs1782330,1,A,C,68717321,110210,68630923,69024139,86398
10,ENSG00000148484.12,16817424,10-16832566-T-C,rs1797081,-1,T,C,16832566,15142,16620816,17014032,211750
10,ENSG00000148484.12,16817424,10-16832566-T-A,rs1797081,-1,T,A,16832566,15142,16620816,17014032,211750
10,ENSG00000122852.9,79610939,10-79629844-C-A,rs1863889,1,C,A,79629844,18905,79414331,79807547,215513
10,ENSG00000122852.9,79610939,10-79629844-C-T,rs1863889,1,C,T,79629844,18905,79414331,79807547,215513
10,ENSG00000119906.6,100912963,10-100887424-A-G,rs1886276,1,A,G,100887424,25539,100716355,101109571,171069
10,ENSG00000156374.8,103351140,10-103242040-G-A,rs1891293,-1,G,A,103242040,109100,103154532,103547748,87508
10,ENSG00000107719.7,70478767,10-70493140-A-T,rs1904593,1,A,T,70493140,14373,70282159,70675375,210981
10,ENSG00000107719.7,70478767,10-70493140-A-C,rs1904593,1,A,C,70493140,14373,70282159,70675375,210981
10,ENSG00000107719.7,70478767,10-70493140-A-G,rs1904593,1,A,G,70493140,14373,70282159,70675375,210981
10,ENSG00000172731.9,70382625,10-70384502-A-C,rs1904594,-1,A,C,70384502,1877,70186017,70579233,198485
10,ENSG00000165383.6,48914232,10-48911009-A-T,rs1913517,-1,A,T,48911009,3223,48717624,49110840,193385
10,ENSG00000165383.6,48914232,10-48911009-A-G,rs1913517,-1,A,G,48911009,3223,48717624,49110840,193385
10,ENSG00000178217.8,80537902,10-80652046-C-T,rs1913751,1,C,T,80652046,114144,80341294,80734510,310752
10,ENSG00000178217.8,80537902,10-80652046-C-G,rs1913751,1,C,G,80652046,114144,80341294,80734510,310752
10,ENSG00000204161.7,49188391,10-49184968-C-T,rs1962336,-1,C,T,49184968,3423,48991783,49384999,193185
10,ENSG00000150347.10,61901699,10-61760940-T-A,rs1992625,1,T,A,61760940,140759,61705091,62098307,55849
10,ENSG00000150347.10,61901699,10-61760940-T-G,rs1992625,1,T,G,61760940,140759,61705091,62098307,55849
10,ENSG00000150347.10,61901699,10-61760940-T-C,rs1992625,1,T,C,61760940,140759,61705091,62098307,55849
10,ENSG00000107897.13,27240797,10-27413994-C-G,rs201821343,-1,C,G,27413994,173197,27044189,27437405,369805
10,ENSG00000107897.13,27240797,10-27413994-C-T,rs201821343,-1,C,T,27413994,173197,27044189,27437405,369805
10,ENSG00000170759.10,32056425,10-32047402-T-G,rs211289,-1,T,G,32047402,9023,31859817,32253033,187585
10,ENSG00000107798.11,89251775,10-89246097-C-T,rs2246833,-1,C,T,89246097,5678,89055167,89448383,190930
10,ENSG00000107679.9,122374708,10-122464428-C-G,rs2248799,1,C,G,122464428,89720,122178100,122571316,286328
10,ENSG00000107679.9,122374708,10-122464428-C-A,rs2248799,1,C,A,122464428,89720,122178100,122571316,286328
10,ENSG00000107679.9,122374708,10-122464428-C-T,rs2248799,1,C,T,122464428,89720,122178100,122571316,286328
10,ENSG00000165507.7,44978809,10-44978892-G-C,rs2274888,-1,G,C,44978892,83,44782201,45175417,196691
10,ENSG00000165507.7,44978809,10-44978892-G-T,rs2274888,-1,G,T,44978892,83,44782201,45175417,196691
10,ENSG00000165507.7,44978809,10-44978892-G-A,rs2274888,-1,G,A,44978892,83,44782201,45175417,196691
10,ENSG00000176171.7,131981923,10-132106586-C-T,rs2379228,-1,C,T,132106586,124663,131785315,132178531,321271
10,ENSG00000107672.8,121975217,10-121902207-C-A,rs2420970,-1,C,A,121902207,73010,121778609,122171825,123598
10,ENSG00000107672.8,121975217,10-121902207-C-G,rs2420970,-1,C,G,121902207,73010,121778609,122171825,123598
10,ENSG00000107672.8,121975217,10-121902207-C-T,rs2420970,-1,C,T,121902207,73010,121778609,122171825,123598
10,ENSG00000165731.11,43077069,10-43087702-A-G,rs2435356,1,A,G,43087702,10633,42880461,43273677,207241
10,ENSG00000165731.11,43077069,10-43087702-A-T,rs2435356,1,A,T,43087702,10633,42880461,43273677,207241
10,ENSG00000107890.12,27100494,10-27237602-G-T,rs2483489,-1,G,T,27237602,137108,26903886,27297102,333716
10,ENSG00000107890.12,27100494,10-27237602-G-C,rs2483489,-1,G,C,27237602,137108,26903886,27297102,333716
10,ENSG00000107890.12,27100494,10-27237602-G-A,rs2483489,-1,G,A,27237602,137108,26903886,27297102,333716
10,ENSG00000138316.6,70672506,10-70750322-G-A,rs2541228,1,G,A,70750322,77816,70475898,70869114,274424
10,ENSG00000138316.6,70672506,10-70750322-G-T,rs2541228,1,G,T,70750322,77816,70475898,70869114,274424
10,ENSG00000138347.10,68109488,10-68155278-A-G,rs2673797,1,A,G,68155278,45790,67912880,68306096,242398
10,ENSG00000148483.7,17752201,10-17727339-A-G,rs2688793,1,A,G,17727339,24862,17555593,17948809,171746
10,ENSG00000148814.13,132332193,10-132345217-A-G,rs2748391,1,A,G,132345217,13024,132135585,132528801,209632
10,ENSG00000095787.14,28533118,10-28481089-A-G,rs2790453,1,A,G,28481089,52029,28336510,28729726,144579
10,ENSG00000095787.14,28533118,10-28481089-A-T,rs2790453,1,A,T,28481089,52029,28336510,28729726,144579
10,ENSG00000188385.7,132065946,10-132145902-G-A,rs2814175,1,G,A,132145902,79956,131869338,132262554,276564
10,ENSG00000151640.7,132186948,10-132222549-G-A,rs2814197,1,G,A,132222549,35601,131990340,132383556,232209
10,ENSG00000151640.7,132186948,10-132222549-G-C,rs2814197,1,G,C,132222549,35601,131990340,132383556,232209
10,ENSG00000156510.9,69220332,10-69090203-G-A,rs2855022,1,G,A,69090203,130129,69023724,69416940,66479
10,ENSG00000185532.8,51074487,10-50995464-T-G,rs2879550,1,T,G,50995464,79023,50877879,51271095,117585
10,ENSG00000185532.8,51074487,10-50995464-T-C,rs2879550,1,T,C,50995464,79023,50877879,51271095,117585
10,ENSG00000185532.8,51074487,10-50995464-T-A,rs2879550,1,T,A,50995464,79023,50877879,51271095,117585
10,ENSG00000107960.6,103918184,10-103877231-T-C,rs2902638,-1,T,C,103877231,40953,103721576,104114792,155655
10,ENSG00000119977.13,95693927,10-95754860-G-A,rs3176893,-1,G,A,95754860,60933,95497319,95890535,257541
10,ENSG00000065809.8,14774897,10-14959283-C-A,rs34021689,-1,C,A,14959283,184386,14578289,14971505,380994
10,ENSG00000065809.8,14774897,10-14959283-C-T,rs34021689,-1,C,T,14959283,184386,14578289,14971505,380994
10,ENSG00000171813.10,132397200,10-132511506-A-G,rs34140003,1,A,G,132511506,114306,132200592,132593808,310914
10,ENSG00000148832.9,133379262,10-133318548-A-T,rs34466598,1,A,T,133318548,60714,133182654,133575870,135894
10,ENSG00000148832.9,133379262,10-133318548-A-C,rs34466598,1,A,C,133318548,60714,133182654,133575870,135894
10,ENSG00000148803.7,133358019,10-133352119-G-A,rs34780987,-1,G,A,133352119,5900,133161411,133554627,190708
10,ENSG00000186862.11,101031129,10-100859326-C-A,rs35355083,-1,C,A,100859326,171803,100834521,101227737,24805
10,ENSG00000186862.11,101031129,10-100859326-C-T,rs35355083,-1,C,T,100859326,171803,100834521,101227737,24805
10,ENSG00000134470.12,5977543,10-5977007-A-G,rs36055263,-1,A,G,5977007,536,5780935,6174151,196072
10,ENSG00000165650.7,117375440,10-117249657-A-C,rs363401,-1,A,C,117249657,125783,117178832,117572048,70825
10,ENSG00000165650.7,117375440,10-117249657-A-G,rs363401,-1,A,G,117249657,125783,117178832,117572048,70825
10,ENSG00000177613.7,51699595,10-51698287-A-G,rs3740228,-1,A,G,51698287,1308,51502987,51896203,195300
10,ENSG00000107854.5,91798426,10-91630923-G-A,rs3781228,1,G,A,91630923,167503,91601818,91995034,29105
10,ENSG00000107551.13,44959802,10-44968587-A-G,rs3814566,1,A,G,44968587,8785,44763194,45156410,205393
10,ENSG00000138185.11,95756163,10-95606063-G-A,rs4037,1,G,A,95606063,150100,95559555,95952771,46508
10,ENSG00000165995.14,18140424,10-18328653-A-C,rs4146986,1,A,C,18328653,188229,17943816,18337032,384837
10,ENSG00000165633.6,49115522,10-49092134-C-A,rs4240498,-1,C,A,49092134,23388,48918914,49312130,173220
10,ENSG00000172538.6,49134021,10-49135640-G-C,rs4338455,-1,G,C,49135640,1619,48937413,49330629,198227
10,ENSG00000183049.8,12349547,10-12340705-C-T,rs4354614,1,C,T,12340705,8842,12152939,12546155,187766
10,ENSG00000198924.3,113854082,10-113877281-T-C,rs4376860,-1,T,C,113877281,23199,113657474,114050690,219807
10,ENSG00000165997.4,18659431,10-18587155-C-G,rs4445544,1,C,G,18587155,72276,18462823,18856039,124332
10,ENSG00000165997.4,18659431,10-18587155-C-A,rs4445544,1,C,A,18587155,72276,18462823,18856039,124332
10,ENSG00000198954.4,68988803,10-68892516-G-A,rs4472827,1,G,A,68892516,96287,68792195,69185411,100321
10,ENSG00000241058.1,18651587,10-18500795-T-A,rs4485000,-1,T,A,18500795,150792,18454979,18848195,45816
10,ENSG00000241058.1,18651587,10-18500795-T-G,rs4485000,-1,T,G,18500795,150792,18454979,18848195,45816
10,ENSG00000148719.9,72354919,10-72309220-G-C,rs4495815,-1,G,C,72309220,45699,72158311,72551527,150909
10,ENSG00000148719.9,72354919,10-72309220-G-T,rs4495815,-1,G,T,72309220,45699,72158311,72551527,150909
10,ENSG00000198728.6,102120368,10-101971620-T-A,rs4614373,-1,T,A,101971620,148748,101923760,102316976,47860
10,ENSG00000198728.6,102120368,10-101971620-T-C,rs4614373,-1,T,C,101971620,148748,101923760,102316976,47860
10,ENSG00000197746.7,71851251,10-71799195-C-T,rs4747195,-1,C,T,71799195,52056,71654643,72047859,144552
10,ENSG00000165630.8,13586965,10-13484000-T-C,rs4748040,1,T,C,13484000,102965,13390357,13783573,93643
10,ENSG00000176244.6,15088776,10-15073720-C-T,rs4748140,-1,C,T,15073720,15056,14892168,15285384,181552
10,ENSG00000176244.6,15088776,10-15073720-C-G,rs4748140,-1,C,G,15073720,15056,14892168,15285384,181552
10,ENSG00000176244.6,15088776,10-15073720-C-A,rs4748140,-1,C,A,15073720,15056,14892168,15285384,181552
10,ENSG00000123240.10,13100163,10-13231577-G-T,rs4750326,1,G,T,13231577,131414,12903555,13296771,328022
10,ENSG00000123240.10,13100163,10-13231577-G-A,rs4750326,1,G,A,13231577,131414,12903555,13296771,328022
10,ENSG00000237489.2,130110830,10-130110342-G-C,rs4751162,-1,G,C,130110342,488,129914222,130307438,196120
10,ENSG00000237489.2,130110830,10-130110342-G-A,rs4751162,-1,G,A,130110342,488,129914222,130307438,196120
10,ENSG00000170430.9,129467241,10-129602044-A-G,rs480643,1,A,G,129602044,134803,129270633,129663849,331411
10,ENSG00000170430.9,129467241,10-129602044-A-T,rs480643,1,A,T,129602044,134803,129270633,129663849,331411
10,ENSG00000108061.7,110919604,10-111107461-T-C,rs4918625,1,T,C,111107461,187857,110722996,111116212,384465
10,ENSG00000171311.7,97446006,10-97445974-A-C,rs4919098,-1,A,C,97445974,32,97249398,97642614,196576
10,ENSG00000171311.7,97446006,10-97445974-A-G,rs4919098,-1,A,G,97445974,32,97249398,97642614,196576
10,ENSG00000171160.12,97633500,10-97669550-A-G,rs4919128,-1,A,G,97669550,36050,97436892,97830108,232658
10,ENSG00000171160.12,97633500,10-97669550-A-T,rs4919128,-1,A,T,97669550,36050,97436892,97830108,232658
10,ENSG00000165678.13,84139509,10-84221109-C-T,rs4933982,1,C,T,84221109,81600,83942901,84336117,278208
10,ENSG00000165678.13,84139509,10-84221109-C-A,rs4933982,1,C,A,84221109,81600,83942901,84336117,278208
10,ENSG00000148444.9,22316388,10-22230027-A-G,rs56186224,1,A,G,22230027,86361,22119780,22512996,110247
10,ENSG00000214655.5,73785606,10-73950272-G-A,rs56215513,1,G,A,73950272,164666,73588998,73982214,361274
10,ENSG00000107816.11,100999476,10-100837035-C-A,rs56367693,1,C,A,100837035,162441,100802868,101196084,34167
10,ENSG00000151632.11,5003857,10-4812307-T-C,rs57563616,-1,T,C,4812307,191550,4807249,5200465,5058
10,ENSG00000151632.11,5003857,10-4812307-T-G,rs57563616,-1,T,G,4812307,191550,4807249,5200465,5058
10,ENSG00000151632.11,5003857,10-4812307-T-A,rs57563616,-1,T,A,4812307,191550,4807249,5200465,5058
10,ENSG00000173267.9,86958599,10-86851786-G-A,rs58256798,1,G,A,86851786,106813,86761991,87155207,89795
10,ENSG00000108039.12,109923511,10-109870973-G-A,rs612155,-1,G,A,109870973,52538,109726903,110120119,144070
10,ENSG00000108039.12,109923511,10-109870973-G-C,rs612155,-1,G,C,109870973,52538,109726903,110120119,144070
10,ENSG00000148426.6,11823356,10-11819951-T-C,rs61846275,1,T,C,11819951,3405,11626748,12019964,193203
10,ENSG00000148426.6,11823356,10-11819951-T-A,rs61846275,1,T,A,11819951,3405,11626748,12019964,193203
10,ENSG00000171811.7,132942570,10-133030795-C-G,rs61861012,-1,C,G,133030795,88225,132745962,133139178,284833
10,ENSG00000152778.7,89414568,10-89356949-T-C,rs627127,1,T,C,89356949,57619,89217960,89611176,138989
10,ENSG00000152778.7,89414568,10-89356949-T-A,rs627127,1,T,A,89356949,57619,89217960,89611176,138989
10,ENSG00000108187.9,68332928,10-68175478-T-C,rs6480306,-1,T,C,68175478,157450,68136320,68529536,39158
10,ENSG00000108187.9,68332928,10-68175478-T-A,rs6480306,-1,T,A,68175478,157450,68136320,68529536,39158
10,ENSG00000138190.12,92848520,10-92907226-T-G,rs6583847,1,T,G,92907226,58706,92651912,93045128,255314
10,ENSG00000150593.11,110871928,10-111005922-G-A,rs6585028,1,G,A,111005922,133994,110675320,111068536,330602
10,ENSG00000150593.11,110871928,10-111005922-G-T,rs6585028,1,G,T,111005922,133994,110675320,111068536,330602
10,ENSG00000165512.4,45000923,10-45002467-C-T,rs7068660,1,C,T,45002467,1544,44804315,45197531,198152
10,ENSG00000165512.4,45000923,10-45002467-C-G,rs7068660,1,C,G,45002467,1544,44804315,45197531,198152
10,ENSG00000175029.11,125028071,10-124982872-T-A,rs7071558,-1,T,A,124982872,45199,124831463,125224679,151409
10,ENSG00000175029.11,125028071,10-124982872-T-C,rs7071558,-1,T,C,124982872,45199,124831463,125224679,151409
10,ENSG00000120549.10,24209138,10-24344856-T-C,rs7072844,1,T,C,24344856,135718,24012530,24405746,332326
10,ENSG00000198546.9,133308914,10-133348239-A-T,rs7075437,1,A,T,133348239,39325,133112306,133505522,235933
10,ENSG00000198546.9,133308914,10-133348239-A-G,rs7075437,1,A,G,133348239,39325,133112306,133505522,235933
10,ENSG00000198546.9,133308914,10-133348239-A-C,rs7075437,1,A,C,133348239,39325,133112306,133505522,235933
10,ENSG00000107862.4,102245532,10-102393028-T-A,rs7083038,1,T,A,102393028,147496,102048924,102442140,344104
10,ENSG00000107862.4,102245532,10-102393028-T-C,rs7083038,1,T,C,102393028,147496,102048924,102442140,344104
10,ENSG00000134461.9,5889893,10-5894148-G-A,rs7085189,-1,G,A,5894148,4255,5693285,6086501,200863
10,ENSG00000165832.4,114938195,10-115016126-G-T,rs7090904,1,G,T,115016126,77931,114741587,115134803,274539
10,ENSG00000197444.5,49762323,10-49777199-G-A,rs7091448,-1,G,A,49777199,14876,49565715,49958931,211484
10,ENSG00000197444.5,49762323,10-49777199-G-T,rs7091448,-1,G,T,49777199,14876,49565715,49958931,211484
10,ENSG00000165996.8,17617374,10-17628033-A-T,rs7094334,-1,A,T,17628033,10659,17420766,17813982,207267
10,ENSG00000165996.8,17617374,10-17628033-A-C,rs7094334,-1,A,C,17628033,10659,17420766,17813982,207267
10,ENSG00000107954.6,103493705,10-103566492-A-G,rs7094488,1,A,G,103566492,72787,103297097,103690313,269395
10,ENSG00000107815.3,100987543,10-100880492-T-G,rs7096225,1,T,G,100880492,107051,100790935,101184151,89557
10,ENSG00000107815.3,100987543,10-100880492-T-A,rs7096225,1,T,A,100880492,107051,100790935,101184151,89557
10,ENSG00000174721.9,91909486,10-91904887-T-C,rs7099658,-1,T,C,91904887,4599,91712878,92106094,192009
10,ENSG00000148429.7,11611650,10-11640397-C-T,rs7101132,-1,C,T,11640397,28747,11415042,11808258,225355
10,ENSG00000138134.7,88880245,10-88907836-A-C,rs717576,1,A,C,88907836,27591,88683637,89076853,224199
10,ENSG00000138134.7,88880245,10-88907836-A-G,rs717576,1,A,G,88907836,27591,88683637,89076853,224199
10,ENSG00000138134.7,88880245,10-88907836-A-T,rs717576,1,A,T,88907836,27591,88683637,89076853,224199
10,ENSG00000198879.6,7411034,10-7359472-C-T,rs72775555,-1,C,T,7359472,51562,7214426,7607642,145046
10,ENSG00000185875.8,25016612,10-25144865-T-C,rs72792064,1,T,C,25144865,128253,24820004,25213220,324861
10,ENSG00000043591.4,114043866,10-114035957-C-A,rs72823019,1,C,A,114035957,7909,113847258,114240474,188699
10,ENSG00000062650.11,86521792,10-86691113-C-T,rs72848117,-1,C,T,86691113,169321,86325184,86718400,365929
10,ENSG00000148824.12,133394157,10-133512952-C-A,rs74753222,1,C,A,133512952,118795,133197549,133590765,315403
10,ENSG00000138346.9,68471973,10-68472384-T-A,rs7478105,-1,T,A,68472384,411,68275365,68668581,197019
10,ENSG00000138346.9,68471973,10-68472384-T-C,rs7478105,-1,T,C,68472384,411,68275365,68668581,197019
10,ENSG00000156398.6,102714636,10-102604466-A-G,rs74854733,1,A,G,102604466,110170,102518028,102911244,86438
10,ENSG00000122952.11,56361259,10-56393630-G-C,rs76244763,-1,G,C,56393630,32371,56164651,56557867,228979
10,ENSG00000180817.6,70233429,10-70131796-T-C,rs76251505,-1,T,C,70131796,101633,70036821,70430037,94975
10,ENSG00000171314.6,97426191,10-97432178-G-A,rs764223,1,G,A,97432178,5987,97229583,97622799,202595
10,ENSG00000198018.6,99659509,10-99709597-T-C,rs76530337,1,T,C,99709597,50088,99462901,99856117,246696
10,ENSG00000119929.8,99732234,10-99709597-T-C,rs76530337,1,T,C,99709597,22637,99535626,99928842,173971
10,ENSG00000107438.4,95291003,10-95289181-G-C,rs76672094,-1,G,C,95289181,1822,95094395,95487611,194786
10,ENSG00000107438.4,95291003,10-95289181-G-A,rs76672094,-1,G,A,95289181,1822,95094395,95487611,194786
10,ENSG00000203805.6,120457227,10-120292393-G-A,rs77437002,1,G,A,120292393,164834,120260619,120653835,31774
10,ENSG00000060339.8,68721239,10-68782821-T-C,rs78811806,1,T,C,68782821,61582,68524631,68917847,258190
10,ENSG00000107829.8,101695170,10-101551678-C-T,rs7897749,-1,C,T,101551678,143492,101498562,101891778,53116
10,ENSG00000165733.6,42782795,10-42793157-C-T,rs7898007,1,C,T,42793157,10362,42586187,42979403,206970
10,ENSG00000107959.9,3172782,10-3142315-A-C,rs7898695,-1,A,C,3142315,30467,2976174,3369390,166141
10,ENSG00000107959.9,3172782,10-3142315-A-G,rs7898695,-1,A,G,3142315,30467,2976174,3369390,166141
10,ENSG00000150867.7,22714578,10-22828287-C-A,rs7902635,-1,C,A,22828287,113709,22517970,22911186,310317
10,ENSG00000012779.5,45374216,10-45222769-T-C,rs7921486,1,T,C,45222769,151447,45177608,45570824,45161
10,ENSG00000165752.11,132307950,10-132328817-C-T,rs7922627,-1,C,T,132328817,20867,132111342,132504558,217475
10,ENSG00000134463.10,11742382,10-11728172-G-T,rs7923065,1,G,T,11728172,14210,11545774,11938990,182398
10,ENSG00000156042.11,73358770,10-73489853-C-T,rs7923276,-1,C,T,73489853,131083,73162162,73555378,327691
10,ENSG00000156042.11,73358770,10-73489853-C-A,rs7923276,-1,C,A,73489853,131083,73162162,73555378,327691
10,ENSG00000138175.7,102714397,10-102658899-C-G,rs7923415,-1,C,G,102658899,55498,102517789,102911005,141110
10,ENSG00000138175.7,102714397,10-102658899-C-T,rs7923415,-1,C,T,102658899,55498,102517789,102911005,141110
10,ENSG00000107537.9,13300064,10-13271567-T-C,rs825631,-1,T,C,13271567,28497,13103456,13496672,168111
10,ENSG00000107537.9,13300064,10-13271567-T-A,rs825631,-1,T,A,13271567,28497,13103456,13496672,168111
10,ENSG00000151532.9,112447215,10-112411841-T-C,rs876873,1,T,C,112411841,35374,112250607,112643823,161234
10,ENSG00000107738.12,71773520,10-71762937-T-C,rs9415039,-1,T,C,71762937,10583,71576912,71970128,186025
10,ENSG00000179988.8,122980401,10-122956576-G-A,rs9423292,1,G,A,122956576,23825,122783793,123177009,172783
10,ENSG00000151224.7,80289658,10-80445650-A-G,rs9663342,-1,A,G,80445650,155992,80093050,80486266,352600
10,ENSG00000151224.7,80289658,10-80445650-A-T,rs9663342,-1,A,T,80445650,155992,80093050,80486266,352600
10,ENSG00000176986.10,73744372,10-73650209-T-C,rs9664184,1,T,C,73650209,94163,73547764,73940980,102445
10,ENSG00000156521.9,70146700,10-70156705-G-A,rs9971029,-1,G,A,70156705,10005,69950092,70343308,206613
10,ENSG00000156521.9,70146700,10-70156705-G-C,rs9971029,-1,G,C,70156705,10005,69950092,70343308,206613
10,ENSG00000156521.9,70146700,10-70156705-G-T,rs9971029,-1,G,T,70156705,10005,69950092,70343308,206613
10,ENSG00000189319.9,124744378,10-124658034-C-A,rs1006368,-1,C,A,124658034,86344,124547770,124940986,110264
10,ENSG00000189319.9,124744378,10-124658034-C-T,rs1006368,-1,C,T,124658034,86344,124547770,124940986,110264
10,ENSG00000181915.3,62804720,10-62852129-A-G,rs10509173,1,A,G,62852129,47409,62608112,63001328,244017
10,ENSG00000181915.3,62804720,10-62852129-A-C,rs10509173,1,A,C,62852129,47409,62608112,63001328,244017
10,ENSG00000181915.3,62804720,10-62852129-A-T,rs10509173,1,A,T,62852129,47409,62608112,63001328,244017
10,ENSG00000152778.7,89414568,10-89315502-A-T,rs10749605,1,A,T,89315502,99066,89217960,89611176,97542
10,ENSG00000152778.7,89414568,10-89315502-A-G,rs10749605,1,A,G,89315502,99066,89217960,89611176,97542
10,ENSG00000107719.7,70478767,10-70493069-C-T,rs10762385,1,C,T,70493069,14302,70282159,70675375,210910
10,ENSG00000138160.4,92593130,10-92436063-G-A,rs10786046,1,G,A,92436063,157067,92396522,92789738,39541
10,ENSG00000138160.4,92593130,10-92436063-G-T,rs10786046,1,G,T,92436063,157067,92396522,92789738,39541
10,ENSG00000198682.7,87659878,10-87663488-A-G,rs10788561,1,A,G,87663488,3610,87463270,87856486,200218
10,ENSG00000198682.7,87659878,10-87663488-A-C,rs10788561,1,A,C,87663488,3610,87463270,87856486,200218
10,ENSG00000198682.7,87659878,10-87663488-A-T,rs10788561,1,A,T,87663488,3610,87463270,87856486,200218
10,ENSG00000196793.8,43574616,10-43592223-T-A,rs10793446,-1,T,A,43592223,17607,43378008,43771224,214215
10,ENSG00000196793.8,43574616,10-43592223-T-C,rs10793446,-1,T,C,43592223,17607,43378008,43771224,214215
10,ENSG00000204147.5,50739936,10-50856463-C-T,rs10821887,1,C,T,50856463,116527,50543328,50936544,313135
10,ENSG00000150275.12,54801231,10-54681127-C-T,rs10825373,-1,C,T,54681127,120104,54604623,54997839,76504
10,ENSG00000185875.8,25016612,10-24918474-A-T,rs10828724,1,A,T,24918474,98138,24820004,25213220,98470
10,ENSG00000185875.8,25016612,10-24918474-A-C,rs10828724,1,A,C,24918474,98138,24820004,25213220,98470
10,ENSG00000165997.4,18659431,10-18639126-C-G,rs10829058,1,C,G,18639126,20305,18462823,18856039,176303
10,ENSG00000165997.4,18659431,10-18639126-C-A,rs10829058,1,C,A,18639126,20305,18462823,18856039,176303
10,ENSG00000152804.6,92689955,10-92702670-T-C,rs10882101,1,T,C,92702670,12715,92493347,92886563,209323
10,ENSG00000152804.6,92689955,10-92702670-T-A,rs10882101,1,T,A,92702670,12715,92493347,92886563,209323
10,ENSG00000138185.11,95756163,10-95896530-C-T,rs10882684,1,C,T,95896530,140367,95559555,95952771,336975
10,ENSG00000171206.7,102644479,10-102640355-T-C,rs10883756,1,T,C,102640355,4124,102447871,102841087,192484
10,ENSG00000171206.7,102644479,10-102640355-T-A,rs10883756,1,T,A,102640355,4124,102447871,102841087,192484
10,ENSG00000065621.8,104269184,10-104110374-A-G,rs10883967,1,A,G,104110374,158810,104072576,104465792,37798
10,ENSG00000198298.8,43606438,10-43616358-G-A,rs10899839,1,G,A,43616358,9920,43409830,43803046,206528
10,ENSG00000107551.13,44959802,10-44958502-T-C,rs10900143,1,T,C,44958502,1300,44763194,45156410,195308
10,ENSG00000107949.11,125823546,10-125756081-C-T,rs10901423,1,C,T,125756081,67465,125626938,126020154,129143
10,ENSG00000148377.5,1025859,10-941673-G-T,rs10904587,-1,G,T,941673,84186,829251,1222467,112422
10,ENSG00000196372.7,5666595,10-5646122-C-T,rs10905791,-1,C,T,5646122,20473,5469987,5863203,176135
10,ENSG00000065809.8,14774897,10-14647836-C-T,rs10906729,-1,C,T,14647836,127061,14578289,14971505,69547
10,ENSG00000165730.10,68827531,10-68665216-A-G,rs10998374,1,A,G,68665216,162315,68630923,69024139,34293
10,ENSG00000099282.4,69451465,10-69388403-C-T,rs10998754,1,C,T,69388403,63062,69254857,69648073,133546
10,ENSG00000099284.7,70052846,10-69950717-G-A,rs10999050,1,G,A,69950717,102129,69856238,70249454,94479
10,ENSG00000042286.9,70132825,10-70027397-A-G,rs10999089,-1,A,G,70027397,105428,69936217,70329433,91180
10,ENSG00000183621.9,31031937,10-30985448-C-G,rs11008322,-1,C,G,30985448,46489,30835329,31228545,150119
10,ENSG00000078403.11,21534232,10-21473338-A-G,rs11012716,1,A,G,21473338,60894,21337624,21730840,135714
10,ENSG00000077420.9,26438341,10-26461103-C-T,rs11015121,1,C,T,26461103,22762,26241733,26634949,219370
10,ENSG00000108010.7,130136391,10-130198668-G-T,rs11017131,1,G,T,130198668,62277,129939783,130332999,258885
10,ENSG00000108010.7,130136391,10-130198668-G-A,rs11017131,1,G,A,130198668,62277,129939783,130332999,258885
10,ENSG00000119965.8,122954227,10-122953445-A-G,rs1106056,-1,A,G,122953445,782,122757619,123150835,195826
10,ENSG00000171314.6,97426191,10-97375458-T-A,rs11189172,1,T,A,97375458,50733,97229583,97622799,145875
10,ENSG00000171314.6,97426191,10-97375458-T-C,rs11189172,1,T,C,97375458,50733,97229583,97622799,145875
10,ENSG00000107882.7,102503972,10-102461782-A-G,rs11191293,1,A,G,102461782,42190,102307364,102700580,154418
10,ENSG00000107882.7,102503972,10-102461782-A-C,rs11191293,1,A,C,102461782,42190,102307364,102700580,154418
10,ENSG00000138107.6,102502712,10-102511335-C-A,rs11191310,-1,C,A,102511335,8623,102306104,102699320,205231
10,ENSG00000185933.6,103458900,10-103628528-C-T,rs11191750,-1,C,T,103628528,169628,103262292,103655508,366236
10,ENSG00000203867.6,110644336,10-110763335-G-A,rs11195312,1,G,A,110763335,118999,110447728,110840944,315607
10,ENSG00000203867.6,110644336,10-110763335-G-C,rs11195312,1,G,C,110763335,118999,110447728,110840944,315607
10,ENSG00000188690.7,125823258,10-125986561-A-T,rs11244752,-1,A,T,125986561,163303,125626650,126019866,359911
10,ENSG00000188690.7,125823258,10-125986561-A-G,rs11244752,-1,A,G,125986561,163303,125626650,126019866,359911
10,ENSG00000148848.9,126388477,10-126310257-C-T,rs11244948,-1,C,T,126310257,78220,126191869,126585085,118388
10,ENSG00000107902.9,124461823,10-124469341-A-C,rs11245061,1,A,C,124469341,7518,124265215,124658431,204126
10,ENSG00000107902.9,124461823,10-124469341-A-G,rs11245061,1,A,G,124469341,7518,124265215,124658431,204126
10,ENSG00000057608.10,5813434,10-5708115-G-A,rs11254266,-1,G,A,5708115,105319,5616826,6010042,91289
10,ENSG00000057608.10,5813434,10-5708115-G-C,rs11254266,-1,G,C,5708115,105319,5616826,6010042,91289
10,ENSG00000057608.10,5813434,10-5708115-G-T,rs11254266,-1,G,T,5708115,105319,5616826,6010042,91289
10,ENSG00000183049.8,12349547,10-12381108-G-A,rs11257754,1,G,A,12381108,31561,12152939,12546155,228169
10,ENSG00000154473.11,123154402,10-123119667-C-T,rs11594133,1,C,T,123119667,34735,122957794,123351010,161873
10,ENSG00000166167.12,101354165,10-101303323-G-T,rs11597176,1,G,T,101303323,50842,101157557,101550773,145766
10,ENSG00000156113.13,77637808,10-77633696-G-A,rs11598241,-1,G,A,77633696,4112,77441200,77834416,192496
10,ENSG00000216937.5,32451643,10-32326517-A-G,rs11599044,1,A,G,32326517,125126,32255035,32648251,71482
10,ENSG00000165449.7,59709850,10-59701217-T-C,rs1171627,-1,T,C,59701217,8633,59513242,59906458,187975
10,ENSG00000165449.7,59709850,10-59701217-T-A,rs1171627,-1,T,A,59701217,8633,59513242,59906458,187975
10,ENSG00000151651.11,133276868,10-133178230-A-G,rs117587114,-1,A,G,133178230,98638,133080260,133473476,97970
10,ENSG00000108091.10,59906556,10-59864939-A-G,rs1177701,-1,A,G,59864939,41617,59709948,60103164,154991
10,ENSG00000185267.5,14838037,10-14859699-C-T,rs12098756,-1,C,T,14859699,21662,14641429,15034645,218270
10,ENSG00000170525.12,6202932,10-6179333-C-T,rs12217915,1,C,T,6179333,23599,6006324,6399540,173009
10,ENSG00000165669.7,118342324,10-118517923-T-C,rs12249078,-1,T,C,118517923,175599,118145716,118538932,372207
10,ENSG00000204161.7,49188391,10-49210904-A-C,rs12249370,-1,A,C,49210904,22513,48991783,49384999,219121
10,ENSG00000204161.7,49188391,10-49210904-A-T,rs12249370,-1,A,T,49210904,22513,48991783,49384999,219121
10,ENSG00000204161.7,49188391,10-49210904-A-G,rs12249370,-1,A,G,49210904,22513,48991783,49384999,219121
10,ENSG00000148735.10,113751310,10-113731434-G-A,rs12249629,1,G,A,113731434,19876,113554702,113947918,176732
10,ENSG00000172538.6,49134021,10-49207276-T-C,rs12253910,-1,T,C,49207276,73255,48937413,49330629,269863
10,ENSG00000165633.6,49115522,10-49110439-G-A,rs12255055,-1,G,A,49110439,5083,48918914,49312130,191525
10,ENSG00000165406.9,45535371,10-45519223-T-C,rs12257537,-1,T,C,45519223,16148,45338763,45731979,180460
10,ENSG00000067057.10,3067548,10-3117935-C-A,rs12257705,1,C,A,3117935,50387,2870940,3264156,246995
10,ENSG00000067057.10,3067548,10-3117935-C-T,rs12257705,1,C,T,3117935,50387,2870940,3264156,246995
10,ENSG00000177613.7,51699595,10-51581982-C-T,rs12265406,-1,C,T,51581982,117613,51502987,51896203,78995
10,ENSG00000197746.7,71851251,10-71678587-A-C,rs1227041,-1,A,C,71678587,172664,71654643,72047859,23944
10,ENSG00000197746.7,71851251,10-71678587-A-T,rs1227041,-1,A,T,71678587,172664,71654643,72047859,23944
10,ENSG00000197746.7,71851251,10-71678587-A-G,rs1227041,-1,A,G,71678587,172664,71654643,72047859,23944
10,ENSG00000171811.7,132942570,10-132834775-C-G,rs12356978,-1,C,G,132834775,107795,132745962,133139178,88813
10,ENSG00000171811.7,132942570,10-132834775-C-A,rs12356978,-1,C,A,132834775,107795,132745962,133139178,88813
10,ENSG00000171811.7,132942570,10-132834775-C-T,rs12356978,-1,C,T,132834775,107795,132745962,133139178,88813
10,ENSG00000165630.8,13586965,10-13568867-A-G,rs12358543,1,A,G,13568867,18098,13390357,13783573,178510
10,ENSG00000095637.13,95561371,10-95605406-G-A,rs12359272,-1,G,A,95605406,44035,95364763,95757979,240643
10,ENSG00000138303.11,72216276,10-72089773-T-G,rs1245542,-1,T,G,72089773,126503,72019668,72412884,70105
10,ENSG00000107742.7,72088551,10-72077662-A-C,rs1245560,-1,A,C,72077662,10889,71891943,72285159,185719
10,ENSG00000150593.11,110871928,10-110810372-G-A,rs12572941,1,G,A,110810372,61556,110675320,111068536,135052
10,ENSG00000150593.11,110871928,10-110810372-G-C,rs12572941,1,G,C,110810372,61556,110675320,111068536,135052
10,ENSG00000122882.5,73168008,10-73004316-G-A,rs12573768,-1,G,A,73004316,163692,72971400,73364616,32916
10,ENSG00000138336.7,68560337,10-68620741-C-A,rs12764361,1,C,A,68620741,60404,68363729,68756945,257012
10,ENSG00000197889.4,14959388,10-14932906-T-C,rs12768894,1,T,C,14932906,26482,14762780,15155996,170126
10,ENSG00000178217.8,80537902,10-80623686-A-T,rs12772279,1,A,T,80623686,85784,80341294,80734510,282392
10,ENSG00000178217.8,80537902,10-80623686-A-G,rs12772279,1,A,G,80623686,85784,80341294,80734510,282392
10,ENSG00000180628.10,91220663,10-91231750-G-A,rs12774904,1,G,A,91231750,11087,91024055,91417271,207695
10,ENSG00000166275.10,102854259,10-102725544-G-A,rs12775883,1,G,A,102725544,128715,102657651,103050867,67893
10,ENSG00000204020.4,88760020,10-88602079-C-T,rs12777350,1,C,T,88602079,157941,88563412,88956628,38667
10,ENSG00000151640.7,132186948,10-132142397-G-C,rs12778246,1,G,C,132142397,44551,131990340,132383556,152057
10,ENSG00000151640.7,132186948,10-132142397-G-A,rs12778246,1,G,A,132142397,44551,131990340,132383556,152057
10,ENSG00000182010.6,62268844,10-62182200-A-G,rs12783236,-1,A,G,62182200,86644,62072236,62465452,109964
10,ENSG00000170312.10,60778478,10-60675564-A-G,rs12784166,1,A,G,60675564,102914,60581870,60975086,93694
10,ENSG00000165983.9,16437010,10-16511719-G-T,rs1331255,1,G,T,16511719,74709,16240402,16633618,271317
10,ENSG00000165983.9,16437010,10-16511719-G-A,rs1331255,1,G,A,16511719,74709,16240402,16633618,271317
10,ENSG00000198018.6,99659509,10-99618763-A-C,rs1332104,1,A,C,99618763,40746,99462901,99856117,155862
10,ENSG00000107566.8,100186029,10-100295066-G-A,rs147426900,-1,G,A,100295066,109037,99989421,100382637,305645
10,ENSG00000048740.10,11017872,10-10894648-C-A,rs1570438,1,C,A,10894648,123224,10821264,11214480,73384
10,ENSG00000048740.10,11017872,10-10894648-C-T,rs1570438,1,C,T,10894648,123224,10821264,11214480,73384
10,ENSG00000048740.10,11017872,10-10894648-C-G,rs1570438,1,C,G,10894648,123224,10821264,11214480,73384
10,ENSG00000095739.6,28677521,10-28836990-G-T,rs1691907,1,G,T,28836990,159469,28480913,28874129,356077
10,ENSG00000095739.6,28677521,10-28836990-G-A,rs1691907,1,G,A,28836990,159469,28480913,28874129,356077
10,ENSG00000182180.9,73252644,10-73126162-T-C,rs16930350,-1,T,C,73126162,126482,73056036,73449252,70126
10,ENSG00000182180.9,73252644,10-73126162-T-A,rs16930350,-1,T,A,73126162,126482,73056036,73449252,70126
10,ENSG00000197444.5,49762323,10-49830501-C-T,rs17010387,-1,C,T,49830501,68178,49565715,49958931,264786
10,ENSG00000107643.10,48306677,10-48470355-C-T,rs17010496,1,C,T,48470355,163678,48110069,48503285,360286
10,ENSG00000107643.10,48306677,10-48470355-C-G,rs17010496,1,C,G,48470355,163678,48110069,48503285,360286
10,ENSG00000169826.6,43138445,10-43128364-C-T,rs17028,1,C,T,43128364,10081,42941837,43335053,186527
10,ENSG00000014919.7,99732127,10-99754462-G-A,rs17112219,-1,G,A,99754462,22335,99535519,99928735,218943
10,ENSG00000138134.7,88880245,10-88920467-G-C,rs17114161,1,G,C,88920467,40222,88683637,89076853,236830
10,ENSG00000148484.12,16817424,10-16677036-A-G,rs17139010,-1,A,G,16677036,140388,16620816,17014032,56220
10,ENSG00000148484.12,16817424,10-16677036-A-T,rs17139010,-1,A,T,16677036,140388,16620816,17014032,56220
10,ENSG00000148484.12,16817424,10-16677036-A-C,rs17139010,-1,A,C,16677036,140388,16620816,17014032,56220
10,ENSG00000165733.6,42782795,10-42800892-T-G,rs17158193,1,T,G,42800892,18097,42586187,42979403,214705
10,ENSG00000119929.8,99732234,10-99844350-C-T,rs17216317,1,C,T,99844350,112116,99535626,99928842,308724
10,ENSG00000148468.11,15371289,10-15334858-T-C,rs17293523,-1,T,C,15334858,36431,15174681,15567897,160177
10,ENSG00000107937.13,988434,10-1010312-C-T,rs17293608,1,C,T,1010312,21878,791826,1185042,218486
10,ENSG00000107937.13,988434,10-1010312-C-A,rs17293608,1,C,A,1010312,21878,791826,1185042,218486
10,ENSG00000095794.14,35126846,10-35246669-A-G,rs17500653,1,A,G,35246669,119823,34930238,35323454,316431
10,ENSG00000075407.11,38094337,10-38082971-T-A,rs176838,1,T,A,38082971,11366,37897729,38290945,185242
10,ENSG00000165646.7,117241114,10-117397974-A-C,rs1772810,1,A,C,117397974,156860,117044506,117437722,353468
10,ENSG00000138166.4,110497907,10-110355908-A-G,rs1774644,1,A,G,110355908,141999,110301299,110694515,54609
10,ENSG00000138166.4,110497907,10-110355908-A-T,rs1774644,1,A,T,110355908,141999,110301299,110694515,54609
10,ENSG00000107796.7,88952773,10-89028200-T-C,rs1926202,-1,T,C,89028200,75427,88756165,89149381,272035
10,ENSG00000107796.7,88952773,10-89028200-T-A,rs1926202,-1,T,A,89028200,75427,88756165,89149381,272035
10,ENSG00000107796.7,88952773,10-89028200-T-G,rs1926202,-1,T,G,89028200,75427,88756165,89149381,272035
10,ENSG00000123243.10,7666966,10-7613389-G-A,rs1931901,-1,G,A,7613389,53577,7470358,7863574,143031
10,ENSG00000107872.8,102420836,10-102538034-T-C,rs2031604,1,T,C,102538034,117198,102224228,102617444,313806
10,ENSG00000107872.8,102420836,10-102538034-T-A,rs2031604,1,T,A,102538034,117198,102224228,102617444,313806
10,ENSG00000128805.9,48605073,10-48565250-C-T,rs2120905,-1,C,T,48565250,39823,48408465,48801681,156785
10,ENSG00000128805.9,48605073,10-48565250-C-A,rs2120905,-1,C,A,48565250,39823,48408465,48801681,156785
10,ENSG00000128805.9,48605073,10-48565250-C-G,rs2120905,-1,C,G,48565250,39823,48408465,48801681,156785
10,ENSG00000172650.7,73698109,10-73584940-A-G,rs2140935,-1,A,G,73584940,113169,73501501,73894717,83439
10,ENSG00000165996.8,17617374,10-17563118-A-T,rs2186113,-1,A,T,17563118,54256,17420766,17813982,142352
10,ENSG00000165996.8,17617374,10-17563118-A-C,rs2186113,-1,A,C,17563118,54256,17420766,17813982,142352
10,ENSG00000165996.8,17617374,10-17563118-A-G,rs2186113,-1,A,G,17563118,54256,17420766,17813982,142352
10,ENSG00000241058.1,18651587,10-18539442-C-T,rs2228645,-1,C,T,18539442,112145,18454979,18848195,84463
10,ENSG00000241058.1,18651587,10-18539442-C-G,rs2228645,-1,C,G,18539442,112145,18454979,18848195,84463
10,ENSG00000241058.1,18651587,10-18539442-C-A,rs2228645,-1,C,A,18539442,112145,18454979,18848195,84463
10,ENSG00000148483.7,17752201,10-17642399-C-G,rs2251596,1,C,G,17642399,109802,17555593,17948809,86806
10,ENSG00000148483.7,17752201,10-17642399-C-T,rs2251596,1,C,T,17642399,109802,17555593,17948809,86806
10,ENSG00000119977.13,95693927,10-95864952-A-C,rs2275759,-1,A,C,95864952,171025,95497319,95890535,367633
10,ENSG00000107959.9,3172782,10-3138759-G-A,rs2279216,-1,G,A,3138759,34023,2976174,3369390,162585
10,ENSG00000107959.9,3172782,10-3138759-G-T,rs2279216,-1,G,T,3138759,34023,2976174,3369390,162585
10,ENSG00000185009.8,74150828,10-74107435-G-T,rs2279648,-1,G,T,74107435,43393,73954220,74347436,153215
10,ENSG00000148803.7,133358019,10-133328068-G-T,rs2298122,-1,G,T,133328068,29951,133161411,133554627,166657
10,ENSG00000196177.7,123009006,10-123036699-A-T,rs2421139,1,A,T,123036699,27693,122812398,123205614,224301
10,ENSG00000196177.7,123009006,10-123036699-A-G,rs2421139,1,A,G,123036699,27693,122812398,123205614,224301
10,ENSG00000136754.12,26860958,10-26933028-G-C,rs2477935,-1,G,C,26933028,72070,26664350,27057566,268678
10,ENSG00000108039.12,109923511,10-110090745-A-T,rs2501574,-1,A,T,110090745,167234,109726903,110120119,363842
10,ENSG00000108039.12,109923511,10-110090745-A-G,rs2501574,-1,A,G,110090745,167234,109726903,110120119,363842
10,ENSG00000108039.12,109923511,10-110090745-A-C,rs2501574,-1,A,C,110090745,167234,109726903,110120119,363842
10,ENSG00000187908.9,122560754,10-122501897-T-C,rs2672609,1,T,C,122501897,58857,122364146,122757362,137751
10,ENSG00000187908.9,122560754,10-122501897-T-A,rs2672609,1,T,A,122501897,58857,122364146,122757362,137751
10,ENSG00000187908.9,122560754,10-122501897-T-G,rs2672609,1,T,G,122501897,58857,122364146,122757362,137751
10,ENSG00000138347.10,68109488,10-68149756-C-T,rs2673801,1,C,T,68149756,40268,67912880,68306096,236876
10,ENSG00000196968.4,73772276,10-73935966-T-A,rs2688624,1,T,A,73935966,163690,73575668,73968884,360298
10,ENSG00000196968.4,73772276,10-73935966-T-G,rs2688624,1,T,G,73935966,163690,73575668,73968884,360298
10,ENSG00000196968.4,73772276,10-73935966-T-C,rs2688624,1,T,C,73935966,163690,73575668,73968884,360298
10,ENSG00000107679.9,122374708,10-122479467-G-A,rs2736917,1,G,A,122479467,104759,122178100,122571316,301367
10,ENSG00000107679.9,122374708,10-122479467-G-C,rs2736917,1,G,C,122479467,104759,122178100,122571316,301367
10,ENSG00000165322.12,31928831,10-31764890-T-A,rs2778668,-1,T,A,31764890,163941,31732223,32125439,32667
10,ENSG00000165322.12,31928831,10-31764890-T-C,rs2778668,-1,T,C,31764890,163941,31732223,32125439,32667
10,ENSG00000165322.12,31928831,10-31764890-T-G,rs2778668,-1,T,G,31764890,163941,31732223,32125439,32667
10,ENSG00000181274.5,97334729,10-97153239-A-C,rs2784921,-1,A,C,97153239,181490,97138121,97531337,15118
10,ENSG00000181274.5,97334729,10-97153239-A-G,rs2784921,-1,A,G,97153239,181490,97138121,97531337,15118
10,ENSG00000181274.5,97334729,10-97153239-A-T,rs2784921,-1,A,T,97153239,181490,97138121,97531337,15118
10,ENSG00000148814.13,132332193,10-132258344-A-G,rs2814191,1,A,G,132258344,73849,132135585,132528801,122759
10,ENSG00000107537.9,13300064,10-13298236-G-A,rs28938169,-1,G,A,13298236,1828,13103456,13496672,194780
10,ENSG00000165731.11,43077069,10-42988715-T-C,rs3004258,1,T,C,42988715,88354,42880461,43273677,108254
10,ENSG00000165731.11,43077069,10-42988715-T-A,rs3004258,1,T,A,42988715,88354,42880461,43273677,108254
10,ENSG00000165731.11,43077069,10-42988715-T-G,rs3004258,1,T,G,42988715,88354,42880461,43273677,108254
10,ENSG00000134461.9,5889893,10-5966191-C-T,rs3181147,-1,C,T,5966191,76298,5693285,6086501,272906
10,ENSG00000166197.11,102152389,10-102082966-C-T,rs34848795,1,C,T,102082966,69423,101955781,102348997,127185
10,ENSG00000122912.9,68527523,10-68345421-C-T,rs3781567,-1,C,T,68345421,182102,68330915,68724131,14506
10,ENSG00000122912.9,68527523,10-68345421-C-G,rs3781567,-1,C,G,68345421,182102,68330915,68724131,14506
10,ENSG00000107929.9,931705,10-998839-G-T,rs3793776,-1,G,T,998839,67134,735097,1128313,263742
10,ENSG00000122859.4,69573422,10-69486879-G-A,rs3793837,-1,G,A,69486879,86543,69376814,69770030,110065
10,ENSG00000148908.10,119542719,10-119538339-C-T,rs3808954,-1,C,T,119538339,4380,119346111,119739327,192228
10,ENSG00000148908.10,119542719,10-119538339-C-A,rs3808954,-1,C,A,119538339,4380,119346111,119739327,192228
10,ENSG00000165476.6,63521401,10-63640091-T-C,rs3858120,1,T,C,63640091,118690,63324793,63718009,315298
10,ENSG00000165476.6,63521401,10-63640091-T-A,rs3858120,1,T,A,63640091,118690,63324793,63718009,315298
10,ENSG00000148824.12,133394157,10-133402574-C-G,rs41283343,1,C,G,133402574,8417,133197549,133590765,205025
10,ENSG00000138131.3,98268194,10-98247937-G-A,rs41307056,-1,G,A,98247937,20257,98071586,98464802,176351
10,ENSG00000138279.10,73414058,10-73571695-A-G,rs41313834,-1,A,G,73571695,157637,73217450,73610666,354245
10,ENSG00000198246.7,71319259,10-71373197-C-G,rs41380348,1,C,G,71373197,53938,71122651,71515867,250546
10,ENSG00000122863.5,71964395,10-71979503-C-T,rs4148927,1,C,T,71979503,15108,71767787,72161003,211716
10,ENSG00000148600.10,84194537,10-84213509-G-T,rs4244946,1,G,T,84213509,18972,83997929,84391145,215580
10,ENSG00000148600.10,84194537,10-84213509-G-A,rs4244946,1,G,A,84213509,18972,83997929,84391145,215580
10,ENSG00000065154.7,124418923,10-124235125-T-G,rs4282943,-1,T,G,124235125,183798,124222315,124615531,12810
10,ENSG00000120053.8,99430624,10-99424523-T-C,rs4328160,-1,T,C,99424523,6101,99234016,99627232,190507
10,ENSG00000151532.9,112447215,10-112400002-C-T,rs4333963,1,C,T,112400002,47213,112250607,112643823,149395
10,ENSG00000062650.11,86521792,10-86345937-A-G,rs4445560,-1,A,G,86345937,175855,86325184,86718400,20753
10,ENSG00000119986.6,97687241,10-97874784-T-C,rs4919153,-1,T,C,97874784,187543,97490633,97883849,384151
10,ENSG00000119986.6,97687241,10-97874784-T-A,rs4919153,-1,T,A,97874784,187543,97490633,97883849,384151
10,ENSG00000227345.3,49942027,10-50019987-T-G,rs4935050,-1,T,G,50019987,77960,49745419,50138635,274568
10,ENSG00000179988.8,122980401,10-123106481-G-T,rs4980177,1,G,T,123106481,126080,122783793,123177009,322688
10,ENSG00000179988.8,122980401,10-123106481-G-A,rs4980177,1,G,A,123106481,126080,122783793,123177009,322688
10,ENSG00000107438.4,95291003,10-95300425-C-A,rs56119156,-1,C,A,95300425,9422,95094395,95487611,206030
10,ENSG00000107438.4,95291003,10-95300425-C-T,rs56119156,-1,C,T,95300425,9422,95094395,95487611,206030
10,ENSG00000151208.10,77926755,10-78087531-G-A,rs56808049,-1,G,A,78087531,160776,77730147,78123363,357384
10,ENSG00000148426.6,11823356,10-11825464-A-G,rs61846304,1,A,G,11825464,2108,11626748,12019964,198716
10,ENSG00000122952.11,56361259,10-56223605-A-C,rs61852436,-1,A,C,56223605,137654,56164651,56557867,58954
10,ENSG00000122852.9,79610939,10-79459754-C-T,rs61862467,1,C,T,79459754,151185,79414331,79807547,45423
10,ENSG00000138180.10,93496612,10-93650241-A-G,rs6583901,1,A,G,93650241,153629,93300004,93693220,350237
10,ENSG00000067082.9,3785209,10-3875410-A-G,rs6601773,-1,A,G,3875410,90201,3588601,3981817,286809
10,ENSG00000067082.9,3785209,10-3875410-A-T,rs6601773,-1,A,T,3875410,90201,3588601,3981817,286809
10,ENSG00000067082.9,3785209,10-3875410-A-C,rs6601773,-1,A,C,3875410,90201,3588601,3981817,286809
10,ENSG00000148634.10,68075283,10-67969257-T-A,rs669794,-1,T,A,67969257,106026,67878675,68271891,90582
10,ENSG00000148634.10,68075283,10-67969257-T-C,rs669794,-1,T,C,67969257,106026,67878675,68271891,90582
10,ENSG00000095564.8,91923770,10-92111309-G-T,rs701846,1,G,T,92111309,187539,91727162,92120378,384147
10,ENSG00000095564.8,91923770,10-92111309-G-C,rs701846,1,G,C,92111309,187539,91727162,92120378,384147
10,ENSG00000095564.8,91923770,10-92111309-G-A,rs701846,1,G,A,92111309,187539,91727162,92120378,384147
10,ENSG00000134460.9,6062367,10-6044422-C-T,rs706781,-1,C,T,6044422,17945,5865759,6258975,178663
10,ENSG00000107651.8,119892730,10-119946269-C-A,rs7071594,1,C,A,119946269,53539,119696122,120089338,250147
10,ENSG00000107651.8,119892730,10-119946269-C-T,rs7071594,1,C,T,119946269,53539,119696122,120089338,250147
10,ENSG00000107651.8,119892730,10-119946269-C-G,rs7071594,1,C,G,119946269,53539,119696122,120089338,250147
10,ENSG00000107854.5,91798426,10-91812630-T-C,rs7076618,1,T,C,91812630,14204,91601818,91995034,210812
10,ENSG00000165752.11,132307950,10-132369417-G-A,rs7079070,-1,G,A,132369417,61467,132111342,132504558,258075
10,ENSG00000180817.6,70233429,10-70134046-T-A,rs7080119,-1,T,A,70134046,99383,70036821,70430037,97225
10,ENSG00000150054.12,28303064,10-28212416-T-C,rs7081651,-1,T,C,28212416,90648,28106456,28499672,105960
10,ENSG00000150054.12,28303064,10-28212416-T-A,rs7081651,-1,T,A,28212416,90648,28106456,28499672,105960
10,ENSG00000175029.11,125028071,10-124902202-T-C,rs7083336,-1,T,C,124902202,125869,124831463,125224679,70739
10,ENSG00000175029.11,125028071,10-124902202-T-A,rs7083336,-1,T,A,124902202,125869,124831463,125224679,70739
10,ENSG00000156398.6,102714636,10-102799509-G-A,rs7088711,1,G,A,102799509,84873,102518028,102911244,281481
10,ENSG00000107736.13,71396920,10-71449137-A-G,rs7099452,1,A,G,71449137,52217,71200312,71593528,248825
10,ENSG00000107736.13,71396920,10-71449137-A-C,rs7099452,1,A,C,71449137,52217,71200312,71593528,248825
10,ENSG00000107954.6,103493705,10-103642807-C-A,rs7100298,1,C,A,103642807,149102,103297097,103690313,345710
10,ENSG00000107954.6,103493705,10-103642807-C-T,rs7100298,1,C,T,103642807,149102,103297097,103690313,345710
10,ENSG00000120594.9,19816432,10-19978776-C-T,rs716829,1,C,T,19978776,162344,19619824,20013040,358952
10,ENSG00000120594.9,19816432,10-19978776-C-A,rs716829,1,C,A,19978776,162344,19619824,20013040,358952
10,ENSG00000148450.8,23095579,10-23080492-C-T,rs722258,1,C,T,23080492,15087,22898971,23292187,181521
10,ENSG00000256574.2,45315608,10-45324061-G-A,rs72784596,-1,G,A,45324061,8453,45119000,45512216,205061
10,ENSG00000078114.13,20897311,10-21025520-G-A,rs72790576,-1,G,A,21025520,128209,20700703,21093919,324817
10,ENSG00000148671.7,86968482,10-86932885-C-T,rs72807990,1,C,T,86932885,35597,86771874,87165090,161011
10,ENSG00000122884.7,73096866,10-73060688-C-A,rs72812263,-1,C,A,73060688,36178,72900258,73293474,160430
10,ENSG00000095539.10,100972540,10-100856549-C-A,rs72846630,1,C,A,100856549,115991,100775932,101169148,80617
10,ENSG00000138119.11,93482334,10-93340668-T-C,rs732867,-1,T,C,93340668,141666,93285726,93678942,54942
10,ENSG00000127884.4,133373354,10-133283523-A-C,rs74164137,-1,A,C,133283523,89831,133176746,133569962,106777
10,ENSG00000243660.3,43437111,10-43428198-G-A,rs74497314,1,G,A,43428198,8913,43240503,43633719,187695
10,ENSG00000176171.7,131981923,10-131997269-T-C,rs74733024,-1,T,C,131997269,15346,131785315,132178531,211954
10,ENSG00000165879.7,97319271,10-97190720-C-G,rs7474809,1,C,G,97190720,128551,97122663,97515879,68057
10,ENSG00000165879.7,97319271,10-97190720-C-T,rs7474809,1,C,T,97190720,128551,97122663,97515879,68057
10,ENSG00000168209.3,72273924,10-72127857-G-C,rs751207,1,G,C,72127857,146067,72077316,72470532,50541
10,ENSG00000148840.6,102133040,10-102134852-G-T,rs75709864,1,G,T,102134852,1812,101936432,102329648,198420
10,ENSG00000196233.6,96832298,10-96726055-T-C,rs75799982,1,T,C,96726055,106243,96635690,97028906,90365
10,ENSG00000166321.9,73110455,10-73184164-T-G,rs77733274,1,T,G,73184164,73709,72913847,73307063,270317
10,ENSG00000214688.3,71719778,10-71728190-C-G,rs78865428,-1,C,G,71728190,8412,71523170,71916386,205020
10,ENSG00000214688.3,71719778,10-71728190-C-A,rs78865428,-1,C,A,71728190,8412,71523170,71916386,205020
10,ENSG00000214688.3,71719778,10-71728190-C-T,rs78865428,-1,C,T,71728190,8412,71523170,71916386,205020
10,ENSG00000181192.7,12068954,10-12068519-A-G,rs7894615,1,A,G,12068519,435,11872346,12265562,196173
10,ENSG00000181192.7,12068954,10-12068519-A-T,rs7894615,1,A,T,12068519,435,11872346,12265562,196173
10,ENSG00000119906.6,100912963,10-100887929-T-G,rs7899336,1,T,G,100887929,25034,100716355,101109571,171574
10,ENSG00000107521.13,98446935,10-98414012-T-C,rs7903739,-1,T,C,98414012,32923,98250327,98643543,163685
10,ENSG00000165507.7,44978809,10-45069969-A-T,rs7910293,-1,A,T,45069969,91160,44782201,45175417,287768
10,ENSG00000165507.7,44978809,10-45069969-A-C,rs7910293,-1,A,C,45069969,91160,44782201,45175417,287768
10,ENSG00000138346.9,68471973,10-68574793-C-T,rs7911579,-1,C,T,68574793,102820,68275365,68668581,299428
10,ENSG00000152766.5,88851844,10-88898302-T-G,rs7912777,-1,T,G,88898302,46458,88655236,89048452,243066
10,ENSG00000152766.5,88851844,10-88898302-T-C,rs7912777,-1,T,C,88898302,46458,88655236,89048452,243066
10,ENSG00000119927.9,112183765,10-112207892-A-G,rs7913485,-1,A,G,112207892,24127,111987157,112380373,220735
10,ENSG00000165985.7,16521879,10-16517382-C-T,rs7913889,-1,C,T,16517382,4497,16325271,16718487,192111
10,ENSG00000043591.4,114043866,10-114025486-A-G,rs7915120,1,A,G,114025486,18380,113847258,114240474,178228
10,ENSG00000148677.6,90921087,10-90994210-C-T,rs7917186,-1,C,T,90994210,73123,90724479,91117695,269731
10,ENSG00000148677.6,90921087,10-90994210-C-G,rs7917186,-1,C,G,90994210,73123,90724479,91117695,269731
10,ENSG00000148677.6,90921087,10-90994210-C-A,rs7917186,-1,C,A,90994210,73123,90724479,91117695,269731
10,ENSG00000108179.8,79347469,10-79367893-A-T,rs7922163,1,A,T,79367893,20424,79150861,79544077,217032
10,ENSG00000108179.8,79347469,10-79367893-A-G,rs7922163,1,A,G,79367893,20424,79150861,79544077,217032
10,ENSG00000165678.13,84139509,10-84256345-T-C,rs7922232,1,T,C,84256345,116836,83942901,84336117,313444
10,ENSG00000107669.12,121928031,10-121948791-T-C,rs7923699,-1,T,C,121948791,20760,121731423,122124639,217368
10,ENSG00000107669.12,121928031,10-121948791-T-A,rs7923699,-1,T,A,121948791,20760,121731423,122124639,217368
10,ENSG00000119943.6,98415182,10-98396206-T-C,rs7924303,-1,T,C,98396206,18976,98218574,98611790,177632
10,ENSG00000134463.10,11742382,10-11728861-C-T,rs79704860,1,C,T,11728861,13521,11545774,11938990,183087
10,ENSG00000107819.8,101031234,10-101032538-G-A,rs807014,1,G,A,101032538,1304,100834626,101227842,197912
10,ENSG00000107819.8,101031234,10-101032538-G-T,rs807014,1,G,T,101032538,1304,100834626,101227842,197912
10,ENSG00000107819.8,101031234,10-101032538-G-C,rs807014,1,G,C,101032538,1304,100834626,101227842,197912
10,ENSG00000023041.7,112446914,10-112428029-T-G,rs8624,-1,T,G,112428029,18885,112250306,112643522,177723
10,ENSG00000023041.7,112446914,10-112428029-T-C,rs8624,-1,T,C,112428029,18885,112250306,112643522,177723
10,ENSG00000155254.7,97713730,10-97611972-A-C,rs933057,1,A,C,97611972,101758,97517122,97910338,94850
10,ENSG00000107738.12,71773520,10-71764611-G-A,rs9415996,-1,G,A,71764611,8909,71576912,71970128,187699
10,ENSG00000188316.8,116849499,10-116861266-T-A,rs9420215,1,T,A,116861266,11767,116652891,117046107,208375
10,ENSG00000188316.8,116849499,10-116861266-T-C,rs9420215,1,T,C,116861266,11767,116652891,117046107,208375
10,ENSG00000184923.6,87225448,10-87035113-T-C,rs9421560,1,T,C,87035113,190335,87028840,87422056,6273
10,ENSG00000108061.7,110919604,10-110843268-A-G,rs9633680,1,A,G,110843268,76336,110722996,111116212,120272
10,ENSG00000122378.9,80408551,10-80409842-C-T,rs9787439,1,C,T,80409842,1291,80211943,80605159,197899
10,ENSG00000122378.9,80408551,10-80409842-C-A,rs9787439,1,C,A,80409842,1291,80211943,80605159,197899
10,ENSG00000122378.9,80408551,10-80409842-C-G,rs9787439,1,C,G,80409842,1291,80211943,80605159,197899
10,ENSG00000015171.13,135455,10-318459-A-G,rs9804310,1,A,G,318459,183004,-61153,332063,379612
10,ENSG00000089876.7,125881292,10-125721713-G-A,rs9804381,-1,G,A,125721713,159579,125684684,126077900,37029
10,ENSG00000089876.7,125881292,10-125721713-G-T,rs9804381,-1,G,T,125721713,159579,125684684,126077900,37029
10,ENSG00000170430.9,129467241,10-129663059-G-T,rs9971190,1,G,T,129663059,195818,129270633,129663849,392426
10,ENSG00000170430.9,129467241,10-129663059-G-A,rs9971190,1,G,A,129663059,195818,129270633,129663849,392426
9,ENSG00000238227.3,136118875,9-136167429-C-A,rs10114437,-1,C,A,136167429,48554,135922267,136315483,245162
9,ENSG00000238227.3,136118875,9-136167429-C-T,rs10114437,-1,C,T,136167429,48554,135922267,136315483,245162
9,ENSG00000238227.3,136118875,9-136167429-C-G,rs10114437,-1,C,G,136167429,48554,135922267,136315483,245162
9,ENSG00000148057.10,83623143,9-83666830-G-A,rs10114717,1,G,A,83666830,43687,83426535,83819751,240295
9,ENSG00000155158.13,15307360,9-15296452-T-A,rs10118629,-1,T,A,15296452,10908,15110752,15503968,185700
9,ENSG00000155158.13,15307360,9-15296452-T-G,rs10118629,-1,T,G,15296452,10908,15110752,15503968,185700
9,ENSG00000106785.9,98119222,9-98117017-A-T,rs10119351,-1,A,T,98117017,2205,97922614,98315830,194403
9,ENSG00000196092.7,37034268,9-36968467-T-A,rs10121274,-1,T,A,36968467,65801,36837660,37230876,130807
9,ENSG00000196092.7,37034268,9-36968467-T-C,rs10121274,-1,T,C,36968467,65801,36837660,37230876,130807
9,ENSG00000196092.7,37034268,9-36968467-T-G,rs10121274,-1,T,G,36968467,65801,36837660,37230876,130807
9,ENSG00000056558.6,120926796,9-121045260-T-C,rs1017119,-1,T,C,121045260,118464,120730188,121123404,315072
9,ENSG00000095303.10,122371024,9-122387794-G-A,rs10306165,1,G,A,122387794,16770,122174416,122567632,213378
9,ENSG00000160408.9,127899603,9-127908373-A-T,rs1043012,-1,A,T,127908373,8770,127702995,128096211,205378
9,ENSG00000160408.9,127899603,9-127908373-A-G,rs1043012,-1,A,G,127908373,8770,127702995,128096211,205378
9,ENSG00000136810.8,110256507,9-110256475-T-C,rs1049927,-1,T,C,110256475,32,110059899,110453115,196576
9,ENSG00000164970.10,34458570,9-34365359-C-T,rs10511918,-1,C,T,34365359,93211,34261962,34655178,103397
9,ENSG00000185920.9,95509266,9-95534121-C-T,rs10512247,-1,C,T,95534121,24855,95312658,95705874,221463
9,ENSG00000136842.8,97501666,9-97513142-C-A,rs1052270,1,C,A,97513142,11476,97305058,97698274,208084
9,ENSG00000136842.8,97501666,9-97513142-C-T,rs1052270,1,C,T,97513142,11476,97305058,97698274,208084
9,ENSG00000136925.9,97633368,9-97513142-C-A,rs1052270,-1,C,A,97513142,120226,97436760,97829976,76382
9,ENSG00000136925.9,97633368,9-97513142-C-T,rs1052270,-1,C,T,97513142,120226,97436760,97829976,76382
9,ENSG00000148384.11,136439845,9-136424677-G-T,rs10747044,-1,G,T,136424677,15168,136243237,136636453,181440
9,ENSG00000170122.4,118417,9-206255-G-T,rs10757084,-1,G,T,206255,87838,-78191,315025,284446
9,ENSG00000170122.4,118417,9-206255-G-C,rs10757084,-1,G,C,206255,87838,-78191,315025,284446
9,ENSG00000170122.4,118417,9-206255-G-A,rs10757084,-1,G,A,206255,87838,-78191,315025,284446
9,ENSG00000165304.3,36572895,9-36696777-A-T,rs10758388,1,A,T,36696777,123882,36376287,36769503,320490
9,ENSG00000165304.3,36572895,9-36696777-A-G,rs10758388,1,A,G,36696777,123882,36376287,36769503,320490
9,ENSG00000137054.10,37485948,9-37488012-C-T,rs10758432,1,C,T,37488012,2064,37289340,37682556,198672
9,ENSG00000106976.12,128203379,9-128202956-G-A,rs10760548,1,G,A,128202956,423,128006771,128399987,196185
9,ENSG00000106976.12,128203379,9-128202956-G-T,rs10760548,1,G,T,128202956,423,128006771,128399987,196185
9,ENSG00000198642.5,21335404,9-21193433-T-G,rs10811497,-1,T,G,21193433,141971,21138796,21532012,54637
9,ENSG00000198642.5,21335404,9-21193433-T-A,rs10811497,-1,T,A,21193433,141971,21138796,21532012,54637
9,ENSG00000233816.2,21368962,9-21519296-T-A,rs10811557,-1,T,A,21519296,150334,21172354,21565570,346942
9,ENSG00000147852.9,2621787,9-2602831-C-G,rs10812325,1,C,G,2602831,18956,2425179,2818395,177652
9,ENSG00000147852.9,2621787,9-2602831-C-T,rs10812325,1,C,T,2602831,18956,2425179,2818395,177652
9,ENSG00000096872.10,26956412,9-26960087-A-T,rs10812503,1,A,T,26960087,3675,26759804,27153020,200283
9,ENSG00000096872.10,26956412,9-26960087-A-G,rs10812503,1,A,G,26960087,3675,26759804,27153020,200283
9,ENSG00000096872.10,26956412,9-26960087-A-C,rs10812503,1,A,C,26960087,3675,26759804,27153020,200283
9,ENSG00000186051.4,105662457,9-105661085-T-G,rs10816292,1,T,G,105661085,1372,105465849,105859065,195236
9,ENSG00000188483.6,129178261,9-129270358-T-C,rs10819484,-1,T,C,129270358,92097,128981653,129374869,288705
9,ENSG00000130956.9,96450169,9-96519987-G-C,rs10820757,1,G,C,96519987,69818,96253561,96646777,266426
9,ENSG00000106733.15,75088155,9-75092779-A-C,rs10869500,-1,A,C,75092779,4624,74891547,75284763,201232
9,ENSG00000106733.15,75088155,9-75092779-A-G,rs10869500,-1,A,G,75092779,4624,74891547,75284763,201232
9,ENSG00000106733.15,75088155,9-75092779-A-T,rs10869500,-1,A,T,75092779,4624,74891547,75284763,201232
9,ENSG00000196358.5,132162058,9-132235224-A-G,rs10901141,1,A,G,132235224,73166,131965450,132358666,269774
9,ENSG00000125484.6,132670464,9-132675838-T-C,rs10901197,1,T,C,132675838,5374,132473856,132867072,201982
9,ENSG00000125484.6,132670464,9-132675838-T-G,rs10901197,1,T,G,132675838,5374,132473856,132867072,201982
9,ENSG00000184434.7,27005672,9-27000342-C-G,rs10967652,-1,C,G,27000342,5330,26809064,27202280,191278
9,ENSG00000184434.7,27005672,9-27000342-C-T,rs10967652,-1,C,T,27000342,5330,26809064,27202280,191278
9,ENSG00000159884.7,35658292,9-35656878-C-G,rs10972552,1,C,G,35656878,1414,35461684,35854900,195194
9,ENSG00000159884.7,35658292,9-35656878-C-T,rs10972552,1,C,T,35656878,1414,35461684,35854900,195194
9,ENSG00000122707.7,36036913,9-36032585-T-C,rs10972700,1,T,C,36032585,4328,35840305,36233521,192280
9,ENSG00000122694.10,36136733,9-36186267-T-C,rs10972784,1,T,C,36186267,49534,35940125,36333341,246142
9,ENSG00000159921.8,36258448,9-36262740-G-A,rs10972814,-1,G,A,36262740,4292,36061840,36455056,200900
9,ENSG00000147905.12,37120574,9-37183939-T-A,rs10973244,1,T,A,37183939,63365,36923966,37317182,259973
9,ENSG00000165275.5,37753805,9-37775180-C-G,rs10973538,1,C,G,37775180,21375,37557197,37950413,217983
9,ENSG00000165275.5,37753805,9-37775180-C-T,rs10973538,1,C,T,37775180,21375,37557197,37950413,217983
9,ENSG00000122741.11,37800797,9-37795395-C-A,rs10973556,1,C,A,37795395,5402,37604189,37997405,191206
9,ENSG00000120217.9,5450542,9-5544405-A-G,rs10975175,1,A,G,5544405,93863,5253934,5647150,290471
9,ENSG00000095209.7,105694541,9-105692062-A-G,rs10978204,1,A,G,105692062,2479,105497933,105891149,194129
9,ENSG00000095209.7,105694541,9-105692062-A-C,rs10978204,1,A,C,105692062,2479,105497933,105891149,194129
9,ENSG00000188152.6,96928843,9-97002375-T-G,rs10980078,1,T,G,97002375,73532,96732235,97125451,270140
9,ENSG00000119314.11,112333619,9-112212328-G-T,rs10981317,-1,G,T,112212328,121291,112137011,112530227,75317
9,ENSG00000119314.11,112333619,9-112212328-G-C,rs10981317,-1,G,C,112212328,121291,112137011,112530227,75317
9,ENSG00000119314.11,112333619,9-112212328-G-A,rs10981317,-1,G,A,112212328,121291,112137011,112530227,75317
9,ENSG00000136868.8,113221544,9-113233621-C-T,rs10981699,1,C,T,113233621,12077,113024936,113418152,208685
9,ENSG00000176386.4,113275572,9-113287218-T-C,rs10981715,-1,T,C,113287218,11646,113078964,113472180,208254
9,ENSG00000148225.10,113340275,9-113336421-T-C,rs10981736,-1,T,C,113336421,3854,113143667,113536883,192754
9,ENSG00000119396.6,121201869,9-121086559-A-G,rs10985148,-1,A,G,121086559,115310,121005261,121398477,81298
9,ENSG00000119396.6,121201869,9-121086559-A-T,rs10985148,-1,A,T,121086559,115310,121005261,121398477,81298
9,ENSG00000182150.9,95875691,9-95840724-G-C,rs10985499,1,G,C,95840724,34967,95679083,96072299,161641
9,ENSG00000182150.9,95875691,9-95840724-G-A,rs10985499,1,G,A,95840724,34967,95679083,96072299,161641
9,ENSG00000182150.9,95875691,9-95840724-G-T,rs10985499,1,G,T,95840724,34967,95679083,96072299,161641
9,ENSG00000136930.8,124415442,9-124273482-G-T,rs10986296,-1,G,T,124273482,141960,124218834,124612050,54648
9,ENSG00000136930.8,124415442,9-124273482-G-C,rs10986296,-1,G,C,124273482,141960,124218834,124612050,54648
9,ENSG00000119408.11,124257949,9-124304852-G-A,rs10986309,1,G,A,124304852,46903,124061341,124454557,243511
9,ENSG00000136859.5,127122635,9-127184463-T-C,rs10987570,-1,T,C,127184463,61828,126926027,127319243,258436
9,ENSG00000160404.13,127735294,9-127628439-G-A,rs10987706,-1,G,A,127628439,106855,127538686,127931902,89753
9,ENSG00000106991.8,127854658,9-127856098-T-C,rs10987759,-1,T,C,127856098,1440,127658050,128051266,198048
9,ENSG00000148339.8,128068232,9-128057295-G-C,rs10987852,1,G,C,128057295,10937,127871624,128264840,185671
9,ENSG00000148339.8,128068232,9-128057295-G-A,rs10987852,1,G,A,128057295,10937,127871624,128264840,185671
9,ENSG00000119523.8,99221942,9-99201731-A-G,rs10988749,-1,A,G,99201731,20211,99025334,99418550,176397
9,ENSG00000048828.11,93451685,9-93451009-A-G,rs10992740,1,A,G,93451009,676,93255077,93648293,195932
9,ENSG00000130560.4,135961373,9-135942816-C-G,rs11103235,-1,C,G,135942816,18557,135764765,136157981,178051
9,ENSG00000130560.4,135961373,9-135942816-C-T,rs11103235,-1,C,T,135942816,18557,135764765,136157981,178051
9,ENSG00000130560.4,135961373,9-135942816-C-A,rs11103235,-1,C,A,135942816,18557,135764765,136157981,178051
9,ENSG00000182154.7,137551879,9-137736582-A-G,rs11137193,1,A,G,137736582,184703,137355271,137748487,381311
9,ENSG00000181090.12,137619005,9-137772069-T-G,rs11137221,1,T,G,137772069,153064,137422397,137815613,349672
9,ENSG00000148408.8,137877782,9-137866039-C-T,rs11137278,1,C,T,137866039,11743,137681174,138074390,184865
9,ENSG00000135040.11,85941146,9-85916164-G-A,rs11141148,1,G,A,85916164,24982,85744538,86137754,171626
9,ENSG00000135040.11,85941146,9-85916164-G-T,rs11141148,1,G,T,85916164,24982,85744538,86137754,171626
9,ENSG00000156017.8,75028293,9-74867063-T-C,rs11144123,-1,T,C,74867063,161230,74831685,75224901,35378
9,ENSG00000213221.4,136363744,9-136360621-G-A,rs11145958,-1,G,A,136360621,3123,136167136,136560352,193485
9,ENSG00000213221.4,136363744,9-136360621-G-C,rs11145958,-1,G,C,136360621,3123,136167136,136560352,193485
9,ENSG00000213221.4,136363744,9-136360621-G-T,rs11145958,-1,G,T,136360621,3123,136167136,136560352,193485
9,ENSG00000176978.7,137114733,9-137109889-T-C,rs11145996,-1,T,C,137109889,4844,136918125,137311341,191764
9,ENSG00000176978.7,137114733,9-137109889-T-G,rs11145996,-1,T,G,137109889,4844,136918125,137311341,191764
9,ENSG00000188566.6,137205700,9-137155324-T-G,rs112416966,1,T,G,137155324,50376,137009092,137402308,146232
9,ENSG00000107164.13,130579577,9-130482812-G-T,rs11243474,1,G,T,130482812,96765,130382969,130776185,99843
9,ENSG00000136856.11,127397169,9-127447832-T-A,rs1139400,1,T,A,127447832,50663,127200561,127593777,247271
9,ENSG00000136856.11,127397169,9-127447832-T-C,rs1139400,1,T,C,127447832,50663,127200561,127593777,247271
9,ENSG00000119326.10,109013499,9-108916228-C-T,rs1140064,-1,C,T,108916228,97271,108816891,109210107,99337
9,ENSG00000160325.9,133459978,9-133532073-C-T,rs11507716,1,C,T,133532073,72095,133263370,133656586,268703
9,ENSG00000175283.6,128947603,9-128770415-C-T,rs11560592,-1,C,T,128770415,177188,128750995,129144211,19420
9,ENSG00000175283.6,128947603,9-128770415-C-G,rs11560592,-1,C,G,128770415,177188,128750995,129144211,19420
9,ENSG00000198000.6,92325350,9-92391690-A-G,rs116388354,-1,A,G,92391690,66340,92128742,92521958,262948
9,ENSG00000183354.7,6008482,9-6151129-T-C,rs116898132,-1,T,C,6151129,142647,5811874,6205090,339255
9,ENSG00000177943.8,136852346,9-136865196-G-A,rs116924614,1,G,A,136865196,12850,136655738,137048954,209458
9,ENSG00000081377.12,96619843,9-96632324-A-G,rs116950909,-1,A,G,96632324,12481,96423235,96816451,209089
9,ENSG00000136897.6,101398618,9-101318928-T-C,rs117104094,-1,T,C,101318928,79690,101202010,101595226,116918
9,ENSG00000120235.3,21351378,9-21329434-C-A,rs11791015,-1,C,A,21329434,21944,21154770,21547986,174664
9,ENSG00000120235.3,21351378,9-21329434-C-G,rs11791015,-1,C,G,21329434,21944,21154770,21547986,174664
9,ENSG00000120235.3,21351378,9-21329434-C-T,rs11791015,-1,C,T,21329434,21944,21154770,21547986,174664
9,ENSG00000136866.9,113056724,9-113056970-C-T,rs11791740,-1,C,T,113056970,246,112860116,113253332,196854
9,ENSG00000136888.6,114587769,9-114588322-A-G,rs118009168,1,A,G,114588322,553,114391161,114784377,197161
9,ENSG00000106799.6,99105113,9-99170243-A-G,rs118112234,1,A,G,99170243,65130,98908505,99301721,261738
9,ENSG00000148053.11,84669729,9-84651437-A-T,rs1187333,1,A,T,84651437,18292,84473121,84866337,178316
9,ENSG00000148053.11,84669729,9-84651437-A-G,rs1187333,1,A,G,84651437,18292,84473121,84866337,178316
9,ENSG00000148053.11,84669729,9-84651437-A-C,rs1187333,1,A,C,84651437,18292,84473121,84866337,178316
9,ENSG00000164967.5,34612097,9-34512395-T-G,rs11999454,-1,T,G,34512395,99702,34415489,34808705,96906
9,ENSG00000119318.7,107283279,9-107127969-A-G,rs12002945,1,A,G,107127969,155310,107086671,107479887,41298
9,ENSG00000130635.10,134641803,9-134786174-T-C,rs12005720,1,T,C,134786174,144371,134445195,134838411,340979
9,ENSG00000137101.6,35618413,9-35733973-A-C,rs12340601,-1,A,C,35733973,115560,35421805,35815021,312168
9,ENSG00000148120.9,94726699,9-94845391-C-T,rs12344157,1,C,T,94845391,118692,94530091,94923307,315300
9,ENSG00000147889.10,21974857,9-22128710-C-G,rs12347779,-1,C,G,22128710,153853,21778249,22171465,350461
9,ENSG00000106952.3,114930591,9-114769028-C-T,rs12348862,-1,C,T,114769028,161563,114733983,115127199,35045
9,ENSG00000172159.10,83538401,9-83441289-A-C,rs12378340,-1,A,C,83441289,97112,83341793,83735009,99496
9,ENSG00000198722.7,35162009,9-35150638-T-C,rs12378933,1,T,C,35150638,11371,34965401,35358617,185237
9,ENSG00000070610.10,35749228,9-35633798-T-C,rs12551214,-1,T,C,35633798,115430,35552620,35945836,81178
9,ENSG00000178445.8,6645729,9-6632061-G-A,rs1260463,-1,G,A,6632061,13668,6449121,6842337,182940
9,ENSG00000136942.9,124861957,9-124758356-T-C,rs12683027,-1,T,C,124758356,103601,124665349,125058565,93007
9,ENSG00000165661.10,136245812,9-136218808-C-T,rs12684650,-1,C,T,136218808,27004,136049204,136442420,169604
9,ENSG00000165023.5,90642824,9-90535684-C-G,rs12685637,-1,C,G,90535684,107140,90446216,90839432,89468
9,ENSG00000165023.5,90642824,9-90535684-C-T,rs12685637,-1,C,T,90535684,107140,90446216,90839432,89468
9,ENSG00000185963.9,92764833,9-92762720-A-G,rs12685780,-1,A,G,92762720,2113,92568225,92961441,194495
9,ENSG00000185963.9,92764833,9-92762720-A-T,rs12685780,-1,A,T,92762720,2113,92568225,92961441,194495
9,ENSG00000160447.6,128702503,9-128703202-C-G,rs13283282,1,C,G,128703202,699,128505895,128899111,197307
9,ENSG00000137124.5,38392702,9-38387868-A-G,rs13290293,1,A,G,38387868,4834,38196094,38589310,191774
9,ENSG00000197958.8,127451406,9-127428907-C-T,rs13292096,-1,C,T,127428907,22499,127254798,127648014,174109
9,ENSG00000198435.2,137302271,9-137428362-A-G,rs13296446,-1,A,G,137428362,126091,137105663,137498879,322699
9,ENSG00000198435.2,137302271,9-137428362-A-T,rs13296446,-1,A,T,137428362,126091,137105663,137498879,322699
9,ENSG00000137038.7,7799778,9-7799606-C-A,rs14059,-1,C,A,7799606,172,7603170,7996386,196436
9,ENSG00000165118.9,83956742,9-83763852-T-C,rs1421144,-1,T,C,83763852,192890,83760134,84153350,3718
9,ENSG00000165118.9,83956742,9-83763852-T-A,rs1421144,-1,T,A,83763852,192890,83760134,84153350,3718
9,ENSG00000176884.10,137139154,9-137067808-G-A,rs144334202,1,G,A,137067808,71346,136942546,137335762,125262
9,ENSG00000176884.10,137139154,9-137067808-G-C,rs144334202,1,G,C,137067808,71346,136942546,137335762,125262
9,ENSG00000196739.8,114155537,9-114154651-A-C,rs1469598,1,A,C,114154651,886,113958929,114352145,195722
9,ENSG00000196739.8,114155537,9-114154651-A-G,rs1469598,1,A,G,114154651,886,113958929,114352145,195722
9,ENSG00000137090.6,841697,9-658151-G-A,rs1570479,1,G,A,658151,183546,645089,1038305,13062
9,ENSG00000119446.8,122264840,9-122235946-A-G,rs1571585,-1,A,G,122235946,28894,122068232,122461448,167714
9,ENSG00000160293.11,133992324,9-133950235-G-C,rs16803,-1,G,C,133950235,42089,133795716,134188932,154519
9,ENSG00000160293.11,133992324,9-133950235-G-A,rs16803,-1,G,A,133950235,42089,133795716,134188932,154519
9,ENSG00000165140.5,94639518,9-94636510-C-A,rs16910850,-1,C,A,94636510,3008,94442910,94836126,193600
9,ENSG00000165140.5,94639518,9-94636510-C-G,rs16910850,-1,C,G,94636510,3008,94442910,94836126,193600
9,ENSG00000165140.5,94639518,9-94636510-C-T,rs16910850,-1,C,T,94636510,3008,94442910,94836126,193600
9,ENSG00000136938.7,97983341,9-98119458-C-T,rs16912804,1,C,T,98119458,136117,97786733,98179949,332725
9,ENSG00000204291.5,98943907,9-99053057-G-T,rs16918167,1,G,T,99053057,109150,98747299,99140515,305758
9,ENSG00000204291.5,98943907,9-99053057-G-A,rs16918167,1,G,A,99053057,109150,98747299,99140515,305758
9,ENSG00000205808.3,4662294,9-4670573-C-A,rs16921782,1,C,A,4670573,8279,4465686,4858902,204887
9,ENSG00000205808.3,4662294,9-4670573-C-T,rs16921782,1,C,T,4670573,8279,4465686,4858902,204887
9,ENSG00000175854.6,128276244,9-128237072-C-G,rs16930318,1,C,G,128237072,39172,128079636,128472852,157436
9,ENSG00000175854.6,128276244,9-128237072-C-T,rs16930318,1,C,T,128237072,39172,128079636,128472852,157436
9,ENSG00000164976.7,34376898,9-34242096-T-A,rs16935457,-1,T,A,34242096,134802,34180290,34573506,61806
9,ENSG00000154330.6,68356611,9-68384399-T-A,rs17081271,1,T,A,68384399,27788,68160003,68553219,224396
9,ENSG00000154330.6,68356611,9-68384399-T-C,rs17081271,1,T,C,68384399,27788,68160003,68553219,224396
9,ENSG00000154330.6,68356611,9-68384399-T-G,rs17081271,1,T,G,68384399,27788,68160003,68553219,224396
9,ENSG00000136872.10,101435774,9-101403078-C-T,rs17185855,-1,C,T,101403078,32696,101239166,101632382,163912
9,ENSG00000106692.8,105558131,9-105647333-T-C,rs17251166,1,T,C,105647333,89202,105361523,105754739,285810
9,ENSG00000175764.10,122093308,9-122047850-T-C,rs17263303,-1,T,C,122047850,45458,121896700,122289916,151150
9,ENSG00000175287.14,128920982,9-128943484-G-A,rs17432839,1,G,A,128943484,22502,128724374,129117590,219110
9,ENSG00000106823.8,92535990,9-92594569-G-A,rs17462411,-1,G,A,92594569,58579,92339382,92732598,255187
9,ENSG00000172785.11,179147,9-270321-A-G,rs17720310,-1,A,G,270321,91174,-17461,375755,287782
9,ENSG00000120162.8,27529814,9-27488094-T-G,rs17779457,-1,T,G,27488094,41720,27333206,27726422,154888
9,ENSG00000120162.8,27529814,9-27488094-T-A,rs17779457,-1,T,A,27488094,41720,27333206,27726422,154888
9,ENSG00000154529.8,42129426,9-42186681-G-A,rs201906478,-1,G,A,42186681,57255,41932818,42326034,253863
9,ENSG00000147955.10,34637787,9-34649445-A-G,rs2070074,-1,A,G,34649445,11658,34441179,34834395,208266
9,ENSG00000107020.5,5437925,9-5383460-C-G,rs2104175,-1,C,G,5383460,54465,5241317,5634533,142143
9,ENSG00000107020.5,5437925,9-5383460-C-T,rs2104175,-1,C,T,5383460,54465,5241317,5634533,142143
9,ENSG00000107020.5,5437925,9-5383460-C-A,rs2104175,-1,C,A,5383460,54465,5241317,5634533,142143
9,ENSG00000136891.8,100352942,9-100346659-C-A,rs2151131,-1,C,A,100346659,6283,100156334,100549550,190325
9,ENSG00000136891.8,100352942,9-100346659-C-T,rs2151131,-1,C,T,100346659,6283,100156334,100549550,190325
9,ENSG00000136891.8,100352942,9-100346659-C-G,rs2151131,-1,C,G,100346659,6283,100156334,100549550,190325
9,ENSG00000147874.6,19102904,9-18994590-C-G,rs2152464,-1,C,G,18994590,108314,18906296,19299512,88294
9,ENSG00000147874.6,19102904,9-18994590-C-A,rs2152464,-1,C,A,18994590,108314,18906296,19299512,88294
9,ENSG00000106804.5,121050275,9-121020778-T-A,rs2159777,-1,T,A,121020778,29497,120853667,121246883,167111
9,ENSG00000106804.5,121050275,9-121020778-T-G,rs2159777,-1,T,G,121020778,29497,120853667,121246883,167111
9,ENSG00000213930.6,34646675,9-34691538-T-C,rs2233873,1,T,C,34691538,44863,34450067,34843283,241471
9,ENSG00000054148.13,136849409,9-136859658-G-T,rs2236544,1,G,T,136859658,10249,136652801,137046017,206857
9,ENSG00000054148.13,136849409,9-136859658-G-A,rs2236544,1,G,A,136859658,10249,136652801,137046017,206857
9,ENSG00000196152.6,127424382,9-127459109-T-C,rs2243767,1,T,C,127459109,34727,127227774,127620990,231335
9,ENSG00000196152.6,127424382,9-127459109-T-A,rs2243767,1,T,A,127459109,34727,127227774,127620990,231335
9,ENSG00000054179.6,137054061,9-137052352-C-T,rs2271867,-1,C,T,137052352,1709,136857453,137250669,194899
9,ENSG00000054179.6,137054061,9-137052352-C-A,rs2271867,-1,C,A,137052352,1709,136857453,137250669,194899
9,ENSG00000054179.6,137054061,9-137052352-C-G,rs2271867,-1,C,G,137052352,1709,136857453,137250669,194899
9,ENSG00000107281.5,137046177,9-137052352-C-T,rs2271867,-1,C,T,137052352,6175,136849569,137242785,202783
9,ENSG00000107281.5,137046177,9-137052352-C-A,rs2271867,-1,C,A,137052352,6175,136849569,137242785,202783
9,ENSG00000107281.5,137046177,9-137052352-C-G,rs2271867,-1,C,G,137052352,6175,136849569,137242785,202783
9,ENSG00000070061.10,108934124,9-108926487-C-T,rs2275635,-1,C,T,108926487,7637,108737516,109130732,188971
9,ENSG00000127080.5,92670131,9-92642542-A-C,rs2277167,-1,A,C,92642542,27589,92473523,92866739,169019
9,ENSG00000127080.5,92670131,9-92642542-A-G,rs2277167,-1,A,G,92642542,27589,92473523,92866739,169019
9,ENSG00000147894.10,27573481,9-27572636-C-T,rs2282240,-1,C,T,27572636,845,27376873,27770089,195763
9,ENSG00000147894.10,27573481,9-27572636-C-A,rs2282240,-1,C,A,27572636,845,27376873,27770089,195763
9,ENSG00000147894.10,27573481,9-27572636-C-G,rs2282240,-1,C,G,27572636,845,27376873,27770089,195763
9,ENSG00000070601.5,37650954,9-37708575-A-G,rs2296554,1,A,G,37708575,57621,37454346,37847562,254229
9,ENSG00000177076.4,19409009,9-19448475-A-G,rs2383096,1,A,G,19448475,39466,19212401,19605617,236074
9,ENSG00000165028.7,104764129,9-104774614-A-T,rs2515606,1,A,T,104774614,10485,104567521,104960737,207093
9,ENSG00000165028.7,104764129,9-104774614-A-G,rs2515606,1,A,G,104774614,10485,104567521,104960737,207093
9,ENSG00000204136.6,121499844,9-121394770-G-A,rs2572854,-1,G,A,121394770,105074,121303236,121696452,91534
9,ENSG00000148229.8,113410675,9-113397580-G-A,rs2761025,-1,G,A,113397580,13095,113214067,113607283,183513
9,ENSG00000106948.11,114387982,9-114367105-C-G,rs2787352,-1,C,G,114367105,20877,114191374,114584590,175731
9,ENSG00000066697.10,100427143,9-100293656-G-A,rs2787375,1,G,A,100293656,133487,100230535,100623751,63121
9,ENSG00000066697.10,100427143,9-100293656-G-C,rs2787375,1,G,C,100293656,133487,100230535,100623751,63121
9,ENSG00000148175.8,121370250,9-121381022-A-G,rs2793265,-1,A,G,121381022,10772,121173642,121566858,207380
9,ENSG00000148175.8,121370250,9-121381022-A-C,rs2793265,-1,A,C,121381022,10772,121173642,121566858,207380
9,ENSG00000177984.6,136764518,9-136788772-G-A,rs2811786,-1,G,A,136788772,24254,136567910,136961126,220862
9,ENSG00000188747.4,137423393,9-137233633-T-C,rs28407527,1,T,C,137233633,189760,137226785,137620001,6848
9,ENSG00000176058.7,137200741,9-137233633-T-C,rs28407527,-1,T,C,137233633,32892,137004133,137397349,229500
9,ENSG00000167113.5,128322839,9-128321416-C-T,rs28636742,1,C,T,128321416,1423,128126231,128519447,195185
9,ENSG00000176248.6,137188560,9-137348112-G-A,rs28671254,-1,G,A,137348112,159552,136991952,137385168,356160
9,ENSG00000176248.6,137188560,9-137348112-G-T,rs28671254,-1,G,T,137348112,159552,136991952,137385168,356160
9,ENSG00000106789.8,98192637,9-98192147-G-A,rs28703824,-1,G,A,98192147,490,97996029,98389245,196118
9,ENSG00000148335.8,129626163,9-129631991-G-T,rs2900277,1,G,T,129631991,5828,129429555,129822771,202436
9,ENSG00000148335.8,129626163,9-129631991-G-A,rs2900277,1,G,A,129631991,5828,129429555,129822771,202436
9,ENSG00000123453.10,133738352,9-133735651-C-T,rs2905214,-1,C,T,133735651,2701,133541744,133934960,193907
9,ENSG00000165025.10,90801819,9-90799027-T-C,rs290992,1,T,C,90799027,2792,90605211,90998427,193816
9,ENSG00000107341.4,33817160,9-33968821-T-C,rs307673,1,T,C,33968821,151661,33620552,34013768,348269
9,ENSG00000148290.5,133356487,9-133425943-T-C,rs3118667,-1,T,C,133425943,69456,133159879,133553095,266064
9,ENSG00000135002.7,76394426,9-76394431-G-A,rs3739730,-1,G,A,76394431,5,76197818,76591034,196613
9,ENSG00000148296.5,133336188,9-133327975-A-G,rs3739890,-1,A,G,133327975,8213,133139580,133532796,188395
9,ENSG00000119431.5,113376986,9-113375733-C-T,rs3747816,-1,C,T,113375733,1253,113180378,113573594,195355
9,ENSG00000165271.10,33473924,9-33449954-C-T,rs3758280,-1,C,T,33449954,23970,33277316,33670532,172638
9,ENSG00000165271.10,33473924,9-33449954-C-A,rs3758280,-1,C,A,33449954,23970,33277316,33670532,172638
9,ENSG00000148331.7,129642151,9-129629139-T-C,rs3780695,-1,T,C,129629139,13012,129445543,129838759,183596
9,ENSG00000167112.7,128322447,9-128150578-C-T,rs3780836,-1,C,T,128150578,171869,128125839,128519055,24739
9,ENSG00000167112.7,128322447,9-128150578-C-A,rs3780836,-1,C,A,128150578,171869,128125839,128519055,24739
9,ENSG00000167103.7,127930777,9-127951337-T-C,rs3802354,-1,T,C,127951337,20560,127734169,128127385,217168
9,ENSG00000119514.5,98807670,9-98728784-C-A,rs380857,1,C,A,98728784,78886,98611062,99004278,117722
9,ENSG00000119514.5,98807670,9-98728784-C-G,rs380857,1,C,G,98728784,78886,98611062,99004278,117722
9,ENSG00000119514.5,98807670,9-98728784-C-T,rs380857,1,C,T,98728784,78886,98611062,99004278,117722
9,ENSG00000165138.11,98796555,9-98728784-C-A,rs380857,-1,C,A,98728784,67771,98599947,98993163,128837
9,ENSG00000165138.11,98796555,9-98728784-C-G,rs380857,-1,C,G,98728784,67771,98599947,98993163,128837
9,ENSG00000165138.11,98796555,9-98728784-C-T,rs380857,-1,C,T,98728784,67771,98599947,98993163,128837
9,ENSG00000147872.5,19127492,9-19127879-G-A,rs3808657,-1,G,A,19127879,387,18930884,19324100,196995
9,ENSG00000147872.5,19127492,9-19127879-G-T,rs3808657,-1,G,T,19127879,387,18930884,19324100,196995
9,ENSG00000107263.12,131740076,9-131595766-C-T,rs3808803,-1,C,T,131595766,144310,131543468,131936684,52298
9,ENSG00000136875.7,113275658,9-113274286-A-G,rs3810918,1,A,G,113274286,1372,113079050,113472266,195236
9,ENSG00000148396.12,136483040,9-136474610-C-T,rs3812595,-1,C,T,136474610,8430,136286432,136679648,188178
9,ENSG00000171159.4,128160265,9-128148408-A-G,rs3814526,1,A,G,128148408,11857,127963657,128356873,184751
9,ENSG00000106853.11,111599647,9-111660113-A-G,rs3824469,-1,A,G,111660113,60466,111403039,111796255,257074
9,ENSG00000136908.13,127937854,9-127939274-G-C,rs3824528,-1,G,C,127939274,1420,127741246,128134462,198028
9,ENSG00000119321.4,113221277,9-113157502-T-C,rs3934969,-1,T,C,113157502,63775,113024669,113417885,132833
9,ENSG00000120215.5,5890889,9-5765648-G-A,rs41280733,1,G,A,5765648,125241,5694281,6087497,71367
9,ENSG00000186193.7,137070557,9-137080743-C-T,rs41302685,-1,C,T,137080743,10186,136873949,137267165,206794
9,ENSG00000197355.6,137077517,9-137080743-C-T,rs41302685,1,C,T,137080743,3226,136880909,137274125,199834
9,ENSG00000157653.7,113410747,9-113583838-G-A,rs41305473,1,G,A,113583838,173091,113214139,113607355,369699
9,ENSG00000136783.9,104747683,9-104792547-T-G,rs4149328,1,T,G,104792547,44864,104551075,104944291,241472
9,ENSG00000136783.9,104747683,9-104792547-T-C,rs4149328,1,T,C,104792547,44864,104551075,104944291,241472
9,ENSG00000107036.7,5629107,9-5526124-C-T,rs4237162,1,C,T,5526124,102983,5432499,5825715,93625
9,ENSG00000187239.10,130043189,9-130216198-G-C,rs4240447,-1,G,C,130216198,173009,129846581,130239797,369617
9,ENSG00000187239.10,130043189,9-130216198-G-A,rs4240447,-1,G,A,130216198,173009,129846581,130239797,369617
9,ENSG00000137133.5,35815042,9-35903401-G-A,rs4271053,-1,G,A,35903401,88359,35618434,36011650,284967
9,ENSG00000137106.11,37422696,9-37421771-C-A,rs4472607,1,C,A,37421771,925,37226088,37619304,195683
9,ENSG00000137106.11,37422696,9-37421771-C-T,rs4472607,1,C,T,37421771,925,37226088,37619304,195683
9,ENSG00000187796.9,136373669,9-136408849-A-G,rs4487900,-1,A,G,136408849,35180,136177061,136570277,231788
9,ENSG00000130714.10,131502918,9-131528812-A-G,rs4740260,1,A,G,131528812,25894,131306310,131699526,222502
9,ENSG00000130714.10,131502918,9-131528812-A-T,rs4740260,1,A,T,131528812,25894,131306310,131699526,222502
9,ENSG00000106688.7,4490468,9-4559775-C-T,rs4742007,1,C,T,4559775,69307,4293860,4687076,265915
9,ENSG00000136824.13,104094309,9-104094797-A-G,rs4742906,1,A,G,104094797,488,103897701,104290917,197096
9,ENSG00000106701.7,105448034,9-105614816-G-A,rs4742955,1,G,A,105614816,166782,105251426,105644642,363390
9,ENSG00000106701.7,105448034,9-105614816-G-T,rs4742955,1,G,T,105614816,166782,105251426,105644642,363390
9,ENSG00000148343.14,129036626,9-129222427-G-T,rs4836644,1,G,T,129222427,185801,128840018,129233234,382409
9,ENSG00000148341.12,129028331,9-129023624-C-T,rs4837333,-1,C,T,129023624,4707,128831723,129224939,191901
9,ENSG00000148341.12,129028331,9-129023624-C-G,rs4837333,-1,C,G,129023624,4707,128831723,129224939,191901
9,ENSG00000136931.5,124507399,9-124460933-G-A,rs4838181,-1,G,A,124460933,46466,124310791,124704007,150142
9,ENSG00000107140.9,35605262,9-35669907-G-A,rs4878625,1,G,A,35669907,64645,35408654,35801870,261253
9,ENSG00000198467.7,35689925,9-35700840-C-T,rs4879926,-1,C,T,35700840,10915,35493317,35886533,207523
9,ENSG00000198467.7,35689925,9-35700840-C-G,rs4879926,-1,C,G,35700840,10915,35493317,35886533,207523
9,ENSG00000187713.5,137205648,9-137136549-C-T,rs4880213,-1,C,T,137136549,69099,137009040,137402256,127509
9,ENSG00000187713.5,137205648,9-137136549-C-G,rs4880213,-1,C,G,137136549,69099,137009040,137402256,127509
9,ENSG00000106868.12,112175297,9-112199396-C-T,rs4978477,-1,C,T,112199396,24099,111978689,112371905,220707
9,ENSG00000106868.12,112175297,9-112199396-C-A,rs4978477,-1,C,A,112199396,24099,111978689,112371905,220707
9,ENSG00000106868.12,112175297,9-112199396-C-G,rs4978477,-1,C,G,112199396,24099,111978689,112371905,220707
9,ENSG00000119328.7,108934400,9-109000645-C-A,rs4978767,1,C,A,109000645,66245,108737792,109131008,262853
9,ENSG00000119328.7,108934400,9-109000645-C-T,rs4978767,1,C,T,109000645,66245,108737792,109131008,262853
9,ENSG00000119328.7,108934400,9-109000645-C-G,rs4978767,1,C,G,109000645,66245,108737792,109131008,262853
9,ENSG00000188959.9,110208159,9-110167600-G-A,rs4978875,-1,G,A,110167600,40559,110011551,110404767,156049
9,ENSG00000198121.7,111038470,9-111040153-C-A,rs4978978,-1,C,A,111040153,1683,110841862,111235078,198291
9,ENSG00000198121.7,111038470,9-111040153-C-G,rs4978978,-1,C,G,111040153,1683,110841862,111235078,198291
9,ENSG00000119471.10,112380108,9-112377996-G-C,rs4979109,1,G,C,112377996,2112,112183500,112576716,194496
9,ENSG00000119471.10,112380108,9-112377996-G-A,rs4979109,1,G,A,112377996,2112,112183500,112576716,194496
9,ENSG00000157693.10,114611291,9-114613629-C-A,rs4979444,1,C,A,114613629,2338,114414683,114807899,198946
9,ENSG00000187024.8,127715663,9-127715489-G-A,rs504434,-1,G,A,127715489,174,127519055,127912271,196434
9,ENSG00000165280.11,35072625,9-35062975-C-A,rs514492,-1,C,A,35062975,9650,34876017,35269233,186958
9,ENSG00000165280.11,35072625,9-35062975-C-T,rs514492,-1,C,T,35062975,9650,34876017,35269233,186958
9,ENSG00000160401.9,127706988,9-127714881-G-A,rs550045,1,G,A,127714881,7893,127510380,127903596,204501
9,ENSG00000160401.9,127706988,9-127714881-G-C,rs550045,1,G,C,127714881,7893,127510380,127903596,204501
9,ENSG00000164985.9,15510970,9-15523306-T-C,rs57142629,-1,T,C,15523306,12336,15314362,15707578,208944
9,ENSG00000159899.10,35791591,9-35742984-G-T,rs58869857,1,G,T,35742984,48607,35594983,35988199,148001
9,ENSG00000159899.10,35791591,9-35742984-G-A,rs58869857,1,G,A,35742984,48607,35594983,35988199,148001
9,ENSG00000164946.13,14910428,9-14926776-T-C,rs59846294,-1,T,C,14926776,16348,14713820,15107036,212956
9,ENSG00000106772.11,76906114,9-76711589-A-G,rs615187,-1,A,G,76711589,194525,76709506,77102722,2083
9,ENSG00000106772.11,76906114,9-76711589-A-T,rs615187,-1,A,T,76711589,194525,76709506,77102722,2083
9,ENSG00000106772.11,76906114,9-76711589-A-C,rs615187,-1,A,C,76711589,194525,76709506,77102722,2083
9,ENSG00000148291.5,133356550,9-133361131-C-T,rs61751475,1,C,T,133361131,4581,133159942,133553158,201189
9,ENSG00000136828.13,126914782,9-126884943-C-T,rs624903,1,C,T,126884943,29839,126718174,127111390,166769
9,ENSG00000187922.9,136742940,9-136725921-G-A,rs62582186,-1,G,A,136725921,17019,136546332,136939548,179589
9,ENSG00000136827.9,129824136,9-129975577-A-G,rs62583655,-1,A,G,129975577,151441,129627528,130020744,348049
9,ENSG00000107331.10,137028237,9-137048360-C-T,rs62584466,-1,C,T,137048360,20123,136831629,137224845,216731
9,ENSG00000107331.10,137028237,9-137048360-C-A,rs62584466,-1,C,A,137048360,20123,136831629,137224845,216731
9,ENSG00000122729.11,32384643,9-32532471-A-T,rs626214,1,A,T,32532471,147828,32188035,32581251,344436
9,ENSG00000122729.11,32384643,9-32532471-A-C,rs626214,1,A,C,32532471,147828,32188035,32581251,344436
9,ENSG00000167081.10,125747373,9-125650397-G-C,rs631287,1,G,C,125650397,96976,125550765,125943981,99632
9,ENSG00000167081.10,125747373,9-125650397-G-T,rs631287,1,G,T,125650397,96976,125550765,125943981,99632
9,ENSG00000167081.10,125747373,9-125650397-G-A,rs631287,1,G,A,125650397,96976,125550765,125943981,99632
9,ENSG00000171843.10,20622499,9-20781980-C-A,rs6475473,-1,C,A,20781980,159481,20425891,20819107,356089
9,ENSG00000171843.10,20622499,9-20781980-C-T,rs6475473,-1,C,T,20781980,159481,20425891,20819107,356089
9,ENSG00000107099.9,214865,9-289061-A-G,rs6476030,1,A,G,289061,74196,18257,411473,270804
9,ENSG00000137073.14,34048887,9-33873559-C-G,rs6476426,-1,C,G,33873559,175328,33852279,34245495,21280
9,ENSG00000136867.6,113151007,9-113103737-G-T,rs6477983,1,G,T,113103737,47270,112954399,113347615,149338
9,ENSG00000167136.6,128818500,9-128826609-G-C,rs6478854,1,G,C,128826609,8109,128621892,129015108,204717
9,ENSG00000178966.11,83980805,9-84006618-C-T,rs6559756,1,C,T,84006618,25813,83784197,84177413,222421
9,ENSG00000178966.11,83980805,9-84006618-C-A,rs6559756,1,C,A,84006618,25813,83784197,84177413,222421
9,ENSG00000178966.11,83980805,9-84006618-C-G,rs6559756,1,C,G,84006618,25813,83784197,84177413,222421
9,ENSG00000187210.8,76459182,9-76525740-T-G,rs6560531,1,T,G,76525740,66558,76262574,76655790,263166
9,ENSG00000187210.8,76459182,9-76525740-T-C,rs6560531,1,T,C,76525740,66558,76262574,76655790,263166
9,ENSG00000180549.7,137032088,9-137039568-G-A,rs6605,-1,G,A,137039568,7480,136835480,137228696,204088
9,ENSG00000176101.7,137188676,9-137207235-A-G,rs6606564,1,A,G,137207235,18559,136992068,137385284,215167
9,ENSG00000198113.2,137277726,9-137268088-A-G,rs67211234,1,A,G,137268088,9638,137081118,137474334,186970
9,ENSG00000198113.2,137277726,9-137268088-A-C,rs67211234,1,A,C,137268088,9638,137081118,137474334,186970
9,ENSG00000136878.7,129835458,9-129993991-T-C,rs7019010,1,T,C,129993991,158533,129638850,130032066,355141
9,ENSG00000136878.7,129835458,9-129993991-T-G,rs7019010,1,T,G,129993991,158533,129638850,130032066,355141
9,ENSG00000122692.7,33076674,9-33113324-C-A,rs7019909,-1,C,A,33113324,36650,32880066,33273282,233258
9,ENSG00000122692.7,33076674,9-33113324-C-T,rs7019909,-1,C,T,33113324,36650,32880066,33273282,233258
9,ENSG00000165233.13,93096217,9-93100259-G-A,rs7020130,1,G,A,93100259,4042,92899609,93292825,200650
9,ENSG00000119125.12,72149440,9-72148510-A-G,rs7021424,1,A,G,72148510,930,71952832,72346048,195678
9,ENSG00000135069.8,78297125,9-78223341-C-A,rs7022097,1,C,A,78223341,73784,78100517,78493733,122824
9,ENSG00000135069.8,78297125,9-78223341-C-T,rs7022097,1,C,T,78223341,73784,78100517,78493733,122824
9,ENSG00000136935.8,124941083,9-124911106-A-C,rs7022663,-1,A,C,124911106,29977,124744475,125137691,166631
9,ENSG00000136935.8,124941083,9-124911106-A-T,rs7022663,-1,A,T,124911106,29977,124744475,125137691,166631
9,ENSG00000135048.9,71768513,9-71868717-C-A,rs7023190,-1,C,A,71868717,100204,71571905,71965121,296812
9,ENSG00000135048.9,71768513,9-71868717-C-T,rs7023190,-1,C,T,71868717,100204,71571905,71965121,296812
9,ENSG00000136940.9,122828588,9-122821959-C-T,rs7023344,-1,C,T,122821959,6629,122631980,123025196,189979
9,ENSG00000119139.11,69174277,9-69179357-C-T,rs7023961,1,C,T,69179357,5080,68977669,69370885,201688
9,ENSG00000099219.9,5833117,9-5925878-C-T,rs7024130,-1,C,T,5925878,92761,5636509,6029725,289369
9,ENSG00000099219.9,5833117,9-5925878-C-A,rs7024130,-1,C,A,5925878,92761,5636509,6029725,289369
9,ENSG00000188938.10,93453581,9-93481463-A-C,rs7025805,-1,A,C,93481463,27882,93256973,93650189,224490
9,ENSG00000188938.10,93453581,9-93481463-A-G,rs7025805,-1,A,G,93481463,27882,93256973,93650189,224490
9,ENSG00000136928.4,98708935,9-98571785-A-C,rs7029361,-1,A,C,98571785,137150,98512327,98905543,59458
9,ENSG00000180071.12,38620596,9-38661419-A-G,rs7031991,-1,A,G,38661419,40823,38423988,38817204,237431
9,ENSG00000131669.5,93134251,9-93120619-T-C,rs7032525,-1,T,C,93120619,13632,92937643,93330859,182976
9,ENSG00000107242.11,68705240,9-68671055-A-G,rs7032654,1,A,G,68671055,34185,68508632,68901848,162423
9,ENSG00000119402.10,120793416,9-120838263-T-C,rs7035159,-1,T,C,120838263,44847,120596808,120990024,241455
9,ENSG00000164989.9,15553043,9-15683077-A-T,rs7035422,1,A,T,15683077,130034,15356435,15749651,326642
9,ENSG00000164989.9,15553043,9-15683077-A-G,rs7035422,1,A,G,15683077,130034,15356435,15749651,326642
9,ENSG00000164989.9,15553043,9-15683077-A-C,rs7035422,1,A,C,15683077,130034,15356435,15749651,326642
9,ENSG00000164978.12,34329569,9-34332742-A-C,rs7039222,1,A,C,34332742,3173,34132961,34526177,199781
9,ENSG00000164978.12,34329569,9-34332742-A-G,rs7039222,1,A,G,34332742,3173,34132961,34526177,199781
9,ENSG00000187866.5,68780065,9-68737577-T-C,rs7044422,1,T,C,68737577,42488,68583457,68976673,154120
9,ENSG00000187866.5,68780065,9-68737577-T-A,rs7044422,1,T,A,68737577,42488,68583457,68976673,154120
9,ENSG00000090054.8,92115413,9-92148533-G-T,rs7049168,-1,G,T,92148533,33120,91918805,92312021,229728
9,ENSG00000090054.8,92115413,9-92148533-G-A,rs7049168,-1,G,A,92148533,33120,91918805,92312021,229728
9,ENSG00000148154.5,111896814,9-111867962-A-G,rs716440,1,A,G,111867962,28852,111700206,112093422,167756
9,ENSG00000148154.5,111896814,9-111867962-A-C,rs716440,1,A,C,111867962,28852,111700206,112093422,167756
9,ENSG00000148154.5,111896814,9-111867962-A-T,rs716440,1,A,T,111867962,28852,111700206,112093422,167756
9,ENSG00000221829.4,35079942,9-35163510-C-G,rs72722992,-1,C,G,35163510,83568,34883334,35276550,280176
9,ENSG00000196781.8,81689547,9-81703136-A-G,rs72749025,-1,A,G,81703136,13589,81492939,81886155,210197
9,ENSG00000119401.9,116687305,9-116525236-C-T,rs72759981,1,C,T,116525236,162069,116490697,116883913,34539
9,ENSG00000187609.10,137423162,9-137411175-G-A,rs72765153,-1,G,A,137411175,11987,137226554,137619770,184621
9,ENSG00000187609.10,137423162,9-137411175-G-C,rs72765153,-1,G,C,137411175,11987,137226554,137619770,184621
9,ENSG00000148411.3,136095289,9-136078854-G-T,rs72773715,-1,G,T,136078854,16435,135898681,136291897,180173
9,ENSG00000148411.3,136095289,9-136078854-G-C,rs72773715,-1,G,C,136078854,16435,135898681,136291897,180173
9,ENSG00000148411.3,136095289,9-136078854-G-A,rs72773715,-1,G,A,136078854,16435,135898681,136291897,180173
9,ENSG00000188229.4,137241287,9-137373594-C-T,rs7389250,1,C,T,137373594,132307,137044679,137437895,328915
9,ENSG00000147862.9,14314141,9-14314797-T-C,rs74646167,-1,T,C,14314797,656,14117533,14510749,197264
9,ENSG00000197919.3,21440439,9-21531949-G-C,rs75145502,1,G,C,21531949,91510,21243831,21637047,288118
9,ENSG00000197919.3,21440439,9-21531949-G-T,rs75145502,1,G,T,21531949,91510,21243831,21637047,288118
9,ENSG00000165684.3,136400170,9-136398310-T-C,rs75200747,-1,T,C,136398310,1860,136203562,136596778,194748
9,ENSG00000137135.12,35665195,9-35753660-G-A,rs75446899,-1,G,A,35753660,88465,35468587,35861803,285073
9,ENSG00000165119.11,83980215,9-84118607-C-T,rs75556442,-1,C,T,84118607,138392,83783607,84176823,335000
9,ENSG00000184709.7,137170051,9-137155084-G-A,rs75845722,-1,G,A,137155084,14967,136973443,137366659,181641
9,ENSG00000135063.12,69325215,9-69319821-T-C,rs75984529,1,T,C,69319821,5394,69128607,69521823,191214
9,ENSG00000137070.12,34652185,9-34602786-G-T,rs77020248,1,G,T,34602786,49399,34455577,34848793,147209
9,ENSG00000137070.12,34652185,9-34602786-G-A,rs77020248,1,G,A,34602786,49399,34455577,34848793,147209
9,ENSG00000070159.7,109498307,9-109655621-C-T,rs77242551,-1,C,T,109655621,157314,109301699,109694915,353922
9,ENSG00000107104.12,504695,9-523504-C-A,rs77420486,1,C,A,523504,18809,308087,701303,215417
9,ENSG00000125485.12,132669983,9-132695048-C-T,rs7848496,-1,C,T,132695048,25065,132473375,132866591,221673
9,ENSG00000106927.5,114078300,9-114094885-T-A,rs7853169,-1,T,A,114094885,16585,113881692,114274908,213193
9,ENSG00000106927.5,114078300,9-114094885-T-C,rs7853169,-1,T,C,114094885,16585,113881692,114274908,213193
9,ENSG00000136811.9,128456152,9-128481915-C-T,rs7853988,1,C,T,128481915,25763,128259544,128652760,222371
9,ENSG00000119392.10,128504719,9-128481915-C-T,rs7853988,1,C,T,128481915,22804,128308111,128701327,173804
9,ENSG00000197816.8,97307659,9-97238449-A-G,rs7856254,1,A,G,97238449,69210,97111051,97504267,127398
9,ENSG00000130958.7,96383711,9-96511956-A-G,rs7856709,-1,A,G,96511956,128245,96187103,96580319,324853
9,ENSG00000158122.6,96655317,9-96511956-A-G,rs7856709,-1,A,G,96511956,143361,96458709,96851925,53247
9,ENSG00000119522.11,123930126,9-123916152-T-C,rs7859011,-1,T,C,123916152,13974,123733518,124126734,182634
9,ENSG00000119383.15,129111415,9-129208929-C-G,rs7861435,1,C,G,129208929,97514,128914807,129308023,294122
9,ENSG00000147912.8,37576380,9-37518764-G-A,rs7865834,-1,G,A,37518764,57616,37379772,37772988,138992
9,ENSG00000095321.10,129110793,9-129100800-T-G,rs7866897,-1,T,G,129100800,9993,128914185,129307401,186615
9,ENSG00000095321.10,129110793,9-129100800-T-A,rs7866897,-1,T,A,129100800,9993,128914185,129307401,186615
9,ENSG00000095321.10,129110793,9-129100800-T-C,rs7866897,-1,T,C,129100800,9993,128914185,129307401,186615
9,ENSG00000106992.13,127877675,9-127988522-G-A,rs7868260,-1,G,A,127988522,110847,127681067,128074283,307455
9,ENSG00000106992.13,127877675,9-127988522-G-C,rs7868260,-1,G,C,127988522,110847,127681067,128074283,307455
9,ENSG00000106992.13,127877675,9-127988522-G-T,rs7868260,-1,G,T,127988522,110847,127681067,128074283,307455
9,ENSG00000130222.6,89605012,9-89703305-G-C,rs7870796,1,G,C,89703305,98293,89408404,89801620,294901
9,ENSG00000130222.6,89605012,9-89703305-G-T,rs7870796,1,G,T,89703305,98293,89408404,89801620,294901
9,ENSG00000130222.6,89605012,9-89703305-G-A,rs7870796,1,G,A,89703305,98293,89408404,89801620,294901
9,ENSG00000168795.4,37465450,9-37384980-G-A,rs7871498,-1,G,A,37384980,80470,37268842,37662058,116138
9,ENSG00000119411.10,113349541,9-113351116-C-T,rs7873862,1,C,T,113351116,1575,113152933,113546149,198183
9,ENSG00000148019.7,78236075,9-78294491-C-T,rs7873943,1,C,T,78294491,58416,78039467,78432683,255024
9,ENSG00000106689.6,124011768,9-124002375-T-C,rs79165010,1,T,C,124002375,9393,123815160,124208376,187215
9,ENSG00000137076.12,35732195,9-35917953-C-T,rs79857739,-1,C,T,35917953,185758,35535587,35928803,382366
9,ENSG00000197646.6,5510531,9-5510742-A-G,rs80027732,1,A,G,5510742,211,5313923,5707139,196819
9,ENSG00000148357.11,130265760,9-130393974-G-A,rs80073481,1,G,A,130393974,128214,130069152,130462368,324822
9,ENSG00000148218.11,113401284,9-113403698-G-A,rs818692,-1,G,A,113403698,2414,113204676,113597892,199022
9,ENSG00000086102.13,33290516,9-33270750-G-C,rs831271,1,G,C,33270750,19766,33093908,33487124,176842
9,ENSG00000086102.13,33290516,9-33270750-G-T,rs831271,1,G,T,33270750,19766,33093908,33487124,176842
9,ENSG00000086062.7,33167336,9-33135087-G-A,rs913214,-1,G,A,33135087,32249,32970728,33363944,164359
9,ENSG00000130653.9,137550402,9-137592656-T-G,rs928046,-1,T,G,137592656,42254,137353794,137747010,238862
9,ENSG00000130653.9,137550402,9-137592656-T-C,rs928046,-1,T,C,137592656,42254,137353794,137747010,238862
9,ENSG00000130653.9,137550402,9-137592656-T-A,rs928046,-1,T,A,137592656,42254,137353794,137747010,238862
9,ENSG00000148110.10,94374569,9-94461012-C-T,rs9409550,1,C,T,94461012,86443,94177961,94571177,283051
9,ENSG00000148110.10,94374569,9-94461012-C-G,rs9409550,1,C,G,94461012,86443,94177961,94571177,283051
9,ENSG00000095319.8,128947699,9-128878753-C-G,rs941960,1,C,G,128878753,68946,128751091,129144307,127662
9,ENSG00000160445.6,128771927,9-128638786-T-C,rs945836,-1,T,C,128638786,133141,128575319,128968535,63467
9,ENSG00000106780.7,120714470,9-120691003-T-A,rs966396,-1,T,A,120691003,23467,120517862,120911078,173141
9,ENSG00000106780.7,120714470,9-120691003-T-C,rs966396,-1,T,C,120691003,23467,120517862,120911078,173141
9,ENSG00000188986.4,137255327,9-137250197-G-C,rs9802576,1,G,C,137250197,5130,137058719,137451935,191478
9,ENSG00000188986.4,137255327,9-137250197-G-T,rs9802576,1,G,T,137250197,5130,137058719,137451935,191478
9,ENSG00000188986.4,137255327,9-137250197-G-A,rs9802576,1,G,A,137250197,5130,137058719,137451935,191478
9,ENSG00000159921.8,36258448,9-36262123-C-T,rs10114702,-1,C,T,36262123,3675,36061840,36455056,200283
9,ENSG00000107242.11,68705240,9-68750547-T-C,rs10115871,1,T,C,68750547,45307,68508632,68901848,241915
9,ENSG00000107242.11,68705240,9-68750547-T-A,rs10115871,1,T,A,68750547,45307,68508632,68901848,241915
9,ENSG00000107242.11,68705240,9-68750547-T-G,rs10115871,1,T,G,68750547,45307,68508632,68901848,241915
9,ENSG00000130956.9,96450169,9-96413174-T-C,rs10122517,1,T,C,96413174,36995,96253561,96646777,159613
9,ENSG00000148053.11,84669729,9-84700202-T-A,rs1025743,1,T,A,84700202,30473,84473121,84866337,227081
9,ENSG00000148053.11,84669729,9-84700202-T-G,rs1025743,1,T,G,84700202,30473,84473121,84866337,227081
9,ENSG00000148053.11,84669729,9-84700202-T-C,rs1025743,1,T,C,84700202,30473,84473121,84866337,227081
9,ENSG00000136810.8,110256507,9-110186340-C-A,rs1041482,-1,C,A,110186340,70167,110059899,110453115,126441
9,ENSG00000136810.8,110256507,9-110186340-C-G,rs1041482,-1,C,G,110186340,70167,110059899,110453115,126441
9,ENSG00000119431.5,113376986,9-113373918-C-T,rs1043836,-1,C,T,113373918,3068,113180378,113573594,193540
9,ENSG00000119431.5,113376986,9-113373918-C-G,rs1043836,-1,C,G,113373918,3068,113180378,113573594,193540
9,ENSG00000159884.7,35658292,9-35659594-T-C,rs10441725,1,T,C,35659594,1302,35461684,35854900,197910
9,ENSG00000136870.6,101398851,9-101417666-A-G,rs10491511,1,A,G,101417666,18815,101202243,101595459,215423
9,ENSG00000127084.12,92947523,9-92850567-A-G,rs10491803,1,A,G,92850567,96956,92750915,93144131,99652
9,ENSG00000081377.12,96619843,9-96498292-A-G,rs10512238,-1,A,G,96498292,121551,96423235,96816451,75057
9,ENSG00000136867.6,113151007,9-113162652-C-G,rs10513187,1,C,G,113162652,11645,112954399,113347615,208253
9,ENSG00000196116.6,97412096,9-97513142-C-A,rs1052270,1,C,A,97513142,101046,97215488,97608704,297654
9,ENSG00000196116.6,97412096,9-97513142-C-T,rs1052270,1,C,T,97513142,101046,97215488,97608704,297654
9,ENSG00000107201.4,32526196,9-32409444-G-A,rs10738886,-1,G,A,32409444,116752,32329588,32722804,79856
9,ENSG00000107201.4,32526196,9-32409444-G-C,rs10738886,-1,G,C,32409444,116752,32329588,32722804,79856
9,ENSG00000086062.7,33167336,9-33107710-T-C,rs10758187,-1,T,C,33107710,59626,32970728,33363944,136982
9,ENSG00000086062.7,33167336,9-33107710-T-G,rs10758187,-1,T,G,33107710,59626,32970728,33363944,136982
9,ENSG00000122694.10,36136733,9-36310781-T-G,rs10758368,1,T,G,36310781,174048,35940125,36333341,370656
9,ENSG00000122694.10,36136733,9-36310781-T-C,rs10758368,1,T,C,36310781,174048,35940125,36333341,370656
9,ENSG00000148296.5,133336188,9-133331753-C-G,rs10793964,-1,C,G,133331753,4435,133139580,133532796,192173
9,ENSG00000148296.5,133336188,9-133331753-C-T,rs10793964,-1,C,T,133331753,4435,133139580,133532796,192173
9,ENSG00000147872.5,19127492,9-19152046-G-T,rs10811128,-1,G,T,19152046,24554,18930884,19324100,221162
9,ENSG00000086102.13,33290516,9-33104526-A-C,rs10813946,1,A,C,33104526,185990,33093908,33487124,10618
9,ENSG00000086102.13,33290516,9-33104526-A-G,rs10813946,1,A,G,33104526,185990,33093908,33487124,10618
9,ENSG00000086065.8,33265049,9-33420450-A-C,rs10813974,1,A,C,33420450,155401,33068441,33461657,352009
9,ENSG00000086065.8,33265049,9-33420450-A-G,rs10813974,1,A,G,33420450,155401,33068441,33461657,352009
9,ENSG00000107175.6,35732666,9-35910804-G-T,rs10814296,1,G,T,35910804,178138,35536058,35929274,374746
9,ENSG00000107175.6,35732666,9-35910804-G-C,rs10814296,1,G,C,35910804,178138,35536058,35929274,374746
9,ENSG00000107175.6,35732666,9-35910804-G-A,rs10814296,1,G,A,35910804,178138,35536058,35929274,374746
9,ENSG00000119321.4,113221277,9-113243503-C-G,rs10817465,-1,C,G,113243503,22226,113024669,113417885,218834
9,ENSG00000119321.4,113221277,9-113243503-C-T,rs10817465,-1,C,T,113243503,22226,113024669,113417885,218834
9,ENSG00000119408.11,124257949,9-124151583-T-C,rs10818924,1,T,C,124151583,106366,124061341,124454557,90242
9,ENSG00000170681.6,100578079,9-100675702-G-A,rs10819806,1,G,A,100675702,97623,100381471,100774687,294231
9,ENSG00000170681.6,100578079,9-100675702-G-T,rs10819806,1,G,T,100675702,97623,100381471,100774687,294231
9,ENSG00000165661.10,136245812,9-136227369-A-G,rs10858250,-1,A,G,136227369,18443,136049204,136442420,178165
9,ENSG00000119125.12,72149440,9-72164488-T-G,rs10869137,1,T,G,72164488,15048,71952832,72346048,211656
9,ENSG00000119125.12,72149440,9-72164488-T-C,rs10869137,1,T,C,72164488,15048,71952832,72346048,211656
9,ENSG00000198642.5,21335404,9-21347960-T-C,rs10964969,-1,T,C,21347960,12556,21138796,21532012,209164
9,ENSG00000205808.3,4662294,9-4677454-G-A,rs10974724,1,G,A,4677454,15160,4465686,4858902,211768
9,ENSG00000205808.3,4662294,9-4677454-G-T,rs10974724,1,G,T,4677454,15160,4465686,4858902,211768
9,ENSG00000178445.8,6645729,9-6617555-A-T,rs10975694,-1,A,T,6617555,28174,6449121,6842337,168434
9,ENSG00000095209.7,105694541,9-105686456-C-T,rs10978203,1,C,T,105686456,8085,105497933,105891149,188523
9,ENSG00000041982.9,115118157,9-115228517-C-T,rs10982619,-1,C,T,115228517,110360,114921549,115314765,306968
9,ENSG00000136842.8,97501666,9-97542249-A-G,rs10982622,1,A,G,97542249,40583,97305058,97698274,237191
9,ENSG00000182752.7,116153791,9-116075391-A-C,rs10983051,1,A,C,116075391,78400,115957183,116350399,118208
9,ENSG00000182752.7,116153791,9-116075391-A-G,rs10983051,1,A,G,116075391,78400,115957183,116350399,118208
9,ENSG00000119402.10,120793416,9-120941616-C-T,rs10985097,-1,C,T,120941616,148200,120596808,120990024,344808
9,ENSG00000119402.10,120793416,9-120941616-C-G,rs10985097,-1,C,G,120941616,148200,120596808,120990024,344808
9,ENSG00000167103.7,127930777,9-127970556-A-G,rs10987790,-1,A,G,127970556,39779,127734169,128127385,236387
9,ENSG00000127080.5,92670131,9-92789335-C-T,rs10992469,-1,C,T,92789335,119204,92473523,92866739,315812
9,ENSG00000185963.9,92764833,9-92826614-A-G,rs10992485,-1,A,G,92826614,61781,92568225,92961441,258389
9,ENSG00000185963.9,92764833,9-92826614-A-C,rs10992485,-1,A,C,92826614,61781,92568225,92961441,258389
9,ENSG00000158079.10,94084464,9-94099516-T-C,rs10993052,1,T,C,94099516,15052,93887856,94281072,211660
9,ENSG00000158079.10,94084464,9-94099516-T-G,rs10993052,1,T,G,94099516,15052,93887856,94281072,211660
9,ENSG00000158079.10,94084464,9-94099516-T-A,rs10993052,1,T,A,94099516,15052,93887856,94281072,211660
9,ENSG00000148019.7,78236075,9-78285761-C-T,rs11137585,1,C,T,78285761,49686,78039467,78432683,246294
9,ENSG00000148019.7,78236075,9-78285761-C-G,rs11137585,1,C,G,78285761,49686,78039467,78432683,246294
9,ENSG00000135069.8,78297125,9-78452332-A-C,rs11137682,1,A,C,78452332,155207,78100517,78493733,351815
9,ENSG00000172159.10,83538401,9-83450273-G-A,rs11140095,-1,G,A,83450273,88128,83341793,83735009,108480
9,ENSG00000172159.10,83538401,9-83450273-G-T,rs11140095,-1,G,T,83450273,88128,83341793,83735009,108480
9,ENSG00000154330.6,68356611,9-68493516-G-A,rs11142649,1,G,A,68493516,136905,68160003,68553219,333513
9,ENSG00000148384.11,136439845,9-136418520-G-T,rs11145967,-1,G,T,136418520,21325,136243237,136636453,175283
9,ENSG00000187609.10,137423162,9-137253313-C-G,rs1134511,-1,C,G,137253313,169849,137226554,137619770,26759
9,ENSG00000187609.10,137423162,9-137253313-C-T,rs1134511,-1,C,T,137253313,169849,137226554,137619770,26759
9,ENSG00000176248.6,137188560,9-137320206-G-C,rs113950356,-1,G,C,137320206,131646,136991952,137385168,328254
9,ENSG00000176248.6,137188560,9-137320206-G-A,rs113950356,-1,G,A,137320206,131646,136991952,137385168,328254
9,ENSG00000119446.8,122264840,9-122418727-C-T,rs11521582,-1,C,T,122418727,153887,122068232,122461448,350495
9,ENSG00000054148.13,136849409,9-136672437-G-T,rs11558192,1,G,T,136672437,176972,136652801,137046017,19636
9,ENSG00000054148.13,136849409,9-136672437-G-C,rs11558192,1,G,C,136672437,176972,136652801,137046017,19636
9,ENSG00000054148.13,136849409,9-136672437-G-A,rs11558192,1,G,A,136672437,176972,136652801,137046017,19636
9,ENSG00000148341.12,129028331,9-129074123-A-C,rs11564099,-1,A,C,129074123,45792,128831723,129224939,242400
9,ENSG00000148341.12,129028331,9-129074123-A-T,rs11564099,-1,A,T,129074123,45792,128831723,129224939,242400
9,ENSG00000148341.12,129028331,9-129074123-A-G,rs11564099,-1,A,G,129074123,45792,128831723,129224939,242400
9,ENSG00000095321.10,129110793,9-129282938-C-A,rs115802554,-1,C,A,129282938,172145,128914185,129307401,368753
9,ENSG00000165802.14,137459334,9-137349521-G-A,rs116575725,-1,G,A,137349521,109813,137262726,137655942,86795
9,ENSG00000165802.14,137459334,9-137349521-G-C,rs116575725,-1,G,C,137349521,109813,137262726,137655942,86795
9,ENSG00000119392.10,128504719,9-128358102-G-A,rs117199693,1,G,A,128358102,146617,128308111,128701327,49991
9,ENSG00000136861.11,120580167,9-120443420-C-T,rs117351867,-1,C,T,120443420,136747,120383559,120776775,59861
9,ENSG00000130957.4,94593824,9-94570392-C-T,rs117355087,-1,C,T,94570392,23432,94397216,94790432,173176
9,ENSG00000197724.6,93576584,9-93724846-C-A,rs117408675,1,C,A,93724846,148262,93379976,93773192,344870
9,ENSG00000197724.6,93576584,9-93724846-C-T,rs117408675,1,C,T,93724846,148262,93379976,93773192,344870
9,ENSG00000070159.7,109498307,9-109671425-T-C,rs117914628,-1,T,C,109671425,173118,109301699,109694915,369726
9,ENSG00000070159.7,109498307,9-109671425-T-G,rs117914628,-1,T,G,109671425,173118,109301699,109694915,369726
9,ENSG00000184709.7,137170051,9-137159684-T-C,rs11794201,-1,T,C,137159684,10367,136973443,137366659,186241
9,ENSG00000188483.6,129178261,9-129237489-G-T,rs11794903,-1,G,T,129237489,59228,128981653,129374869,255836
9,ENSG00000188483.6,129178261,9-129237489-G-A,rs11794903,-1,G,A,129237489,59228,128981653,129374869,255836
9,ENSG00000107159.7,35673928,9-35857852-G-A,rs118137738,1,G,A,35857852,183924,35477320,35870536,380532
9,ENSG00000167118.6,128371374,9-128374739-T-A,rs11999003,1,T,A,128374739,3365,128174766,128567982,199973
9,ENSG00000167118.6,128371374,9-128374739-T-C,rs11999003,1,T,C,128374739,3365,128174766,128567982,199973
9,ENSG00000167118.6,128371374,9-128374739-T-G,rs11999003,1,T,G,128374739,3365,128174766,128567982,199973
9,ENSG00000186638.9,34329268,9-34515330-T-C,rs12001113,-1,T,C,34515330,186062,34132660,34525876,382670
9,ENSG00000122729.11,32384643,9-32456019-G-T,rs12006123,1,G,T,32456019,71376,32188035,32581251,267984
9,ENSG00000122729.11,32384643,9-32456019-G-A,rs12006123,1,G,A,32456019,71376,32188035,32581251,267984
9,ENSG00000119414.7,125189803,9-125235024-G-T,rs12009,-1,G,T,125235024,45221,124993195,125386411,241829
9,ENSG00000119414.7,125189803,9-125235024-G-A,rs12009,-1,G,A,125235024,45221,124993195,125386411,241829
9,ENSG00000147852.9,2621787,9-2551654-T-C,rs12237653,1,T,C,2551654,70133,2425179,2818395,126475
9,ENSG00000135047.9,87726119,9-87888819-C-T,rs12238266,1,C,T,87888819,162700,87529511,87922727,359308
9,ENSG00000157693.10,114611291,9-114586186-G-A,rs12238437,1,G,A,114586186,25105,114414683,114807899,171503
9,ENSG00000119314.11,112333619,9-112383825-C-T,rs12335731,-1,C,T,112383825,50206,112137011,112530227,246814
9,ENSG00000136897.6,101398618,9-101307254-G-A,rs12337610,-1,G,A,101307254,91364,101202010,101595226,105244
9,ENSG00000147853.10,4741202,9-4740251-A-C,rs12348423,-1,A,C,4740251,951,4544594,4937810,195657
9,ENSG00000147853.10,4741202,9-4740251-A-G,rs12348423,-1,A,G,4740251,951,4544594,4937810,195657
9,ENSG00000148120.9,94726699,9-94702099-G-A,rs12349751,1,G,A,94702099,24600,94530091,94923307,172008
9,ENSG00000147862.9,14314141,9-14171855-G-C,rs12351537,-1,G,C,14171855,142286,14117533,14510749,54322
9,ENSG00000147862.9,14314141,9-14171855-G-A,rs12351537,-1,G,A,14171855,142286,14117533,14510749,54322
9,ENSG00000106780.7,120714470,9-120864255-A-G,rs12377227,-1,A,G,120864255,149785,120517862,120911078,346393
9,ENSG00000106976.12,128203379,9-128206889-T-G,rs12380222,1,T,G,128206889,3510,128006771,128399987,200118
9,ENSG00000106976.12,128203379,9-128206889-T-A,rs12380222,1,T,A,128206889,3510,128006771,128399987,200118
9,ENSG00000106976.12,128203379,9-128206889-T-C,rs12380222,1,T,C,128206889,3510,128006771,128399987,200118
9,ENSG00000137038.7,7799778,9-7798435-C-T,rs1254,-1,C,T,7798435,1343,7603170,7996386,195265
9,ENSG00000178031.9,18474153,9-18642146-A-G,rs12552620,1,A,G,18642146,167993,18277545,18670761,364601
9,ENSG00000126882.8,131276510,9-131470423-A-G,rs12682910,-1,A,G,131470423,193913,131079902,131473118,390521
9,ENSG00000126882.8,131276510,9-131470423-A-T,rs12682910,-1,A,T,131470423,193913,131079902,131473118,390521
9,ENSG00000126882.8,131276510,9-131470423-A-C,rs12682910,-1,A,C,131470423,193913,131079902,131473118,390521
9,ENSG00000198887.7,70258978,9-70068369-G-C,rs12685632,1,G,C,70068369,190609,70062370,70455586,5999
9,ENSG00000198887.7,70258978,9-70068369-G-A,rs12685632,1,G,A,70068369,190609,70062370,70455586,5999
9,ENSG00000099219.9,5833117,9-5656436-A-G,rs12685784,-1,A,G,5656436,176681,5636509,6029725,19927
9,ENSG00000148290.5,133356487,9-133360384-G-A,rs12763,-1,G,A,133360384,3897,133159879,133553095,200505
9,ENSG00000148290.5,133356487,9-133360384-G-T,rs12763,-1,G,T,133360384,3897,133159879,133553095,200505
9,ENSG00000197859.5,133534704,9-133677746-G-C,rs129889,1,G,C,133677746,143042,133338096,133731312,339650
9,ENSG00000197859.5,133534704,9-133677746-G-A,rs129889,1,G,A,133677746,143042,133338096,133731312,339650
9,ENSG00000048828.11,93451685,9-93291586-T-G,rs1317698,1,T,G,93291586,160099,93255077,93648293,36509
9,ENSG00000066697.10,100427143,9-100387705-T-A,rs13284428,1,T,A,100387705,39438,100230535,100623751,157170
9,ENSG00000066697.10,100427143,9-100387705-T-C,rs13284428,1,T,C,100387705,39438,100230535,100623751,157170
9,ENSG00000136783.9,104747683,9-104746345-C-A,rs13288256,1,C,A,104746345,1338,104551075,104944291,195270
9,ENSG00000136783.9,104747683,9-104746345-C-T,rs13288256,1,C,T,104746345,1338,104551075,104944291,195270
9,ENSG00000165283.10,35103131,9-34983193-C-T,rs13293550,-1,C,T,34983193,119938,34906523,35299739,76670
9,ENSG00000130707.12,130444961,9-130252358-G-A,rs13302591,1,G,A,130252358,192603,130248353,130641569,4005
9,ENSG00000130707.12,130444961,9-130252358-G-C,rs13302591,1,G,C,130252358,192603,130248353,130641569,4005
9,ENSG00000197355.6,137077517,9-137111750-G-A,rs13631,1,G,A,137111750,34233,136880909,137274125,230841
9,ENSG00000137054.10,37485948,9-37526451-A-G,rs1475414,1,A,G,37526451,40503,37289340,37682556,237111
9,ENSG00000137054.10,37485948,9-37526451-A-T,rs1475414,1,A,T,37526451,40503,37289340,37682556,237111
9,ENSG00000137054.10,37485948,9-37526451-A-C,rs1475414,1,A,C,37526451,40503,37289340,37682556,237111
9,ENSG00000090054.8,92115413,9-91939543-C-T,rs1534534,-1,C,T,91939543,175870,91918805,92312021,20738
9,ENSG00000106823.8,92535990,9-92611602-A-G,rs1552908,-1,A,G,92611602,75612,92339382,92732598,272220
9,ENSG00000106823.8,92535990,9-92611602-A-T,rs1552908,-1,A,T,92611602,75612,92339382,92732598,272220
9,ENSG00000165118.9,83956742,9-83956696-A-T,rs1572030,-1,A,T,83956696,46,83760134,84153350,196562
9,ENSG00000165118.9,83956742,9-83956696-A-G,rs1572030,-1,A,G,83956696,46,83760134,84153350,196562
9,ENSG00000136869.13,117704403,9-117747674-C-A,rs16906116,1,C,A,117747674,43271,117507795,117901011,239879
9,ENSG00000175764.10,122093308,9-121932951-A-T,rs16911128,-1,A,T,121932951,160357,121896700,122289916,36251
9,ENSG00000136866.9,113056724,9-112915112-T-C,rs16917488,-1,T,C,112915112,141612,112860116,113253332,54996
9,ENSG00000165280.11,35072625,9-34970200-T-C,rs16932097,-1,T,C,34970200,102425,34876017,35269233,94183
9,ENSG00000175893.6,14693432,9-14701853-G-C,rs16932197,-1,G,C,14701853,8421,14496824,14890040,205029
9,ENSG00000175893.6,14693432,9-14701853-G-A,rs16932197,-1,G,A,14701853,8421,14496824,14890040,205029
9,ENSG00000164985.9,15510970,9-15489083-T-C,rs16933326,-1,T,C,15489083,21887,15314362,15707578,174721
9,ENSG00000107372.8,72365208,9-72561797-G-A,rs17057894,-1,G,A,72561797,196589,72168600,72561816,393197
9,ENSG00000136950.9,124862130,9-124925937-T-C,rs17250311,1,T,C,124925937,63807,124665522,125058738,260415
9,ENSG00000159069.9,136944738,9-136918005-C-G,rs17250539,-1,C,G,136918005,26733,136748130,137141346,169875
9,ENSG00000159069.9,136944738,9-136918005-C-T,rs17250539,-1,C,T,136918005,26733,136748130,137141346,169875
9,ENSG00000070601.5,37650954,9-37743252-A-G,rs17508250,1,A,G,37743252,92298,37454346,37847562,288906
9,ENSG00000096872.10,26956412,9-27066072-T-C,rs17694631,1,T,C,27066072,109660,26759804,27153020,306268
9,ENSG00000119411.10,113349541,9-113316188-C-A,rs17764563,1,C,A,113316188,33353,113152933,113546149,163255
9,ENSG00000136824.13,104094309,9-104276307-G-C,rs17817167,1,G,C,104276307,181998,103897701,104290917,378606
9,ENSG00000136824.13,104094309,9-104276307-G-A,rs17817167,1,G,A,104276307,181998,103897701,104290917,378606
9,ENSG00000148218.11,113401284,9-113388911-A-G,rs1805313,-1,A,G,113388911,12373,113204676,113597892,184235
9,ENSG00000148218.11,113401284,9-113388911-A-T,rs1805313,-1,A,T,113388911,12373,113204676,113597892,184235
9,ENSG00000120162.8,27529814,9-27447436-G-A,rs1822725,-1,G,A,27447436,82378,27333206,27726422,114230
9,ENSG00000155621.8,71911639,9-72003760-T-C,rs1886255,1,T,C,72003760,92121,71715031,72108247,288729
9,ENSG00000155621.8,71911639,9-72003760-T-A,rs1886255,1,T,A,72003760,92121,71715031,72108247,288729
9,ENSG00000097007.11,130835254,9-130662285-G-A,rs1890599,1,G,A,130662285,172969,130638646,131031862,23639
9,ENSG00000160293.11,133992324,9-133961335-G-C,rs2073829,-1,G,C,133961335,30989,133795716,134188932,165619
9,ENSG00000160293.11,133992324,9-133961335-G-T,rs2073829,-1,G,T,133961335,30989,133795716,134188932,165619
9,ENSG00000160293.11,133992324,9-133961335-G-A,rs2073829,-1,G,A,133961335,30989,133795716,134188932,165619
9,ENSG00000160404.13,127735294,9-127870731-A-T,rs2094332,-1,A,T,127870731,135437,127538686,127931902,332045
9,ENSG00000160404.13,127735294,9-127870731-A-G,rs2094332,-1,A,G,127870731,135437,127538686,127931902,332045
9,ENSG00000119383.15,129111415,9-129095351-C-T,rs2229419,1,C,T,129095351,16064,128914807,129308023,180544
9,ENSG00000119383.15,129111415,9-129095351-C-G,rs2229419,1,C,G,129095351,16064,128914807,129308023,180544
9,ENSG00000175854.6,128276244,9-128257459-T-C,rs2240961,1,T,C,128257459,18785,128079636,128472852,177823
9,ENSG00000106927.5,114078300,9-114077924-A-G,rs2251680,-1,A,G,114077924,376,113881692,114274908,196232
9,ENSG00000106927.5,114078300,9-114077924-A-T,rs2251680,-1,A,T,114077924,376,113881692,114274908,196232
9,ENSG00000107331.10,137028237,9-137052352-C-G,rs2271867,-1,C,G,137052352,24115,136831629,137224845,220723
9,ENSG00000107331.10,137028237,9-137052352-C-T,rs2271867,-1,C,T,137052352,24115,136831629,137224845,220723
9,ENSG00000107331.10,137028237,9-137052352-C-A,rs2271867,-1,C,A,137052352,24115,136831629,137224845,220723
9,ENSG00000167106.6,127980989,9-127944802-A-G,rs2274426,-1,A,G,127944802,36187,127784381,128177597,160421
9,ENSG00000167136.6,128818500,9-128822352-C-T,rs2280844,1,C,T,128822352,3852,128621892,129015108,200460
9,ENSG00000137135.12,35665195,9-35650461-G-A,rs2297880,-1,G,A,35650461,14734,35468587,35861803,181874
9,ENSG00000137135.12,35665195,9-35650461-G-C,rs2297880,-1,G,C,35650461,14734,35468587,35861803,181874
9,ENSG00000134996.11,75088514,9-75075833-C-T,rs2376397,1,C,T,75075833,12681,74891906,75285122,183927
9,ENSG00000188921.11,21031640,9-20883200-C-G,rs2383169,-1,C,G,20883200,148440,20835032,21228248,48168
9,ENSG00000123453.10,133738352,9-133716297-C-G,rs2427981,-1,C,G,133716297,22055,133541744,133934960,174553
9,ENSG00000123453.10,133738352,9-133716297-C-T,rs2427981,-1,C,T,133716297,22055,133541744,133934960,174553
9,ENSG00000123453.10,133738352,9-133716297-C-A,rs2427981,-1,C,A,133716297,22055,133541744,133934960,174553
9,ENSG00000188152.6,96928843,9-96902072-C-T,rs2479209,1,C,T,96902072,26771,96732235,97125451,169837
9,ENSG00000182154.7,137551879,9-137670744-T-C,rs2501559,1,T,C,137670744,118865,137355271,137748487,315473
9,ENSG00000164989.9,15553043,9-15509621-A-G,rs2665503,1,A,G,15509621,43422,15356435,15749651,153186
9,ENSG00000137106.11,37422696,9-37400984-C-G,rs2768652,1,C,G,37400984,21712,37226088,37619304,174896
9,ENSG00000137106.11,37422696,9-37400984-C-T,rs2768652,1,C,T,37400984,21712,37226088,37619304,174896
9,ENSG00000136938.7,97983341,9-98149140-C-T,rs2795491,1,C,T,98149140,165799,97786733,98179949,362407
9,ENSG00000136874.6,99906654,9-99979193-G-T,rs2795575,1,G,T,99979193,72539,99710046,100103262,269147
9,ENSG00000136874.6,99906654,9-99979193-G-A,rs2795575,1,G,A,99979193,72539,99710046,100103262,269147
9,ENSG00000148362.6,136992422,9-136827061-T-G,rs2811751,1,T,G,136827061,165361,136795814,137189030,31247
9,ENSG00000148362.6,136992422,9-136827061-T-A,rs2811751,1,T,A,136827061,165361,136795814,137189030,31247
9,ENSG00000148362.6,136992422,9-136827061-T-C,rs2811751,1,T,C,136827061,165361,136795814,137189030,31247
9,ENSG00000187713.5,137205648,9-137233633-T-C,rs28407527,-1,T,C,137233633,27985,137009040,137402256,224593
9,ENSG00000196363.4,134136082,9-134129765-G-A,rs28412218,1,G,A,134129765,6317,133939474,134332690,190291
9,ENSG00000196363.4,134136082,9-134129765-G-T,rs28412218,1,G,T,134129765,6317,133939474,134332690,190291
9,ENSG00000176101.7,137188676,9-137181267-T-C,rs28451678,1,T,C,137181267,7409,136992068,137385284,189199
9,ENSG00000187796.9,136373669,9-136354445-G-A,rs28628657,-1,G,A,136354445,19224,136177061,136570277,177384
9,ENSG00000187796.9,136373669,9-136354445-G-C,rs28628657,-1,G,C,136354445,19224,136177061,136570277,177384
9,ENSG00000187796.9,136373669,9-136354445-G-T,rs28628657,-1,G,T,136354445,19224,136177061,136570277,177384
9,ENSG00000178966.11,83980805,9-83983529-G-T,rs296894,1,G,T,83983529,2724,83784197,84177413,199332
9,ENSG00000178966.11,83980805,9-83983529-G-A,rs296894,1,G,A,83983529,2724,83784197,84177413,199332
9,ENSG00000180071.12,38620596,9-38652717-G-T,rs2993174,-1,G,T,38652717,32121,38423988,38817204,228729
9,ENSG00000180071.12,38620596,9-38652717-G-A,rs2993174,-1,G,A,38652717,32121,38423988,38817204,228729
9,ENSG00000148175.8,121370250,9-121328857-G-A,rs306771,-1,G,A,121328857,41393,121173642,121566858,155215
9,ENSG00000130222.6,89605012,9-89604886-C-A,rs3138496,1,C,A,89604886,126,89408404,89801620,196482
9,ENSG00000130222.6,89605012,9-89604886-C-T,rs3138496,1,C,T,89604886,126,89408404,89801620,196482
9,ENSG00000130222.6,89605012,9-89604886-C-G,rs3138496,1,C,G,89604886,126,89408404,89801620,196482
9,ENSG00000106804.5,121050275,9-121116037-A-G,rs34680486,-1,A,G,121116037,65762,120853667,121246883,262370
9,ENSG00000160447.6,128702503,9-128628923-C-T,rs35782171,1,C,T,128628923,73580,128505895,128899111,123028
9,ENSG00000119471.10,112380108,9-112398025-G-C,rs35938444,1,G,C,112398025,17917,112183500,112576716,214525
9,ENSG00000119471.10,112380108,9-112398025-G-T,rs35938444,1,G,T,112398025,17917,112183500,112576716,214525
9,ENSG00000135070.9,86282538,9-86282976-A-G,rs3739733,-1,A,G,86282976,438,86085930,86479146,197046
9,ENSG00000135070.9,86282538,9-86282976-A-T,rs3739733,-1,A,T,86282976,438,86085930,86479146,197046
9,ENSG00000136816.10,129803184,9-129880569-T-C,rs3739858,1,T,C,129880569,77385,129606576,129999792,273993
9,ENSG00000180549.7,137032088,9-137088416-C-A,rs3750518,-1,C,A,137088416,56328,136835480,137228696,252936
9,ENSG00000180549.7,137032088,9-137088416-C-T,rs3750518,-1,C,T,137088416,56328,136835480,137228696,252936
9,ENSG00000107020.5,5437925,9-5340129-T-G,rs3758240,-1,T,G,5340129,97796,5241317,5634533,98812
9,ENSG00000107020.5,5437925,9-5340129-T-C,rs3758240,-1,T,C,5340129,97796,5241317,5634533,98812
9,ENSG00000204291.5,98943907,9-99037011-A-C,rs3780621,1,A,C,99037011,93104,98747299,99140515,289712
9,ENSG00000204291.5,98943907,9-99037011-A-G,rs3780621,1,A,G,99037011,93104,98747299,99140515,289712
9,ENSG00000095370.14,127778666,9-127762096-A-G,rs3780652,-1,A,G,127762096,16570,127582058,127975274,180038
9,ENSG00000095370.14,127778666,9-127762096-A-C,rs3780652,-1,A,C,127762096,16570,127582058,127975274,180038
9,ENSG00000196152.6,127424382,9-127367164-C-T,rs3802369,1,C,T,127367164,57218,127227774,127620990,139390
9,ENSG00000165684.3,136400170,9-136367539-A-G,rs3812556,-1,A,G,136367539,32631,136203562,136596778,163977
9,ENSG00000165684.3,136400170,9-136367539-A-C,rs3812556,-1,A,C,136367539,32631,136203562,136596778,163977
9,ENSG00000213221.4,136363744,9-136367539-A-G,rs3812556,-1,A,G,136367539,3795,136167136,136560352,200403
9,ENSG00000213221.4,136363744,9-136367539-A-C,rs3812556,-1,A,C,136367539,3795,136167136,136560352,200403
9,ENSG00000107021.11,128787253,9-128591710-G-A,rs3814530,1,G,A,128591710,195543,128590645,128983861,1065
9,ENSG00000107021.11,128787253,9-128591710-G-C,rs3814530,1,G,C,128591710,195543,128590645,128983861,1065
9,ENSG00000136856.11,127397169,9-127383345-G-T,rs3824415,1,G,T,127383345,13824,127200561,127593777,182784
9,ENSG00000136856.11,127397169,9-127383345-G-A,rs3824415,1,G,A,127383345,13824,127200561,127593777,182784
9,ENSG00000136891.8,100352942,9-100303602-C-T,rs3923501,-1,C,T,100303602,49340,100156334,100549550,147268
9,ENSG00000136891.8,100352942,9-100303602-C-A,rs3923501,-1,C,A,100303602,49340,100156334,100549550,147268
9,ENSG00000119403.8,120877188,9-120871670-A-G,rs3933326,-1,A,G,120871670,5518,120680580,121073796,191090
9,ENSG00000196781.8,81689547,9-81885879-T-C,rs3936878,-1,T,C,81885879,196332,81492939,81886155,392940
9,ENSG00000212864.2,137222240,9-137233413-G-C,rs4076685,-1,G,C,137233413,11173,137025632,137418848,207781
9,ENSG00000212864.2,137222240,9-137233413-G-A,rs4076685,-1,G,A,137233413,11173,137025632,137418848,207781
9,ENSG00000106789.8,98192637,9-98233736-T-C,rs41283620,-1,T,C,98233736,41099,97996029,98389245,237707
9,ENSG00000095203.8,109321059,9-109342264-A-C,rs4292768,-1,A,C,109342264,21205,109124451,109517667,217813
9,ENSG00000158122.6,96655317,9-96710220-C-T,rs4379561,-1,C,T,96710220,54903,96458709,96851925,251511
9,ENSG00000158122.6,96655317,9-96710220-C-A,rs4379561,-1,C,A,96710220,54903,96458709,96851925,251511
9,ENSG00000136868.8,113221544,9-113159563-C-A,rs4483236,1,C,A,113159563,61981,113024936,113418152,134627
9,ENSG00000136868.8,113221544,9-113159563-C-T,rs4483236,1,C,T,113159563,61981,113024936,113418152,134627
9,ENSG00000136868.8,113221544,9-113159563-C-G,rs4483236,1,C,G,113159563,61981,113024936,113418152,134627
9,ENSG00000120158.6,4792944,9-4855514-C-A,rs457417,1,C,A,4855514,62570,4596336,4989552,259178
9,ENSG00000120158.6,4792944,9-4855514-C-T,rs457417,1,C,T,4855514,62570,4596336,4989552,259178
9,ENSG00000120158.6,4792944,9-4855514-C-G,rs457417,1,C,G,4855514,62570,4596336,4989552,259178
9,ENSG00000164975.10,15422876,9-15424940-G-A,rs4741498,1,G,A,15424940,2064,15226268,15619484,198672
9,ENSG00000165138.11,98796555,9-98749858-G-A,rs4742738,-1,G,A,98749858,46697,98599947,98993163,149911
9,ENSG00000165138.11,98796555,9-98749858-G-C,rs4742738,-1,G,C,98749858,46697,98599947,98993163,149911
9,ENSG00000136881.7,101385006,9-101338601-A-T,rs4742811,-1,A,T,101338601,46405,101188398,101581614,150203
9,ENSG00000136881.7,101385006,9-101338601-A-G,rs4742811,-1,A,G,101338601,46405,101188398,101581614,150203
9,ENSG00000135046.9,73151865,9-73129076-C-T,rs4745215,1,C,T,73129076,22789,72955257,73348473,173819
9,ENSG00000148180.9,121268162,9-121084342-A-T,rs4837808,1,A,T,121084342,183820,121071554,121464770,12788
9,ENSG00000148180.9,121268162,9-121084342-A-G,rs4837808,1,A,G,121084342,183820,121071554,121464770,12788
9,ENSG00000148180.9,121268162,9-121084342-A-C,rs4837808,1,A,C,121084342,183820,121071554,121464770,12788
9,ENSG00000148187.12,122264882,9-122222310-C-T,rs4837950,1,C,T,122222310,42572,122068274,122461490,154036
9,ENSG00000148187.12,122264882,9-122222310-C-A,rs4837950,1,C,A,122222310,42572,122068274,122461490,154036
9,ENSG00000148187.12,122264882,9-122222310-C-G,rs4837950,1,C,G,122222310,42572,122068274,122461490,154036
9,ENSG00000107223.8,136866308,9-136982031-G-T,rs4880180,-1,G,T,136982031,115723,136669700,137062916,312331
9,ENSG00000155158.13,15307360,9-15308156-G-A,rs491322,-1,G,A,15308156,796,15110752,15503968,197404
9,ENSG00000155158.13,15307360,9-15308156-G-C,rs491322,-1,G,C,15308156,796,15110752,15503968,197404
9,ENSG00000160271.9,133121240,9-133183495-T-A,rs4962101,-1,T,A,133183495,62255,132924632,133317848,258863
9,ENSG00000160271.9,133121240,9-133183495-T-C,rs4962101,-1,T,C,133183495,62255,132924632,133317848,258863
9,ENSG00000160271.9,133121240,9-133183495-T-G,rs4962101,-1,T,G,133183495,62255,132924632,133317848,258863
9,ENSG00000196358.5,132162058,9-132245816-T-G,rs4962175,1,T,G,132245816,83758,131965450,132358666,280366
9,ENSG00000196358.5,132162058,9-132245816-T-C,rs4962175,1,T,C,132245816,83758,131965450,132358666,280366
9,ENSG00000130653.9,137550402,9-137461922-C-G,rs4962240,-1,C,G,137461922,88480,137353794,137747010,108128
9,ENSG00000130653.9,137550402,9-137461922-C-T,rs4962240,-1,C,T,137461922,88480,137353794,137747010,108128
9,ENSG00000130653.9,137550402,9-137461922-C-A,rs4962240,-1,C,A,137461922,88480,137353794,137747010,108128
9,ENSG00000188959.9,110208159,9-110140281-G-A,rs4978873,-1,G,A,110140281,67878,110011551,110404767,128730
9,ENSG00000136872.10,101435774,9-101432250-T-A,rs533017,-1,T,A,101432250,3524,101239166,101632382,193084
9,ENSG00000136872.10,101435774,9-101432250-T-G,rs533017,-1,T,G,101432250,3524,101239166,101632382,193084
9,ENSG00000136872.10,101435774,9-101432250-T-C,rs533017,-1,T,C,101432250,3524,101239166,101632382,193084
9,ENSG00000204136.6,121499844,9-121581314-T-C,rs603757,-1,T,C,121581314,81470,121303236,121696452,278078
9,ENSG00000160325.9,133459978,9-133346666-C-T,rs616836,1,C,T,133346666,113312,133263370,133656586,83296
9,ENSG00000160325.9,133459978,9-133346666-C-A,rs616836,1,C,A,133346666,113312,133263370,133656586,83296
9,ENSG00000160325.9,133459978,9-133346666-C-G,rs616836,1,C,G,133346666,113312,133263370,133656586,83296
9,ENSG00000148300.6,133418010,9-133361131-C-T,rs61751475,-1,C,T,133361131,56879,133221402,133614618,139729
9,ENSG00000137070.12,34652185,9-34807949-T-C,rs62544923,1,T,C,34807949,155764,34455577,34848793,352372
9,ENSG00000164970.10,34458570,9-34409979-C-T,rs62559871,-1,C,T,34409979,48591,34261962,34655178,148017
9,ENSG00000080503.14,2015347,9-1975279-G-C,rs6475359,1,G,C,1975279,40068,1818739,2211955,156540
9,ENSG00000080503.14,2015347,9-1975279-G-A,rs6475359,1,G,A,1975279,40068,1818739,2211955,156540
9,ENSG00000157303.5,93058701,9-93130161-A-T,rs6479454,1,A,T,93130161,71460,92862093,93255309,268068
9,ENSG00000157303.5,93058701,9-93130161-A-G,rs6479454,1,A,G,93130161,71460,92862093,93255309,268068
9,ENSG00000157303.5,93058701,9-93130161-A-C,rs6479454,1,A,C,93130161,71460,92862093,93255309,268068
9,ENSG00000160323.13,133422367,9-133445896-G-A,rs652600,1,G,A,133445896,23529,133225759,133618975,220137
9,ENSG00000136933.12,125200542,9-125071998-G-C,rs656322,1,G,C,125071998,128544,125003934,125397150,68064
9,ENSG00000136933.12,125200542,9-125071998-G-A,rs656322,1,G,A,125071998,128544,125003934,125397150,68064
9,ENSG00000070061.10,108934124,9-109079914-A-T,rs674178,-1,A,T,109079914,145790,108737516,109130732,342398
9,ENSG00000070061.10,108934124,9-109079914-A-C,rs674178,-1,A,C,109079914,145790,108737516,109130732,342398
9,ENSG00000122728.6,32635669,9-32822211-C-G,rs680103,-1,C,G,32822211,186542,32439061,32832277,383150
9,ENSG00000122728.6,32635669,9-32822211-C-A,rs680103,-1,C,A,32822211,186542,32439061,32832277,383150
9,ENSG00000122728.6,32635669,9-32822211-C-T,rs680103,-1,C,T,32822211,186542,32439061,32832277,383150
9,ENSG00000119514.5,98807670,9-98673449-G-A,rs7019449,1,G,A,98673449,134221,98611062,99004278,62387
9,ENSG00000135063.12,69325215,9-69284053-C-A,rs7019607,1,C,A,69284053,41162,69128607,69521823,155446
9,ENSG00000135063.12,69325215,9-69284053-C-T,rs7019607,1,C,T,69284053,41162,69128607,69521823,155446
9,ENSG00000107362.9,71911193,9-71868717-C-T,rs7023190,-1,C,T,71868717,42476,71714585,72107801,154132
9,ENSG00000107362.9,71911193,9-71868717-C-A,rs7023190,-1,C,A,71868717,42476,71714585,72107801,154132
9,ENSG00000164978.12,34329569,9-34336268-C-T,rs7025269,1,C,T,34336268,6699,34132961,34526177,203307
9,ENSG00000136827.9,129824136,9-129794931-T-C,rs7025992,-1,T,C,129794931,29205,129627528,130020744,167403
9,ENSG00000136827.9,129824136,9-129794931-T-A,rs7025992,-1,T,A,129794931,29205,129627528,130020744,167403
9,ENSG00000083223.12,86354410,9-86459769-T-G,rs7026472,-1,T,G,86459769,105359,86157802,86551018,301967
9,ENSG00000107262.11,33264708,9-33354238-T-G,rs7027207,-1,T,G,33354238,89530,33068100,33461316,286138
9,ENSG00000165119.11,83980215,9-84055778-C-A,rs7029362,-1,C,A,84055778,75563,83783607,84176823,272171
9,ENSG00000165119.11,83980215,9-84055778-C-G,rs7029362,-1,C,G,84055778,75563,83783607,84176823,272171
9,ENSG00000119326.10,109013499,9-109037987-G-A,rs7029890,-1,G,A,109037987,24488,108816891,109210107,221096
9,ENSG00000119421.5,122159779,9-122198676-G-A,rs7030904,-1,G,A,122198676,38897,121963171,122356387,235505
9,ENSG00000164967.5,34612097,9-34582885-T-C,rs7032335,-1,T,C,34582885,29212,34415489,34808705,167396
9,ENSG00000164967.5,34612097,9-34582885-T-G,rs7032335,-1,T,G,34582885,29212,34415489,34808705,167396
9,ENSG00000154529.8,42129426,9-42211508-A-G,rs7032438,-1,A,G,42211508,82082,41932818,42326034,278690
9,ENSG00000165025.10,90801819,9-90810063-G-A,rs7032733,1,G,A,90810063,8244,90605211,90998427,204852
9,ENSG00000184434.7,27005672,9-26958441-C-G,rs7037860,-1,C,G,26958441,47231,26809064,27202280,149377
9,ENSG00000184434.7,27005672,9-26958441-C-A,rs7037860,-1,C,A,26958441,47231,26809064,27202280,149377
9,ENSG00000107018.5,5339876,9-5186332-C-T,rs7038681,-1,C,T,5186332,153544,5143268,5536484,43064
9,ENSG00000119139.11,69174277,9-69198655-T-A,rs7043149,1,T,A,69198655,24378,68977669,69370885,220986
9,ENSG00000119139.11,69174277,9-69198655-T-C,rs7043149,1,T,C,69198655,24378,68977669,69370885,220986
9,ENSG00000148110.10,94374569,9-94446035-T-C,rs7045712,1,T,C,94446035,71466,94177961,94571177,268074
9,ENSG00000198963.5,74497335,9-74693674-G-T,rs72730919,1,G,T,74693674,196339,74300727,74693943,392947
9,ENSG00000198963.5,74497335,9-74693674-G-A,rs72730919,1,G,A,74693674,196339,74300727,74693943,392947
9,ENSG00000148400.9,136546048,9-136738755-C-A,rs73668366,-1,C,A,136738755,192707,136349440,136742656,389315
9,ENSG00000106803.5,99222282,9-99200128-G-A,rs74437514,1,G,A,99200128,22154,99025674,99418890,174454
9,ENSG00000130559.14,135907546,9-136074817-G-A,rs74443985,-1,G,A,136074817,167271,135710938,136104154,363879
9,ENSG00000137055.10,26947242,9-26862961-G-C,rs74742269,-1,G,C,26862961,84281,26750634,27143850,112327
9,ENSG00000137055.10,26947242,9-26862961-G-A,rs74742269,-1,G,A,26862961,84281,26750634,27143850,112327
9,ENSG00000165233.13,93096217,9-93192737-T-C,rs75694376,1,T,C,93192737,96520,92899609,93292825,293128
9,ENSG00000119523.8,99221942,9-99248056-A-G,rs76235977,-1,A,G,99248056,26114,99025334,99418550,222722
9,ENSG00000197969.6,77177534,9-77137384-G-A,rs76607186,1,G,A,77137384,40150,76980926,77374142,156458
9,ENSG00000165264.6,32573159,9-32698402-G-T,rs76843843,-1,G,T,32698402,125243,32376551,32769767,321851
9,ENSG00000172889.10,136662916,9-136612604-G-A,rs77277738,1,G,A,136612604,50312,136466308,136859524,146296
9,ENSG00000106733.15,75088155,9-75054749-T-A,rs773146,-1,T,A,75054749,33406,74891547,75284763,163202
9,ENSG00000106733.15,75088155,9-75054749-T-G,rs773146,-1,T,G,75054749,33406,74891547,75284763,163202
9,ENSG00000106733.15,75088155,9-75054749-T-C,rs773146,-1,T,C,75054749,33406,74891547,75284763,163202
9,ENSG00000165275.5,37753805,9-37936467-C-A,rs776021,1,C,A,37936467,182662,37557197,37950413,379270
9,ENSG00000165275.5,37753805,9-37936467-C-T,rs776021,1,C,T,37936467,182662,37557197,37950413,379270
9,ENSG00000136928.4,98708935,9-98780550-C-G,rs78235211,-1,C,G,98780550,71615,98512327,98905543,268223
9,ENSG00000136928.4,98708935,9-98780550-C-T,rs78235211,-1,C,T,98780550,71615,98512327,98905543,268223
9,ENSG00000136928.4,98708935,9-98780550-C-A,rs78235211,-1,C,A,98780550,71615,98512327,98905543,268223
9,ENSG00000176058.7,137200741,9-137255836-C-T,rs78469234,-1,C,T,137255836,55095,137004133,137397349,251703
9,ENSG00000189357.4,81928428,9-81774816-A-C,rs7847362,1,A,C,81774816,153612,81731820,82125036,42996
9,ENSG00000186788.8,81943500,9-81774816-A-C,rs7847362,1,A,C,81774816,168684,81746892,82140108,27924
9,ENSG00000054179.6,137054061,9-137053021-G-T,rs7861020,-1,G,T,137053021,1040,136857453,137250669,195568
9,ENSG00000107281.5,137046177,9-137053021-G-T,rs7861020,-1,G,T,137053021,6844,136849569,137242785,203452
9,ENSG00000137040.8,6015624,9-6090276-T-C,rs7865727,-1,T,C,6090276,74652,5819016,6212232,271260
9,ENSG00000183354.7,6008482,9-6090276-T-C,rs7865727,-1,T,C,6090276,81794,5811874,6205090,278402
9,ENSG00000167123.11,128420857,9-128536949-C-T,rs7871140,1,C,T,128536949,116092,128224249,128617465,312700
9,ENSG00000106853.11,111599647,9-111624855-A-G,rs7875749,-1,A,G,111624855,25208,111403039,111796255,221816
9,ENSG00000175768.8,37592597,9-37414685-G-A,rs78924091,-1,G,A,37414685,177912,37395989,37789205,18696
9,ENSG00000120217.9,5450542,9-5510742-A-G,rs80027732,1,A,G,5510742,60200,5253934,5647150,256808
9,ENSG00000181090.12,137619005,9-137618188-G-C,rs821311,1,G,C,137618188,817,137422397,137815613,195791
9,ENSG00000181090.12,137619005,9-137618188-G-A,rs821311,1,G,A,137618188,817,137422397,137815613,195791
9,ENSG00000106771.7,109119947,9-108930852-T-C,rs838818,-1,T,C,108930852,189095,108923339,109316555,7513
9,ENSG00000106771.7,109119947,9-108930852-T-A,rs838818,-1,T,A,108930852,189095,108923339,109316555,7513
9,ENSG00000122140.6,135500682,9-135554128-C-T,rs895189,1,C,T,135554128,53446,135304074,135697290,250054
9,ENSG00000122140.6,135500682,9-135554128-C-G,rs895189,1,C,G,135554128,53446,135304074,135697290,250054
9,ENSG00000095303.10,122371024,9-122199025-G-A,rs913935,1,G,A,122199025,171999,122174416,122567632,24609
9,ENSG00000187922.9,136742940,9-136644302-T-A,rs914746,-1,T,A,136644302,98638,136546332,136939548,97970
9,ENSG00000187922.9,136742940,9-136644302-T-C,rs914746,-1,T,C,136644302,98638,136546332,136939548,97970
9,ENSG00000187922.9,136742940,9-136644302-T-G,rs914746,-1,T,G,136644302,98638,136546332,136939548,97970
9,ENSG00000165724.5,137590512,9-137592656-T-C,rs928046,-1,T,C,137592656,2144,137393904,137787120,198752
9,ENSG00000165724.5,137590512,9-137592656-T-G,rs928046,-1,T,G,137592656,2144,137393904,137787120,198752
9,ENSG00000165724.5,137590512,9-137592656-T-A,rs928046,-1,T,A,137592656,2144,137393904,137787120,198752
9,ENSG00000148408.8,137877782,9-137856943-G-A,rs9410147,1,G,A,137856943,20839,137681174,138074390,175769
9,ENSG00000148408.8,137877782,9-137856943-G-T,rs9410147,1,G,T,137856943,20839,137681174,138074390,175769
9,ENSG00000148399.7,137578925,9-137453949-T-C,rs9410194,-1,T,C,137453949,124976,137382317,137775533,71632
9,ENSG00000148399.7,137578925,9-137453949-T-A,rs9410194,-1,T,A,137453949,124976,137382317,137775533,71632
9,ENSG00000148399.7,137578925,9-137453949-T-G,rs9410194,-1,T,G,137453949,124976,137382317,137775533,71632
9,ENSG00000106785.9,98119222,9-98127058-G-T,rs942165,-1,G,T,98127058,7836,97922614,98315830,204444
9,ENSG00000106785.9,98119222,9-98127058-G-A,rs942165,-1,G,A,98127058,7836,97922614,98315830,204444
9,ENSG00000119328.7,108934400,9-108760820-A-T,rs946708,1,A,T,108760820,173580,108737792,109131008,23028
9,ENSG00000119328.7,108934400,9-108760820-A-G,rs946708,1,A,G,108760820,173580,108737792,109131008,23028
9,ENSG00000238227.3,136118875,9-136106764-A-T,rs959016,-1,A,T,136106764,12111,135922267,136315483,184497
9,ENSG00000238227.3,136118875,9-136106764-A-G,rs959016,-1,A,G,136106764,12111,135922267,136315483,184497
9,ENSG00000238227.3,136118875,9-136106764-A-C,rs959016,-1,A,C,136106764,12111,135922267,136315483,184497
9,ENSG00000188986.4,137255327,9-137394607-G-A,rs9721793,1,G,A,137394607,139280,137058719,137451935,335888
9,ENSG00000106771.7,109119947,9-109187808-G-T,rs10116353,-1,G,T,109187808,67861,108923339,109316555,264469
9,ENSG00000106771.7,109119947,9-109187808-G-A,rs10116353,-1,G,A,109187808,67861,108923339,109316555,264469
9,ENSG00000165698.11,132878898,9-132892556-C-T,rs1050700,1,C,T,132892556,13658,132682290,133075506,210266
9,ENSG00000165698.11,132878898,9-132892556-C-A,rs1050700,1,C,A,132892556,13658,132682290,133075506,210266
9,ENSG00000096872.10,26956412,9-26797403-G-C,rs10511773,1,G,C,26797403,159009,26759804,27153020,37599
9,ENSG00000096872.10,26956412,9-26797403-G-A,rs10511773,1,G,A,26797403,159009,26759804,27153020,37599
9,ENSG00000135046.9,73151865,9-73166330-T-G,rs10512015,1,T,G,73166330,14465,72955257,73348473,211073
9,ENSG00000135046.9,73151865,9-73166330-T-C,rs10512015,1,T,C,73166330,14465,72955257,73348473,211073
9,ENSG00000119411.10,113349541,9-113262679-A-G,rs10513202,1,A,G,113262679,86862,113152933,113546149,109746
9,ENSG00000122705.10,36190921,9-36211830-C-T,rs1053414,1,C,T,36211830,20909,35994313,36387529,217517
9,ENSG00000148296.5,133336188,9-133470702-C-G,rs1054379,-1,C,G,133470702,134514,133139580,133532796,331122
9,ENSG00000148296.5,133336188,9-133470702-C-T,rs1054379,-1,C,T,133470702,134514,133139580,133532796,331122
9,ENSG00000164985.9,15510970,9-15451868-A-T,rs10738397,-1,A,T,15451868,59102,15314362,15707578,137506
9,ENSG00000164985.9,15510970,9-15451868-A-G,rs10738397,-1,A,G,15451868,59102,15314362,15707578,137506
9,ENSG00000136875.7,113275658,9-113172572-C-T,rs10739387,1,C,T,113172572,103086,113079050,113472266,93522
9,ENSG00000136875.7,113275658,9-113172572-C-A,rs10739387,1,C,A,113172572,103086,113079050,113472266,93522
9,ENSG00000136875.7,113275658,9-113172572-C-G,rs10739387,1,C,G,113172572,103086,113079050,113472266,93522
9,ENSG00000148187.12,122264882,9-122248579-G-C,rs10739607,1,G,C,122248579,16303,122068274,122461490,180305
9,ENSG00000148187.12,122264882,9-122248579-G-T,rs10739607,1,G,T,122248579,16303,122068274,122461490,180305
9,ENSG00000148187.12,122264882,9-122248579-G-A,rs10739607,1,G,A,122248579,16303,122068274,122461490,180305
9,ENSG00000197958.8,127451406,9-127346159-A-C,rs10739691,-1,A,C,127346159,105247,127254798,127648014,91361
9,ENSG00000197958.8,127451406,9-127346159-A-T,rs10739691,-1,A,T,127346159,105247,127254798,127648014,91361
9,ENSG00000197958.8,127451406,9-127346159-A-G,rs10739691,-1,A,G,127346159,105247,127254798,127648014,91361
9,ENSG00000130950.8,94328644,9-94215368-T-C,rs10739973,-1,T,C,94215368,113276,94132036,94525252,83332
9,ENSG00000130950.8,94328644,9-94215368-T-A,rs10739973,-1,T,A,94215368,113276,94132036,94525252,83332
9,ENSG00000159069.9,136944738,9-136759012-T-A,rs10747035,-1,T,A,136759012,185726,136748130,137141346,10882
9,ENSG00000159069.9,136944738,9-136759012-T-G,rs10747035,-1,T,G,136759012,185726,136748130,137141346,10882
9,ENSG00000137054.10,37485948,9-37591239-T-G,rs10758442,1,T,G,37591239,105291,37289340,37682556,301899
9,ENSG00000188959.9,110208159,9-110156251-A-G,rs10759392,-1,A,G,110156251,51908,110011551,110404767,144700
9,ENSG00000188959.9,110208159,9-110156251-A-T,rs10759392,-1,A,T,110156251,51908,110011551,110404767,144700
9,ENSG00000188959.9,110208159,9-110156251-A-C,rs10759392,-1,A,C,110156251,51908,110011551,110404767,144700
9,ENSG00000136842.8,97501666,9-97510720-G-A,rs10759742,1,G,A,97510720,9054,97305058,97698274,205662
9,ENSG00000136842.8,97501666,9-97510720-G-T,rs10759742,1,G,T,97510720,9054,97305058,97698274,205662
9,ENSG00000136925.9,97633368,9-97510720-G-A,rs10759742,-1,G,A,97510720,122648,97436760,97829976,73960
9,ENSG00000136925.9,97633368,9-97510720-G-T,rs10759742,-1,G,T,97510720,122648,97436760,97829976,73960
9,ENSG00000134996.11,75088514,9-75194126-C-G,rs10781268,1,C,G,75194126,105612,74891906,75285122,302220
9,ENSG00000134996.11,75088514,9-75194126-C-A,rs10781268,1,C,A,75194126,105612,74891906,75285122,302220
9,ENSG00000137106.11,37422696,9-37302158-C-G,rs10814518,1,C,G,37302158,120538,37226088,37619304,76070
9,ENSG00000137106.11,37422696,9-37302158-C-T,rs10814518,1,C,T,37302158,120538,37226088,37619304,76070
9,ENSG00000095383.14,98255649,9-98088685-A-G,rs10818472,-1,A,G,98088685,166964,98059041,98452257,29644
9,ENSG00000136940.9,122828588,9-122823630-A-G,rs10818752,-1,A,G,122823630,4958,122631980,123025196,191650
9,ENSG00000119383.15,129111415,9-129270358-T-C,rs10819484,1,T,C,129270358,158943,128914807,129308023,355551
9,ENSG00000136881.7,101385006,9-101428804-C-T,rs10819931,-1,C,T,101428804,43798,101188398,101581614,240406
9,ENSG00000197506.6,84340758,9-84370075-T-A,rs10868154,-1,T,A,84370075,29317,84144150,84537366,225925
9,ENSG00000106772.11,76906114,9-76822531-G-A,rs10869826,-1,G,A,76822531,83583,76709506,77102722,113025
9,ENSG00000107099.9,214865,9-245706-C-T,rs10965932,1,C,T,245706,30841,18257,411473,227449
9,ENSG00000147852.9,2621787,9-2551594-A-G,rs10966901,1,A,G,2551594,70193,2425179,2818395,126415
9,ENSG00000137073.14,34048887,9-33925678-G-C,rs10971796,-1,G,C,33925678,123209,33852279,34245495,73399
9,ENSG00000137073.14,34048887,9-33925678-G-A,rs10971796,-1,G,A,33925678,123209,33852279,34245495,73399
9,ENSG00000196092.7,37034268,9-37049894-G-A,rs10973169,-1,G,A,37049894,15626,36837660,37230876,212234
9,ENSG00000107036.7,5629107,9-5544405-A-G,rs10975175,1,A,G,5544405,84702,5432499,5825715,111906
9,ENSG00000119326.10,109013499,9-109191835-T-C,rs10979739,-1,T,C,109191835,178336,108816891,109210107,374944
9,ENSG00000173258.8,111525179,9-111531354-A-G,rs10980926,1,A,G,111531354,6175,111328571,111721787,202783
9,ENSG00000119314.11,112333619,9-112154680-T-C,rs10981287,-1,T,C,112154680,178939,112137011,112530227,17669
9,ENSG00000119314.11,112333619,9-112154680-T-G,rs10981287,-1,T,G,112154680,178939,112137011,112530227,17669
9,ENSG00000119431.5,113376986,9-113354203-A-G,rs10981762,-1,A,G,113354203,22783,113180378,113573594,173825
9,ENSG00000214654.5,120793467,9-120736057-C-T,rs10985015,1,C,T,120736057,57410,120596859,120990075,139198
9,ENSG00000095303.10,122371024,9-122203423-C-T,rs10985563,1,C,T,122203423,167601,122174416,122567632,29007
9,ENSG00000044574.6,125241343,9-125386112-T-A,rs10986735,-1,T,A,125386112,144769,125044735,125437951,341377
9,ENSG00000044574.6,125241343,9-125386112-T-C,rs10986735,-1,T,C,125386112,144769,125044735,125437951,341377
9,ENSG00000148358.12,130053906,9-130178768-C-A,rs10988632,1,C,A,130178768,124862,129857298,130250514,321470
9,ENSG00000148358.12,130053906,9-130178768-C-G,rs10988632,1,C,G,130178768,124862,129857298,130250514,321470
9,ENSG00000148358.12,130053906,9-130178768-C-T,rs10988632,1,C,T,130178768,124862,129857298,130250514,321470
9,ENSG00000154330.6,68356611,9-68420787-T-C,rs11142199,1,T,C,68420787,64176,68160003,68553219,260784
9,ENSG00000213213.6,136796338,9-136619223-G-C,rs11145804,1,G,C,136619223,177115,136599730,136992946,19493
9,ENSG00000213213.6,136796338,9-136619223-G-A,rs11145804,1,G,A,136619223,177115,136599730,136992946,19493
9,ENSG00000148291.5,133356550,9-133205932-C-G,rs11244035,1,C,G,133205932,150618,133159942,133553158,45990
9,ENSG00000148291.5,133356550,9-133205932-C-T,rs11244035,1,C,T,133205932,150618,133159942,133553158,45990
9,ENSG00000188747.4,137423393,9-137431510-G-C,rs11534415,1,G,C,137431510,8117,137226785,137620001,204725
9,ENSG00000188747.4,137423393,9-137431510-G-A,rs11534415,1,G,A,137431510,8117,137226785,137620001,204725
9,ENSG00000197070.9,137605686,9-137785776-G-A,rs117211698,1,G,A,137785776,180090,137409078,137802294,376698
9,ENSG00000197070.9,137605686,9-137785776-G-C,rs117211698,1,G,C,137785776,180090,137409078,137802294,376698
9,ENSG00000160404.13,127735294,9-127829258-C-G,rs117826776,-1,C,G,127829258,93964,127538686,127931902,290572
9,ENSG00000160404.13,127735294,9-127829258-C-T,rs117826776,-1,C,T,127829258,93964,127538686,127931902,290572
9,ENSG00000107020.5,5437925,9-5450790-C-T,rs117829760,-1,C,T,5450790,12865,5241317,5634533,209473
9,ENSG00000107020.5,5437925,9-5450790-C-A,rs117829760,-1,C,A,5450790,12865,5241317,5634533,209473
9,ENSG00000070061.10,108934124,9-108856646-A-G,rs11787880,-1,A,G,108856646,77478,108737516,109130732,119130
9,ENSG00000070061.10,108934124,9-108856646-A-T,rs11787880,-1,A,T,108856646,77478,108737516,109130732,119130
9,ENSG00000070061.10,108934124,9-108856646-A-C,rs11787880,-1,A,C,108856646,77478,108737516,109130732,119130
9,ENSG00000136856.11,127397169,9-127408282-G-A,rs11790967,1,G,A,127408282,11113,127200561,127593777,207721
9,ENSG00000164978.12,34329569,9-34400583-C-T,rs11793308,1,C,T,34400583,71014,34132961,34526177,267622
9,ENSG00000164978.12,34329569,9-34400583-C-G,rs11793308,1,C,G,34400583,71014,34132961,34526177,267622
9,ENSG00000176978.7,137114733,9-137130394-G-T,rs11794273,-1,G,T,137130394,15661,136918125,137311341,212269
9,ENSG00000176978.7,137114733,9-137130394-G-A,rs11794273,-1,G,A,137130394,15661,136918125,137311341,212269
9,ENSG00000119523.8,99221942,9-99226683-G-T,rs118142760,-1,G,T,99226683,4741,99025334,99418550,201349
9,ENSG00000119523.8,99221942,9-99226683-G-A,rs118142760,-1,G,A,99226683,4741,99025334,99418550,201349
9,ENSG00000187796.9,136373669,9-136476890-G-A,rs11999525,-1,G,A,136476890,103221,136177061,136570277,299829
9,ENSG00000167118.6,128371374,9-128249977-T-C,rs12343000,1,T,C,128249977,121397,128174766,128567982,75211
9,ENSG00000106789.8,98192637,9-98222664-T-C,rs12351801,-1,T,C,98222664,30027,97996029,98389245,226635
9,ENSG00000106789.8,98192637,9-98222664-T-A,rs12351801,-1,T,A,98222664,30027,97996029,98389245,226635
9,ENSG00000160401.9,127706988,9-127799409-T-C,rs12379987,1,T,C,127799409,92421,127510380,127903596,289029
9,ENSG00000160401.9,127706988,9-127799409-T-A,rs12379987,1,T,A,127799409,92421,127510380,127903596,289029
9,ENSG00000147955.10,34637787,9-34646343-G-A,rs12551313,-1,G,A,34646343,8556,34441179,34834395,205164
9,ENSG00000147955.10,34637787,9-34646343-G-T,rs12551313,-1,G,T,34646343,8556,34441179,34834395,205164
9,ENSG00000175768.8,37592597,9-37743617-A-C,rs12551499,-1,A,C,37743617,151020,37395989,37789205,347628
9,ENSG00000175768.8,37592597,9-37743617-A-T,rs12551499,-1,A,T,37743617,151020,37395989,37789205,347628
9,ENSG00000136783.9,104747683,9-104765549-T-C,rs12552611,1,T,C,104765549,17866,104551075,104944291,214474
9,ENSG00000136783.9,104747683,9-104765549-T-G,rs12552611,1,T,G,104765549,17866,104551075,104944291,214474
9,ENSG00000148175.8,121370250,9-121363046-C-A,rs12554081,-1,C,A,121363046,7204,121173642,121566858,189404
9,ENSG00000148229.8,113410675,9-113315414-T-A,rs12684385,-1,T,A,113315414,95261,113214067,113607283,101347
9,ENSG00000148229.8,113410675,9-113315414-T-G,rs12684385,-1,T,G,113315414,95261,113214067,113607283,101347
9,ENSG00000180071.12,38620596,9-38673330-C-G,rs12686391,-1,C,G,38673330,52734,38423988,38817204,249342
9,ENSG00000180071.12,38620596,9-38673330-C-T,rs12686391,-1,C,T,38673330,52734,38423988,38817204,249342
9,ENSG00000155158.13,15307360,9-15298770-T-C,rs13286025,-1,T,C,15298770,8590,15110752,15503968,188018
9,ENSG00000086062.7,33167336,9-33149186-T-C,rs13296176,-1,T,C,33149186,18150,32970728,33363944,178458
9,ENSG00000086062.7,33167336,9-33149186-T-A,rs13296176,-1,T,A,33149186,18150,32970728,33363944,178458
9,ENSG00000130653.9,137550402,9-137549196-T-G,rs13301653,-1,T,G,137549196,1206,137353794,137747010,195402
9,ENSG00000182150.9,95875691,9-95794612-A-G,rs1369156,1,A,G,95794612,81079,95679083,96072299,115529
9,ENSG00000165233.13,93096217,9-93093366-G-T,rs141357810,1,G,T,93093366,2851,92899609,93292825,193757
9,ENSG00000148297.9,133348131,9-133341555-C-T,rs145653063,-1,C,T,133341555,6576,133151523,133544739,190032
9,ENSG00000106927.5,114078300,9-113993925-T-C,rs16911462,-1,T,C,113993925,84375,113881692,114274908,112233
9,ENSG00000165264.6,32573159,9-32726650-G-A,rs16918479,-1,G,A,32726650,153491,32376551,32769767,350099
9,ENSG00000086061.10,33025273,9-33112625-A-T,rs16918999,1,A,T,33112625,87352,32828665,33221881,283960
9,ENSG00000086061.10,33025273,9-33112625-A-C,rs16918999,1,A,C,33112625,87352,32828665,33221881,283960
9,ENSG00000148399.7,137578925,9-137483268-G-C,rs17065427,-1,G,C,137483268,95657,137382317,137775533,100951
9,ENSG00000148399.7,137578925,9-137483268-G-A,rs17065427,-1,G,A,137483268,95657,137382317,137775533,100951
9,ENSG00000106829.12,79571965,9-79531192-G-A,rs17082537,1,G,A,79531192,40773,79375357,79768573,155835
9,ENSG00000136933.12,125200542,9-125196575-C-A,rs17337635,1,C,A,125196575,3967,125003934,125397150,192641
9,ENSG00000136933.12,125200542,9-125196575-C-T,rs17337635,1,C,T,125196575,3967,125003934,125397150,192641
9,ENSG00000188483.6,129178261,9-129290732-G-C,rs17456987,-1,G,C,129290732,112471,128981653,129374869,309079
9,ENSG00000095397.9,114505473,9-114494187-A-G,rs17807115,-1,A,G,114494187,11286,114308865,114702081,185322
9,ENSG00000097007.11,130835254,9-130855797-T-C,rs1800609,1,T,C,130855797,20543,130638646,131031862,217151
9,ENSG00000170681.6,100578079,9-100711770-G-A,rs1892128,1,G,A,100711770,133691,100381471,100774687,330299
9,ENSG00000198853.6,35490111,9-35343530-C-T,rs1927955,1,C,T,35343530,146581,35293503,35686719,50027
9,ENSG00000137098.9,35812262,9-35920859-A-T,rs2025174,-1,A,T,35920859,108597,35615654,36008870,305205
9,ENSG00000137098.9,35812262,9-35920859-A-G,rs2025174,-1,A,G,35920859,108597,35615654,36008870,305205
9,ENSG00000159921.8,36258448,9-36204458-C-T,rs2025879,-1,C,T,36204458,53990,36061840,36455056,142618
9,ENSG00000165029.11,104928155,9-104980908-C-T,rs2027400,-1,C,T,104980908,52753,104731547,105124763,249361
9,ENSG00000011454.11,122941020,9-122780234-G-C,rs2050871,1,G,C,122780234,160786,122744412,123137628,35822
9,ENSG00000011454.11,122941020,9-122780234-G-T,rs2050871,1,G,T,122780234,160786,122744412,123137628,35822
9,ENSG00000011454.11,122941020,9-122780234-G-A,rs2050871,1,G,A,122780234,160786,122744412,123137628,35822
9,ENSG00000197355.6,137077517,9-137242377-C-G,rs2071355,1,C,G,137242377,164860,136880909,137274125,361468
9,ENSG00000136868.8,113221544,9-113344807-G-A,rs2093691,1,G,A,113344807,123263,113024936,113418152,319871
9,ENSG00000136868.8,113221544,9-113344807-G-C,rs2093691,1,G,C,113344807,123263,113024936,113418152,319871
9,ENSG00000196358.5,132162058,9-132226867-C-T,rs2149171,1,C,T,132226867,64809,131965450,132358666,261417
9,ENSG00000148153.7,112718117,9-112863419-C-T,rs2182046,-1,C,T,112863419,145302,112521509,112914725,341910
9,ENSG00000196152.6,127424382,9-127534967-C-G,rs2247374,1,C,G,127534967,110585,127227774,127620990,307193
9,ENSG00000196152.6,127424382,9-127534967-C-T,rs2247374,1,C,T,127534967,110585,127227774,127620990,307193
9,ENSG00000137076.12,35732195,9-35711809-G-C,rs2249250,-1,G,C,35711809,20386,35535587,35928803,176222
9,ENSG00000137076.12,35732195,9-35711809-G-A,rs2249250,-1,G,A,35711809,20386,35535587,35928803,176222
9,ENSG00000137076.12,35732195,9-35711809-G-T,rs2249250,-1,G,T,35711809,20386,35535587,35928803,176222
9,ENSG00000070601.5,37650954,9-37731010-C-A,rs2274324,1,C,A,37731010,80056,37454346,37847562,276664
9,ENSG00000070601.5,37650954,9-37731010-C-T,rs2274324,1,C,T,37731010,80056,37454346,37847562,276664
9,ENSG00000107130.6,130172404,9-130110483-A-G,rs2277197,1,A,G,130110483,61921,129975796,130369012,134687
9,ENSG00000106733.15,75088155,9-75130508-T-C,rs2295861,-1,T,C,75130508,42353,74891547,75284763,238961
9,ENSG00000106733.15,75088155,9-75130508-T-A,rs2295861,-1,T,A,75130508,42353,74891547,75284763,238961
9,ENSG00000106733.15,75088155,9-75130508-T-G,rs2295861,-1,T,G,75130508,42353,74891547,75284763,238961
9,ENSG00000198467.7,35689925,9-35676610-G-A,rs2301372,-1,G,A,35676610,13315,35493317,35886533,183293
9,ENSG00000136935.8,124941083,9-124881667-A-G,rs2304957,-1,A,G,124881667,59416,124744475,125137691,137192
9,ENSG00000136935.8,124941083,9-124881667-A-C,rs2304957,-1,A,C,124881667,59416,124744475,125137691,137192
9,ENSG00000136897.6,101398618,9-101346368-G-A,rs2417250,-1,G,A,101346368,52250,101202010,101595226,144358
9,ENSG00000136897.6,101398618,9-101346368-G-T,rs2417250,-1,G,T,101346368,52250,101202010,101595226,144358
9,ENSG00000106785.9,98119222,9-98120599-T-G,rs2487912,-1,T,G,98120599,1377,97922614,98315830,197985
9,ENSG00000106785.9,98119222,9-98120599-T-A,rs2487912,-1,T,A,98120599,1377,97922614,98315830,197985
9,ENSG00000106785.9,98119222,9-98120599-T-C,rs2487912,-1,T,C,98120599,1377,97922614,98315830,197985
9,ENSG00000123454.5,133636363,9-133630196-G-A,rs2519147,1,G,A,133630196,6167,133439755,133832971,190441
9,ENSG00000136827.9,129824136,9-129907221-G-C,rs2528,-1,G,C,129907221,83085,129627528,130020744,279693
9,ENSG00000148331.7,129642151,9-129604557-A-C,rs2542242,-1,A,C,129604557,37594,129445543,129838759,159014
9,ENSG00000148331.7,129642151,9-129604557-A-T,rs2542242,-1,A,T,129604557,37594,129445543,129838759,159014
9,ENSG00000148331.7,129642151,9-129604557-A-G,rs2542242,-1,A,G,129604557,37594,129445543,129838759,159014
9,ENSG00000164975.10,15422876,9-15461855-G-C,rs2665504,1,G,C,15461855,38979,15226268,15619484,235587
9,ENSG00000204136.6,121499844,9-121570871-G-A,rs2777298,-1,G,A,121570871,71027,121303236,121696452,267635
9,ENSG00000176101.7,137188676,9-137310817-C-T,rs28374197,1,C,T,137310817,122141,136992068,137385284,318749
9,ENSG00000198113.2,137277726,9-137235809-T-C,rs28434439,1,T,C,137235809,41917,137081118,137474334,154691
9,ENSG00000198113.2,137277726,9-137235809-T-G,rs28434439,1,T,G,137235809,41917,137081118,137474334,154691
9,ENSG00000205808.3,4662294,9-4680653-G-T,rs301486,1,G,T,4680653,18359,4465686,4858902,214967
9,ENSG00000205808.3,4662294,9-4680653-G-A,rs301486,1,G,A,4680653,18359,4465686,4858902,214967
9,ENSG00000137135.12,35665195,9-35648953-A-G,rs3138083,-1,A,G,35648953,16242,35468587,35861803,180366
9,ENSG00000137135.12,35665195,9-35648953-A-T,rs3138083,-1,A,T,35648953,16242,35468587,35861803,180366
9,ENSG00000137135.12,35665195,9-35648953-A-C,rs3138083,-1,A,C,35648953,16242,35468587,35861803,180366
9,ENSG00000159884.7,35658292,9-35657066-C-T,rs34080245,1,C,T,35657066,1226,35461684,35854900,195382
9,ENSG00000159884.7,35658292,9-35657066-C-G,rs34080245,1,C,G,35657066,1226,35461684,35854900,195382
9,ENSG00000107104.12,504695,9-449874-G-C,rs34908836,1,G,C,449874,54821,308087,701303,141787
9,ENSG00000095209.7,105694541,9-105773965-G-C,rs35232724,1,G,C,105773965,79424,105497933,105891149,276032
9,ENSG00000136830.5,127569073,9-127525193-G-C,rs3765601,-1,G,C,127525193,43880,127372465,127765681,152728
9,ENSG00000136830.5,127569073,9-127525193-G-T,rs3765601,-1,G,T,127525193,43880,127372465,127765681,152728
9,ENSG00000176386.4,113275572,9-113329062-T-C,rs3810921,-1,T,C,113329062,53490,113078964,113472180,250098
9,ENSG00000119138.3,70414657,9-70607235-T-C,rs3812535,-1,T,C,70607235,192578,70218049,70611265,389186
9,ENSG00000120162.8,27529814,9-27560596-T-C,rs3849944,-1,T,C,27560596,30782,27333206,27726422,227390
9,ENSG00000196781.8,81689547,9-81795723-T-G,rs3907292,-1,T,G,81795723,106176,81492939,81886155,302784
9,ENSG00000196781.8,81689547,9-81795723-T-A,rs3907292,-1,T,A,81795723,106176,81492939,81886155,302784
9,ENSG00000196781.8,81689547,9-81795723-T-C,rs3907292,-1,T,C,81795723,106176,81492939,81886155,302784
9,ENSG00000185963.9,92764833,9-92616379-A-G,rs41266679,-1,A,G,92616379,148454,92568225,92961441,48154
9,ENSG00000119514.5,98807670,9-98715218-C-T,rs420158,1,C,T,98715218,92452,98611062,99004278,104156
9,ENSG00000119514.5,98807670,9-98715218-C-G,rs420158,1,C,G,98715218,92452,98611062,99004278,104156
9,ENSG00000136810.8,110256507,9-110211368-A-G,rs4314718,-1,A,G,110211368,45139,110059899,110453115,151469
9,ENSG00000136810.8,110256507,9-110211368-A-T,rs4314718,-1,A,T,110211368,45139,110059899,110453115,151469
9,ENSG00000136810.8,110256507,9-110211368-A-C,rs4314718,-1,A,C,110211368,45139,110059899,110453115,151469
9,ENSG00000155876.4,19049427,9-19201740-T-C,rs457062,1,T,C,19201740,152313,18852819,19246035,348921
9,ENSG00000119402.10,120793416,9-120762466-C-A,rs4620348,-1,C,A,120762466,30950,120596808,120990024,165658
9,ENSG00000171169.7,128067320,9-128256360-T-G,rs4734,-1,T,G,128256360,189040,127870712,128263928,385648
9,ENSG00000136824.13,104094309,9-104251600-C-G,rs4743702,1,C,G,104251600,157291,103897701,104290917,353899
9,ENSG00000136824.13,104094309,9-104251600-C-A,rs4743702,1,C,A,104251600,157291,103897701,104290917,353899
9,ENSG00000136824.13,104094309,9-104251600-C-T,rs4743702,1,C,T,104251600,157291,103897701,104290917,353899
9,ENSG00000172785.11,179147,9-205964-A-T,rs478882,-1,A,T,205964,26817,-17461,375755,223425
9,ENSG00000172785.11,179147,9-205964-A-C,rs478882,-1,A,C,205964,26817,-17461,375755,223425
9,ENSG00000172785.11,179147,9-205964-A-G,rs478882,-1,A,G,205964,26817,-17461,375755,223425
9,ENSG00000136819.8,129835275,9-129777146-T-C,rs4837413,-1,T,C,129777146,58129,129638667,130031883,138479
9,ENSG00000119401.9,116687305,9-116515532-T-G,rs4837584,1,T,G,116515532,171773,116490697,116883913,24835
9,ENSG00000119401.9,116687305,9-116515532-T-C,rs4837584,1,T,C,116515532,171773,116490697,116883913,24835
9,ENSG00000119401.9,116687305,9-116515532-T-A,rs4837584,1,T,A,116515532,171773,116490697,116883913,24835
9,ENSG00000148180.9,121268162,9-121298711-C-G,rs4837835,1,C,G,121298711,30549,121071554,121464770,227157
9,ENSG00000054179.6,137054061,9-137108302-C-T,rs4880090,-1,C,T,137108302,54241,136857453,137250669,250849
9,ENSG00000107281.5,137046177,9-137108302-C-T,rs4880090,-1,C,T,137108302,62125,136849569,137242785,258733
9,ENSG00000212864.2,137222240,9-137123686-C-A,rs4880094,-1,C,A,137123686,98554,137025632,137418848,98054
9,ENSG00000212864.2,137222240,9-137123686-C-G,rs4880094,-1,C,G,137123686,98554,137025632,137418848,98054
9,ENSG00000212864.2,137222240,9-137123686-C-T,rs4880094,-1,C,T,137123686,98554,137025632,137418848,98054
9,ENSG00000176058.7,137200741,9-137136549-C-T,rs4880213,-1,C,T,137136549,64192,137004133,137397349,132416
9,ENSG00000176058.7,137200741,9-137136549-C-G,rs4880213,-1,C,G,137136549,64192,137004133,137397349,132416
9,ENSG00000148290.5,133356487,9-133370907-C-A,rs4962046,-1,C,A,133370907,14420,133159879,133553095,211028
9,ENSG00000148290.5,133356487,9-133370907-C-T,rs4962046,-1,C,T,133370907,14420,133159879,133553095,211028
9,ENSG00000165802.14,137459334,9-137461922-C-A,rs4962240,-1,C,A,137461922,2588,137262726,137655942,199196
9,ENSG00000165802.14,137459334,9-137461922-C-T,rs4962240,-1,C,T,137461922,2588,137262726,137655942,199196
9,ENSG00000165802.14,137459334,9-137461922-C-G,rs4962240,-1,C,G,137461922,2588,137262726,137655942,199196
9,ENSG00000157653.7,113410747,9-113552638-G-C,rs4979253,1,G,C,113552638,141891,113214139,113607355,338499
9,ENSG00000170122.4,118417,9-275049-G-T,rs523830,-1,G,T,275049,156632,-78191,315025,353240
9,ENSG00000170122.4,118417,9-275049-G-A,rs523830,-1,G,A,275049,156632,-78191,315025,353240
9,ENSG00000170122.4,118417,9-275049-G-C,rs523830,-1,G,C,275049,156632,-78191,315025,353240
9,ENSG00000196422.5,135479782,9-135524568-G-A,rs59238865,1,G,A,135524568,44786,135283174,135676390,241394
9,ENSG00000123453.10,133738352,9-133733337-C-T,rs593824,-1,C,T,133733337,5015,133541744,133934960,191593
9,ENSG00000123453.10,133738352,9-133733337-C-A,rs593824,-1,C,A,133733337,5015,133541744,133934960,191593
9,ENSG00000188379.5,21385398,9-21564789-T-C,rs60506615,-1,T,C,21564789,179391,21188790,21582006,375999
9,ENSG00000188986.4,137255327,9-137272145-G-C,rs61751916,1,G,C,137272145,16818,137058719,137451935,213426
9,ENSG00000188986.4,137255327,9-137272145-G-A,rs61751916,1,G,A,137272145,16818,137058719,137451935,213426
9,ENSG00000232434.1,136842478,9-136725921-G-A,rs62582186,1,G,A,136725921,116557,136645870,137039086,80051
9,ENSG00000119408.11,124257949,9-124223159-A-G,rs62583791,1,A,G,124223159,34790,124061341,124454557,161818
9,ENSG00000130956.9,96450169,9-96615197-T-G,rs6477572,1,T,G,96615197,165028,96253561,96646777,361636
9,ENSG00000130956.9,96450169,9-96615197-T-C,rs6477572,1,T,C,96615197,165028,96253561,96646777,361636
9,ENSG00000196597.7,96854514,9-97029630-A-T,rs6477831,-1,A,T,97029630,175116,96657906,97051122,371724
9,ENSG00000196597.7,96854514,9-97029630-A-G,rs6477831,-1,A,G,97029630,175116,96657906,97051122,371724
9,ENSG00000196597.7,96854514,9-97029630-A-C,rs6477831,-1,A,C,97029630,175116,96657906,97051122,371724
9,ENSG00000107372.8,72365208,9-72308956-C-A,rs6560270,-1,C,A,72308956,56252,72168600,72561816,140356
9,ENSG00000107372.8,72365208,9-72308956-C-G,rs6560270,-1,C,G,72308956,56252,72168600,72561816,140356
9,ENSG00000180549.7,137032088,9-137116032-C-T,rs6560659,-1,C,T,137116032,83944,136835480,137228696,280552
9,ENSG00000196363.4,134136082,9-133963739-T-C,rs695067,1,T,C,133963739,172343,133939474,134332690,24265
9,ENSG00000196363.4,134136082,9-133963739-T-A,rs695067,1,T,A,133963739,172343,133939474,134332690,24265
9,ENSG00000196363.4,134136082,9-133963739-T-G,rs695067,1,T,G,133963739,172343,133939474,134332690,24265
9,ENSG00000106853.11,111599647,9-111432994-T-A,rs7018469,-1,T,A,111432994,166653,111403039,111796255,29955
9,ENSG00000106853.11,111599647,9-111432994-T-C,rs7018469,-1,T,C,111432994,166653,111403039,111796255,29955
9,ENSG00000090054.8,92115413,9-92003282-G-T,rs7018784,-1,G,T,92003282,112131,91918805,92312021,84477
9,ENSG00000137094.9,34989745,9-35113250-G-A,rs7020853,1,G,A,35113250,123505,34793137,35186353,320113
9,ENSG00000165272.8,33447593,9-33487025-G-C,rs7022355,-1,G,C,33487025,39432,33250985,33644201,236040
9,ENSG00000165272.8,33447593,9-33487025-G-A,rs7022355,-1,G,A,33487025,39432,33250985,33644201,236040
9,ENSG00000148204.7,123356197,9-123320064-T-C,rs7024188,1,T,C,123320064,36133,123159589,123552805,160475
9,ENSG00000119508.12,99821885,9-99862214-T-C,rs7024419,1,T,C,99862214,40329,99625277,100018493,236937
9,ENSG00000106688.7,4490468,9-4490134-T-G,rs7031998,1,T,G,4490134,334,4293860,4687076,196274
9,ENSG00000106688.7,4490468,9-4490134-T-C,rs7031998,1,T,C,4490134,334,4293860,4687076,196274
9,ENSG00000130958.7,96383711,9-96506408-C-T,rs7035310,-1,C,T,96506408,122697,96187103,96580319,319305
9,ENSG00000130958.7,96383711,9-96506408-C-A,rs7035310,-1,C,A,96506408,122697,96187103,96580319,319305
9,ENSG00000178445.8,6645729,9-6611609-G-T,rs7035933,-1,G,T,6611609,34120,6449121,6842337,162488
9,ENSG00000178445.8,6645729,9-6611609-G-C,rs7035933,-1,G,C,6611609,34120,6449121,6842337,162488
9,ENSG00000213930.6,34646675,9-34587487-C-T,rs7037232,1,C,T,34587487,59188,34450067,34843283,137420
9,ENSG00000175854.6,128276244,9-128197499-T-G,rs7039822,1,T,G,128197499,78745,128079636,128472852,117863
9,ENSG00000175854.6,128276244,9-128197499-T-A,rs7039822,1,T,A,128197499,78745,128079636,128472852,117863
9,ENSG00000175854.6,128276244,9-128197499-T-C,rs7039822,1,T,C,128197499,78745,128079636,128472852,117863
9,ENSG00000135040.11,85941146,9-85948696-T-C,rs7040368,1,T,C,85948696,7550,85744538,86137754,204158
9,ENSG00000178966.11,83980805,9-84177042-A-T,rs7042671,1,A,T,84177042,196237,83784197,84177413,392845
9,ENSG00000178966.11,83980805,9-84177042-A-C,rs7042671,1,A,C,84177042,196237,83784197,84177413,392845
9,ENSG00000136932.8,97922500,9-97772541-A-G,rs7045465,-1,A,G,97772541,149959,97725892,98119108,46649
9,ENSG00000136932.8,97922500,9-97772541-A-C,rs7045465,-1,A,C,97772541,149959,97725892,98119108,46649
9,ENSG00000136932.8,97922500,9-97772541-A-T,rs7045465,-1,A,T,97772541,149959,97725892,98119108,46649
9,ENSG00000148053.11,84669729,9-84804202-A-G,rs716893,1,A,G,84804202,134473,84473121,84866337,331081
9,ENSG00000198963.5,74497335,9-74436711-G-T,rs72729216,1,G,T,74436711,60624,74300727,74693943,135984
9,ENSG00000135052.11,86099558,9-86081938-A-G,rs72746701,-1,A,G,86081938,17620,85902950,86296166,178988
9,ENSG00000148200.11,124771311,9-124818795-G-C,rs72763336,-1,G,C,124818795,47484,124574703,124967919,244092
9,ENSG00000148200.11,124771311,9-124818795-G-A,rs72763336,-1,G,A,124818795,47484,124574703,124967919,244092
9,ENSG00000157693.10,114611291,9-114558167-T-C,rs730705,1,T,C,114558167,53124,114414683,114807899,143484
9,ENSG00000157693.10,114611291,9-114558167-T-A,rs730705,1,T,A,114558167,53124,114414683,114807899,143484
9,ENSG00000130222.6,89605012,9-89694910-T-C,rs73648579,1,T,C,89694910,89898,89408404,89801620,286506
9,ENSG00000165689.12,136410614,9-136398310-T-C,rs75200747,-1,T,C,136398310,12304,136214006,136607222,184304
9,ENSG00000213221.4,136363744,9-136398310-T-C,rs75200747,-1,T,C,136398310,34566,136167136,136560352,231174
9,ENSG00000148408.8,137877782,9-137829308-C-T,rs75268321,1,C,T,137829308,48474,137681174,138074390,148134
9,ENSG00000171843.10,20622499,9-20603759-G-A,rs756728,-1,G,A,20603759,18740,20425891,20819107,177868
9,ENSG00000130707.12,130444961,9-130304660-C-T,rs76577761,1,C,T,130304660,140301,130248353,130641569,56307
9,ENSG00000130707.12,130444961,9-130304660-C-G,rs76577761,1,C,G,130304660,140301,130248353,130641569,56307
9,ENSG00000198876.7,34126698,9-34255825-C-G,rs76716576,-1,C,G,34255825,129127,33930090,34323306,325735
9,ENSG00000164976.7,34376898,9-34255825-C-G,rs76716576,-1,C,G,34255825,121073,34180290,34573506,75535
9,ENSG00000188938.10,93453581,9-93635287-T-A,rs77133953,-1,T,A,93635287,181706,93256973,93650189,378314
9,ENSG00000188938.10,93453581,9-93635287-T-G,rs77133953,-1,T,G,93635287,181706,93256973,93650189,378314
9,ENSG00000136928.4,98708935,9-98857194-C-A,rs7849595,-1,C,A,98857194,148259,98512327,98905543,344867
9,ENSG00000136928.4,98708935,9-98857194-C-G,rs7849595,-1,C,G,98857194,148259,98512327,98905543,344867
9,ENSG00000136928.4,98708935,9-98857194-C-T,rs7849595,-1,C,T,98857194,148259,98512327,98905543,344867
9,ENSG00000196730.8,87497867,9-87556605-T-A,rs7852573,1,T,A,87556605,58738,87301259,87694475,255346
9,ENSG00000196730.8,87497867,9-87556605-T-C,rs7852573,1,T,C,87556605,58738,87301259,87694475,255346
9,ENSG00000196730.8,87497867,9-87556605-T-G,rs7852573,1,T,G,87556605,58738,87301259,87694475,255346
9,ENSG00000182752.7,116153791,9-116268497-A-G,rs7854428,1,A,G,116268497,114706,115957183,116350399,311314
9,ENSG00000182752.7,116153791,9-116268497-A-T,rs7854428,1,A,T,116268497,114706,115957183,116350399,311314
9,ENSG00000182752.7,116153791,9-116268497-A-C,rs7854428,1,A,C,116268497,114706,115957183,116350399,311314
9,ENSG00000148411.3,136095289,9-136197833-G-A,rs7860634,-1,G,A,136197833,102544,135898681,136291897,299152
9,ENSG00000137133.5,35815042,9-35902239-G-A,rs7864548,-1,G,A,35902239,87197,35618434,36011650,283805
9,ENSG00000137133.5,35815042,9-35902239-G-C,rs7864548,-1,G,C,35902239,87197,35618434,36011650,283805
9,ENSG00000122694.10,36136733,9-36068578-A-G,rs7866368,1,A,G,36068578,68155,35940125,36333341,128453
9,ENSG00000119125.12,72149440,9-72193094-A-T,rs7867133,1,A,T,72193094,43654,71952832,72346048,240262
9,ENSG00000119125.12,72149440,9-72193094-A-C,rs7867133,1,A,C,72193094,43654,71952832,72346048,240262
9,ENSG00000119125.12,72149440,9-72193094-A-G,rs7867133,1,A,G,72193094,43654,71952832,72346048,240262
9,ENSG00000165118.9,83956742,9-84067331-G-T,rs78682152,-1,G,T,84067331,110589,83760134,84153350,307197
9,ENSG00000165118.9,83956742,9-84067331-G-A,rs78682152,-1,G,A,84067331,110589,83760134,84153350,307197
9,ENSG00000127080.5,92670131,9-92793657-T-C,rs7868651,-1,T,C,92793657,123526,92473523,92866739,320134
9,ENSG00000127080.5,92670131,9-92793657-T-A,rs7868651,-1,T,A,92793657,123526,92473523,92866739,320134
9,ENSG00000127080.5,92670131,9-92793657-T-G,rs7868651,-1,T,G,92793657,123526,92473523,92866739,320134
9,ENSG00000160345.8,135499869,9-135364062-A-G,rs7869343,-1,A,G,135364062,135807,135303261,135696477,60801
9,ENSG00000160345.8,135499869,9-135364062-A-T,rs7869343,-1,A,T,135364062,135807,135303261,135696477,60801
9,ENSG00000148334.9,128127729,9-128041408-C-T,rs7869490,-1,C,T,128041408,86321,127931121,128324337,110287
9,ENSG00000148334.9,128127729,9-128041408-C-A,rs7869490,-1,C,A,128041408,86321,127931121,128324337,110287
9,ENSG00000148334.9,128127729,9-128041408-C-G,rs7869490,-1,C,G,128041408,86321,127931121,128324337,110287
9,ENSG00000107223.8,136866308,9-136795692-A-G,rs7871359,-1,A,G,136795692,70616,136669700,137062916,125992
9,ENSG00000107223.8,136866308,9-136795692-A-C,rs7871359,-1,A,C,136795692,70616,136669700,137062916,125992
9,ENSG00000107223.8,136866308,9-136795692-A-T,rs7871359,-1,A,T,136795692,70616,136669700,137062916,125992
9,ENSG00000107175.6,35732666,9-35726824-G-C,rs7873822,1,G,C,35726824,5842,35536058,35929274,190766
9,ENSG00000107175.6,35732666,9-35726824-G-T,rs7873822,1,G,T,35726824,5842,35536058,35929274,190766
9,ENSG00000120217.9,5450542,9-5547288-C-T,rs7874637,1,C,T,5547288,96746,5253934,5647150,293354
9,ENSG00000120217.9,5450542,9-5547288-C-A,rs7874637,1,C,A,5547288,96746,5253934,5647150,293354
9,ENSG00000177076.4,19409009,9-19305513-G-A,rs79987248,1,G,A,19305513,103496,19212401,19605617,93112
9,ENSG00000119335.11,128689222,9-128820392-C-T,rs80294648,1,C,T,128820392,131170,128492614,128885830,327778
9,ENSG00000119335.11,128689222,9-128820392-C-G,rs80294648,1,C,G,128820392,131170,128492614,128885830,327778
9,ENSG00000106780.7,120714470,9-120890620-T-C,rs881375,-1,T,C,120890620,176150,120517862,120911078,372758
9,ENSG00000107242.11,68705240,9-68518002-C-G,rs902949,1,C,G,68518002,187238,68508632,68901848,9370
9,ENSG00000107242.11,68705240,9-68518002-C-A,rs902949,1,C,A,68518002,187238,68508632,68901848,9370
9,ENSG00000181090.12,137619005,9-137426165-C-T,rs9414734,1,C,T,137426165,192840,137422397,137815613,3768
9,ENSG00000147889.10,21974857,9-22115287-T-A,rs944797,-1,T,A,22115287,140430,21778249,22171465,337038
9,ENSG00000147889.10,21974857,9-22115287-T-G,rs944797,-1,T,G,22115287,140430,21778249,22171465,337038
9,ENSG00000147889.10,21974857,9-22115287-T-C,rs944797,-1,T,C,22115287,140430,21778249,22171465,337038
9,ENSG00000167123.11,128420857,9-128600082-T-C,rs945831,1,T,C,128600082,179225,128224249,128617465,375833
9,ENSG00000165138.11,98796555,9-98643279-A-G,rs967931,-1,A,G,98643279,153276,98599947,98993163,43332
9,ENSG00000165138.11,98796555,9-98643279-A-C,rs967931,-1,A,C,98643279,153276,98599947,98993163,43332
9,ENSG00000165138.11,98796555,9-98643279-A-T,rs967931,-1,A,T,98643279,153276,98599947,98993163,43332
9,ENSG00000160323.13,133422367,9-133479491-G-A,rs968471,1,G,A,133479491,57124,133225759,133618975,253732
9,ENSG00000204291.5,98943907,9-98839363-T-C,rs999471,1,T,C,98839363,104544,98747299,99140515,92064
8,ENSG00000185015.3,85245458,8-85227767-T-G,rs10090196,1,T,G,85227767,17691,85048850,85442066,178917
8,ENSG00000185015.3,85245458,8-85227767-T-C,rs10090196,1,T,C,85227767,17691,85048850,85442066,178917
8,ENSG00000132294.8,131904093,8-131870447-A-G,rs10090261,1,A,G,131870447,33646,131707485,132100701,162962
8,ENSG00000132294.8,131904093,8-131870447-A-C,rs10090261,1,A,C,131870447,33646,131707485,132100701,162962
8,ENSG00000198846.4,59119147,8-58960675-A-C,rs10092016,-1,A,C,58960675,158472,58922539,59315755,38136
8,ENSG00000104312.6,89757816,8-89837077-C-A,rs10094579,1,C,A,89837077,79261,89561208,89954424,275869
8,ENSG00000172728.10,33473146,8-33473052-G-A,rs10097936,-1,G,A,33473052,94,33276538,33669754,196514
8,ENSG00000183638.5,10655143,8-10497792-T-C,rs10104413,-1,T,C,10497792,157351,10458535,10851751,39257
8,ENSG00000105339.6,141128589,8-141181649-T-G,rs10104549,1,T,G,141181649,53060,140931981,141325197,249668
8,ENSG00000105339.6,141128589,8-141181649-T-A,rs10104549,1,T,A,141181649,53060,140931981,141325197,249668
8,ENSG00000104756.11,25458433,8-25369103-T-C,rs10106554,-1,T,C,25369103,89330,25261825,25655041,107278
8,ENSG00000104756.11,25458433,8-25369103-T-A,rs10106554,-1,T,A,25369103,89330,25261825,25655041,107278
8,ENSG00000186918.9,28386460,8-28232826-G-A,rs10216536,-1,G,A,28232826,153634,28189852,28583068,42974
8,ENSG00000137571.5,69834978,8-69676506-T-C,rs10448033,-1,T,C,69676506,158472,69638370,70031586,38136
8,ENSG00000175806.10,10054292,8-10120550-G-T,rs10503402,1,G,T,10120550,66258,9857684,10250900,262866
8,ENSG00000175806.10,10054292,8-10120550-G-A,rs10503402,1,G,A,10120550,66258,9857684,10250900,262866
8,ENSG00000171320.10,27774554,8-27779621-G-A,rs10503820,1,G,A,27779621,5067,27577946,27971162,201675
8,ENSG00000076641.3,81112068,8-81105137-G-C,rs10504730,-1,G,C,81105137,6931,80915460,81308676,189677
8,ENSG00000076641.3,81112068,8-81105137-G-A,rs10504730,-1,G,A,81105137,6931,80915460,81308676,189677
8,ENSG00000136982.5,119855894,8-119834883-C-T,rs1055131,-1,C,T,119834883,21011,119659286,120052502,175597
8,ENSG00000164751.10,77000078,8-76988783-C-G,rs10808814,-1,C,G,76988783,11295,76803470,77196686,185313
8,ENSG00000164751.10,77000078,8-76988783-C-A,rs10808814,-1,C,A,76988783,11295,76803470,77196686,185313
8,ENSG00000164751.10,77000078,8-76988783-C-T,rs10808814,-1,C,T,76988783,11295,76803470,77196686,185313
8,ENSG00000156482.6,98045545,8-98005320-G-A,rs10955146,-1,G,A,98005320,40225,97848937,98242153,156383
8,ENSG00000104325.2,90001477,8-90174490-C-T,rs10956500,1,C,T,90174490,173013,89804869,90198085,369621
8,ENSG00000104325.2,90001477,8-90174490-C-A,rs10956500,1,C,A,90174490,173013,89804869,90198085,369621
8,ENSG00000104529.12,143597415,8-143568377-G-A,rs11136302,-1,G,A,143568377,29038,143400807,143794023,167570
8,ENSG00000168487.13,22165372,8-22164004-G-A,rs1124,1,G,A,22164004,1368,21968764,22361980,195240
8,ENSG00000155087.3,102551589,8-102432898-G-C,rs113072599,1,G,C,102432898,118691,102354981,102748197,77917
8,ENSG00000155087.3,102551589,8-102432898-G-A,rs113072599,1,G,A,102432898,118691,102354981,102748197,77917
8,ENSG00000187954.8,144462871,8-144533989-G-A,rs115476098,-1,G,A,144533989,71118,144266263,144659479,267726
8,ENSG00000169398.14,141001233,8-140807352-C-G,rs116910216,-1,C,G,140807352,193881,140804625,141197841,2727
8,ENSG00000169398.14,141001233,8-140807352-C-T,rs116910216,-1,C,T,140807352,193881,140804625,141197841,2727
8,ENSG00000168078.5,27837817,8-28004938-G-A,rs117255293,-1,G,A,28004938,167121,27641209,28034425,363729
8,ENSG00000183309.5,143636019,8-143779453-C-T,rs117340801,1,C,T,143779453,143434,143439411,143832627,340042
8,ENSG00000042832.6,132866958,8-132972045-C-T,rs117512053,1,C,T,132972045,105087,132670350,133063566,301695
8,ENSG00000120992.11,54101947,8-54071539-C-T,rs117617235,-1,C,T,54071539,30408,53905339,54298555,166200
8,ENSG00000136960.7,119638839,8-119636347-G-A,rs11775064,-1,G,A,119636347,2492,119442231,119835447,194116
8,ENSG00000183779.4,37695782,8-37550066-C-T,rs117767565,1,C,T,37550066,145716,37499174,37892390,50892
8,ENSG00000178209.10,143939597,8-143952282-T-C,rs11778018,-1,T,C,143952282,12685,143742989,144136205,209293
8,ENSG00000155189.7,6708642,8-6728721-C-G,rs11991276,1,C,G,6728721,20079,6512034,6905250,216687
8,ENSG00000137547.4,54135241,8-54156501-C-G,rs11991952,1,C,G,54156501,21260,53938633,54331849,217868
8,ENSG00000137547.4,54135241,8-54156501-C-T,rs11991952,1,C,T,54156501,21260,53938633,54331849,217868
8,ENSG00000160948.8,144428548,8-144378061-G-A,rs11992877,-1,G,A,144378061,50487,144231940,144625156,146121
8,ENSG00000179526.12,144103773,8-144280341-C-T,rs11993916,-1,C,T,144280341,176568,143907165,144300381,373176
8,ENSG00000179526.12,144103773,8-144280341-C-A,rs11993916,-1,C,A,144280341,176568,143907165,144300381,373176
8,ENSG00000104635.8,22367278,8-22189316-T-G,rs11994254,1,T,G,22189316,177962,22170670,22563886,18646
8,ENSG00000171428.9,18210109,8-18344776-C-T,rs11994435,1,C,T,18344776,134667,18013501,18406717,331275
8,ENSG00000104695.7,30812818,8-30974933-C-G,rs11998244,-1,C,G,30974933,162115,30616210,31009426,358723
8,ENSG00000104695.7,30812818,8-30974933-C-A,rs11998244,-1,C,A,30974933,162115,30616210,31009426,358723
8,ENSG00000104321.5,72075584,8-71963243-G-T,rs12541619,-1,G,T,71963243,112341,71878976,72272192,84267
8,ENSG00000104321.5,72075584,8-71963243-G-C,rs12541619,-1,G,C,71963243,112341,71878976,72272192,84267
8,ENSG00000104518.6,143558346,8-143565758-T-C,rs12541647,1,T,C,143565758,7412,143361738,143754954,204020
8,ENSG00000185122.5,144291604,8-144344210-C-T,rs12546042,1,C,T,144344210,52606,144094996,144488212,249214
8,ENSG00000185122.5,144291604,8-144344210-C-G,rs12546042,1,C,G,144344210,52606,144094996,144488212,249214
8,ENSG00000164961.10,125091792,8-125070323-T-G,rs12546767,-1,T,G,125070323,21469,124895184,125288400,175139
8,ENSG00000164961.10,125091792,8-125070323-T-C,rs12546767,-1,T,C,125070323,21469,124895184,125288400,175139
8,ENSG00000070718.7,42153063,8-42162095-G-A,rs12547064,1,G,A,42162095,9032,41956455,42349671,205640
8,ENSG00000181135.11,143684479,8-143693114-G-T,rs12679165,1,G,T,143693114,8635,143487871,143881087,205243
8,ENSG00000181135.11,143684479,8-143693114-G-C,rs12679165,1,G,C,143693114,8635,143487871,143881087,205243
8,ENSG00000165066.10,41650817,8-41609270-T-C,rs12708212,-1,T,C,41609270,41547,41454209,41847425,155061
8,ENSG00000165066.10,41650817,8-41609270-T-G,rs12708212,-1,T,G,41609270,41547,41454209,41847425,155061
8,ENSG00000164733.14,11868087,8-11861019-T-C,rs1293288,-1,T,C,11861019,7068,11671479,12064695,189540
8,ENSG00000164733.14,11868087,8-11861019-T-G,rs1293288,-1,T,G,11861019,7068,11671479,12064695,189540
8,ENSG00000066855.10,65644734,8-65781884-C-A,rs1316700,1,C,A,65781884,137150,65448126,65841342,333758
8,ENSG00000066855.10,65644734,8-65781884-C-G,rs1316700,1,C,G,65781884,137150,65448126,65841342,333758
8,ENSG00000182759.3,143430732,8-143362039-T-C,rs13250507,-1,T,C,143362039,68693,143234124,143627340,127915
8,ENSG00000182759.3,143430732,8-143362039-T-G,rs13250507,-1,T,G,143362039,68693,143234124,143627340,127915
8,ENSG00000164879.5,85438859,8-85250136-G-A,rs13259399,1,G,A,85250136,188723,85242251,85635467,7885
8,ENSG00000156469.4,96261610,8-96226541-A-G,rs13261747,-1,A,G,96226541,35069,96065002,96458218,161539
8,ENSG00000147684.3,124539123,8-124488277-A-G,rs13264071,1,A,G,124488277,50846,124342515,124735731,145762
8,ENSG00000147684.3,124539123,8-124488277-A-T,rs13264071,1,A,T,124488277,50846,124342515,124735731,145762
8,ENSG00000164949.3,94262319,8-94234188-G-T,rs13264275,-1,G,T,94234188,28131,94065711,94458927,168477
8,ENSG00000179698.9,144107739,8-144120626-T-C,rs13264654,1,T,C,144120626,12887,143911131,144304347,209495
8,ENSG00000155099.3,91040859,8-91083403-A-G,rs13270682,-1,A,G,91083403,42544,90844251,91237467,239152
8,ENSG00000215114.3,58411361,8-58416879-A-G,rs13277646,1,A,G,58416879,5518,58214753,58607969,202126
8,ENSG00000104689.5,23225102,8-23225458-G-C,rs13278062,-1,G,C,23225458,356,23028494,23421710,196964
8,ENSG00000104689.5,23225102,8-23225458-G-A,rs13278062,-1,G,A,23225458,356,23028494,23421710,196964
8,ENSG00000104689.5,23225102,8-23225458-G-T,rs13278062,-1,G,T,23225458,356,23028494,23421710,196964
8,ENSG00000173281.4,9150658,8-9336872-G-A,rs13439811,-1,G,A,9336872,186214,8954050,9347266,382822
8,ENSG00000171033.8,78516340,8-78659987-C-A,rs1384804,1,C,A,78659987,143647,78319732,78712948,340255
8,ENSG00000171033.8,78516340,8-78659987-C-G,rs1384804,1,C,G,78659987,143647,78319732,78712948,340255
8,ENSG00000171033.8,78516340,8-78659987-C-T,rs1384804,1,C,T,78659987,143647,78319732,78712948,340255
8,ENSG00000164930.6,103298898,8-103333550-A-G,rs1403294,1,A,G,103333550,34652,103102290,103495506,231260
8,ENSG00000147434.4,42768786,8-42693096-C-T,rs1530847,-1,C,T,42693096,75690,42572178,42965394,120918
8,ENSG00000147434.4,42768786,8-42693096-C-A,rs1530847,-1,C,A,42693096,75690,42572178,42965394,120918
8,ENSG00000147434.4,42768786,8-42693096-C-G,rs1530847,-1,C,G,42693096,75690,42572178,42965394,120918
8,ENSG00000104427.6,78666089,8-78732202-A-G,rs1545228,1,A,G,78732202,66113,78469481,78862697,262721
8,ENSG00000205038.7,109362461,8-109527686-C-G,rs1673383,1,C,G,109527686,165225,109165853,109559069,361833
8,ENSG00000155097.7,103021083,8-103077254-T-G,rs16870038,1,T,G,103077254,56171,102824475,103217691,252779
8,ENSG00000155097.7,103021083,8-103077254-T-C,rs16870038,1,T,C,103077254,56171,102824475,103217691,252779
8,ENSG00000177669.3,30144665,8-30178120-C-T,rs16876622,-1,C,T,30178120,33455,29948057,30341273,230063
8,ENSG00000177669.3,30144665,8-30178120-C-A,rs16876622,-1,C,A,30178120,33455,29948057,30341273,230063
8,ENSG00000155792.5,119873722,8-119700439-A-G,rs16893021,1,A,G,119700439,173283,119677114,120070330,23325
8,ENSG00000104324.11,96645242,8-96537335-G-A,rs16894706,1,G,A,96537335,107907,96448634,96841850,88701
8,ENSG00000104324.11,96645242,8-96537335-G-T,rs16894706,1,G,T,96537335,107907,96448634,96841850,88701
8,ENSG00000156802.8,123396447,8-123202104-C-T,rs16898132,-1,C,T,123202104,194343,123199839,123593055,2265
8,ENSG00000156802.8,123396447,8-123202104-C-G,rs16898132,-1,C,G,123202104,194343,123199839,123593055,2265
8,ENSG00000253250.2,90985238,8-90935545-C-T,rs16906597,-1,C,T,90935545,49693,90788630,91181846,146915
8,ENSG00000123119.7,90791775,8-90935545-C-T,rs16906597,1,C,T,90935545,143770,90595167,90988383,340378
8,ENSG00000205133.7,92966144,8-92965781-G-T,rs16915402,-1,G,T,92965781,363,92769536,93162752,196245
8,ENSG00000205133.7,92966144,8-92965781-G-A,rs16915402,-1,G,A,92965781,363,92769536,93162752,196245
8,ENSG00000206579.5,55102028,8-55123587-A-G,rs16921164,1,A,G,55123587,21559,54905420,55298636,218167
8,ENSG00000091656.10,76681247,8-76529630-C-T,rs16939292,1,C,T,76529630,151617,76484639,76877855,44991
8,ENSG00000120915.8,27491143,8-27508635-T-A,rs17057284,1,T,A,27508635,17492,27294535,27687751,214100
8,ENSG00000120915.8,27491143,8-27508635-T-G,rs17057284,1,T,G,27508635,17492,27294535,27687751,214100
8,ENSG00000120885.13,27614700,8-27644146-G-A,rs17057475,-1,G,A,27644146,29446,27418092,27811308,226054
8,ENSG00000120885.13,27614700,8-27644146-G-C,rs17057475,-1,G,C,27644146,29446,27418092,27811308,226054
8,ENSG00000147316.8,6406627,8-6407475-C-T,rs17076757,1,C,T,6407475,848,6210019,6603235,197456
8,ENSG00000061337.10,20303963,8-20454222-A-C,rs17092453,-1,A,C,20454222,150259,20107355,20500571,346867
8,ENSG00000061337.10,20303963,8-20454222-A-T,rs17092453,-1,A,T,20454222,150259,20107355,20500571,346867
8,ENSG00000171056.6,10730511,8-10765730-T-C,rs17711777,-1,T,C,10765730,35219,10533903,10927119,231827
8,ENSG00000008988.5,56074506,8-56073858-A-C,rs17814456,-1,A,C,56073858,648,55877898,56271114,195960
8,ENSG00000008988.5,56074506,8-56073858-A-G,rs17814456,-1,A,G,56073858,648,55877898,56271114,195960
8,ENSG00000132541.5,98117171,8-98097220-A-T,rs17832106,-1,A,T,98097220,19951,97920563,98313779,176657
8,ENSG00000132541.5,98117171,8-98097220-A-G,rs17832106,-1,A,G,98097220,19951,97920563,98313779,176657
8,ENSG00000147813.11,143578330,8-143580905-G-A,rs1809148,-1,G,A,143580905,2575,143381722,143774938,199183
8,ENSG00000104497.9,81842185,8-81839587-T-A,rs1814534,-1,T,A,81839587,2598,81645577,82038793,194010
8,ENSG00000104497.9,81842185,8-81839587-T-G,rs1814534,-1,T,G,81839587,2598,81645577,82038793,194010
8,ENSG00000104497.9,81842185,8-81839587-T-C,rs1814534,-1,T,C,81839587,2598,81645577,82038793,194010
8,ENSG00000214814.2,123851987,8-123843073-A-G,rs1821116,1,A,G,123843073,8914,123655379,124048595,187694
8,ENSG00000214814.2,123851987,8-123843073-A-T,rs1821116,1,A,T,123843073,8914,123655379,124048595,187694
8,ENSG00000104290.6,28494212,8-28493236-T-C,rs1946583,1,T,C,28493236,976,28297604,28690820,195632
8,ENSG00000104290.6,28494212,8-28493236-T-A,rs1946583,1,T,A,28493236,976,28297604,28690820,195632
8,ENSG00000104290.6,28494212,8-28493236-T-G,rs1946583,1,T,G,28493236,976,28297604,28690820,195632
8,ENSG00000133731.5,81686325,8-81652967-A-T,rs2142316,-1,A,T,81652967,33358,81489717,81882933,163250
8,ENSG00000133731.5,81686325,8-81652967-A-C,rs2142316,-1,A,C,81652967,33358,81489717,81882933,163250
8,ENSG00000133731.5,81686325,8-81652967-A-G,rs2142316,-1,A,G,81652967,33358,81489717,81882933,163250
8,ENSG00000253598.1,81695058,8-81652967-A-T,rs2142316,-1,A,T,81652967,42091,81498450,81891666,154517
8,ENSG00000253598.1,81695058,8-81652967-A-C,rs2142316,-1,A,C,81652967,42091,81498450,81891666,154517
8,ENSG00000253598.1,81695058,8-81652967-A-G,rs2142316,-1,A,G,81652967,42091,81498450,81891666,154517
8,ENSG00000071894.9,144409335,8-144441971-C-A,rs2242265,-1,C,A,144441971,32636,144212727,144605943,229244
8,ENSG00000160949.11,144444440,8-144439290-G-T,rs2242268,-1,G,T,144439290,5150,144247832,144641048,191458
8,ENSG00000160949.11,144444440,8-144439290-G-A,rs2242268,-1,G,A,144439290,5150,144247832,144641048,191458
8,ENSG00000104611.7,19313693,8-19313865-G-T,rs2272000,1,G,T,19313865,172,19117085,19510301,196780
8,ENSG00000180694.9,90646083,8-90726602-G-C,rs2339230,-1,G,C,90726602,80519,90449475,90842691,277127
8,ENSG00000180694.9,90646083,8-90726602-G-A,rs2339230,-1,G,A,90726602,80519,90449475,90842691,277127
8,ENSG00000180694.9,90646083,8-90726602-G-T,rs2339230,-1,G,T,90726602,80519,90449475,90842691,277127
8,ENSG00000155090.10,102655725,8-102564430-G-A,rs2436889,-1,G,A,102564430,91295,102459117,102852333,105313
8,ENSG00000104517.7,102412700,8-102564430-G-A,rs2436889,-1,G,A,102564430,151730,102216092,102609308,348338
8,ENSG00000156509.9,100145817,8-100206126-G-A,rs2439455,-1,G,A,100206126,60309,99949209,100342425,256917
8,ENSG00000104341.10,97775788,8-97780458-A-C,rs2449504,1,A,C,97780458,4670,97579180,97972396,201278
8,ENSG00000177570.9,118621963,8-118617215-G-T,rs2460970,-1,G,T,118617215,4748,118425355,118818571,191860
8,ENSG00000177570.9,118621963,8-118617215-G-A,rs2460970,-1,G,A,118617215,4748,118425355,118818571,191860
8,ENSG00000104213.7,17577216,8-17575614-T-C,rs2517260,1,T,C,17575614,1602,17380608,17773824,195006
8,ENSG00000104643.5,11284816,8-11379466-A-G,rs2572386,1,A,G,11379466,94650,11088208,11481424,291258
8,ENSG00000092964.10,26514031,8-26576498-G-A,rs2585456,1,G,A,26576498,62467,26317423,26710639,259075
8,ENSG00000092964.10,26514031,8-26576498-G-C,rs2585456,1,G,C,26576498,62467,26317423,26710639,259075
8,ENSG00000196378.5,144787317,8-144825428-C-T,rs2722475,-1,C,T,144825428,38111,144590709,144983925,234719
8,ENSG00000170631.10,144950880,8-144825428-C-T,rs2722475,-1,C,T,144825428,125452,144754272,145147488,71156
8,ENSG00000164823.5,89902570,8-89903080-G-T,rs2735377,1,G,T,89903080,510,89705962,90099178,197118
8,ENSG00000154319.10,11466753,8-11486464-C-G,rs2736340,-1,C,G,11486464,19711,11270145,11663361,216319
8,ENSG00000154319.10,11466753,8-11486464-C-A,rs2736340,-1,C,A,11486464,19711,11270145,11663361,216319
8,ENSG00000154319.10,11466753,8-11486464-C-T,rs2736340,-1,C,T,11486464,19711,11270145,11663361,216319
8,ENSG00000158815.6,22042820,8-21891286-T-C,rs28398141,1,T,C,21891286,151534,21846212,22239428,45074
8,ENSG00000158806.9,22024134,8-21891286-T-C,rs28398141,1,T,C,21891286,132848,21827526,22220742,63760
8,ENSG00000129691.10,38105529,8-38167105-A-T,rs2843745,1,A,T,38167105,61576,37908921,38302137,258184
8,ENSG00000179886.4,143597831,8-143514552-G-A,rs28569868,1,G,A,143514552,83279,143401223,143794439,113329
8,ENSG00000136574.12,11704202,8-11747150-C-G,rs28709984,1,C,G,11747150,42948,11507594,11900810,239556
8,ENSG00000136574.12,11704202,8-11747150-C-T,rs28709984,1,C,T,11747150,42948,11507594,11900810,239556
8,ENSG00000136999.4,119416446,8-119233096-T-A,rs2875872,1,T,A,119233096,183350,119219838,119613054,13258
8,ENSG00000136999.4,119416446,8-119233096-T-C,rs2875872,1,T,C,119233096,183350,119219838,119613054,13258
8,ENSG00000104219.8,17156482,8-17162904-G-A,rs2904662,1,G,A,17162904,6422,16959874,17353090,203030
8,ENSG00000104375.11,98825688,8-98913400-C-G,rs2922068,-1,C,G,98913400,87712,98629080,99022296,284320
8,ENSG00000104375.11,98825688,8-98913400-C-T,rs2922068,-1,C,T,98913400,87712,98629080,99022296,284320
8,ENSG00000164920.5,98944442,8-98913400-C-G,rs2922068,1,C,G,98913400,31042,98747834,99141050,165566
8,ENSG00000164920.5,98944442,8-98913400-C-T,rs2922068,1,C,T,98913400,31042,98747834,99141050,165566
8,ENSG00000104687.8,30727846,8-30766480-T-A,rs2956016,-1,T,A,30766480,38634,30531238,30924454,235242
8,ENSG00000104687.8,30727846,8-30766480-T-G,rs2956016,-1,T,G,30766480,38634,30531238,30924454,235242
8,ENSG00000104687.8,30727846,8-30766480-T-C,rs2956016,-1,T,C,30766480,38634,30531238,30924454,235242
8,ENSG00000147408.10,19602495,8-19638773-C-T,rs2957618,-1,C,T,19638773,36278,19405887,19799103,232886
8,ENSG00000176209.6,42541585,8-42548897-C-T,rs2974349,1,C,T,42548897,7312,42344977,42738193,203920
8,ENSG00000104369.4,74321540,8-74267402-G-A,rs2977046,-1,G,A,74267402,54138,74124932,74518148,142470
8,ENSG00000104369.4,74321540,8-74267402-G-T,rs2977046,-1,G,T,74267402,54138,74124932,74518148,142470
8,ENSG00000253457.1,30638580,8-30598071-G-C,rs2979524,1,G,C,30598071,40509,30441972,30835188,156099
8,ENSG00000253457.1,30638580,8-30598071-G-A,rs2979524,1,G,A,30598071,40509,30441972,30835188,156099
8,ENSG00000078674.11,17922988,8-17754377-G-T,rs2979788,1,G,T,17754377,168611,17726380,18119596,27997
8,ENSG00000078674.11,17922988,8-17754377-G-C,rs2979788,1,G,C,17754377,168611,17726380,18119596,27997
8,ENSG00000078674.11,17922988,8-17754377-G-A,rs2979788,1,G,A,17754377,168611,17726380,18119596,27997
8,ENSG00000164749.7,75539869,8-75413404-C-A,rs2980252,1,C,A,75413404,126465,75343261,75736477,70143
8,ENSG00000164749.7,75539869,8-75413404-C-T,rs2980252,1,C,T,75413404,126465,75343261,75736477,70143
8,ENSG00000164749.7,75539869,8-75413404-C-G,rs2980252,1,C,G,75413404,126465,75343261,75736477,70143
8,ENSG00000147650.6,104589258,8-104496821-T-C,rs3018438,-1,T,C,104496821,92437,104392650,104785866,104171
8,ENSG00000147650.6,104589258,8-104496821-T-G,rs3018438,-1,T,G,104496821,92437,104392650,104785866,104171
8,ENSG00000034677.7,100309953,8-100220780-T-A,rs3020182,-1,T,A,100220780,89173,100113345,100506561,107435
8,ENSG00000034677.7,100309953,8-100220780-T-G,rs3020182,-1,T,G,100220780,89173,100113345,100506561,107435
8,ENSG00000034677.7,100309953,8-100220780-T-C,rs3020182,-1,T,C,100220780,89173,100113345,100506561,107435
8,ENSG00000164933.5,103415107,8-103395913-G-T,rs3098256,-1,G,T,103395913,19194,103218499,103611715,177414
8,ENSG00000104660.13,30095408,8-30016087-A-G,rs309853,1,A,G,30016087,79321,29898800,30292016,117287
8,ENSG00000197275.7,94475115,8-94457138-G-A,rs3098704,-1,G,A,94457138,17977,94278507,94671723,178631
8,ENSG00000164934.8,103415386,8-103407872-T-C,rs3134254,1,T,C,103407872,7514,103218778,103611994,189094
8,ENSG00000164934.8,103415386,8-103407872-T-A,rs3134254,1,T,A,103407872,7514,103218778,103611994,189094
8,ENSG00000165392.5,31033810,8-31132174-C-T,rs3213202,1,C,T,31132174,98364,30837202,31230418,294972
8,ENSG00000160886.9,142700111,8-142740610-C-T,rs34956412,1,C,T,142740610,40499,142503503,142896719,237107
8,ENSG00000104728.11,1823926,8-1906418-T-C,rs35174153,1,T,C,1906418,82492,1627318,2020534,279100
8,ENSG00000167700.3,144509070,8-144514991-C-G,rs35842750,1,C,G,144514991,5921,144312462,144705678,202529
8,ENSG00000167700.3,144509070,8-144514991-C-T,rs35842750,1,C,T,144514991,5921,144312462,144705678,202529
8,ENSG00000104408.5,108248717,8-108091412-A-G,rs370662,-1,A,G,108091412,157305,108052109,108445325,39303
8,ENSG00000164695.4,81732448,8-81732207-G-A,rs3735701,1,G,A,81732207,241,81535840,81929056,196367
8,ENSG00000133739.10,85107238,8-85145768-A-G,rs3779899,1,A,G,85145768,38530,84910630,85303846,235138
8,ENSG00000204839.4,143572772,8-143582424-C-A,rs3793368,-1,C,A,143582424,9652,143376164,143769380,206260
8,ENSG00000204839.4,143572772,8-143582424-C-G,rs3793368,-1,C,G,143582424,9652,143376164,143769380,206260
8,ENSG00000204839.4,143572772,8-143582424-C-T,rs3793368,-1,C,T,143582424,9652,143376164,143769380,206260
8,ENSG00000104522.11,143617549,8-143582129-G-A,rs3793371,-1,G,A,143582129,35420,143420941,143814157,161188
8,ENSG00000183665.4,124450820,8-124450857-A-C,rs3812474,1,A,C,124450857,37,124254212,124647428,196645
8,ENSG00000183665.4,124450820,8-124450857-A-G,rs3812474,1,A,G,124450857,37,124254212,124647428,196645
8,ENSG00000183665.4,124450820,8-124450857-A-T,rs3812474,1,A,T,124450857,37,124254212,124647428,196645
8,ENSG00000175606.6,73976195,8-73982852-T-C,rs3816751,1,T,C,73982852,6657,73779587,74172803,203265
8,ENSG00000036448.5,2045046,8-2133269-A-C,rs3824172,1,A,C,2133269,88223,1848438,2241654,284831
8,ENSG00000036448.5,2045046,8-2133269-A-G,rs3824172,1,A,G,2133269,88223,1848438,2241654,284831
8,ENSG00000036448.5,2045046,8-2133269-A-T,rs3824172,1,A,T,2133269,88223,1848438,2241654,284831
8,ENSG00000178685.8,143986460,8-143987456-C-T,rs3936211,-1,C,T,143987456,996,143789852,144183068,197604
8,ENSG00000160959.3,144517992,8-144516318-C-G,rs4244612,1,C,G,144516318,1674,144321384,144714600,194934
8,ENSG00000160959.3,144517992,8-144516318-C-A,rs4244612,1,C,A,144516318,1674,144321384,144714600,194934
8,ENSG00000198363.9,61714592,8-61748634-A-C,rs4322003,-1,A,C,61748634,34042,61517984,61911200,230650
8,ENSG00000198363.9,61714592,8-61748634-A-G,rs4322003,-1,A,G,61748634,34042,61517984,61911200,230650
8,ENSG00000147459.12,25184689,8-25029429-C-T,rs4392898,1,C,T,25029429,155260,24988081,25381297,41348
8,ENSG00000254093.3,10839875,8-10988971-A-T,rs4484650,-1,A,T,10988971,149096,10643267,11036483,345704
8,ENSG00000197217.8,23457647,8-23412389-A-G,rs4546673,-1,A,G,23412389,45258,23261039,23654255,151350
8,ENSG00000104472.5,140511322,8-140517207-A-T,rs4610723,1,A,T,140517207,5885,140314714,140707930,202493
8,ENSG00000104472.5,140511322,8-140517207-A-G,rs4610723,1,A,G,140517207,5885,140314714,140707930,202493
8,ENSG00000147799.7,144685846,8-144655948-C-T,rs4610795,-1,C,T,144655948,29898,144489238,144882454,166710
8,ENSG00000147799.7,144685846,8-144655948-C-A,rs4610795,-1,C,A,144655948,29898,144489238,144882454,166710
8,ENSG00000197892.8,29263070,8-29221779-T-C,rs4732920,-1,T,C,29221779,41291,29066462,29459678,155317
8,ENSG00000164924.12,100952020,8-100957891-C-G,rs4734500,-1,C,G,100957891,5871,100755412,101148628,202479
8,ENSG00000164924.12,100952020,8-100957891-C-T,rs4734500,-1,C,T,100957891,5871,100755412,101148628,202479
8,ENSG00000168490.8,22232099,8-22254358-C-A,rs4872456,-1,C,A,22254358,22259,22035491,22428707,218867
8,ENSG00000168490.8,22232099,8-22254358-C-G,rs4872456,-1,C,G,22254358,22259,22035491,22428707,218867
8,ENSG00000120910.10,22441078,8-22435793-C-T,rs4872499,1,C,T,22435793,5285,22244470,22637686,191323
8,ENSG00000120910.10,22441078,8-22435793-C-A,rs4872499,1,C,A,22435793,5285,22244470,22637686,191323
8,ENSG00000176623.7,86508686,8-86473939-T-A,rs4961193,-1,T,A,86473939,34747,86312078,86705294,161861
8,ENSG00000176623.7,86508686,8-86473939-T-C,rs4961193,-1,T,C,86473939,34747,86312078,86705294,161861
8,ENSG00000176623.7,86508686,8-86473939-T-G,rs4961193,-1,T,G,86473939,34747,86312078,86705294,161861
8,ENSG00000185000.4,144326852,8-144284925-C-A,rs4977199,-1,C,A,144284925,41927,144130244,144523460,154681
8,ENSG00000185000.4,144326852,8-144284925-C-G,rs4977199,-1,C,G,144284925,41927,144130244,144523460,154681
8,ENSG00000185900.5,43093515,8-43103864-C-T,rs5024011,1,C,T,43103864,10349,42896907,43290123,206957
8,ENSG00000185900.5,43093515,8-43103864-C-G,rs5024011,1,C,G,43103864,10349,42896907,43290123,206957
8,ENSG00000185900.5,43093515,8-43103864-C-A,rs5024011,1,C,A,43103864,10349,42896907,43290123,206957
8,ENSG00000022567.5,141308288,8-141238355-G-A,rs55846720,-1,G,A,141238355,69933,141111680,141504896,126675
8,ENSG00000181790.6,142449649,8-142513030-T-C,rs58371504,1,T,C,142513030,63381,142253041,142646257,259989
8,ENSG00000181790.6,142449649,8-142513030-T-G,rs58371504,1,T,G,142513030,63381,142253041,142646257,259989
8,ENSG00000180921.6,143733779,8-143717088-G-T,rs61201083,-1,G,T,143717088,16691,143537171,143930387,179917
8,ENSG00000131931.4,42843325,8-42817914-G-A,rs62515897,-1,G,A,42817914,25411,42646717,43039933,171197
8,ENSG00000185189.11,143840973,8-143894828-A-C,rs6420192,-1,A,C,143894828,53855,143644365,144037581,250463
8,ENSG00000185189.11,143840973,8-143894828-A-G,rs6420192,-1,A,G,143894828,53855,143644365,144037581,250463
8,ENSG00000175895.3,95133785,8-95100475-C-T,rs6471520,1,C,T,95100475,33310,94937177,95330393,163298
8,ENSG00000175895.3,95133785,8-95100475-C-A,rs6471520,1,C,A,95100475,33310,94937177,95330393,163298
8,ENSG00000175895.3,95133785,8-95100475-C-G,rs6471520,1,C,G,95100475,33310,94937177,95330393,163298
8,ENSG00000185730.3,143291417,8-143294322-G-A,rs6651419,1,G,A,143294322,2905,143094809,143488025,199513
8,ENSG00000185730.3,143291417,8-143294322-G-C,rs6651419,1,G,C,143294322,2905,143094809,143488025,199513
8,ENSG00000185730.3,143291417,8-143294322-G-T,rs6651419,1,G,T,143294322,2905,143094809,143488025,199513
8,ENSG00000161016.10,144792390,8-144770380-G-A,rs66716313,-1,G,A,144770380,22010,144595782,144988998,174598
8,ENSG00000161016.10,144792390,8-144770380-G-T,rs66716313,-1,G,T,144770380,22010,144595782,144988998,174598
8,ENSG00000147324.6,8893630,8-8753273-A-C,rs678250,-1,A,C,8753273,140357,8697022,9090238,56251
8,ENSG00000104228.7,27311272,8-27316536-T-C,rs6981016,-1,T,C,27316536,5264,27114664,27507880,201872
8,ENSG00000147475.9,37736634,8-37669591-A-C,rs6985249,1,A,C,37669591,67043,37540026,37933242,129565
8,ENSG00000221947.3,70669339,8-70681190-G-T,rs6991329,1,G,T,70681190,11851,70472731,70865947,208459
8,ENSG00000221947.3,70669339,8-70681190-G-A,rs6991329,1,G,A,70681190,11851,70472731,70865947,208459
8,ENSG00000164841.4,108787594,8-108900907-G-T,rs6994782,-1,G,T,108900907,113313,108590986,108984202,309921
8,ENSG00000164841.4,108787594,8-108900907-G-A,rs6994782,-1,G,A,108900907,113313,108590986,108984202,309921
8,ENSG00000104442.5,65634177,8-65592869-T-C,rs6995242,-1,T,C,65592869,41308,65437569,65830785,155300
8,ENSG00000104442.5,65634177,8-65592869-T-A,rs6995242,-1,T,A,65592869,41308,65437569,65830785,155300
8,ENSG00000104442.5,65634177,8-65592869-T-G,rs6995242,-1,T,G,65592869,41308,65437569,65830785,155300
8,ENSG00000154328.9,11769710,8-11786463-T-C,rs6997097,1,T,C,11786463,16753,11573102,11966318,213361
8,ENSG00000169495.4,38974228,8-38951427-G-C,rs6999287,1,G,C,38951427,22801,38777620,39170836,173807
8,ENSG00000169495.4,38974228,8-38951427-G-A,rs6999287,1,G,A,38951427,22801,38777620,39170836,173807
8,ENSG00000147647.7,104467055,8-104393693-G-A,rs6999483,-1,G,A,104393693,73362,104270447,104663663,123246
8,ENSG00000212993.3,127409026,8-127428683-A-G,rs6999921,1,A,G,127428683,19657,127212418,127605634,216265
8,ENSG00000158856.11,22056814,8-22111282-T-G,rs7000569,1,T,G,22111282,54468,21860206,22253422,251076
8,ENSG00000158106.8,143368876,8-143365185-A-G,rs7003432,1,A,G,143365185,3691,143172268,143565484,192917
8,ENSG00000147533.11,41490582,8-41443539-A-T,rs7013682,1,A,T,41443539,47043,41293974,41687190,149565
8,ENSG00000147533.11,41490582,8-41443539-A-G,rs7013682,1,A,G,41443539,47043,41293974,41687190,149565
8,ENSG00000147677.6,116755823,8-116905180-A-G,rs7014154,-1,A,G,116905180,149357,116559215,116952431,345965
8,ENSG00000156795.2,123416774,8-123436496-A-G,rs7014678,1,A,G,123436496,19722,123220166,123613382,216330
8,ENSG00000156795.2,123416774,8-123436496-A-T,rs7014678,1,A,T,123436496,19722,123220166,123613382,216330
8,ENSG00000147654.10,109540173,8-109385509-T-G,rs7016085,1,T,G,109385509,154664,109343565,109736781,41944
8,ENSG00000147654.10,109540173,8-109385509-T-C,rs7016085,1,T,C,109385509,154664,109343565,109736781,41944
8,ENSG00000147654.10,109540173,8-109385509-T-A,rs7016085,1,T,A,109385509,154664,109343565,109736781,41944
8,ENSG00000198169.3,144755531,8-144839646-C-G,rs71520599,-1,C,G,144839646,84115,144558923,144952139,280723
8,ENSG00000198169.3,144755531,8-144839646-C-T,rs71520599,-1,C,T,144839646,84115,144558923,144952139,280723
8,ENSG00000198169.3,144755531,8-144839646-C-A,rs71520599,-1,C,A,144839646,84115,144558923,144952139,280723
8,ENSG00000129422.9,17801094,8-17812721-T-C,rs71526162,-1,T,C,17812721,11627,17604486,17997702,208235
8,ENSG00000042980.8,24294069,8-24351834-C-T,rs73217065,1,C,T,24351834,57765,24097461,24490677,254373
8,ENSG00000186523.9,12194082,8-12024892-C-T,rs73542355,-1,C,T,12024892,169190,11997474,12390690,27418
8,ENSG00000186523.9,12194082,8-12024892-C-G,rs73542355,-1,C,G,12024892,169190,11997474,12390690,27418
8,ENSG00000104419.9,133297252,8-133374094-A-C,rs737438,-1,A,C,133374094,76842,133100644,133493860,273450
8,ENSG00000104419.9,133297252,8-133374094-A-G,rs737438,-1,A,G,133374094,76842,133100644,133493860,273450
8,ENSG00000008513.10,133571887,8-133452433-A-G,rs741901,-1,A,G,133452433,119454,133375279,133768495,77154
8,ENSG00000104361.5,98294235,8-98293135-G-A,rs7461545,-1,G,A,98293135,1100,98097627,98490843,195508
8,ENSG00000160972.5,144477982,8-144476070-A-C,rs750472,1,A,C,144476070,1912,144281374,144674590,194696
8,ENSG00000160972.5,144477982,8-144476070-A-G,rs750472,1,A,G,144476070,1912,144281374,144674590,194696
8,ENSG00000120896.9,22551927,8-22587645-T-C,rs75622036,1,T,C,22587645,35718,22355319,22748535,232326
8,ENSG00000120896.9,22551927,8-22587645-T-G,rs75622036,1,T,G,22587645,35718,22355319,22748535,232326
8,ENSG00000147804.5,144416844,8-144414270-T-C,rs75920625,-1,T,C,144414270,2574,144220236,144613452,194034
8,ENSG00000168575.5,42501231,8-42466429-C-T,rs76509575,-1,C,T,42466429,34802,42304623,42697839,161806
8,ENSG00000158941.12,22604757,8-22460519-C-T,rs76564756,1,C,T,22460519,144238,22408149,22801365,52370
8,ENSG00000182307.8,145052467,8-145053635-G-A,rs77005838,1,G,A,145053635,1168,144855859,145249075,197776
8,ENSG00000179388.7,22693480,8-22630437-G-C,rs77509180,-1,G,C,22630437,63043,22496872,22890088,133565
8,ENSG00000179388.7,22693480,8-22630437-G-A,rs77509180,-1,G,A,22630437,63043,22496872,22890088,133565
8,ENSG00000156172.5,95269201,8-95262912-A-T,rs7815085,-1,A,T,95262912,6289,95072593,95465809,190319
8,ENSG00000156172.5,95269201,8-95262912-A-C,rs7815085,-1,A,C,95262912,6289,95072593,95465809,190319
8,ENSG00000156172.5,95269201,8-95262912-A-G,rs7815085,-1,A,G,95262912,6289,95072593,95465809,190319
8,ENSG00000064313.7,119832841,8-119775815-C-T,rs7833407,-1,C,T,119775815,57026,119636233,120029449,139582
8,ENSG00000147604.9,73293633,8-73349099-A-G,rs7835634,-1,A,G,73349099,55466,73097025,73490241,252074
8,ENSG00000147604.9,73293633,8-73349099-A-C,rs7835634,-1,A,C,73349099,55466,73097025,73490241,252074
8,ENSG00000171045.10,142403182,8-142407652-G-A,rs7838831,-1,G,A,142407652,4470,142206574,142599790,201078
8,ENSG00000171045.10,142403182,8-142407652-G-C,rs7838831,-1,G,C,142407652,4470,142206574,142599790,201078
8,ENSG00000171045.10,142403182,8-142407652-G-T,rs7838831,-1,G,T,142407652,4470,142206574,142599790,201078
8,ENSG00000164983.6,124372701,8-124238827-G-C,rs7843699,-1,G,C,124238827,133874,124176093,124569309,62734
8,ENSG00000164983.6,124372701,8-124238827-G-A,rs7843699,-1,G,A,124238827,133874,124176093,124569309,62734
8,ENSG00000164941.9,94823287,8-94871004-A-G,rs7844932,1,A,G,94871004,47717,94626679,95019895,244325
8,ENSG00000164941.9,94823287,8-94871004-A-T,rs7844932,1,A,T,94871004,47717,94626679,95019895,244325
8,ENSG00000147548.10,38382271,8-38277894-T-A,rs7845911,-1,T,A,38277894,104377,38185663,38578879,92231
8,ENSG00000147548.10,38382271,8-38277894-T-C,rs7845911,-1,T,C,38277894,104377,38185663,38578879,92231
8,ENSG00000104524.9,143609575,8-143591786-C-A,rs79185314,-1,C,A,143591786,17789,143412967,143806183,178819
8,ENSG00000129292.15,132775388,8-132905374-C-T,rs79609056,1,C,T,132905374,129986,132578780,132971996,326594
8,ENSG00000079459.7,11802741,8-11769124-C-T,rs8191513,1,C,T,11769124,33617,11606133,11999349,162991
8,ENSG00000104356.6,98117293,8-98186838-C-G,rs896416,1,C,G,98186838,69545,97920685,98313901,266153
8,ENSG00000104356.6,98117293,8-98186838-C-T,rs896416,1,C,T,98186838,69545,97920685,98313901,266153
8,ENSG00000014164.5,143541447,8-143502610-A-G,rs896945,-1,A,G,143502610,38837,143344839,143738055,157771
8,ENSG00000186583.7,144012280,8-143993299-G-T,rs9100,1,G,T,143993299,18981,143815672,144208888,177627
8,ENSG00000186583.7,144012280,8-143993299-G-A,rs9100,1,G,A,143993299,18981,143815672,144208888,177627
8,ENSG00000136573.6,11494387,8-11494403-C-A,rs922483,1,C,A,11494403,16,11297779,11690995,196624
8,ENSG00000136573.6,11494387,8-11494403-C-T,rs922483,1,C,T,11494403,16,11297779,11690995,196624
8,ENSG00000130193.7,142727223,8-142670817-T-C,rs9297976,1,T,C,142670817,56406,142530615,142923831,140202
8,ENSG00000130193.7,142727223,8-142670817-T-G,rs9297976,1,T,G,142670817,56406,142530615,142923831,140202
8,ENSG00000205189.6,80486226,8-80441419-G-A,rs9298338,1,G,A,80441419,44807,80289618,80682834,151801
8,ENSG00000104267.4,85464007,8-85495291-C-T,rs9329911,1,C,T,85495291,31284,85267399,85660615,227892
8,ENSG00000164944.7,94553469,8-94529074-A-T,rs957448,-1,A,T,94529074,24395,94356861,94750077,172213
8,ENSG00000164944.7,94553469,8-94529074-A-G,rs957448,-1,A,G,94529074,24395,94356861,94750077,172213
8,ENSG00000156471.8,96261902,8-96425359-T-C,rs958402,1,T,C,96425359,163457,96065294,96458510,360065
8,ENSG00000156471.8,96261902,8-96425359-T-G,rs958402,1,T,G,96425359,163457,96065294,96458510,360065
8,ENSG00000121039.5,73294602,8-73411653-G-T,rs9643663,1,G,T,73411653,117051,73097994,73491210,313659
8,ENSG00000121039.5,73294602,8-73411653-G-A,rs9643663,1,G,A,73411653,117051,73097994,73491210,313659
8,ENSG00000121039.5,73294602,8-73411653-G-C,rs9643663,1,G,C,73411653,117051,73097994,73491210,313659
8,ENSG00000164794.3,109975771,8-109799846-G-A,rs10091773,-1,G,A,109799846,175925,109779163,110172379,20683
8,ENSG00000134014.11,28093139,8-28228291-T-C,rs10094977,1,T,C,28228291,135152,27896531,28289747,331760
8,ENSG00000104660.13,30095408,8-30020980-T-A,rs10107039,1,T,A,30020980,74428,29898800,30292016,122180
8,ENSG00000120915.8,27491143,8-27544615-T-C,rs1042064,1,T,C,27544615,53472,27294535,27687751,250080
8,ENSG00000180694.9,90646083,8-90532649-C-T,rs10504895,-1,C,T,90532649,113434,90449475,90842691,83174
8,ENSG00000042832.6,132866958,8-132844972-C-A,rs10505602,1,C,A,132844972,21986,132670350,133063566,174622
8,ENSG00000253457.1,30638580,8-30618409-A-G,rs10955031,1,A,G,30618409,20171,30441972,30835188,176437
8,ENSG00000158106.8,143368876,8-143220058-G-A,rs11136273,1,G,A,143220058,148818,143172268,143565484,47790
8,ENSG00000179832.12,144148016,8-143984818-A-T,rs11136343,1,A,T,143984818,163198,143951408,144344624,33410
8,ENSG00000179832.12,144148016,8-143984818-A-G,rs11136343,1,A,G,143984818,163198,143951408,144344624,33410
8,ENSG00000179832.12,144148016,8-143984818-A-C,rs11136343,1,A,C,143984818,163198,143951408,144344624,33410
8,ENSG00000172748.7,232456,8-287333-T-G,rs11136516,1,T,G,287333,54877,35848,429064,251485
8,ENSG00000147437.5,25424261,8-25378082-C-G,rs111902374,-1,C,G,25378082,46179,25227653,25620869,150429
8,ENSG00000147548.10,38382271,8-38523585-G-A,rs112070057,-1,G,A,38523585,141314,38185663,38578879,337922
8,ENSG00000186106.7,100559759,8-100704967-G-C,rs113574896,-1,G,C,100704967,145208,100363151,100756367,341816
8,ENSG00000177669.3,30144665,8-30104435-C-T,rs11557703,-1,C,T,30104435,40230,29948057,30341273,156378
8,ENSG00000147649.5,97644184,8-97716023-G-A,rs116888747,1,G,A,97716023,71839,97447576,97840792,268447
8,ENSG00000189233.7,28083936,8-28142868-T-C,rs117147334,-1,T,C,28142868,58932,27887328,28280544,255540
8,ENSG00000186523.9,12194082,8-12024556-G-A,rs117391281,-1,G,A,12024556,169526,11997474,12390690,27082
8,ENSG00000104419.9,133297252,8-133442986-T-C,rs11774184,-1,T,C,133442986,145734,133100644,133493860,342342
8,ENSG00000076641.3,81112068,8-81125016-G-A,rs11778780,-1,G,A,81125016,12948,80915460,81308676,209556
8,ENSG00000076641.3,81112068,8-81125016-G-T,rs11778780,-1,G,T,81125016,12948,80915460,81308676,209556
8,ENSG00000076641.3,81112068,8-81125016-G-C,rs11778780,-1,G,C,81125016,12948,80915460,81308676,209556
8,ENSG00000104228.7,27311272,8-27210635-C-T,rs11781760,-1,C,T,27210635,100637,27114664,27507880,95971
8,ENSG00000164695.4,81732448,8-81741409-A-T,rs11782652,1,A,T,81741409,8961,81535840,81929056,205569
8,ENSG00000164695.4,81732448,8-81741409-A-G,rs11782652,1,A,G,81741409,8961,81535840,81929056,205569
8,ENSG00000185730.3,143291417,8-143452710-A-T,rs11785686,1,A,T,143452710,161293,143094809,143488025,357901
8,ENSG00000185730.3,143291417,8-143452710-A-G,rs11785686,1,A,G,143452710,161293,143094809,143488025,357901
8,ENSG00000012232.4,28701501,8-28824247-A-G,rs11985067,1,A,G,28824247,122746,28504893,28898109,319354
8,ENSG00000012232.4,28701501,8-28824247-A-T,rs11985067,1,A,T,28824247,122746,28504893,28898109,319354
8,ENSG00000104728.11,1823926,8-1915217-C-T,rs11988014,1,C,T,1915217,91291,1627318,2020534,287899
8,ENSG00000132294.8,131904093,8-132036518-C-T,rs11991293,1,C,T,132036518,132425,131707485,132100701,329033
8,ENSG00000164749.7,75539869,8-75569476-T-C,rs11991658,1,T,C,75569476,29607,75343261,75736477,226215
8,ENSG00000168172.3,42896978,8-42979456-T-C,rs11997992,1,T,C,42979456,82478,42700370,43093586,279086
8,ENSG00000168172.3,42896978,8-42979456-T-G,rs11997992,1,T,G,42979456,82478,42700370,43093586,279086
8,ENSG00000160957.7,144517833,8-144351822-C-A,rs12056725,-1,C,A,144351822,166011,144321225,144714441,30597
8,ENSG00000160957.7,144517833,8-144351822-C-T,rs12056725,-1,C,T,144351822,166011,144321225,144714441,30597
8,ENSG00000160957.7,144517833,8-144351822-C-G,rs12056725,-1,C,G,144351822,166011,144321225,144714441,30597
8,ENSG00000136982.5,119855894,8-119946030-T-C,rs12541789,-1,T,C,119946030,90136,119659286,120052502,286744
8,ENSG00000136982.5,119855894,8-119946030-T-A,rs12541789,-1,T,A,119946030,90136,119659286,120052502,286744
8,ENSG00000171045.10,142403182,8-142437539-G-A,rs12544597,-1,G,A,142437539,34357,142206574,142599790,230965
8,ENSG00000183665.4,124450820,8-124531695-T-A,rs12544621,1,T,A,124531695,80875,124254212,124647428,277483
8,ENSG00000185728.11,63168621,8-63300612-G-A,rs12544880,1,G,A,63300612,131991,62972013,63365229,328599
8,ENSG00000185728.11,63168621,8-63300612-G-C,rs12544880,1,G,C,63300612,131991,62972013,63365229,328599
8,ENSG00000167700.3,144509070,8-144378477-C-A,rs12548842,1,C,A,144378477,130593,144312462,144705678,66015
8,ENSG00000167700.3,144509070,8-144378477-C-G,rs12548842,1,C,G,144378477,130593,144312462,144705678,66015
8,ENSG00000167700.3,144509070,8-144378477-C-T,rs12548842,1,C,T,144378477,130593,144312462,144705678,66015
8,ENSG00000129422.9,17801094,8-17865492-A-G,rs13250201,-1,A,G,17865492,64398,17604486,17997702,261006
8,ENSG00000176595.3,1973677,8-1967930-C-G,rs13250845,1,C,G,1967930,5747,1777069,2170285,190861
8,ENSG00000176595.3,1973677,8-1967930-C-T,rs13250845,1,C,T,1967930,5747,1777069,2170285,190861
8,ENSG00000176595.3,1973677,8-1967930-C-A,rs13250845,1,C,A,1967930,5747,1777069,2170285,190861
8,ENSG00000104529.12,143597415,8-143473146-G-T,rs13253331,-1,G,T,143473146,124269,143400807,143794023,72339
8,ENSG00000104529.12,143597415,8-143473146-G-A,rs13253331,-1,G,A,143473146,124269,143400807,143794023,72339
8,ENSG00000156170.7,95024989,8-95150736-A-C,rs13263827,1,A,C,95150736,125747,94828381,95221597,322355
8,ENSG00000156170.7,95024989,8-95150736-A-G,rs13263827,1,A,G,95150736,125747,94828381,95221597,322355
8,ENSG00000133874.1,33567128,8-33554518-C-T,rs13439478,-1,C,T,33554518,12610,33370520,33763736,183998
8,ENSG00000155087.3,102551589,8-102536282-A-T,rs1347320,1,A,T,102536282,15307,102354981,102748197,181301
8,ENSG00000155087.3,102551589,8-102536282-A-G,rs1347320,1,A,G,102536282,15307,102354981,102748197,181301
8,ENSG00000215114.3,58411361,8-58337342-C-G,rs1457035,1,C,G,58337342,74019,58214753,58607969,122589
8,ENSG00000215114.3,58411361,8-58337342-C-T,rs1457035,1,C,T,58337342,74019,58214753,58607969,122589
8,ENSG00000205038.7,109362461,8-109463347-T-A,rs1673401,1,T,A,109463347,100886,109165853,109559069,297494
8,ENSG00000205038.7,109362461,8-109463347-T-C,rs1673401,1,T,C,109463347,100886,109165853,109559069,297494
8,ENSG00000157110.11,30384541,8-30487075-G-T,rs16877081,1,G,T,30487075,102534,30187933,30581149,299142
8,ENSG00000157110.11,30384541,8-30487075-G-A,rs16877081,1,G,A,30487075,102534,30187933,30581149,299142
8,ENSG00000104368.13,42207565,8-42383040-G-C,rs16891270,-1,G,C,42383040,175475,42010957,42404173,372083
8,ENSG00000104368.13,42207565,8-42383040-G-T,rs16891270,-1,G,T,42383040,175475,42010957,42404173,372083
8,ENSG00000147434.4,42768786,8-42928532-T-C,rs16891647,-1,T,C,42928532,159746,42572178,42965394,356354
8,ENSG00000178764.6,122781655,8-122794460-A-T,rs16897445,1,A,T,122794460,12805,122585047,122978263,209413
8,ENSG00000178764.6,122781655,8-122794460-A-G,rs16897445,1,A,G,122794460,12805,122585047,122978263,209413
8,ENSG00000008988.5,56074506,8-55941613-C-A,rs16922459,-1,C,A,55941613,132893,55877898,56271114,63715
8,ENSG00000008988.5,56074506,8-55941613-C-T,rs16922459,-1,C,T,55941613,132893,55877898,56271114,63715
8,ENSG00000171316.6,60678740,8-60849057-C-T,rs16926499,1,C,T,60849057,170317,60482132,60875348,366925
8,ENSG00000171316.6,60678740,8-60849057-C-G,rs16926499,1,C,G,60849057,170317,60482132,60875348,366925
8,ENSG00000104381.8,74350403,8-74275130-A-G,rs16938845,1,A,G,74275130,75273,74153795,74547011,121335
8,ENSG00000147459.12,25184689,8-25018762-G-A,rs17052988,1,G,A,25018762,165927,24988081,25381297,30681
8,ENSG00000092964.10,26514031,8-26409846-A-T,rs17055196,1,A,T,26409846,104185,26317423,26710639,92423
8,ENSG00000092964.10,26514031,8-26409846-A-C,rs17055196,1,A,C,26409846,104185,26317423,26710639,92423
8,ENSG00000104765.9,26383054,8-26409846-A-T,rs17055196,1,A,T,26409846,26792,26186446,26579662,223400
8,ENSG00000104765.9,26383054,8-26409846-A-C,rs17055196,1,A,C,26409846,26792,26186446,26579662,223400
8,ENSG00000156011.11,19013703,8-19067626-G-A,rs17127771,-1,G,A,19067626,53923,18817095,19210311,250531
8,ENSG00000175895.3,95133785,8-94946409-C-G,rs1713669,1,C,G,94946409,187376,94937177,95330393,9232
8,ENSG00000104361.5,98294235,8-98314531-G-A,rs17367639,-1,G,A,98314531,20296,98097627,98490843,216904
8,ENSG00000156509.9,100145817,8-100291704-A-C,rs17422240,-1,A,C,100291704,145887,99949209,100342425,342495
8,ENSG00000104427.6,78666089,8-78777400-C-T,rs17505589,1,C,T,78777400,111311,78469481,78862697,307919
8,ENSG00000156103.11,88327483,8-88420771-A-G,rs17669974,-1,A,G,88420771,93288,88130875,88524091,289896
8,ENSG00000120910.10,22441078,8-22527548-T-C,rs17733133,1,T,C,22527548,86470,22244470,22637686,283078
8,ENSG00000104321.5,72075584,8-71978366-A-G,rs17737248,-1,A,G,71978366,97218,71878976,72272192,99390
8,ENSG00000165392.5,31033810,8-31081188-G-A,rs1800391,1,G,A,31081188,47378,30837202,31230418,243986
8,ENSG00000104518.6,143558346,8-143580905-G-A,rs1809148,1,G,A,143580905,22559,143361738,143754954,219167
8,ENSG00000133863.2,30913008,8-30917814-A-G,rs1895094,-1,A,G,30917814,4806,30716400,31109616,201414
8,ENSG00000147813.11,143578330,8-143581491-G-T,rs2123758,-1,G,T,143581491,3161,143381722,143774938,199769
8,ENSG00000147813.11,143578330,8-143581491-G-A,rs2123758,-1,G,A,143581491,3161,143381722,143774938,199769
8,ENSG00000104524.9,143609575,8-143596704-C-T,rs2242095,-1,C,T,143596704,12871,143412967,143806183,183737
8,ENSG00000167701.9,144504140,8-144452086-A-G,rs2245052,1,A,G,144452086,52054,144307532,144700748,144554
8,ENSG00000167701.9,144504140,8-144452086-A-T,rs2245052,1,A,T,144452086,52054,144307532,144700748,144554
8,ENSG00000167701.9,144504140,8-144452086-A-C,rs2245052,1,A,C,144452086,52054,144307532,144700748,144554
8,ENSG00000136573.6,11494387,8-11539365-A-G,rs2248325,1,A,G,11539365,44978,11297779,11690995,241586
8,ENSG00000168081.4,28317268,8-28352320-C-T,rs2272750,1,C,T,28352320,35052,28120660,28513876,231660
8,ENSG00000181638.12,143246939,8-143427853-G-C,rs2280930,1,G,C,143427853,180914,143050331,143443547,377522
8,ENSG00000181638.12,143246939,8-143427853-G-A,rs2280930,1,G,A,143427853,180914,143050331,143443547,377522
8,ENSG00000104517.7,102412700,8-102600480-T-G,rs2436929,-1,T,G,102600480,187780,102216092,102609308,384388
8,ENSG00000104517.7,102412700,8-102600480-T-C,rs2436929,-1,T,C,102600480,187780,102216092,102609308,384388
8,ENSG00000104517.7,102412700,8-102600480-T-A,rs2436929,-1,T,A,102600480,187780,102216092,102609308,384388
8,ENSG00000156482.6,98045545,8-98009781-C-T,rs2444896,-1,C,T,98009781,35764,97848937,98242153,160844
8,ENSG00000156482.6,98045545,8-98009781-C-A,rs2444896,-1,C,A,98009781,35764,97848937,98242153,160844
8,ENSG00000164949.3,94262319,8-94241168-T-G,rs2448911,-1,T,G,94241168,21151,94065711,94458927,175457
8,ENSG00000104341.10,97775788,8-97773295-A-C,rs2449529,1,A,C,97773295,2493,97579180,97972396,194115
8,ENSG00000104341.10,97775788,8-97773295-A-G,rs2449529,1,A,G,97773295,2493,97579180,97972396,194115
8,ENSG00000104341.10,97775788,8-97773295-A-T,rs2449529,1,A,T,97773295,2493,97579180,97972396,194115
8,ENSG00000155090.10,102655725,8-102646717-C-T,rs2511718,-1,C,T,102646717,9008,102459117,102852333,187600
8,ENSG00000177459.6,98064568,8-98099678-A-G,rs2514334,1,A,G,98099678,35110,97867960,98261176,231718
8,ENSG00000177570.9,118621963,8-118621516-G-A,rs2514599,-1,G,A,118621516,447,118425355,118818571,196161
8,ENSG00000182197.6,118111826,8-118195608-C-G,rs2514981,-1,C,G,118195608,83782,117915218,118308434,280390
8,ENSG00000182197.6,118111826,8-118195608-C-T,rs2514981,-1,C,T,118195608,83782,117915218,118308434,280390
8,ENSG00000169427.2,139703123,8-139543601-A-T,rs2542474,-1,A,T,139543601,159522,139506515,139899731,37086
8,ENSG00000169427.2,139703123,8-139543601-A-G,rs2542474,-1,A,G,139543601,159522,139506515,139899731,37086
8,ENSG00000177710.5,11331012,8-11243532-A-T,rs2572433,1,A,T,11243532,87480,11134404,11527620,109128
8,ENSG00000177710.5,11331012,8-11243532-A-G,rs2572433,1,A,G,11243532,87480,11134404,11527620,109128
8,ENSG00000177710.5,11331012,8-11243532-A-C,rs2572433,1,A,C,11243532,87480,11134404,11527620,109128
8,ENSG00000079112.5,94208555,8-94225198-G-T,rs2623151,-1,G,T,94225198,16643,94011947,94405163,213251
8,ENSG00000079112.5,94208555,8-94225198-G-A,rs2623151,-1,G,A,94225198,16643,94011947,94405163,213251
8,ENSG00000079112.5,94208555,8-94225198-G-C,rs2623151,-1,G,C,94225198,16643,94011947,94405163,213251
8,ENSG00000067167.3,70608416,8-70648189-C-A,rs268629,-1,C,A,70648189,39773,70411808,70805024,236381
8,ENSG00000067167.3,70608416,8-70648189-C-T,rs268629,-1,C,T,70648189,39773,70411808,70805024,236381
8,ENSG00000164930.6,103298898,8-103317360-C-T,rs2687347,1,C,T,103317360,18462,103102290,103495506,215070
8,ENSG00000164930.6,103298898,8-103317360-C-G,rs2687347,1,C,G,103317360,18462,103102290,103495506,215070
8,ENSG00000164930.6,103298898,8-103317360-C-A,rs2687347,1,C,A,103317360,18462,103102290,103495506,215070
8,ENSG00000147642.12,109644822,8-109544654-G-C,rs2703389,-1,G,C,109544654,100168,109448214,109841430,96440
8,ENSG00000137547.4,54135241,8-54296305-C-A,rs2719384,1,C,A,54296305,161064,53938633,54331849,357672
8,ENSG00000172728.10,33473146,8-33438181-A-G,rs2732256,-1,A,G,33438181,34965,33276538,33669754,161643
8,ENSG00000155096.8,102864163,8-102721250-G-A,rs28366584,-1,G,A,102721250,142913,102667555,103060771,53695
8,ENSG00000156787.11,123072707,8-122991509-A-G,rs28385415,1,A,G,122991509,81198,122876099,123269315,115410
8,ENSG00000147601.7,73008864,8-72953611-G-C,rs28616742,1,G,C,72953611,55253,72812256,73205472,141355
8,ENSG00000147601.7,73008864,8-72953611-G-A,rs28616742,1,G,A,72953611,55253,72812256,73205472,141355
8,ENSG00000175324.5,38176493,8-38341271-A-G,rs28674538,-1,A,G,38341271,164778,37979885,38373101,361386
8,ENSG00000165066.10,41650817,8-41632742-C-A,rs2920123,-1,C,A,41632742,18075,41454209,41847425,178533
8,ENSG00000165066.10,41650817,8-41632742-C-T,rs2920123,-1,C,T,41632742,18075,41454209,41847425,178533
8,ENSG00000165066.10,41650817,8-41632742-C-G,rs2920123,-1,C,G,41632742,18075,41454209,41847425,178533
8,ENSG00000104371.3,42377229,8-42549034-G-A,rs2923446,-1,G,A,42549034,171805,42180621,42573837,368413
8,ENSG00000008513.10,133571887,8-133528207-T-C,rs2945787,-1,T,C,133528207,43680,133375279,133768495,152928
8,ENSG00000155189.7,6708642,8-6835973-T-G,rs2951851,1,T,G,6835973,127331,6512034,6905250,323939
8,ENSG00000155189.7,6708642,8-6835973-T-C,rs2951851,1,T,C,6835973,127331,6512034,6905250,323939
8,ENSG00000155189.7,6708642,8-6835973-T-A,rs2951851,1,T,A,6835973,127331,6512034,6905250,323939
8,ENSG00000197363.4,144798913,8-144799567-G-A,rs2958522,1,G,A,144799567,654,144602305,144995521,197262
8,ENSG00000197363.4,144798913,8-144799567-G-C,rs2958522,1,G,C,144799567,654,144602305,144995521,197262
8,ENSG00000132541.5,98117171,8-98076023-A-G,rs2959644,-1,A,G,98076023,41148,97920563,98313779,155460
8,ENSG00000176209.6,42541585,8-42600703-C-T,rs2974312,1,C,T,42600703,59118,42344977,42738193,255726
8,ENSG00000071894.9,144409335,8-144397883-C-G,rs2977834,-1,C,G,144397883,11452,144212727,144605943,185156
8,ENSG00000071894.9,144409335,8-144397883-C-A,rs2977834,-1,C,A,144397883,11452,144212727,144605943,185156
8,ENSG00000071894.9,144409335,8-144397883-C-T,rs2977834,-1,C,T,144397883,11452,144212727,144605943,185156
8,ENSG00000197275.7,94475115,8-94401878-C-T,rs3019146,-1,C,T,94401878,73237,94278507,94671723,123371
8,ENSG00000147650.6,104589258,8-104462707-T-G,rs3133278,-1,T,G,104462707,126551,104392650,104785866,70057
8,ENSG00000147650.6,104589258,8-104462707-T-C,rs3133278,-1,T,C,104462707,126551,104392650,104785866,70057
8,ENSG00000034677.7,100309953,8-100150218-C-G,rs3133677,-1,C,G,100150218,159735,100113345,100506561,36873
8,ENSG00000034677.7,100309953,8-100150218-C-T,rs3133677,-1,C,T,100150218,159735,100113345,100506561,36873
8,ENSG00000164933.5,103415107,8-103395865-T-A,rs3133806,-1,T,A,103395865,19242,103218499,103611715,177366
8,ENSG00000164933.5,103415107,8-103395865-T-C,rs3133806,-1,T,C,103395865,19242,103218499,103611715,177366
8,ENSG00000147526.13,38787236,8-38712463-G-A,rs34821839,1,G,A,38712463,74773,38590628,38983844,121835
8,ENSG00000178814.11,144060692,8-143921796-G-A,rs35139934,-1,G,A,143921796,138896,143864084,144257300,57712
8,ENSG00000147684.3,124539123,8-124430010-C-G,rs35630807,1,C,G,124430010,109113,124342515,124735731,87495
8,ENSG00000147684.3,124539123,8-124430010-C-T,rs35630807,1,C,T,124430010,109113,124342515,124735731,87495
8,ENSG00000154359.8,12755526,8-12770785-C-A,rs35735067,-1,C,A,12770785,15259,12558918,12952134,211867
8,ENSG00000154359.8,12755526,8-12770785-C-T,rs35735067,-1,C,T,12770785,15259,12558918,12952134,211867
8,ENSG00000205002.3,116938207,8-116837735-G-A,rs35811513,1,G,A,116837735,100472,116741599,117134815,96136
8,ENSG00000205002.3,116938207,8-116837735-G-T,rs35811513,1,G,T,116837735,100472,116741599,117134815,96136
8,ENSG00000205002.3,116938207,8-116837735-G-C,rs35811513,1,G,C,116837735,100472,116741599,117134815,96136
8,ENSG00000187954.8,144462871,8-144514991-C-T,rs35842750,-1,C,T,144514991,52120,144266263,144659479,248728
8,ENSG00000187954.8,144462871,8-144514991-C-G,rs35842750,-1,C,G,144514991,52120,144266263,144659479,248728
8,ENSG00000104312.6,89757816,8-89825402-G-A,rs374957,1,G,A,89825402,67586,89561208,89954424,264194
8,ENSG00000183309.5,143636019,8-143650280-G-T,rs3750204,1,G,T,143650280,14261,143439411,143832627,210869
8,ENSG00000183309.5,143636019,8-143650280-G-C,rs3750204,1,G,C,143650280,14261,143439411,143832627,210869
8,ENSG00000183309.5,143636019,8-143650280-G-A,rs3750204,1,G,A,143650280,14261,143439411,143832627,210869
8,ENSG00000198846.4,59119147,8-59000178-T-A,rs380013,-1,T,A,59000178,118969,58922539,59315755,77639
8,ENSG00000198846.4,59119147,8-59000178-T-C,rs380013,-1,T,C,59000178,118969,58922539,59315755,77639
8,ENSG00000182307.8,145052467,8-144946362-G-T,rs3824109,1,G,T,144946362,106105,144855859,145249075,90503
8,ENSG00000182307.8,145052467,8-144946362-G-A,rs3824109,1,G,A,144946362,106105,144855859,145249075,90503
8,ENSG00000205189.6,80486226,8-80495621-C-T,rs3863246,1,C,T,80495621,9395,80289618,80682834,206003
8,ENSG00000205189.6,80486226,8-80495621-C-G,rs3863246,1,C,G,80495621,9395,80289618,80682834,206003
8,ENSG00000164924.12,100952020,8-100975998-G-A,rs4002957,-1,G,A,100975998,23978,100755412,101148628,220586
8,ENSG00000147687.11,124539085,8-124588403-T-C,rs4007923,-1,T,C,124588403,49318,124342477,124735693,245926
8,ENSG00000168615.7,38996973,8-39146326-A-G,rs4236757,1,A,G,39146326,149353,38800365,39193581,345961
8,ENSG00000104356.6,98117293,8-98155095-T-C,rs4305870,1,T,C,98155095,37802,97920685,98313901,234410
8,ENSG00000234616.3,142669967,8-142857551-G-A,rs4383949,-1,G,A,142857551,187584,142473359,142866575,384192
8,ENSG00000183638.5,10655143,8-10553413-T-C,rs4395859,-1,T,C,10553413,101730,10458535,10851751,94878
8,ENSG00000175305.11,94895201,8-94702955-T-C,rs4443628,-1,T,C,94702955,192246,94698593,95091809,4362
8,ENSG00000104613.6,19817416,8-19800506-T-G,rs4577973,1,T,G,19800506,16910,19620808,20014024,179698
8,ENSG00000104613.6,19817416,8-19800506-T-C,rs4577973,1,T,C,19800506,16910,19620808,20014024,179698
8,ENSG00000104613.6,19817416,8-19800506-T-A,rs4577973,1,T,A,19800506,16910,19620808,20014024,179698
8,ENSG00000136986.4,123042302,8-122872543-A-G,rs4593547,-1,A,G,122872543,169759,122845694,123238910,26849
8,ENSG00000079459.7,11802741,8-11844424-T-A,rs4839,1,T,A,11844424,41683,11606133,11999349,238291
8,ENSG00000079459.7,11802741,8-11844424-T-C,rs4839,1,T,C,11844424,41683,11606133,11999349,238291
8,ENSG00000014164.5,143541447,8-143488567-T-C,rs4874139,-1,T,C,143488567,52880,143344839,143738055,143728
8,ENSG00000160949.11,144444440,8-144411764-G-C,rs4925820,-1,G,C,144411764,32676,144247832,144641048,163932
8,ENSG00000160949.11,144444440,8-144411764-G-T,rs4925820,-1,G,T,144411764,32676,144247832,144641048,163932
8,ENSG00000147324.6,8893630,8-8772759-A-C,rs506960,-1,A,C,8772759,120871,8697022,9090238,75737
8,ENSG00000253958.1,8701937,8-8760920-C-A,rs517394,1,C,A,8760920,58983,8505329,8898545,255591
8,ENSG00000179886.4,143597831,8-143479428-G-A,rs55747119,1,G,A,143479428,118403,143401223,143794439,78205
8,ENSG00000029534.14,41797622,8-41713915-C-T,rs558889,-1,C,T,41713915,83707,41601014,41994230,112901
8,ENSG00000153310.12,129939832,8-129820267-G-A,rs61058420,-1,G,A,129820267,119565,129743224,130136440,77043
8,ENSG00000160932.6,143018529,8-142912850-A-C,rs61757294,1,A,C,142912850,105679,142821921,143215137,90929
8,ENSG00000160932.6,143018529,8-142912850-A-G,rs61757294,1,A,G,142912850,105679,142821921,143215137,90929
8,ENSG00000167034.8,23682938,8-23523230-C-T,rs62503281,-1,C,T,23523230,159708,23486330,23879546,36900
8,ENSG00000167034.8,23682938,8-23523230-C-A,rs62503281,-1,C,A,23523230,159708,23486330,23879546,36900
8,ENSG00000167034.8,23682938,8-23523230-C-G,rs62503281,-1,C,G,23523230,159708,23486330,23879546,36900
8,ENSG00000156162.12,94719900,8-94794226-C-A,rs6415570,1,C,A,94794226,74326,94523292,94916508,270934
8,ENSG00000156795.2,123416774,8-123451258-A-C,rs6470153,1,A,C,123451258,34484,123220166,123613382,231092
8,ENSG00000180921.6,143733779,8-143810914-G-A,rs6558394,-1,G,A,143810914,77135,143537171,143930387,273743
8,ENSG00000171033.8,78516340,8-78573815-A-G,rs6980867,1,A,G,78573815,57475,78319732,78712948,254083
8,ENSG00000153317.9,130443674,8-130473278-G-C,rs6986306,-1,G,C,130473278,29604,130247066,130640282,226212
8,ENSG00000104490.12,101790969,8-101958412-C-T,rs6991019,-1,C,T,101958412,167443,101594361,101987577,364051
8,ENSG00000104490.12,101790969,8-101958412-C-A,rs6991019,-1,C,A,101958412,167443,101594361,101987577,364051
8,ENSG00000156172.5,95269201,8-95290145-G-A,rs6996255,-1,G,A,95290145,20944,95072593,95465809,217552
8,ENSG00000186583.7,144012280,8-143923759-G-A,rs7002002,1,G,A,143923759,88521,143815672,144208888,108087
8,ENSG00000179526.12,144103773,8-144059941-C-T,rs7004867,-1,C,T,144059941,43832,143907165,144300381,152776
8,ENSG00000164683.11,79767767,8-79937615-T-C,rs7008017,-1,T,C,79937615,169848,79571159,79964375,366456
8,ENSG00000173281.4,9150658,8-9087592-A-C,rs7009435,-1,A,C,9087592,63066,8954050,9347266,133542
8,ENSG00000173281.4,9150658,8-9087592-A-G,rs7009435,-1,A,G,9087592,63066,8954050,9347266,133542
8,ENSG00000164823.5,89902570,8-89863690-T-C,rs7015630,1,T,C,89863690,38880,89705962,90099178,157728
8,ENSG00000164823.5,89902570,8-89863690-T-A,rs7015630,1,T,A,89863690,38880,89705962,90099178,157728
8,ENSG00000022567.5,141308288,8-141164245-G-A,rs72681540,-1,G,A,141164245,144043,141111680,141504896,52565
8,ENSG00000160948.8,144428548,8-144452980-C-T,rs72697630,-1,C,T,144452980,24432,144231940,144625156,221040
8,ENSG00000164983.6,124372701,8-124364493-A-G,rs72711187,-1,A,G,124364493,8208,124176093,124569309,188400
8,ENSG00000185000.4,144326852,8-144286837-G-A,rs73374024,-1,G,A,144286837,40015,144130244,144523460,156593
8,ENSG00000164751.10,77000078,8-76924071-C-T,rs73691231,-1,C,T,76924071,76007,76803470,77196686,120601
8,ENSG00000164751.10,77000078,8-76924071-C-A,rs73691231,-1,C,A,76924071,76007,76803470,77196686,120601
8,ENSG00000159167.6,23854806,8-23798595-A-G,rs75009409,-1,A,G,23798595,56211,23658198,24051414,140397
8,ENSG00000085788.8,38231585,8-38047841-C-T,rs75553966,1,C,T,38047841,183744,38034977,38428193,12864
8,ENSG00000123908.7,140635633,8-140462990-G-T,rs75670848,-1,G,T,140462990,172643,140439025,140832241,23965
8,ENSG00000180543.3,97277928,8-97262093-T-C,rs76602935,-1,T,C,97262093,15835,97081320,97474536,180773
8,ENSG00000168575.5,42501231,8-42571503-T-C,rs76831292,-1,T,C,42571503,70272,42304623,42697839,266880
8,ENSG00000104313.12,71362069,8-71358716-T-C,rs76981761,-1,T,C,71358716,3353,71165461,71558677,193255
8,ENSG00000164808.10,47260938,8-47380517-G-A,rs77182583,1,G,A,47380517,119579,47064330,47457546,316187
8,ENSG00000164808.10,47260938,8-47380517-G-C,rs77182583,1,G,C,47380517,119579,47064330,47457546,316187
8,ENSG00000183117.10,4994914,8-5032626-G-A,rs77220086,-1,G,A,5032626,37712,4798306,5191522,234320
8,ENSG00000183117.10,4994914,8-5032626-G-C,rs77220086,-1,G,C,5032626,37712,4798306,5191522,234320
8,ENSG00000183117.10,4994914,8-5032626-G-T,rs77220086,-1,G,T,5032626,37712,4798306,5191522,234320
8,ENSG00000212993.3,127409026,8-127556093-G-A,rs77288742,1,G,A,127556093,147067,127212418,127605634,343675
8,ENSG00000203499.6,143734139,8-143543326-G-C,rs7814091,1,G,C,143543326,190813,143537531,143930747,5795
8,ENSG00000203499.6,143734139,8-143543326-G-A,rs7814091,1,G,A,143543326,190813,143537531,143930747,5795
8,ENSG00000164951.11,93916923,8-93919644-G-T,rs7814312,1,G,T,93919644,2721,93720315,94113531,199329
8,ENSG00000164951.11,93916923,8-93919644-G-A,rs7814312,1,G,A,93919644,2721,93720315,94113531,199329
8,ENSG00000253598.1,81695058,8-81545273-C-T,rs78153152,-1,C,T,81545273,149785,81498450,81891666,46823
8,ENSG00000104450.8,100158587,8-100198243-A-G,rs7816209,1,A,G,100198243,39656,99961979,100355195,236264
8,ENSG00000173334.3,125430358,8-125337964-C-A,rs7820471,1,C,A,125337964,92394,125233750,125626966,104214
8,ENSG00000173334.3,125430358,8-125337964-C-G,rs7820471,1,C,G,125337964,92394,125233750,125626966,104214
8,ENSG00000173334.3,125430358,8-125337964-C-T,rs7820471,1,C,T,125337964,92394,125233750,125626966,104214
8,ENSG00000253250.2,90985238,8-91023093-A-C,rs7828122,-1,A,C,91023093,37855,90788630,91181846,234463
8,ENSG00000253250.2,90985238,8-91023093-A-G,rs7828122,-1,A,G,91023093,37855,90788630,91181846,234463
8,ENSG00000137574.6,55773446,8-55757421-T-G,rs7828202,1,T,G,55757421,16025,55576838,55970054,180583
8,ENSG00000137574.6,55773446,8-55757421-T-C,rs7828202,1,T,C,55757421,16025,55576838,55970054,180583
8,ENSG00000137574.6,55773446,8-55757421-T-A,rs7828202,1,T,A,55757421,16025,55576838,55970054,180583
8,ENSG00000066855.10,65644734,8-65716971-T-C,rs7829562,1,T,C,65716971,72237,65448126,65841342,268845
8,ENSG00000161016.10,144792390,8-144785726-T-A,rs7833780,-1,T,A,144785726,6664,144595782,144988998,189944
8,ENSG00000161016.10,144792390,8-144785726-T-G,rs7833780,-1,T,G,144785726,6664,144595782,144988998,189944
8,ENSG00000070501.6,42338494,8-42490117-G-A,rs7834047,1,G,A,42490117,151623,42141886,42535102,348231
8,ENSG00000104497.9,81842185,8-81786093-G-A,rs7836040,-1,G,A,81786093,56092,81645577,82038793,140516
8,ENSG00000036448.5,2045046,8-2217043-G-A,rs7838658,1,G,A,2217043,171997,1848438,2241654,368605
8,ENSG00000104219.8,17156482,8-17150571-T-A,rs7842887,1,T,A,17150571,5911,16959874,17353090,190697
8,ENSG00000104219.8,17156482,8-17150571-T-C,rs7842887,1,T,C,17150571,5911,16959874,17353090,190697
8,ENSG00000173530.5,23164027,8-23130480-C-G,rs7843602,-1,C,G,23130480,33547,22967419,23360635,163061
8,ENSG00000173530.5,23164027,8-23130480-C-T,rs7843602,-1,C,T,23130480,33547,22967419,23360635,163061
8,ENSG00000172167.3,120445419,8-120566847-T-C,rs7845125,1,T,C,120566847,121428,120248811,120642027,318036
8,ENSG00000196150.7,144901453,8-145000270-C-T,rs79615697,-1,C,T,145000270,98817,144704845,145098061,295425
8,ENSG00000130193.7,142727223,8-142768077-C-T,rs79649145,1,C,T,142768077,40854,142530615,142923831,237462
8,ENSG00000204839.4,143572772,8-143558336-G-C,rs80346174,-1,G,C,143558336,14436,143376164,143769380,182172
8,ENSG00000070718.7,42153063,8-42188571-C-T,rs8178743,1,C,T,42188571,35508,41956455,42349671,232116
8,ENSG00000154328.9,11769710,8-11769124-C-T,rs8191513,1,C,T,11769124,586,11573102,11966318,196022
8,ENSG00000160886.9,142700111,8-142670817-T-G,rs9297976,1,T,G,142670817,29294,142503503,142896719,167314
8,ENSG00000160886.9,142700111,8-142670817-T-C,rs9297976,1,T,C,142670817,29294,142503503,142896719,167314
8,ENSG00000154319.10,11466753,8-11465516-G-A,rs9644687,-1,G,A,11465516,1237,11270145,11663361,195371
8,ENSG00000154319.10,11466753,8-11465516-G-C,rs9644687,-1,G,C,11465516,1237,11270145,11663361,195371
8,ENSG00000164761.4,118951885,8-119004840-A-G,rs9650075,-1,A,G,119004840,52955,118755277,119148493,249563
8,ENSG00000179698.9,144107739,8-144221689-C-G,rs9650467,1,C,G,144221689,113950,143911131,144304347,310558
8,ENSG00000179698.9,144107739,8-144221689-C-A,rs9650467,1,C,A,144221689,113950,143911131,144304347,310558
8,ENSG00000140396.7,70403808,8-70501032-C-T,rs10089018,-1,C,T,70501032,97224,70207200,70600416,293832
8,ENSG00000140396.7,70403808,8-70501032-C-G,rs10089018,-1,C,G,70501032,97224,70207200,70600416,293832
8,ENSG00000180828.1,64580365,8-64682970-C-G,rs10090584,1,C,G,64682970,102605,64383757,64776973,299213
8,ENSG00000180828.1,64580365,8-64682970-C-A,rs10090584,1,C,A,64682970,102605,64383757,64776973,299213
8,ENSG00000180900.11,143815773,8-143648286-G-A,rs10098662,-1,G,A,143648286,167487,143619165,144012381,29121
8,ENSG00000176595.3,1973677,8-2153558-A-G,rs10099190,1,A,G,2153558,179881,1777069,2170285,376489
8,ENSG00000176595.3,1973677,8-2153558-A-C,rs10099190,1,A,C,2153558,179881,1777069,2170285,376489
8,ENSG00000176595.3,1973677,8-2153558-A-T,rs10099190,1,A,T,2153558,179881,1777069,2170285,376489
8,ENSG00000204839.4,143572772,8-143516839-C-T,rs10103957,-1,C,T,143516839,55933,143376164,143769380,140675
8,ENSG00000159167.6,23854806,8-23859057-G-A,rs10108951,-1,G,A,23859057,4251,23658198,24051414,200859
8,ENSG00000159167.6,23854806,8-23859057-G-C,rs10108951,-1,G,C,23859057,4251,23658198,24051414,200859
8,ENSG00000104219.8,17156482,8-17135465-A-G,rs10110771,1,A,G,17135465,21017,16959874,17353090,175591
8,ENSG00000104219.8,17156482,8-17135465-A-T,rs10110771,1,A,T,17135465,21017,16959874,17353090,175591
8,ENSG00000178764.6,122781655,8-122708376-G-A,rs10217088,1,G,A,122708376,73279,122585047,122978263,123329
8,ENSG00000136997.9,127736231,8-127672086-T-G,rs10429276,1,T,G,127672086,64145,127539623,127932839,132463
8,ENSG00000147650.6,104589258,8-104550948-C-T,rs10429349,-1,C,T,104550948,38310,104392650,104785866,158298
8,ENSG00000173530.5,23164027,8-23003453-T-G,rs1107140,-1,T,G,23003453,160574,22967419,23360635,36034
8,ENSG00000178719.11,143990056,8-143984818-A-T,rs11136343,1,A,T,143984818,5238,143793448,144186664,191370
8,ENSG00000178719.11,143990056,8-143984818-A-C,rs11136343,1,A,C,143984818,5238,143793448,144186664,191370
8,ENSG00000178719.11,143990056,8-143984818-A-G,rs11136343,1,A,G,143984818,5238,143793448,144186664,191370
8,ENSG00000104613.6,19817416,8-19792822-T-G,rs11204072,1,T,G,19792822,24594,19620808,20014024,172014
8,ENSG00000104613.6,19817416,8-19792822-T-C,rs11204072,1,T,C,19792822,24594,19620808,20014024,172014
8,ENSG00000158815.6,22042820,8-22026004-A-C,rs113373756,1,A,C,22026004,16816,21846212,22239428,179792
8,ENSG00000158815.6,22042820,8-22026004-A-G,rs113373756,1,A,G,22026004,16816,21846212,22239428,179792
8,ENSG00000167702.6,144466337,8-144524616-G-A,rs114251607,1,G,A,144524616,58279,144269729,144662945,254887
8,ENSG00000104522.11,143617549,8-143607119-C-T,rs11549789,-1,C,T,143607119,10430,143420941,143814157,186178
8,ENSG00000133878.4,33600023,8-33677947-C-A,rs115503498,-1,C,A,33677947,77924,33403415,33796631,274532
8,ENSG00000164687.6,81280536,8-81280973-C-T,rs116967130,1,C,T,81280973,437,81083928,81477144,197045
8,ENSG00000164808.10,47260938,8-47148937-T-C,rs116980433,1,T,C,47148937,112001,47064330,47457546,84607
8,ENSG00000104660.13,30095408,8-30262546-G-A,rs117561059,1,G,A,30262546,167138,29898800,30292016,363746
8,ENSG00000158941.12,22604757,8-22727401-G-C,rs117648676,1,G,C,22727401,122644,22408149,22801365,319252
8,ENSG00000070718.7,42153063,8-42032867-T-C,rs11774557,1,T,C,42032867,120196,41956455,42349671,76412
8,ENSG00000070718.7,42153063,8-42032867-T-G,rs11774557,1,T,G,42032867,120196,41956455,42349671,76412
8,ENSG00000176623.7,86508686,8-86375722-A-G,rs11775728,-1,A,G,86375722,132964,86312078,86705294,63644
8,ENSG00000188343.7,93700550,8-93649861-T-C,rs11776927,1,T,C,93649861,50689,93503942,93897158,145919
8,ENSG00000104332.6,41309473,8-41144576-G-A,rs117984023,-1,G,A,41144576,164897,41112865,41506081,31711
8,ENSG00000171044.5,11201833,8-11013760-A-G,rs118103120,-1,A,G,11013760,188073,11005225,11398441,8535
8,ENSG00000179698.9,144107739,8-144077730-T-C,rs11990558,1,T,C,144077730,30009,143911131,144304347,166599
8,ENSG00000147684.3,124539123,8-124591057-G-A,rs11994203,1,G,A,124591057,51934,124342515,124735731,248542
8,ENSG00000183665.4,124450820,8-124591057-G-A,rs11994203,1,G,A,124591057,140237,124254212,124647428,336845
8,ENSG00000136982.5,119855894,8-119791414-C-T,rs11996390,-1,C,T,119791414,64480,119659286,120052502,132128
8,ENSG00000136982.5,119855894,8-119791414-C-G,rs11996390,-1,C,G,119791414,64480,119659286,120052502,132128
8,ENSG00000178685.8,143986460,8-143871023-T-C,rs12543389,-1,T,C,143871023,115437,143789852,144183068,81171
8,ENSG00000173535.8,23102921,8-23231650-C-T,rs12543863,1,C,T,23231650,128729,22906313,23299529,325337
8,ENSG00000173535.8,23102921,8-23231650-C-A,rs12543863,1,C,A,23231650,128729,22906313,23299529,325337
8,ENSG00000147724.7,138497261,8-138604522-C-T,rs12543875,-1,C,T,138604522,107261,138300653,138693869,303869
8,ENSG00000185730.3,143291417,8-143474771-A-G,rs12547588,1,A,G,143474771,183354,143094809,143488025,379962
8,ENSG00000185730.3,143291417,8-143474771-A-C,rs12547588,1,A,C,143474771,183354,143094809,143488025,379962
8,ENSG00000164941.9,94823287,8-94922936-C-A,rs12548874,1,C,A,94922936,99649,94626679,95019895,296257
8,ENSG00000164941.9,94823287,8-94922936-C-G,rs12548874,1,C,G,94922936,99649,94626679,95019895,296257
8,ENSG00000035681.3,58659853,8-58586126-T-G,rs12679938,-1,T,G,58586126,73727,58463245,58856461,122881
8,ENSG00000147647.7,104467055,8-104375922-A-C,rs1316456,-1,A,C,104375922,91133,104270447,104663663,105475
8,ENSG00000147647.7,104467055,8-104375922-A-G,rs1316456,-1,A,G,104375922,91133,104270447,104663663,105475
8,ENSG00000156482.6,98045545,8-98223600-A-G,rs1319282,-1,A,G,98223600,178055,97848937,98242153,374663
8,ENSG00000147548.10,38382271,8-38403297-T-C,rs13248631,-1,T,C,38403297,21026,38185663,38578879,217634
8,ENSG00000104427.6,78666089,8-78472684-T-C,rs13272970,1,T,C,78472684,193405,78469481,78862697,3203
8,ENSG00000171033.8,78516340,8-78521197-G-A,rs13275966,1,G,A,78521197,4857,78319732,78712948,201465
8,ENSG00000067167.3,70608416,8-70713163-A-C,rs13280922,-1,A,C,70713163,104747,70411808,70805024,301355
8,ENSG00000104312.6,89757816,8-89628493-C-T,rs1397308,1,C,T,89628493,129323,89561208,89954424,67285
8,ENSG00000182197.6,118111826,8-117976303-A-C,rs1466429,-1,A,C,117976303,135523,117915218,118308434,61085
8,ENSG00000179886.4,143597831,8-143722308-C-T,rs146972476,1,C,T,143722308,124477,143401223,143794439,321085
8,ENSG00000147677.6,116755823,8-116612244-G-C,rs1529943,-1,G,C,116612244,143579,116559215,116952431,53029
8,ENSG00000147677.6,116755823,8-116612244-G-T,rs1529943,-1,G,T,116612244,143579,116559215,116952431,53029
8,ENSG00000079459.7,11802741,8-11786294-C-A,rs1534862,1,C,A,11786294,16447,11606133,11999349,180161
8,ENSG00000079459.7,11802741,8-11786294-C-T,rs1534862,1,C,T,11786294,16447,11606133,11999349,180161
8,ENSG00000079459.7,11802741,8-11786294-C-G,rs1534862,1,C,G,11786294,16447,11606133,11999349,180161
8,ENSG00000253457.1,30638580,8-30487075-G-A,rs16877081,1,G,A,30487075,151505,30441972,30835188,45103
8,ENSG00000253457.1,30638580,8-30487075-G-T,rs16877081,1,G,T,30487075,151505,30441972,30835188,45103
8,ENSG00000120526.6,109334087,8-109491989-A-G,rs16879659,-1,A,G,109491989,157902,109137479,109530695,354510
8,ENSG00000104371.3,42377229,8-42423090-C-T,rs16891290,-1,C,T,42423090,45861,42180621,42573837,242469
8,ENSG00000076641.3,81112068,8-81106908-T-G,rs16908611,-1,T,G,81106908,5160,80915460,81308676,191448
8,ENSG00000076641.3,81112068,8-81106908-T-C,rs16908611,-1,T,C,81106908,5160,80915460,81308676,191448
8,ENSG00000164749.7,75539869,8-75708759-G-A,rs16919400,1,G,A,75708759,168890,75343261,75736477,365498
8,ENSG00000164749.7,75539869,8-75708759-G-C,rs16919400,1,G,C,75708759,168890,75343261,75736477,365498
8,ENSG00000104442.5,65634177,8-65558008-A-G,rs16932223,-1,A,G,65558008,76169,65437569,65830785,120439
8,ENSG00000104442.5,65634177,8-65558008-A-C,rs16932223,-1,A,C,65558008,76169,65437569,65830785,120439
8,ENSG00000104442.5,65634177,8-65558008-A-T,rs16932223,-1,A,T,65558008,76169,65437569,65830785,120439
8,ENSG00000147570.5,66021553,8-66015818-G-A,rs16932415,1,G,A,66015818,5735,65824945,66218161,190873
8,ENSG00000104369.4,74321540,8-74267985-C-T,rs16938844,-1,C,T,74267985,53555,74124932,74518148,143053
8,ENSG00000104369.4,74321540,8-74267985-C-G,rs16938844,-1,C,G,74267985,53555,74124932,74518148,143053
8,ENSG00000164751.10,77000078,8-76856154-T-G,rs16939380,-1,T,G,76856154,143924,76803470,77196686,52684
8,ENSG00000184661.7,25459233,8-25644212-G-A,rs17054092,1,G,A,25644212,184979,25262625,25655841,381587
8,ENSG00000197217.8,23457647,8-23534805-A-C,rs17089331,-1,A,C,23534805,77158,23261039,23654255,273766
8,ENSG00000197217.8,23457647,8-23534805-A-G,rs17089331,-1,A,G,23534805,77158,23261039,23654255,273766
8,ENSG00000156011.11,19013703,8-19192605-T-C,rs17127966,-1,T,C,19192605,178902,18817095,19210311,375510
8,ENSG00000164933.5,103415107,8-103231186-C-T,rs17205590,-1,C,T,103231186,183921,103218499,103611715,12687
8,ENSG00000161016.10,144792390,8-144843209-T-C,rs1735408,-1,T,C,144843209,50819,144595782,144988998,247427
8,ENSG00000147576.11,66432504,8-66418110-G-A,rs17383243,1,G,A,66418110,14394,66235896,66629112,182214
8,ENSG00000137547.4,54135241,8-54262259-C-T,rs17394176,1,C,T,54262259,127018,53938633,54331849,323626
8,ENSG00000104611.7,19313693,8-19342909-A-G,rs17478238,1,A,G,19342909,29216,19117085,19510301,225824
8,ENSG00000104611.7,19313693,8-19342909-A-T,rs17478238,1,A,T,19342909,29216,19117085,19510301,225824
8,ENSG00000182372.6,1763789,8-1826660-C-A,rs17756439,1,C,A,1826660,62871,1567181,1960397,259479
8,ENSG00000182372.6,1763789,8-1826660-C-T,rs17756439,1,C,T,1826660,62871,1567181,1960397,259479
8,ENSG00000154359.8,12755526,8-12842662-C-T,rs17769628,-1,C,T,12842662,87136,12558918,12952134,283744
8,ENSG00000042832.6,132866958,8-132868999-C-T,rs180204,1,C,T,132868999,2041,132670350,133063566,198649
8,ENSG00000187840.4,38030534,8-37959657-C-T,rs1892818,1,C,T,37959657,70877,37833926,38227142,125731
8,ENSG00000177570.9,118621963,8-118593364-T-A,rs1915541,-1,T,A,118593364,28599,118425355,118818571,168009
8,ENSG00000177570.9,118621963,8-118593364-T-C,rs1915541,-1,T,C,118593364,28599,118425355,118818571,168009
8,ENSG00000177570.9,118621963,8-118593364-T-G,rs1915541,-1,T,G,118593364,28599,118425355,118818571,168009
8,ENSG00000179388.7,22693480,8-22813992-G-A,rs1996148,-1,G,A,22813992,120512,22496872,22890088,317120
8,ENSG00000168619.10,39584568,8-39766052-C-A,rs202012,1,C,A,39766052,181484,39387960,39781176,378092
8,ENSG00000168619.10,39584568,8-39766052-C-T,rs202012,1,C,T,39766052,181484,39387960,39781176,378092
8,ENSG00000197275.7,94475115,8-94395222-C-T,rs2046663,-1,C,T,94395222,79893,94278507,94671723,116715
8,ENSG00000183779.4,37695782,8-37628233-C-A,rs2051166,1,C,A,37628233,67549,37499174,37892390,129059
8,ENSG00000183779.4,37695782,8-37628233-C-G,rs2051166,1,C,G,37628233,67549,37499174,37892390,129059
8,ENSG00000164823.5,89902570,8-89988796-C-T,rs2107465,1,C,T,89988796,86226,89705962,90099178,282834
8,ENSG00000164823.5,89902570,8-89988796-C-A,rs2107465,1,C,A,89988796,86226,89705962,90099178,282834
8,ENSG00000132541.5,98117171,8-98033750-A-C,rs2255464,-1,A,C,98033750,83421,97920563,98313779,113187
8,ENSG00000132541.5,98117171,8-98033750-A-G,rs2255464,-1,A,G,98033750,83421,97920563,98313779,113187
8,ENSG00000132541.5,98117171,8-98033750-A-T,rs2255464,-1,A,T,98033750,83421,97920563,98313779,113187
8,ENSG00000160948.8,144428548,8-144416180-T-G,rs2280839,-1,T,G,144416180,12368,144231940,144625156,184240
8,ENSG00000180921.6,143733779,8-143575430-G-A,rs2290416,-1,G,A,143575430,158349,143537171,143930387,38259
8,ENSG00000177669.3,30144665,8-30146977-G-C,rs2341177,-1,G,C,30146977,2312,29948057,30341273,198920
8,ENSG00000177669.3,30144665,8-30146977-G-A,rs2341177,-1,G,A,30146977,2312,29948057,30341273,198920
8,ENSG00000168300.9,51899036,8-52017317-C-G,rs2433235,-1,C,G,52017317,118281,51702428,52095644,314889
8,ENSG00000168300.9,51899036,8-52017317-C-T,rs2433235,-1,C,T,52017317,118281,51702428,52095644,314889
8,ENSG00000120963.7,101205673,8-101191462-C-T,rs2441706,-1,C,T,101191462,14211,101009065,101402281,182397
8,ENSG00000158106.8,143368876,8-143331246-G-T,rs2450772,1,G,T,143331246,37630,143172268,143565484,158978
8,ENSG00000158106.8,143368876,8-143331246-G-A,rs2450772,1,G,A,143331246,37630,143172268,143565484,158978
8,ENSG00000184428.7,143334880,8-143355002-A-G,rs2467947,-1,A,G,143355002,20122,143138272,143531488,216730
8,ENSG00000104341.10,97775788,8-97773257-C-A,rs2513985,1,C,A,97773257,2531,97579180,97972396,194077
8,ENSG00000104341.10,97775788,8-97773257-C-G,rs2513985,1,C,G,97773257,2531,97579180,97972396,194077
8,ENSG00000164949.3,94262319,8-94169018-G-A,rs2514809,-1,G,A,94169018,93301,94065711,94458927,103307
8,ENSG00000164949.3,94262319,8-94169018-G-C,rs2514809,-1,G,C,94169018,93301,94065711,94458927,103307
8,ENSG00000169427.2,139703123,8-139551000-T-C,rs2542465,-1,T,C,139551000,152123,139506515,139899731,44485
8,ENSG00000104324.11,96645242,8-96634912-C-T,rs2582804,1,C,T,96634912,10330,96448634,96841850,186278
8,ENSG00000071894.9,144409335,8-144465013-A-T,rs2620645,-1,A,T,144465013,55678,144212727,144605943,252286
8,ENSG00000071894.9,144409335,8-144465013-A-C,rs2620645,-1,A,C,144465013,55678,144212727,144605943,252286
8,ENSG00000071894.9,144409335,8-144465013-A-G,rs2620645,-1,A,G,144465013,55678,144212727,144605943,252286
8,ENSG00000165392.5,31033810,8-31123685-A-G,rs2725353,1,A,G,31123685,89875,30837202,31230418,286483
8,ENSG00000154319.10,11466753,8-11275257-T-A,rs2736381,-1,T,A,11275257,191496,11270145,11663361,5112
8,ENSG00000104432.7,78805463,8-78880811-G-A,rs28529281,-1,G,A,78880811,75348,78608855,79002071,271956
8,ENSG00000156172.5,95269201,8-95264147-C-T,rs28718377,-1,C,T,95264147,5054,95072593,95465809,191554
8,ENSG00000155189.7,6708642,8-6581944-G-A,rs2922860,1,G,A,6581944,126698,6512034,6905250,69910
8,ENSG00000155189.7,6708642,8-6581944-G-C,rs2922860,1,G,C,6581944,126698,6512034,6905250,69910
8,ENSG00000155189.7,6708642,8-6581944-G-T,rs2922860,1,G,T,6581944,126698,6512034,6905250,69910
8,ENSG00000253598.1,81695058,8-81706019-A-C,rs2955005,-1,A,C,81706019,10961,81498450,81891666,207569
8,ENSG00000253598.1,81695058,8-81706019-A-G,rs2955005,-1,A,G,81706019,10961,81498450,81891666,207569
8,ENSG00000253598.1,81695058,8-81706019-A-T,rs2955005,-1,A,T,81706019,10961,81498450,81891666,207569
8,ENSG00000008513.10,133571887,8-133521933-T-C,rs2978007,-1,T,C,133521933,49954,133375279,133768495,146654
8,ENSG00000164944.7,94553469,8-94485761-A-C,rs3102854,-1,A,C,94485761,67708,94356861,94750077,128900
8,ENSG00000164944.7,94553469,8-94485761-A-G,rs3102854,-1,A,G,94485761,67708,94356861,94750077,128900
8,ENSG00000164944.7,94553469,8-94485761-A-T,rs3102854,-1,A,T,94485761,67708,94356861,94750077,128900
8,ENSG00000168490.8,22232099,8-22047380-G-T,rs3176300,-1,G,T,22047380,184719,22035491,22428707,11889
8,ENSG00000168490.8,22232099,8-22047380-G-A,rs3176300,-1,G,A,22047380,184719,22035491,22428707,11889
8,ENSG00000092964.10,26514031,8-26625674-G-C,rs327225,1,G,C,26625674,111643,26317423,26710639,308251
8,ENSG00000092964.10,26514031,8-26625674-G-A,rs327225,1,G,A,26625674,111643,26317423,26710639,308251
8,ENSG00000092964.10,26514031,8-26625674-G-T,rs327225,1,G,T,26625674,111643,26317423,26710639,308251
8,ENSG00000168615.7,38996973,8-38950699-G-C,rs34794075,1,G,C,38950699,46274,38800365,39193581,150334
8,ENSG00000168615.7,38996973,8-38950699-G-T,rs34794075,1,G,T,38950699,46274,38800365,39193581,150334
8,ENSG00000214050.3,28490229,8-28588035-A-G,rs34979186,-1,A,G,28588035,97806,28293621,28686837,294414
8,ENSG00000160932.6,143018529,8-143178823-T-G,rs35355856,1,T,G,143178823,160294,142821921,143215137,356902
8,ENSG00000160932.6,143018529,8-143178823-T-C,rs35355856,1,T,C,143178823,160294,142821921,143215137,356902
8,ENSG00000160932.6,143018529,8-143178823-T-A,rs35355856,1,T,A,143178823,160294,142821921,143215137,356902
8,ENSG00000171045.10,142403182,8-142393591-C-A,rs35755256,-1,C,A,142393591,9591,142206574,142599790,187017
8,ENSG00000171045.10,142403182,8-142393591-C-T,rs35755256,-1,C,T,142393591,9591,142206574,142599790,187017
8,ENSG00000014164.5,143541447,8-143538701-A-C,rs3750209,-1,A,C,143538701,2746,143344839,143738055,193862
8,ENSG00000014164.5,143541447,8-143538701-A-G,rs3750209,-1,A,G,143538701,2746,143344839,143738055,193862
8,ENSG00000156795.2,123416774,8-123395606-C-A,rs3779983,1,C,A,123395606,21168,123220166,123613382,175440
8,ENSG00000156795.2,123416774,8-123395606-C-T,rs3779983,1,C,T,123395606,21168,123220166,123613382,175440
8,ENSG00000147813.11,143578330,8-143582129-G-A,rs3793371,-1,G,A,143582129,3799,143381722,143774938,200407
8,ENSG00000170631.10,144950880,8-144948250-T-G,rs3808375,-1,T,G,144948250,2630,144754272,145147488,193978
8,ENSG00000170631.10,144950880,8-144948250-T-C,rs3808375,-1,T,C,144948250,2630,144754272,145147488,193978
8,ENSG00000104679.6,23288108,8-23290051-G-C,rs3808536,1,G,C,23290051,1943,23091500,23484716,198551
8,ENSG00000104679.6,23288108,8-23290051-G-A,rs3808536,1,G,A,23290051,1943,23091500,23484716,198551
8,ENSG00000104518.6,143558346,8-143531510-C-T,rs3889129,1,C,T,143531510,26836,143361738,143754954,169772
8,ENSG00000104518.6,143558346,8-143531510-C-G,rs3889129,1,C,G,143531510,26836,143361738,143754954,169772
8,ENSG00000155975.5,17246958,8-17107567-G-A,rs3915068,1,G,A,17107567,139391,17050350,17443566,57217
8,ENSG00000155975.5,17246958,8-17107567-G-C,rs3915068,1,G,C,17107567,139391,17050350,17443566,57217
8,ENSG00000155975.5,17246958,8-17107567-G-T,rs3915068,1,G,T,17107567,139391,17050350,17443566,57217
8,ENSG00000104320.8,89984667,8-89857752-C-T,rs398957,-1,C,T,89857752,126915,89788059,90181275,69693
8,ENSG00000104267.4,85464007,8-85535479-C-T,rs414922,1,C,T,85535479,71472,85267399,85660615,268080
8,ENSG00000120533.8,109334347,8-109153787-C-T,rs4314624,1,C,T,109153787,180560,109137739,109530955,16048
8,ENSG00000120533.8,109334347,8-109153787-C-G,rs4314624,1,C,G,109153787,180560,109137739,109530955,16048
8,ENSG00000104361.5,98294235,8-98259545-G-A,rs4451278,-1,G,A,98259545,34690,98097627,98490843,161918
8,ENSG00000253250.2,90985238,8-91051873-T-C,rs4467904,-1,T,C,91051873,66635,90788630,91181846,263243
8,ENSG00000214954.4,91102662,8-91214126-T-G,rs4515507,1,T,G,91214126,111464,90906054,91299270,308072
8,ENSG00000214954.4,91102662,8-91214126-T-A,rs4515507,1,T,A,91214126,111464,90906054,91299270,308072
8,ENSG00000104497.9,81842185,8-81909462-G-C,rs4557658,-1,G,C,81909462,67277,81645577,82038793,263885
8,ENSG00000104497.9,81842185,8-81909462-G-A,rs4557658,-1,G,A,81909462,67277,81645577,82038793,263885
8,ENSG00000164951.11,93916923,8-93980594-A-G,rs4631428,1,A,G,93980594,63671,93720315,94113531,260279
8,ENSG00000164951.11,93916923,8-93980594-A-C,rs4631428,1,A,C,93980594,63671,93720315,94113531,260279
8,ENSG00000155090.10,102655725,8-102530310-A-G,rs4734636,-1,A,G,102530310,125415,102459117,102852333,71193
8,ENSG00000169122.7,57994523,8-58141141-T-G,rs4738647,1,T,G,58141141,146618,57797915,58191131,343226
8,ENSG00000169122.7,57994523,8-58141141-T-C,rs4738647,1,T,C,58141141,146618,57797915,58191131,343226
8,ENSG00000186523.9,12194082,8-12002231-A-T,rs4841663,-1,A,T,12002231,191851,11997474,12390690,4757
8,ENSG00000186523.9,12194082,8-12002231-A-C,rs4841663,-1,A,C,12002231,191851,11997474,12390690,4757
8,ENSG00000104635.8,22367278,8-22399789-T-C,rs4871996,1,T,C,22399789,32511,22170670,22563886,229119
8,ENSG00000104635.8,22367278,8-22399789-T-A,rs4871996,1,T,A,22399789,32511,22170670,22563886,229119
8,ENSG00000036448.5,2045046,8-2126170-A-T,rs4876222,1,A,T,2126170,81124,1848438,2241654,277732
8,ENSG00000036448.5,2045046,8-2126170-A-C,rs4876222,1,A,C,2126170,81124,1848438,2241654,277732
8,ENSG00000036448.5,2045046,8-2126170-A-G,rs4876222,1,A,G,2126170,81124,1848438,2241654,277732
8,ENSG00000120885.13,27614700,8-27612623-G-T,rs545243,-1,G,T,27612623,2077,27418092,27811308,194531
8,ENSG00000176209.6,42541585,8-42482116-G-A,rs55840085,1,G,A,42482116,59469,42344977,42738193,137139
8,ENSG00000085719.7,86514435,8-86657515-G-A,rs59109039,1,G,A,86657515,143080,86317827,86711043,339688
8,ENSG00000042980.8,24294069,8-24420220-T-G,rs61500183,1,T,G,24420220,126151,24097461,24490677,322759
8,ENSG00000181135.11,143684479,8-143667865-G-A,rs62524163,1,G,A,143667865,16614,143487871,143881087,179994
8,ENSG00000164924.12,100952020,8-101054030-C-A,rs6468755,-1,C,A,101054030,102010,100755412,101148628,298618
8,ENSG00000164924.12,100952020,8-101054030-C-T,rs6468755,-1,C,T,101054030,102010,100755412,101148628,298618
8,ENSG00000259305.1,123267387,8-123116890-T-C,rs6470140,-1,T,C,123116890,150497,123070779,123463995,46111
8,ENSG00000259305.1,123267387,8-123116890-T-A,rs6470140,-1,T,A,123116890,150497,123070779,123463995,46111
8,ENSG00000175895.3,95133785,8-95087947-C-A,rs6471513,1,C,A,95087947,45838,94937177,95330393,150770
8,ENSG00000175895.3,95133785,8-95087947-C-T,rs6471513,1,C,T,95087947,45838,94937177,95330393,150770
8,ENSG00000130193.7,142727223,8-142705417-A-G,rs6471588,1,A,G,142705417,21806,142530615,142923831,174802
8,ENSG00000253958.1,8701937,8-8639042-A-G,rs6601715,1,A,G,8639042,62895,8505329,8898545,133713
8,ENSG00000171316.6,60678740,8-60791524-G-A,rs6982898,1,G,A,60791524,112784,60482132,60875348,309392
8,ENSG00000177710.5,11331012,8-11263401-G-T,rs6986275,1,G,T,11263401,67611,11134404,11527620,128997
8,ENSG00000177710.5,11331012,8-11263401-G-A,rs6986275,1,G,A,11263401,67611,11134404,11527620,128997
8,ENSG00000147485.8,51809445,8-51975588-A-G,rs6990124,-1,A,G,51975588,166143,51612837,52006053,362751
8,ENSG00000147485.8,51809445,8-51975588-A-C,rs6990124,-1,A,C,51975588,166143,51612837,52006053,362751
8,ENSG00000197892.8,29263070,8-29159570-A-G,rs6994211,-1,A,G,29159570,103500,29066462,29459678,93108
8,ENSG00000077782.14,38468635,8-38464828-A-G,rs6996321,-1,A,G,38464828,3807,38272027,38665243,192801
8,ENSG00000189233.7,28083936,8-27900859-C-G,rs7002829,-1,C,G,27900859,183077,27887328,28280544,13531
8,ENSG00000189233.7,28083936,8-27900859-C-T,rs7002829,-1,C,T,27900859,183077,27887328,28280544,13531
8,ENSG00000181638.12,143246939,8-143230820-A-G,rs7011172,1,A,G,143230820,16119,143050331,143443547,180489
8,ENSG00000168078.5,27837817,8-27946864-T-C,rs71519661,-1,T,C,27946864,109047,27641209,28034425,305655
8,ENSG00000120915.8,27491143,8-27524479-C-G,rs721619,1,C,G,27524479,33336,27294535,27687751,229944
8,ENSG00000185728.11,63168621,8-63322084-A-G,rs72661748,1,A,G,63322084,153463,62972013,63365229,350071
8,ENSG00000104419.9,133297252,8-133411154-G-A,rs72718209,-1,G,A,133411154,113902,133100644,133493860,310510
8,ENSG00000070756.8,100722088,8-100600051-C-T,rs73699411,-1,C,T,100600051,122037,100525480,100918696,74571
8,ENSG00000185803.4,144358613,8-144213106-C-T,rs74345248,1,C,T,144213106,145507,144162005,144555221,51101
8,ENSG00000175806.10,10054292,8-10137779-C-A,rs74357253,1,C,A,10137779,83487,9857684,10250900,280095
8,ENSG00000175806.10,10054292,8-10137779-C-T,rs74357253,1,C,T,10137779,83487,9857684,10250900,280095
8,ENSG00000104689.5,23225102,8-23244230-C-G,rs7459962,-1,C,G,23244230,19128,23028494,23421710,215736
8,ENSG00000104689.5,23225102,8-23244230-C-A,rs7459962,-1,C,A,23244230,19128,23028494,23421710,215736
8,ENSG00000147789.10,144827560,8-145008844-G-A,rs74622951,1,G,A,145008844,181284,144630952,145024168,377892
8,ENSG00000078674.11,17922988,8-17981306-G-A,rs75642678,1,G,A,17981306,58318,17726380,18119596,254926
8,ENSG00000078674.11,17922988,8-17981306-G-T,rs75642678,1,G,T,17981306,58318,17726380,18119596,254926
8,ENSG00000167034.8,23682938,8-23554008-G-A,rs75775636,-1,G,A,23554008,128930,23486330,23879546,67678
8,ENSG00000172728.10,33473146,8-33498805-G-A,rs76212197,-1,G,A,33498805,25659,33276538,33669754,222267
8,ENSG00000164761.4,118951885,8-118897855-G-A,rs76936579,-1,G,A,118897855,54030,118755277,119148493,142578
8,ENSG00000104517.7,102412700,8-102312052-A-G,rs77523118,-1,A,G,102312052,100648,102216092,102609308,95960
8,ENSG00000104517.7,102412700,8-102312052-A-T,rs77523118,-1,A,T,102312052,100648,102216092,102609308,95960
8,ENSG00000158856.11,22056814,8-22129144-C-T,rs77620102,1,C,T,22129144,72330,21860206,22253422,268938
8,ENSG00000104321.5,72075584,8-71953326-G-A,rs77887183,-1,G,A,71953326,122258,71878976,72272192,74350
8,ENSG00000104472.5,140511322,8-140505151-A-C,rs7814184,1,A,C,140505151,6171,140314714,140707930,190437
8,ENSG00000164930.6,103298898,8-103354539-G-C,rs7814419,1,G,C,103354539,55641,103102290,103495506,252249
8,ENSG00000164934.8,103415386,8-103354539-G-C,rs7814419,1,G,C,103354539,60847,103218778,103611994,135761
8,ENSG00000147475.9,37736634,8-37713874-G-A,rs7814863,1,G,A,37713874,22760,37540026,37933242,173848
8,ENSG00000164695.4,81732448,8-81545273-C-T,rs78153152,1,C,T,81545273,187175,81535840,81929056,9433
8,ENSG00000187954.8,144462871,8-144644394-G-T,rs7816938,-1,G,T,144644394,181523,144266263,144659479,378131
8,ENSG00000187954.8,144462871,8-144644394-G-A,rs7816938,-1,G,A,144644394,181523,144266263,144659479,378131
8,ENSG00000165066.10,41650817,8-41743178-C-A,rs7819638,-1,C,A,41743178,92361,41454209,41847425,288969
8,ENSG00000165066.10,41650817,8-41743178-C-T,rs7819638,-1,C,T,41743178,92361,41454209,41847425,288969
8,ENSG00000165066.10,41650817,8-41743178-C-G,rs7819638,-1,C,G,41743178,92361,41454209,41847425,288969
8,ENSG00000160972.5,144477982,8-144343394-C-A,rs7827865,1,C,A,144343394,134588,144281374,144674590,62020
8,ENSG00000160972.5,144477982,8-144343394-C-T,rs7827865,1,C,T,144343394,134588,144281374,144674590,62020
8,ENSG00000196150.7,144901453,8-144925347-G-A,rs7829796,-1,G,A,144925347,23894,144704845,145098061,220502
8,ENSG00000104368.13,42207565,8-42245804-C-T,rs7829991,-1,C,T,42245804,38239,42010957,42404173,234847
8,ENSG00000008988.5,56074506,8-56171566-T-C,rs7830138,-1,T,C,56171566,97060,55877898,56271114,293668
8,ENSG00000197858.6,144082634,8-144113921-T-A,rs7836836,1,T,A,144113921,31287,143886026,144279242,227895
8,ENSG00000197858.6,144082634,8-144113921-T-G,rs7836836,1,T,G,144113921,31287,143886026,144279242,227895
8,ENSG00000197858.6,144082634,8-144113921-T-C,rs7836836,1,T,C,144113921,31287,143886026,144279242,227895
8,ENSG00000120889.8,23069031,8-23135854-T-C,rs7957,-1,T,C,23135854,66823,22872423,23265639,263431
8,ENSG00000120889.8,23069031,8-23135854-T-A,rs7957,-1,T,A,23135854,66823,22872423,23265639,263431
8,ENSG00000158806.9,22024134,8-22027924-A-G,rs79872342,1,A,G,22027924,3790,21827526,22220742,200398
8,ENSG00000156103.11,88327483,8-88431163-A-C,rs821111,-1,A,C,88431163,103680,88130875,88524091,300288
8,ENSG00000167904.9,55773378,8-55789424-G-T,rs896126,-1,G,T,55789424,16046,55576770,55969986,212654
8,ENSG00000167904.9,55773378,8-55789424-G-A,rs896126,-1,G,A,55789424,16046,55576770,55969986,212654
8,ENSG00000178860.8,71844412,8-72000879-C-T,rs9298192,-1,C,T,72000879,156467,71647804,72041020,353075
8,ENSG00000147654.10,109540173,8-109458129-T-C,rs9643050,1,T,C,109458129,82044,109343565,109736781,114564
8,ENSG00000155097.7,103021083,8-103105209-G-A,rs979671,1,G,A,103105209,84126,102824475,103217691,280734
8,ENSG00000155097.7,103021083,8-103105209-G-T,rs979671,1,G,T,103105209,84126,102824475,103217691,280734
7,ENSG00000136243.12,23182048,7-23258796-C-A,rs10085838,1,C,A,23258796,76748,22985440,23378656,273356
7,ENSG00000240583.5,30911853,7-30797387-A-G,rs1017012,1,A,G,30797387,114466,30715245,31108461,82142
7,ENSG00000164742.9,45574368,7-45487878-G-A,rs10229543,1,G,A,45487878,86490,45377760,45770976,110118
7,ENSG00000164742.9,45574368,7-45487878-G-C,rs10229543,1,G,C,45487878,86490,45377760,45770976,110118
7,ENSG00000154978.8,55572502,7-55675413-A-T,rs10235329,-1,A,T,55675413,102911,55375894,55769110,299519
7,ENSG00000154978.8,55572502,7-55675413-A-C,rs10235329,-1,A,C,55675413,102911,55375894,55769110,299519
7,ENSG00000215018.4,7535873,7-7572218-G-C,rs10236767,-1,G,C,7572218,36345,7339265,7732481,232953
7,ENSG00000128607.8,130070534,7-130160005-G-A,rs10241132,1,G,A,130160005,89471,129873926,130267142,286079
7,ENSG00000128607.8,130070534,7-130160005-G-C,rs10241132,1,G,C,130160005,89471,129873926,130267142,286079
7,ENSG00000146574.10,6826275,7-6831004-G-T,rs10242703,-1,G,T,6831004,4729,6629667,7022883,201337
7,ENSG00000146574.10,6826275,7-6831004-G-A,rs10242703,-1,G,A,6831004,4729,6629667,7022883,201337
7,ENSG00000106526.6,150323545,7-150289088-G-A,rs10248343,-1,G,A,150289088,34457,150126937,150520153,162151
7,ENSG00000106526.6,150323545,7-150289088-G-T,rs10248343,-1,G,T,150289088,34457,150126937,150520153,162151
7,ENSG00000164850.9,1088113,7-1232183-G-A,rs10249139,1,G,A,1232183,144070,891505,1284721,340678
7,ENSG00000164850.9,1088113,7-1232183-G-T,rs10249139,1,G,T,1232183,144070,891505,1284721,340678
7,ENSG00000164850.9,1088113,7-1232183-G-C,rs10249139,1,G,C,1232183,144070,891505,1284721,340678
7,ENSG00000146701.6,76048106,7-76117091-T-C,rs10255591,1,T,C,76117091,68985,75851498,76244714,265593
7,ENSG00000146701.6,76048106,7-76117091-T-A,rs10255591,1,T,A,76117091,68985,75851498,76244714,265593
7,ENSG00000214960.5,16421538,7-16373856-C-T,rs10257504,-1,C,T,16373856,47682,16224930,16618146,148926
7,ENSG00000214960.5,16421538,7-16373856-C-G,rs10257504,-1,C,G,16373856,47682,16224930,16618146,148926
7,ENSG00000214960.5,16421538,7-16373856-C-A,rs10257504,-1,C,A,16373856,47682,16224930,16618146,148926
7,ENSG00000009335.13,157138926,7-156988404-G-A,rs10260592,1,G,A,156988404,150522,156942318,157335534,46086
7,ENSG00000257093.2,141702166,7-141698907-A-G,rs10261515,-1,A,G,141698907,3259,141505558,141898774,193349
7,ENSG00000105875.9,135211526,7-135044493-T-C,rs10265256,-1,T,C,135044493,167033,135014918,135408134,29575
7,ENSG00000146859.4,135148072,7-135044493-T-C,rs10265256,1,T,C,135044493,103579,134951464,135344680,93029
7,ENSG00000146828.11,100852713,7-100702383-C-T,rs10266044,1,C,T,100702383,150330,100656105,101049321,46278
7,ENSG00000153790.7,25180354,7-25092564-A-G,rs10268780,-1,A,G,25092564,87790,24983746,25376962,108818
7,ENSG00000065883.10,39950256,7-40050333-C-G,rs10272641,1,C,G,40050333,100077,39753648,40146864,296685
7,ENSG00000127955.11,80134831,7-80128551-C-A,rs10277713,1,C,A,80128551,6280,79938223,80331439,190328
7,ENSG00000127955.11,80134831,7-80128551-C-T,rs10277713,1,C,T,80128551,6280,79938223,80331439,190328
7,ENSG00000127955.11,80134831,7-80128551-C-G,rs10277713,1,C,G,80128551,6280,79938223,80331439,190328
7,ENSG00000205413.3,93117979,7-93238211-G-A,rs10280473,-1,G,A,93238211,120232,92921371,93314587,316840
7,ENSG00000106538.5,150341629,7-150348213-G-A,rs10282458,-1,G,A,150348213,6584,150145021,150538237,203192
7,ENSG00000196683.6,22822849,7-22810714-C-A,rs1029741,-1,C,A,22810714,12135,22626241,23019457,184473
7,ENSG00000196683.6,22822849,7-22810714-C-T,rs1029741,-1,C,T,22810714,12135,22626241,23019457,184473
7,ENSG00000170852.5,32891760,7-32869092-T-G,rs1045477,-1,T,G,32869092,22668,32695152,33088368,173940
7,ENSG00000170852.5,32891760,7-32869092-T-C,rs1045477,-1,T,C,32869092,22668,32695152,33088368,173940
7,ENSG00000164654.11,7566884,7-7506060-G-C,rs10486176,1,G,C,7506060,60824,7370276,7763492,135784
7,ENSG00000122644.8,12687633,7-12780976-G-A,rs10488233,1,G,A,12780976,93343,12491025,12884241,289951
7,ENSG00000172331.7,134646853,7-134640553-T-C,rs10488433,1,T,C,134640553,6300,134450245,134843461,190308
7,ENSG00000152926.8,64982119,7-64990178-T-C,rs10807685,-1,T,C,64990178,8059,64785511,65178727,204667
7,ENSG00000225968.4,1670277,7-1748644-G-C,rs10950352,1,G,C,1748644,78367,1473669,1866885,274975
7,ENSG00000225968.4,1670277,7-1748644-G-A,rs10950352,1,G,A,1748644,78367,1473669,1866885,274975
7,ENSG00000106628.6,44123548,7-44130986-G-T,rs10951757,-1,G,T,44130986,7438,43926940,44320156,204046
7,ENSG00000106628.6,44123548,7-44130986-G-A,rs10951757,-1,G,A,44130986,7438,43926940,44320156,204046
7,ENSG00000198517.5,1530702,7-1554022-G-T,rs10952167,1,G,T,1554022,23320,1334094,1727310,219928
7,ENSG00000198517.5,1530702,7-1554022-G-A,rs10952167,1,G,A,1554022,23320,1334094,1727310,219928
7,ENSG00000198517.5,1530702,7-1554022-G-C,rs10952167,1,G,C,1554022,23320,1334094,1727310,219928
7,ENSG00000186088.10,77416349,7-77416905-C-T,rs10953236,-1,C,T,77416905,556,77219741,77612957,197164
7,ENSG00000186088.10,77416349,7-77416905-C-G,rs10953236,-1,C,G,77416905,556,77219741,77612957,197164
7,ENSG00000186088.10,77416349,7-77416905-C-A,rs10953236,-1,C,A,77416905,556,77219741,77612957,197164
7,ENSG00000164880.11,1504389,7-1541764-C-A,rs111764525,-1,C,A,1541764,37375,1307781,1700997,233983
7,ENSG00000164880.11,1504389,7-1541764-C-T,rs111764525,-1,C,T,1541764,37375,1307781,1700997,233983
7,ENSG00000197461.8,519409,7-592301-G-A,rs112653255,-1,G,A,592301,72892,322801,716017,269500
7,ENSG00000170265.6,149195546,7-149219390-C-T,rs112833271,1,C,T,149219390,23844,148998938,149392154,220452
7,ENSG00000155026.10,5967204,7-5885227-C-T,rs113132829,-1,C,T,5885227,81977,5770596,6163812,114631
7,ENSG00000157778.4,1570032,7-1592740-G-A,rs113210207,-1,G,A,1592740,22708,1373424,1766640,219316
7,ENSG00000157680.8,137846974,7-137697299-T-C,rs113442902,-1,T,C,137697299,149675,137650366,138043582,46933
7,ENSG00000133619.13,149714951,7-149784268-C-T,rs113658613,1,C,T,149784268,69317,149518343,149911559,265925
7,ENSG00000135253.8,128910709,7-128866416-C-T,rs113752302,-1,C,T,128866416,44293,128714101,129107317,152315
7,ENSG00000164708.5,44065567,7-44075830-C-T,rs1139270,-1,C,T,44075830,10263,43868959,44262175,206871
7,ENSG00000241258.2,66114847,7-66110906-G-A,rs1167390,1,G,A,66110906,3941,65918239,66311455,192667
7,ENSG00000106348.12,128409982,7-128349825-G-T,rs117271927,-1,G,T,128349825,60157,128213374,128606590,136451
7,ENSG00000106348.12,128409982,7-128349825-G-A,rs117271927,-1,G,A,128349825,60157,128213374,128606590,136451
7,ENSG00000221970.1,144312419,7-144126740-T-C,rs11763619,1,T,C,144126740,185679,144115811,144509027,10929
7,ENSG00000132436.7,50450350,7-50429143-C-A,rs11764792,-1,C,A,50429143,21207,50253742,50646958,175401
7,ENSG00000132436.7,50450350,7-50429143-C-G,rs11764792,-1,C,G,50429143,21207,50253742,50646958,175401
7,ENSG00000132436.7,50450350,7-50429143-C-T,rs11764792,-1,C,T,50429143,21207,50253742,50646958,175401
7,ENSG00000164659.10,87059654,7-87073316-T-C,rs11768303,-1,T,C,87073316,13662,86863046,87256262,210270
7,ENSG00000173041.7,64563071,7-64505788-C-T,rs11768782,-1,C,T,64505788,57283,64366463,64759679,139325
7,ENSG00000188707.4,150322639,7-150329664-T-C,rs11769348,1,T,C,150329664,7025,150126031,150519247,203633
7,ENSG00000128534.3,118184164,7-118203884-C-G,rs11770353,1,C,G,118203884,19720,117987556,118380772,216328
7,ENSG00000128534.3,118184164,7-118203884-C-T,rs11770353,1,C,T,118203884,19720,117987556,118380772,216328
7,ENSG00000135249.3,105532201,7-105463394-C-A,rs11772023,1,C,A,105463394,68807,105335593,105728809,127801
7,ENSG00000135249.3,105532201,7-105463394-C-T,rs11772023,1,C,T,105463394,68807,105335593,105728809,127801
7,ENSG00000135249.3,105532201,7-105463394-C-G,rs11772023,1,C,G,105463394,68807,105335593,105728809,127801
7,ENSG00000171115.3,150450630,7-150442551-G-A,rs11772955,1,G,A,150442551,8079,150254022,150647238,188529
7,ENSG00000106009.11,2555524,7-2564844-C-T,rs11773176,-1,C,T,2564844,9320,2358916,2752132,205928
7,ENSG00000106603.12,43729523,7-43765096-C-T,rs1181574,-1,C,T,43765096,35573,43532915,43926131,232181
7,ENSG00000126870.11,158856558,7-158895307-C-T,rs1188960,1,C,T,158895307,38749,158659950,159053166,235357
7,ENSG00000136193.10,29989801,7-30089509-G-A,rs11975522,-1,G,A,30089509,99708,29793193,30186409,296316
7,ENSG00000218305.2,48924547,7-49020541-T-G,rs11978940,1,T,G,49020541,95994,48727939,49121155,292602
7,ENSG00000218305.2,48924547,7-49020541-T-C,rs11978940,1,T,C,49020541,95994,48727939,49121155,292602
7,ENSG00000146856.10,134986508,7-135073537-T-G,rs11979458,1,T,G,135073537,87029,134789900,135183116,283637
7,ENSG00000146856.10,134986508,7-135073537-T-C,rs11979458,1,T,C,135073537,87029,134789900,135183116,283637
7,ENSG00000146856.10,134986508,7-135073537-T-A,rs11979458,1,T,A,135073537,87029,134789900,135183116,283637
7,ENSG00000011426.6,36389862,7-36280180-C-T,rs12154765,1,C,T,36280180,109682,36193254,36586470,86926
7,ENSG00000106404.9,101237802,7-101250933-T-C,rs12334190,-1,T,C,101250933,13131,101041194,101434410,209739
7,ENSG00000205238.5,102551232,7-102471533-C-T,rs12534337,1,C,T,102471533,79699,102354624,102747840,116909
7,ENSG00000205238.5,102551232,7-102471533-C-G,rs12534337,1,C,G,102471533,79699,102354624,102747840,116909
7,ENSG00000173678.10,102650319,7-102471533-C-T,rs12534337,1,C,T,102471533,178786,102453711,102846927,17822
7,ENSG00000173678.10,102650319,7-102471533-C-G,rs12534337,1,C,G,102471533,178786,102453711,102846927,17822
7,ENSG00000181220.10,149497809,7-149666766-G-A,rs12536519,-1,G,A,149666766,168957,149301201,149694417,365565
7,ENSG00000181220.10,149497809,7-149666766-G-C,rs12536519,-1,G,C,149666766,168957,149301201,149694417,365565
7,ENSG00000086300.11,26291862,7-26348283-A-T,rs12537599,1,A,T,26348283,56421,26095254,26488470,253029
7,ENSG00000086300.11,26291862,7-26348283-A-G,rs12537599,1,A,G,26348283,56421,26095254,26488470,253029
7,ENSG00000227471.3,134549110,7-134603308-G-C,rs12666996,1,G,C,134603308,54198,134352502,134745718,250806
7,ENSG00000227471.3,134549110,7-134603308-G-A,rs12666996,1,G,A,134603308,54198,134352502,134745718,250806
7,ENSG00000158457.4,129144707,7-129137407-C-T,rs12667978,1,C,T,129137407,7300,128948099,129341315,189308
7,ENSG00000176125.3,100889715,7-100878489-T-C,rs12669120,-1,T,C,100878489,11226,100693107,101086323,185382
7,ENSG00000128595.10,128739359,7-128569804-C-T,rs12670823,1,C,T,128569804,169555,128542751,128935967,27053
7,ENSG00000128595.10,128739359,7-128569804-C-G,rs12670823,1,C,G,128569804,169555,128542751,128935967,27053
7,ENSG00000166997.3,100119634,7-100072705-A-T,rs12673441,1,A,T,100072705,46929,99923026,100316242,149679
7,ENSG00000241644.2,30752135,7-30807131-T-C,rs12690795,1,T,C,30807131,54996,30555527,30948743,251604
7,ENSG00000169193.7,23597382,7-23609095-G-T,rs12700451,1,G,T,23609095,11713,23400774,23793990,208321
7,ENSG00000196511.9,144836053,7-144837740-G-C,rs12703626,-1,G,C,144837740,1687,144639445,145032661,198295
7,ENSG00000077063.6,117873441,7-117982476-C-T,rs13236493,-1,C,T,117982476,109035,117676833,118070049,305643
7,ENSG00000169871.8,101085481,7-101181970-C-T,rs13241091,1,C,T,101181970,96489,100888873,101282089,293097
7,ENSG00000165171.6,73842516,7-73840482-T-C,rs13241921,-1,T,C,73840482,2034,73645908,74039124,194574
7,ENSG00000165171.6,73842516,7-73840482-T-G,rs13241921,-1,T,G,73840482,2034,73645908,74039124,194574
7,ENSG00000164715.5,98106862,7-98093675-T-C,rs13247901,1,T,C,98093675,13187,97910254,98303470,183421
7,ENSG00000122507.15,33129564,7-33157620-C-A,rs1362368,1,C,A,33157620,28056,32932956,33326172,224664
7,ENSG00000105887.10,135977359,7-135963175-T-A,rs1373235,-1,T,A,135963175,14184,135780751,136173967,182424
7,ENSG00000105887.10,135977359,7-135963175-T-C,rs1373235,-1,T,C,135963175,14184,135780751,136173967,182424
7,ENSG00000153814.7,28180795,7-28299637-G-C,rs1398725,-1,G,C,28299637,118842,27984187,28377403,315450
7,ENSG00000085662.8,134459100,7-134618526-T-C,rs1424441,-1,T,C,134618526,159426,134262492,134655708,356034
7,ENSG00000157214.8,90211740,7-90206965-A-G,rs1541428,1,A,G,90206965,4775,90015132,90408348,191833
7,ENSG00000157214.8,90211740,7-90206965-A-C,rs1541428,1,A,C,90206965,4775,90015132,90408348,191833
7,ENSG00000169902.8,66205334,7-66073444-A-C,rs160652,1,A,C,66073444,131890,66008726,66401942,64718
7,ENSG00000169902.8,66205334,7-66073444-A-G,rs160652,1,A,G,66073444,131890,66008726,66401942,64718
7,ENSG00000122643.13,33062776,7-33040023-T-C,rs1609410,-1,T,C,33040023,22753,32866168,33259384,173855
7,ENSG00000146535.8,2844308,7-2824952-G-T,rs1636264,-1,G,T,2824952,19356,2647700,3040916,177252
7,ENSG00000106086.12,30028412,7-29847240-A-G,rs16875169,1,A,G,29847240,181172,29831804,30225020,15436
7,ENSG00000105971.9,116499738,7-116497623-A-G,rs17138767,1,A,G,116497623,2115,116303130,116696346,194493
7,ENSG00000183742.6,20217384,7-20168042-T-A,rs17142519,-1,T,A,20168042,49342,20020776,20413992,147266
7,ENSG00000106052.8,27740162,7-27688230-T-C,rs17150563,1,T,C,27688230,51932,27543554,27936770,144676
7,ENSG00000135164.13,87152453,7-87073355-A-G,rs17161290,1,A,G,87073355,79098,86955845,87349061,117510
7,ENSG00000197448.9,143263441,7-143219751-G-A,rs17164163,1,G,A,143219751,43690,143066833,143460049,152918
7,ENSG00000197448.9,143263441,7-143219751-G-C,rs17164163,1,G,C,143219751,43690,143066833,143460049,152918
7,ENSG00000127920.4,93921735,7-93922294-G-A,rs17165909,1,G,A,93922294,559,93725127,94118343,197167
7,ENSG00000196636.7,97117698,7-97096401-T-G,rs17168173,1,T,G,97096401,21297,96921090,97314306,175311
7,ENSG00000243896.3,144264792,7-144434729-G-A,rs17195674,-1,G,A,144434729,169937,144068184,144461400,366545
7,ENSG00000146576.8,6590021,7-6476806-T-C,rs17198191,1,T,C,6476806,113215,6393413,6786629,83393
7,ENSG00000146576.8,6590021,7-6476806-T-G,rs17198191,1,T,G,6476806,113215,6393413,6786629,83393
7,ENSG00000005471.11,87475680,7-87495506-T-C,rs17209837,-1,T,C,87495506,19826,87279072,87672288,216434
7,ENSG00000106392.5,7182544,7-7250307-C-G,rs17318297,1,C,G,7250307,67763,6985936,7379152,264371
7,ENSG00000213203.2,150716613,7-150566821-A-T,rs17553490,1,A,T,150566821,149792,150520005,150913221,46816
7,ENSG00000213203.2,150716613,7-150566821-A-G,rs17553490,1,A,G,150566821,149792,150520005,150913221,46816
7,ENSG00000213203.2,150716613,7-150566821-A-C,rs17553490,1,A,C,150566821,149792,150520005,150913221,46816
7,ENSG00000106615.5,151519895,7-151327900-C-T,rs17705456,-1,C,T,151327900,191995,151323287,151716503,4613
7,ENSG00000106615.5,151519895,7-151327900-C-A,rs17705456,-1,C,A,151327900,191995,151323287,151716503,4613
7,ENSG00000188372.9,76424950,7-76580142-A-T,rs17718122,1,A,T,76580142,155192,76228342,76621558,351800
7,ENSG00000188372.9,76424950,7-76580142-A-G,rs17718122,1,A,G,76580142,155192,76228342,76621558,351800
7,ENSG00000146707.9,76627279,7-76580142-A-T,rs17718122,-1,A,T,76580142,47137,76430671,76823887,149471
7,ENSG00000146707.9,76627279,7-76580142-A-G,rs17718122,-1,A,G,76580142,47137,76430671,76823887,149471
7,ENSG00000106636.3,44200978,7-44137813-C-T,rs17769733,1,C,T,44137813,63165,44004370,44397586,133443
7,ENSG00000136231.8,23470491,7-23391576-G-A,rs17797853,-1,G,A,23391576,78915,23273883,23667099,117693
7,ENSG00000196584.2,152676141,7-152640561-T-C,rs17813864,-1,T,C,152640561,35580,152479533,152872749,161028
7,ENSG00000087077.7,100867387,7-100896090-G-T,rs17884589,1,G,T,100896090,28703,100670779,101063995,225311
7,ENSG00000087077.7,100867387,7-100896090-G-A,rs17884589,1,G,A,100896090,28703,100670779,101063995,225311
7,ENSG00000154678.12,32070407,7-31883289-A-G,rs1860788,-1,A,G,31883289,187118,31873799,32267015,9490
7,ENSG00000002726.14,150852517,7-150692505-T-C,rs1860871,1,T,C,150692505,160012,150655909,151049125,36596
7,ENSG00000106565.12,150800364,7-150692505-T-C,rs1860871,-1,T,C,150692505,107859,150603756,150996972,88749
7,ENSG00000002933.3,150800769,7-150692505-T-C,rs1860871,1,T,C,150692505,108264,150604161,150997377,88344
7,ENSG00000106415.8,7968796,7-7821036-A-T,rs1863139,1,A,T,7821036,147760,7772188,8165404,48848
7,ENSG00000106415.8,7968796,7-7821036-A-G,rs1863139,1,A,G,7821036,147760,7772188,8165404,48848
7,ENSG00000196937.5,121396308,7-121370155-T-C,rs1990446,-1,T,C,121370155,26153,121199700,121592916,170455
7,ENSG00000106477.12,130441016,7-130393789-C-T,rs1990790,-1,C,T,130393789,47227,130244408,130637624,149381
7,ENSG00000106477.12,130441016,7-130393789-C-G,rs1990790,-1,C,G,130393789,47227,130244408,130637624,149381
7,ENSG00000106624.4,44104345,7-44103193-C-T,rs2014453,1,C,T,44103193,1152,43907737,44300953,195456
7,ENSG00000135211.5,77798434,7-77792277-C-A,rs2057932,-1,C,A,77792277,6157,77601826,77995042,190451
7,ENSG00000128536.11,105963264,7-105884203-T-C,rs2067537,1,T,C,105884203,79061,105766656,106159872,117547
7,ENSG00000205482.7,77062558,7-77122604-A-G,rs2080164,-1,A,G,77122604,60046,76865950,77259166,256654
7,ENSG00000205482.7,77062558,7-77122604-A-C,rs2080164,-1,A,C,77122604,60046,76865950,77259166,256654
7,ENSG00000136270.9,45111697,7-45098160-C-G,rs2083364,-1,C,G,45098160,13537,44915089,45308305,183071
7,ENSG00000105974.7,116525036,7-116577603-G-A,rs2109517,1,G,A,116577603,52567,116328428,116721644,249175
7,ENSG00000158623.10,130668748,7-130595870-C-T,rs2129904,-1,C,T,130595870,72878,130472140,130865356,123730
7,ENSG00000158623.10,130668748,7-130595870-C-G,rs2129904,-1,C,G,130595870,72878,130472140,130865356,123730
7,ENSG00000178381.7,1160196,7-1174367-T-G,rs2140578,-1,T,G,1174367,14171,963588,1356804,210779
7,ENSG00000178381.7,1160196,7-1174367-T-C,rs2140578,-1,T,C,1174367,14171,963588,1356804,210779
7,ENSG00000106591.3,42932376,7-42922743-A-G,rs2162602,1,A,G,42922743,9633,42735768,43128984,186975
7,ENSG00000106366.5,101127104,7-101126257-A-G,rs2227631,1,A,G,101126257,847,100930496,101323712,195761
7,ENSG00000105808.11,102616756,7-102473640-C-T,rs2229796,-1,C,T,102473640,143116,102420148,102813364,53492
7,ENSG00000105808.11,102616756,7-102473640-C-A,rs2229796,-1,C,A,102473640,143116,102420148,102813364,53492
7,ENSG00000127366.4,141790217,7-141778774-G-C,rs2234001,1,G,C,141778774,11443,141593609,141986825,185165
7,ENSG00000127366.4,141790217,7-141778774-G-A,rs2234001,1,G,A,141778774,11443,141593609,141986825,185165
7,ENSG00000127366.4,141790217,7-141778774-G-T,rs2234001,1,G,T,141778774,11443,141593609,141986825,185165
7,ENSG00000164543.5,43583108,7-43647697-C-T,rs2240516,1,C,T,43647697,64589,43386500,43779716,261197
7,ENSG00000160991.10,102433575,7-102308137-G-A,rs2242584,1,G,A,102308137,125438,102236967,102630183,71170
7,ENSG00000160991.10,102433575,7-102308137-G-T,rs2242584,1,G,T,102308137,125438,102236967,102630183,71170
7,ENSG00000106100.6,30478784,7-30475375-T-A,rs2256023,-1,T,A,30475375,3409,30282176,30675392,193199
7,ENSG00000106100.6,30478784,7-30475375-T-C,rs2256023,-1,T,C,30475375,3409,30282176,30675392,193199
7,ENSG00000106100.6,30478784,7-30475375-T-G,rs2256023,-1,T,G,30475375,3409,30282176,30675392,193199
7,ENSG00000136235.10,23246775,7-23273552-T-C,rs2268748,1,T,C,23273552,26777,23050167,23443383,223385
7,ENSG00000122783.11,135170707,7-135169463-T-A,rs2278126,-1,T,A,135169463,1244,134974099,135367315,195364
7,ENSG00000122783.11,135170707,7-135169463-T-C,rs2278126,-1,T,C,135169463,1244,134974099,135367315,195364
7,ENSG00000105877.12,21543039,7-21543345-G-T,rs2285943,1,G,T,21543345,306,21346431,21739647,196914
7,ENSG00000105877.12,21543039,7-21543345-G-A,rs2285943,1,G,A,21543345,306,21346431,21739647,196914
7,ENSG00000105829.6,94004355,7-93994146-A-G,rs2286845,-1,A,G,93994146,10209,93807747,94200963,186399
7,ENSG00000105829.6,94004355,7-93994146-A-C,rs2286845,-1,A,C,93994146,10209,93807747,94200963,186399
7,ENSG00000106344.3,128343908,7-128317549-A-C,rs2290225,-1,A,C,128317549,26359,128147300,128540516,170249
7,ENSG00000106344.3,128343908,7-128317549-A-T,rs2290225,-1,A,T,128317549,26359,128147300,128540516,170249
7,ENSG00000106344.3,128343908,7-128317549-A-G,rs2290225,-1,A,G,128317549,26359,128147300,128540516,170249
7,ENSG00000198898.6,116862587,7-116898580-T-C,rs2301649,1,T,C,116898580,35993,116665979,117059195,232601
7,ENSG00000198898.6,116862587,7-116898580-T-A,rs2301649,1,T,A,116898580,35993,116665979,117059195,232601
7,ENSG00000158604.9,44582231,7-44570153-C-T,rs2304373,-1,C,T,44570153,12078,44385623,44778839,184530
7,ENSG00000164815.6,104208013,7-104228743-A-G,rs2385142,-1,A,G,104228743,20730,104011405,104404621,217338
7,ENSG00000006576.11,77798792,7-77932977-G-A,rs2428939,1,G,A,77932977,134185,77602184,77995400,330793
7,ENSG00000006576.11,77798792,7-77932977-G-T,rs2428939,1,G,T,77932977,134185,77602184,77995400,330793
7,ENSG00000033100.9,151232483,7-151237076-G-T,rs2446065,1,G,T,151237076,4593,151035875,151429091,201201
7,ENSG00000033100.9,151232483,7-151237076-G-A,rs2446065,1,G,A,151237076,4593,151035875,151429091,201201
7,ENSG00000033100.9,151232483,7-151237076-G-C,rs2446065,1,G,C,151237076,4593,151035875,151429091,201201
7,ENSG00000127364.2,141776674,7-141907585-G-T,rs2471744,1,G,T,141907585,130911,141580066,141973282,327519
7,ENSG00000127364.2,141776674,7-141907585-G-A,rs2471744,1,G,A,141907585,130911,141580066,141973282,327519
7,ENSG00000013374.10,151341812,7-151336542-T-C,rs2487161,1,T,C,151336542,5270,151145204,151538420,191338
7,ENSG00000013374.10,151341812,7-151336542-T-A,rs2487161,1,T,A,151336542,5270,151145204,151538420,191338
7,ENSG00000187260.9,151410038,7-151336542-T-C,rs2487161,-1,T,C,151336542,73496,151213430,151606646,123112
7,ENSG00000187260.9,151410038,7-151336542-T-A,rs2487161,-1,T,A,151336542,73496,151213430,151606646,123112
7,ENSG00000048052.15,18495749,7-18509096-G-A,rs2520460,1,G,A,18509096,13347,18299141,18692357,209955
7,ENSG00000181016.4,112480991,7-112463000-A-C,rs2529588,1,A,C,112463000,17991,112284383,112677599,178617
7,ENSG00000181016.4,112480991,7-112463000-A-G,rs2529588,1,A,G,112463000,17991,112284383,112677599,178617
7,ENSG00000181016.4,112480991,7-112463000-A-T,rs2529588,1,A,T,112463000,17991,112284383,112677599,178617
7,ENSG00000205060.6,134316930,7-134235691-G-A,rs2544165,-1,G,A,134235691,81239,134120322,134513538,115369
7,ENSG00000205060.6,134316930,7-134235691-G-C,rs2544165,-1,G,C,134235691,81239,134120322,134513538,115369
7,ENSG00000146833.10,99919530,7-99922293-A-G,rs2571992,-1,A,G,99922293,2763,99722922,100116138,199371
7,ENSG00000188763.3,73433778,7-73569890-T-C,rs2573,1,T,C,73569890,136112,73237170,73630386,332720
7,ENSG00000086288.7,37848597,7-37940850-T-A,rs2598098,1,T,A,37940850,92253,37651989,38045205,288861
7,ENSG00000086288.7,37848597,7-37940850-T-G,rs2598098,1,T,G,37940850,92253,37651989,38045205,288861
7,ENSG00000128617.2,128775794,7-128839313-T-C,rs2643765,-1,T,C,128839313,63519,128579186,128972402,260127
7,ENSG00000091127.8,105522271,7-105507453-A-C,rs2668882,-1,A,C,105507453,14818,105325663,105718879,181790
7,ENSG00000091127.8,105522271,7-105507453-A-G,rs2668882,-1,A,G,105507453,14818,105325663,105718879,181790
7,ENSG00000160868.9,99784184,7-99767828-A-C,rs2687117,-1,A,C,99767828,16356,99587576,99980792,180252
7,ENSG00000160868.9,99784184,7-99767828-A-G,rs2687117,-1,A,G,99767828,16356,99587576,99980792,180252
7,ENSG00000160868.9,99784184,7-99767828-A-T,rs2687117,-1,A,T,99767828,16356,99587576,99980792,180252
7,ENSG00000002745.7,121329000,7-121324351-T-A,rs2707483,1,T,A,121324351,4649,121132392,121525608,191959
7,ENSG00000002745.7,121329000,7-121324351-T-G,rs2707483,1,T,G,121324351,4649,121132392,121525608,191959
7,ENSG00000122778.5,138981389,7-138951561-A-G,rs2718142,-1,A,G,138951561,29828,138784781,139177997,166780
7,ENSG00000071243.11,120950777,7-120896344-G-T,rs2721348,1,G,T,120896344,54433,120754169,121147385,142175
7,ENSG00000160908.14,99500281,7-99663111-C-A,rs28365086,-1,C,A,99663111,162830,99303673,99696889,359438
7,ENSG00000160908.14,99500281,7-99663111-C-T,rs28365086,-1,C,T,99663111,162830,99303673,99696889,359438
7,ENSG00000146963.10,139359894,7-139351312-A-G,rs28477480,1,A,G,139351312,8582,139163286,139556502,188026
7,ENSG00000146963.10,139359894,7-139351312-A-T,rs28477480,1,A,T,139351312,8582,139163286,139556502,188026
7,ENSG00000006459.6,140176983,7-140349492-A-G,rs28670038,-1,A,G,140349492,172509,139980375,140373591,369117
7,ENSG00000090266.7,140696708,7-140715861-C-T,rs2930325,1,C,T,140715861,19153,140500100,140893316,215761
7,ENSG00000133597.5,140672945,7-140715861-C-T,rs2930325,1,C,T,140715861,42916,140476337,140869553,239524
7,ENSG00000136205.11,47582111,7-47482578-C-T,rs2941541,-1,C,T,47482578,99533,47385503,47778719,97075
7,ENSG00000136205.11,47582111,7-47482578-C-G,rs2941541,-1,C,G,47482578,99533,47385503,47778719,97075
7,ENSG00000015676.12,44490658,7-44493099-G-A,rs307003,-1,G,A,44493099,2441,44294050,44687266,199049
7,ENSG00000127951.5,77199819,7-77199958-A-C,rs3093273,-1,A,C,77199958,139,77003211,77396427,196747
7,ENSG00000127951.5,77199819,7-77199958-A-G,rs3093273,-1,A,G,77199958,139,77003211,77396427,196747
7,ENSG00000164707.9,135728186,7-135672728-A-C,rs3110823,-1,A,C,135672728,55458,135531578,135924794,141150
7,ENSG00000164707.9,135728186,7-135672728-A-G,rs3110823,-1,A,G,135672728,55458,135531578,135924794,141150
7,ENSG00000243317.3,135662514,7-135672728-A-C,rs3110823,1,A,C,135672728,10214,135465906,135859122,206822
7,ENSG00000243317.3,135662514,7-135672728-A-G,rs3110823,1,A,G,135672728,10214,135465906,135859122,206822
7,ENSG00000188191.8,727281,7-579301-A-T,rs3211362,-1,A,T,579301,147980,530673,923889,48628
7,ENSG00000188191.8,727281,7-579301-A-G,rs3211362,-1,A,G,579301,147980,530673,923889,48628
7,ENSG00000006704.6,74453906,7-74387615-G-A,rs34083004,1,G,A,74387615,66291,74257298,74650514,130317
7,ENSG00000146540.9,1138247,7-962176-A-G,rs34201071,-1,A,G,962176,176071,941639,1334855,20537
7,ENSG00000146540.9,1138247,7-962176-A-C,rs34201071,-1,A,C,962176,176071,941639,1334855,20537
7,ENSG00000214102.3,141708353,7-141810553-C-A,rs35010424,1,C,A,141810553,102200,141511745,141904961,298808
7,ENSG00000214102.3,141708353,7-141810553-C-T,rs35010424,1,C,T,141810553,102200,141511745,141904961,298808
7,ENSG00000130429.7,99374730,7-99459718-T-G,rs35296070,1,T,G,99459718,84988,99178122,99571338,281596
7,ENSG00000130429.7,99374730,7-99459718-T-C,rs35296070,1,T,C,99459718,84988,99178122,99571338,281596
7,ENSG00000196715.4,65873074,7-65892097-A-G,rs35480979,1,A,G,65892097,19023,65676466,66069682,215631
7,ENSG00000215045.4,6551461,7-6391578-C-T,rs35981225,-1,C,T,6391578,159883,6354853,6748069,36725
7,ENSG00000215045.4,6551461,7-6391578-C-A,rs35981225,-1,C,A,6391578,159883,6354853,6748069,36725
7,ENSG00000136280.10,45000201,7-45108420-C-T,rs3757574,1,C,T,45108420,108219,44803593,45196809,304827
7,ENSG00000106327.8,100641552,7-100643540-A-C,rs3757859,-1,A,C,100643540,1988,100444944,100838160,198596
7,ENSG00000106327.8,100641552,7-100643540-A-G,rs3757859,-1,A,G,100643540,1988,100444944,100838160,198596
7,ENSG00000164692.12,94394895,7-94392163-T-C,rs3763469,1,T,C,94392163,2732,94198287,94591503,193876
7,ENSG00000005075.11,102478922,7-102472646-T-C,rs3800988,-1,T,C,102472646,6276,102282314,102675530,190332
7,ENSG00000005075.11,102478922,7-102472646-T-A,rs3800988,-1,T,A,102472646,6276,102282314,102675530,190332
7,ENSG00000128604.13,128937927,7-128939148-T-C,rs3807307,1,T,C,128939148,1221,128741319,129134535,197829
7,ENSG00000128510.5,130293161,7-130294379-T-A,rs3807344,1,T,A,130294379,1218,130096553,130489769,197826
7,ENSG00000128510.5,130293161,7-130294379-T-C,rs3807344,1,T,C,130294379,1218,130096553,130489769,197826
7,ENSG00000086289.7,37920640,7-37918169-A-G,rs3807612,1,A,G,37918169,2471,37724032,38117248,194137
7,ENSG00000106460.13,12211294,7-12210752-G-A,rs3807866,1,G,A,12210752,542,12014686,12407902,196066
7,ENSG00000117868.9,158829509,7-158788727-G-C,rs3850489,-1,G,C,158788727,40782,158632901,159026117,155826
7,ENSG00000117868.9,158829509,7-158788727-G-A,rs3850489,-1,G,A,158788727,40782,158632901,159026117,155826
7,ENSG00000184903.5,111562492,7-111438856-T-G,rs38752,-1,T,G,111438856,123636,111365884,111759100,72972
7,ENSG00000184903.5,111562492,7-111438856-T-A,rs38752,-1,T,A,111438856,123636,111365884,111759100,72972
7,ENSG00000197150.7,151028450,7-151010256-G-A,rs3918201,1,G,A,151010256,18194,150831842,151225058,178414
7,ENSG00000197150.7,151028450,7-151010256-G-C,rs3918201,1,G,C,151010256,18194,150831842,151225058,178414
7,ENSG00000197150.7,151028450,7-151010256-G-T,rs3918201,1,G,T,151010256,18194,150831842,151225058,178414
7,ENSG00000106367.9,101154476,7-101167419-G-T,rs3919482,1,G,T,101167419,12943,100957868,101351084,209551
7,ENSG00000106367.9,101154476,7-101167419-G-C,rs3919482,1,G,C,101167419,12943,100957868,101351084,209551
7,ENSG00000106367.9,101154476,7-101167419-G-A,rs3919482,1,G,A,101167419,12943,100957868,101351084,209551
7,ENSG00000177683.8,108569706,7-108562348-C-T,rs40939,-1,C,T,108562348,7358,108373098,108766314,189250
7,ENSG00000198822.6,86643909,7-86753004-T-C,rs41381245,1,T,C,86753004,109095,86447301,86840517,305703
7,ENSG00000186472.13,83162884,7-83088852-C-T,rs41521249,-1,C,T,83088852,74032,82966276,83359492,122576
7,ENSG00000164638.5,5282943,7-5301939-A-G,rs4299914,1,A,G,5301939,18996,5086335,5479551,215604
7,ENSG00000164638.5,5282943,7-5301939-A-T,rs4299914,1,A,T,5301939,18996,5086335,5479551,215604
7,ENSG00000164638.5,5282943,7-5301939-A-C,rs4299914,1,A,C,5301939,18996,5086335,5479551,215604
7,ENSG00000136247.10,6577454,7-6608107-T-A,rs4416743,1,T,A,6608107,30653,6380846,6774062,227261
7,ENSG00000136247.10,6577454,7-6608107-T-C,rs4416743,1,T,C,6608107,30653,6380846,6774062,227261
7,ENSG00000106261.12,100015596,7-100045122-A-G,rs4424195,1,A,G,100045122,29526,99818988,100212204,226134
7,ENSG00000106261.12,100015596,7-100045122-A-C,rs4424195,1,A,C,100045122,29526,99818988,100212204,226134
7,ENSG00000129103.13,56064286,7-56049716-G-A,rs4424212,1,G,A,56049716,14570,55867678,56260894,182038
7,ENSG00000129103.13,56064286,7-56049716-G-C,rs4424212,1,G,C,56049716,14570,55867678,56260894,182038
7,ENSG00000198874.7,66996833,7-67172014-G-C,rs4433018,1,G,C,67172014,175181,66800225,67193441,371789
7,ENSG00000198874.7,66996833,7-67172014-G-A,rs4433018,1,G,A,67172014,175181,66800225,67193441,371789
7,ENSG00000198874.7,66996833,7-67172014-G-T,rs4433018,1,G,T,67172014,175181,66800225,67193441,371789
7,ENSG00000136261.10,16646181,7-16783191-C-T,rs4517018,1,C,T,16783191,137010,16449573,16842789,333618
7,ENSG00000234444.3,64313961,7-64356018-G-C,rs4718067,1,G,C,64356018,42057,64117353,64510569,238665
7,ENSG00000234444.3,64313961,7-64356018-G-A,rs4718067,1,G,A,64356018,42057,64117353,64510569,238665
7,ENSG00000050344.6,26152198,7-26120418-C-T,rs4719858,1,C,T,26120418,31780,25955590,26348806,164828
7,ENSG00000075624.8,5530601,7-5560738-C-T,rs4724708,-1,C,T,5560738,30137,5333993,5727209,226745
7,ENSG00000146904.4,143408856,7-143386318-G-A,rs4725616,-1,G,A,143386318,22538,143212248,143605464,174070
7,ENSG00000187416.7,104328603,7-104250637-A-G,rs4727591,1,A,G,104250637,77966,104131995,104525211,118642
7,ENSG00000146700.8,76409697,7-76383349-T-C,rs4728710,-1,T,C,76383349,26348,76213089,76606305,170260
7,ENSG00000170027.4,76358991,7-76383349-T-C,rs4728710,-1,T,C,76383349,24358,76162383,76555599,220966
7,ENSG00000106290.10,100119358,7-100041822-T-C,rs4729568,-1,T,C,100041822,77536,99922750,100315966,119072
7,ENSG00000221838.5,100101643,7-100041822-T-C,rs4729568,1,T,C,100041822,59821,99905035,100298251,136787
7,ENSG00000166529.9,100049774,7-100041822-T-C,rs4729568,1,T,C,100041822,7952,99853166,100246382,188656
7,ENSG00000106123.7,142855076,7-142871094-G-A,rs4987688,1,G,A,142871094,16018,142658468,143051684,212626
7,ENSG00000161036.5,102464984,7-102461063-A-G,rs4989124,1,A,G,102461063,3921,102268376,102661592,192687
7,ENSG00000146830.7,100694250,7-100715797-A-T,rs506597,-1,A,T,100715797,21547,100497642,100890858,218155
7,ENSG00000146830.7,100694250,7-100715797-A-C,rs506597,-1,A,C,100715797,21547,100497642,100890858,218155
7,ENSG00000146830.7,100694250,7-100715797-A-G,rs506597,-1,A,G,100715797,21547,100497642,100890858,218155
7,ENSG00000090263.10,141014952,7-141079940-T-C,rs557962,-1,T,C,141079940,64988,140818344,141211560,261596
7,ENSG00000090263.10,141014952,7-141079940-T-G,rs557962,-1,T,G,141079940,64988,140818344,141211560,261596
7,ENSG00000090263.10,141014952,7-141079940-T-A,rs557962,-1,T,A,141079940,64988,140818344,141211560,261596
7,ENSG00000075213.5,84194789,7-84237520-A-G,rs55825855,-1,A,G,84237520,42731,83998181,84391397,239339
7,ENSG00000155530.2,134127299,7-134086377-C-T,rs55974805,1,C,T,134086377,40922,133930691,134323907,155686
7,ENSG00000188186.6,100148918,7-100222221-G-A,rs56089143,1,G,A,100222221,73303,99952310,100345526,269911
7,ENSG00000086232.7,6059175,7-6058670-C-T,rs581706,-1,C,T,6058670,505,5862567,6255783,196103
7,ENSG00000157240.2,91264433,7-91276216-C-T,rs59201311,1,C,T,91276216,11783,91067825,91461041,208391
7,ENSG00000146842.11,130205406,7-130156105-A-C,rs60394478,-1,A,C,130156105,49301,130008798,130402014,147307
7,ENSG00000146842.11,130205406,7-130156105-A-G,rs60394478,-1,A,G,130156105,49301,130008798,130402014,147307
7,ENSG00000071462.7,73683597,7-73683383-G-C,rs61751896,1,G,C,73683383,214,73486989,73880205,196394
7,ENSG00000071462.7,73683597,7-73683383-G-A,rs61751896,1,G,A,73683383,214,73486989,73880205,196394
7,ENSG00000071462.7,73683597,7-73683383-G-T,rs61751896,1,G,T,73683383,214,73486989,73880205,196394
7,ENSG00000105963.7,954680,7-934672-G-A,rs62433082,-1,G,A,934672,20008,758072,1151288,176600
7,ENSG00000105963.7,954680,7-934672-G-T,rs62433082,-1,G,T,934672,20008,758072,1151288,176600
7,ENSG00000006451.3,39623572,7-39584670-C-T,rs62453608,1,C,T,39584670,38902,39426964,39820180,157706
7,ENSG00000008256.11,6272624,7-6129276-C-A,rs62454270,-1,C,A,6129276,143348,6076016,6469232,53260
7,ENSG00000008256.11,6272624,7-6129276-C-T,rs62454270,-1,C,T,6129276,143348,6076016,6469232,53260
7,ENSG00000188732.6,23680199,7-23690555-A-C,rs6461725,1,A,C,23690555,10356,23483591,23876807,206964
7,ENSG00000188732.6,23680199,7-23690555-A-G,rs6461725,1,A,G,23690555,10356,23483591,23876807,206964
7,ENSG00000188732.6,23680199,7-23690555-A-T,rs6461725,1,A,T,23690555,10356,23483591,23876807,206964
7,ENSG00000066923.11,100177918,7-99993795-G-A,rs6465760,1,G,A,99993795,184123,99981310,100374526,12485
7,ENSG00000008282.3,106112312,7-106053509-T-C,rs6466081,-1,T,C,106053509,58803,105915704,106308920,137805
7,ENSG00000106153.12,56106476,7-56104067-A-C,rs6593298,-1,A,C,56104067,2409,55909868,56303084,194199
7,ENSG00000106153.12,56106476,7-56104067-A-T,rs6593298,-1,A,T,56104067,2409,55909868,56303084,194199
7,ENSG00000106153.12,56106476,7-56104067-A-G,rs6593298,-1,A,G,56104067,2409,55909868,56303084,194199
7,ENSG00000186480.8,155297878,7-155190050-G-A,rs6597475,1,G,A,155190050,107828,155101270,155494486,88780
7,ENSG00000136240.5,6484152,7-6462736-T-C,rs6796,-1,T,C,6462736,21416,6287544,6680760,175192
7,ENSG00000164746.9,48035543,7-47901760-G-A,rs6945000,1,G,A,47901760,133783,47838935,48232151,62825
7,ENSG00000127946.12,75738941,7-75748121-A-G,rs6945301,-1,A,G,75748121,9180,75542333,75935549,205788
7,ENSG00000106013.8,118224704,7-118219617-T-C,rs6946385,1,T,C,118219617,5087,118028096,118421312,191521
7,ENSG00000106013.8,118224704,7-118219617-T-G,rs6946385,1,T,G,118219617,5087,118028096,118421312,191521
7,ENSG00000127948.9,75915155,7-76054230-G-A,rs6950085,1,G,A,76054230,139075,75718547,76111763,335683
7,ENSG00000059378.7,140062951,7-140019639-C-A,rs6952262,-1,C,A,140019639,43312,139866343,140259559,153296
7,ENSG00000059378.7,140062951,7-140019639-C-G,rs6952262,-1,C,G,140019639,43312,139866343,140259559,153296
7,ENSG00000059378.7,140062951,7-140019639-C-T,rs6952262,-1,C,T,140019639,43312,139866343,140259559,153296
7,ENSG00000003147.13,8262167,7-8351589-A-T,rs6952743,-1,A,T,8351589,89422,8065559,8458775,286030
7,ENSG00000196652.6,99504662,7-99544047-C-T,rs6962461,1,C,T,99544047,39385,99308054,99701270,235993
7,ENSG00000106355.5,32490380,7-32453365-C-T,rs6962754,-1,C,T,32453365,37015,32293772,32686988,159593
7,ENSG00000128606.8,102913000,7-102806894-G-C,rs6963884,1,G,C,102806894,106106,102716392,103109608,90502
7,ENSG00000128606.8,102913000,7-102806894-G-A,rs6963884,1,G,A,102806894,106106,102716392,103109608,90502
7,ENSG00000121716.11,100358117,7-100375779-G-A,rs6965458,1,G,A,100375779,17662,100161509,100554725,214270
7,ENSG00000213199.3,151048531,7-151128000-G-T,rs6970983,1,G,T,151128000,79469,150851923,151245139,276077
7,ENSG00000213199.3,151048531,7-151128000-G-A,rs6970983,1,G,A,151128000,79469,150851923,151245139,276077
7,ENSG00000213199.3,151048531,7-151128000-G-C,rs6970983,1,G,C,151128000,79469,150851923,151245139,276077
7,ENSG00000164849.6,1044546,7-1159996-T-C,rs6973680,1,T,C,1159996,115450,847938,1241154,312058
7,ENSG00000136213.7,2403611,7-2348007-T-G,rs6974490,1,T,G,2348007,55604,2207003,2600219,141004
7,ENSG00000136213.7,2403611,7-2348007-T-C,rs6974490,1,T,C,2348007,55604,2207003,2600219,141004
7,ENSG00000164896.13,151080809,7-151125105-C-A,rs729712,-1,C,A,151125105,44296,150884201,151277417,240904
7,ENSG00000164896.13,151080809,7-151125105-C-T,rs729712,-1,C,T,151125105,44296,150884201,151277417,240904
7,ENSG00000106633.11,44189439,7-44232814-G-T,rs730951,-1,G,T,44232814,43375,43992831,44386047,239983
7,ENSG00000106633.11,44189439,7-44232814-G-A,rs730951,-1,G,A,44232814,43375,43992831,44386047,239983
7,ENSG00000164776.5,56092952,7-56040301-A-C,rs73140801,-1,A,C,56040301,52651,55896344,56289560,143957
7,ENSG00000164776.5,56092952,7-56040301-A-G,rs73140801,-1,A,G,56040301,52651,55896344,56289560,143957
7,ENSG00000240204.1,129502531,7-129385468-G-A,rs73234741,1,G,A,129385468,117063,129305923,129699139,79545
7,ENSG00000240204.1,129502531,7-129385468-G-T,rs73234741,1,G,T,129385468,117063,129305923,129699139,79545
7,ENSG00000122512.9,6009049,7-5998414-T-C,rs73331331,-1,T,C,5998414,10635,5812441,6205657,185973
7,ENSG00000122512.9,6009049,7-5998414-T-A,rs73331331,-1,T,A,5998414,10635,5812441,6205657,185973
7,ENSG00000158467.12,129225030,7-129137318-A-T,rs73462930,1,A,T,129137318,87712,129028422,129421638,108896
7,ENSG00000158467.12,129225030,7-129137318-A-G,rs73462930,1,A,G,129137318,87712,129028422,129421638,108896
7,ENSG00000164916.7,4682295,7-4755969-T-C,rs73674092,1,T,C,4755969,73674,4485687,4878903,270282
7,ENSG00000185811.12,50304716,7-50412640-G-A,rs73695639,1,G,A,50412640,107924,50108108,50501324,304532
7,ENSG00000106399.7,7718607,7-7532443-G-A,rs74983009,-1,G,A,7532443,186164,7521999,7915215,10444
7,ENSG00000127952.11,76048000,7-76127146-T-C,rs74999892,-1,T,C,76127146,79146,75851392,76244608,275754
7,ENSG00000106554.7,133082090,7-133235342-G-A,rs75411528,-1,G,A,133235342,153252,132885482,133278698,349860
7,ENSG00000128596.11,128791968,7-128932249-G-A,rs754280,1,G,A,128932249,140281,128595360,128988576,336889
7,ENSG00000105928.9,24757464,7-24719199-G-T,rs754554,-1,G,T,24719199,38265,24560856,24954072,158343
7,ENSG00000105928.9,24757464,7-24719199-G-C,rs754554,-1,G,C,24719199,38265,24560856,24954072,158343
7,ENSG00000105928.9,24757464,7-24719199-G-A,rs754554,-1,G,A,24719199,38265,24560856,24954072,158343
7,ENSG00000010270.9,38178245,7-38223122-C-G,rs756392,1,C,G,38223122,44877,37981637,38374853,241485
7,ENSG00000010270.9,38178245,7-38223122-C-T,rs756392,1,C,T,38223122,44877,37981637,38374853,241485
7,ENSG00000161048.7,103149099,7-103291652-T-C,rs75987935,-1,T,C,103291652,142553,102952491,103345707,339161
7,ENSG00000214194.4,113118554,7-112964576-A-G,rs76629134,-1,A,G,112964576,153978,112921946,113315162,42630
7,ENSG00000164542.8,36367240,7-36474489-G-T,rs76827509,-1,G,T,36474489,107249,36170632,36563848,303857
7,ENSG00000128573.17,114414815,7-114463871-A-G,rs76853245,1,A,G,114463871,49056,114218207,114611423,245664
7,ENSG00000196262.8,44796681,7-44766892-C-T,rs77367934,1,C,T,44766892,29789,44600073,44993289,166819
7,ENSG00000159840.11,143381345,7-143414712-C-T,rs77531530,1,C,T,143414712,33367,143184737,143577953,229975
7,ENSG00000198420.5,143902176,7-143734790-A-C,rs7776595,-1,A,C,143734790,167386,143705568,144098784,29222
7,ENSG00000198420.5,143902176,7-143734790-A-T,rs7776595,-1,A,T,143734790,167386,143705568,144098784,29222
7,ENSG00000198420.5,143902176,7-143734790-A-G,rs7776595,-1,A,G,143734790,167386,143705568,144098784,29222
7,ENSG00000075790.6,107580246,7-107607457-G-A,rs7779261,1,G,A,107607457,27211,107383638,107776854,223819
7,ENSG00000212807.1,144239605,7-144164657-A-C,rs7779313,-1,A,C,144164657,74948,144042997,144436213,121660
7,ENSG00000212807.1,144239605,7-144164657-A-G,rs7779313,-1,A,G,144164657,74948,144042997,144436213,121660
7,ENSG00000213214.3,144195833,7-144164657-A-C,rs7779313,-1,A,C,144164657,31176,143999225,144392441,165432
7,ENSG00000213214.3,144195833,7-144164657-A-G,rs7779313,-1,A,G,144164657,31176,143999225,144392441,165432
7,ENSG00000106125.14,30771417,7-30797660-G-A,rs7781249,1,G,A,30797660,26243,30574809,30968025,222851
7,ENSG00000133574.4,150567390,7-150625466-T-G,rs7784767,1,T,G,150625466,58076,150370782,150763998,254684
7,ENSG00000197362.8,149090718,7-149134529-A-G,rs7788925,-1,A,G,149134529,43811,148894110,149287326,240419
7,ENSG00000197362.8,149090718,7-149134529-A-T,rs7788925,-1,A,T,149134529,43811,148894110,149287326,240419
7,ENSG00000197362.8,149090718,7-149134529-A-C,rs7788925,-1,A,C,149134529,43811,148894110,149287326,240419
7,ENSG00000128591.11,128830406,7-128708351-G-A,rs7790478,1,G,A,128708351,122055,128633798,129027014,74553
7,ENSG00000136238.13,6374527,7-6343893-G-C,rs7791772,1,G,C,6343893,30634,6177919,6571135,165974
7,ENSG00000136238.13,6374527,7-6343893-G-A,rs7791772,1,G,A,6343893,30634,6177919,6571135,165974
7,ENSG00000136238.13,6374527,7-6343893-G-T,rs7791772,1,G,T,6343893,30634,6177919,6571135,165974
7,ENSG00000180354.11,30134986,7-30163220-G-A,rs7793699,1,G,A,30163220,28234,29938378,30331594,224842
7,ENSG00000189077.6,75994595,7-75991323-G-A,rs7794040,-1,G,A,75991323,3272,75797987,76191203,193336
7,ENSG00000059377.10,139829264,7-139818820-T-C,rs77943929,1,T,C,139818820,10444,139632656,140025872,186164
7,ENSG00000059377.10,139829264,7-139818820-T-G,rs77943929,1,T,G,139818820,10444,139632656,140025872,186164
7,ENSG00000127993.9,92528795,7-92651664-T-C,rs7795844,1,T,C,92651664,122869,92332187,92725403,319477
7,ENSG00000171130.11,149873969,7-149874377-A-G,rs7795944,1,A,G,149874377,408,149677361,150070577,197016
7,ENSG00000204947.4,149126324,7-149102480-C-A,rs7796282,-1,C,A,149102480,23844,148929716,149322932,172764
7,ENSG00000136237.12,22357154,7-22351471-C-T,rs7798524,-1,C,T,22351471,5683,22160546,22553762,190925
7,ENSG00000164647.4,90154469,7-90007090-C-T,rs7799411,1,C,T,90007090,147379,89957861,90351077,49229
7,ENSG00000164647.4,90154469,7-90007090-C-G,rs7799411,1,C,G,90007090,147379,89957861,90351077,49229
7,ENSG00000164647.4,90154469,7-90007090-C-A,rs7799411,1,C,A,90007090,147379,89957861,90351077,49229
7,ENSG00000205085.4,128672292,7-128613342-T-C,rs7800335,1,T,C,128613342,58950,128475684,128868900,137658
7,ENSG00000087085.8,100895888,7-100908172-A-G,rs7803865,-1,A,G,100908172,12284,100699280,101092496,208892
7,ENSG00000127399.10,150323355,7-150316304-T-A,rs7806429,1,T,A,150316304,7051,150126747,150519963,189557
7,ENSG00000127399.10,150323355,7-150316304-T-C,rs7806429,1,T,C,150316304,7051,150126747,150519963,189557
7,ENSG00000105855.4,20330900,7-20239019-G-T,rs7806550,1,G,T,20239019,91881,20134292,20527508,104727
7,ENSG00000105855.4,20330900,7-20239019-G-A,rs7806550,1,G,A,20239019,91881,20134292,20527508,104727
7,ENSG00000213462.4,65006687,7-64989251-A-G,rs7807855,-1,A,G,64989251,17436,64810079,65203295,179172
7,ENSG00000213462.4,65006687,7-64989251-A-T,rs7807855,-1,A,T,64989251,17436,64810079,65203295,179172
7,ENSG00000214253.4,101245081,7-101238809-G-C,rs7808669,-1,G,C,101238809,6272,101048473,101441689,190336
7,ENSG00000214253.4,101245081,7-101238809-G-A,rs7808669,-1,G,A,101238809,6272,101048473,101441689,190336
7,ENSG00000214309.3,100126967,7-100127523-C-G,rs78225095,1,C,G,100127523,556,99930359,100323575,197164
7,ENSG00000146757.9,65373855,7-65269753-C-A,rs78369014,1,C,A,65269753,104102,65177247,65570463,92506
7,ENSG00000105810.5,92836573,7-92857303-A-G,rs78581841,-1,A,G,92857303,20730,92639965,93033181,217338
7,ENSG00000105854.7,95435028,7-95495017-G-A,rs78641443,-1,G,A,95495017,59989,95238420,95631636,256597
7,ENSG00000122786.13,134779634,7-134738986-A-C,rs78694204,1,A,C,134738986,40648,134583026,134976242,155960
7,ENSG00000106144.14,143288351,7-143322273-G-T,rs79790719,1,G,T,143322273,33922,143091743,143484959,230530
7,ENSG00000075618.11,5592816,7-5582630-G-A,rs79871375,1,G,A,5582630,10186,5396208,5789424,186422
7,ENSG00000106617.8,151877115,7-151793953-G-C,rs79918575,-1,G,C,151793953,83162,151680507,152073723,113446
7,ENSG00000009954.6,73522293,7-73712768-G-A,rs875342,-1,G,A,73712768,190475,73325685,73718901,387083
7,ENSG00000136295.10,2631986,7-2775100-A-G,rs9332401,1,A,G,2775100,143114,2435378,2828594,339722
7,ENSG00000158525.11,130344816,7-130382200-C-T,rs968404,1,C,T,130382200,37384,130148208,130541424,233992
7,ENSG00000001630.10,92134477,7-92245213-C-G,rs975707,-1,C,G,92245213,110736,91937869,92331085,307344
7,ENSG00000001630.10,92134477,7-92245213-C-A,rs975707,-1,C,A,92245213,110736,91937869,92331085,307344
7,ENSG00000001630.10,92134477,7-92245213-C-T,rs975707,-1,C,T,92245213,110736,91937869,92331085,307344
7,ENSG00000106049.3,27662883,7-27543164-G-T,rs978447,-1,G,T,27543164,119719,27466275,27859491,76889
7,ENSG00000106049.3,27662883,7-27543164-G-C,rs978447,-1,G,C,27543164,119719,27466275,27859491,76889
7,ENSG00000106049.3,27662883,7-27543164-G-A,rs978447,-1,G,A,27543164,119719,27466275,27859491,76889
7,ENSG00000205277.5,100969565,7-101072593-G-A,rs9792109,1,G,A,101072593,103028,100772957,101166173,299636
7,ENSG00000006652.8,112450460,7-112471361-T-C,rs1005659,1,T,C,112471361,20901,112253852,112647068,217509
7,ENSG00000157212.13,155003124,7-155068597-A-T,rs1017488,-1,A,T,155068597,65473,154806516,155199732,262081
7,ENSG00000157212.13,155003124,7-155068597-A-C,rs1017488,-1,A,C,155068597,65473,154806516,155199732,262081
7,ENSG00000157212.13,155003124,7-155068597-A-G,rs1017488,-1,A,G,155068597,65473,154806516,155199732,262081
7,ENSG00000243317.3,135662514,7-135629089-C-T,rs10224307,1,C,T,135629089,33425,135465906,135859122,163183
7,ENSG00000178381.7,1160196,7-1042336-C-G,rs10224368,-1,C,G,1042336,117860,963588,1356804,78748
7,ENSG00000178381.7,1160196,7-1042336-C-A,rs10224368,-1,C,A,1042336,117860,963588,1356804,78748
7,ENSG00000146963.10,139359894,7-139361760-C-T,rs10233769,1,C,T,139361760,1866,139163286,139556502,198474
7,ENSG00000146963.10,139359894,7-139361760-C-G,rs10233769,1,C,G,139361760,1866,139163286,139556502,198474
7,ENSG00000090263.10,141014952,7-141021568-A-G,rs10239770,-1,A,G,141021568,6616,140818344,141211560,203224
7,ENSG00000164690.3,155812463,7-155757204-C-T,rs10252910,-1,C,T,155757204,55259,155615855,156009071,141349
7,ENSG00000003147.13,8262167,7-8179168-G-C,rs10264092,-1,G,C,8179168,82999,8065559,8458775,113609
7,ENSG00000003147.13,8262167,7-8179168-G-A,rs10264092,-1,G,A,8179168,82999,8065559,8458775,113609
7,ENSG00000003147.13,8262167,7-8179168-G-T,rs10264092,-1,G,T,8179168,82999,8065559,8458775,113609
7,ENSG00000085563.8,87600884,7-87633265-G-A,rs10264856,-1,G,A,87633265,32381,87404276,87797492,228989
7,ENSG00000106400.7,101218165,7-101221803-G-A,rs10265206,1,G,A,101221803,3638,101021557,101414773,200246
7,ENSG00000214253.4,101245081,7-101221803-G-A,rs10265206,-1,G,A,101221803,23278,101048473,101441689,173330
7,ENSG00000008256.11,6272624,7-6258325-G-A,rs10268916,-1,G,A,6258325,14299,6076016,6469232,182309
7,ENSG00000164828.12,832476,7-903397-C-T,rs10269327,1,C,T,903397,70921,635868,1029084,267529
7,ENSG00000164828.12,832476,7-903397-C-G,rs10269327,1,C,G,903397,70921,635868,1029084,267529
7,ENSG00000164828.12,832476,7-903397-C-A,rs10269327,1,C,A,903397,70921,635868,1029084,267529
7,ENSG00000106128.13,30963953,7-30788999-T-C,rs10272887,1,T,C,30788999,174954,30767345,31160561,21654
7,ENSG00000196329.5,150737418,7-150672359-C-T,rs10275417,1,C,T,150672359,65059,150540810,150934026,131549
7,ENSG00000198517.5,1530702,7-1449745-G-A,rs10276847,1,G,A,1449745,80957,1334094,1727310,115651
7,ENSG00000136193.10,29989801,7-29876969-G-A,rs10276961,-1,G,A,29876969,112832,29793193,30186409,83776
7,ENSG00000106538.5,150341629,7-150375413-T-C,rs10480297,-1,T,C,150375413,33784,150145021,150538237,230392
7,ENSG00000105855.4,20330900,7-20252255-G-A,rs10486388,1,G,A,20252255,78645,20134292,20527508,117963
7,ENSG00000105855.4,20330900,7-20252255-G-T,rs10486388,1,G,T,20252255,78645,20134292,20527508,117963
7,ENSG00000186645.6,77032361,7-77204749-A-G,rs10488499,-1,A,G,77204749,172388,76835753,77228969,368996
7,ENSG00000105810.5,92836573,7-93021429-T-G,rs10488528,-1,T,G,93021429,184856,92639965,93033181,381464
7,ENSG00000133561.9,150632385,7-150693416-G-T,rs1055240,-1,G,T,150693416,61031,150435777,150828993,257639
7,ENSG00000133561.9,150632385,7-150693416-G-C,rs1055240,-1,G,C,150693416,61031,150435777,150828993,257639
7,ENSG00000133561.9,150632385,7-150693416-G-A,rs1055240,-1,G,A,150693416,61031,150435777,150828993,257639
7,ENSG00000128564.4,101165569,7-100992380-T-C,rs10953313,-1,T,C,100992380,173189,100968961,101362177,23419
7,ENSG00000128564.4,101165569,7-100992380-T-A,rs10953313,-1,T,A,100992380,173189,100968961,101362177,23419
7,ENSG00000146859.4,135148072,7-134969179-T-A,rs11204,1,T,A,134969179,178893,134951464,135344680,17715
7,ENSG00000146859.4,135148072,7-134969179-T-G,rs11204,1,T,G,134969179,178893,134951464,135344680,17715
7,ENSG00000146859.4,135148072,7-134969179-T-C,rs11204,1,T,C,134969179,178893,134951464,135344680,17715
7,ENSG00000106367.9,101154476,7-101173024-T-C,rs112978090,1,T,C,101173024,18548,100957868,101351084,215156
7,ENSG00000106608.12,43906596,7-43761631-T-C,rs113581902,-1,T,C,43761631,144965,43709988,44103204,51643
7,ENSG00000106608.12,43906596,7-43761631-T-A,rs113581902,-1,T,A,43761631,144965,43709988,44103204,51643
7,ENSG00000161036.5,102464984,7-102426426-T-C,rs11444,1,T,C,102426426,38558,102268376,102661592,158050
7,ENSG00000164647.4,90154469,7-90187387-A-G,rs11563564,1,A,G,90187387,32918,89957861,90351077,229526
7,ENSG00000197576.8,27130757,7-27307978-T-C,rs11564006,-1,T,C,27307978,177221,26934149,27327365,373829
7,ENSG00000197576.8,27130757,7-27307978-T-G,rs11564006,-1,T,G,27307978,177221,26934149,27327365,373829
7,ENSG00000106617.8,151877115,7-151901974-A-C,rs116022132,-1,A,C,151901974,24859,151680507,152073723,221467
7,ENSG00000106617.8,151877115,7-151901974-A-G,rs116022132,-1,A,G,151901974,24859,151680507,152073723,221467
7,ENSG00000178809.7,75395629,7-75546611-C-A,rs1167797,1,C,A,75546611,150982,75199021,75592237,347590
7,ENSG00000178809.7,75395629,7-75546611-C-G,rs1167797,1,C,G,75546611,150982,75199021,75592237,347590
7,ENSG00000178809.7,75395629,7-75546611-C-T,rs1167797,1,C,T,75546611,150982,75199021,75592237,347590
7,ENSG00000105854.7,95435028,7-95505406-G-A,rs116922441,-1,G,A,95505406,70378,95238420,95631636,266986
7,ENSG00000105854.7,95435028,7-95505406-G-C,rs116922441,-1,G,C,95505406,70378,95238420,95631636,266986
7,ENSG00000127366.4,141790217,7-141600470-C-T,rs117203961,1,C,T,141600470,189747,141593609,141986825,6861
7,ENSG00000106246.9,99438798,7-99334497-C-G,rs117316159,-1,C,G,99334497,104301,99242190,99635406,92307
7,ENSG00000154978.8,55572502,7-55473993-G-A,rs117337937,-1,G,A,55473993,98509,55375894,55769110,98099
7,ENSG00000136250.6,36724494,7-36881725-G-C,rs117386933,-1,G,C,36881725,157231,36527886,36921102,353839
7,ENSG00000136250.6,36724494,7-36881725-G-A,rs117386933,-1,G,A,36881725,157231,36527886,36921102,353839
7,ENSG00000126522.10,66075819,7-65998667-G-A,rs117429228,1,G,A,65998667,77152,65879211,66272427,119456
7,ENSG00000002933.3,150800769,7-150986933-G-A,rs117564322,1,G,A,150986933,186164,150604161,150997377,382772
7,ENSG00000106636.3,44200978,7-44332588-G-A,rs11762769,1,G,A,44332588,131610,44004370,44397586,328218
7,ENSG00000186480.8,155297878,7-155220772-G-A,rs11765868,1,G,A,155220772,77106,155101270,155494486,119502
7,ENSG00000197008.5,64794428,7-64655565-C-T,rs117663768,1,C,T,64655565,138863,64597820,64991036,57745
7,ENSG00000106268.11,2242226,7-2350500-G-C,rs11767378,1,G,C,2350500,108274,2045618,2438834,304882
7,ENSG00000106268.11,2242226,7-2350500-G-T,rs11767378,1,G,T,2350500,108274,2045618,2438834,304882
7,ENSG00000204946.5,149262196,7-149427759-A-G,rs117675411,1,A,G,149427759,165563,149065588,149458804,362171
7,ENSG00000122550.11,23105785,7-23168424-G-A,rs11770879,1,G,A,23168424,62639,22909177,23302393,259247
7,ENSG00000205356.5,98252232,7-98249398-T-C,rs11771397,-1,T,C,98249398,2834,98055624,98448840,193774
7,ENSG00000205356.5,98252232,7-98249398-T-A,rs11771397,-1,T,A,98249398,2834,98055624,98448840,193774
7,ENSG00000164654.11,7566884,7-7492188-G-A,rs11772657,1,G,A,7492188,74696,7370276,7763492,121912
7,ENSG00000164654.11,7566884,7-7492188-G-C,rs11772657,1,G,C,7492188,74696,7370276,7763492,121912
7,ENSG00000128563.9,102396363,7-102470197-C-T,rs117742273,1,C,T,102470197,73834,102199755,102592971,270442
7,ENSG00000106003.8,2519774,7-2480654-C-A,rs117777395,1,C,A,2480654,39120,2323166,2716382,157488
7,ENSG00000146802.6,112790393,7-112671211-A-G,rs118000904,-1,A,G,112671211,119182,112593785,112987001,77426
7,ENSG00000158457.4,129144707,7-128969820-C-T,rs118038021,1,C,T,128969820,174887,128948099,129341315,21721
7,ENSG00000010270.9,38178245,7-38257544-T-A,rs11971259,1,T,A,38257544,79299,37981637,38374853,275907
7,ENSG00000010270.9,38178245,7-38257544-T-C,rs11971259,1,T,C,38257544,79299,37981637,38374853,275907
7,ENSG00000010270.9,38178245,7-38257544-T-G,rs11971259,1,T,G,38257544,79299,37981637,38374853,275907
7,ENSG00000188707.4,150322639,7-150382371-A-T,rs11981330,1,A,T,150382371,59732,150126031,150519247,256340
7,ENSG00000188707.4,150322639,7-150382371-A-G,rs11981330,1,A,G,150382371,59732,150126031,150519247,256340
7,ENSG00000135249.3,105532201,7-105640741-G-A,rs11983798,1,G,A,105640741,108540,105335593,105728809,305148
7,ENSG00000169902.8,66205334,7-66308872-C-T,rs11984115,1,C,T,66308872,103538,66008726,66401942,300146
7,ENSG00000169902.8,66205334,7-66308872-C-G,rs11984115,1,C,G,66308872,103538,66008726,66401942,300146
7,ENSG00000197362.8,149090718,7-149219535-T-C,rs1202397,-1,T,C,149219535,128817,148894110,149287326,325425
7,ENSG00000106484.8,130492085,7-130480095-C-A,rs12112550,1,C,A,130480095,11990,130295477,130688693,184618
7,ENSG00000106484.8,130492085,7-130480095-C-G,rs12112550,1,C,G,130480095,11990,130295477,130688693,184618
7,ENSG00000106013.8,118224704,7-118160679-G-A,rs12112697,1,G,A,118160679,64025,118028096,118421312,132583
7,ENSG00000106013.8,118224704,7-118160679-G-C,rs12112697,1,G,C,118160679,64025,118028096,118421312,132583
7,ENSG00000106013.8,118224704,7-118160679-G-T,rs12112697,1,G,T,118160679,64025,118028096,118421312,132583
7,ENSG00000169193.7,23597382,7-23639768-G-T,rs12154330,1,G,T,23639768,42386,23400774,23793990,238994
7,ENSG00000169193.7,23597382,7-23639768-G-A,rs12154330,1,G,A,23639768,42386,23400774,23793990,238994
7,ENSG00000213203.2,150716613,7-150688812-T-C,rs1234354,1,T,C,150688812,27801,150520005,150913221,168807
7,ENSG00000128604.13,128937927,7-129077852-G-A,rs12537284,1,G,A,129077852,139925,128741319,129134535,336533
7,ENSG00000106477.12,130441016,7-130448808-A-G,rs12538244,-1,A,G,130448808,7792,130244408,130637624,204400
7,ENSG00000242802.2,4775623,7-4720493-A-G,rs12667710,1,A,G,4720493,55130,4579015,4972231,141478
7,ENSG00000171115.3,150450630,7-150443826-T-C,rs12668210,1,T,C,150443826,6804,150254022,150647238,189804
7,ENSG00000001630.10,92134477,7-92245372-C-T,rs12704637,-1,C,T,92245372,110895,91937869,92331085,307503
7,ENSG00000106459.10,129611720,7-129791972-C-G,rs12706902,1,C,G,129791972,180252,129415112,129808328,376860
7,ENSG00000106459.10,129611720,7-129791972-C-T,rs12706902,1,C,T,129791972,180252,129415112,129808328,376860
7,ENSG00000127364.2,141776674,7-141927349-G-A,rs1285933,1,G,A,141927349,150675,141580066,141973282,347283
7,ENSG00000257093.2,141702166,7-141881525-G-T,rs1285961,-1,G,T,141881525,179359,141505558,141898774,375967
7,ENSG00000196584.2,152676141,7-152562101-C-G,rs13224868,-1,C,G,152562101,114040,152479533,152872749,82568
7,ENSG00000196584.2,152676141,7-152562101-C-T,rs13224868,-1,C,T,152562101,114040,152479533,152872749,82568
7,ENSG00000105974.7,116525036,7-116497431-A-T,rs13226307,1,A,T,116497431,27605,116328428,116721644,169003
7,ENSG00000106049.3,27662883,7-27660770-T-A,rs13227574,-1,T,A,27660770,2113,27466275,27859491,194495
7,ENSG00000106049.3,27662883,7-27660770-T-C,rs13227574,-1,T,C,27660770,2113,27466275,27859491,194495
7,ENSG00000188732.6,23680199,7-23612942-T-C,rs13227748,1,T,C,23612942,67257,23483591,23876807,129351
7,ENSG00000127946.12,75738941,7-75733069-A-G,rs13238507,-1,A,G,75733069,5872,75542333,75935549,190736
7,ENSG00000136261.10,16646181,7-16728575-T-C,rs13239334,1,T,C,16728575,82394,16449573,16842789,279002
7,ENSG00000177683.8,108569706,7-108625745-A-G,rs13242766,-1,A,G,108625745,56039,108373098,108766314,252647
7,ENSG00000127362.2,141764097,7-141602173-T-A,rs13244441,1,T,A,141602173,161924,141567489,141960705,34684
7,ENSG00000127362.2,141764097,7-141602173-T-C,rs13244441,1,T,C,141602173,161924,141567489,141960705,34684
7,ENSG00000127362.2,141764097,7-141602173-T-G,rs13244441,1,T,G,141602173,161924,141567489,141960705,34684
7,ENSG00000122786.13,134779634,7-134780866-A-G,rs1377296,1,A,G,134780866,1232,134583026,134976242,197840
7,ENSG00000122786.13,134779634,7-134780866-A-C,rs1377296,1,A,C,134780866,1232,134583026,134976242,197840
7,ENSG00000105808.11,102616756,7-102692001-C-G,rs141003853,-1,C,G,102692001,75245,102420148,102813364,271853
7,ENSG00000105808.11,102616756,7-102692001-C-T,rs141003853,-1,C,T,102692001,75245,102420148,102813364,271853
7,ENSG00000105808.11,102616756,7-102692001-C-A,rs141003853,-1,C,A,102692001,75245,102420148,102813364,271853
7,ENSG00000105887.10,135977359,7-135983515-C-G,rs1596408,-1,C,G,135983515,6156,135780751,136173967,202764
7,ENSG00000105887.10,135977359,7-135983515-C-T,rs1596408,-1,C,T,135983515,6156,135780751,136173967,202764
7,ENSG00000196511.9,144836053,7-144778502-G-A,rs1635352,-1,G,A,144778502,57551,144639445,145032661,139057
7,ENSG00000234444.3,64313961,7-64227426-C-A,rs17139384,1,C,A,64227426,86535,64117353,64510569,110073
7,ENSG00000234444.3,64313961,7-64227426-C-T,rs17139384,1,C,T,64227426,86535,64117353,64510569,110073
7,ENSG00000005483.13,105014205,7-105207306-C-A,rs17145071,1,C,A,105207306,193101,104817597,105210813,389709
7,ENSG00000186088.10,77416349,7-77439648-C-A,rs17153477,-1,C,A,77439648,23299,77219741,77612957,219907
7,ENSG00000128510.5,130293161,7-130363646-G-T,rs17164851,1,G,T,130363646,70485,130096553,130489769,267093
7,ENSG00000128510.5,130293161,7-130363646-G-A,rs17164851,1,G,A,130363646,70485,130096553,130489769,267093
7,ENSG00000205413.3,93117979,7-93288279-G-T,rs17165250,-1,G,T,93288279,170300,92921371,93314587,366908
7,ENSG00000214960.5,16421538,7-16552789-C-A,rs17169537,-1,C,A,16552789,131251,16224930,16618146,327859
7,ENSG00000196456.4,150379330,7-150339575-T-G,rs17173608,1,T,G,150339575,39755,150182722,150575938,156853
7,ENSG00000127951.5,77199819,7-77241681-T-C,rs17230010,-1,T,C,77241681,41862,77003211,77396427,238470
7,ENSG00000135269.12,116210539,7-116029378-A-C,rs17302005,1,A,C,116029378,181161,116013931,116407147,15447
7,ENSG00000135269.12,116210539,7-116029378-A-G,rs17302005,1,A,G,116029378,181161,116013931,116407147,15447
7,ENSG00000135269.12,116210539,7-116029378-A-T,rs17302005,1,A,T,116029378,181161,116013931,116407147,15447
7,ENSG00000253293.2,27174320,7-27140195-G-A,rs17437369,-1,G,A,27140195,34125,26977712,27370928,162483
7,ENSG00000253293.2,27174320,7-27140195-G-C,rs17437369,-1,G,C,27140195,34125,26977712,27370928,162483
7,ENSG00000001626.8,117480025,7-117536959-G-A,rs17449134,1,G,A,117536959,56934,117283417,117676633,253542
7,ENSG00000078053.11,38631373,7-38616158-C-G,rs17500182,-1,C,G,38616158,15215,38434765,38827981,181393
7,ENSG00000078053.11,38631373,7-38616158-C-T,rs17500182,-1,C,T,38616158,15215,38434765,38827981,181393
7,ENSG00000078053.11,38631373,7-38616158-C-A,rs17500182,-1,C,A,38616158,15215,38434765,38827981,181393
7,ENSG00000188372.9,76424950,7-76600630-C-G,rs1754182,1,C,G,76600630,175680,76228342,76621558,372288
7,ENSG00000188372.9,76424950,7-76600630-C-T,rs1754182,1,C,T,76600630,175680,76228342,76621558,372288
7,ENSG00000158623.10,130668748,7-130645454-C-T,rs17647828,-1,C,T,130645454,23294,130472140,130865356,173314
7,ENSG00000127952.11,76048000,7-75986787-G-C,rs17685,-1,G,C,75986787,61213,75851392,76244608,135395
7,ENSG00000127952.11,76048000,7-75986787-G-A,rs17685,-1,G,A,75986787,61213,75851392,76244608,135395
7,ENSG00000189077.6,75994595,7-75986787-G-C,rs17685,-1,G,C,75986787,7808,75797987,76191203,188800
7,ENSG00000189077.6,75994595,7-75986787-G-A,rs17685,-1,G,A,75986787,7808,75797987,76191203,188800
7,ENSG00000179562.2,127585596,7-127439762-G-A,rs17713208,-1,G,A,127439762,145834,127388988,127782204,50774
7,ENSG00000009335.13,157138926,7-157270582-T-G,rs17837744,1,T,G,157270582,131656,156942318,157335534,328264
7,ENSG00000106086.12,30028412,7-30143370-T-C,rs181542598,1,T,C,30143370,114958,29831804,30225020,311566
7,ENSG00000173041.7,64563071,7-64384713-A-G,rs1852108,-1,A,G,64384713,178358,64366463,64759679,18250
7,ENSG00000173041.7,64563071,7-64384713-A-T,rs1852108,-1,A,T,64384713,178358,64366463,64759679,18250
7,ENSG00000240583.5,30911853,7-30760082-G-T,rs1860510,1,G,T,30760082,151771,30715245,31108461,44837
7,ENSG00000240583.5,30911853,7-30760082-G-C,rs1860510,1,G,C,30760082,151771,30715245,31108461,44837
7,ENSG00000136274.8,45088969,7-45213058-A-G,rs1866577,-1,A,G,45213058,124089,44892361,45285577,320697
7,ENSG00000136274.8,45088969,7-45213058-A-C,rs1866577,-1,A,C,45213058,124089,44892361,45285577,320697
7,ENSG00000136274.8,45088969,7-45213058-A-T,rs1866577,-1,A,T,45213058,124089,44892361,45285577,320697
7,ENSG00000166448.10,98870014,7-99040832-G-C,rs1877913,-1,G,C,99040832,170818,98673406,99066622,367426
7,ENSG00000155530.2,134127299,7-134058640-A-G,rs1986692,1,A,G,134058640,68659,133930691,134323907,127949
7,ENSG00000197037.6,99616946,7-99748750-C-G,rs2005548,1,C,G,99748750,131804,99420338,99813554,328412
7,ENSG00000197037.6,99616946,7-99748750-C-T,rs2005548,1,C,T,99748750,131804,99420338,99813554,328412
7,ENSG00000135253.8,128910709,7-128740695-G-C,rs2060717,-1,G,C,128740695,170014,128714101,129107317,26594
7,ENSG00000135253.8,128910709,7-128740695-G-A,rs2060717,-1,G,A,128740695,170014,128714101,129107317,26594
7,ENSG00000106404.9,101237802,7-101218983-T-G,rs2074685,-1,T,G,101218983,18819,101041194,101434410,177789
7,ENSG00000106404.9,101237802,7-101218983-T-C,rs2074685,-1,T,C,101218983,18819,101041194,101434410,177789
7,ENSG00000213214.3,144195833,7-144026377-C-T,rs2189874,-1,C,T,144026377,169456,143999225,144392441,27152
7,ENSG00000213214.3,144195833,7-144026377-C-A,rs2189874,-1,C,A,144026377,169456,143999225,144392441,27152
7,ENSG00000170667.9,102517777,7-102473640-C-T,rs2229796,-1,C,T,102473640,44137,102321169,102714385,152471
7,ENSG00000170667.9,102517777,7-102473640-C-A,rs2229796,-1,C,A,102473640,44137,102321169,102714385,152471
7,ENSG00000176125.3,100889715,7-100812975-G-A,rs2230585,-1,G,A,100812975,76740,100693107,101086323,119868
7,ENSG00000078967.6,43926436,7-43878005-C-T,rs2232098,1,C,T,43878005,48431,43729828,44123044,148177
7,ENSG00000078967.6,43926436,7-43878005-C-A,rs2232098,1,C,A,43878005,48431,43729828,44123044,148177
7,ENSG00000164708.5,44065567,7-43877414-G-A,rs2232105,-1,G,A,43877414,188153,43868959,44262175,8455
7,ENSG00000105928.9,24757464,7-24722231-G-T,rs2237315,-1,G,T,24722231,35233,24560856,24954072,161375
7,ENSG00000106070.12,50782896,7-50661814-C-G,rs2237460,-1,C,G,50661814,121082,50586288,50979504,75526
7,ENSG00000106070.12,50782896,7-50661814-C-T,rs2237460,-1,C,T,50661814,121082,50586288,50979504,75526
7,ENSG00000015676.12,44490658,7-44427130-T-C,rs2240100,-1,T,C,44427130,63528,44294050,44687266,133080
7,ENSG00000015676.12,44490658,7-44427130-T-G,rs2240100,-1,T,G,44427130,63528,44294050,44687266,133080
7,ENSG00000160999.8,102286868,7-102308137-G-A,rs2242584,1,G,A,102308137,21269,102090260,102483476,217877
7,ENSG00000160999.8,102286868,7-102308137-G-T,rs2242584,1,G,T,102308137,21269,102090260,102483476,217877
7,ENSG00000164604.7,113086827,7-113095873-G-A,rs2248906,-1,G,A,113095873,9046,112890219,113283435,205654
7,ENSG00000164604.7,113086827,7-113095873-G-T,rs2248906,-1,G,T,113095873,9046,112890219,113283435,205654
7,ENSG00000146856.10,134986508,7-134993772-C-T,rs2252826,1,C,T,134993772,7264,134789900,135183116,203872
7,ENSG00000059378.7,140062951,7-139996469-G-C,rs2267706,-1,G,C,139996469,66482,139866343,140259559,130126
7,ENSG00000059378.7,140062951,7-139996469-G-A,rs2267706,-1,G,A,139996469,66482,139866343,140259559,130126
7,ENSG00000105889.10,22500188,7-22350826-C-A,rs2390633,-1,C,A,22350826,149362,22303580,22696796,47246
7,ENSG00000157800.12,140398530,7-140237437-A-G,rs2471279,-1,A,G,140237437,161093,140201922,140595138,35515
7,ENSG00000013374.10,151341812,7-151340035-C-T,rs2487149,1,C,T,151340035,1777,151145204,151538420,194831
7,ENSG00000013374.10,151341812,7-151340035-C-A,rs2487149,1,C,A,151340035,1777,151145204,151538420,194831
7,ENSG00000146833.10,99919530,7-99935555-C-T,rs2525550,-1,C,T,99935555,16025,99722922,100116138,212633
7,ENSG00000160862.8,99976031,7-99969832-C-T,rs2527923,-1,C,T,99969832,6199,99779423,100172639,190409
7,ENSG00000184903.5,111562492,7-111611393-A-C,rs2528665,-1,A,C,111611393,48901,111365884,111759100,245509
7,ENSG00000136237.12,22357154,7-22439499-G-C,rs2528845,-1,G,C,22439499,82345,22160546,22553762,278953
7,ENSG00000136237.12,22357154,7-22439499-G-A,rs2528845,-1,G,A,22439499,82345,22160546,22553762,278953
7,ENSG00000146535.8,2844308,7-2795235-C-T,rs2533886,-1,C,T,2795235,49073,2647700,3040916,147535
7,ENSG00000106105.9,30594878,7-30724436-A-G,rs255155,1,A,G,30724436,129558,30398270,30791486,326166
7,ENSG00000106125.14,30771417,7-30741045-T-C,rs255173,1,T,C,30741045,30372,30574809,30968025,166236
7,ENSG00000106125.14,30771417,7-30741045-T-G,rs255173,1,T,G,30741045,30372,30574809,30968025,166236
7,ENSG00000106125.14,30771417,7-30741045-T-A,rs255173,1,T,A,30741045,30372,30574809,30968025,166236
7,ENSG00000106624.4,44104345,7-44105422-A-G,rs2595705,1,A,G,44105422,1077,43907737,44300953,197685
7,ENSG00000106624.4,44104345,7-44105422-A-C,rs2595705,1,A,C,44105422,1077,43907737,44300953,197685
7,ENSG00000106624.4,44104345,7-44105422-A-T,rs2595705,1,A,T,44105422,1077,43907737,44300953,197685
7,ENSG00000105875.9,135211526,7-135206590-T-A,rs292595,-1,T,A,135206590,4936,135014918,135408134,191672
7,ENSG00000105875.9,135211526,7-135206590-T-C,rs292595,-1,T,C,135206590,4936,135014918,135408134,191672
7,ENSG00000136205.11,47582111,7-47485200-A-G,rs2941542,-1,A,G,47485200,96911,47385503,47778719,99697
7,ENSG00000136205.11,47582111,7-47485200-A-C,rs2941542,-1,A,C,47485200,96911,47385503,47778719,99697
7,ENSG00000136205.11,47582111,7-47485200-A-T,rs2941542,-1,A,T,47485200,96911,47385503,47778719,99697
7,ENSG00000090266.7,140696708,7-140682356-T-C,rs2968553,1,T,C,140682356,14352,140500100,140893316,182256
7,ENSG00000146830.7,100694250,7-100797381-G-C,rs314344,-1,G,C,100797381,103131,100497642,100890858,299739
7,ENSG00000196411.5,100827523,7-100803648-T-A,rs314348,-1,T,A,100803648,23875,100630915,101024131,172733
7,ENSG00000196411.5,100827523,7-100803648-T-G,rs314348,-1,T,G,100803648,23875,100630915,101024131,172733
7,ENSG00000196411.5,100827523,7-100803648-T-C,rs314348,-1,T,C,100803648,23875,100630915,101024131,172733
7,ENSG00000178826.6,143284958,7-143289805-T-G,rs3181166,1,T,G,143289805,4847,143088350,143481566,201455
7,ENSG00000197461.8,519409,7-579301-A-G,rs3211362,-1,A,G,579301,59892,322801,716017,256500
7,ENSG00000197461.8,519409,7-579301-A-T,rs3211362,-1,A,T,579301,59892,322801,716017,256500
7,ENSG00000070882.8,24980178,7-25168344-G-T,rs3213642,-1,G,T,25168344,188166,24783570,25176786,384774
7,ENSG00000070882.8,24980178,7-25168344-G-A,rs3213642,-1,G,A,25168344,188166,24783570,25176786,384774
7,ENSG00000135211.5,77798434,7-77918551-C-T,rs34236870,-1,C,T,77918551,120117,77601826,77995042,316725
7,ENSG00000127993.9,92528795,7-92503630-A-G,rs34418960,1,A,G,92503630,25165,92332187,92725403,171443
7,ENSG00000241258.2,66114847,7-65938222-A-G,rs34529418,1,A,G,65938222,176625,65918239,66311455,19983
7,ENSG00000001629.5,92245974,7-92072960-G-A,rs34581834,1,G,A,92072960,173014,92049366,92442582,23594
7,ENSG00000106330.6,100612540,7-100607979-G-A,rs35142716,1,G,A,100607979,4561,100415932,100809148,192047
7,ENSG00000106330.6,100612540,7-100607979-G-T,rs35142716,1,G,T,100607979,4561,100415932,100809148,192047
7,ENSG00000196652.6,99504662,7-99459718-T-G,rs35296070,1,T,G,99459718,44944,99308054,99701270,151664
7,ENSG00000196652.6,99504662,7-99459718-T-C,rs35296070,1,T,C,99459718,44944,99308054,99701270,151664
7,ENSG00000133619.13,149714951,7-149592373-G-A,rs354033,1,G,A,149592373,122578,149518343,149911559,74030
7,ENSG00000196453.6,149461062,7-149600013-A-G,rs354042,-1,A,G,149600013,138951,149264454,149657670,335559
7,ENSG00000221838.5,100101643,7-100017147-T-C,rs35414630,1,T,C,100017147,84496,99905035,100298251,112112
7,ENSG00000205482.7,77062558,7-77222354-C-A,rs36035520,-1,C,A,77222354,159796,76865950,77259166,356404
7,ENSG00000091127.8,105522271,7-105500561-G-C,rs3735368,-1,G,C,105500561,21710,105325663,105718879,174898
7,ENSG00000091127.8,105522271,7-105500561-G-A,rs3735368,-1,G,A,105500561,21710,105325663,105718879,174898
7,ENSG00000091127.8,105522271,7-105500561-G-T,rs3735368,-1,G,T,105500561,21710,105325663,105718879,174898
7,ENSG00000157999.5,6031376,7-6144205-A-G,rs3750063,1,A,G,6144205,112829,5834768,6227984,309437
7,ENSG00000157999.5,6031376,7-6144205-A-T,rs3750063,1,A,T,6144205,112829,5834768,6227984,309437
7,ENSG00000106415.8,7968796,7-7964091-C-G,rs37963,1,C,G,7964091,4705,7772188,8165404,191903
7,ENSG00000158516.7,130266863,7-130294379-T-C,rs3807344,1,T,C,130294379,27516,130070255,130463471,224124
7,ENSG00000158516.7,130266863,7-130294379-T-A,rs3807344,1,T,A,130294379,27516,130070255,130463471,224124
7,ENSG00000106100.6,30478784,7-30460345-T-C,rs3823773,-1,T,C,30460345,18439,30282176,30675392,178169
7,ENSG00000164849.6,1044546,7-984945-T-A,rs3824081,1,T,A,984945,59601,847938,1241154,137007
7,ENSG00000164849.6,1044546,7-984945-T-C,rs3824081,1,T,C,984945,59601,847938,1241154,137007
7,ENSG00000164849.6,1044546,7-984945-T-G,rs3824081,1,T,G,984945,59601,847938,1241154,137007
7,ENSG00000105976.9,116672196,7-116755203-C-G,rs38860,1,C,G,116755203,83007,116475588,116868804,279615
7,ENSG00000105976.9,116672196,7-116755203-C-T,rs38860,1,C,T,116755203,83007,116475588,116868804,279615
7,ENSG00000146707.9,76627279,7-76690731-T-C,rs3960530,-1,T,C,76690731,63452,76430671,76823887,260060
7,ENSG00000128567.11,131556628,7-131687292-C-T,rs4076265,-1,C,T,131687292,130664,131360020,131753236,327272
7,ENSG00000171130.11,149873969,7-149884188-C-A,rs4077894,1,C,A,149884188,10219,149677361,150070577,206827
7,ENSG00000105825.7,93890753,7-94059271-C-T,rs41529,-1,C,T,94059271,168518,93694145,94087361,365126
7,ENSG00000105825.7,93890753,7-94059271-C-G,rs41529,-1,C,G,94059271,168518,93694145,94087361,365126
7,ENSG00000127920.4,93921735,7-94059652-A-G,rs41532,1,A,G,94059652,137917,93725127,94118343,334525
7,ENSG00000214309.3,100126967,7-100008238-T-A,rs4216,1,T,A,100008238,118729,99930359,100323575,77879
7,ENSG00000214309.3,100126967,7-100008238-T-C,rs4216,1,T,C,100008238,118729,99930359,100323575,77879
7,ENSG00000164815.6,104208013,7-104229706-T-A,rs4265124,-1,T,A,104229706,21693,104011405,104404621,218301
7,ENSG00000164815.6,104208013,7-104229706-T-G,rs4265124,-1,T,G,104229706,21693,104011405,104404621,218301
7,ENSG00000133574.4,150567390,7-150509274-G-A,rs4272282,1,G,A,150509274,58116,150370782,150763998,138492
7,ENSG00000071189.15,17940494,7-17943674-G-T,rs4543441,-1,G,T,17943674,3180,17743886,18137102,199788
7,ENSG00000071189.15,17940494,7-17943674-G-A,rs4543441,-1,G,A,17943674,3180,17743886,18137102,199788
7,ENSG00000197343.5,99558642,7-99735325-T-G,rs45446698,1,T,G,99735325,176683,99362034,99755250,373291
7,ENSG00000106351.8,100539203,7-100413147-C-T,rs4596570,1,C,T,100413147,126056,100342595,100735811,70552
7,ENSG00000164715.5,98106862,7-98262148-A-C,rs4604367,1,A,C,98262148,155286,97910254,98303470,351894
7,ENSG00000164715.5,98106862,7-98262148-A-G,rs4604367,1,A,G,98262148,155286,97910254,98303470,351894
7,ENSG00000164715.5,98106862,7-98262148-A-T,rs4604367,1,A,T,98262148,155286,97910254,98303470,351894
7,ENSG00000188191.8,727281,7-808560-T-C,rs4719437,-1,T,C,808560,81279,530673,923889,277887
7,ENSG00000188191.8,727281,7-808560-T-A,rs4719437,-1,T,A,808560,81279,530673,923889,277887
7,ENSG00000188191.8,727281,7-808560-T-G,rs4719437,-1,T,G,808560,81279,530673,923889,277887
7,ENSG00000215045.4,6551461,7-6562061-A-C,rs4724823,-1,A,C,6562061,10600,6354853,6748069,207208
7,ENSG00000215045.4,6551461,7-6562061-A-T,rs4724823,-1,A,T,6562061,10600,6354853,6748069,207208
7,ENSG00000127399.10,150323355,7-150395596-C-T,rs4725889,1,C,T,150395596,72241,150126747,150519963,268849
7,ENSG00000127399.10,150323355,7-150395596-C-A,rs4725889,1,C,A,150395596,72241,150126747,150519963,268849
7,ENSG00000127399.10,150323355,7-150395596-C-G,rs4725889,1,C,G,150395596,72241,150126747,150519963,268849
7,ENSG00000166529.9,100049774,7-100041777-C-A,rs4727445,1,C,A,100041777,7997,99853166,100246382,188611
7,ENSG00000166529.9,100049774,7-100041777-C-G,rs4727445,1,C,G,100041777,7997,99853166,100246382,188611
7,ENSG00000166529.9,100049774,7-100041777-C-T,rs4727445,1,C,T,100041777,7997,99853166,100246382,188611
7,ENSG00000004864.8,96322098,7-96290387-C-A,rs4729249,-1,C,A,96290387,31711,96125490,96518706,164897
7,ENSG00000105948.9,139133778,7-139325914-C-T,rs4732365,1,C,T,139325914,192136,138937170,139330386,388744
7,ENSG00000132436.7,50450350,7-50426883-T-A,rs4947410,-1,T,A,50426883,23467,50253742,50646958,173141
7,ENSG00000132436.7,50450350,7-50426883-T-C,rs4947410,-1,T,C,50426883,23467,50253742,50646958,173141
7,ENSG00000146530.6,12403865,7-12531967-C-T,rs55845368,-1,C,T,12531967,128102,12207257,12600473,324710
7,ENSG00000005075.11,102478922,7-102462847-G-A,rs56208004,-1,G,A,102462847,16075,102282314,102675530,180533
7,ENSG00000005075.11,102478922,7-102462847-G-C,rs56208004,-1,G,C,102462847,16075,102282314,102675530,180533
7,ENSG00000196937.5,121396308,7-121377420-C-A,rs56364616,-1,C,A,121377420,18888,121199700,121592916,177720
7,ENSG00000006625.11,30504829,7-30497598-C-T,rs57379358,-1,C,T,30497598,7231,30308221,30701437,189377
7,ENSG00000019991.10,81770047,7-81751879-G-A,rs5745647,-1,G,A,81751879,18168,81573439,81966655,178440
7,ENSG00000165171.6,73842516,7-73865031-C-T,rs61742124,-1,C,T,73865031,22515,73645908,74039124,219123
7,ENSG00000239857.1,876554,7-997430-G-A,rs62433132,1,G,A,997430,120876,679946,1073162,317484
7,ENSG00000105926.9,24573452,7-24590782-C-G,rs62449807,1,C,G,24590782,17330,24376844,24770060,213938
7,ENSG00000105926.9,24573452,7-24590782-C-A,rs62449807,1,C,A,24590782,17330,24376844,24770060,213938
7,ENSG00000105926.9,24573452,7-24590782-C-T,rs62449807,1,C,T,24590782,17330,24376844,24770060,213938
7,ENSG00000008311.10,122144249,7-122311395-T-C,rs62476009,-1,T,C,122311395,167146,121947641,122340857,363754
7,ENSG00000196335.8,23710219,7-23625053-G-A,rs6461718,1,G,A,23625053,85166,23513611,23906827,111442
7,ENSG00000196335.8,23710219,7-23625053-G-T,rs6461718,1,G,T,23625053,85166,23513611,23906827,111442
7,ENSG00000221970.1,144312419,7-144144679-C-T,rs6464580,1,C,T,144144679,167740,144115811,144509027,28868
7,ENSG00000212807.1,144239605,7-144144679-C-T,rs6464580,-1,C,T,144144679,94926,144042997,144436213,101682
7,ENSG00000106665.10,74289407,7-74293414-T-A,rs66501245,1,T,A,74293414,4007,74092799,74486015,200615
7,ENSG00000106665.10,74289407,7-74293414-T-C,rs66501245,1,T,C,74293414,4007,74092799,74486015,200615
7,ENSG00000164746.9,48035543,7-47934519-G-A,rs67540717,1,G,A,47934519,101024,47838935,48232151,95584
7,ENSG00000128607.8,130070534,7-130016325-G-C,rs6942507,1,G,C,130016325,54209,129873926,130267142,142399
7,ENSG00000105851.6,106865282,7-106753257-G-A,rs6943210,1,G,A,106753257,112025,106668674,107061890,84583
7,ENSG00000105851.6,106865282,7-106753257-G-C,rs6943210,1,G,C,106753257,112025,106668674,107061890,84583
7,ENSG00000158683.3,47948466,7-47775331-T-C,rs6949512,-1,T,C,47775331,173135,47751858,48145074,23473
7,ENSG00000158683.3,47948466,7-47775331-T-A,rs6949512,-1,T,A,47775331,173135,47751858,48145074,23473
7,ENSG00000005469.7,87345664,7-87256366-A-T,rs6950458,1,A,T,87256366,89298,87149056,87542272,107310
7,ENSG00000005469.7,87345664,7-87256366-A-G,rs6950458,1,A,G,87256366,89298,87149056,87542272,107310
7,ENSG00000005249.6,107044705,7-107010095-T-C,rs6954575,1,T,C,107010095,34610,106848097,107241313,161998
7,ENSG00000105963.7,954680,7-931488-G-C,rs6956301,-1,G,C,931488,23192,758072,1151288,173416
7,ENSG00000105963.7,954680,7-931488-G-A,rs6956301,-1,G,A,931488,23192,758072,1151288,173416
7,ENSG00000146700.8,76409697,7-76322586-A-G,rs6961529,-1,A,G,76322586,87111,76213089,76606305,109497
7,ENSG00000136240.5,6484152,7-6481045-T-C,rs6964421,-1,T,C,6481045,3107,6287544,6680760,193501
7,ENSG00000136240.5,6484152,7-6481045-T-G,rs6964421,-1,T,G,6481045,3107,6287544,6680760,193501
7,ENSG00000106366.5,101127104,7-101084131-C-T,rs6968929,1,C,T,101084131,42973,100930496,101323712,153635
7,ENSG00000106366.5,101127104,7-101084131-C-A,rs6968929,1,C,A,101084131,42973,100930496,101323712,153635
7,ENSG00000205277.5,100969565,7-101019688-G-A,rs6973913,1,G,A,101019688,50123,100772957,101166173,246731
7,ENSG00000009954.6,73522293,7-73652627-A-G,rs6974424,-1,A,G,73652627,130334,73325685,73718901,326942
7,ENSG00000198742.5,99144108,7-99157649-G-T,rs6975245,-1,G,T,99157649,13541,98947500,99340716,210149
7,ENSG00000196262.8,44796681,7-44851384-G-A,rs6975896,1,G,A,44851384,54703,44600073,44993289,251311
7,ENSG00000122778.5,138981389,7-138983042-A-G,rs6977460,-1,A,G,138983042,1653,138784781,139177997,198261
7,ENSG00000106344.3,128343908,7-128276155-G-A,rs6979784,-1,G,A,128276155,67753,128147300,128540516,128855
7,ENSG00000106526.6,150323545,7-150274924-G-A,rs71537924,-1,G,A,150274924,48621,150126937,150520153,147987
7,ENSG00000086300.11,26291862,7-26350495-C-T,rs73068463,1,C,T,26350495,58633,26095254,26488470,255241
7,ENSG00000006704.6,74453906,7-74573075-G-A,rs73137109,1,G,A,74573075,119169,74257298,74650514,315777
7,ENSG00000218305.2,48924547,7-49045218-C-T,rs73697914,1,C,T,49045218,120671,48727939,49121155,317279
7,ENSG00000106460.13,12211294,7-12261960-A-G,rs7457114,1,A,G,12261960,50666,12014686,12407902,247274
7,ENSG00000129103.13,56064286,7-56257428-C-T,rs74834148,1,C,T,56257428,193142,55867678,56260894,389750
7,ENSG00000106603.12,43729523,7-43846250-T-C,rs757859,-1,T,C,43846250,116727,43532915,43926131,313335
7,ENSG00000106603.12,43729523,7-43846250-T-G,rs757859,-1,T,G,43846250,116727,43532915,43926131,313335
7,ENSG00000106603.12,43729523,7-43846250-T-A,rs757859,-1,T,A,43846250,116727,43532915,43926131,313335
7,ENSG00000122644.8,12687633,7-12750510-G-A,rs75912994,1,G,A,12750510,62877,12491025,12884241,259485
7,ENSG00000106571.8,42237209,7-42197922-G-A,rs76257295,-1,G,A,42197922,39287,42040601,42433817,157321
7,ENSG00000106571.8,42237209,7-42197922-G-T,rs76257295,-1,G,T,42197922,39287,42040601,42433817,157321
7,ENSG00000106009.11,2555524,7-2542447-G-A,rs77542618,-1,G,A,2542447,13077,2358916,2752132,183531
7,ENSG00000136270.9,45111697,7-45084409-T-C,rs7777835,-1,T,C,45084409,27288,44915089,45308305,169320
7,ENSG00000136270.9,45111697,7-45084409-T-G,rs7777835,-1,T,G,45084409,27288,44915089,45308305,169320
7,ENSG00000008282.3,106112312,7-106175956-G-A,rs7778888,-1,G,A,106175956,63644,105915704,106308920,260252
7,ENSG00000170027.4,76358991,7-76346269-C-G,rs7779014,-1,C,G,76346269,12722,76162383,76555599,183886
7,ENSG00000170027.4,76358991,7-76346269-C-T,rs7779014,-1,C,T,76346269,12722,76162383,76555599,183886
7,ENSG00000106392.5,7182544,7-7210818-A-T,rs7780273,1,A,T,7210818,28274,6985936,7379152,224882
7,ENSG00000106392.5,7182544,7-7210818-A-C,rs7780273,1,A,C,7210818,28274,6985936,7379152,224882
7,ENSG00000002745.7,121329000,7-121325598-C-T,rs7782648,1,C,T,121325598,3402,121132392,121525608,193206
7,ENSG00000164896.13,151080809,7-151172350-T-C,rs7782650,-1,T,C,151172350,91541,150884201,151277417,288149
7,ENSG00000122674.8,5898733,7-5890035-T-C,rs7789795,1,T,C,5890035,8698,5702125,6095341,187910
7,ENSG00000087085.8,100895888,7-100848613-G-A,rs7794532,-1,G,A,100848613,47275,100699280,101092496,149333
7,ENSG00000164603.6,112939875,7-112928847-T-G,rs7794808,-1,T,G,112928847,11028,112743267,113136483,185580
7,ENSG00000136280.10,45000201,7-45128232-C-T,rs7799075,1,C,T,45128232,128031,44803593,45196809,324639
7,ENSG00000128596.11,128791968,7-128810478-G-A,rs7799186,1,G,A,128810478,18510,128595360,128988576,215118
7,ENSG00000136235.10,23246775,7-23220969-G-T,rs7807879,1,G,T,23220969,25806,23050167,23443383,170802
7,ENSG00000157778.4,1570032,7-1556560-A-G,rs7811444,-1,A,G,1556560,13472,1373424,1766640,183136
7,ENSG00000227471.3,134549110,7-134546863-A-G,rs7811759,1,A,G,134546863,2247,134352502,134745718,194361
7,ENSG00000227471.3,134549110,7-134546863-A-T,rs7811759,1,A,T,134546863,2247,134352502,134745718,194361
7,ENSG00000126870.11,158856558,7-158871562-G-A,rs78313003,1,G,A,158871562,15004,158659950,159053166,211612
7,ENSG00000146733.9,56051444,7-55903760-T-C,rs78485977,-1,T,C,55903760,147684,55854836,56248052,48924
7,ENSG00000164916.7,4682295,7-4822540-G-A,rs79575100,1,G,A,4822540,140245,4485687,4878903,336853
7,ENSG00000261115.1,141074064,7-141102530-A-G,rs79587754,1,A,G,141102530,28466,140877456,141270672,225074
7,ENSG00000157764.7,140924929,7-141028275-T-A,rs801127,-1,T,A,141028275,103346,140728321,141121537,299954
7,ENSG00000157764.7,140924929,7-141028275-T-C,rs801127,-1,T,C,141028275,103346,140728321,141121537,299954
7,ENSG00000157764.7,140924929,7-141028275-T-G,rs801127,-1,T,G,141028275,103346,140728321,141121537,299954
7,ENSG00000154710.9,66740733,7-66567968-G-A,rs801191,1,G,A,66567968,172765,66544125,66937341,23843
7,ENSG00000055130.9,148698903,7-148632290-G-C,rs80284586,1,G,C,148632290,66613,148502295,148895511,129995
7,ENSG00000055130.9,148698903,7-148632290-G-T,rs80284586,1,G,T,148632290,66613,148502295,148895511,129995
7,ENSG00000136238.13,6374527,7-6399287-G-T,rs836547,1,G,T,6399287,24760,6177919,6571135,221368
7,ENSG00000136238.13,6374527,7-6399287-G-A,rs836547,1,G,A,6399287,24760,6177919,6571135,221368
7,ENSG00000122512.9,6009049,7-6070185-C-T,rs852144,-1,C,T,6070185,61136,5812441,6205657,257744
7,ENSG00000086232.7,6059175,7-6070185-C-T,rs852144,-1,C,T,6070185,11010,5862567,6255783,207618
7,ENSG00000075618.11,5592816,7-5681817-G-A,rs852394,1,G,A,5681817,89001,5396208,5789424,285609
7,ENSG00000075618.11,5592816,7-5681817-G-C,rs852394,1,G,C,5681817,89001,5396208,5789424,285609
7,ENSG00000106635.3,73557690,7-73712768-G-A,rs875342,-1,G,A,73712768,155078,73361082,73754298,351686
7,ENSG00000181220.10,149497809,7-149546528-C-T,rs886710,-1,C,T,149546528,48719,149301201,149694417,245327
7,ENSG00000146674.8,45921272,7-45917370-T-G,rs9282734,-1,T,G,45917370,3902,45724664,46117880,192706
7,ENSG00000188186.6,100148918,7-100080868-A-G,rs941289,1,A,G,100080868,68050,99952310,100345526,128558
7,ENSG00000071462.7,73683597,7-73672716-A-G,rs941297,1,A,G,73672716,10881,73486989,73880205,185727
7,ENSG00000106263.12,2354827,7-2360671-T-G,rs953770,1,T,G,2360671,5844,2158219,2551435,202452
7,ENSG00000106263.12,2354827,7-2360671-T-C,rs953770,1,T,C,2360671,5844,2158219,2551435,202452
7,ENSG00000198039.7,64903273,7-64920491-C-T,rs9638210,1,C,T,64920491,17218,64706665,65099881,213826
7,ENSG00000105971.9,116499738,7-116469859-C-A,rs9640770,1,C,A,116469859,29879,116303130,116696346,166729
7,ENSG00000105971.9,116499738,7-116469859-C-T,rs9640770,1,C,T,116469859,29879,116303130,116696346,166729
7,ENSG00000155026.10,5967204,7-6134748-G-C,rs9648587,-1,G,C,6134748,167544,5770596,6163812,364152
7,ENSG00000155026.10,5967204,7-6134748-G-A,rs9648587,-1,G,A,6134748,167544,5770596,6163812,364152
7,ENSG00000106605.6,43758680,7-43580584-G-C,rs9690115,1,G,C,43580584,178096,43562072,43955288,18512
7,ENSG00000205060.6,134316930,7-134155208-A-G,rs997316,-1,A,G,134155208,161722,134120322,134513538,34886
7,ENSG00000205060.6,134316930,7-134155208-A-T,rs997316,-1,A,T,134155208,161722,134120322,134513538,34886
7,ENSG00000106636.3,44200978,7-44223857-T-A,rs1003573,1,T,A,44223857,22879,44004370,44397586,219487
7,ENSG00000106636.3,44200978,7-44223857-T-C,rs1003573,1,T,C,44223857,22879,44004370,44397586,219487
7,ENSG00000133612.13,151086475,7-151069651-T-C,rs10155938,1,T,C,151069651,16824,150889867,151283083,179784
7,ENSG00000133612.13,151086475,7-151069651-T-A,rs10155938,1,T,A,151069651,16824,150889867,151283083,179784
7,ENSG00000133612.13,151086475,7-151069651-T-G,rs10155938,1,T,G,151069651,16824,150889867,151283083,179784
7,ENSG00000077800.7,73328161,7-73506195-T-C,rs10215838,1,T,C,73506195,178034,73131553,73524769,374642
7,ENSG00000077800.7,73328161,7-73506195-T-A,rs10215838,1,T,A,73506195,178034,73131553,73524769,374642
7,ENSG00000244219.1,99598267,7-99534170-A-T,rs10231948,1,A,T,99534170,64097,99401659,99794875,132511
7,ENSG00000127952.11,76048000,7-76144142-G-A,rs10235738,-1,G,A,76144142,96142,75851392,76244608,292750
7,ENSG00000196262.8,44796681,7-44666381-C-T,rs10247064,1,C,T,44666381,130300,44600073,44993289,66308
7,ENSG00000105887.10,135977359,7-136006832-G-A,rs10249387,-1,G,A,136006832,29473,135780751,136173967,226081
7,ENSG00000048052.15,18495749,7-18674411-C-A,rs10254059,1,C,A,18674411,178662,18299141,18692357,375270
7,ENSG00000048052.15,18495749,7-18674411-C-T,rs10254059,1,C,T,18674411,178662,18299141,18692357,375270
7,ENSG00000106399.7,7718607,7-7873680-T-C,rs10255556,-1,T,C,7873680,155073,7521999,7915215,351681
7,ENSG00000131558.8,133253078,7-133271427-G-A,rs10263196,1,G,A,133271427,18349,133056470,133449686,214957
7,ENSG00000178381.7,1160196,7-1132882-C-A,rs10265758,-1,C,A,1132882,27314,963588,1356804,169294
7,ENSG00000178381.7,1160196,7-1132882-C-T,rs10265758,-1,C,T,1132882,27314,963588,1356804,169294
7,ENSG00000004866.13,116953501,7-117140329-T-C,rs10269381,1,T,C,117140329,186828,116756893,117150109,383436
7,ENSG00000136270.9,45111697,7-45037041-C-A,rs10271136,-1,C,A,45037041,74656,44915089,45308305,121952
7,ENSG00000127948.9,75915155,7-75899819-C-T,rs10280802,1,C,T,75899819,15336,75718547,76111763,181272
7,ENSG00000179144.4,150514872,7-150624419-T-C,rs10280903,1,T,C,150624419,109547,150318264,150711480,306155
7,ENSG00000146918.13,158704804,7-158662735-C-T,rs10282082,-1,C,T,158662735,42069,158508196,158901412,154539
7,ENSG00000157741.9,139231237,7-139324124-C-T,rs10282119,1,C,T,139324124,92887,139034629,139427845,289495
7,ENSG00000157741.9,139231237,7-139324124-C-G,rs10282119,1,C,G,139324124,92887,139034629,139427845,289495
7,ENSG00000186591.7,129952960,7-129818187-C-G,rs10480805,-1,C,G,129818187,134773,129756352,130149568,61835
7,ENSG00000186591.7,129952960,7-129818187-C-T,rs10480805,-1,C,T,129818187,134773,129756352,130149568,61835
7,ENSG00000077063.6,117873441,7-117897603-A-G,rs10487379,-1,A,G,117897603,24162,117676833,118070049,220770
7,ENSG00000106392.5,7182544,7-7237632-G-T,rs10487590,1,G,T,7237632,55088,6985936,7379152,251696
7,ENSG00000106392.5,7182544,7-7237632-G-A,rs10487590,1,G,A,7237632,55088,6985936,7379152,251696
7,ENSG00000132436.7,50450350,7-50550906-T-C,rs10499695,-1,T,C,50550906,100556,50253742,50646958,297164
7,ENSG00000132436.7,50450350,7-50550906-T-A,rs10499695,-1,T,A,50550906,100556,50253742,50646958,297164
7,ENSG00000164880.11,1504389,7-1483213-G-A,rs10807961,-1,G,A,1483213,21176,1307781,1700997,175432
7,ENSG00000171130.11,149873969,7-149886081-C-T,rs10807976,1,C,T,149886081,12112,149677361,150070577,208720
7,ENSG00000171130.11,149873969,7-149886081-C-A,rs10807976,1,C,A,149886081,12112,149677361,150070577,208720
7,ENSG00000059378.7,140062951,7-140064194-G-A,rs10808024,-1,G,A,140064194,1243,139866343,140259559,197851
7,ENSG00000059378.7,140062951,7-140064194-G-T,rs10808024,-1,G,T,140064194,1243,139866343,140259559,197851
7,ENSG00000059378.7,140062951,7-140064194-G-C,rs10808024,-1,G,C,140064194,1243,139866343,140259559,197851
7,ENSG00000005469.7,87345664,7-87299266-C-T,rs1089522,1,C,T,87299266,46398,87149056,87542272,150210
7,ENSG00000177409.6,93148385,7-93052506-A-T,rs10953084,-1,A,T,93052506,95879,92951777,93344993,100729
7,ENSG00000177409.6,93148385,7-93052506-A-C,rs10953084,-1,A,C,93052506,95879,92951777,93344993,100729
7,ENSG00000177409.6,93148385,7-93052506-A-G,rs10953084,-1,A,G,93052506,95879,92951777,93344993,100729
7,ENSG00000205277.5,100969565,7-100966246-C-G,rs111373354,1,C,G,100966246,3319,100772957,101166173,193289
7,ENSG00000090266.7,140696708,7-140634330-A-G,rs111752385,1,A,G,140634330,62378,140500100,140893316,134230
7,ENSG00000105825.7,93890753,7-93915044-T-C,rs112031384,-1,T,C,93915044,24291,93694145,94087361,220899
7,ENSG00000164649.15,21945899,7-21934266-T-C,rs113567904,-1,T,C,21934266,11633,21749291,22142507,184975
7,ENSG00000221838.5,100101643,7-100057066-G-A,rs11558476,1,G,A,100057066,44577,99905035,100298251,152031
7,ENSG00000221838.5,100101643,7-100057066-G-T,rs11558476,1,G,T,100057066,44577,99905035,100298251,152031
7,ENSG00000010270.9,38178245,7-38192491-C-T,rs11561858,1,C,T,38192491,14246,37981637,38374853,210854
7,ENSG00000105793.10,90346716,7-90521720-A-C,rs11563419,1,A,C,90521720,175004,90150108,90543324,371612
7,ENSG00000105793.10,90346716,7-90521720-A-G,rs11563419,1,A,G,90521720,175004,90150108,90543324,371612
7,ENSG00000214194.4,113118554,7-113020345-C-T,rs117201467,-1,C,T,113020345,98209,112921946,113315162,98399
7,ENSG00000106565.12,150800364,7-150986933-G-A,rs117564322,-1,G,A,150986933,186569,150603756,150996972,383177
7,ENSG00000105855.4,20330900,7-20351760-C-A,rs11762117,1,C,A,20351760,20860,20134292,20527508,217468
7,ENSG00000106367.9,101154476,7-100990546-C-A,rs11762738,1,C,A,100990546,163930,100957868,101351084,32678
7,ENSG00000164692.12,94394895,7-94362483-C-T,rs11762862,1,C,T,94362483,32412,94198287,94591503,164196
7,ENSG00000106477.12,130441016,7-130364917-A-G,rs11767377,-1,A,G,130364917,76099,130244408,130637624,120509
7,ENSG00000133606.5,140479505,7-140635770-C-T,rs11767611,-1,C,T,140635770,156265,140282897,140676113,352873
7,ENSG00000133606.5,140479505,7-140635770-C-A,rs11767611,-1,C,A,140635770,156265,140282897,140676113,352873
7,ENSG00000106603.12,43729523,7-43738827-T-C,rs11768924,-1,T,C,43738827,9304,43532915,43926131,205912
7,ENSG00000164542.8,36367240,7-36171501-A-G,rs11769392,-1,A,G,36171501,195739,36170632,36563848,869
7,ENSG00000164659.10,87059654,7-87236899-A-G,rs11771665,-1,A,G,87236899,177245,86863046,87256262,373853
7,ENSG00000185055.6,105581493,7-105462925-C-G,rs11771875,-1,C,G,105462925,118568,105384885,105778101,78040
7,ENSG00000186480.8,155297878,7-155302883-G-T,rs11772189,1,G,T,155302883,5005,155101270,155494486,201613
7,ENSG00000186480.8,155297878,7-155302883-G-A,rs11772189,1,G,A,155302883,5005,155101270,155494486,201613
7,ENSG00000186088.10,77416349,7-77429703-A-G,rs11772368,-1,A,G,77429703,13354,77219741,77612957,209962
7,ENSG00000136197.6,42912070,7-42789916-T-C,rs117840025,-1,T,C,42789916,122154,42715462,43108678,74454
7,ENSG00000128513.8,124929825,7-125053836-C-T,rs117847010,-1,C,T,125053836,124011,124733217,125126433,320619
7,ENSG00000127946.12,75738941,7-75634447-T-C,rs1179632,-1,T,C,75634447,104494,75542333,75935549,92114
7,ENSG00000127946.12,75738941,7-75634447-T-G,rs1179632,-1,T,G,75634447,104494,75542333,75935549,92114
7,ENSG00000127946.12,75738941,7-75634447-T-A,rs1179632,-1,T,A,75634447,104494,75542333,75935549,92114
7,ENSG00000128564.4,101165569,7-101121224-T-C,rs117963972,-1,T,C,101121224,44345,100968961,101362177,152263
7,ENSG00000090263.10,141014952,7-140990752-T-G,rs118102967,-1,T,G,140990752,24200,140818344,141211560,172408
7,ENSG00000146535.8,2844308,7-2873445-T-C,rs1182142,-1,T,C,2873445,29137,2647700,3040916,225745
7,ENSG00000002746.8,43112647,7-43287021-G-A,rs11978433,1,G,A,43287021,174374,42916039,43309255,370982
7,ENSG00000153790.7,25180354,7-25179272-C-T,rs11980216,-1,C,T,25179272,1082,24983746,25376962,195526
7,ENSG00000106526.6,150323545,7-150382371-A-G,rs11981330,-1,A,G,150382371,58826,150126937,150520153,255434
7,ENSG00000106526.6,150323545,7-150382371-A-T,rs11981330,-1,A,T,150382371,58826,150126937,150520153,255434
7,ENSG00000204947.4,149126324,7-149191951-C-G,rs1202470,-1,C,G,149191951,65627,148929716,149322932,262235
7,ENSG00000204947.4,149126324,7-149191951-C-T,rs1202470,-1,C,T,149191951,65627,148929716,149322932,262235
7,ENSG00000158623.10,130668748,7-130480095-C-A,rs12112550,-1,C,A,130480095,188653,130472140,130865356,7955
7,ENSG00000158623.10,130668748,7-130480095-C-G,rs12112550,-1,C,G,130480095,188653,130472140,130865356,7955
7,ENSG00000164849.6,1044546,7-923196-T-C,rs12381369,1,T,C,923196,121350,847938,1241154,75258
7,ENSG00000130429.7,99374730,7-99412355-T-C,rs12531852,1,T,C,99412355,37625,99178122,99571338,234233
7,ENSG00000106004.4,27143681,7-27289554-C-G,rs12535894,-1,C,G,27289554,145873,26947073,27340289,342481
7,ENSG00000136238.13,6374527,7-6396270-G-A,rs12536544,1,G,A,6396270,21743,6177919,6571135,218351
7,ENSG00000212807.1,144239605,7-144435635-A-T,rs12666210,-1,A,T,144435635,196030,144042997,144436213,392638
7,ENSG00000212807.1,144239605,7-144435635-A-C,rs12666210,-1,A,C,144435635,196030,144042997,144436213,392638
7,ENSG00000212807.1,144239605,7-144435635-A-G,rs12666210,-1,A,G,144435635,196030,144042997,144436213,392638
7,ENSG00000196329.5,150737418,7-150573252-A-G,rs12669961,1,A,G,150573252,164166,150540810,150934026,32442
7,ENSG00000157764.7,140924929,7-140998751-A-G,rs12672764,-1,A,G,140998751,73822,140728321,141121537,270430
7,ENSG00000157764.7,140924929,7-140998751-A-C,rs12672764,-1,A,C,140998751,73822,140728321,141121537,270430
7,ENSG00000157764.7,140924929,7-140998751-A-T,rs12672764,-1,A,T,140998751,73822,140728321,141121537,270430
7,ENSG00000213413.2,100219236,7-100072705-A-T,rs12673441,1,A,T,100072705,146531,100022628,100415844,50077
7,ENSG00000136231.8,23470491,7-23396706-A-T,rs12700427,-1,A,T,23396706,73785,23273883,23667099,122823
7,ENSG00000136231.8,23470491,7-23396706-A-C,rs12700427,-1,A,C,23396706,73785,23273883,23667099,122823
7,ENSG00000136231.8,23470491,7-23396706-A-G,rs12700427,-1,A,G,23396706,73785,23273883,23667099,122823
7,ENSG00000133574.4,150567390,7-150588016-T-C,rs13222892,1,T,C,150588016,20626,150370782,150763998,217234
7,ENSG00000006459.6,140176983,7-140246253-A-G,rs13225058,-1,A,G,140246253,69270,139980375,140373591,265878
7,ENSG00000106635.3,73557690,7-73633765-A-G,rs13230514,-1,A,G,73633765,76075,73361082,73754298,272683
7,ENSG00000106635.3,73557690,7-73633765-A-T,rs13230514,-1,A,T,73633765,76075,73361082,73754298,272683
7,ENSG00000086232.7,6059175,7-6074927-A-G,rs13230531,-1,A,G,6074927,15752,5862567,6255783,212360
7,ENSG00000129103.13,56064286,7-56072925-T-G,rs13238899,1,T,G,56072925,8639,55867678,56260894,205247
7,ENSG00000177679.14,76201896,7-76115715-T-G,rs13239185,1,T,G,76115715,86181,76005288,76398504,110427
7,ENSG00000177679.14,76201896,7-76115715-T-C,rs13239185,1,T,C,76115715,86181,76005288,76398504,110427
7,ENSG00000106302.5,123845169,7-123806334-T-C,rs13240375,1,T,C,123806334,38835,123648561,124041777,157773
7,ENSG00000128604.13,128937927,7-129085243-A-G,rs13244090,1,A,G,129085243,147316,128741319,129134535,343924
7,ENSG00000170852.5,32891760,7-32915653-C-T,rs1376303,-1,C,T,32915653,23893,32695152,33088368,220501
7,ENSG00000170852.5,32891760,7-32915653-C-A,rs1376303,-1,C,A,32915653,23893,32695152,33088368,220501
7,ENSG00000170852.5,32891760,7-32915653-C-G,rs1376303,-1,C,G,32915653,23893,32695152,33088368,220501
7,ENSG00000086289.7,37920640,7-37950173-T-C,rs1450851,1,T,C,37950173,29533,37724032,38117248,226141
7,ENSG00000135253.8,128910709,7-128863489-T-C,rs1472147,-1,T,C,128863489,47220,128714101,129107317,149388
7,ENSG00000126524.4,66995586,7-67052638-G-A,rs151323838,-1,G,A,67052638,57052,66798978,67192194,253660
7,ENSG00000227471.3,134549110,7-134470781-C-T,rs1553976,1,C,T,134470781,78329,134352502,134745718,118279
7,ENSG00000164815.6,104208013,7-104128437-A-T,rs17133236,-1,A,T,104128437,79576,104011405,104404621,117032
7,ENSG00000009954.6,73522293,7-73519750-T-C,rs17145721,-1,T,C,73519750,2543,73325685,73718901,194065
7,ENSG00000105928.9,24757464,7-24717611-G-A,rs17149980,-1,G,A,24717611,39853,24560856,24954072,156755
7,ENSG00000091127.8,105522271,7-105605430-G-C,rs17150293,-1,G,C,105605430,83159,105325663,105718879,279767
7,ENSG00000091127.8,105522271,7-105605430-G-A,rs17150293,-1,G,A,105605430,83159,105325663,105718879,279767
7,ENSG00000064393.11,139777998,7-139942907-C-T,rs17161280,-1,C,T,139942907,164909,139581390,139974606,361517
7,ENSG00000106245.5,99408969,7-99344286-C-T,rs17161687,1,C,T,99344286,64683,99212361,99605577,131925
7,ENSG00000196652.6,99504662,7-99379444-A-G,rs17161700,1,A,G,99379444,125218,99308054,99701270,71390
7,ENSG00000087077.7,100867387,7-100886548-A-G,rs17162528,1,A,G,100886548,19161,100670779,101063995,215769
7,ENSG00000106484.8,130492085,7-130363646-G-T,rs17164851,1,G,T,130363646,128439,130295477,130688693,68169
7,ENSG00000106484.8,130492085,7-130363646-G-A,rs17164851,1,G,A,130363646,128439,130295477,130688693,68169
7,ENSG00000146859.4,135148072,7-134974312-G-T,rs17168150,1,G,T,134974312,173760,134951464,135344680,22848
7,ENSG00000146859.4,135148072,7-134974312-G-A,rs17168150,1,G,A,134974312,173760,134951464,135344680,22848
7,ENSG00000122557.4,35695135,7-35559810-T-C,rs17171522,-1,T,C,35559810,135325,35498527,35891743,61283
7,ENSG00000122557.4,35695135,7-35559810-T-A,rs17171522,-1,T,A,35559810,135325,35498527,35891743,61283
7,ENSG00000006451.3,39623572,7-39684865-A-G,rs17171612,1,A,G,39684865,61293,39426964,39820180,257901
7,ENSG00000136193.10,29989801,7-29885070-A-C,rs174966,-1,A,C,29885070,104731,29793193,30186409,91877
7,ENSG00000136193.10,29989801,7-29885070-A-G,rs174966,-1,A,G,29885070,104731,29793193,30186409,91877
7,ENSG00000164708.5,44065567,7-44060774-C-T,rs17546439,-1,C,T,44060774,4793,43868959,44262175,191815
7,ENSG00000213214.3,144195833,7-144173412-C-G,rs17591937,-1,C,G,144173412,22421,143999225,144392441,174187
7,ENSG00000213214.3,144195833,7-144173412-C-T,rs17591937,-1,C,T,144173412,22421,143999225,144392441,174187
7,ENSG00000213214.3,144195833,7-144173412-C-A,rs17591937,-1,C,A,144173412,22421,143999225,144392441,174187
7,ENSG00000106344.3,128343908,7-128302531-G-A,rs17618802,-1,G,A,128302531,41377,128147300,128540516,155231
7,ENSG00000008282.3,106112312,7-106085811-C-T,rs176479,-1,C,T,106085811,26501,105915704,106308920,170107
7,ENSG00000008282.3,106112312,7-106085811-C-A,rs176479,-1,C,A,106085811,26501,105915704,106308920,170107
7,ENSG00000105835.7,106284983,7-106178400-G-A,rs176572,-1,G,A,106178400,106583,106088375,106481591,90025
7,ENSG00000106009.11,2555524,7-2405685-A-G,rs17793630,-1,A,G,2405685,149839,2358916,2752132,46769
7,ENSG00000173041.7,64563071,7-64617333-C-T,rs1867917,-1,C,T,64617333,54262,64366463,64759679,250870
7,ENSG00000173041.7,64563071,7-64617333-C-G,rs1867917,-1,C,G,64617333,54262,64366463,64759679,250870
7,ENSG00000059377.10,139829264,7-139931695-C-T,rs193961,1,C,T,139931695,102431,139632656,140025872,299039
7,ENSG00000059377.10,139829264,7-139931695-C-A,rs193961,1,C,A,139931695,102431,139632656,140025872,299039
7,ENSG00000122547.6,36153254,7-36253867-G-T,rs196551,1,G,T,36253867,100613,35956646,36349862,297221
7,ENSG00000122547.6,36153254,7-36253867-G-A,rs196551,1,G,A,36253867,100613,35956646,36349862,297221
7,ENSG00000213203.2,150716613,7-150749983-G-A,rs2058446,1,G,A,150749983,33370,150520005,150913221,229978
7,ENSG00000106615.5,151519895,7-151343308-G-A,rs2063995,-1,G,A,151343308,176587,151323287,151716503,20021
7,ENSG00000106615.5,151519895,7-151343308-G-T,rs2063995,-1,G,T,151343308,176587,151323287,151716503,20021
7,ENSG00000106615.5,151519895,7-151343308-G-C,rs2063995,-1,G,C,151343308,176587,151323287,151716503,20021
7,ENSG00000160862.8,99976031,7-100099174-T-C,rs2070215,-1,T,C,100099174,123143,99779423,100172639,319751
7,ENSG00000091136.9,108003161,7-108104584-A-G,rs2074748,-1,A,G,108104584,101423,107806553,108199769,298031
7,ENSG00000228049.3,102671629,7-102735579-G-A,rs2109994,-1,G,A,102735579,63950,102475021,102868237,260558
7,ENSG00000173114.7,111091127,7-111226634-G-T,rs214474,1,G,T,111226634,135507,110894519,111287735,332115
7,ENSG00000173114.7,111091127,7-111226634-G-A,rs214474,1,G,A,111226634,135507,110894519,111287735,332115
7,ENSG00000173114.7,111091127,7-111226634-G-C,rs214474,1,G,C,111226634,135507,110894519,111287735,332115
7,ENSG00000106554.7,133082090,7-133268943-A-T,rs2178689,-1,A,T,133268943,186853,132885482,133278698,383461
7,ENSG00000146833.10,99919530,7-99768096-A-G,rs2246709,-1,A,G,99768096,151434,99722922,100116138,45174
7,ENSG00000196411.5,100827523,7-100824534-G-A,rs2250818,-1,G,A,100824534,2989,100630915,101024131,193619
7,ENSG00000166925.4,100479214,7-100600248-A-G,rs2272575,-1,A,G,100600248,121034,100282606,100675822,317642
7,ENSG00000106571.8,42237209,7-42172250-A-G,rs2286294,-1,A,G,42172250,64959,42040601,42433817,131649
7,ENSG00000188372.9,76424950,7-76395203-C-T,rs2286427,1,C,T,76395203,29747,76228342,76621558,166861
7,ENSG00000188707.4,150322639,7-150407322-C-G,rs2293282,1,C,G,150407322,84683,150126031,150519247,281291
7,ENSG00000188707.4,150322639,7-150407322-C-A,rs2293282,1,C,A,150407322,84683,150126031,150519247,281291
7,ENSG00000188707.4,150322639,7-150407322-C-T,rs2293282,1,C,T,150407322,84683,150126031,150519247,281291
7,ENSG00000106125.14,30771417,7-30755672-A-T,rs2302339,1,A,T,30755672,15745,30574809,30968025,180863
7,ENSG00000106125.14,30771417,7-30755672-A-G,rs2302339,1,A,G,30755672,15745,30574809,30968025,180863
7,ENSG00000106459.10,129611720,7-129765967-A-T,rs2402959,1,A,T,129765967,154247,129415112,129808328,350855
7,ENSG00000106459.10,129611720,7-129765967-A-G,rs2402959,1,A,G,129765967,154247,129415112,129808328,350855
7,ENSG00000106459.10,129611720,7-129765967-A-C,rs2402959,1,A,C,129765967,154247,129415112,129808328,350855
7,ENSG00000136247.10,6577454,7-6648120-C-T,rs2464873,1,C,T,6648120,70666,6380846,6774062,267274
7,ENSG00000164896.13,151080809,7-151193154-G-A,rs2487151,-1,G,A,151193154,112345,150884201,151277417,308953
7,ENSG00000160999.8,102286868,7-102264522-G-A,rs2529124,1,G,A,102264522,22346,102090260,102483476,174262
7,ENSG00000243317.3,135662514,7-135482251-T-A,rs2696887,1,T,A,135482251,180263,135465906,135859122,16345
7,ENSG00000243317.3,135662514,7-135482251-T-C,rs2696887,1,T,C,135482251,180263,135465906,135859122,16345
7,ENSG00000157680.8,137846974,7-137894347-A-T,rs273936,-1,A,T,137894347,47373,137650366,138043582,243981
7,ENSG00000157680.8,137846974,7-137894347-A-G,rs273936,-1,A,G,137894347,47373,137650366,138043582,243981
7,ENSG00000127951.5,77199819,7-77253084-G-A,rs3108424,-1,G,A,77253084,53265,77003211,77396427,249873
7,ENSG00000164707.9,135728186,7-135701239-C-T,rs3110798,-1,C,T,135701239,26947,135531578,135924794,169661
7,ENSG00000164707.9,135728186,7-135701239-C-G,rs3110798,-1,C,G,135701239,26947,135531578,135924794,169661
7,ENSG00000087085.8,100895888,7-100834358-T-C,rs314320,-1,T,C,100834358,61530,100699280,101092496,135078
7,ENSG00000008311.10,122144249,7-122085907-A-G,rs3213699,-1,A,G,122085907,58342,121947641,122340857,138266
7,ENSG00000188763.3,73433778,7-73311890-C-T,rs34014814,1,C,T,73311890,121888,73237170,73630386,74720
7,ENSG00000188186.6,100148918,7-100123371-A-G,rs35146811,1,A,G,100123371,25547,99952310,100345526,171061
7,ENSG00000188186.6,100148918,7-100123371-A-C,rs35146811,1,A,C,100123371,25547,99952310,100345526,171061
7,ENSG00000127980.10,92528520,7-92614879-C-T,rs3731389,-1,C,T,92614879,86359,92331912,92725128,282967
7,ENSG00000146842.11,130205406,7-130132948-A-G,rs3800562,-1,A,G,130132948,72458,130008798,130402014,124150
7,ENSG00000106268.11,2242226,7-2077626-C-T,rs3800875,1,C,T,2077626,164600,2045618,2438834,32008
7,ENSG00000086300.11,26291862,7-26350152-C-G,rs3801886,1,C,G,26350152,58290,26095254,26488470,254898
7,ENSG00000126870.11,158856558,7-158735911-A-G,rs3816465,1,A,G,158735911,120647,158659950,159053166,75961
7,ENSG00000126870.11,158856558,7-158735911-A-T,rs3816465,1,A,T,158735911,120647,158659950,159053166,75961
7,ENSG00000164916.7,4682295,7-4800251-T-C,rs3816854,1,T,C,4800251,117956,4485687,4878903,314564
7,ENSG00000091073.13,76461709,7-76587931-C-A,rs3906145,1,C,A,76587931,126222,76265101,76658317,322830
7,ENSG00000002726.14,150852517,7-150992682-C-T,rs3918158,1,C,T,150992682,140165,150655909,151049125,336773
7,ENSG00000105976.9,116672196,7-116677823-G-A,rs40239,1,G,A,116677823,5627,116475588,116868804,202235
7,ENSG00000127920.4,93921735,7-94062395-T-A,rs41535,1,T,A,94062395,140660,93725127,94118343,337268
7,ENSG00000127920.4,93921735,7-94062395-T-C,rs41535,1,T,C,94062395,140660,93725127,94118343,337268
7,ENSG00000127920.4,93921735,7-94062395-T-G,rs41535,1,T,G,94062395,140660,93725127,94118343,337268
7,ENSG00000196367.7,98878532,7-98973260-A-T,rs41645,1,A,T,98973260,94728,98681924,99075140,291336
7,ENSG00000196367.7,98878532,7-98973260-A-C,rs41645,1,A,C,98973260,94728,98681924,99075140,291336
7,ENSG00000071243.11,120950777,7-121004503-G-A,rs41704,1,G,A,121004503,53726,120754169,121147385,250334
7,ENSG00000106052.8,27740162,7-27678097-G-C,rs42102,1,G,C,27678097,62065,27543554,27936770,134543
7,ENSG00000106049.3,27662883,7-27678097-G-C,rs42102,-1,G,C,27678097,15214,27466275,27859491,211822
7,ENSG00000169871.8,101085481,7-100950289-C-T,rs4236547,1,C,T,100950289,135192,100888873,101282089,61416
7,ENSG00000169871.8,101085481,7-100950289-C-A,rs4236547,1,C,A,100950289,135192,100888873,101282089,61416
7,ENSG00000161036.5,102464984,7-102441839-A-C,rs4342524,1,A,C,102441839,23145,102268376,102661592,173463
7,ENSG00000161036.5,102464984,7-102441839-A-G,rs4342524,1,A,G,102441839,23145,102268376,102661592,173463
7,ENSG00000214253.4,101245081,7-101274027-A-G,rs4574779,-1,A,G,101274027,28946,101048473,101441689,225554
7,ENSG00000105963.7,954680,7-915343-A-G,rs4596552,-1,A,G,915343,39337,758072,1151288,157271
7,ENSG00000106624.4,44104345,7-44081516-C-G,rs4640970,1,C,G,44081516,22829,43907737,44300953,173779
7,ENSG00000106624.4,44104345,7-44081516-C-T,rs4640970,1,C,T,44081516,22829,43907737,44300953,173779
7,ENSG00000136235.10,23246775,7-23231467-T-A,rs4719731,1,T,A,23231467,15308,23050167,23443383,181300
7,ENSG00000122644.8,12687633,7-12727657-G-A,rs4721131,1,G,A,12727657,40024,12491025,12884241,236632
7,ENSG00000136243.12,23182048,7-23067050-C-T,rs4722224,1,C,T,23067050,114998,22985440,23378656,81610
7,ENSG00000172115.4,25125260,7-25036094-T-C,rs4722419,-1,T,C,25036094,89166,24928652,25321868,107442
7,ENSG00000172115.4,25125260,7-25036094-T-A,rs4722419,-1,T,A,25036094,89166,24928652,25321868,107442
7,ENSG00000172115.4,25125260,7-25036094-T-G,rs4722419,-1,T,G,25036094,89166,24928652,25321868,107442
7,ENSG00000240583.5,30911853,7-30740601-C-G,rs4723008,1,C,G,30740601,171252,30715245,31108461,25356
7,ENSG00000240583.5,30911853,7-30740601-C-T,rs4723008,1,C,T,30740601,171252,30715245,31108461,25356
7,ENSG00000106105.9,30594878,7-30752232-G-A,rs4723010,1,G,A,30752232,157354,30398270,30791486,353962
7,ENSG00000136205.11,47582111,7-47388499-A-C,rs4724569,-1,A,C,47388499,193612,47385503,47778719,2996
7,ENSG00000136205.11,47582111,7-47388499-A-T,rs4724569,-1,A,T,47388499,193612,47385503,47778719,2996
7,ENSG00000136205.11,47582111,7-47388499-A-G,rs4724569,-1,A,G,47388499,193612,47385503,47778719,2996
7,ENSG00000197362.8,149090718,7-149250607-A-G,rs4725801,-1,A,G,149250607,159889,148894110,149287326,356497
7,ENSG00000197362.8,149090718,7-149250607-A-C,rs4725801,-1,A,C,149250607,159889,148894110,149287326,356497
7,ENSG00000197448.9,143263441,7-143363198-T-G,rs4726612,1,T,G,143363198,99757,143066833,143460049,296365
7,ENSG00000197448.9,143263441,7-143363198-T-A,rs4726612,1,T,A,143363198,99757,143066833,143460049,296365
7,ENSG00000197448.9,143263441,7-143363198-T-C,rs4726612,1,T,C,143363198,99757,143066833,143460049,296365
7,ENSG00000146904.4,143408856,7-143363198-T-G,rs4726612,-1,T,G,143363198,45658,143212248,143605464,150950
7,ENSG00000146904.4,143408856,7-143363198-T-A,rs4726612,-1,T,A,143363198,45658,143212248,143605464,150950
7,ENSG00000146904.4,143408856,7-143363198-T-C,rs4726612,-1,T,C,143363198,45658,143212248,143605464,150950
7,ENSG00000170027.4,76358991,7-76371417-G-C,rs4728696,-1,G,C,76371417,12426,76162383,76555599,209034
7,ENSG00000170027.4,76358991,7-76371417-G-T,rs4728696,-1,G,T,76371417,12426,76162383,76555599,209034
7,ENSG00000170027.4,76358991,7-76371417-G-A,rs4728696,-1,G,A,76371417,12426,76162383,76555599,209034
7,ENSG00000106077.13,73738802,7-73712013-G-A,rs55951611,-1,G,A,73712013,26789,73542194,73935410,169819
7,ENSG00000106077.13,73738802,7-73712013-G-C,rs55951611,-1,G,C,73712013,26789,73542194,73935410,169819
7,ENSG00000173678.10,102650319,7-102462847-G-A,rs56208004,1,G,A,102462847,187472,102453711,102846927,9136
7,ENSG00000173678.10,102650319,7-102462847-G-C,rs56208004,1,G,C,102462847,187472,102453711,102846927,9136
7,ENSG00000106333.8,100602363,7-100554096-G-A,rs61742738,1,G,A,100554096,48267,100405755,100798971,148341
7,ENSG00000157999.5,6031376,7-6129276-C-A,rs62454270,1,C,A,6129276,97900,5834768,6227984,294508
7,ENSG00000157999.5,6031376,7-6129276-C-T,rs62454270,1,C,T,6129276,97900,5834768,6227984,294508
7,ENSG00000168090.5,100088969,7-100041564-G-A,rs62484984,1,G,A,100041564,47405,99892361,100285577,149203
7,ENSG00000006704.6,74453906,7-74395124-T-C,rs6460078,1,T,C,74395124,58782,74257298,74650514,137826
7,ENSG00000188732.6,23680199,7-23625053-G-A,rs6461718,1,G,A,23625053,55146,23483591,23876807,141462
7,ENSG00000188732.6,23680199,7-23625053-G-T,rs6461718,1,G,T,23625053,55146,23483591,23876807,141462
7,ENSG00000105784.11,87628398,7-87508870-A-C,rs6946379,1,A,C,87508870,119528,87431790,87825006,77080
7,ENSG00000105784.11,87628398,7-87508870-A-G,rs6946379,1,A,G,87508870,119528,87431790,87825006,77080
7,ENSG00000105784.11,87628398,7-87508870-A-T,rs6946379,1,A,T,87508870,119528,87431790,87825006,77080
7,ENSG00000011426.6,36389862,7-36278172-C-T,rs6946846,1,C,T,36278172,111690,36193254,36586470,84918
7,ENSG00000105854.7,95435028,7-95437094-A-G,rs6946850,-1,A,G,95437094,2066,95238420,95631636,198674
7,ENSG00000105854.7,95435028,7-95437094-A-T,rs6946850,-1,A,T,95437094,2066,95238420,95631636,198674
7,ENSG00000105854.7,95435028,7-95437094-A-C,rs6946850,-1,A,C,95437094,2066,95238420,95631636,198674
7,ENSG00000172331.7,134646853,7-134658190-G-C,rs6946952,1,G,C,134658190,11337,134450245,134843461,207945
7,ENSG00000172331.7,134646853,7-134658190-G-T,rs6946952,1,G,T,134658190,11337,134450245,134843461,207945
7,ENSG00000065883.10,39950256,7-39932050-A-G,rs6947071,1,A,G,39932050,18206,39753648,40146864,178402
7,ENSG00000106638.9,73578579,7-73718911-T-G,rs6951030,-1,T,G,73718911,140332,73381971,73775187,336940
7,ENSG00000070882.8,24980178,7-24931186-T-C,rs6951637,-1,T,C,24931186,48992,24783570,25176786,147616
7,ENSG00000070882.8,24980178,7-24931186-T-A,rs6951637,-1,T,A,24931186,48992,24783570,25176786,147616
7,ENSG00000002745.7,121329000,7-121309188-A-G,rs6953489,1,A,G,121309188,19812,121132392,121525608,176796
7,ENSG00000002745.7,121329000,7-121309188-A-C,rs6953489,1,A,C,121309188,19812,121132392,121525608,176796
7,ENSG00000106086.12,30028412,7-30137662-C-T,rs6954379,1,C,T,30137662,109250,29831804,30225020,305858
7,ENSG00000183696.9,48089265,7-47933437-G-A,rs6955251,1,G,A,47933437,155828,47892657,48285873,40780
7,ENSG00000183696.9,48089265,7-47933437-G-C,rs6955251,1,G,C,47933437,155828,47892657,48285873,40780
7,ENSG00000136240.5,6484152,7-6495429-C-G,rs6959768,-1,C,G,6495429,11277,6287544,6680760,207885
7,ENSG00000136240.5,6484152,7-6495429-C-A,rs6959768,-1,C,A,6495429,11277,6287544,6680760,207885
7,ENSG00000146856.10,134986508,7-135111234-T-C,rs6962111,1,T,C,135111234,124726,134789900,135183116,321334
7,ENSG00000105879.4,107744142,7-107811181-A-G,rs6962701,1,A,G,107811181,67039,107547534,107940750,263647
7,ENSG00000214309.3,100126967,7-100004568-C-T,rs6967487,1,C,T,100004568,122399,99930359,100323575,74209
7,ENSG00000214309.3,100126967,7-100004568-C-G,rs6967487,1,C,G,100004568,122399,99930359,100323575,74209
7,ENSG00000253293.2,27174320,7-27183944-G-T,rs6968828,-1,G,T,27183944,9624,26977712,27370928,206232
7,ENSG00000135211.5,77798434,7-77796930-T-C,rs6970158,-1,T,C,77796930,1504,77601826,77995042,195104
7,ENSG00000135211.5,77798434,7-77796930-T-G,rs6970158,-1,T,G,77796930,1504,77601826,77995042,195104
7,ENSG00000135211.5,77798434,7-77796930-T-A,rs6970158,-1,T,A,77796930,1504,77601826,77995042,195104
7,ENSG00000157259.6,92447482,7-92562432-C-T,rs6970992,1,C,T,92562432,114950,92250874,92644090,311558
7,ENSG00000157259.6,92447482,7-92562432-C-A,rs6970992,1,C,A,92562432,114950,92250874,92644090,311558
7,ENSG00000128609.9,123557818,7-123707214-C-T,rs6975039,-1,C,T,123707214,149396,123361210,123754426,346004
7,ENSG00000229937.4,18027846,7-18039468-A-G,rs6977061,-1,A,G,18039468,11622,17831238,18224454,208230
7,ENSG00000239857.1,876554,7-1063632-C-G,rs6980433,1,C,G,1063632,187078,679946,1073162,383686
7,ENSG00000127399.10,150323355,7-150265936-C-G,rs71537921,1,C,G,150265936,57419,150126747,150519963,139189
7,ENSG00000127399.10,150323355,7-150265936-C-A,rs71537921,1,C,A,150265936,57419,150126747,150519963,139189
7,ENSG00000127399.10,150323355,7-150265936-C-T,rs71537921,1,C,T,150265936,57419,150126747,150519963,139189
7,ENSG00000153993.9,85187056,7-85203581-C-T,rs718413,-1,C,T,85203581,16525,84990448,85383664,213133
7,ENSG00000153993.9,85187056,7-85203581-C-A,rs718413,-1,C,A,85203581,16525,84990448,85383664,213133
7,ENSG00000153993.9,85187056,7-85203581-C-G,rs718413,-1,C,G,85203581,16525,84990448,85383664,213133
7,ENSG00000106341.6,31687215,7-31824188-G-T,rs73092410,1,G,T,31824188,136973,31490607,31883823,333581
7,ENSG00000106341.6,31687215,7-31824188-G-A,rs73092410,1,G,A,31824188,136973,31490607,31883823,333581
7,ENSG00000105993.9,157337004,7-157459135-A-G,rs73178459,1,A,G,157459135,122131,157140396,157533612,318739
7,ENSG00000218305.2,48924547,7-49095803-G-A,rs73695655,1,G,A,49095803,171256,48727939,49121155,367864
7,ENSG00000106070.12,50782896,7-50768456-T-G,rs74813781,-1,T,G,50768456,14440,50586288,50979504,182168
7,ENSG00000128606.8,102913000,7-102928699-C-T,rs74992440,1,C,T,102928699,15699,102716392,103109608,212307
7,ENSG00000122786.13,134779634,7-134809572-C-A,rs759987,1,C,A,134809572,29938,134583026,134976242,226546
7,ENSG00000196247.6,64666133,7-64644819-C-G,rs7776508,1,C,G,64644819,21314,64469525,64862741,175294
7,ENSG00000196247.6,64666133,7-64644819-C-A,rs7776508,1,C,A,64644819,21314,64469525,64862741,175294
7,ENSG00000105851.6,106865282,7-106954440-C-T,rs7779057,1,C,T,106954440,89158,106668674,107061890,285766
7,ENSG00000164746.9,48035543,7-48010973-T-C,rs7779252,1,T,C,48010973,24570,47838935,48232151,172038
7,ENSG00000050327.8,144355402,7-144525836-A-G,rs7779534,1,A,G,144525836,170434,144158794,144552010,367042
7,ENSG00000128602.5,129188633,7-129102167-A-G,rs7779671,1,A,G,129102167,86466,128992025,129385241,110142
7,ENSG00000106013.8,118224704,7-118412224-A-T,rs7780891,1,A,T,118412224,187520,118028096,118421312,384128
7,ENSG00000106013.8,118224704,7-118412224-A-G,rs7780891,1,A,G,118412224,187520,118028096,118421312,384128
7,ENSG00000165055.10,128476748,7-128501584-G-T,rs7785264,1,G,T,128501584,24836,128280140,128673356,221444
7,ENSG00000165055.10,128476748,7-128501584-G-A,rs7785264,1,G,A,128501584,24836,128280140,128673356,221444
7,ENSG00000165171.6,73842516,7-73794320-T-C,rs77900184,-1,T,C,73794320,48196,73645908,74039124,148412
7,ENSG00000185955.4,100464260,7-100471313-T-C,rs7794485,-1,T,C,100471313,7053,100267652,100660868,203661
7,ENSG00000001629.5,92245974,7-92272402-C-G,rs7796370,1,C,G,92272402,26428,92049366,92442582,223036
7,ENSG00000001629.5,92245974,7-92272402-C-A,rs7796370,1,C,A,92272402,26428,92049366,92442582,223036
7,ENSG00000106415.8,7968796,7-7820793-T-C,rs7796962,1,T,C,7820793,148003,7772188,8165404,48605
7,ENSG00000106415.8,7968796,7-7820793-T-A,rs7796962,1,T,A,7820793,148003,7772188,8165404,48605
7,ENSG00000146676.5,44885530,7-44915275-C-A,rs7799125,-1,C,A,44915275,29745,44688922,45082138,226353
7,ENSG00000146676.5,44885530,7-44915275-C-G,rs7799125,-1,C,G,44915275,29745,44688922,45082138,226353
7,ENSG00000182095.9,5423834,7-5265317-T-G,rs7799951,-1,T,G,5265317,158517,5227226,5620442,38091
7,ENSG00000182095.9,5423834,7-5265317-T-C,rs7799951,-1,T,C,5265317,158517,5227226,5620442,38091
7,ENSG00000181444.8,149773588,7-149744229-A-C,rs7802599,-1,A,C,149744229,29359,149576980,149970196,167249
7,ENSG00000198420.5,143902176,7-143737056-G-C,rs7803432,-1,G,C,143737056,165120,143705568,144098784,31488
7,ENSG00000004766.11,93232366,7-93388079-A-G,rs7804125,1,A,G,93388079,155713,93035758,93428974,352321
7,ENSG00000214300.5,100307702,7-100467096-A-G,rs7806537,1,A,G,100467096,159394,100111094,100504310,356002
7,ENSG00000121716.11,100358117,7-100467096-A-G,rs7806537,1,A,G,100467096,108979,100161509,100554725,305587
7,ENSG00000146802.6,112790393,7-112780017-C-A,rs7806781,-1,C,A,112780017,10376,112593785,112987001,186232
7,ENSG00000146802.6,112790393,7-112780017-C-T,rs7806781,-1,C,T,112780017,10376,112593785,112987001,186232
7,ENSG00000013374.10,151341812,7-151334421-A-G,rs7807594,1,A,G,151334421,7391,151145204,151538420,189217
7,ENSG00000187260.9,151410038,7-151334421-A-G,rs7807594,-1,A,G,151334421,75617,151213430,151606646,120991
7,ENSG00000234444.3,64313961,7-64331778-G-A,rs7810545,1,G,A,64331778,17817,64117353,64510569,214425
7,ENSG00000105877.12,21543039,7-21494140-T-A,rs7810841,1,T,A,21494140,48899,21346431,21739647,147709
7,ENSG00000105877.12,21543039,7-21494140-T-C,rs7810841,1,T,C,21494140,48899,21346431,21739647,147709
7,ENSG00000213199.3,151048531,7-151012483-G-T,rs7830,1,G,T,151012483,36048,150851923,151245139,160560
7,ENSG00000169402.10,6757590,7-6594702-T-C,rs79000164,1,T,C,6594702,162888,6560982,6954198,33720
7,ENSG00000166529.9,100049774,7-100058940-C-G,rs79017592,1,C,G,100058940,9166,99853166,100246382,205774
7,ENSG00000178809.7,75395629,7-75567227-G-A,rs794356,1,G,A,75567227,171598,75199021,75592237,368206
7,ENSG00000106366.5,101127104,7-101169149-G-C,rs80264175,1,G,C,101169149,42045,100930496,101323712,238653
7,ENSG00000106366.5,101127104,7-101169149-G-A,rs80264175,1,G,A,101169149,42045,100930496,101323712,238653
7,ENSG00000153814.7,28180795,7-28156603-A-G,rs849134,-1,A,G,28156603,24192,27984187,28377403,172416
7,ENSG00000171115.3,150450630,7-150446717-A-C,rs952825,1,A,C,150446717,3913,150254022,150647238,192695
7,ENSG00000171115.3,150450630,7-150446717-A-T,rs952825,1,A,T,150446717,3913,150254022,150647238,192695
7,ENSG00000188191.8,727281,7-630775-A-T,rs9690480,-1,A,T,630775,96506,530673,923889,100102
7,ENSG00000188191.8,727281,7-630775-A-G,rs9690480,-1,A,G,630775,96506,530673,923889,100102
7,ENSG00000221866.5,132576470,7-132770487-T-G,rs9692533,-1,T,G,132770487,194017,132379862,132773078,390625
7,ENSG00000221866.5,132576470,7-132770487-T-A,rs9692533,-1,T,A,132770487,194017,132379862,132773078,390625
7,ENSG00000155530.2,134127299,7-134155208-A-T,rs997316,1,A,T,134155208,27909,133930691,134323907,224517
7,ENSG00000155530.2,134127299,7-134155208-A-G,rs997316,1,A,G,134155208,27909,133930691,134323907,224517
6,ENSG00000155115.6,110958706,6-110879552-C-T,rs1007274,1,C,T,110879552,79154,110762098,111155314,117454
6,ENSG00000155115.6,110958706,6-110879552-C-A,rs1007274,1,C,A,110879552,79154,110762098,111155314,117454
6,ENSG00000112282.12,131628242,6-131595075-A-G,rs10081029,-1,A,G,131595075,33167,131431634,131824850,163441
6,ENSG00000231389.2,33080710,6-33069222-T-C,rs1042190,-1,T,C,33069222,11488,32884102,33277318,185120
6,ENSG00000231389.2,33080710,6-33069222-T-G,rs1042190,-1,T,G,33069222,11488,32884102,33277318,185120
6,ENSG00000156711.10,36130513,6-36147711-C-T,rs10447375,1,C,T,36147711,17198,35933905,36327121,213806
6,ENSG00000111843.8,10723070,6-10723216-A-C,rs1045911,1,A,C,10723216,146,10526462,10919678,196754
6,ENSG00000111843.8,10723070,6-10723216-A-G,rs1045911,1,A,G,10723216,146,10526462,10919678,196754
6,ENSG00000027697.7,137219385,6-137410807-A-G,rs10484596,-1,A,G,137410807,191422,137022777,137415993,388030
6,ENSG00000111962.7,148747030,6-148790981-A-G,rs10499260,1,A,G,148790981,43951,148550422,148943638,240559
6,ENSG00000178425.7,116100853,6-116247610-A-T,rs1052443,1,A,T,116247610,146757,115904245,116297461,343365
6,ENSG00000178425.7,116100853,6-116247610-A-C,rs1052443,1,A,C,116247610,146757,115904245,116297461,343365
6,ENSG00000196735.6,32637406,6-32659937-T-G,rs1063355,1,T,G,32659937,22531,32440798,32834014,219139
6,ENSG00000196735.6,32637406,6-32659937-T-C,rs1063355,1,T,C,32659937,22531,32440798,32834014,219139
6,ENSG00000179344.11,32666657,6-32659937-T-G,rs1063355,-1,T,G,32659937,6720,32470049,32863265,189888
6,ENSG00000179344.11,32666657,6-32659937-T-C,rs1063355,-1,T,C,32659937,6720,32470049,32863265,189888
6,ENSG00000124613.4,27388759,6-27368934-T-A,rs10755644,1,T,A,27368934,19825,27192151,27585367,176783
6,ENSG00000124613.4,27388759,6-27368934-T-C,rs10755644,1,T,C,27368934,19825,27192151,27585367,176783
6,ENSG00000124508.12,26383108,6-26405036-G-C,rs10807008,1,G,C,26405036,21928,26186500,26579716,218536
6,ENSG00000112699.6,2245605,6-2436259-C-T,rs10900924,-1,C,T,2436259,190654,2048997,2442213,387262
6,ENSG00000112304.5,24667077,6-24703312-G-C,rs10946720,1,G,C,24703312,36235,24470469,24863685,232843
6,ENSG00000137413.11,42050524,6-42056547-G-A,rs10948011,1,G,A,42056547,6023,41853916,42247132,202631
6,ENSG00000111816.5,116060891,6-116033428-C-T,rs11153594,-1,C,T,116033428,27463,115864283,116257499,169145
6,ENSG00000188820.8,116461375,6-116460830-C-T,rs11153612,1,C,T,116460830,545,116264767,116657983,196063
6,ENSG00000214113.5,5260950,6-5260461-C-T,rs111557465,-1,C,T,5260461,489,5064342,5457558,196119
6,ENSG00000187566.3,18122677,6-18204714-A-C,rs112298915,-1,A,C,18204714,82037,17926069,18319285,278645
6,ENSG00000137285.8,3227653,6-3205200-T-A,rs11242827,-1,T,A,3205200,22453,3031045,3424261,174155
6,ENSG00000137285.8,3227653,6-3205200-T-C,rs11242827,-1,T,C,3205200,22453,3031045,3424261,174155
6,ENSG00000137285.8,3227653,6-3205200-T-G,rs11242827,-1,T,G,3205200,22453,3031045,3424261,174155
6,ENSG00000137267.4,3157544,6-3205200-T-A,rs11242827,-1,T,A,3205200,47656,2960936,3354152,244264
6,ENSG00000137267.4,3157544,6-3205200-T-C,rs11242827,-1,T,C,3205200,47656,2960936,3354152,244264
6,ENSG00000137267.4,3157544,6-3205200-T-G,rs11242827,-1,T,G,3205200,47656,2960936,3354152,244264
6,ENSG00000182952.3,26538366,6-26538315-C-T,rs113223941,1,C,T,26538315,51,26341758,26734974,196557
6,ENSG00000182952.3,26538366,6-26538315-C-A,rs113223941,1,C,A,26538315,51,26341758,26734974,196557
6,ENSG00000118407.9,75493800,6-75476322-T-C,rs113307287,-1,T,C,75476322,17478,75297192,75690408,179130
6,ENSG00000204580.6,30884519,6-30751704-C-A,rs113617295,1,C,A,30751704,132815,30687911,31081127,63793
6,ENSG00000168116.9,57046693,6-57189149-T-C,rs11398,1,T,C,57189149,142456,56850085,57243301,339064
6,ENSG00000137312.10,30742687,6-30869513-C-G,rs114059502,-1,C,G,30869513,126826,30546079,30939295,323434
6,ENSG00000137312.10,30742687,6-30869513-C-T,rs114059502,-1,C,T,30869513,126826,30546079,30939295,323434
6,ENSG00000137312.10,30742687,6-30869513-C-A,rs114059502,-1,C,A,30869513,126826,30546079,30939295,323434
6,ENSG00000112343.7,25962802,6-26056189-G-C,rs114826548,1,G,C,26056189,93387,25766194,26159410,289995
6,ENSG00000112343.7,25962802,6-26056189-G-A,rs114826548,1,G,A,26056189,93387,25766194,26159410,289995
6,ENSG00000197279.3,28080568,6-28156150-T-C,rs1150666,1,T,C,28156150,75582,27883960,28277176,272190
6,ENSG00000204348.5,31972138,6-32082981-C-A,rs1150754,-1,C,A,32082981,110843,31775530,32168746,307451
6,ENSG00000204348.5,31972138,6-32082981-C-T,rs1150754,-1,C,T,32082981,110843,31775530,32168746,307451
6,ENSG00000137409.12,36986196,6-36968707-C-T,rs11548580,-1,C,T,36968707,17489,36789588,37182804,179119
6,ENSG00000146476.6,151452466,6-151445687-C-T,rs11550103,1,C,T,151445687,6779,151255858,151649074,189829
6,ENSG00000146476.6,151452466,6-151445687-C-A,rs11550103,1,C,A,151445687,6779,151255858,151649074,189829
6,ENSG00000204482.5,31586277,6-31590014-G-A,rs11575839,1,G,A,31590014,3737,31389669,31782885,200345
6,ENSG00000118491.7,143864474,6-143833841-G-A,rs116910255,1,G,A,143833841,30633,143667866,144061082,165975
6,ENSG00000083097.9,83067671,6-83160552-G-A,rs117404686,1,G,A,83160552,92881,82871063,83264279,289489
6,ENSG00000122335.8,158168262,6-158151943-G-T,rs11756587,-1,G,T,158151943,16319,157971654,158364870,180289
6,ENSG00000196821.5,34696767,6-34546430-C-A,rs11757517,-1,C,A,34546430,150337,34500159,34893375,46271
6,ENSG00000196821.5,34696767,6-34546430-C-T,rs11757517,-1,C,T,34546430,150337,34500159,34893375,46271
6,ENSG00000124507.4,34466076,6-34467254-A-C,rs11759825,1,A,C,34467254,1178,34269468,34662684,197786
6,ENSG00000124507.4,34466076,6-34467254-A-G,rs11759825,1,A,G,34467254,1178,34269468,34662684,197786
6,ENSG00000204574.6,30571442,6-30679595-C-T,rs118140680,1,C,T,30679595,108153,30374834,30768050,304761
6,ENSG00000168631.6,30940973,6-30952101-G-T,rs11970154,1,G,T,30952101,11128,30744365,31137581,207736
6,ENSG00000168631.6,30940973,6-30952101-G-C,rs11970154,1,G,C,30952101,11128,30744365,31137581,207736
6,ENSG00000050393.6,13814557,6-13817127-T-C,rs1204148,-1,T,C,13817127,2570,13617949,14011165,199178
6,ENSG00000050393.6,13814557,6-13817127-T-G,rs1204148,-1,T,G,13817127,2570,13617949,14011165,199178
6,ENSG00000013392.5,83193357,6-83198513-C-T,rs12190337,1,C,T,83198513,5156,82996749,83389965,201764
6,ENSG00000146409.5,132798637,6-132819554-G-T,rs12204740,-1,G,T,132819554,20917,132602029,132995245,217525
6,ENSG00000130363.6,159000202,6-158977771-C-T,rs12204826,-1,C,T,158977771,22431,158803594,159196810,174177
6,ENSG00000130363.6,159000202,6-158977771-C-A,rs12204826,-1,C,A,158977771,22431,158803594,159196810,174177
6,ENSG00000010818.4,142945176,6-142893692-T-C,rs12205042,-1,T,C,142893692,51484,142748568,143141784,145124
6,ENSG00000010818.4,142945176,6-142893692-T-G,rs12205042,-1,T,G,142893692,51484,142748568,143141784,145124
6,ENSG00000164484.7,130366017,6-130291855-G-A,rs12211846,1,G,A,130291855,74162,130169409,130562625,122446
6,ENSG00000164484.7,130366017,6-130291855-G-T,rs12211846,1,G,T,130291855,74162,130169409,130562625,122446
6,ENSG00000111897.5,122471807,6-122580854-G-C,rs12212981,-1,G,C,122580854,109047,122275199,122668415,305655
6,ENSG00000124787.9,5004037,6-4994898-T-A,rs1246986,-1,T,A,4994898,9139,4807429,5200645,187469
6,ENSG00000124787.9,5004037,6-4994898-T-G,rs1246986,-1,T,G,4994898,9139,4807429,5200645,187469
6,ENSG00000204392.5,31806966,6-31901358-G-A,rs12525922,-1,G,A,31901358,94392,31610358,32003574,291000
6,ENSG00000204540.6,31114800,6-31137636-A-C,rs1265099,1,A,C,31137636,22836,30918192,31311408,219444
6,ENSG00000204540.6,31114800,6-31137636-A-G,rs1265099,1,A,G,31137636,22836,30918192,31311408,219444
6,ENSG00000137310.7,31158589,6-31151812-G-C,rs1265109,1,G,C,31151812,6777,30961981,31355197,189831
6,ENSG00000137310.7,31158589,6-31151812-G-T,rs1265109,1,G,T,31151812,6777,30961981,31355197,189831
6,ENSG00000204531.9,31170682,6-31151812-G-C,rs1265109,-1,G,C,31151812,18870,30974074,31367290,177738
6,ENSG00000204531.9,31170682,6-31151812-G-T,rs1265109,-1,G,T,31151812,18870,30974074,31367290,177738
6,ENSG00000234745.3,31357179,6-31172270-G-A,rs1265159,-1,G,A,31172270,184909,31160571,31553787,11699
6,ENSG00000173214.5,111259339,6-111253534-A-T,rs12662324,1,A,T,111253534,5805,111062731,111455947,190803
6,ENSG00000173214.5,111259339,6-111253534-A-G,rs12662324,1,A,G,111253534,5805,111062731,111455947,190803
6,ENSG00000171217.5,155264013,6-155235534-G-A,rs12663896,1,G,A,155235534,28479,155067405,155460621,168129
6,ENSG00000124496.8,42452045,6-42503841-G-C,rs12665070,-1,G,C,42503841,51796,42255437,42648653,248404
6,ENSG00000124496.8,42452045,6-42503841-G-A,rs12665070,-1,G,A,42503841,51796,42255437,42648653,248404
6,ENSG00000118514.9,134950101,6-134965367-T-C,rs13199205,-1,T,C,134965367,15266,134753493,135146709,211874
6,ENSG00000118514.9,134950101,6-134965367-T-A,rs13199205,-1,T,A,134965367,15266,134753493,135146709,211874
6,ENSG00000118514.9,134950101,6-134965367-T-G,rs13199205,-1,T,G,134965367,15266,134753493,135146709,211874
6,ENSG00000155085.9,109691202,6-109634847-C-T,rs13201430,-1,C,T,109634847,56355,109494594,109887810,140253
6,ENSG00000132423.6,99394195,6-99435639-G-C,rs13208607,-1,G,C,99435639,41444,99197587,99590803,238052
6,ENSG00000180992.5,44127452,6-44109619-A-G,rs1321097,-1,A,G,44109619,17833,43930844,44324060,178775
6,ENSG00000137200.6,37433221,6-37442727-T-C,rs13212461,1,T,C,37442727,9506,37236613,37629829,206114
6,ENSG00000079931.10,132401475,6-132405216-G-A,rs1338937,-1,G,A,132405216,3741,132204867,132598083,200349
6,ENSG00000135547.4,125749632,6-125914170-G-A,rs1407592,1,G,A,125914170,164538,125553024,125946240,361146
6,ENSG00000111906.12,125301967,6-125292975-C-T,rs1417700,-1,C,T,125292975,8992,125105359,125498575,187616
6,ENSG00000111906.12,125301967,6-125292975-C-A,rs1417700,-1,C,A,125292975,8992,125105359,125498575,187616
6,ENSG00000204438.5,31664997,6-31667933-T-C,rs14365,-1,T,C,31667933,2936,31468389,31861605,199544
6,ENSG00000213760.5,31546608,6-31679209-G-A,rs145921744,-1,G,A,31679209,132601,31350000,31743216,329209
6,ENSG00000186340.9,169253846,6-169190703-C-T,rs1467584,-1,C,T,169190703,63143,169057238,169450454,133465
6,ENSG00000186340.9,169253846,6-169190703-C-A,rs1467584,-1,C,A,169190703,63143,169057238,169450454,133465
6,ENSG00000146376.5,129710177,6-129695948-T-G,rs1476042,-1,T,G,129695948,14229,129513569,129906785,182379
6,ENSG00000118689.9,108560917,6-108564420-C-T,rs1536057,1,C,T,108564420,3503,108364309,108757525,200111
6,ENSG00000112167.5,39115186,6-39156672-T-G,rs1544935,-1,T,G,39156672,41486,38918578,39311794,238094
6,ENSG00000197238.3,27824092,6-27995414-G-A,rs156742,1,G,A,27995414,171322,27627484,28020700,367930
6,ENSG00000198833.5,89352722,6-89299480-A-T,rs1570931,-1,A,T,89299480,53242,89156114,89549330,143366
6,ENSG00000198833.5,89352722,6-89299480-A-C,rs1570931,-1,A,C,89299480,53242,89156114,89549330,143366
6,ENSG00000064995.12,34888042,6-34883049-G-C,rs15922,-1,G,C,34883049,4993,34691434,35084650,191615
6,ENSG00000064995.12,34888042,6-34883049-G-A,rs15922,-1,G,A,34883049,4993,34691434,35084650,191615
6,ENSG00000206503.6,29942532,6-29821394-T-A,rs1610677,1,T,A,29821394,121138,29745924,30139140,75470
6,ENSG00000206503.6,29942532,6-29821394-T-G,rs1610677,1,T,G,29821394,121138,29745924,30139140,75470
6,ENSG00000206503.6,29942532,6-29821394-T-C,rs1610677,1,T,C,29821394,121138,29745924,30139140,75470
6,ENSG00000204632.7,29827825,6-29861474-A-T,rs1611713,1,A,T,29861474,33649,29631217,30024433,230257
6,ENSG00000204632.7,29827825,6-29861474-A-C,rs1611713,1,A,C,29861474,33649,29631217,30024433,230257
6,ENSG00000112761.12,112054104,6-112076242-C-G,rs1624814,1,C,G,112076242,22138,111857496,112250712,218746
6,ENSG00000112761.12,112054104,6-112076242-C-T,rs1624814,1,C,T,112076242,22138,111857496,112250712,218746
6,ENSG00000203778.2,112087591,6-112076242-C-G,rs1624814,1,C,G,112076242,11349,111890983,112284199,185259
6,ENSG00000203778.2,112087591,6-112076242-C-T,rs1624814,1,C,T,112076242,11349,111890983,112284199,185259
6,ENSG00000204618.3,30075769,6-30018907-T-C,rs165256,-1,T,C,30018907,56862,29879161,30272377,139746
6,ENSG00000204287.8,32439887,6-32443935-G-A,rs16822632,1,G,A,32443935,4048,32243279,32636495,200656
6,ENSG00000135315.7,84227643,6-84213170-G-A,rs16874339,-1,G,A,84213170,14473,84031035,84424251,182135
6,ENSG00000135315.7,84227643,6-84213170-G-T,rs16874339,-1,G,T,84213170,14473,84031035,84424251,182135
6,ENSG00000111875.6,118894152,6-118749651-A-T,rs1688641,1,A,T,118749651,144501,118697544,119090760,52107
6,ENSG00000111875.6,118894152,6-118749651-A-G,rs1688641,1,A,G,118749651,144501,118697544,119090760,52107
6,ENSG00000111875.6,118894152,6-118749651-A-C,rs1688641,1,A,C,118749651,144501,118697544,119090760,52107
6,ENSG00000010030.9,36387669,6-36379051-C-T,rs16888237,-1,C,T,36379051,8618,36191061,36584277,187990
6,ENSG00000010030.9,36387669,6-36379051-C-G,rs16888237,-1,C,G,36379051,8618,36191061,36584277,187990
6,ENSG00000112210.6,57222307,6-57211754-G-C,rs16888392,-1,G,C,57211754,10553,57025699,57418915,186055
6,ENSG00000112210.6,57222307,6-57211754-G-A,rs16888392,-1,G,A,57211754,10553,57025699,57418915,186055
6,ENSG00000124772.7,36839444,6-36869665-A-G,rs16889215,-1,A,G,36869665,30221,36642836,37036052,226829
6,ENSG00000124635.6,27132795,6-27162377-T-C,rs16894520,-1,T,C,27162377,29582,26936187,27329403,226190
6,ENSG00000188107.8,65707226,6-65806299-C-T,rs16897203,-1,C,T,65806299,99073,65510618,65903834,295681
6,ENSG00000071242.7,166627251,6-166634458-T-C,rs16899273,-1,T,C,166634458,7207,166430643,166823859,203815
6,ENSG00000197442.7,136792477,6-136937336-C-T,rs17053708,-1,C,T,136937336,144859,136595869,136989085,341467
6,ENSG00000169976.5,144095573,6-144087998-G-A,rs17073338,-1,G,A,144087998,7575,143898965,144292181,189033
6,ENSG00000146350.9,121334480,6-121298055-T-C,rs17083385,-1,T,C,121298055,36425,121137872,121531088,160183
6,ENSG00000096696.8,7541671,6-7537775-G-A,rs17142963,1,G,A,7537775,3896,7345063,7738279,192712
6,ENSG00000096696.8,7541671,6-7537775-G-T,rs17142963,1,G,T,7537775,3896,7345063,7738279,192712
6,ENSG00000203872.5,87344813,6-87330150-G-A,rs1746444,1,G,A,87330150,14663,87148205,87541421,181945
6,ENSG00000203872.5,87344813,6-87330150-G-C,rs1746444,1,G,C,87330150,14663,87148205,87541421,181945
6,ENSG00000153989.7,117675469,6-117560442-A-G,rs1759,1,A,G,117560442,115027,117478861,117872077,81581
6,ENSG00000153989.7,117675469,6-117560442-A-T,rs1759,1,A,T,117560442,115027,117478861,117872077,81581
6,ENSG00000111981.3,149963943,6-149943490-C-T,rs17748581,1,C,T,149943490,20453,149767335,150160551,176155
6,ENSG00000111981.3,149963943,6-149943490-C-G,rs17748581,1,C,G,149943490,20453,149767335,150160551,176155
6,ENSG00000111981.3,149963943,6-149943490-C-A,rs17748581,1,C,A,149943490,20453,149767335,150160551,176155
6,ENSG00000096654.10,27473105,6-27382602-A-C,rs1883404,-1,A,C,27382602,90503,27276497,27669713,106105
6,ENSG00000096654.10,27473105,6-27382602-A-T,rs1883404,-1,A,T,27382602,90503,27276497,27669713,106105
6,ENSG00000112294.8,24494969,6-24491247-A-C,rs1883415,1,A,C,24491247,3722,24298361,24691577,192886
6,ENSG00000124570.11,2971567,6-2932762-G-C,rs1885294,-1,G,C,2932762,38805,2774959,3168175,157803
6,ENSG00000145949.8,2750922,6-2932762-G-C,rs1885294,-1,G,C,2932762,181840,2554314,2947530,378448
6,ENSG00000137269.9,53795005,6-53618857-T-G,rs188664917,1,T,G,53618857,176148,53598397,53991613,20460
6,ENSG00000146373.11,124962437,6-124932492-A-G,rs1889437,1,A,G,124932492,29945,124765829,125159045,166663
6,ENSG00000146243.8,78867551,6-79011692-C-A,rs1933238,1,C,A,79011692,144141,78670943,79064159,340749
6,ENSG00000172738.7,37258122,6-37284953-G-C,rs195751,-1,G,C,37284953,26831,37061514,37454730,223439
6,ENSG00000172738.7,37258122,6-37284953-G-A,rs195751,-1,G,A,37284953,26831,37061514,37454730,223439
6,ENSG00000196126.6,32589848,6-32481634-T-C,rs1964995,-1,T,C,32481634,108214,32393240,32786456,88394
6,ENSG00000196126.6,32589848,6-32481634-T-A,rs1964995,-1,T,A,32481634,108214,32393240,32786456,88394
6,ENSG00000196126.6,32589848,6-32481634-T-G,rs1964995,-1,T,G,32481634,108214,32393240,32786456,88394
6,ENSG00000112685.8,693139,6-669506-A-G,rs1970338,-1,A,G,669506,23633,496531,889747,172975
6,ENSG00000112685.8,693139,6-669506-A-C,rs1970338,-1,A,C,669506,23633,496531,889747,172975
6,ENSG00000112685.8,693139,6-669506-A-T,rs1970338,-1,A,T,669506,23633,496531,889747,172975
6,ENSG00000180596.6,26123926,6-26113112-T-C,rs198838,-1,T,C,26113112,10814,25927318,26320534,185794
6,ENSG00000180596.6,26123926,6-26113112-T-A,rs198838,-1,T,A,26113112,10814,25927318,26320534,185794
6,ENSG00000010704.13,26087429,6-25981420-A-G,rs199757,1,A,G,25981420,106009,25890821,26284037,90599
6,ENSG00000130348.7,106629578,6-106629627-G-A,rs2054365,1,G,A,106629627,49,106432970,106826186,196657
6,ENSG00000180573.7,26124172,6-26091108-T-C,rs2071303,1,T,C,26091108,33064,25927564,26320780,163544
6,ENSG00000204264.4,32844047,6-32843868-A-G,rs2071542,-1,A,G,32843868,179,32647439,33040655,196429
6,ENSG00000030110.7,33580276,6-33572432-A-G,rs210134,-1,A,G,33572432,7844,33383668,33776884,188764
6,ENSG00000030110.7,33580276,6-33572432-A-T,rs210134,-1,A,T,33572432,7844,33383668,33776884,188764
6,ENSG00000137218.6,41779900,6-41655295-G-T,rs2143678,-1,G,T,41655295,124605,41583292,41976508,72003
6,ENSG00000164414.11,87472974,6-87470923-A-T,rs2207146,1,A,T,87470923,2051,87276366,87669582,194557
6,ENSG00000164414.11,87472974,6-87470923-A-G,rs2207146,1,A,G,87470923,2051,87276366,87669582,194557
6,ENSG00000187189.9,116254075,6-116254113-T-C,rs2232466,-1,T,C,116254113,38,116057467,116450683,196646
6,ENSG00000187189.9,116254075,6-116254113-T-G,rs2232466,-1,T,G,116254113,38,116057467,116450683,196646
6,ENSG00000124608.4,44313347,6-44266184-C-T,rs2233424,-1,C,T,44266184,47163,44116739,44509955,149445
6,ENSG00000124608.4,44313347,6-44266184-C-G,rs2233424,-1,C,G,44266184,47163,44116739,44509955,149445
6,ENSG00000124608.4,44313347,6-44266184-C-A,rs2233424,-1,C,A,44266184,47163,44116739,44509955,149445
6,ENSG00000196230.7,30720352,6-30611538-C-T,rs2252745,1,C,T,30611538,108814,30523744,30916960,87794
6,ENSG00000204472.7,31615234,6-31616050-T-A,rs2259571,1,T,A,31616050,816,31418626,31811842,197424
6,ENSG00000204472.7,31615234,6-31616050-T-G,rs2259571,1,T,G,31616050,816,31418626,31811842,197424
6,ENSG00000171611.4,42916053,6-42965788-C-T,rs2274515,1,C,T,42965788,49735,42719445,43112661,246343
6,ENSG00000074935.7,112087482,6-112054441-G-A,rs2280153,-1,G,A,112054441,33041,111890874,112284090,163567
6,ENSG00000135336.8,87590135,6-87530329-T-C,rs2295085,1,T,C,87530329,59806,87393527,87786743,136802
6,ENSG00000112357.7,136822592,6-136845512-A-G,rs2295592,1,A,G,136845512,22920,136625984,137019200,219528
6,ENSG00000154548.8,89118071,6-89158568-G-A,rs2297308,-1,G,A,89158568,40497,88921463,89314679,237105
6,ENSG00000154548.8,89118071,6-89158568-G-T,rs2297308,-1,G,T,89158568,40497,88921463,89314679,237105
6,ENSG00000124532.9,24402936,6-24426731-G-T,rs2298059,1,G,T,24426731,23795,24206328,24599544,220403
6,ENSG00000137338.4,28281572,6-28414975-C-T,rs2394098,1,C,T,28414975,133403,28084964,28478180,330011
6,ENSG00000124713.5,42960754,6-42972935-A-G,rs2395943,1,A,G,42972935,12181,42764146,43157362,208789
6,ENSG00000124713.5,42960754,6-42972935-A-C,rs2395943,1,A,C,42972935,12181,42764146,43157362,208789
6,ENSG00000096092.5,52671113,6-52667174-C-T,rs2397098,1,C,T,52667174,3939,52474505,52867721,192669
6,ENSG00000031691.5,49463370,6-49492265-A-G,rs2501968,1,A,G,49492265,28895,49266762,49659978,225503
6,ENSG00000031691.5,49463370,6-49492265-A-C,rs2501968,1,A,C,49492265,28895,49266762,49659978,225503
6,ENSG00000031691.5,49463370,6-49492265-A-T,rs2501968,1,A,T,49492265,28895,49266762,49659978,225503
6,ENSG00000244694.3,48111197,6-48258797-T-C,rs2503672,-1,T,C,48258797,147600,47914589,48307805,344208
6,ENSG00000244694.3,48111197,6-48258797-T-A,rs2503672,-1,T,A,48258797,147600,47914589,48307805,344208
6,ENSG00000204516.5,31498145,6-31513522-A-G,rs2516399,1,A,G,31513522,15377,31301537,31694753,211985
6,ENSG00000198563.8,31542003,6-31450245-A-G,rs2596457,-1,A,G,31450245,91758,31345395,31738611,104850
6,ENSG00000204267.8,32838739,6-32820930-A-G,rs2621323,-1,A,G,32820930,17809,32642131,33035347,178799
6,ENSG00000204267.8,32838739,6-32820930-A-C,rs2621323,-1,A,C,32820930,17809,32642131,33035347,178799
6,ENSG00000154079.5,70566930,6-70600428-A-G,rs2691505,1,A,G,70600428,33498,70370322,70763538,230106
6,ENSG00000203734.6,138796087,6-138916507-G-A,rs2698741,1,G,A,138916507,120420,138599479,138992695,317028
6,ENSG00000204427.7,31703324,6-31777507-C-T,rs2736426,-1,C,T,31777507,74183,31506716,31899932,270791
6,ENSG00000124562.5,34757505,6-34687223-C-T,rs2744961,1,C,T,34687223,70282,34560897,34954113,126326
6,ENSG00000008083.8,15246069,6-15092434-G-C,rs2747507,1,G,C,15092434,153635,15049461,15442677,42973
6,ENSG00000008083.8,15246069,6-15092434-G-A,rs2747507,1,G,A,15092434,153635,15049461,15442677,42973
6,ENSG00000008083.8,15246069,6-15092434-G-T,rs2747507,1,G,T,15092434,153635,15049461,15442677,42973
6,ENSG00000175048.11,157381190,6-157388857-T-C,rs2749668,1,T,C,157388857,7667,157184582,157577798,204275
6,ENSG00000175048.11,157381190,6-157388857-T-G,rs2749668,1,T,G,157388857,7667,157184582,157577798,204275
6,ENSG00000175048.11,157381190,6-157388857-T-A,rs2749668,1,T,A,157388857,7667,157184582,157577798,204275
6,ENSG00000080546.9,109094846,6-108925931-T-A,rs2754822,-1,T,A,108925931,168915,108898238,109291454,27693
6,ENSG00000080546.9,109094846,6-108925931-T-C,rs2754822,-1,T,C,108925931,168915,108898238,109291454,27693
6,ENSG00000120437.7,159762045,6-159736872-C-T,rs2842972,1,C,T,159736872,25173,159565437,159958653,171435
6,ENSG00000204248.5,33192467,6-33171178-G-T,rs2855437,-1,G,T,33171178,21289,32995859,33389075,175319
6,ENSG00000204248.5,33192467,6-33171178-G-A,rs2855437,-1,G,A,33171178,21289,32995859,33389075,175319
6,ENSG00000204248.5,33192467,6-33171178-G-C,rs2855437,-1,G,C,33171178,21289,32995859,33389075,175319
6,ENSG00000223865.4,33075990,6-33078305-C-T,rs2856819,1,C,T,33078305,2315,32879382,33272598,198923
6,ENSG00000223865.4,33075990,6-33078305-C-A,rs2856819,1,C,A,33078305,2315,32879382,33272598,198923
6,ENSG00000185127.5,169702190,6-169830086-A-G,rs2864054,1,A,G,169830086,127896,169505582,169898798,324504
6,ENSG00000185127.5,169702190,6-169830086-A-C,rs2864054,1,A,C,169830086,127896,169505582,169898798,324504
6,ENSG00000026950.12,26402275,6-26430753-A-G,rs2893848,1,A,G,26430753,28478,26205667,26598883,225086
6,ENSG00000146112.6,30686645,6-30707828-T-G,rs28986467,-1,T,G,30707828,21183,30490037,30883253,217791
6,ENSG00000204228.3,33204655,6-33131119-C-G,rs3129267,1,C,G,33131119,73536,33008047,33401263,123072
6,ENSG00000204228.3,33204655,6-33131119-C-A,rs3129267,1,C,A,33131119,73536,33008047,33401263,123072
6,ENSG00000204257.8,32953097,6-33129837-C-A,rs3129269,-1,C,A,33129837,176740,32756489,33149705,373348
6,ENSG00000204257.8,32953097,6-33129837-C-T,rs3129269,-1,C,T,33129837,176740,32756489,33149705,373348
6,ENSG00000236104.2,33317744,6-33346316-T-A,rs3130104,-1,T,A,33346316,28572,33121136,33514352,225180
6,ENSG00000236104.2,33317744,6-33346316-T-C,rs3130104,-1,T,C,33346316,28572,33121136,33514352,225180
6,ENSG00000235863.1,33277123,6-33346316-T-A,rs3130104,1,T,A,33346316,69193,33080515,33473731,265801
6,ENSG00000235863.1,33277123,6-33346316-T-C,rs3130104,1,T,C,33346316,69193,33080515,33473731,265801
6,ENSG00000137343.12,30626874,6-30772383-G-A,rs3130666,1,G,A,30772383,145509,30430266,30823482,342117
6,ENSG00000112031.11,153002709,6-153187190-G-A,rs316289,-1,G,A,153187190,184481,152806101,153199317,381089
6,ENSG00000112031.11,153002709,6-153187190-G-C,rs316289,-1,G,C,153187190,184481,152806101,153199317,381089
6,ENSG00000112031.11,153002709,6-153187190-G-T,rs316289,-1,G,T,153187190,184481,152806101,153199317,381089
6,ENSG00000231925.6,33314078,6-33303717-T-C,rs3173275,-1,T,C,33303717,10361,33117470,33510686,186247
6,ENSG00000170542.5,2903309,6-2898362-A-G,rs318491,-1,A,G,2898362,4947,2706701,3099917,191661
6,ENSG00000170542.5,2903309,6-2898362-A-C,rs318491,-1,A,C,2898362,4947,2706701,3099917,191661
6,ENSG00000170542.5,2903309,6-2898362-A-T,rs318491,-1,A,T,2898362,4947,2706701,3099917,191661
6,ENSG00000124641.10,41921139,6-41818398-G-A,rs33954419,-1,G,A,41818398,102741,41724531,42117747,93867
6,ENSG00000124641.10,41921139,6-41818398-G-T,rs33954419,-1,G,T,41818398,102741,41724531,42117747,93867
6,ENSG00000189134.3,28259297,6-28125485-G-A,rs34304311,1,G,A,28125485,133812,28062689,28455905,62796
6,ENSG00000001561.5,46129989,6-46079721-C-T,rs3734207,1,C,T,46079721,50268,45933381,46326597,146340
6,ENSG00000001561.5,46129989,6-46079721-C-A,rs3734207,1,C,A,46079721,50268,45933381,46326597,146340
6,ENSG00000131013.3,149546043,6-149593917-C-A,rs3734295,-1,C,A,149593917,47874,149349435,149742651,244482
6,ENSG00000131013.3,149546043,6-149593917-C-T,rs3734295,-1,C,T,149593917,47874,149349435,149742651,244482
6,ENSG00000131013.3,149546043,6-149593917-C-G,rs3734295,-1,C,G,149593917,47874,149349435,149742651,244482
6,ENSG00000171462.9,43455548,6-43456041-A-G,rs3734688,-1,A,G,43456041,493,43258940,43652156,197101
6,ENSG00000112297.9,106360717,6-106519903-T-C,rs3747787,1,T,C,106519903,159186,106164109,106557325,355794
6,ENSG00000111802.8,24666899,6-24665112-A-C,rs3756819,-1,A,C,24665112,1787,24470291,24863507,194821
6,ENSG00000124678.12,35141339,6-35142928-A-G,rs3756856,-1,A,G,35142928,1589,34944731,35337947,198197
6,ENSG00000196284.9,45377934,6-45379907-G-A,rs3763190,-1,G,A,45379907,1973,45181326,45574542,198581
6,ENSG00000146426.12,154995315,6-155150320-C-T,rs3792958,1,C,T,155150320,155005,154798707,155191923,351613
6,ENSG00000146426.12,154995315,6-155150320-C-A,rs3792958,1,C,A,155150320,155005,154798707,155191923,351613
6,ENSG00000112655.10,43076314,6-43098175-A-G,rs3793017,1,A,G,43098175,21861,42879706,43272922,218469
6,ENSG00000112655.10,43076314,6-43098175-A-C,rs3793017,1,A,C,43098175,21861,42879706,43272922,218469
6,ENSG00000137274.8,3118711,6-3150281-C-A,rs3799216,1,C,A,3150281,31570,2922103,3315319,228178
6,ENSG00000137274.8,3118711,6-3150281-C-T,rs3799216,1,C,T,3150281,31570,2922103,3315319,228178
6,ENSG00000146410.7,136250311,6-136348413-G-A,rs3799403,-1,G,A,136348413,98102,136053703,136446919,294710
6,ENSG00000124615.12,39934462,6-39934461-C-G,rs3800349,-1,C,G,39934461,1,39737854,40131070,196607
6,ENSG00000124615.12,39934462,6-39934461-C-T,rs3800349,-1,C,T,39934461,1,39737854,40131070,196607
6,ENSG00000146085.6,49463253,6-49463856-A-C,rs3806988,-1,A,C,49463856,603,49266645,49659861,197211
6,ENSG00000146085.6,49463253,6-49463856-A-G,rs3806988,-1,A,G,49463856,603,49266645,49659861,197211
6,ENSG00000204252.7,33009591,6-33009643-G-T,rs381218,-1,G,T,33009643,52,32812983,33206199,196660
6,ENSG00000237541.3,32741391,6-32668032-T-C,rs3828790,1,T,C,32668032,73359,32544783,32937999,123249
6,ENSG00000237541.3,32741391,6-32668032-T-A,rs3828790,1,T,A,32668032,73359,32544783,32937999,123249
6,ENSG00000237541.3,32741391,6-32668032-T-G,rs3828790,1,T,G,32668032,73359,32544783,32937999,123249
6,ENSG00000047932.9,117602511,6-117546888-T-G,rs389663,-1,T,G,117546888,55623,117405903,117799119,140985
6,ENSG00000047932.9,117602511,6-117546888-T-C,rs389663,-1,T,C,117546888,55623,117405903,117799119,140985
6,ENSG00000145979.11,13328537,6-13296207-C-T,rs402705,-1,C,T,13296207,32330,13131929,13525145,164278
6,ENSG00000146281.5,89146055,6-89154960-A-G,rs4053639,1,A,G,89154960,8905,88949447,89342663,205513
6,ENSG00000124575.5,26234987,6-26409662-G-A,rs41266839,-1,G,A,26409662,174675,26038379,26431595,371283
6,ENSG00000124575.5,26234987,6-26409662-G-C,rs41266839,-1,G,C,26409662,174675,26038379,26431595,371283
6,ENSG00000197261.7,49550668,6-49551456-T-C,rs41273692,1,T,C,49551456,788,49354060,49747276,197396
6,ENSG00000112280.11,70303084,6-70280967-G-A,rs41303785,-1,G,A,70280967,22117,70106476,70499692,174491
6,ENSG00000112619.6,42722597,6-42700666-T-C,rs422717,-1,T,C,42700666,21931,42525989,42919205,174677
6,ENSG00000112619.6,42722597,6-42700666-T-A,rs422717,-1,T,A,42700666,21931,42525989,42919205,174677
6,ENSG00000112619.6,42722597,6-42700666-T-G,rs422717,-1,T,G,42700666,21931,42525989,42919205,174677
6,ENSG00000122194.12,160702244,6-160741374-T-C,rs4252170,1,T,C,160741374,39130,160505636,160898852,235738
6,ENSG00000172469.9,95577535,6-95613505-G-A,rs4379299,1,G,A,95613505,35970,95380927,95774143,232578
6,ENSG00000124491.9,6320662,6-6381296-C-T,rs4395776,-1,C,T,6381296,60634,6124054,6517270,257242
6,ENSG00000198478.6,79631329,6-79598469-C-A,rs4413576,1,C,A,79598469,32860,79434721,79827937,163748
6,ENSG00000135318.6,85450083,6-85448787-T-C,rs4458647,1,T,C,85448787,1296,85253475,85646691,195312
6,ENSG00000083123.8,80106671,6-79971524-G-T,rs4541708,1,G,T,79971524,135147,79910063,80303279,61461
6,ENSG00000083123.8,80106671,6-79971524-G-C,rs4541708,1,G,C,79971524,135147,79910063,80303279,61461
6,ENSG00000112308.7,24719154,6-24677760-C-T,rs4544900,-1,C,T,24677760,41394,24522546,24915762,155214
6,ENSG00000112514.10,33418107,6-33284559-G-A,rs467508,-1,G,A,33284559,133548,33221499,33614715,63060
6,ENSG00000112514.10,33418107,6-33284559-G-C,rs467508,-1,G,C,33284559,133548,33221499,33614715,63060
6,ENSG00000118432.11,88166347,6-88179497-C-A,rs4707437,-1,C,A,88179497,13150,87969739,88362955,209758
6,ENSG00000118432.11,88166347,6-88179497-C-G,rs4707437,-1,C,G,88179497,13150,87969739,88362955,209758
6,ENSG00000118432.11,88166347,6-88179497-C-T,rs4707437,-1,C,T,88179497,13150,87969739,88362955,209758
6,ENSG00000124721.13,38715311,6-38755650-A-C,rs4714178,1,A,C,38755650,40339,38518703,38911919,236947
6,ENSG00000124721.13,38715311,6-38755650-A-G,rs4714178,1,A,G,38755650,40339,38518703,38911919,236947
6,ENSG00000112576.8,41941808,6-42023203-T-C,rs4714551,-1,T,C,42023203,81395,41745200,42138416,278003
6,ENSG00000112576.8,41941808,6-42023203-T-A,rs4714551,-1,T,A,42023203,81395,41745200,42138416,278003
6,ENSG00000112576.8,41941808,6-42023203-T-G,rs4714551,-1,T,G,42023203,81395,41745200,42138416,278003
6,ENSG00000112599.7,42194956,6-42206740-A-T,rs4714579,-1,A,T,42206740,11784,41998348,42391564,208392
6,ENSG00000112599.7,42194956,6-42206740-A-G,rs4714579,-1,A,G,42206740,11784,41998348,42391564,208392
6,ENSG00000112599.7,42194956,6-42206740-A-C,rs4714579,-1,A,C,42206740,11784,41998348,42391564,208392
6,ENSG00000112640.9,42984570,6-43154631-G-C,rs4714669,1,G,C,43154631,170061,42787962,43181178,366669
6,ENSG00000112640.9,42984570,6-43154631-G-T,rs4714669,1,G,T,43154631,170061,42787962,43181178,366669
6,ENSG00000112640.9,42984570,6-43154631-G-A,rs4714669,1,G,A,43154631,170061,42787962,43181178,366669
6,ENSG00000024862.11,138773769,6-138710785-G-C,rs4895537,1,G,C,138710785,62984,138577161,138970377,133624
6,ENSG00000024862.11,138773769,6-138710785-G-T,rs4895537,1,G,T,138710785,62984,138577161,138970377,133624
6,ENSG00000146411.5,134052624,6-133992919-T-G,rs4896019,-1,T,G,133992919,59705,133856016,134249232,136903
6,ENSG00000146411.5,134052624,6-133992919-T-C,rs4896019,-1,T,C,133992919,59705,133856016,134249232,136903
6,ENSG00000146416.10,143060889,6-143062971-C-T,rs4896620,1,C,T,143062971,2082,142864281,143257497,198690
6,ENSG00000180822.7,3258947,6-3251901-C-A,rs4959782,1,C,A,3251901,7046,3062339,3455555,189562
6,ENSG00000124587.9,42979181,6-42963486-G-A,rs4987173,-1,G,A,42963486,15695,42782573,43175789,180913
6,ENSG00000204525.8,31272092,6-31273255-A-G,rs5010528,-1,A,G,31273255,1163,31075484,31468700,197771
6,ENSG00000135297.10,73461737,6-73620580-G-A,rs506262,1,G,A,73620580,158843,73265129,73658345,355451
6,ENSG00000135297.10,73461737,6-73620580-G-T,rs506262,1,G,T,73620580,158843,73265129,73658345,355451
6,ENSG00000112697.10,75284792,6-75224357-A-G,rs542717,-1,A,G,75224357,60435,75088184,75481400,136173
6,ENSG00000112697.10,75284792,6-75224357-A-C,rs542717,-1,A,C,75224357,60435,75088184,75481400,136173
6,ENSG00000213654.5,32192643,6-32237295-C-T,rs549270,-1,C,T,32237295,44652,31996035,32389251,241260
6,ENSG00000124657.1,27957241,6-27892756-C-G,rs58106751,1,C,G,27892756,64485,27760633,28153849,132123
6,ENSG00000124657.1,27957241,6-27892756-C-T,rs58106751,1,C,T,27892756,64485,27760633,28153849,132123
6,ENSG00000124657.1,27957241,6-27892756-C-A,rs58106751,1,C,A,27892756,64485,27760633,28153849,132123
6,ENSG00000164458.5,166167851,6-166287023-G-C,rs58377461,-1,G,C,166287023,119172,165971243,166364459,315780
6,ENSG00000164458.5,166167851,6-166287023-G-A,rs58377461,-1,G,A,166287023,119172,165971243,166364459,315780
6,ENSG00000164442.7,139374648,6-139519556-A-C,rs592423,-1,A,C,139519556,144908,139178040,139571256,341516
6,ENSG00000145982.5,5261513,6-5386284-G-A,rs59355030,1,G,A,5386284,124771,5064905,5458121,321379
6,ENSG00000176381.4,166308392,6-166287287-C-A,rs61137892,-1,C,A,166287287,21105,166111784,166505000,175503
6,ENSG00000176381.4,166308392,6-166287287-C-G,rs61137892,-1,C,G,166287287,21105,166111784,166505000,175503
6,ENSG00000204227.4,33208500,6-33194763-C-T,rs61669264,1,C,T,33194763,13737,33011892,33405108,182871
6,ENSG00000204227.4,33208500,6-33194763-C-G,rs61669264,1,C,G,33194763,13737,33011892,33405108,182871
6,ENSG00000044090.4,43053851,6-43046284-G-T,rs61732148,-1,G,T,43046284,7567,42857243,43250459,189041
6,ENSG00000044090.4,43053851,6-43046284-G-A,rs61732148,-1,G,A,43046284,7567,42857243,43250459,189041
6,ENSG00000197903.6,27146855,6-27309831-A-G,rs61736084,-1,A,G,27309831,162976,26950247,27343463,359584
6,ENSG00000184465.11,169702029,6-169647806-T-A,rs61740334,-1,T,A,169647806,54223,169505421,169898637,142385
6,ENSG00000184465.11,169702029,6-169647806-T-G,rs61740334,-1,T,G,169647806,54223,169505421,169898637,142385
6,ENSG00000137265.9,391752,6-421281-G-A,rs62389423,1,G,A,421281,29529,195144,588360,226137
6,ENSG00000137265.9,391752,6-421281-G-T,rs62389423,1,G,T,421281,29529,195144,588360,226137
6,ENSG00000021355.7,2841863,6-2940506-C-T,rs62391543,-1,C,T,2940506,98643,2645255,3038471,295251
6,ENSG00000124535.10,2765393,6-2940506-C-T,rs62391543,1,C,T,2940506,175113,2568785,2962001,371721
6,ENSG00000111845.4,10694972,6-10661131-C-G,rs62397698,1,C,G,10661131,33841,10498364,10891580,162767
6,ENSG00000111845.4,10694972,6-10661131-C-T,rs62397698,1,C,T,10661131,33841,10498364,10891580,162767
6,ENSG00000204569.4,30617243,6-30537223-T-C,rs62407243,-1,T,C,30537223,80020,30420635,30813851,116588
6,ENSG00000146247.11,79078254,6-79172917-T-A,rs62411266,-1,T,A,79172917,94663,78881646,79274862,291271
6,ENSG00000124733.3,43013946,6-43164190-C-T,rs62417512,-1,C,T,43164190,150244,42817338,43210554,346852
6,ENSG00000124733.3,43013946,6-43164190-C-A,rs62417512,-1,C,A,43164190,150244,42817338,43210554,346852
6,ENSG00000164440.10,139291998,6-139270754-T-C,rs62441202,-1,T,C,139270754,21244,139095390,139488606,175364
6,ENSG00000111846.11,10521351,6-10528201-A-T,rs631299,1,A,T,10528201,6850,10324743,10717959,203458
6,ENSG00000111846.11,10521351,6-10528201-A-G,rs631299,1,A,G,10528201,6850,10324743,10717959,203458
6,ENSG00000111846.11,10521351,6-10528201-A-C,rs631299,1,A,C,10528201,6850,10324743,10717959,203458
6,ENSG00000137203.6,10415074,6-10345338-G-C,rs6456402,-1,G,C,10345338,69736,10218466,10611682,126872
6,ENSG00000137203.6,10415074,6-10345338-G-A,rs6456402,-1,G,A,10345338,69736,10218466,10611682,126872
6,ENSG00000065491.8,37257772,6-37275165-G-T,rs6457986,1,G,T,37275165,17393,37061164,37454380,214001
6,ENSG00000065491.8,37257772,6-37275165-G-C,rs6457986,1,G,C,37275165,17393,37061164,37454380,214001
6,ENSG00000065491.8,37257772,6-37275165-G-A,rs6457986,1,G,A,37275165,17393,37061164,37454380,214001
6,ENSG00000078401.6,12290361,6-12261688-T-C,rs6458155,1,T,C,12261688,28673,12093753,12486969,167935
6,ENSG00000078401.6,12290361,6-12261688-T-G,rs6458155,1,T,G,12261688,28673,12093753,12486969,167935
6,ENSG00000198721.8,4135575,6-4109359-C-G,rs649725,-1,C,G,4109359,26216,3938967,4332183,170392
6,ENSG00000198721.8,4135575,6-4109359-C-T,rs649725,-1,C,T,4109359,26216,3938967,4332183,170392
6,ENSG00000198721.8,4135575,6-4109359-C-A,rs649725,-1,C,A,4109359,26216,3938967,4332183,170392
6,ENSG00000146386.7,139028745,6-139033345-G-A,rs6570301,1,G,A,139033345,4600,138832137,139225353,201208
6,ENSG00000178199.9,149485014,6-149370219-T-G,rs6570963,-1,T,G,149370219,114795,149288406,149681622,81813
6,ENSG00000153162.7,7726099,6-7684391-T-C,rs6597279,1,T,C,7684391,41708,7529491,7922707,154900
6,ENSG00000153162.7,7726099,6-7684391-T-G,rs6597279,1,T,G,7684391,41708,7529491,7922707,154900
6,ENSG00000137251.9,54308441,6-54307667-A-C,rs682088,1,A,C,54307667,774,54111833,54505049,195834
6,ENSG00000137251.9,54308441,6-54307667-A-G,rs682088,1,A,G,54307667,774,54111833,54505049,195834
6,ENSG00000137364.4,18155077,6-18204114-T-G,rs6902280,-1,T,G,18204114,49037,17958469,18351685,245645
6,ENSG00000232629.4,32763532,6-32658534-T-C,rs6906021,-1,T,C,32658534,104998,32566924,32960140,91610
6,ENSG00000153157.8,10887052,6-10902206-A-G,rs6910232,1,A,G,10902206,15154,10690444,11083660,211762
6,ENSG00000170915.8,52362151,6-52348212-A-T,rs6912417,1,A,T,52348212,13939,52165543,52558759,182669
6,ENSG00000170915.8,52362151,6-52348212-A-C,rs6912417,1,A,C,52348212,13939,52165543,52558759,182669
6,ENSG00000170915.8,52362151,6-52348212-A-G,rs6912417,1,A,G,52348212,13939,52165543,52558759,182669
6,ENSG00000135604.9,144150517,6-144191852-C-T,rs6912580,1,C,T,144191852,41335,143953909,144347125,237943
6,ENSG00000135604.9,144150517,6-144191852-C-A,rs6912580,1,C,A,144191852,41335,143953909,144347125,237943
6,ENSG00000196787.2,27133043,6-27028352-C-G,rs6913271,1,C,G,27028352,104691,26936435,27329651,91917
6,ENSG00000112081.10,36594362,6-36630432-G-A,rs6913530,1,G,A,36630432,36070,36397754,36790970,232678
6,ENSG00000112081.10,36594362,6-36630432-G-C,rs6913530,1,G,C,36630432,36070,36397754,36790970,232678
6,ENSG00000135334.7,87702233,6-87800691-C-G,rs6914106,-1,C,G,87800691,98458,87505625,87898841,295066
6,ENSG00000135334.7,87702233,6-87800691-C-T,rs6914106,-1,C,T,87800691,98458,87505625,87898841,295066
6,ENSG00000137198.5,16238587,6-16280956-C-A,rs6914805,1,C,A,16280956,42369,16041979,16435195,238977
6,ENSG00000137198.5,16238587,6-16280956-C-T,rs6914805,1,C,T,16280956,42369,16041979,16435195,238977
6,ENSG00000137198.5,16238587,6-16280956-C-G,rs6914805,1,C,G,16280956,42369,16041979,16435195,238977
6,ENSG00000158406.2,26285534,6-26288894-A-T,rs6916289,-1,A,T,26288894,3360,26088926,26482142,199968
6,ENSG00000158406.2,26285534,6-26288894-A-C,rs6916289,-1,A,C,26288894,3360,26088926,26482142,199968
6,ENSG00000112146.10,53065404,6-53206551-G-A,rs6917666,1,G,A,53206551,141147,52868796,53262012,337755
6,ENSG00000146166.11,63319983,6-63429951-G-A,rs6919709,-1,G,A,63429951,109968,63123375,63516591,306576
6,ENSG00000146166.11,63319983,6-63429951-G-T,rs6919709,-1,G,T,63429951,109968,63123375,63516591,306576
6,ENSG00000196911.5,116681211,6-116513921-T-C,rs6919880,1,T,C,116513921,167290,116484603,116877819,29318
6,ENSG00000146278.9,89080751,6-89053992-A-G,rs6921997,1,A,G,89053992,26759,88884143,89277359,169849
6,ENSG00000146278.9,89080751,6-89053992-A-T,rs6921997,1,A,T,89053992,26759,88884143,89277359,169849
6,ENSG00000146278.9,89080751,6-89053992-A-C,rs6921997,1,A,C,89053992,26759,88884143,89277359,169849
6,ENSG00000085382.7,104859919,6-104900830-C-T,rs6923490,-1,C,T,104900830,40911,104663311,105056527,237519
6,ENSG00000112290.8,110179670,6-110146843-A-G,rs6927697,-1,A,G,110146843,32827,109983062,110376278,163781
6,ENSG00000112290.8,110179670,6-110146843-A-C,rs6927697,-1,A,C,110146843,32827,109983062,110376278,163781
6,ENSG00000240065.2,32854192,6-32858673-T-G,rs6930981,1,T,G,32858673,4481,32657584,33050800,201089
6,ENSG00000240065.2,32854192,6-32858673-T-C,rs6930981,1,T,C,32858673,4481,32657584,33050800,201089
6,ENSG00000164627.12,39725408,6-39715158-T-C,rs6933563,-1,T,C,39715158,10250,39528800,39922016,186358
6,ENSG00000112139.9,37697883,6-37704146-T-G,rs6937280,-1,T,G,37704146,6263,37501275,37894491,202871
6,ENSG00000112139.9,37697883,6-37704146-T-A,rs6937280,-1,T,A,37704146,6263,37501275,37894491,202871
6,ENSG00000065029.9,35259735,6-35229693-G-A,rs6938138,1,G,A,35229693,30042,35063127,35456343,166566
6,ENSG00000023892.8,35297818,6-35312920-C-A,rs6938946,1,C,A,35312920,15102,35101210,35494426,211710
6,ENSG00000023892.8,35297818,6-35312920-C-T,rs6938946,1,C,T,35312920,15102,35101210,35494426,211710
6,ENSG00000007944.10,16129086,6-16037321-C-T,rs6941340,1,C,T,16037321,91765,15932478,16325694,104843
6,ENSG00000007944.10,16129086,6-16037321-C-G,rs6941340,1,C,G,16037321,91765,15932478,16325694,104843
6,ENSG00000146282.12,87589987,6-87661239-C-A,rs715207,-1,C,A,87661239,71252,87393379,87786595,267860
6,ENSG00000130347.8,106629498,6-106761984-A-G,rs71574210,-1,A,G,106761984,132486,106432890,106826106,329094
6,ENSG00000214338.6,127519191,6-127460675-T-C,rs723642,-1,T,C,127460675,58516,127322583,127715799,138092
6,ENSG00000124588.13,2999894,6-2937256-A-G,rs72838699,1,A,G,2937256,62638,2803286,3196502,133970
6,ENSG00000146192.9,37005655,6-37010687-A-G,rs72848057,1,A,G,37010687,5032,36809047,37202263,201640
6,ENSG00000178409.9,107115515,6-107057933-C-T,rs72935728,-1,C,T,107057933,57582,106918907,107312123,139026
6,ENSG00000156508.12,73521032,6-73705309-C-T,rs72953378,-1,C,T,73705309,184277,73324424,73717640,380885
6,ENSG00000189007.9,143450695,6-143441609-C-T,rs72988635,-1,C,T,143441609,9086,143254087,143647303,187522
6,ENSG00000118495.12,144008259,6-144090201-G-A,rs73008259,-1,G,A,144090201,81942,143811651,144204867,278550
6,ENSG00000189298.6,28349947,6-28369695-T-G,rs73401666,1,T,G,28369695,19748,28153339,28546555,216356
6,ENSG00000137434.7,10694616,6-10694492-A-G,rs73439094,-1,A,G,10694492,124,10498008,10891224,196484
6,ENSG00000112249.9,100881329,6-100999267-C-T,rs75039186,-1,C,T,100999267,117938,100684721,101077937,314546
6,ENSG00000112667.8,43229481,6-43220435-A-G,rs75187159,-1,A,G,43220435,9046,43032873,43426089,187562
6,ENSG00000124767.5,38703145,6-38676020-C-T,rs7604,-1,C,T,38676020,27125,38506537,38899753,169483
6,ENSG00000135525.12,136550422,6-136588526-T-C,rs760862,-1,T,C,136588526,38104,136353814,136747030,234712
6,ENSG00000135525.12,136550422,6-136588526-T-A,rs760862,-1,T,A,136588526,38104,136353814,136747030,234712
6,ENSG00000146242.5,82363817,6-82356171-G-T,rs770898,1,G,T,82356171,7646,82167209,82560425,188962
6,ENSG00000146242.5,82363817,6-82356171-G-A,rs770898,1,G,A,82356171,7646,82167209,82560425,188962
6,ENSG00000152818.12,144285335,6-144293730-T-C,rs7740792,1,T,C,144293730,8395,144088727,144481943,205003
6,ENSG00000112195.8,41201149,6-41284483-G-A,rs7742256,-1,G,A,41284483,83334,41004541,41397757,279942
6,ENSG00000001036.8,143511720,6-143513413-A-T,rs7743944,-1,A,T,143513413,1693,143315112,143708328,198301
6,ENSG00000111886.8,89315299,6-89317075-A-G,rs7744352,-1,A,G,89317075,1776,89118691,89511907,198384
6,ENSG00000111886.8,89315299,6-89317075-A-T,rs7744352,-1,A,T,89317075,1776,89118691,89511907,198384
6,ENSG00000189367.9,127459389,6-127519665-A-G,rs7749831,-1,A,G,127519665,60276,127262781,127655997,256884
6,ENSG00000189367.9,127459389,6-127519665-A-C,rs7749831,-1,A,C,127519665,60276,127262781,127655997,256884
6,ENSG00000135541.15,135497740,6-135506535-A-G,rs7750586,-1,A,G,135506535,8795,135301132,135694348,205403
6,ENSG00000096060.8,35688915,6-35727497-G-A,rs7751693,-1,G,A,35727497,38582,35492307,35885523,235190
6,ENSG00000096060.8,35688915,6-35727497-G-C,rs7751693,-1,G,C,35727497,38582,35492307,35885523,235190
6,ENSG00000155906.11,151452126,6-151440486-A-G,rs7752091,-1,A,G,151440486,11640,151255518,151648734,184968
6,ENSG00000155906.11,151452126,6-151440486-A-T,rs7752091,-1,A,T,151440486,11640,151255518,151648734,184968
6,ENSG00000065060.12,34792083,6-34754882-G-A,rs7756405,1,G,A,34754882,37201,34595475,34988691,159407
6,ENSG00000065060.12,34792083,6-34754882-G-C,rs7756405,1,G,C,34754882,37201,34595475,34988691,159407
6,ENSG00000065060.12,34792083,6-34754882-G-T,rs7756405,1,G,T,34754882,37201,34595475,34988691,159407
6,ENSG00000130024.10,169724500,6-169660291-G-A,rs7760433,-1,G,A,169660291,64209,169527892,169921108,132399
6,ENSG00000137225.8,44158820,6-44172132-C-T,rs7763358,1,C,T,44172132,13312,43962212,44355428,209920
6,ENSG00000005700.10,82247744,6-82259395-C-T,rs7763533,-1,C,T,82259395,11651,82051136,82444352,208259
6,ENSG00000051620.5,138404223,6-138389387-A-G,rs7765991,1,A,G,138389387,14836,138207615,138600831,181772
6,ENSG00000130338.8,158312465,6-158329298-A-C,rs7767022,1,A,C,158329298,16833,158115857,158509073,213441
6,ENSG00000112759.11,44223595,6-44195793-A-G,rs7768389,1,A,G,44195793,27802,44026987,44420203,168806
6,ENSG00000146221.8,44297698,6-44333169-C-A,rs7769324,-1,C,A,44333169,35471,44101090,44494306,232079
6,ENSG00000146221.8,44297698,6-44333169-C-G,rs7769324,-1,C,G,44333169,35471,44101090,44494306,232079
6,ENSG00000146221.8,44297698,6-44333169-C-T,rs7769324,-1,C,T,44333169,35471,44101090,44494306,232079
6,ENSG00000124786.8,8435545,6-8563706-T-C,rs7769697,-1,T,C,8563706,128161,8238937,8632153,324769
6,ENSG00000146425.6,158644743,6-158779375-G-A,rs77752019,-1,G,A,158779375,134632,158448135,158841351,331240
6,ENSG00000118507.11,131135467,6-131115748-G-C,rs7776083,1,G,C,131115748,19719,130938859,131332075,176889
6,ENSG00000118507.11,131135467,6-131115748-G-T,rs7776083,1,G,T,131115748,19719,130938859,131332075,176889
6,ENSG00000112096.11,159693241,6-159728147-T-C,rs78550031,-1,T,C,159728147,34906,159496633,159889849,231514
6,ENSG00000164626.8,39229475,6-39068969-C-T,rs80228310,-1,C,T,39068969,160506,39032867,39426083,36102
6,ENSG00000204428.7,31680377,6-31695180-C-T,rs805277,-1,C,T,31695180,14803,31483769,31876985,211411
6,ENSG00000204428.7,31680377,6-31695180-C-A,rs805277,-1,C,A,31695180,14803,31483769,31876985,211411
6,ENSG00000197409.6,26197286,6-26141147-C-T,rs806970,-1,C,T,26141147,56139,26000678,26393894,140469
6,ENSG00000124784.4,7389808,6-7496877-A-G,rs823695,1,A,G,7496877,107069,7193200,7586416,303677
6,ENSG00000204536.8,31157802,6-31178143-C-A,rs887464,-1,C,A,31178143,20341,30961194,31354410,216949
6,ENSG00000204536.8,31157802,6-31178143-C-T,rs887464,-1,C,T,31178143,20341,30961194,31354410,216949
6,ENSG00000065308.4,52577060,6-52546324-A-C,rs910244,-1,A,C,52546324,30736,52380452,52773668,165872
6,ENSG00000065308.4,52577060,6-52546324-A-G,rs910244,-1,A,G,52546324,30736,52380452,52773668,165872
6,ENSG00000065308.4,52577060,6-52546324-A-T,rs910244,-1,A,T,52546324,30736,52380452,52773668,165872
6,ENSG00000187987.5,28443491,6-28440481-A-G,rs916403,-1,A,G,28440481,3010,28246883,28640099,193598
6,ENSG00000187987.5,28443491,6-28440481-A-T,rs916403,-1,A,T,28440481,3010,28246883,28640099,193598
6,ENSG00000204642.7,29723434,6-29744479-G-T,rs9258224,1,G,T,29744479,21045,29526826,29920042,217653
6,ENSG00000204642.7,29723434,6-29744479-G-C,rs9258224,1,G,C,29744479,21045,29526826,29920042,217653
6,ENSG00000204642.7,29723434,6-29744479-G-A,rs9258224,1,G,A,29744479,21045,29526826,29920042,217653
6,ENSG00000137404.10,30690984,6-30777677-T-C,rs9262192,-1,T,C,30777677,86693,30494376,30887592,283301
6,ENSG00000198502.5,32530287,6-32634619-C-T,rs9272226,-1,C,T,32634619,104332,32333679,32726895,300940
6,ENSG00000198502.5,32530287,6-32634619-C-A,rs9272226,-1,C,A,32634619,104332,32333679,32726895,300940
6,ENSG00000025039.9,89412273,6-89277418-C-A,rs9294430,-1,C,A,89277418,134855,89215665,89608881,61753
6,ENSG00000025039.9,89412273,6-89277418-C-T,rs9294430,-1,C,T,89277418,134855,89215665,89608881,61753
6,ENSG00000197935.5,29005315,6-29137158-G-T,rs9295794,-1,G,T,29137158,131843,28808707,29201923,328451
6,ENSG00000197935.5,29005315,6-29137158-G-A,rs9295794,-1,G,A,29137158,131843,28808707,29201923,328451
6,ENSG00000124523.9,13574601,6-13563825-C-A,rs9296714,1,C,A,13563825,10776,13377993,13771209,185832
6,ENSG00000124523.9,13574601,6-13563825-C-G,rs9296714,1,C,G,13563825,10776,13377993,13771209,185832
6,ENSG00000124523.9,13574601,6-13563825-C-T,rs9296714,1,C,T,13563825,10776,13377993,13771209,185832
6,ENSG00000047579.13,15663028,6-15686468-G-A,rs9296989,-1,G,A,15686468,23440,15466420,15859636,220048
6,ENSG00000028839.4,133953224,6-133958449-G-T,rs9321423,1,G,T,133958449,5225,133756616,134149832,201833
6,ENSG00000028839.4,133953224,6-133958449-G-A,rs9321423,1,G,A,133958449,5225,133756616,134149832,201833
6,ENSG00000111863.7,11778803,6-11734629-A-G,rs932345,-1,A,G,11734629,44174,11582195,11975411,152434
6,ENSG00000119900.6,71288811,6-71282113-T-G,rs9346455,1,T,G,71282113,6698,71092203,71485419,189910
6,ENSG00000112584.8,170306758,6-170318921-T-G,rs9348266,1,T,G,170318921,12163,170110150,170503366,208771
6,ENSG00000112584.8,170306758,6-170318921-T-C,rs9348266,1,T,C,170318921,12163,170110150,170503366,208771
6,ENSG00000130396.15,167826911,6-167962003-G-T,rs9355146,1,G,T,167962003,135092,167630303,168023519,331700
6,ENSG00000198818.5,166342545,6-166337928-C-G,rs9356478,-1,C,G,166337928,4617,166145937,166539153,191991
6,ENSG00000198818.5,166342545,6-166337928-C-T,rs9356478,-1,C,T,166337928,4617,166145937,166539153,191991
6,ENSG00000158373.7,26158122,6-26303091-T-G,rs9357004,1,T,G,26303091,144969,25961514,26354730,341577
6,ENSG00000158373.7,26158122,6-26303091-T-C,rs9357004,1,T,C,26303091,144969,25961514,26354730,341577
6,ENSG00000158373.7,26158122,6-26303091-T-A,rs9357004,1,T,A,26303091,144969,25961514,26354730,341577
6,ENSG00000112624.6,42782052,6-42791425-T-A,rs9357404,1,T,A,42791425,9373,42585444,42978660,205981
6,ENSG00000112624.6,42782052,6-42791425-T-G,rs9357404,1,T,G,42791425,9373,42585444,42978660,205981
6,ENSG00000186470.7,26365198,6-26363527-G-C,rs9358934,1,G,C,26363527,1671,26168590,26561806,194937
6,ENSG00000112763.10,26457955,6-26471886-A-G,rs9358945,1,A,G,26471886,13931,26261347,26654563,210539
6,ENSG00000112763.10,26457955,6-26471886-A-T,rs9358945,1,A,T,26471886,13931,26261347,26654563,210539
6,ENSG00000026297.10,166956550,6-166960220-C-T,rs9366076,-1,C,T,166960220,3670,166759942,167153158,200278
6,ENSG00000111801.10,26440504,6-26354019-G-C,rs9366653,1,G,C,26354019,86485,26243896,26637112,110123
6,ENSG00000111801.10,26440504,6-26354019-G-A,rs9366653,1,G,A,26354019,86485,26243896,26637112,110123
6,ENSG00000048544.5,42217861,6-42191394-C-G,rs9369346,-1,C,G,42191394,26467,42021253,42414469,170141
6,ENSG00000172594.8,122789258,6-122765043-G-A,rs9372715,1,G,A,122765043,24215,122592650,122985866,172393
6,ENSG00000188428.12,8064389,6-8258002-G-A,rs9379178,-1,G,A,8258002,193613,7867781,8260997,390221
6,ENSG00000188428.12,8064389,6-8258002-G-C,rs9379178,-1,G,C,8258002,193613,7867781,8260997,390221
6,ENSG00000198315.5,28141883,6-28008422-G-C,rs9380032,1,G,C,28008422,133461,27945275,28338491,63147
6,ENSG00000198315.5,28141883,6-28008422-G-A,rs9380032,1,G,A,28008422,133461,27945275,28338491,63147
6,ENSG00000198315.5,28141883,6-28008422-G-T,rs9380032,1,G,T,28008422,133461,27945275,28338491,63147
6,ENSG00000137288.4,33711700,6-33709779-C-G,rs9380374,-1,C,G,33709779,1921,33515092,33908308,194687
6,ENSG00000137288.4,33711700,6-33709779-C-A,rs9380374,-1,C,A,33709779,1921,33515092,33908308,194687
6,ENSG00000137168.7,36874803,6-36885767-A-T,rs9380618,-1,A,T,36885767,10964,36678195,37071411,207572
6,ENSG00000137168.7,36874803,6-36885767-A-G,rs9380618,-1,A,G,36885767,10964,36678195,37071411,207572
6,ENSG00000146072.5,47309905,6-47175393-C-T,rs9381516,-1,C,T,47175393,134512,47113297,47506513,62096
6,ENSG00000146072.5,47309905,6-47175393-C-A,rs9381516,-1,C,A,47175393,134512,47113297,47506513,62096
6,ENSG00000112218.5,96837477,6-96795719-C-T,rs9386830,-1,C,T,96795719,41758,96640869,97034085,154850
6,ENSG00000034693.8,143450805,6-143503835-A-G,rs9390096,1,A,G,143503835,53030,143254197,143647413,249638
6,ENSG00000137331.10,30744547,6-30811009-A-T,rs9391696,-1,A,T,30811009,66462,30547939,30941155,263070
6,ENSG00000137331.10,30744547,6-30811009-A-G,rs9391696,-1,A,G,30811009,66462,30547939,30941155,263070
6,ENSG00000137331.10,30744547,6-30811009-A-C,rs9391696,-1,A,C,30811009,66462,30547939,30941155,263070
6,ENSG00000157593.11,44257528,6-44378269-C-G,rs9395010,-1,C,G,44378269,120741,44060920,44454136,317349
6,ENSG00000157593.11,44257528,6-44378269-C-A,rs9395010,-1,C,A,44378269,120741,44060920,44454136,317349
6,ENSG00000157593.11,44257528,6-44378269-C-T,rs9395010,-1,C,T,44378269,120741,44060920,44454136,317349
6,ENSG00000112796.4,46170980,6-46216722-A-T,rs9395166,-1,A,T,46216722,45742,45974372,46367588,242350
6,ENSG00000112796.4,46170980,6-46216722-A-G,rs9395166,-1,A,G,46216722,45742,45974372,46367588,242350
6,ENSG00000112796.4,46170980,6-46216722-A-C,rs9395166,-1,A,C,46216722,45742,45974372,46367588,242350
6,ENSG00000151914.12,56954830,6-56981317-C-T,rs9396246,-1,C,T,56981317,26487,56758222,57151438,223095
6,ENSG00000091844.2,153131282,6-153095777-G-T,rs9397587,-1,G,T,153095777,35505,152934674,153327890,161103
6,ENSG00000091844.2,153131282,6-153095777-G-A,rs9397587,-1,G,A,153095777,35505,152934674,153327890,161103
6,ENSG00000091844.2,153131282,6-153095777-G-C,rs9397587,-1,G,C,153095777,35505,152934674,153327890,161103
6,ENSG00000203797.4,110415575,6-110421991-T-C,rs9398236,-1,T,C,110421991,6416,110218967,110612183,203024
6,ENSG00000203797.4,110415575,6-110421991-T-G,rs9398236,-1,T,G,110421991,6416,110218967,110612183,203024
6,ENSG00000111885.5,119349761,6-119346247-G-A,rs9398506,-1,G,A,119346247,3514,119153153,119546369,193094
6,ENSG00000111885.5,119349761,6-119346247-G-T,rs9398506,-1,G,T,119346247,3514,119153153,119546369,193094
6,ENSG00000111885.5,119349761,6-119346247-G-C,rs9398506,-1,G,C,119346247,3514,119153153,119546369,193094
6,ENSG00000079819.10,131063245,6-131057787-C-G,rs9398971,-1,C,G,131057787,5458,130866637,131259853,191150
6,ENSG00000112367.6,109691296,6-109672515-C-G,rs9400316,1,C,G,109672515,18781,109494688,109887904,177827
6,ENSG00000112367.6,109691296,6-109672515-C-A,rs9400316,1,C,A,109672515,18781,109494688,109887904,177827
6,ENSG00000112367.6,109691296,6-109672515-C-T,rs9400316,1,C,T,109672515,18781,109494688,109887904,177827
6,ENSG00000111817.11,116370947,6-116278502-T-C,rs9400897,1,T,C,116278502,92445,116174339,116567555,104163
6,ENSG00000111817.11,116370947,6-116278502-T-A,rs9400897,1,T,A,116278502,92445,116174339,116567555,104163
6,ENSG00000093144.13,127343609,6-127397917-T-C,rs9401955,-1,T,C,127397917,54308,127147001,127540217,250916
6,ENSG00000172197.9,20212469,6-20198614-G-A,rs943573,-1,G,A,20198614,13855,20015861,20409077,182753
6,ENSG00000156535.8,73696203,6-73722913-C-T,rs9442951,1,C,T,73722913,26710,73499595,73892811,223318
6,ENSG00000164691.11,159044991,6-159127244-T-C,rs9457558,-1,T,C,159127244,82253,158848383,159241599,278861
6,ENSG00000079691.13,25279374,6-25400095-G-A,rs9461157,1,G,A,25400095,120721,25082766,25475982,317329
6,ENSG00000224389.3,32014795,6-31863944-G-T,rs9461727,1,G,T,31863944,150851,31818187,32211403,45757
6,ENSG00000197977.3,11044305,6-11083743-C-A,rs9468395,-1,C,A,11083743,39438,10847697,11240913,236046
6,ENSG00000197977.3,11044305,6-11083743-C-T,rs9468395,-1,C,T,11083743,39438,10847697,11240913,236046
6,ENSG00000112039.3,35452338,6-35452851-A-C,rs9470029,1,A,C,35452851,513,35255730,35648946,197121
6,ENSG00000112039.3,35452338,6-35452851-A-G,rs9470029,1,A,G,35452851,513,35255730,35648946,197121
6,ENSG00000198663.9,36885952,6-36939818-G-A,rs9470440,1,G,A,36939818,53866,36689344,37082560,250474
6,ENSG00000010017.8,13711835,6-13736778-G-T,rs9475227,-1,G,T,13736778,24943,13515227,13908443,221551
6,ENSG00000010017.8,13711835,6-13736778-G-A,rs9475227,-1,G,A,13736778,24943,13515227,13908443,221551
6,ENSG00000010017.8,13711835,6-13736778-G-C,rs9475227,-1,G,C,13736778,24943,13515227,13908443,221551
6,ENSG00000151917.11,56955107,6-56971347-C-G,rs9475760,1,C,G,56971347,16240,56758499,57151715,212848
6,ENSG00000151917.11,56955107,6-56971347-C-A,rs9475760,1,C,A,56971347,16240,56758499,57151715,212848
6,ENSG00000135587.4,109440724,6-109430398-G-A,rs9480957,1,G,A,109430398,10326,109244116,109637332,186282
6,ENSG00000111834.7,116616479,6-116482833-A-G,rs9481643,1,A,G,116482833,133646,116419871,116813087,62962
6,ENSG00000055211.7,149566375,6-149565339-A-T,rs9485402,1,A,T,149565339,1036,149369767,149762983,195572
6,ENSG00000055211.7,149566375,6-149565339-A-G,rs9485402,1,A,G,149565339,1036,149369767,149762983,195572
6,ENSG00000055211.7,149566375,6-149565339-A-C,rs9485402,1,A,C,149565339,1036,149369767,149762983,195572
6,ENSG00000112335.10,108261040,6-108264117-G-A,rs9486841,-1,G,A,108264117,3077,108064432,108457648,199685
6,ENSG00000093134.8,132734765,6-132752994-G-A,rs9493423,-1,G,A,132752994,18229,132538157,132931373,214837
6,ENSG00000093134.8,132734765,6-132752994-G-T,rs9493423,-1,G,T,132752994,18229,132538157,132931373,214837
6,ENSG00000112303.9,132757904,6-132752994-G-A,rs9493423,-1,G,A,132752994,4910,132561296,132954512,191698
6,ENSG00000112303.9,132757904,6-132752994-G-T,rs9493423,-1,G,T,132752994,4910,132561296,132954512,191698
6,ENSG00000112306.7,132814569,6-132814668-C-T,rs9493450,1,C,T,132814668,99,132617961,133011177,196707
6,ENSG00000124782.14,7107961,6-7251630-C-T,rs9502567,1,C,T,7251630,143669,6911353,7304569,340277
6,ENSG00000197062.6,28267143,6-28242910-C-T,rs967005,1,C,T,28242910,24233,28070535,28463751,172375
6,ENSG00000118420.12,83065841,6-82872539-T-C,rs9688767,-1,T,C,82872539,193302,82869233,83262449,3306
6,ENSG00000112799.3,6588720,6-6588648-A-T,rs977785,1,A,T,6588648,72,6392112,6785328,196536
6,ENSG00000112799.3,6588720,6-6588648-A-G,rs977785,1,A,G,6588648,72,6392112,6785328,196536
6,ENSG00000112799.3,6588720,6-6588648-A-C,rs977785,1,A,C,6588648,72,6392112,6785328,196536
6,ENSG00000112242.9,20401879,6-20350562-A-G,rs1009779,1,A,G,20350562,51317,20205271,20598487,145291
6,ENSG00000112149.5,14117772,6-14086162-A-C,rs1028323,1,A,C,14086162,31610,13921164,14314380,164998
6,ENSG00000112149.5,14117772,6-14086162-A-T,rs1028323,1,A,T,14086162,31610,13921164,14314380,164998
6,ENSG00000111860.9,118651591,6-118635938-A-G,rs10484285,-1,A,G,118635938,15653,118454983,118848199,180955
6,ENSG00000111860.9,118651591,6-118635938-A-C,rs10484285,-1,A,C,118635938,15653,118454983,118848199,180955
6,ENSG00000112031.11,153002709,6-152950717-C-T,rs10484865,-1,C,T,152950717,51992,152806101,153199317,144616
6,ENSG00000146457.10,159727506,6-159564680-G-A,rs10484951,1,G,A,159564680,162826,159530898,159924114,33782
6,ENSG00000146457.10,159727506,6-159564680-G-C,rs10484951,1,G,C,159564680,162826,159530898,159924114,33782
6,ENSG00000111802.8,24666899,6-24703312-G-C,rs10946720,-1,G,C,24703312,36413,24470291,24863507,233021
6,ENSG00000151917.11,56955107,6-57068404-C-G,rs10949010,1,C,G,57068404,113297,56758499,57151715,309905
6,ENSG00000151917.11,56955107,6-57068404-C-T,rs10949010,1,C,T,57068404,113297,56758499,57151715,309905
6,ENSG00000146247.11,79078254,6-79152757-G-C,rs111518623,-1,G,C,79152757,74503,78881646,79274862,271111
6,ENSG00000173214.5,111259339,6-111259358-C-A,rs11153277,1,C,A,111259358,19,111062731,111455947,196627
6,ENSG00000173214.5,111259339,6-111259358-C-G,rs11153277,1,C,G,111259358,19,111062731,111455947,196627
6,ENSG00000205269.4,11537749,6-11605010-G-T,rs1150565,1,G,T,11605010,67261,11341141,11734357,263869
6,ENSG00000205269.4,11537749,6-11605010-G-A,rs1150565,1,G,A,11605010,67261,11341141,11734357,263869
6,ENSG00000213760.5,31546608,6-31350916-G-C,rs115164306,-1,G,C,31350916,195692,31350000,31743216,916
6,ENSG00000213760.5,31546608,6-31350916-G-A,rs115164306,-1,G,A,31350916,195692,31350000,31743216,916
6,ENSG00000204348.5,31972138,6-31883030-T-C,rs115272033,-1,T,C,31883030,89108,31775530,32168746,107500
6,ENSG00000137171.10,43059631,6-43061550-G-A,rs11558979,1,G,A,43061550,1919,42863023,43256239,198527
6,ENSG00000124541.5,43021623,6-43061550-G-A,rs11558979,1,G,A,43061550,39927,42825015,43218231,236535
6,ENSG00000204498.5,31547608,6-31593171-C-T,rs11575835,1,C,T,31593171,45563,31351000,31744216,242171
6,ENSG00000204475.4,31593006,6-31592893-C-T,rs11575837,-1,C,T,31592893,113,31396398,31789614,196495
6,ENSG00000204388.4,31827738,6-31668166-A-G,rs115820082,1,A,G,31668166,159572,31631130,32024346,37036
6,ENSG00000204389.5,31815543,6-31668166-A-G,rs115820082,1,A,G,31668166,147377,31618935,32012151,49231
6,ENSG00000118491.7,143864474,6-144055015-C-G,rs117059750,1,C,G,144055015,190541,143667866,144061082,387149
6,ENSG00000112320.6,107490117,6-107672957-G-C,rs117424450,1,G,C,107672957,182840,107293509,107686725,379448
6,ENSG00000155085.9,109691202,6-109762875-C-T,rs11751112,-1,C,T,109762875,71673,109494594,109887810,268281
6,ENSG00000131019.4,150069121,6-150212579-C-G,rs11753049,-1,C,G,150212579,143458,149872513,150265729,340066
6,ENSG00000131019.4,150069121,6-150212579-C-T,rs11753049,-1,C,T,150212579,143458,149872513,150265729,340066
6,ENSG00000124731.7,41286682,6-41238327-C-A,rs11753659,-1,C,A,41238327,48355,41090074,41483290,148253
6,ENSG00000124731.7,41286682,6-41238327-C-T,rs11753659,-1,C,T,41238327,48355,41090074,41483290,148253
6,ENSG00000154548.8,89118071,6-89201968-G-A,rs11754862,-1,G,A,89201968,83897,88921463,89314679,280505
6,ENSG00000123505.9,110874785,6-110995416-C-T,rs11754928,1,C,T,110995416,120631,110678177,111071393,317239
6,ENSG00000123505.9,110874785,6-110995416-C-G,rs11754928,1,C,G,110995416,120631,110678177,111071393,317239
6,ENSG00000124664.6,34556329,6-34546430-C-A,rs11757517,-1,C,A,34546430,9899,34359721,34752937,186709
6,ENSG00000124664.6,34556329,6-34546430-C-T,rs11757517,-1,C,T,34546430,9899,34359721,34752937,186709
6,ENSG00000231852.2,32038415,6-31876918-G-A,rs118007953,1,G,A,31876918,161497,31841807,32235023,35111
6,ENSG00000203734.6,138796087,6-138900713-G-T,rs1188873,1,G,T,138900713,104626,138599479,138992695,301234
6,ENSG00000112357.7,136822592,6-136858471-A-G,rs11963487,1,A,G,136858471,35879,136625984,137019200,232487
6,ENSG00000051620.5,138404223,6-138341259-G-A,rs11964805,1,G,A,138341259,62964,138207615,138600831,133644
6,ENSG00000137404.10,30690984,6-30584008-G-A,rs11968929,-1,G,A,30584008,106976,30494376,30887592,89632
6,ENSG00000204371.6,31897684,6-32053353-C-T,rs11969759,-1,C,T,32053353,155669,31701076,32094292,352277
6,ENSG00000050393.6,13814557,6-13833981-G-A,rs1204161,-1,G,A,13833981,19424,13617949,14011165,216032
6,ENSG00000112584.8,170306758,6-170376449-A-C,rs12189864,1,A,C,170376449,69691,170110150,170503366,266299
6,ENSG00000112584.8,170306758,6-170376449-A-G,rs12189864,1,A,G,170376449,69691,170110150,170503366,266299
6,ENSG00000137331.10,30744547,6-30817608-A-C,rs12192760,-1,A,C,30817608,73061,30547939,30941155,269669
6,ENSG00000111886.8,89315299,6-89324017-C-A,rs12195070,-1,C,A,89324017,8718,89118691,89511907,205326
6,ENSG00000111886.8,89315299,6-89324017-C-T,rs12195070,-1,C,T,89324017,8718,89118691,89511907,205326
6,ENSG00000186340.9,169253846,6-169280647-G-A,rs12196140,-1,G,A,169280647,26801,169057238,169450454,223409
6,ENSG00000137414.4,17600302,6-17699091-G-A,rs12199222,1,G,A,17699091,98789,17403694,17796910,295397
6,ENSG00000137414.4,17600302,6-17699091-G-T,rs12199222,1,G,T,17699091,98789,17403694,17796910,295397
6,ENSG00000112659.8,43182196,6-43254158-G-A,rs12204749,1,G,A,43254158,71962,42985588,43378804,268570
6,ENSG00000112659.8,43182196,6-43254158-G-T,rs12204749,1,G,T,43254158,71962,42985588,43378804,268570
6,ENSG00000189367.9,127459389,6-127479910-T-C,rs12211079,-1,T,C,127479910,20521,127262781,127655997,217129
6,ENSG00000137251.9,54308441,6-54294348-G-A,rs12215705,1,G,A,54294348,14093,54111833,54505049,182515
6,ENSG00000135596.12,109455772,6-109339681-C-A,rs12528712,-1,C,A,109339681,116091,109259164,109652380,80517
6,ENSG00000164414.11,87472974,6-87408931-A-G,rs12529423,1,A,G,87408931,64043,87276366,87669582,132565
6,ENSG00000118513.13,135181308,6-135264221-T-C,rs12529613,1,T,C,135264221,82913,134984700,135377916,279521
6,ENSG00000066379.10,30061265,6-30088699-A-T,rs1264709,1,A,T,30088699,27434,29864657,30257873,224042
6,ENSG00000137310.7,31158589,6-31144298-G-A,rs1265080,1,G,A,31144298,14291,30961981,31355197,182317
6,ENSG00000204531.9,31170682,6-31144298-G-A,rs1265080,-1,G,A,31144298,26384,30974074,31367290,170224
6,ENSG00000124508.12,26383108,6-26462128-C-T,rs12660069,1,C,T,26462128,79020,26186500,26579716,275628
6,ENSG00000124795.10,18264530,6-18181114-C-T,rs12664214,-1,C,T,18181114,83416,18067922,18461138,113192
6,ENSG00000204256.6,32968594,6-33080864-A-G,rs12722027,1,A,G,33080864,112270,32771986,33165202,308878
6,ENSG00000026652.9,161274061,6-161231671-T-C,rs13194692,-1,T,C,161231671,42390,161077453,161470669,154218
6,ENSG00000026652.9,161274061,6-161231671-T-G,rs13194692,-1,T,G,161231671,42390,161077453,161470669,154218
6,ENSG00000154079.5,70566930,6-70586074-G-A,rs13197182,1,G,A,70586074,19144,70370322,70763538,215752
6,ENSG00000111880.10,88963618,6-88881919-C-A,rs13209883,-1,C,A,88881919,81699,88767010,89160226,114909
6,ENSG00000111880.10,88963618,6-88881919-C-T,rs13209883,-1,C,T,88881919,81699,88767010,89160226,114909
6,ENSG00000146410.7,136250311,6-136059009-T-G,rs1383393,-1,T,G,136059009,191302,136053703,136446919,5306
6,ENSG00000146410.7,136250311,6-136059009-T-A,rs1383393,-1,T,A,136059009,191302,136053703,136446919,5306
6,ENSG00000146410.7,136250311,6-136059009-T-C,rs1383393,-1,T,C,136059009,191302,136053703,136446919,5306
6,ENSG00000112297.9,106360717,6-106534613-T-C,rs1462147,1,T,C,106534613,173896,106164109,106557325,370504
6,ENSG00000112297.9,106360717,6-106534613-T-A,rs1462147,1,T,A,106534613,173896,106164109,106557325,370504
6,ENSG00000172738.7,37258122,6-37311157-T-C,rs149709,-1,T,C,37311157,53035,37061514,37454730,249643
6,ENSG00000168116.9,57046693,6-56992867-A-C,rs1562908,1,A,C,56992867,53826,56850085,57243301,142782
6,ENSG00000168116.9,57046693,6-56992867-A-T,rs1562908,1,A,T,56992867,53826,56850085,57243301,142782
6,ENSG00000168116.9,57046693,6-56992867-A-G,rs1562908,1,A,G,56992867,53826,56850085,57243301,142782
6,ENSG00000164483.12,130222951,6-130107079-G-A,rs1572292,-1,G,A,130107079,115872,130026343,130419559,80736
6,ENSG00000189007.9,143450695,6-143481353-C-G,rs161061,-1,C,G,143481353,30658,143254087,143647303,227266
6,ENSG00000189007.9,143450695,6-143481353-C-A,rs161061,-1,C,A,143481353,30658,143254087,143647303,227266
6,ENSG00000026297.10,166956550,6-167042141-G-A,rs162298,-1,G,A,167042141,85591,166759942,167153158,282199
6,ENSG00000026297.10,166956550,6-167042141-G-T,rs162298,-1,G,T,167042141,85591,166759942,167153158,282199
6,ENSG00000026297.10,166956550,6-167042141-G-C,rs162298,-1,G,C,167042141,85591,166759942,167153158,282199
6,ENSG00000178233.10,44270450,6-44277233-C-G,rs16871694,1,C,G,44277233,6783,44073842,44467058,203391
6,ENSG00000145990.5,13487600,6-13345479-G-A,rs16874066,-1,G,A,13345479,142121,13290992,13684208,54487
6,ENSG00000135299.11,89433152,6-89555946-G-A,rs16881936,1,G,A,89555946,122794,89236544,89629760,319402
6,ENSG00000135299.11,89433152,6-89555946-G-C,rs16881936,1,G,C,89555946,122794,89236544,89629760,319402
6,ENSG00000096092.5,52671113,6-52662610-C-A,rs16882833,1,C,A,52662610,8503,52474505,52867721,188105
6,ENSG00000096092.5,52671113,6-52662610-C-T,rs16882833,1,C,T,52662610,8503,52474505,52867721,188105
6,ENSG00000112304.5,24667077,6-24650398-C-T,rs16889567,1,C,T,24650398,16679,24470469,24863685,179929
6,ENSG00000048544.5,42217861,6-42196532-T-C,rs16895284,-1,T,C,42196532,21329,42021253,42414469,175279
6,ENSG00000112276.9,105137157,6-105276766-T-G,rs17065726,-1,T,G,105276766,139609,104940549,105333765,336217
6,ENSG00000112290.8,110179670,6-110256564-T-C,rs17071351,-1,T,C,110256564,76894,109983062,110376278,273502
6,ENSG00000034693.8,143450805,6-143281917-T-C,rs17072423,1,T,C,143281917,168888,143254197,143647413,27720
6,ENSG00000153989.7,117675469,6-117481975-C-G,rs17079281,1,C,G,117481975,193494,117478861,117872077,3114
6,ENSG00000153989.7,117675469,6-117481975-C-T,rs17079281,1,C,T,117481975,193494,117478861,117872077,3114
6,ENSG00000111897.5,122471807,6-122339884-G-A,rs17084433,-1,G,A,122339884,131923,122275199,122668415,64685
6,ENSG00000232629.4,32763532,6-32652506-C-T,rs17843604,-1,C,T,32652506,111026,32566924,32960140,85582
6,ENSG00000170542.5,2903309,6-2932762-G-C,rs1885294,-1,G,C,2932762,29453,2706701,3099917,226061
6,ENSG00000137275.7,3068494,6-2932762-G-C,rs1885294,1,G,C,2932762,135732,2871886,3265102,60876
6,ENSG00000172673.6,127901058,6-127890224-C-T,rs198527,-1,C,T,127890224,10834,127704450,128097666,185774
6,ENSG00000093144.13,127343609,6-127390028-G-A,rs2000909,-1,G,A,127390028,46419,127147001,127540217,243027
6,ENSG00000093144.13,127343609,6-127390028-G-C,rs2000909,-1,G,C,127390028,46419,127147001,127540217,243027
6,ENSG00000198721.8,4135575,6-4109747-G-A,rs2002835,-1,G,A,4109747,25828,3938967,4332183,170780
6,ENSG00000145979.11,13328537,6-13298666-A-G,rs2002961,-1,A,G,13298666,29871,13131929,13525145,166737
6,ENSG00000196747.3,27808173,6-27848045-T-G,rs200990,1,T,G,27848045,39872,27611565,28004781,236480
6,ENSG00000184357.3,27867588,6-27840414-A-G,rs201002,-1,A,G,27840414,27174,27670980,28064196,169434
6,ENSG00000197279.3,28080568,6-28109108-C-T,rs203885,1,C,T,28109108,28540,27883960,28277176,225148
6,ENSG00000112343.7,25962802,6-25944983-A-C,rs2051541,1,A,C,25944983,17819,25766194,26159410,178789
6,ENSG00000112343.7,25962802,6-25944983-A-G,rs2051541,1,A,G,25944983,17819,25766194,26159410,178789
6,ENSG00000112343.7,25962802,6-25944983-A-T,rs2051541,1,A,T,25944983,17819,25766194,26159410,178789
6,ENSG00000164484.7,130366017,6-130248686-G-T,rs2064874,1,G,T,130248686,117331,130169409,130562625,79277
6,ENSG00000146376.5,129710177,6-129708694-G-A,rs2068685,-1,G,A,129708694,1483,129513569,129906785,195125
6,ENSG00000187837.2,26056470,6-26091108-T-C,rs2071303,-1,T,C,26091108,34638,25859862,26253078,231246
6,ENSG00000203797.4,110415575,6-110408770-G-C,rs2073210,-1,G,C,110408770,6805,110218967,110612183,189803
6,ENSG00000203797.4,110415575,6-110408770-G-T,rs2073210,-1,G,T,110408770,6805,110218967,110612183,189803
6,ENSG00000203797.4,110415575,6-110408770-G-A,rs2073210,-1,G,A,110408770,6805,110218967,110612183,189803
6,ENSG00000026950.12,26402275,6-26374931-A-G,rs2073529,1,A,G,26374931,27344,26205667,26598883,169264
6,ENSG00000204472.7,31615234,6-31644063-C-A,rs2077102,1,C,A,31644063,28829,31418626,31811842,225437
6,ENSG00000137198.5,16238587,6-16203330-A-T,rs2092107,1,A,T,16203330,35257,16041979,16435195,161351
6,ENSG00000137198.5,16238587,6-16203330-A-C,rs2092107,1,A,C,16203330,35257,16041979,16435195,161351
6,ENSG00000111863.7,11778803,6-11715518-G-T,rs210913,-1,G,T,11715518,63285,11582195,11975411,133323
6,ENSG00000111863.7,11778803,6-11715518-G-C,rs210913,-1,G,C,11715518,63285,11582195,11975411,133323
6,ENSG00000204410.9,31740005,6-31572779-T-C,rs2229094,1,T,C,31572779,167226,31543397,31936613,29382
6,ENSG00000112200.11,57090188,6-57228858-C-T,rs223296,1,C,T,57228858,138670,56893580,57286796,335278
6,ENSG00000157593.11,44257528,6-44260425-G-A,rs2233437,-1,G,A,44260425,2897,44060920,44454136,199505
6,ENSG00000124587.9,42979181,6-42929336-T-C,rs2234185,-1,T,C,42929336,49845,42782573,43175789,146763
6,ENSG00000124767.5,38703145,6-38573708-T-C,rs2252550,-1,T,C,38573708,129437,38506537,38899753,67171
6,ENSG00000124767.5,38703145,6-38573708-T-A,rs2252550,-1,T,A,38573708,129437,38506537,38899753,67171
6,ENSG00000146282.12,87589987,6-87476059-T-C,rs2268996,-1,T,C,87476059,113928,87393379,87786595,82680
6,ENSG00000235109.3,28336148,6-28532102-A-G,rs2273106,-1,A,G,28532102,195954,28139540,28532756,392562
6,ENSG00000137288.4,33711700,6-33801120-A-G,rs2281820,-1,A,G,33801120,89420,33515092,33908308,286028
6,ENSG00000204209.6,33322959,6-33131211-C-A,rs2294477,-1,C,A,33131211,191748,33126351,33519567,4860
6,ENSG00000204209.6,33322959,6-33131211-C-G,rs2294477,-1,C,G,33131211,191748,33126351,33519567,4860
6,ENSG00000204209.6,33322959,6-33131211-C-T,rs2294477,-1,C,T,33131211,191748,33126351,33519567,4860
6,ENSG00000124641.10,41921139,6-41927412-G-A,rs2296916,-1,G,A,41927412,6273,41724531,42117747,202881
6,ENSG00000172197.9,20212469,6-20186529-C-A,rs2328395,-1,C,A,20186529,25940,20015861,20409077,170668
6,ENSG00000172197.9,20212469,6-20186529-C-T,rs2328395,-1,C,T,20186529,25940,20015861,20409077,170668
6,ENSG00000137168.7,36874803,6-36824059-T-G,rs236375,-1,T,G,36824059,50744,36678195,37071411,145864
6,ENSG00000137168.7,36874803,6-36824059-T-A,rs236375,-1,T,A,36824059,50744,36678195,37071411,145864
6,ENSG00000137168.7,36874803,6-36824059-T-C,rs236375,-1,T,C,36824059,50744,36678195,37071411,145864
6,ENSG00000204516.5,31498145,6-31516740-C-A,rs2395045,1,C,A,31516740,18595,31301537,31694753,215203
6,ENSG00000204516.5,31498145,6-31516740-C-T,rs2395045,1,C,T,31516740,18595,31301537,31694753,215203
6,ENSG00000204516.5,31498145,6-31516740-C-G,rs2395045,1,C,G,31516740,18595,31301537,31694753,215203
6,ENSG00000164627.12,39725408,6-39620342-A-G,rs2446649,-1,A,G,39620342,105066,39528800,39922016,91542
6,ENSG00000227507.2,31582424,6-31479811-C-A,rs2516513,-1,C,A,31479811,102613,31385816,31779032,93995
6,ENSG00000227507.2,31582424,6-31479811-C-T,rs2516513,-1,C,T,31479811,102613,31385816,31779032,93995
6,ENSG00000204642.7,29723434,6-29831969-C-G,rs2517898,1,C,G,29831969,108535,29526826,29920042,305143
6,ENSG00000204642.7,29723434,6-29831969-C-T,rs2517898,1,C,T,29831969,108535,29526826,29920042,305143
6,ENSG00000146411.5,134052624,6-134043290-C-G,rs2627234,-1,C,G,134043290,9334,133856016,134249232,187274
6,ENSG00000146411.5,134052624,6-134043290-C-T,rs2627234,-1,C,T,134043290,9334,133856016,134249232,187274
6,ENSG00000188820.8,116461375,6-116466215-T-C,rs2637678,1,T,C,116466215,4840,116264767,116657983,201448
6,ENSG00000204632.7,29827825,6-29947524-C-A,rs2735097,1,C,A,29947524,119699,29631217,30024433,316307
6,ENSG00000204632.7,29827825,6-29947524-C-G,rs2735097,1,C,G,29947524,119699,29631217,30024433,316307
6,ENSG00000124532.9,24402936,6-24544104-G-A,rs2744605,1,G,A,24544104,141168,24206328,24599544,337776
6,ENSG00000236104.2,33317744,6-33459573-T-G,rs2772372,-1,T,G,33459573,141829,33121136,33514352,338437
6,ENSG00000236104.2,33317744,6-33459573-T-C,rs2772372,-1,T,C,33459573,141829,33121136,33514352,338437
6,ENSG00000236104.2,33317744,6-33459573-T-A,rs2772372,-1,T,A,33459573,141829,33121136,33514352,338437
6,ENSG00000196376.6,117907264,6-117907364-A-C,rs2788996,1,A,C,117907364,100,117710656,118103872,196708
6,ENSG00000135338.7,79537430,6-79615517-C-T,rs2812681,-1,C,T,79615517,78087,79340822,79734038,274695
6,ENSG00000135338.7,79537430,6-79615517-C-G,rs2812681,-1,C,G,79615517,78087,79340822,79734038,274695
6,ENSG00000112167.5,39115186,6-39275768-G-A,rs2815040,-1,G,A,39275768,160582,38918578,39311794,357190
6,ENSG00000124678.12,35141339,6-35108299-G-A,rs2820229,-1,G,A,35108299,33040,34944731,35337947,163568
6,ENSG00000204536.8,31157802,6-31229630-C-T,rs28397289,-1,C,T,31229630,71828,30961194,31354410,268436
6,ENSG00000231389.2,33080710,6-33177933-A-T,rs2855423,-1,A,T,33177933,97223,32884102,33277318,293831
6,ENSG00000231389.2,33080710,6-33177933-A-G,rs2855423,-1,A,G,33177933,97223,32884102,33277318,293831
6,ENSG00000198719.7,170291078,6-170133775-A-T,rs3012361,-1,A,T,170133775,157303,170094470,170487686,39305
6,ENSG00000198719.7,170291078,6-170133775-A-G,rs3012361,-1,A,G,170133775,157303,170094470,170487686,39305
6,ENSG00000112715.16,43770211,6-43777370-G-C,rs3024997,1,G,C,43777370,7159,43573603,43966819,203767
6,ENSG00000112715.16,43770211,6-43777370-G-A,rs3024997,1,G,A,43777370,7159,43573603,43966819,203767
6,ENSG00000172432.12,43629264,6-43785588-G-A,rs3025053,-1,G,A,43785588,156324,43432656,43825872,352932
6,ENSG00000206503.6,29942532,6-29868462-C-G,rs3094157,1,C,G,29868462,74070,29745924,30139140,122538
6,ENSG00000206503.6,29942532,6-29868462-C-T,rs3094157,1,C,T,29868462,74070,29745924,30139140,122538
6,ENSG00000213588.3,33454576,6-33358473-A-T,rs3106192,1,A,T,33358473,96103,33257968,33651184,100505
6,ENSG00000213588.3,33454576,6-33358473-A-G,rs3106192,1,A,G,33358473,96103,33257968,33651184,100505
6,ENSG00000204252.7,33009591,6-33052196-A-T,rs3128952,-1,A,T,33052196,42605,32812983,33206199,239213
6,ENSG00000204252.7,33009591,6-33052196-A-G,rs3128952,-1,A,G,33052196,42605,32812983,33206199,239213
6,ENSG00000204228.3,33204655,6-33151135-A-T,rs3130157,1,A,T,33151135,53520,33008047,33401263,143088
6,ENSG00000204228.3,33204655,6-33151135-A-C,rs3130157,1,A,C,33151135,53520,33008047,33401263,143088
6,ENSG00000204228.3,33204655,6-33151135-A-G,rs3130157,1,A,G,33151135,53520,33008047,33401263,143088
6,ENSG00000021355.7,2841863,6-2912043-G-C,rs318497,-1,G,C,2912043,70180,2645255,3038471,266788
6,ENSG00000021355.7,2841863,6-2912043-G-T,rs318497,-1,G,T,2912043,70180,2645255,3038471,266788
6,ENSG00000021355.7,2841863,6-2912043-G-A,rs318497,-1,G,A,2912043,70180,2645255,3038471,266788
6,ENSG00000145949.8,2750922,6-2912043-G-C,rs318497,-1,G,C,2912043,161121,2554314,2947530,357729
6,ENSG00000145949.8,2750922,6-2912043-G-T,rs318497,-1,G,T,2912043,161121,2554314,2947530,357729
6,ENSG00000145949.8,2750922,6-2912043-G-A,rs318497,-1,G,A,2912043,161121,2554314,2947530,357729
6,ENSG00000137218.6,41779900,6-41942598-T-C,rs3218084,-1,T,C,41942598,162698,41583292,41976508,359306
6,ENSG00000204248.5,33192467,6-33033994-T-C,rs34493748,-1,T,C,33033994,158473,32995859,33389075,38135
6,ENSG00000204390.7,31815283,6-31809864-C-T,rs34814308,-1,C,T,31809864,5419,31618675,32011891,191189
6,ENSG00000204616.4,30113090,6-30168525-C-G,rs34823152,-1,C,G,30168525,55435,29916482,30309698,252043
6,ENSG00000057663.8,106325760,6-106165888-G-C,rs35342892,-1,G,C,106165888,159872,106129152,106522368,36736
6,ENSG00000112339.10,135054822,6-135006317-G-T,rs35485255,-1,G,T,135006317,48505,134858214,135251430,148103
6,ENSG00000112339.10,135054822,6-135006317-G-A,rs35485255,-1,G,A,135006317,48505,134858214,135251430,148103
6,ENSG00000112796.4,46170980,6-46079721-C-T,rs3734207,-1,C,T,46079721,91259,45974372,46367588,105349
6,ENSG00000112796.4,46170980,6-46079721-C-A,rs3734207,-1,C,A,46079721,91259,45974372,46367588,105349
6,ENSG00000010017.8,13711835,6-13787346-G-A,rs3734672,-1,G,A,13787346,75511,13515227,13908443,272119
6,ENSG00000010017.8,13711835,6-13787346-G-C,rs3734672,-1,G,C,13787346,75511,13515227,13908443,272119
6,ENSG00000124574.9,43427541,6-43348285-A-G,rs3734683,1,A,G,43348285,79256,43230933,43624149,117352
6,ENSG00000124562.5,34757505,6-34888724-T-G,rs3756859,1,T,G,34888724,131219,34560897,34954113,327827
6,ENSG00000124535.10,2765393,6-2766493-A-C,rs3757094,1,A,C,2766493,1100,2568785,2962001,197708
6,ENSG00000124535.10,2765393,6-2766493-A-G,rs3757094,1,A,G,2766493,1100,2568785,2962001,197708
6,ENSG00000197442.7,136792477,6-136794881-T-A,rs3757165,-1,T,A,136794881,2404,136595869,136989085,199012
6,ENSG00000197442.7,136792477,6-136794881-T-C,rs3757165,-1,T,C,136794881,2404,136595869,136989085,199012
6,ENSG00000197442.7,136792477,6-136794881-T-G,rs3757165,-1,T,G,136794881,2404,136595869,136989085,199012
6,ENSG00000198502.5,32530287,6-32408694-A-C,rs3763313,-1,A,C,32408694,121593,32333679,32726895,75015
6,ENSG00000188112.4,42142620,6-42174319-T-C,rs3793083,-1,T,C,42174319,31699,41946012,42339228,228307
6,ENSG00000111850.5,87322588,6-87333842-T-C,rs379455,1,T,C,87333842,11254,87125980,87519196,207862
6,ENSG00000111816.5,116060891,6-115996281-T-C,rs3798232,-1,T,C,115996281,64610,115864283,116257499,131998
6,ENSG00000112308.7,24719154,6-24719750-G-A,rs3813687,-1,G,A,24719750,596,24522546,24915762,197204
6,ENSG00000112308.7,24719154,6-24719750-G-T,rs3813687,-1,G,T,24719750,596,24522546,24915762,197204
6,ENSG00000137203.6,10415074,6-10388420-T-G,rs3818408,-1,T,G,10388420,26654,10218466,10611682,169954
6,ENSG00000137203.6,10415074,6-10388420-T-C,rs3818408,-1,T,C,10388420,26654,10218466,10611682,169954
6,ENSG00000029639.6,155314484,6-155239346-C-T,rs3935935,-1,C,T,155239346,75138,155117876,155511092,121470
6,ENSG00000155115.6,110958706,6-111031496-G-A,rs4082794,1,G,A,111031496,72790,110762098,111155314,269398
6,ENSG00000204267.8,32838739,6-32829711-C-A,rs4148874,-1,C,A,32829711,9028,32642131,33035347,187580
6,ENSG00000204267.8,32838739,6-32829711-C-T,rs4148874,-1,C,T,32829711,9028,32642131,33035347,187580
6,ENSG00000204540.6,31114800,6-31034750-A-G,rs4248153,1,A,G,31034750,80050,30918192,31311408,116558
6,ENSG00000204540.6,31114800,6-31034750-A-T,rs4248153,1,A,T,31034750,80050,30918192,31311408,116558
6,ENSG00000204540.6,31114800,6-31034750-A-C,rs4248153,1,A,C,31034750,80050,30918192,31311408,116558
6,ENSG00000096433.5,33621322,6-33589448-A-G,rs430655,1,A,G,33589448,31874,33424714,33817930,164734
6,ENSG00000112096.11,159693241,6-159677190-G-A,rs4342445,-1,G,A,159677190,16051,159496633,159889849,180557
6,ENSG00000079691.13,25279374,6-25409618-C-T,rs4440453,1,C,T,25409618,130244,25082766,25475982,326852
6,ENSG00000124721.13,38715311,6-38907976-A-G,rs4452640,1,A,G,38907976,192665,38518703,38911919,389273
6,ENSG00000092820.13,158819368,6-158858262-T-C,rs4569991,-1,T,C,158858262,38894,158622760,159015976,235502
6,ENSG00000156535.8,73696203,6-73712999-G-C,rs4708076,1,G,C,73712999,16796,73499595,73892811,213404
6,ENSG00000156535.8,73696203,6-73712999-G-A,rs4708076,1,G,A,73712999,16796,73499595,73892811,213404
6,ENSG00000204569.4,30617243,6-30631925-G-A,rs4713340,-1,G,A,30631925,14682,30420635,30813851,211290
6,ENSG00000112599.7,42194956,6-42206820-A-C,rs4714580,-1,A,C,42206820,11864,41998348,42391564,208472
6,ENSG00000112599.7,42194956,6-42206820-A-T,rs4714580,-1,A,T,42206820,11864,41998348,42391564,208472
6,ENSG00000112599.7,42194956,6-42206820-A-G,rs4714580,-1,A,G,42206820,11864,41998348,42391564,208472
6,ENSG00000137225.8,44158820,6-44173995-G-A,rs4714764,1,G,A,44173995,15175,43962212,44355428,211783
6,ENSG00000137225.8,44158820,6-44173995-G-C,rs4714764,1,G,C,44173995,15175,43962212,44355428,211783
6,ENSG00000118515.7,134318112,6-134288153-A-C,rs4896038,-1,A,C,134288153,29959,134121504,134514720,166649
6,ENSG00000111877.12,118935159,6-118947191-G-A,rs4946380,-1,G,A,118947191,12032,118738551,119131767,208640
6,ENSG00000214113.5,5260950,6-5156067-T-C,rs4960070,-1,T,C,5156067,104883,5064342,5457558,91725
6,ENSG00000065833.6,83431051,6-83487071-A-G,rs500891,-1,A,G,83487071,56020,83234443,83627659,252628
6,ENSG00000065833.6,83431051,6-83487071-A-C,rs500891,-1,A,C,83487071,56020,83234443,83627659,252628
6,ENSG00000065833.6,83431051,6-83487071-A-T,rs500891,-1,A,T,83487071,56020,83234443,83627659,252628
6,ENSG00000112697.10,75284792,6-75290078-A-T,rs502900,-1,A,T,75290078,5286,75088184,75481400,201894
6,ENSG00000112697.10,75284792,6-75290078-A-G,rs502900,-1,A,G,75290078,5286,75088184,75481400,201894
6,ENSG00000237541.3,32741391,6-32614196-G-A,rs521539,1,G,A,32614196,127195,32544783,32937999,69413
6,ENSG00000112695.7,75243801,6-75166376-T-G,rs545588,-1,T,G,75166376,77425,75047193,75440409,119183
6,ENSG00000112695.7,75243801,6-75166376-T-C,rs545588,-1,T,C,75166376,77425,75047193,75440409,119183
6,ENSG00000204438.5,31664997,6-31851599-G-A,rs574914,-1,G,A,31851599,186602,31468389,31861605,383210
6,ENSG00000135549.8,122610405,6-122735415-T-C,rs58551574,1,T,C,122735415,125010,122413797,122807013,321618
6,ENSG00000111834.7,116616479,6-116791567-T-G,rs600928,1,T,G,116791567,175088,116419871,116813087,371696
6,ENSG00000111834.7,116616479,6-116791567-T-C,rs600928,1,T,C,116791567,175088,116419871,116813087,371696
6,ENSG00000111834.7,116616479,6-116791567-T-A,rs600928,1,T,A,116791567,175088,116419871,116813087,371696
6,ENSG00000155906.11,151452126,6-151412926-C-T,rs60701331,-1,C,T,151412926,39200,151255518,151648734,157408
6,ENSG00000204482.5,31586277,6-31452279-C-T,rs60796110,1,C,T,31452279,133998,31389669,31782885,62610
6,ENSG00000137269.9,53795005,6-53646426-T-C,rs60969333,1,T,C,53646426,148579,53598397,53991613,48029
6,ENSG00000137204.10,43298260,6-43186049-G-A,rs61743561,1,G,A,43186049,112211,43101652,43494868,84397
6,ENSG00000124588.13,2999894,6-3024349-T-G,rs62392501,1,T,G,3024349,24455,2803286,3196502,221063
6,ENSG00000146232.9,44265551,6-44205197-T-C,rs62401143,-1,T,C,44205197,60354,44068943,44462159,136254
6,ENSG00000096070.14,36196744,6-36315081-T-C,rs62403699,1,T,C,36315081,118337,36000136,36393352,314945
6,ENSG00000065308.4,52577060,6-52561961-G-A,rs62405876,-1,G,A,52561961,15099,52380452,52773668,181509
6,ENSG00000112280.11,70303084,6-70387472-C-A,rs62420316,-1,C,A,70387472,84388,70106476,70499692,280996
6,ENSG00000093134.8,132734765,6-132716722-G-T,rs6569827,-1,G,T,132716722,18043,132538157,132931373,178565
6,ENSG00000118514.9,134950101,6-134903615-C-T,rs6569976,-1,C,T,134903615,46486,134753493,135146709,150122
6,ENSG00000118514.9,134950101,6-134903615-C-A,rs6569976,-1,C,A,134903615,46486,134753493,135146709,150122
6,ENSG00000118514.9,134950101,6-134903615-C-G,rs6569976,-1,C,G,134903615,46486,134753493,135146709,150122
6,ENSG00000146386.7,139028745,6-139031663-T-A,rs6570300,1,T,A,139031663,2918,138832137,139225353,199526
6,ENSG00000146386.7,139028745,6-139031663-T-G,rs6570300,1,T,G,139031663,2918,138832137,139225353,199526
6,ENSG00000111962.7,148747030,6-148661484-A-G,rs6570876,1,A,G,148661484,85546,148550422,148943638,111062
6,ENSG00000111962.7,148747030,6-148661484-A-C,rs6570876,1,A,C,148661484,85546,148550422,148943638,111062
6,ENSG00000111962.7,148747030,6-148661484-A-T,rs6570876,1,A,T,148661484,85546,148550422,148943638,111062
6,ENSG00000112739.11,4021300,6-3996744-G-C,rs6597023,1,G,C,3996744,24556,3824692,4217908,172052
6,ENSG00000112739.11,4021300,6-3996744-G-T,rs6597023,1,G,T,3996744,24556,3824692,4217908,172052
6,ENSG00000122335.8,158168262,6-158201359-A-T,rs662185,-1,A,T,158201359,33097,157971654,158364870,229705
6,ENSG00000122335.8,158168262,6-158201359-A-G,rs662185,-1,A,G,158201359,33097,157971654,158364870,229705
6,ENSG00000122335.8,158168262,6-158201359-A-C,rs662185,-1,A,C,158201359,33097,157971654,158364870,229705
6,ENSG00000180573.7,26124172,6-26274190-C-T,rs6901096,1,C,T,26274190,150018,25927564,26320780,346626
6,ENSG00000132424.10,99425308,6-99247232-C-A,rs6904604,-1,C,A,99247232,178076,99228700,99621916,18532
6,ENSG00000132424.10,99425308,6-99247232-C-T,rs6904604,-1,C,T,99247232,178076,99228700,99621916,18532
6,ENSG00000146426.12,154995315,6-155183826-C-A,rs6905473,1,C,A,155183826,188511,154798707,155191923,385119
6,ENSG00000146426.12,154995315,6-155183826-C-T,rs6905473,1,C,T,155183826,188511,154798707,155191923,385119
6,ENSG00000204264.4,32844047,6-32658534-T-C,rs6906021,-1,T,C,32658534,185513,32647439,33040655,11095
6,ENSG00000197409.6,26197286,6-26186897-C-T,rs6906367,-1,C,T,26186897,10389,26000678,26393894,186219
6,ENSG00000079819.10,131063245,6-131023993-A-G,rs6906478,-1,A,G,131023993,39252,130866637,131259853,157356
6,ENSG00000112110.5,159790467,6-159796974-G-A,rs6908294,1,G,A,159796974,6507,159593859,159987075,203115
6,ENSG00000204052.3,43510686,6-43691888-C-T,rs6908311,-1,C,T,43691888,181202,43314078,43707294,377810
6,ENSG00000112234.3,98947946,6-99078045-G-T,rs6912645,-1,G,T,99078045,130099,98751338,99144554,326707
6,ENSG00000112667.8,43229481,6-43178649-A-G,rs6914964,-1,A,G,43178649,50832,43032873,43426089,145776
6,ENSG00000137413.11,42050524,6-42224844-G-A,rs6915565,1,G,A,42224844,174320,41853916,42247132,370928
6,ENSG00000112379.7,138161939,6-138207174-T-C,rs6916055,1,T,C,138207174,45235,137965331,138358547,241843
6,ENSG00000112139.9,37697883,6-37692341-A-C,rs6916856,-1,A,C,37692341,5542,37501275,37894491,191066
6,ENSG00000112139.9,37697883,6-37692341-A-G,rs6916856,-1,A,G,37692341,5542,37501275,37894491,191066
6,ENSG00000112799.3,6588720,6-6626030-G-A,rs6922002,1,G,A,6626030,37310,6392112,6785328,233918
6,ENSG00000204227.4,33208500,6-33028086-C-T,rs6933319,1,C,T,33028086,180414,33011892,33405108,16194
6,ENSG00000204227.4,33208500,6-33028086-C-G,rs6933319,1,C,G,33028086,180414,33011892,33405108,16194
6,ENSG00000137285.8,3227653,6-3143531-T-A,rs6933330,-1,T,A,3143531,84122,3031045,3424261,112486
6,ENSG00000137285.8,3227653,6-3143531-T-G,rs6933330,-1,T,G,3143531,84122,3031045,3424261,112486
6,ENSG00000137267.4,3157544,6-3143531-T-A,rs6933330,-1,T,A,3143531,14013,2960936,3354152,182595
6,ENSG00000137267.4,3157544,6-3143531-T-G,rs6933330,-1,T,G,3143531,14013,2960936,3354152,182595
6,ENSG00000131016.12,151239967,6-151247807-T-A,rs6934340,1,T,A,151247807,7840,151043359,151436575,204448
6,ENSG00000131016.12,151239967,6-151247807-T-C,rs6934340,1,T,C,151247807,7840,151043359,151436575,204448
6,ENSG00000170950.3,49787285,6-49774023-C-A,rs699991,-1,C,A,49774023,13262,49590677,49983893,183346
6,ENSG00000137193.8,37170152,6-36995364-G-C,rs708008,1,G,C,36995364,174788,36973544,37366760,21820
6,ENSG00000137193.8,37170152,6-36995364-G-A,rs708008,1,G,A,36995364,174788,36973544,37366760,21820
6,ENSG00000137193.8,37170152,6-36995364-G-T,rs708008,1,G,T,36995364,174788,36973544,37366760,21820
6,ENSG00000176381.4,166308392,6-166281220-T-G,rs729887,-1,T,G,166281220,27172,166111784,166505000,169436
6,ENSG00000176381.4,166308392,6-166281220-T-C,rs729887,-1,T,C,166281220,27172,166111784,166505000,169436
6,ENSG00000198818.5,166342545,6-166281220-T-G,rs729887,-1,T,G,166281220,61325,166145937,166539153,135283
6,ENSG00000198818.5,166342545,6-166281220-T-C,rs729887,-1,T,C,166281220,61325,166145937,166539153,135283
6,ENSG00000153162.7,7726099,6-7897914-A-G,rs73719371,1,A,G,7897914,171815,7529491,7922707,368423
6,ENSG00000153162.7,7726099,6-7897914-A-T,rs73719371,1,A,T,7897914,171815,7529491,7922707,368423
6,ENSG00000112576.8,41941808,6-42077626-G-A,rs73735020,-1,G,A,42077626,135818,41745200,42138416,332426
6,ENSG00000137338.4,28281572,6-28428667-C-G,rs74409142,1,C,G,28428667,147095,28084964,28478180,343703
6,ENSG00000010030.9,36387669,6-36368310-A-G,rs744848,-1,A,G,36368310,19359,36191061,36584277,177249
6,ENSG00000124784.4,7389808,6-7442624-C-A,rs76117671,1,C,A,7442624,52816,7193200,7586416,249424
6,ENSG00000124784.4,7389808,6-7442624-C-T,rs76117671,1,C,T,7442624,52816,7193200,7586416,249424
6,ENSG00000124786.8,8435545,6-8262962-C-T,rs76333269,-1,C,T,8262962,172583,8238937,8632153,24025
6,ENSG00000124786.8,8435545,6-8262962-C-G,rs76333269,-1,C,G,8262962,172583,8238937,8632153,24025
6,ENSG00000112312.5,24774937,6-24916871-G-A,rs76656398,1,G,A,24916871,141934,24578329,24971545,338542
6,ENSG00000198755.6,35468401,6-35377791-G-A,rs76690650,1,G,A,35377791,90610,35271793,35665009,105998
6,ENSG00000131018.16,152637362,6-152816167-C-A,rs76718311,-1,C,A,152816167,178805,152440754,152833970,375413
6,ENSG00000118508.4,146543833,6-146631279-T-C,rs76877742,1,T,C,146631279,87446,146347225,146740441,284054
6,ENSG00000124787.9,5004037,6-4931884-T-G,rs77281944,-1,T,G,4931884,72153,4807429,5200645,124455
6,ENSG00000124787.9,5004037,6-4931884-T-C,rs77281944,-1,T,C,4931884,72153,4807429,5200645,124455
6,ENSG00000111859.12,11232668,6-11222975-C-A,rs7739306,-1,C,A,11222975,9693,11036060,11429276,186915
6,ENSG00000111859.12,11232668,6-11222975-C-T,rs7739306,-1,C,T,11222975,9693,11036060,11429276,186915
6,ENSG00000214338.6,127519191,6-127519665-A-G,rs7749831,-1,A,G,127519665,474,127322583,127715799,197082
6,ENSG00000214338.6,127519191,6-127519665-A-C,rs7749831,-1,A,C,127519665,474,127322583,127715799,197082
6,ENSG00000146085.6,49463253,6-49467981-G-A,rs7750700,-1,G,A,49467981,4728,49266645,49659861,201336
6,ENSG00000203872.5,87344813,6-87350973-T-C,rs7756440,1,T,C,87350973,6160,87148205,87541421,202768
6,ENSG00000074706.9,154356803,6-154262245-T-C,rs7761411,-1,T,C,154262245,94558,154160195,154553411,102050
6,ENSG00000085382.7,104859919,6-104896961-T-A,rs7762076,-1,T,A,104896961,37042,104663311,105056527,233650
6,ENSG00000085382.7,104859919,6-104896961-T-G,rs7762076,-1,T,G,104896961,37042,104663311,105056527,233650
6,ENSG00000146409.5,132798637,6-132825657-C-G,rs7769051,-1,C,G,132825657,27020,132602029,132995245,223628
6,ENSG00000146409.5,132798637,6-132825657-C-A,rs7769051,-1,C,A,132825657,27020,132602029,132995245,223628
6,ENSG00000135541.15,135497740,6-135605412-C-T,rs7769840,-1,C,T,135605412,107672,135301132,135694348,304280
6,ENSG00000170915.8,52362151,6-52352901-A-C,rs7772620,1,A,C,52352901,9250,52165543,52558759,187358
6,ENSG00000170915.8,52362151,6-52352901-A-G,rs7772620,1,A,G,52352901,9250,52165543,52558759,187358
6,ENSG00000096696.8,7541671,6-7555016-G-A,rs7774328,1,G,A,7555016,13345,7345063,7738279,209953
6,ENSG00000096696.8,7541671,6-7555016-G-C,rs7774328,1,G,C,7555016,13345,7345063,7738279,209953
6,ENSG00000164442.7,139374648,6-139316737-C-A,rs7775616,-1,C,A,139316737,57911,139178040,139571256,138697
6,ENSG00000164442.7,139374648,6-139316737-C-T,rs7775616,-1,C,T,139316737,57911,139178040,139571256,138697
6,ENSG00000164442.7,139374648,6-139316737-C-G,rs7775616,-1,C,G,139316737,57911,139178040,139571256,138697
6,ENSG00000196569.6,128883138,6-128977716-A-G,rs77880750,1,A,G,128977716,94578,128686530,129079746,291186
6,ENSG00000196569.6,128883138,6-128977716-A-C,rs77880750,1,A,C,128977716,94578,128686530,129079746,291186
6,ENSG00000118495.12,144008259,6-143971356-A-G,rs78198773,-1,A,G,143971356,36903,143811651,144204867,159705
6,ENSG00000120437.7,159762045,6-159679270-A-G,rs7855,1,A,G,159679270,82775,159565437,159958653,113833
6,ENSG00000171467.10,43369647,6-43182821-C-T,rs78780266,-1,C,T,43182821,186826,43173039,43566255,9782
6,ENSG00000164440.10,139291998,6-139433650-C-G,rs79324176,-1,C,G,139433650,141652,139095390,139488606,338260
6,ENSG00000146038.6,24358059,6-24546799-A-C,rs811100,-1,A,C,24546799,188740,24161451,24554667,385348
6,ENSG00000146038.6,24358059,6-24546799-A-G,rs811100,-1,A,G,24546799,188740,24161451,24554667,385348
6,ENSG00000146038.6,24358059,6-24546799-A-T,rs811100,-1,A,T,24546799,188740,24161451,24554667,385348
6,ENSG00000146281.5,89146055,6-89047612-T-C,rs855568,1,T,C,89047612,98443,88949447,89342663,98165
6,ENSG00000124635.6,27132795,6-27205737-G-C,rs858983,-1,G,C,27205737,72942,26936187,27329403,269550
6,ENSG00000124635.6,27132795,6-27205737-G-A,rs858983,-1,G,A,27205737,72942,26936187,27329403,269550
6,ENSG00000180992.5,44127452,6-44108162-A-G,rs877112,-1,A,G,44108162,19290,43930844,44324060,177318
6,ENSG00000204525.8,31272092,6-31330463-G-A,rs9265549,-1,G,A,31330463,58371,31075484,31468700,254979
6,ENSG00000204525.8,31272092,6-31330463-G-C,rs9265549,-1,G,C,31330463,58371,31075484,31468700,254979
6,ENSG00000204428.7,31680377,6-31681372-C-G,rs9267535,-1,C,G,31681372,995,31483769,31876985,197603
6,ENSG00000204428.7,31680377,6-31681372-C-T,rs9267535,-1,C,T,31681372,995,31483769,31876985,197603
6,ENSG00000196735.6,32637406,6-32460285-C-T,rs9268833,1,C,T,32460285,177121,32440798,32834014,19487
6,ENSG00000196126.6,32589848,6-32622293-A-G,rs9271541,-1,A,G,32622293,32445,32393240,32786456,229053
6,ENSG00000196126.6,32589848,6-32622293-A-C,rs9271541,-1,A,C,32622293,32445,32393240,32786456,229053
6,ENSG00000204287.8,32439887,6-32628097-C-T,rs9271894,1,C,T,32628097,188210,32243279,32636495,384818
6,ENSG00000204287.8,32439887,6-32628097-C-G,rs9271894,1,C,G,32628097,188210,32243279,32636495,384818
6,ENSG00000179344.11,32666657,6-32660921-C-A,rs9273529,-1,C,A,32660921,5736,32470049,32863265,190872
6,ENSG00000179344.11,32666657,6-32660921-C-T,rs9273529,-1,C,T,32660921,5736,32470049,32863265,190872
6,ENSG00000146166.11,63319983,6-63248692-G-C,rs9294140,-1,G,C,63248692,71291,63123375,63516591,125317
6,ENSG00000146166.11,63319983,6-63248692-G-T,rs9294140,-1,G,T,63248692,71291,63123375,63516591,125317
6,ENSG00000146166.11,63319983,6-63248692-G-A,rs9294140,-1,G,A,63248692,71291,63123375,63516591,125317
6,ENSG00000198315.5,28141883,6-28241324-G-A,rs9295768,1,G,A,28241324,99441,27945275,28338491,296049
6,ENSG00000030110.7,33580276,6-33574746-T-G,rs9296095,-1,T,G,33574746,5530,33383668,33776884,191078
6,ENSG00000030110.7,33580276,6-33574746-T-C,rs9296095,-1,T,C,33574746,5530,33383668,33776884,191078
6,ENSG00000124491.9,6320662,6-6399916-G-A,rs9328360,-1,G,A,6399916,79254,6124054,6517270,275862
6,ENSG00000175048.11,157381190,6-157554797-A-C,rs9331344,1,A,C,157554797,173607,157184582,157577798,370215
6,ENSG00000175048.11,157381190,6-157554797-A-G,rs9331344,1,A,G,157554797,173607,157184582,157577798,370215
6,ENSG00000078269.9,157981863,6-158031312-C-A,rs9347027,1,C,A,158031312,49449,157785255,158178471,246057
6,ENSG00000213886.3,29559732,6-29488244-G-A,rs9348832,-1,G,A,29488244,71488,29363124,29756340,125120
6,ENSG00000213886.3,29559732,6-29488244-G-T,rs9348832,-1,G,T,29488244,71488,29363124,29756340,125120
6,ENSG00000146243.8,78867551,6-78862961-G-T,rs9352668,1,G,T,78862961,4590,78670943,79064159,192018
6,ENSG00000146243.8,78867551,6-78862961-G-A,rs9352668,1,G,A,78862961,4590,78670943,79064159,192018
6,ENSG00000112763.10,26457955,6-26479663-G-C,rs9357008,1,G,C,26479663,21708,26261347,26654563,218316
6,ENSG00000112763.10,26457955,6-26479663-G-T,rs9357008,1,G,T,26479663,21708,26261347,26654563,218316
6,ENSG00000146109.3,26596953,6-26479663-G-C,rs9357008,1,G,C,26479663,117290,26400345,26793561,79318
6,ENSG00000146109.3,26596953,6-26479663-G-T,rs9357008,1,G,T,26479663,117290,26400345,26793561,79318
6,ENSG00000118418.10,79234689,6-79116431-C-G,rs9361491,-1,C,G,79116431,118258,79038081,79431297,78350
6,ENSG00000118418.10,79234689,6-79116431-C-A,rs9361491,-1,C,A,79116431,118258,79038081,79431297,78350
6,ENSG00000118418.10,79234689,6-79116431-C-T,rs9361491,-1,C,T,79116431,118258,79038081,79431297,78350
6,ENSG00000112309.6,70957060,6-70797455-T-C,rs9364106,-1,T,C,70797455,159605,70760452,71153668,37003
6,ENSG00000153157.8,10887052,6-10887018-T-G,rs9366663,1,T,G,10887018,34,10690444,11083660,196574
6,ENSG00000153157.8,10887052,6-10887018-T-C,rs9366663,1,T,C,10887018,34,10690444,11083660,196574
6,ENSG00000153157.8,10887052,6-10887018-T-A,rs9366663,1,T,A,10887018,34,10690444,11083660,196574
6,ENSG00000124496.8,42452045,6-42497689-T-G,rs9367148,-1,T,G,42497689,45644,42255437,42648653,242252
6,ENSG00000124496.8,42452045,6-42497689-T-A,rs9367148,-1,T,A,42497689,45644,42255437,42648653,242252
6,ENSG00000124613.4,27388759,6-27327303-A-G,rs9368501,1,A,G,27327303,61456,27192151,27585367,135152
6,ENSG00000124613.4,27388759,6-27327303-A-T,rs9368501,1,A,T,27327303,61456,27192151,27585367,135152
6,ENSG00000124613.4,27388759,6-27327303-A-C,rs9368501,1,A,C,27327303,61456,27192151,27585367,135152
6,ENSG00000204435.8,31666080,6-31834907-A-T,rs9368700,1,A,T,31834907,168827,31469472,31862688,365435
6,ENSG00000204435.8,31666080,6-31834907-A-G,rs9368700,1,A,G,31834907,168827,31469472,31862688,365435
6,ENSG00000204435.8,31666080,6-31834907-A-C,rs9368700,1,A,C,31834907,168827,31469472,31862688,365435
6,ENSG00000146416.10,143060889,6-143138242-G-A,rs9373375,1,G,A,143138242,77353,142864281,143257497,273961
6,ENSG00000131013.3,149546043,6-149560687-G-A,rs9373596,-1,G,A,149560687,14644,149349435,149742651,211252
6,ENSG00000153975.5,116668766,6-116750220-C-A,rs9374622,-1,C,A,116750220,81454,116472158,116865374,278062
6,ENSG00000153975.5,116668766,6-116750220-C-T,rs9374622,-1,C,T,116750220,81454,116472158,116865374,278062
6,ENSG00000153975.5,116668766,6-116750220-C-G,rs9374622,-1,C,G,116750220,81454,116472158,116865374,278062
6,ENSG00000112306.7,132814569,6-132866046-T-G,rs9375927,1,T,G,132866046,51477,132617961,133011177,248085
6,ENSG00000112306.7,132814569,6-132866046-T-A,rs9375927,1,T,A,132866046,51477,132617961,133011177,248085
6,ENSG00000009844.9,142147263,6-142305562-T-G,rs9376683,1,T,G,142305562,158299,141950655,142343871,354907
6,ENSG00000009844.9,142147263,6-142305562-T-C,rs9376683,1,T,C,142305562,158299,141950655,142343871,354907
6,ENSG00000009844.9,142147263,6-142305562-T-A,rs9376683,1,T,A,142305562,158299,141950655,142343871,354907
6,ENSG00000112419.9,143677965,6-143613568-G-C,rs9376770,1,G,C,143613568,64397,143481357,143874573,132211
6,ENSG00000112419.9,143677965,6-143613568-G-T,rs9376770,1,G,T,143613568,64397,143481357,143874573,132211
6,ENSG00000145982.5,5261513,6-5246699-C-G,rs9378420,1,C,G,5246699,14814,5064905,5458121,181794
6,ENSG00000145982.5,5261513,6-5246699-C-T,rs9378420,1,C,T,5246699,14814,5064905,5458121,181794
6,ENSG00000124783.8,7313199,6-7504124-C-T,rs9379111,-1,C,T,7504124,190925,7116591,7509807,387533
6,ENSG00000096060.8,35688915,6-35690550-C-T,rs9380526,-1,C,T,35690550,1635,35492307,35885523,198243
6,ENSG00000172594.8,122789258,6-122855468-C-G,rs9385272,1,C,G,122855468,66210,122592650,122985866,262818
6,ENSG00000172594.8,122789258,6-122855468-C-T,rs9385272,1,C,T,122855468,66210,122592650,122985866,262818
6,ENSG00000178199.9,149485014,6-149509525-C-A,rs9399689,-1,C,A,149509525,24511,149288406,149681622,221119
6,ENSG00000178199.9,149485014,6-149509525-C-T,rs9399689,-1,C,T,149509525,24511,149288406,149681622,221119
6,ENSG00000178425.7,116100853,6-116278502-T-C,rs9400897,1,T,C,116278502,177649,115904245,116297461,374257
6,ENSG00000178425.7,116100853,6-116278502-T-A,rs9400897,1,T,A,116278502,177649,115904245,116297461,374257
6,ENSG00000146350.9,121334480,6-121513172-A-C,rs9401410,-1,A,C,121513172,178692,121137872,121531088,375300
6,ENSG00000132423.6,99394195,6-99435818-T-C,rs9402791,-1,T,C,99435818,41623,99197587,99590803,238231
6,ENSG00000135521.8,143843338,6-144013430-T-A,rs9403544,1,T,A,144013430,170092,143646730,144039946,366700
6,ENSG00000135521.8,143843338,6-144013430-T-C,rs9403544,1,T,C,144013430,170092,143646730,144039946,366700
6,ENSG00000112706.7,76072662,6-75947981-C-G,rs943085,-1,C,G,75947981,124681,75876054,76269270,71927
6,ENSG00000112706.7,76072662,6-75947981-C-T,rs943085,-1,C,T,75947981,124681,75876054,76269270,71927
6,ENSG00000112706.7,76072662,6-75947981-C-A,rs943085,-1,C,A,75947981,124681,75876054,76269270,71927
6,ENSG00000013392.5,83193357,6-83125480-C-T,rs9444038,1,C,T,83125480,67877,82996749,83389965,128731
6,ENSG00000118402.5,79947553,6-79905099-G-A,rs9448846,-1,G,A,79905099,42454,79750945,80144161,154154
6,ENSG00000112773.11,81752681,6-81807251-G-A,rs9449367,-1,G,A,81807251,54570,81556073,81949289,251178
6,ENSG00000013375.9,83193265,6-83202082-G-A,rs9449589,-1,G,A,83202082,8817,82996657,83389873,205425
6,ENSG00000135318.6,85450083,6-85485580-A-G,rs9450282,1,A,G,85485580,35497,85253475,85646691,232105
6,ENSG00000135318.6,85450083,6-85485580-A-T,rs9450282,1,A,T,85485580,35497,85253475,85646691,232105
6,ENSG00000146433.7,158560091,6-158559319-A-G,rs9457403,1,A,G,158559319,772,158363483,158756699,195836
6,ENSG00000130340.9,157823246,6-157801208-G-T,rs9458540,1,G,T,157801208,22038,157626638,158019854,174570
6,ENSG00000112592.6,170554369,6-170384238-G-A,rs9459997,1,G,A,170384238,170131,170357761,170750977,26477
6,ENSG00000111843.8,10723070,6-10629451-G-A,rs9460954,1,G,A,10629451,93619,10526462,10919678,102989
6,ENSG00000244731.3,31982057,6-31863944-G-T,rs9461727,1,G,T,31863944,118113,31785449,32178665,78495
6,ENSG00000186470.7,26365198,6-26340557-G-C,rs9467714,1,G,C,26340557,24641,26168590,26561806,171967
6,ENSG00000186470.7,26365198,6-26340557-G-A,rs9467714,1,G,A,26340557,24641,26168590,26561806,171967
6,ENSG00000158373.7,26158122,6-26341073-T-G,rs9467715,1,T,G,26341073,182951,25961514,26354730,379559
6,ENSG00000158373.7,26158122,6-26341073-T-C,rs9467715,1,T,C,26341073,182951,25961514,26354730,379559
6,ENSG00000156711.10,36130513,6-36107442-A-G,rs9470219,1,A,G,36107442,23071,35933905,36327121,173537
6,ENSG00000156711.10,36130513,6-36107442-A-C,rs9470219,1,A,C,36107442,23071,35933905,36327121,173537
6,ENSG00000078401.6,12290361,6-12307032-T-C,rs9471438,1,T,C,12307032,16671,12093753,12486969,213279
6,ENSG00000031691.5,49463370,6-49523592-C-T,rs9473583,1,C,T,49523592,60222,49266762,49659978,256830
6,ENSG00000153721.11,154510685,6-154441846-A-T,rs9479857,-1,A,T,154441846,68839,154314077,154707293,127769
6,ENSG00000153721.11,154510685,6-154441846-A-G,rs9479857,-1,A,G,154441846,68839,154314077,154707293,127769
6,ENSG00000153721.11,154510685,6-154441846-A-C,rs9479857,-1,A,C,154441846,68839,154314077,154707293,127769
6,ENSG00000178409.9,107115515,6-107076383-G-A,rs9480726,-1,G,A,107076383,39132,106918907,107312123,157476
6,ENSG00000111906.12,125301967,6-125312223-A-C,rs9482641,-1,A,C,125312223,10256,125105359,125498575,206864
6,ENSG00000111906.12,125301967,6-125312223-A-T,rs9482641,-1,A,T,125312223,10256,125105359,125498575,206864
6,ENSG00000111906.12,125301967,6-125312223-A-G,rs9482641,-1,A,G,125312223,10256,125105359,125498575,206864
6,ENSG00000112218.5,96837477,6-96805860-T-C,rs9487199,-1,T,C,96805860,31617,96640869,97034085,164991
6,ENSG00000112218.5,96837477,6-96805860-T-A,rs9487199,-1,T,A,96805860,31617,96640869,97034085,164991
6,ENSG00000196911.5,116681211,6-116630515-A-C,rs9488991,1,A,C,116630515,50696,116484603,116877819,145912
6,ENSG00000007866.13,35497064,6-35403558-C-T,rs9658122,-1,C,T,35403558,93506,35300456,35693672,103102
6,ENSG00000124523.9,13574601,6-13456584-C-T,rs966255,1,C,T,13456584,118017,13377993,13771209,78591
6,ENSG00000001561.5,46129989,6-46096908-A-G,rs976083,1,A,G,46096908,33081,45933381,46326597,163527
6,ENSG00000001561.5,46129989,6-46096908-A-T,rs976083,1,A,T,46096908,33081,45933381,46326597,163527
6,ENSG00000124615.12,39934462,6-39966593-C-G,rs979044,-1,C,G,39966593,32131,39737854,40131070,228739
6,ENSG00000124615.12,39934462,6-39966593-C-T,rs979044,-1,C,T,39966593,32131,39737854,40131070,228739
6,ENSG00000124713.5,42960754,6-42975041-A-G,rs9986447,1,A,G,42975041,14287,42764146,43157362,210895
6,ENSG00000112210.6,57222307,6-57260083-T-A,rs1013147,-1,T,A,57260083,37776,57025699,57418915,234384
6,ENSG00000112210.6,57222307,6-57260083-T-C,rs1013147,-1,T,C,57260083,37776,57025699,57418915,234384
6,ENSG00000112592.6,170554369,6-170374153-G-T,rs1022615,1,G,T,170374153,180216,170357761,170750977,16392
6,ENSG00000112592.6,170554369,6-170374153-G-C,rs1022615,1,G,C,170374153,180216,170357761,170750977,16392
6,ENSG00000112592.6,170554369,6-170374153-G-A,rs1022615,1,G,A,170374153,180216,170357761,170750977,16392
6,ENSG00000112167.5,39115186,6-39077545-A-C,rs10305488,-1,A,C,39077545,37641,38918578,39311794,158967
6,ENSG00000112167.5,39115186,6-39077545-A-G,rs10305488,-1,A,G,39077545,37641,38918578,39311794,158967
6,ENSG00000047579.13,15663028,6-15537094-T-C,rs10456773,-1,T,C,15537094,125934,15466420,15859636,70674
6,ENSG00000112619.6,42722597,6-42646106-T-C,rs10484912,-1,T,C,42646106,76491,42525989,42919205,120117
6,ENSG00000050393.6,13814557,6-13782388-G-A,rs1062066,-1,G,A,13782388,32169,13617949,14011165,164439
6,ENSG00000214736.3,41787694,6-41925071-G-A,rs10947996,1,G,A,41925071,137377,41591086,41984302,333985
6,ENSG00000214736.3,41787694,6-41925071-G-T,rs10947996,1,G,T,41925071,137377,41591086,41984302,333985
6,ENSG00000189367.9,127459389,6-127471066-G-A,rs11154413,-1,G,A,127471066,11677,127262781,127655997,208285
6,ENSG00000197442.7,136792477,6-136792110-G-C,rs114489274,-1,G,C,136792110,367,136595869,136989085,196241
6,ENSG00000197442.7,136792477,6-136792110-G-A,rs114489274,-1,G,A,136792110,367,136595869,136989085,196241
6,ENSG00000204248.5,33192467,6-33191522-A-C,rs115831888,-1,A,C,33191522,945,32995859,33389075,195663
6,ENSG00000111863.7,11778803,6-11636299-G-A,rs115988391,-1,G,A,11636299,142504,11582195,11975411,54104
6,ENSG00000111863.7,11778803,6-11636299-G-C,rs115988391,-1,G,C,11636299,142504,11582195,11975411,54104
6,ENSG00000112343.7,25962802,6-25870314-T-A,rs1165205,1,T,A,25870314,92488,25766194,26159410,104120
6,ENSG00000112343.7,25962802,6-25870314-T-C,rs1165205,1,T,C,25870314,92488,25766194,26159410,104120
6,ENSG00000112343.7,25962802,6-25870314-T-G,rs1165205,1,T,G,25870314,92488,25766194,26159410,104120
6,ENSG00000164691.11,159044991,6-159186071-A-G,rs116942979,-1,A,G,159186071,141080,158848383,159241599,337688
6,ENSG00000082269.12,70413508,6-70345915-T-C,rs117062375,1,T,C,70345915,67593,70216900,70610116,129015
6,ENSG00000118418.10,79234689,6-79244968-G-A,rs11755402,-1,G,A,79244968,10279,79038081,79431297,206887
6,ENSG00000137168.7,36874803,6-36826798-C-T,rs11758807,-1,C,T,36826798,48005,36678195,37071411,148603
6,ENSG00000093144.13,127343609,6-127186258-T-C,rs11759578,-1,T,C,127186258,157351,127147001,127540217,39257
6,ENSG00000204439.2,31660778,6-31661861-G-C,rs11965323,-1,G,C,31661861,1083,31464170,31857386,197691
6,ENSG00000204439.2,31660778,6-31661861-G-T,rs11965323,-1,G,T,31661861,1083,31464170,31857386,197691
6,ENSG00000137413.11,42050524,6-42051145-G-T,rs11967378,1,G,T,42051145,621,41853916,42247132,197229
6,ENSG00000137413.11,42050524,6-42051145-G-C,rs11967378,1,G,C,42051145,621,41853916,42247132,197229
6,ENSG00000156639.7,37819727,6-37665564-G-A,rs12191101,1,G,A,37665564,154163,37623119,38016335,42445
6,ENSG00000137269.9,53795005,6-53819240-A-G,rs12195491,1,A,G,53819240,24235,53598397,53991613,220843
6,ENSG00000178425.7,116100853,6-116168387-A-T,rs12196141,1,A,T,116168387,67534,115904245,116297461,264142
6,ENSG00000178425.7,116100853,6-116168387-A-C,rs12196141,1,A,C,116168387,67534,115904245,116297461,264142
6,ENSG00000178425.7,116100853,6-116168387-A-G,rs12196141,1,A,G,116168387,67534,115904245,116297461,264142
6,ENSG00000146285.9,107824313,6-107832815-C-T,rs12202454,-1,C,T,107832815,8502,107627705,108020921,205110
6,ENSG00000146285.9,107824313,6-107832815-C-A,rs12202454,-1,C,A,107832815,8502,107627705,108020921,205110
6,ENSG00000124788.12,16761460,6-16693946-T-C,rs12204969,-1,T,C,16693946,67514,16564852,16958068,129094
6,ENSG00000010704.13,26087429,6-26116754-C-T,rs12206204,1,C,T,26116754,29325,25890821,26284037,225933
6,ENSG00000112378.9,138107419,6-137995866-G-A,rs12210441,-1,G,A,137995866,111553,137910811,138304027,85055
6,ENSG00000027697.7,137219385,6-137293081-T-A,rs12213281,-1,T,A,137293081,73696,137022777,137415993,270304
6,ENSG00000137177.13,17987635,6-17804886-C-T,rs12213755,-1,C,T,17804886,182749,17791027,18184243,13859
6,ENSG00000137177.13,17987635,6-17804886-C-A,rs12213755,-1,C,A,17804886,182749,17791027,18184243,13859
6,ENSG00000137177.13,17987635,6-17804886-C-G,rs12213755,-1,C,G,17804886,182749,17791027,18184243,13859
6,ENSG00000112218.5,96837477,6-96898113-A-G,rs12524027,-1,A,G,96898113,60636,96640869,97034085,257244
6,ENSG00000146457.10,159727506,6-159665056-G-A,rs12529327,1,G,A,159665056,62450,159530898,159924114,134158
6,ENSG00000204580.6,30884519,6-30876483-G-A,rs1264334,1,G,A,30876483,8036,30687911,31081127,188572
6,ENSG00000204592.5,30489509,6-30490287-G-A,rs1264457,1,G,A,30490287,778,30292901,30686117,197386
6,ENSG00000204592.5,30489509,6-30490287-G-T,rs1264457,1,G,T,30490287,778,30292901,30686117,197386
6,ENSG00000204525.8,31272092,6-31175917-G-A,rs1265155,-1,G,A,31175917,96175,31075484,31468700,100433
6,ENSG00000204525.8,31272092,6-31175917-G-C,rs1265155,-1,G,C,31175917,96175,31075484,31468700,100433
6,ENSG00000026950.12,26402275,6-26462128-C-T,rs12660069,1,C,T,26462128,59853,26205667,26598883,256461
6,ENSG00000083099.6,89638747,6-89488530-A-C,rs12660909,-1,A,C,89488530,150217,89442139,89835355,46391
6,ENSG00000137364.4,18155077,6-18181114-C-T,rs12664214,-1,C,T,18181114,26037,17958469,18351685,222645
6,ENSG00000155115.6,110958706,6-110825620-C-T,rs1292123,1,C,T,110825620,133086,110762098,111155314,63522
6,ENSG00000261272.1,31010474,6-31144960-C-A,rs130079,1,C,A,31144960,134486,30813866,31207082,331094
6,ENSG00000118496.3,145814795,6-145999392-A-T,rs1304095,-1,A,T,145999392,184597,145618187,146011403,381205
6,ENSG00000118496.3,145814795,6-145999392-A-G,rs1304095,-1,A,G,145999392,184597,145618187,146011403,381205
6,ENSG00000124641.10,41921139,6-42017491-C-T,rs13204359,-1,C,T,42017491,96352,41724531,42117747,292960
6,ENSG00000013392.5,83193357,6-83377940-A-G,rs13205856,1,A,G,83377940,184583,82996749,83389965,381191
6,ENSG00000137288.4,33711700,6-33652231-C-A,rs1408711,-1,C,A,33652231,59469,33515092,33908308,137139
6,ENSG00000137288.4,33711700,6-33652231-C-G,rs1408711,-1,C,G,33652231,59469,33515092,33908308,137139
6,ENSG00000137288.4,33711700,6-33652231-C-T,rs1408711,-1,C,T,33652231,59469,33515092,33908308,137139
6,ENSG00000096433.5,33621322,6-33652231-C-A,rs1408711,1,C,A,33652231,30909,33424714,33817930,227517
6,ENSG00000096433.5,33621322,6-33652231-C-G,rs1408711,1,C,G,33652231,30909,33424714,33817930,227517
6,ENSG00000096433.5,33621322,6-33652231-C-T,rs1408711,1,C,T,33652231,30909,33424714,33817930,227517
6,ENSG00000112706.7,76072662,6-76127065-A-T,rs1486053,-1,A,T,76127065,54403,75876054,76269270,251011
6,ENSG00000112706.7,76072662,6-76127065-A-G,rs1486053,-1,A,G,76127065,54403,75876054,76269270,251011
6,ENSG00000196747.3,27808173,6-27997045-A-C,rs149940,1,A,C,27997045,188872,27611565,28004781,385480
6,ENSG00000026297.10,166956550,6-167039757-T-A,rs151604,-1,T,A,167039757,83207,166759942,167153158,279815
6,ENSG00000026297.10,166956550,6-167039757-T-G,rs151604,-1,T,G,167039757,83207,166759942,167153158,279815
6,ENSG00000026297.10,166956550,6-167039757-T-C,rs151604,-1,T,C,167039757,83207,166759942,167153158,279815
6,ENSG00000112812.10,27247701,6-27346292-G-A,rs1555040,1,G,A,27346292,98591,27051093,27444309,295199
6,ENSG00000112812.10,27247701,6-27346292-G-T,rs1555040,1,G,T,27346292,98591,27051093,27444309,295199
6,ENSG00000112812.10,27247701,6-27346292-G-C,rs1555040,1,G,C,27346292,98591,27051093,27444309,295199
6,ENSG00000204227.4,33208500,6-33215093-G-A,rs1567464,1,G,A,33215093,6593,33011892,33405108,203201
6,ENSG00000204681.5,29633183,6-29712244-C-G,rs1611371,-1,C,G,29712244,79061,29436575,29829791,275669
6,ENSG00000204681.5,29633183,6-29712244-C-T,rs1611371,-1,C,T,29712244,79061,29436575,29829791,275669
6,ENSG00000171453.11,43517089,6-43463262-C-T,rs1622800,1,C,T,43463262,53827,43320481,43713697,142781
6,ENSG00000171453.11,43517089,6-43463262-C-A,rs1622800,1,C,A,43463262,53827,43320481,43713697,142781
6,ENSG00000029639.6,155314484,6-155374516-T-A,rs162993,-1,T,A,155374516,60032,155117876,155511092,256640
6,ENSG00000029639.6,155314484,6-155374516-T-G,rs162993,-1,T,G,155374516,60032,155117876,155511092,256640
6,ENSG00000029639.6,155314484,6-155374516-T-C,rs162993,-1,T,C,155374516,60032,155117876,155511092,256640
6,ENSG00000237441.3,33298942,6-33293669-A-G,rs16869023,-1,A,G,33293669,5273,33102334,33495550,191335
6,ENSG00000111859.12,11232668,6-11193497-A-C,rs16871072,-1,A,C,11193497,39171,11036060,11429276,157437
6,ENSG00000111886.8,89315299,6-89342196-A-T,rs16881711,-1,A,T,89342196,26897,89118691,89511907,223505
6,ENSG00000111886.8,89315299,6-89342196-A-G,rs16881711,-1,A,G,89342196,26897,89118691,89511907,223505
6,ENSG00000185760.10,72622064,6-72712644-G-A,rs16882726,1,G,A,72712644,90580,72425456,72818672,287188
6,ENSG00000256980.3,73225496,6-73300891-A-G,rs16883564,-1,A,G,73300891,75395,73028888,73422104,272003
6,ENSG00000197153.3,27890826,6-28046799-G-A,rs16893601,-1,G,A,28046799,155973,27694218,28087434,352581
6,ENSG00000197153.3,27890826,6-28046799-G-T,rs16893601,-1,G,T,28046799,155973,27694218,28087434,352581
6,ENSG00000197062.6,28267143,6-28422453-C-T,rs16894095,1,C,T,28422453,155310,28070535,28463751,351918
6,ENSG00000111897.5,122471807,6-122659414-C-T,rs17052989,-1,C,T,122659414,187607,122275199,122668415,384215
6,ENSG00000111897.5,122471807,6-122659414-C-G,rs17052989,-1,C,G,122659414,187607,122275199,122668415,384215
6,ENSG00000010810.11,111873452,6-111961196-G-A,rs17073100,-1,G,A,111961196,87744,111676844,112070060,284352
6,ENSG00000091844.2,153131282,6-153089540-A-G,rs17083538,-1,A,G,153089540,41742,152934674,153327890,154866
6,ENSG00000025156.7,122399652,6-122422593-C-T,rs17084528,1,C,T,122422593,22941,122203044,122596260,219549
6,ENSG00000204516.5,31498145,6-31601743-G-A,rs17207190,1,G,A,31601743,103598,31301537,31694753,300206
6,ENSG00000204516.5,31498145,6-31601743-G-T,rs17207190,1,G,T,31601743,103598,31301537,31694753,300206
6,ENSG00000187987.5,28443491,6-28332559-A-G,rs17312661,-1,A,G,28332559,110932,28246883,28640099,85676
6,ENSG00000232040.2,28587298,6-28757075-G-C,rs17398081,-1,G,C,28757075,169777,28390690,28783906,366385
6,ENSG00000137409.12,36986196,6-37002079-C-T,rs1753285,-1,C,T,37002079,15883,36789588,37182804,212491
6,ENSG00000170899.6,52995284,6-53133137-C-A,rs17670011,-1,C,A,53133137,137853,52798676,53191892,334461
6,ENSG00000111860.9,118651591,6-118706687-A-C,rs1771752,-1,A,C,118706687,55096,118454983,118848199,251704
6,ENSG00000122194.12,160702244,6-160775768-A-C,rs1782627,1,A,C,160775768,73524,160505636,160898852,270132
6,ENSG00000122194.12,160702244,6-160775768-A-G,rs1782627,1,A,G,160775768,73524,160505636,160898852,270132
6,ENSG00000111981.3,149963943,6-149977706-C-T,rs1853665,1,C,T,149977706,13763,149767335,150160551,210371
6,ENSG00000112679.9,292487,6-403604-G-A,rs1877179,1,G,A,403604,111117,95879,489095,307725
6,ENSG00000180596.6,26123926,6-26306456-C-A,rs1883214,-1,C,A,26306456,182530,25927318,26320534,379138
6,ENSG00000223865.4,33075990,6-33118671-G-A,rs1883414,1,G,A,33118671,42681,32879382,33272598,239289
6,ENSG00000223865.4,33075990,6-33118671-G-T,rs1883414,1,G,T,33118671,42681,32879382,33272598,239289
6,ENSG00000008083.8,15246069,6-15133634-G-C,rs1884121,1,G,C,15133634,112435,15049461,15442677,84173
6,ENSG00000008083.8,15246069,6-15133634-G-A,rs1884121,1,G,A,15133634,112435,15049461,15442677,84173
6,ENSG00000135521.8,143843338,6-143696641-C-T,rs1884172,1,C,T,143696641,146697,143646730,144039946,49911
6,ENSG00000153157.8,10887052,6-10904731-T-A,rs1890486,1,T,A,10904731,17679,10690444,11083660,214287
6,ENSG00000153157.8,10887052,6-10904731-T-C,rs1890486,1,T,C,10904731,17679,10690444,11083660,214287
6,ENSG00000153157.8,10887052,6-10904731-T-G,rs1890486,1,T,G,10904731,17679,10690444,11083660,214287
6,ENSG00000010818.4,142945176,6-142754477-A-G,rs197476,-1,A,G,142754477,190699,142748568,143141784,5909
6,ENSG00000010818.4,142945176,6-142754477-A-T,rs197476,-1,A,T,142754477,190699,142748568,143141784,5909
6,ENSG00000197238.3,27824092,6-27847716-C-T,rs200991,1,C,T,27847716,23624,27627484,28020700,220232
6,ENSG00000197238.3,27824092,6-27847716-C-A,rs200991,1,C,A,27847716,23624,27627484,28020700,220232
6,ENSG00000204590.7,30556489,6-30481705-G-A,rs2021719,-1,G,A,30481705,74784,30359881,30753097,121824
6,ENSG00000118514.9,134950101,6-135118125-A-C,rs2026937,-1,A,C,135118125,168024,134753493,135146709,364632
6,ENSG00000118514.9,134950101,6-135118125-A-G,rs2026937,-1,A,G,135118125,168024,134753493,135146709,364632
6,ENSG00000112799.3,6588720,6-6568789-G-C,rs2039510,1,G,C,6568789,19931,6392112,6785328,176677
6,ENSG00000112799.3,6588720,6-6568789-G-A,rs2039510,1,G,A,6568789,19931,6392112,6785328,176677
6,ENSG00000156711.10,36130513,6-36139395-G-A,rs2071863,1,G,A,36139395,8882,35933905,36327121,205490
6,ENSG00000074935.7,112087482,6-112189460-C-A,rs2072028,-1,C,A,112189460,101978,111890874,112284090,298586
6,ENSG00000184530.8,127577174,6-127588832-C-A,rs2121881,1,C,A,127588832,11658,127380566,127773782,208266
6,ENSG00000184530.8,127577174,6-127588832-C-T,rs2121881,1,C,T,127588832,11658,127380566,127773782,208266
6,ENSG00000164484.7,130366017,6-130449980-T-G,rs2209151,1,T,G,130449980,83963,130169409,130562625,280571
6,ENSG00000164484.7,130366017,6-130449980-T-C,rs2209151,1,T,C,130449980,83963,130169409,130562625,280571
6,ENSG00000204475.4,31593006,6-31572980-A-C,rs2229092,-1,A,C,31572980,20026,31396398,31789614,176582
6,ENSG00000168631.6,30940973,6-31113428-T-C,rs2233956,1,T,C,31113428,172455,30744365,31137581,369063
6,ENSG00000034693.8,143450805,6-143382476-T-C,rs223597,1,T,C,143382476,68329,143254197,143647413,128279
6,ENSG00000204482.5,31586277,6-31587353-A-T,rs2256965,1,A,T,31587353,1076,31389669,31782885,197684
6,ENSG00000204482.5,31586277,6-31587353-A-G,rs2256965,1,A,G,31587353,1076,31389669,31782885,197684
6,ENSG00000065308.4,52577060,6-52490408-T-G,rs2273120,-1,T,G,52490408,86652,52380452,52773668,109956
6,ENSG00000065308.4,52577060,6-52490408-T-C,rs2273120,-1,T,C,52490408,86652,52380452,52773668,109956
6,ENSG00000065308.4,52577060,6-52490408-T-A,rs2273120,-1,T,A,52490408,86652,52380452,52773668,109956
6,ENSG00000096654.10,27473105,6-27309886-G-T,rs2281023,-1,G,T,27309886,163219,27276497,27669713,33389
6,ENSG00000096654.10,27473105,6-27309886-G-A,rs2281023,-1,G,A,27309886,163219,27276497,27669713,33389
6,ENSG00000112299.7,132714055,6-132724673-G-A,rs2294758,-1,G,A,132724673,10618,132517447,132910663,207226
6,ENSG00000118508.4,146543833,6-146364188-T-C,rs2300619,1,T,C,146364188,179645,146347225,146740441,16963
6,ENSG00000124772.7,36839444,6-36778804-C-G,rs236418,-1,C,G,36778804,60640,36642836,37036052,135968
6,ENSG00000124772.7,36839444,6-36778804-C-T,rs236418,-1,C,T,36778804,60640,36642836,37036052,135968
6,ENSG00000226979.3,31572289,6-31384263-T-C,rs2442749,1,T,C,31384263,188026,31375681,31768897,8582
6,ENSG00000226979.3,31572289,6-31384263-T-A,rs2442749,1,T,A,31384263,188026,31375681,31768897,8582
6,ENSG00000204498.5,31547608,6-31562106-C-G,rs2516390,1,C,G,31562106,14498,31351000,31744216,211106
6,ENSG00000204498.5,31547608,6-31562106-C-T,rs2516390,1,C,T,31562106,14498,31351000,31744216,211106
6,ENSG00000241370.1,30345156,6-30378094-T-A,rs2524212,1,T,A,30378094,32938,30148548,30541764,229546
6,ENSG00000241370.1,30345156,6-30378094-T-C,rs2524212,1,T,C,30378094,32938,30148548,30541764,229546
6,ENSG00000241370.1,30345156,6-30378094-T-G,rs2524212,1,T,G,30378094,32938,30148548,30541764,229546
6,ENSG00000234745.3,31357179,6-31364462-A-C,rs2596551,-1,A,C,31364462,7283,31160571,31553787,203891
6,ENSG00000112697.10,75284792,6-75305271-A-G,rs2748254,-1,A,G,75305271,20479,75088184,75481400,217087
6,ENSG00000112697.10,75284792,6-75305271-A-T,rs2748254,-1,A,T,75305271,20479,75088184,75481400,217087
6,ENSG00000112096.11,159693241,6-159683812-G-T,rs2758330,-1,G,T,159683812,9429,159496633,159889849,187179
6,ENSG00000214113.5,5260950,6-5240666-C-T,rs2773296,-1,C,T,5240666,20284,5064342,5457558,176324
6,ENSG00000196126.6,32589848,6-32591976-T-C,rs28366266,-1,T,C,32591976,2128,32393240,32786456,198736
6,ENSG00000196735.6,32637406,6-32668919-G-A,rs28371206,1,G,A,32668919,31513,32440798,32834014,228121
6,ENSG00000124570.11,2971567,6-3005952-G-A,rs28383612,-1,G,A,3005952,34385,2774959,3168175,230993
6,ENSG00000198502.5,32530287,6-32713500-A-G,rs2858331,-1,A,G,32713500,183213,32333679,32726895,379821
6,ENSG00000184465.11,169702029,6-169830086-A-C,rs2864054,-1,A,C,169830086,128057,169505421,169898637,324665
6,ENSG00000184465.11,169702029,6-169830086-A-G,rs2864054,-1,A,G,169830086,128057,169505421,169898637,324665
6,ENSG00000112701.12,75601880,6-75426552-G-A,rs2951928,1,G,A,75426552,175328,75405272,75798488,21280
6,ENSG00000112293.8,24489578,6-24650533-A-G,rs3087943,-1,A,G,24650533,160955,24292970,24686186,357563
6,ENSG00000204428.7,31680377,6-31675622-T-A,rs3115667,-1,T,A,31675622,4755,31483769,31876985,191853
6,ENSG00000204428.7,31680377,6-31675622-T-C,rs3115667,-1,T,C,31675622,4755,31483769,31876985,191853
6,ENSG00000204428.7,31680377,6-31675622-T-G,rs3115667,-1,T,G,31675622,4755,31483769,31876985,191853
6,ENSG00000080007.6,73394828,6-73416165-A-C,rs311685,1,A,C,73416165,21337,73198220,73591436,217945
6,ENSG00000080007.6,73394828,6-73416165-A-G,rs311685,1,A,G,73416165,21337,73198220,73591436,217945
6,ENSG00000080007.6,73394828,6-73416165-A-T,rs311685,1,A,T,73416165,21337,73198220,73591436,217945
6,ENSG00000204228.3,33204655,6-33077781-G-A,rs3135021,1,G,A,33077781,126874,33008047,33401263,69734
6,ENSG00000021355.7,2841863,6-2932221-A-G,rs318449,-1,A,G,2932221,90358,2645255,3038471,286966
6,ENSG00000124535.10,2765393,6-2936966-G-C,rs318453,1,G,C,2936966,171573,2568785,2962001,368181
6,ENSG00000124535.10,2765393,6-2936966-G-A,rs318453,1,G,A,2936966,171573,2568785,2962001,368181
6,ENSG00000145949.8,2750922,6-2936966-G-C,rs318453,-1,G,C,2936966,186044,2554314,2947530,382652
6,ENSG00000145949.8,2750922,6-2936966-G-A,rs318453,-1,G,A,2936966,186044,2554314,2947530,382652
6,ENSG00000170542.5,2903309,6-2910764-A-C,rs318496,-1,A,C,2910764,7455,2706701,3099917,204063
6,ENSG00000170542.5,2903309,6-2910764-A-G,rs318496,-1,A,G,2910764,7455,2706701,3099917,204063
6,ENSG00000112796.4,46170980,6-46194030-G-T,rs34098343,-1,G,T,46194030,23050,45974372,46367588,219658
6,ENSG00000173214.5,111259339,6-111105762-C-T,rs34362588,1,C,T,111105762,153577,111062731,111455947,43031
6,ENSG00000204392.5,31806966,6-31809864-C-T,rs34814308,-1,C,T,31809864,2898,31610358,32003574,199506
6,ENSG00000112335.10,108261040,6-108374075-T-C,rs35153558,-1,T,C,108374075,113035,108064432,108457648,309643
6,ENSG00000172738.7,37258122,6-37218737-A-C,rs35867476,-1,A,C,37218737,39385,37061514,37454730,157223
6,ENSG00000172738.7,37258122,6-37218737-A-G,rs35867476,-1,A,G,37218737,39385,37061514,37454730,157223
6,ENSG00000048544.5,42217861,6-42239135-C-T,rs35884864,-1,C,T,42239135,21274,42021253,42414469,217882
6,ENSG00000146281.5,89146055,6-89178724-T-C,rs3734201,1,T,C,89178724,32669,88949447,89342663,229277
6,ENSG00000112357.7,136822592,6-136819855-T-C,rs3757167,1,T,C,136819855,2737,136625984,137019200,193871
6,ENSG00000146038.6,24358059,6-24414908-T-C,rs3761789,-1,T,C,24414908,56849,24161451,24554667,253457
6,ENSG00000124562.5,34757505,6-34855097-T-C,rs3777750,1,T,C,34855097,97592,34560897,34954113,294200
6,ENSG00000124562.5,34757505,6-34855097-T-G,rs3777750,1,T,G,34855097,97592,34560897,34954113,294200
6,ENSG00000183826.12,38639929,6-38678854-A-G,rs3799703,-1,A,G,38678854,38925,38443321,38836537,235533
6,ENSG00000196821.5,34696767,6-34648545-G-C,rs3800461,-1,G,C,34648545,48222,34500159,34893375,148386
6,ENSG00000146247.11,79078254,6-78962721-T-C,rs3805746,-1,T,C,78962721,115533,78881646,79274862,81075
6,ENSG00000079950.8,132513116,6-132589495-C-T,rs3813354,-1,C,T,132589495,76379,132316508,132709724,272987
6,ENSG00000123505.9,110874785,6-111067173-C-T,rs3851224,1,C,T,111067173,192388,110678177,111071393,388996
6,ENSG00000123505.9,110874785,6-111067173-C-G,rs3851224,1,C,G,111067173,192388,110678177,111071393,388996
6,ENSG00000112511.13,33411014,6-33440765-G-A,rs411136,1,G,A,33440765,29751,33214406,33607622,226359
6,ENSG00000112511.13,33411014,6-33440765-G-C,rs411136,1,G,C,33440765,29751,33214406,33607622,226359
6,ENSG00000124507.4,34466076,6-34418442-G-A,rs41269040,1,G,A,34418442,47634,34269468,34662684,148974
6,ENSG00000124507.4,34466076,6-34418442-G-T,rs41269040,1,G,T,34418442,47634,34269468,34662684,148974
6,ENSG00000112294.8,24494969,6-24425219-G-C,rs41271779,1,G,C,24425219,69750,24298361,24691577,126858
6,ENSG00000112294.8,24494969,6-24425219-G-A,rs41271779,1,G,A,24425219,69750,24298361,24691577,126858
6,ENSG00000112739.11,4021300,6-3884918-C-T,rs4145940,1,C,T,3884918,136382,3824692,4217908,60226
6,ENSG00000112739.11,4021300,6-3884918-C-G,rs4145940,1,C,G,3884918,136382,3824692,4217908,60226
6,ENSG00000204267.8,32838739,6-32829016-G-A,rs4148876,-1,G,A,32829016,9723,32642131,33035347,186885
6,ENSG00000124588.13,2999894,6-3019420-T-A,rs4149370,1,T,A,3019420,19526,2803286,3196502,216134
6,ENSG00000124588.13,2999894,6-3019420-T-C,rs4149370,1,T,C,3019420,19526,2803286,3196502,216134
6,ENSG00000124588.13,2999894,6-3019420-T-G,rs4149370,1,T,G,3019420,19526,2803286,3196502,216134
6,ENSG00000175048.11,157381190,6-157435296-G-A,rs41505947,1,G,A,157435296,54106,157184582,157577798,250714
6,ENSG00000175048.11,157381190,6-157435296-G-T,rs41505947,1,G,T,157435296,54106,157184582,157577798,250714
6,ENSG00000175048.11,157381190,6-157435296-G-C,rs41505947,1,G,C,157435296,54106,157184582,157577798,250714
6,ENSG00000213066.5,166999397,6-166984126-G-A,rs435359,1,G,A,166984126,15271,166802789,167196005,181337
6,ENSG00000178199.9,149485014,6-149472088-C-T,rs439495,-1,C,T,149472088,12926,149288406,149681622,183682
6,ENSG00000153162.7,7726099,6-7896258-A-G,rs443861,1,A,G,7896258,170159,7529491,7922707,366767
6,ENSG00000153162.7,7726099,6-7896258-A-C,rs443861,1,A,C,7896258,170159,7529491,7922707,366767
6,ENSG00000198945.3,130018581,6-129831151-G-T,rs4458716,1,G,T,129831151,187430,129821973,130215189,9178
6,ENSG00000198945.3,130018581,6-129831151-G-A,rs4458716,1,G,A,129831151,187430,129821973,130215189,9178
6,ENSG00000198945.3,130018581,6-129831151-G-C,rs4458716,1,G,C,129831151,187430,129821973,130215189,9178
6,ENSG00000120253.8,149746529,6-149935473-A-C,rs4504486,-1,A,C,149935473,188944,149549921,149943137,385552
6,ENSG00000120253.8,149746529,6-149935473-A-G,rs4504486,-1,A,G,149935473,188944,149549921,149943137,385552
6,ENSG00000204252.7,33009591,6-33007604-A-C,rs453779,-1,A,C,33007604,1987,32812983,33206199,194621
6,ENSG00000204252.7,33009591,6-33007604-A-G,rs453779,-1,A,G,33007604,1987,32812983,33206199,194621
6,ENSG00000204252.7,33009591,6-33007604-A-T,rs453779,-1,A,T,33007604,1987,32812983,33206199,194621
6,ENSG00000130363.6,159000202,6-159023759-G-A,rs4709262,-1,G,A,159023759,23557,158803594,159196810,220165
6,ENSG00000231389.2,33080710,6-33118170-G-C,rs4711314,-1,G,C,33118170,37460,32884102,33277318,234068
6,ENSG00000231389.2,33080710,6-33118170-G-A,rs4711314,-1,G,A,33118170,37460,32884102,33277318,234068
6,ENSG00000137404.10,30690984,6-30663286-G-A,rs4713346,-1,G,A,30663286,27698,30494376,30887592,168910
6,ENSG00000030110.7,33580276,6-33754321-T-A,rs4713676,-1,T,A,33754321,174045,33383668,33776884,370653
6,ENSG00000030110.7,33580276,6-33754321-T-G,rs4713676,-1,T,G,33754321,174045,33383668,33776884,370653
6,ENSG00000078401.6,12290361,6-12331575-A-C,rs4714429,1,A,C,12331575,41214,12093753,12486969,237822
6,ENSG00000112576.8,41941808,6-42025491-A-G,rs4714556,-1,A,G,42025491,83683,41745200,42138416,280291
6,ENSG00000124608.4,44313347,6-44344255-C-A,rs4714781,-1,C,A,44344255,30908,44116739,44509955,227516
6,ENSG00000057657.9,106086336,6-105926140-C-A,rs4946713,1,C,A,105926140,160196,105889728,106282944,36412
6,ENSG00000057657.9,106086336,6-105926140-C-G,rs4946713,1,C,G,105926140,160196,105889728,106282944,36412
6,ENSG00000056972.13,111605878,6-111609703-G-A,rs4947129,-1,G,A,111609703,3825,111409270,111802486,200433
6,ENSG00000204632.7,29827825,6-29755897-T-C,rs4947236,1,T,C,29755897,71928,29631217,30024433,124680
6,ENSG00000130396.15,167826911,6-167819149-A-G,rs503364,1,A,G,167819149,7762,167630303,168023519,188846
6,ENSG00000130396.15,167826911,6-167819149-A-T,rs503364,1,A,T,167819149,7762,167630303,168023519,188846
6,ENSG00000130396.15,167826911,6-167819149-A-C,rs503364,1,A,C,167819149,7762,167630303,168023519,188846
6,ENSG00000111816.5,116060891,6-115943191-C-G,rs550480,-1,C,G,115943191,117700,115864283,116257499,78908
6,ENSG00000111816.5,116060891,6-115943191-C-T,rs550480,-1,C,T,115943191,117700,115864283,116257499,78908
6,ENSG00000111816.5,116060891,6-115943191-C-A,rs550480,-1,C,A,115943191,117700,115864283,116257499,78908
6,ENSG00000145979.11,13328537,6-13318377-G-A,rs555100,-1,G,A,13318377,10160,13131929,13525145,186448
6,ENSG00000124508.12,26383108,6-26405588-T-C,rs55676749,1,T,C,26405588,22480,26186500,26579716,219088
6,ENSG00000096401.7,44387706,6-44529821-C-T,rs55938961,1,C,T,44529821,142115,44191098,44584314,338723
6,ENSG00000188820.8,116461375,6-116433293-G-T,rs574278,1,G,T,116433293,28082,116264767,116657983,168526
6,ENSG00000188820.8,116461375,6-116433293-G-C,rs574278,1,G,C,116433293,28082,116264767,116657983,168526
6,ENSG00000185130.4,27807929,6-27892756-C-G,rs58106751,-1,C,G,27892756,84827,27611321,28004537,281435
6,ENSG00000185130.4,27807929,6-27892756-C-A,rs58106751,-1,C,A,27892756,84827,27611321,28004537,281435
6,ENSG00000185130.4,27807929,6-27892756-C-T,rs58106751,-1,C,T,27892756,84827,27611321,28004537,281435
6,ENSG00000130338.8,158312465,6-158476762-C-G,rs599329,1,C,G,158476762,164297,158115857,158509073,360905
6,ENSG00000130338.8,158312465,6-158476762-C-T,rs599329,1,C,T,158476762,164297,158115857,158509073,360905
6,ENSG00000112667.8,43229481,6-43046284-G-T,rs61732148,-1,G,T,43046284,183197,43032873,43426089,13411
6,ENSG00000112667.8,43229481,6-43046284-G-A,rs61732148,-1,G,A,43046284,183197,43032873,43426089,13411
6,ENSG00000151914.12,56954830,6-57054645-A-G,rs61740375,-1,A,G,57054645,99815,56758222,57151438,296423
6,ENSG00000146192.9,37005655,6-37117383-G-A,rs62408363,1,G,A,37117383,111728,36809047,37202263,308336
6,ENSG00000146192.9,37005655,6-37117383-G-C,rs62408363,1,G,C,37117383,111728,36809047,37202263,308336
6,ENSG00000198833.5,89352722,6-89268597-G-T,rs62416348,-1,G,T,89268597,84125,89156114,89549330,112483
6,ENSG00000198833.5,89352722,6-89268597-G-A,rs62416348,-1,G,A,89268597,84125,89156114,89549330,112483
6,ENSG00000112182.9,90296843,6-90336839-A-G,rs6454806,-1,A,G,90336839,39996,90100235,90493451,236604
6,ENSG00000055211.7,149566375,6-149416359-G-A,rs652807,1,G,A,149416359,150016,149369767,149762983,46592
6,ENSG00000137207.6,43516926,6-43483455-G-C,rs66726175,-1,G,C,43483455,33471,43320318,43713534,163137
6,ENSG00000137207.6,43516926,6-43483455-G-A,rs66726175,-1,G,A,43483455,33471,43320318,43713534,163137
6,ENSG00000112031.11,153002709,6-152888973-C-T,rs674327,-1,C,T,152888973,113736,152806101,153199317,82872
6,ENSG00000112312.5,24774937,6-24950601-A-G,rs680009,1,A,G,24950601,175664,24578329,24971545,372272
6,ENSG00000137251.9,54308441,6-54422922-A-G,rs681834,1,A,G,54422922,114481,54111833,54505049,311089
6,ENSG00000137251.9,54308441,6-54422922-A-C,rs681834,1,A,C,54422922,114481,54111833,54505049,311089
6,ENSG00000085382.7,104859919,6-104787882-A-G,rs6900902,-1,A,G,104787882,72037,104663311,105056527,124571
6,ENSG00000085382.7,104859919,6-104787882-A-T,rs6900902,-1,A,T,104787882,72037,104663311,105056527,124571
6,ENSG00000165097.8,18155422,6-18204114-T-G,rs6902280,1,T,G,18204114,48692,17958814,18352030,245300
6,ENSG00000120438.7,159789602,6-159826217-G-T,rs6902339,-1,G,T,159826217,36615,159592994,159986210,233223
6,ENSG00000146416.10,143060889,6-143054750-T-C,rs6902732,1,T,C,143054750,6139,142864281,143257497,190469
6,ENSG00000152818.12,144285335,6-144364595-T-C,rs6904291,1,T,C,144364595,79260,144088727,144481943,275868
6,ENSG00000196911.5,116681211,6-116557784-C-T,rs6906668,1,C,T,116557784,123427,116484603,116877819,73181
6,ENSG00000171467.10,43369647,6-43373668-G-T,rs6911856,-1,G,T,43373668,4021,43173039,43566255,200629
6,ENSG00000171467.10,43369647,6-43373668-G-A,rs6911856,-1,G,A,43373668,4021,43173039,43566255,200629
6,ENSG00000171467.10,43369647,6-43373668-G-C,rs6911856,-1,G,C,43373668,4021,43173039,43566255,200629
6,ENSG00000080546.9,109094846,6-109049926-T-C,rs6916819,-1,T,C,109049926,44920,108898238,109291454,151688
6,ENSG00000080546.9,109094846,6-109049926-T-G,rs6916819,-1,T,G,109049926,44920,108898238,109291454,151688
6,ENSG00000137309.14,34236873,6-34275736-C-T,rs6916965,1,C,T,34275736,38863,34040265,34433481,235471
6,ENSG00000012660.9,53348950,6-53206551-G-A,rs6917666,-1,G,A,53206551,142399,53152342,53545558,54209
6,ENSG00000196787.2,27133043,6-27242667-G-A,rs6918648,1,G,A,27242667,109624,26936435,27329651,306232
6,ENSG00000007866.13,35497064,6-35344211-G-A,rs6919734,-1,G,A,35344211,152853,35300456,35693672,43755
6,ENSG00000112658.6,43171269,6-43222184-C-T,rs6923954,1,C,T,43222184,50915,42974661,43367877,247523
6,ENSG00000158406.2,26285534,6-26277891-G-A,rs6924986,-1,G,A,26277891,7643,26088926,26482142,188965
6,ENSG00000124532.9,24402936,6-24467138-C-T,rs6928435,1,C,T,24467138,64202,24206328,24599544,260810
6,ENSG00000124532.9,24402936,6-24467138-C-G,rs6928435,1,C,G,24467138,64202,24206328,24599544,260810
6,ENSG00000122335.8,158168262,6-158150623-G-A,rs6929520,-1,G,A,158150623,17639,157971654,158364870,178969
6,ENSG00000122335.8,158168262,6-158150623-G-C,rs6929520,-1,G,C,158150623,17639,157971654,158364870,178969
6,ENSG00000023892.8,35297818,6-35269376-C-T,rs6934083,1,C,T,35269376,28442,35101210,35494426,168166
6,ENSG00000124587.9,42979181,6-42923573-C-T,rs6936722,-1,C,T,42923573,55608,42782573,43175789,141000
6,ENSG00000079691.13,25279374,6-25392918-C-T,rs716796,1,C,T,25392918,113544,25082766,25475982,310152
6,ENSG00000146453.7,159800276,6-159862858-C-T,rs722498,1,C,T,159862858,62582,159603668,159996884,259190
6,ENSG00000189325.6,36336888,6-36297915-G-A,rs72848557,-1,G,A,36297915,38973,36140280,36533496,157635
6,ENSG00000124713.5,42960754,6-43101709-T-C,rs72867536,1,T,C,43101709,140955,42764146,43157362,337563
6,ENSG00000112306.7,132814569,6-132891440-C-G,rs73002029,1,C,G,132891440,76871,132617961,133011177,273479
6,ENSG00000186340.9,169253846,6-169200949-C-G,rs73041845,-1,C,G,169200949,52897,169057238,169450454,143711
6,ENSG00000186340.9,169253846,6-169200949-C-T,rs73041845,-1,C,T,169200949,52897,169057238,169450454,143711
6,ENSG00000137225.8,44158820,6-44225969-C-G,rs731780,1,C,G,44225969,67149,43962212,44355428,263757
6,ENSG00000137225.8,44158820,6-44225969-C-T,rs731780,1,C,T,44225969,67149,43962212,44355428,263757
6,ENSG00000146112.6,30686645,6-30772479-G-A,rs73434608,-1,G,A,30772479,85834,30490037,30883253,282442
6,ENSG00000118495.12,144008259,6-143922148-G-C,rs74353552,-1,G,C,143922148,86111,143811651,144204867,110497
6,ENSG00000118495.12,144008259,6-143922148-G-A,rs74353552,-1,G,A,143922148,86111,143811651,144204867,110497
6,ENSG00000118495.12,144008259,6-143922148-G-T,rs74353552,-1,G,T,143922148,86111,143811651,144204867,110497
6,ENSG00000189298.6,28349947,6-28428667-C-G,rs74409142,1,C,G,28428667,78720,28153339,28546555,275328
6,ENSG00000188994.8,87155565,6-86961711-G-A,rs74559531,1,G,A,86961711,193854,86958957,87352173,2754
6,ENSG00000198719.7,170291078,6-170124240-G-T,rs75552394,-1,G,T,170124240,166838,170094470,170487686,29770
6,ENSG00000198719.7,170291078,6-170124240-G-A,rs75552394,-1,G,A,170124240,166838,170094470,170487686,29770
6,ENSG00000204390.7,31815283,6-31644000-T-G,rs760293,-1,T,G,31644000,171283,31618675,32011891,25325
6,ENSG00000204390.7,31815283,6-31644000-T-C,rs760293,-1,T,C,31644000,171283,31618675,32011891,25325
6,ENSG00000204390.7,31815283,6-31644000-T-A,rs760293,-1,T,A,31644000,171283,31618675,32011891,25325
6,ENSG00000153046.12,4776404,6-4784495-G-A,rs76087897,1,G,A,4784495,8091,4579796,4973012,204699
6,ENSG00000185127.5,169702190,6-169811787-T-C,rs761443,1,T,C,169811787,109597,169505582,169898798,306205
6,ENSG00000170915.8,52362151,6-52354377-T-C,rs76517689,1,T,C,52354377,7774,52165543,52558759,188834
6,ENSG00000111906.12,125301967,6-125271904-G-A,rs76718053,-1,G,A,125271904,30063,125105359,125498575,166545
6,ENSG00000177688.5,149400262,6-149457279-C-G,rs77314078,1,C,G,149457279,57017,149203654,149596870,253625
6,ENSG00000124795.10,18264530,6-18135289-T-C,rs77339739,-1,T,C,18135289,129241,18067922,18461138,67367
6,ENSG00000118507.11,131135467,6-131116106-G-A,rs7738223,1,G,A,131116106,19361,130938859,131332075,177247
6,ENSG00000111875.6,118894152,6-118781108-A-G,rs7743045,1,A,G,118781108,113044,118697544,119090760,83564
6,ENSG00000096093.9,52420342,6-52590770-C-A,rs7745317,1,C,A,52590770,170428,52223734,52616950,367036
6,ENSG00000014123.9,96521806,6-96689105-T-G,rs7746875,1,T,G,96689105,167299,96325198,96718414,363907
6,ENSG00000112079.8,36547479,6-36365849-T-G,rs7748318,-1,T,G,36365849,181630,36350871,36744087,14978
6,ENSG00000112079.8,36547479,6-36365849-T-C,rs7748318,-1,T,C,36365849,181630,36350871,36744087,14978
6,ENSG00000057663.8,106325760,6-106387109-T-C,rs7757514,-1,T,C,106387109,61349,106129152,106522368,257957
6,ENSG00000176381.4,166308392,6-166291144-G-A,rs7759603,-1,G,A,166291144,17248,166111784,166505000,179360
6,ENSG00000112200.11,57090188,6-57247330-G-C,rs7760349,1,G,C,57247330,157142,56893580,57286796,353750
6,ENSG00000112200.11,57090188,6-57247330-G-A,rs7760349,1,G,A,57247330,157142,56893580,57286796,353750
6,ENSG00000135596.12,109455772,6-109457146-C-A,rs7764669,-1,C,A,109457146,1374,109259164,109652380,197982
6,ENSG00000135596.12,109455772,6-109457146-C-T,rs7764669,-1,C,T,109457146,1374,109259164,109652380,197982
6,ENSG00000135596.12,109455772,6-109457146-C-G,rs7764669,-1,C,G,109457146,1374,109259164,109652380,197982
6,ENSG00000198755.6,35468401,6-35552874-G-A,rs7768598,1,G,A,35552874,84473,35271793,35665009,281081
6,ENSG00000093134.8,132734765,6-132650517-T-C,rs77729056,-1,T,C,132650517,84248,132538157,132931373,112360
6,ENSG00000204315.3,32130288,6-32078498-A-C,rs7774197,-1,A,C,32078498,51790,31933680,32326896,144818
6,ENSG00000112599.7,42194956,6-42222110-G-T,rs7775141,-1,G,T,42222110,27154,41998348,42391564,223762
6,ENSG00000112599.7,42194956,6-42222110-G-A,rs7775141,-1,G,A,42222110,27154,41998348,42391564,223762
6,ENSG00000146072.5,47309905,6-47380443-C-T,rs78189219,-1,C,T,47380443,70538,47113297,47506513,267146
6,ENSG00000137275.7,3068494,6-3253224-G-A,rs78312256,1,G,A,3253224,184730,2871886,3265102,381338
6,ENSG00000137216.13,44127554,6-43990410-C-T,rs78663521,1,C,T,43990410,137144,43930946,44324162,59464
6,ENSG00000025039.9,89412273,6-89516056-T-G,rs78810995,-1,T,G,89516056,103783,89215665,89608881,300391
6,ENSG00000112761.12,112054104,6-112238036-G-T,rs79128042,1,G,T,112238036,183932,111857496,112250712,380540
6,ENSG00000156535.8,73696203,6-73695400-C-T,rs79317699,1,C,T,73695400,803,73499595,73892811,195805
6,ENSG00000135318.6,85450083,6-85594044-A-G,rs79514927,1,A,G,85594044,143961,85253475,85646691,340569
6,ENSG00000135318.6,85450083,6-85594044-A-C,rs79514927,1,A,C,85594044,143961,85253475,85646691,340569
6,ENSG00000168298.4,26156329,6-26141147-C-T,rs806970,1,C,T,26141147,15182,25959721,26352937,181426
6,ENSG00000124787.9,5004037,6-5007636-T-A,rs811259,-1,T,A,5007636,3599,4807429,5200645,200207
6,ENSG00000124787.9,5004037,6-5007636-T-G,rs811259,-1,T,G,5007636,3599,4807429,5200645,200207
6,ENSG00000124787.9,5004037,6-5007636-T-C,rs811259,-1,T,C,5007636,3599,4807429,5200645,200207
6,ENSG00000137193.8,37170152,6-37033816-G-A,rs831483,1,G,A,37033816,136336,36973544,37366760,60272
6,ENSG00000180992.5,44127452,6-44066954-C-G,rs833810,-1,C,G,44066954,60498,43930844,44324060,136110
6,ENSG00000180992.5,44127452,6-44066954-C-A,rs833810,-1,C,A,44066954,60498,43930844,44324060,136110
6,ENSG00000146232.9,44265551,6-44342954-A-G,rs883193,-1,A,G,44342954,77403,44068943,44462159,274011
6,ENSG00000164674.10,158650054,6-158798572-C-T,rs901367,1,C,T,158798572,148518,158453446,158846662,345126
6,ENSG00000164674.10,158650054,6-158798572-C-A,rs901367,1,C,A,158798572,148518,158453446,158846662,345126
6,ENSG00000206503.6,29942532,6-29940299-T-A,rs9260048,1,T,A,29940299,2233,29745924,30139140,194375
6,ENSG00000206503.6,29942532,6-29940299-T-G,rs9260048,1,T,G,29940299,2233,29745924,30139140,194375
6,ENSG00000206503.6,29942532,6-29940299-T-C,rs9260048,1,T,C,29940299,2233,29745924,30139140,194375
6,ENSG00000179344.11,32666657,6-32619077-G-A,rs9271366,-1,G,A,32619077,47580,32470049,32863265,149028
6,ENSG00000179344.11,32666657,6-32619077-G-T,rs9271366,-1,G,T,32619077,47580,32470049,32863265,149028
6,ENSG00000179344.11,32666657,6-32619077-G-C,rs9271366,-1,G,C,32619077,47580,32470049,32863265,149028
6,ENSG00000124491.9,6320662,6-6331640-T-A,rs927332,-1,T,A,6331640,10978,6124054,6517270,207586
6,ENSG00000124491.9,6320662,6-6331640-T-C,rs927332,-1,T,C,6331640,10978,6124054,6517270,207586
6,ENSG00000182952.3,26538366,6-26455841-C-G,rs9295690,1,C,G,26455841,82525,26341758,26734974,114083
6,ENSG00000182952.3,26538366,6-26455841-C-A,rs9295690,1,C,A,26455841,82525,26341758,26734974,114083
6,ENSG00000146426.12,154995315,6-154933915-G-A,rs9322486,1,G,A,154933915,61400,154798707,155191923,135208
6,ENSG00000146426.12,154995315,6-154933915-G-C,rs9322486,1,G,C,154933915,61400,154798707,155191923,135208
6,ENSG00000171217.5,155264013,6-155269675-A-T,rs9322507,1,A,T,155269675,5662,155067405,155460621,202270
6,ENSG00000171217.5,155264013,6-155269675-A-G,rs9322507,1,A,G,155269675,5662,155067405,155460621,202270
6,ENSG00000164304.10,7389742,6-7494892-T-C,rs9328426,-1,T,C,7494892,105150,7193134,7586350,301758
6,ENSG00000172197.9,20212469,6-20209561-A-G,rs9350223,-1,A,G,20209561,2908,20015861,20409077,193700
6,ENSG00000118432.11,88166347,6-88226000-C-G,rs9351142,-1,C,G,88226000,59653,87969739,88362955,256261
6,ENSG00000118432.11,88166347,6-88226000-C-A,rs9351142,-1,C,A,88226000,59653,87969739,88362955,256261
6,ENSG00000118432.11,88166347,6-88226000-C-T,rs9351142,-1,C,T,88226000,59653,87969739,88362955,256261
6,ENSG00000184357.3,27867588,6-27779263-A-T,rs9357048,-1,A,T,27779263,88325,27670980,28064196,108283
6,ENSG00000184357.3,27867588,6-27779263-A-G,rs9357048,-1,A,G,27779263,88325,27670980,28064196,108283
6,ENSG00000124743.5,53665756,6-53731152-C-A,rs9357772,-1,C,A,53731152,65396,53469148,53862364,262004
6,ENSG00000186470.7,26365198,6-26340802-C-T,rs9358928,1,C,T,26340802,24396,26168590,26561806,172212
6,ENSG00000186470.7,26365198,6-26340802-C-G,rs9358928,1,C,G,26340802,24396,26168590,26561806,172212
6,ENSG00000146243.8,78867551,6-79050015-C-T,rs9361485,1,C,T,79050015,182464,78670943,79064159,379072
6,ENSG00000146243.8,78867551,6-79050015-C-A,rs9361485,1,C,A,79050015,182464,78670943,79064159,379072
6,ENSG00000164506.9,147204417,6-147318398-C-G,rs9373522,1,C,G,147318398,113981,147007809,147401025,310589
6,ENSG00000164506.9,147204417,6-147318398-C-T,rs9373522,1,C,T,147318398,113981,147007809,147401025,310589
6,ENSG00000132424.10,99425308,6-99393043-C-A,rs9376127,-1,C,A,99393043,32265,99228700,99621916,164343
6,ENSG00000132424.10,99425308,6-99393043-C-T,rs9376127,-1,C,T,99393043,32265,99228700,99621916,164343
6,ENSG00000137285.8,3227653,6-3162144-C-A,rs9392465,-1,C,A,3162144,65509,3031045,3424261,131099
6,ENSG00000137267.4,3157544,6-3162144-C-A,rs9392465,-1,C,A,3162144,4600,2960936,3354152,201208
6,ENSG00000001561.5,46129989,6-46216722-A-C,rs9395166,1,A,C,46216722,86733,45933381,46326597,283341
6,ENSG00000001561.5,46129989,6-46216722-A-G,rs9395166,1,A,G,46216722,86733,45933381,46326597,283341
6,ENSG00000001561.5,46129989,6-46216722-A-T,rs9395166,1,A,T,46216722,86733,45933381,46326597,283341
6,ENSG00000203797.4,110415575,6-110482811-T-C,rs9400393,-1,T,C,110482811,67236,110218967,110612183,263844
6,ENSG00000153975.5,116668766,6-116522140-C-T,rs9400930,-1,C,T,116522140,146626,116472158,116865374,49982
6,ENSG00000153975.5,116668766,6-116522140-C-A,rs9400930,-1,C,A,116522140,146626,116472158,116865374,49982
6,ENSG00000146376.5,129710177,6-129715324-C-A,rs9402164,-1,C,A,129715324,5147,129513569,129906785,201755
6,ENSG00000132423.6,99394195,6-99379438-T-A,rs9402716,-1,T,A,99379438,14757,99197587,99590803,181851
6,ENSG00000132423.6,99394195,6-99379438-T-C,rs9402716,-1,T,C,99379438,14757,99197587,99590803,181851
6,ENSG00000132423.6,99394195,6-99379438-T-G,rs9402716,-1,T,G,99379438,14757,99197587,99590803,181851
6,ENSG00000135604.9,144150517,6-144013430-T-C,rs9403544,1,T,C,144013430,137087,143953909,144347125,59521
6,ENSG00000135604.9,144150517,6-144013430-T-A,rs9403544,1,T,A,144013430,137087,143953909,144347125,59521
6,ENSG00000232629.4,32763532,6-32689243-C-G,rs9405042,-1,C,G,32689243,74289,32566924,32960140,122319
6,ENSG00000232629.4,32763532,6-32689243-C-A,rs9405042,-1,C,A,32689243,74289,32566924,32960140,122319
6,ENSG00000168994.8,3751713,6-3928821-G-A,rs9405208,-1,G,A,3928821,177108,3555105,3948321,373716
6,ENSG00000168994.8,3751713,6-3928821-G-C,rs9405208,-1,G,C,3928821,177108,3555105,3948321,373716
6,ENSG00000112406.4,139135080,6-139257872-G-C,rs943651,1,G,C,139257872,122792,138938472,139331688,319400
6,ENSG00000112406.4,139135080,6-139257872-G-T,rs943651,1,G,T,139257872,122792,138938472,139331688,319400
6,ENSG00000118420.12,83065841,6-83221302-T-G,rs9444047,-1,T,G,83221302,155461,82869233,83262449,352069
6,ENSG00000118420.12,83065841,6-83221302-T-C,rs9444047,-1,T,C,83221302,155461,82869233,83262449,352069
6,ENSG00000233822.2,27838569,6-27858082-G-A,rs9461416,1,G,A,27858082,19513,27641961,28035177,216121
6,ENSG00000137310.7,31158589,6-31275570-C-T,rs9461680,1,C,T,31275570,116981,30961981,31355197,313589
6,ENSG00000204531.9,31170682,6-31275570-C-T,rs9461680,-1,C,T,31275570,104888,30974074,31367290,301496
6,ENSG00000124613.4,27388759,6-27554111-C-G,rs9468157,1,C,G,27554111,165352,27192151,27585367,361960
6,ENSG00000112062.6,36027808,6-35982433-T-C,rs9470187,1,T,C,35982433,45375,35831200,36224416,151233
6,ENSG00000044090.4,43053851,6-43101606-A-G,rs9472007,-1,A,G,43101606,47755,42857243,43250459,244363
6,ENSG00000044090.4,43053851,6-43101606-A-T,rs9472007,-1,A,T,43101606,47755,42857243,43250459,244363
6,ENSG00000146476.6,151452466,6-151325662-T-C,rs9479011,1,T,C,151325662,126804,151255858,151649074,69804
6,ENSG00000074706.9,154356803,6-154279233-A-G,rs9479807,-1,A,G,154279233,77570,154160195,154553411,119038
6,ENSG00000112303.9,132757904,6-132748326-G-A,rs9483497,-1,G,A,132748326,9578,132561296,132954512,187030
6,ENSG00000155085.9,109691202,6-109821629-G-A,rs9487226,-1,G,A,109821629,130427,109494594,109887810,327035
6,ENSG00000112290.8,110179670,6-110333173-C-T,rs9487382,-1,C,T,110333173,153503,109983062,110376278,350111
6,ENSG00000203778.2,112087591,6-112208067-C-T,rs9487847,1,C,T,112208067,120476,111890983,112284199,317084
6,ENSG00000189241.5,116279930,6-116115849-A-G,rs9488838,-1,A,G,116115849,164081,116083322,116476538,32527
6,ENSG00000172673.6,127901058,6-127741682-T-C,rs9491858,-1,T,C,127741682,159376,127704450,128097666,37232
6,ENSG00000164440.10,139291998,6-139278990-G-T,rs9495409,-1,G,T,139278990,13008,139095390,139488606,183600
6,ENSG00000164440.10,139291998,6-139278990-G-A,rs9495409,-1,G,A,139278990,13008,139095390,139488606,183600
6,ENSG00000111962.7,148747030,6-148695370-G-A,rs9498130,1,G,A,148695370,51660,148550422,148943638,144948
6,ENSG00000111962.7,148747030,6-148695370-G-C,rs9498130,1,G,C,148695370,51660,148550422,148943638,144948
6,ENSG00000111962.7,148747030,6-148695370-G-T,rs9498130,1,G,T,148695370,51660,148550422,148943638,144948
6,ENSG00000112685.8,693139,6-587736-T-G,rs9504379,-1,T,G,587736,105403,496531,889747,91205
6,ENSG00000112685.8,693139,6-587736-T-C,rs9504379,-1,T,C,587736,105403,496531,889747,91205
6,ENSG00000239264.2,7910788,6-7917295-T-G,rs9505309,-1,T,G,7917295,6507,7714180,8107396,203115
6,ENSG00000239264.2,7910788,6-7917295-T-C,rs9505309,-1,T,C,7917295,6507,7714180,8107396,203115
6,ENSG00000124615.12,39934462,6-39924281-G-A,rs9689513,-1,G,A,39924281,10181,39737854,40131070,186427
6,ENSG00000112139.9,37697883,6-37681935-C-G,rs989713,-1,C,G,37681935,15948,37501275,37894491,180660
6,ENSG00000112139.9,37697883,6-37681935-C-T,rs989713,-1,C,T,37681935,15948,37501275,37894491,180660
5,ENSG00000152684.10,52787916,5-52857922-T-C,rs10038615,1,T,C,52857922,70006,52591308,52984524,266614
5,ENSG00000164576.6,154445997,5-154399157-G-A,rs10040997,1,G,A,154399157,46840,154249389,154642605,149768
5,ENSG00000154153.9,16616997,5-16557758-C-T,rs10041159,-1,C,T,16557758,59239,16420389,16813605,137369
5,ENSG00000154153.9,16616997,5-16557758-C-A,rs10041159,-1,C,A,16557758,59239,16420389,16813605,137369
5,ENSG00000186952.10,110726671,5-110640887-G-A,rs10043185,-1,G,A,110640887,85784,110530063,110923279,110824
5,ENSG00000186952.10,110726671,5-110640887-G-T,rs10043185,-1,G,T,110640887,85784,110530063,110923279,110824
5,ENSG00000164308.12,96876500,5-96943786-A-T,rs10051637,1,A,T,96943786,67286,96679892,97073108,263894
5,ENSG00000164308.12,96876500,5-96943786-A-G,rs10051637,1,A,G,96943786,67286,96679892,97073108,263894
5,ENSG00000112874.5,103562789,5-103549137-T-C,rs10057864,-1,T,C,103549137,13652,103366181,103759397,182956
5,ENSG00000113296.10,80035348,5-79978772-T-A,rs10060444,1,T,A,79978772,56576,79838740,80231956,140032
5,ENSG00000171720.4,141636849,5-141768731-G-A,rs10062181,-1,G,A,141768731,131882,141440241,141833457,328490
5,ENSG00000171720.4,141636849,5-141768731-G-T,rs10062181,-1,G,T,141768731,131882,141440241,141833457,328490
5,ENSG00000164209.11,110739007,5-110846397-A-T,rs10068260,1,A,T,110846397,107390,110542399,110935615,303998
5,ENSG00000039600.6,157652438,5-157650752-T-C,rs10069721,-1,T,C,157650752,1686,157455830,157849046,194922
5,ENSG00000152620.8,36241925,5-36242252-A-T,rs10075150,-1,A,T,36242252,327,36045317,36438533,196935
5,ENSG00000152620.8,36241925,5-36242252-A-G,rs10075150,-1,A,G,36242252,327,36045317,36438533,196935
5,ENSG00000176049.10,147782728,5-147759166-G-A,rs1016104,-1,G,A,147759166,23562,147586120,147979336,173046
5,ENSG00000164587.7,150449739,5-150453104-A-G,rs10447222,-1,A,G,150453104,3365,150253131,150646347,199973
5,ENSG00000131435.8,132257696,5-132261699-A-T,rs10463891,1,A,T,132261699,4003,132061088,132454304,200611
5,ENSG00000131435.8,132257696,5-132261699-A-C,rs10463891,1,A,C,132261699,4003,132061088,132454304,200611
5,ENSG00000131435.8,132257696,5-132261699-A-G,rs10463891,1,A,G,132261699,4003,132061088,132454304,200611
5,ENSG00000183323.8,69332801,5-69320252-G-A,rs10471773,-1,G,A,69320252,12549,69136193,69529409,184059
5,ENSG00000051596.5,175968315,5-175919787-G-A,rs10476176,-1,G,A,175919787,48528,175771707,176164923,148080
5,ENSG00000164221.8,115296654,5-115467000-T-C,rs10478234,-1,T,C,115467000,170346,115100046,115493262,366954
5,ENSG00000043143.14,134525670,5-134420638-A-G,rs10479077,1,A,G,134420638,105032,134329062,134722278,91576
5,ENSG00000152359.9,75717437,5-75684747-A-G,rs10515213,-1,A,G,75684747,32690,75520829,75914045,163918
5,ENSG00000198677.6,95554977,5-95463438-T-C,rs10515227,-1,T,C,95463438,91539,95358369,95751585,105069
5,ENSG00000145725.11,103120301,5-102965664-T-C,rs10515337,1,T,C,102965664,154637,102923693,103316909,41971
5,ENSG00000197043.7,151157779,5-151146340-A-G,rs10515644,-1,A,G,151146340,11439,150961171,151354387,185169
5,ENSG00000113368.6,126777136,5-126836307-T-C,rs1051643,1,T,C,126836307,59171,126580528,126973744,255779
5,ENSG00000113368.6,126777136,5-126836307-T-A,rs1051643,1,T,A,126836307,59171,126580528,126973744,255779
5,ENSG00000113368.6,126777136,5-126836307-T-G,rs1051643,1,T,G,126836307,59171,126580528,126973744,255779
5,ENSG00000113441.11,96936080,5-96909735-C-A,rs1056893,1,C,A,96909735,26345,96739472,97132688,170263
5,ENSG00000113441.11,96936080,5-96909735-C-T,rs1056893,1,C,T,96909735,26345,96739472,97132688,170263
5,ENSG00000113638.8,40755961,5-40716051-C-A,rs10737963,-1,C,A,40716051,39910,40559353,40952569,156698
5,ENSG00000171530.8,77776339,5-77926979-G-A,rs10942835,-1,G,A,77926979,150640,77579731,77972947,347248
5,ENSG00000171530.8,77776339,5-77926979-G-C,rs10942835,-1,G,C,77926979,150640,77579731,77972947,347248
5,ENSG00000169258.5,176610156,5-176622621-T-C,rs11134986,-1,T,C,176622621,12465,176413548,176806764,209073
5,ENSG00000169258.5,176610156,5-176622621-T-A,rs11134986,-1,T,A,176622621,12465,176413548,176806764,209073
5,ENSG00000169258.5,176610156,5-176622621-T-G,rs11134986,-1,T,G,176622621,12465,176413548,176806764,209073
5,ENSG00000230561.3,127703391,5-127567076-C-A,rs11241931,1,C,A,127567076,136315,127506783,127899999,60293
5,ENSG00000230561.3,127703391,5-127567076-C-T,rs11241931,1,C,T,127567076,136315,127506783,127899999,60293
5,ENSG00000230561.3,127703391,5-127567076-C-G,rs11241931,1,C,G,127567076,136315,127506783,127899999,60293
5,ENSG00000228672.2,139395104,5-139426616-T-C,rs11242465,-1,T,C,139426616,31512,139198496,139591712,228120
5,ENSG00000228672.2,139395104,5-139426616-T-G,rs11242465,-1,T,G,139426616,31512,139198496,139591712,228120
5,ENSG00000165810.11,181040266,5-181028372-C-T,rs11249756,1,C,T,181028372,11894,180843658,181236874,184714
5,ENSG00000165810.11,181040266,5-181028372-C-G,rs11249756,1,C,G,181028372,11894,180843658,181236874,184714
5,ENSG00000169230.5,177303799,5-177301457-G-T,rs1128287,1,G,T,177301457,2342,177107191,177500407,194266
5,ENSG00000169230.5,177303799,5-177301457-G-C,rs1128287,1,G,C,177301457,2342,177107191,177500407,194266
5,ENSG00000169131.6,178730659,5-178713089-C-G,rs1132336,-1,C,G,178713089,17570,178534051,178927267,179038
5,ENSG00000169131.6,178730659,5-178713089-C-T,rs1132336,-1,C,T,178713089,17570,178534051,178927267,179038
5,ENSG00000164509.9,55851357,5-55927935-T-G,rs113678094,1,T,G,55927935,76578,55654749,56047965,273186
5,ENSG00000039560.9,34656328,5-34708148-A-G,rs114417817,1,A,G,34708148,51820,34459720,34852936,248428
5,ENSG00000172901.13,115962475,5-116001469-G-A,rs114773365,1,G,A,116001469,38994,115765867,116159083,235602
5,ENSG00000164190.11,36876769,5-36723279-G-T,rs115594123,1,G,T,36723279,153490,36680161,37073377,43118
5,ENSG00000164197.7,64165843,5-64153357-C-T,rs115645847,1,C,T,64153357,12486,63969235,64362451,184122
5,ENSG00000253485.1,141364162,5-141374825-C-A,rs11575953,1,C,A,141374825,10663,141167554,141560770,207271
5,ENSG00000253485.1,141364162,5-141374825-C-G,rs11575953,1,C,G,141374825,10663,141167554,141560770,207271
5,ENSG00000164176.8,84384880,5-84233545-T-G,rs1159734,-1,T,G,84233545,151335,84188272,84581488,45273
5,ENSG00000164176.8,84384880,5-84233545-T-C,rs1159734,-1,T,C,84233545,151335,84188272,84581488,45273
5,ENSG00000164176.8,84384880,5-84233545-T-A,rs1159734,-1,T,A,84233545,151335,84188272,84581488,45273
5,ENSG00000146094.9,177509826,5-177619537-C-T,rs116120158,-1,C,T,177619537,109711,177313218,177706434,306319
5,ENSG00000145911.5,178113532,5-177992290-G-A,rs116225539,1,G,A,177992290,121242,177916924,178310140,75366
5,ENSG00000174136.7,98773663,5-98580866-C-T,rs11738094,1,C,T,98580866,192797,98577055,98970271,3811
5,ENSG00000174136.7,98773663,5-98580866-C-A,rs11738094,1,C,A,98580866,192797,98577055,98970271,3811
5,ENSG00000070614.9,150508131,5-150592605-T-C,rs11739838,1,T,C,150592605,84474,150311523,150704739,281082
5,ENSG00000044115.14,138753425,5-138632045-G-C,rs11743323,1,G,C,138632045,121380,138556817,138950033,75228
5,ENSG00000044115.14,138753425,5-138632045-G-A,rs11743323,1,G,A,138632045,121380,138556817,138950033,75228
5,ENSG00000177721.3,43040319,5-43095616-C-T,rs11746055,-1,C,T,43095616,55297,42843711,43236927,251905
5,ENSG00000221886.3,160400054,5-160352627-G-C,rs11748304,-1,G,C,160352627,47427,160203446,160596662,149181
5,ENSG00000221886.3,160400054,5-160352627-G-A,rs11748304,-1,G,A,160352627,47427,160203446,160596662,149181
5,ENSG00000221886.3,160400054,5-160352627-G-T,rs11748304,-1,G,T,160352627,47427,160203446,160596662,149181
5,ENSG00000180104.9,443176,5-386657-C-G,rs11749473,1,C,G,386657,56519,246568,639784,140089
5,ENSG00000177733.4,137754363,5-137740518-A-T,rs11750549,-1,A,T,137740518,13845,137557755,137950971,182763
5,ENSG00000177733.4,137754363,5-137740518-A-G,rs11750549,-1,A,G,137740518,13845,137557755,137950971,182763
5,ENSG00000145907.9,151771954,5-151592287-C-T,rs11948904,1,C,T,151592287,179667,151575346,151968562,16941
5,ENSG00000011083.4,150190062,5-150383699-G-T,rs11950303,1,G,T,150383699,193637,149993454,150386670,390245
5,ENSG00000164253.8,77492316,5-77556953-C-T,rs11958339,-1,C,T,77556953,64637,77295708,77688924,261245
5,ENSG00000072803.13,172006638,5-172086352-G-A,rs11958723,-1,G,A,172086352,79714,171810030,172203246,276322
5,ENSG00000131711.10,72107475,5-72093924-G-C,rs1217817,1,G,C,72093924,13551,71910867,72304083,183057
5,ENSG00000131711.10,72107475,5-72093924-G-A,rs1217817,1,G,A,72093924,13551,71910867,72304083,183057
5,ENSG00000132837.9,79069674,5-79221320-C-T,rs12189248,-1,C,T,79221320,151646,78873066,79266282,348254
5,ENSG00000151292.13,123512099,5-123608955-G-T,rs12515732,1,G,T,123608955,96856,123315491,123708707,293464
5,ENSG00000151292.13,123512099,5-123608955-G-A,rs12515732,1,G,A,123608955,96856,123315491,123708707,293464
5,ENSG00000168944.10,123423403,5-123345585-T-G,rs12520233,-1,T,G,123345585,77818,123226795,123620011,118790
5,ENSG00000168944.10,123423403,5-123345585-T-C,rs12520233,-1,T,C,123345585,77818,123226795,123620011,118790
5,ENSG00000168944.10,123423403,5-123345585-T-A,rs12520233,-1,T,A,123345585,77818,123226795,123620011,118790
5,ENSG00000204767.3,169980495,5-169922991-G-A,rs12522080,-1,G,A,169922991,57504,169783887,170177103,139104
5,ENSG00000253767.1,141392633,5-141584847-A-G,rs12523361,1,A,G,141584847,192214,141196025,141589241,388822
5,ENSG00000154162.8,22853344,5-22856632-T-C,rs12652791,-1,T,C,22856632,3288,22656736,23049952,199896
5,ENSG00000169252.4,148826611,5-148826178-G-C,rs12654778,1,G,C,148826178,433,148630003,149023219,196175
5,ENSG00000169252.4,148826611,5-148826178-G-A,rs12654778,1,G,A,148826178,433,148630003,149023219,196175
5,ENSG00000132915.6,149944793,5-150116043-G-T,rs12655077,-1,G,T,150116043,171250,149748185,150141401,367858
5,ENSG00000132915.6,149944793,5-150116043-G-A,rs12655077,-1,G,A,150116043,171250,149748185,150141401,367858
5,ENSG00000169228.9,177303719,5-177330949-G-A,rs12657206,-1,G,A,177330949,27230,177107111,177500327,223838
5,ENSG00000170231.11,160229506,5-160221282-G-A,rs12657454,1,G,A,160221282,8224,160032898,160426114,188384
5,ENSG00000170231.11,160229506,5-160221282-G-T,rs12657454,1,G,T,160221282,8224,160032898,160426114,188384
5,ENSG00000174705.7,172454525,5-172562670-T-A,rs12658472,-1,T,A,172562670,108145,172257917,172651133,304753
5,ENSG00000153113.17,96662376,5-96661008-C-T,rs12659730,1,C,T,96661008,1368,96465768,96858984,195240
5,ENSG00000113068.5,140303101,5-140135379-T-C,rs13156549,-1,T,C,140135379,167722,140106493,140499709,28886
5,ENSG00000113068.5,140303101,5-140135379-T-A,rs13156549,-1,T,A,140135379,167722,140106493,140499709,28886
5,ENSG00000153044.5,69189583,5-69169644-C-G,rs13175606,1,C,G,69169644,19939,68992975,69386191,176669
5,ENSG00000153044.5,69189583,5-69169644-C-T,rs13175606,1,C,T,69169644,19939,68992975,69386191,176669
5,ENSG00000120306.5,140175188,5-140231923-T-C,rs13175916,1,T,C,140231923,56735,139978580,140371796,253343
5,ENSG00000164236.6,10564070,5-10704985-G-A,rs13176602,1,G,A,10704985,140915,10367462,10760678,337523
5,ENSG00000113615.8,134648785,5-134570139-C-T,rs13178130,1,C,T,134570139,78646,134452177,134845393,117962
5,ENSG00000113615.8,134648785,5-134570139-C-G,rs13178130,1,C,G,134570139,78646,134452177,134845393,117962
5,ENSG00000198624.7,151224092,5-151212630-C-T,rs13183776,-1,C,T,151212630,11462,151027484,151420700,185146
5,ENSG00000198624.7,151224092,5-151212630-C-A,rs13183776,-1,C,A,151212630,11462,151027484,151420700,185146
5,ENSG00000181104.6,76716126,5-76862029-T-A,rs1320305,1,T,A,76862029,145903,76519518,76912734,342511
5,ENSG00000181104.6,76716126,5-76862029-T-G,rs1320305,1,T,G,76862029,145903,76519518,76912734,342511
5,ENSG00000181104.6,76716126,5-76862029-T-C,rs1320305,1,T,C,76862029,145903,76519518,76912734,342511
5,ENSG00000170571.6,50441288,5-50575899-C-T,rs13355434,-1,C,T,50575899,134611,50244680,50637896,331219
5,ENSG00000186314.7,145835342,5-145839882-T-C,rs13359571,-1,T,C,145839882,4540,145638734,146031950,201148
5,ENSG00000186314.7,145835342,5-145839882-T-G,rs13359571,-1,T,G,145839882,4540,145638734,146031950,201148
5,ENSG00000146083.7,176537402,5-176633845-G-A,rs1352303,-1,G,A,176633845,96443,176340794,176734010,293051
5,ENSG00000131459.8,180353336,5-180293555-T-G,rs1363516,-1,T,G,180293555,59781,180156728,180549944,136827
5,ENSG00000131459.8,180353336,5-180293555-T-A,rs1363516,-1,T,A,180293555,59781,180156728,180549944,136827
5,ENSG00000131459.8,180353336,5-180293555-T-C,rs1363516,-1,T,C,180293555,59781,180156728,180549944,136827
5,ENSG00000134061.4,67196799,5-67002834-T-C,rs1363932,-1,T,C,67002834,193965,67000191,67393407,2643
5,ENSG00000228716.2,80654983,5-80656346-C-G,rs1382540,-1,C,G,80656346,1363,80458375,80851591,197971
5,ENSG00000120314.14,140664904,5-140558652-C-T,rs145698446,1,C,T,140558652,106252,140468296,140861512,90356
5,ENSG00000079215.8,36606606,5-36689261-A-G,rs1529461,1,A,G,36689261,82655,36409998,36803214,279263
5,ENSG00000177556.7,151758631,5-151687851-T-C,rs1545030,-1,T,C,151687851,70780,151562023,151955239,125828
5,ENSG00000145730.15,102755305,5-102774568-G-A,rs154635,1,G,A,102774568,19263,102558697,102951913,215871
5,ENSG00000145687.10,81751097,5-81757626-C-G,rs1550802,-1,C,G,81757626,6529,81554489,81947705,203137
5,ENSG00000145687.10,81751097,5-81757626-C-A,rs1550802,-1,C,A,81757626,6529,81554489,81947705,203137
5,ENSG00000082074.10,39219563,5-39261865-T-C,rs155450,-1,T,C,39261865,42302,39022955,39416171,238910
5,ENSG00000082074.10,39219563,5-39261865-T-A,rs155450,-1,T,A,39261865,42302,39022955,39416171,238910
5,ENSG00000172568.4,157345677,5-157454845-G-A,rs1559144,-1,G,A,157454845,109168,157149069,157542285,305776
5,ENSG00000158497.2,143812161,5-143820488-C-T,rs161557,1,C,T,143820488,8327,143615553,144008769,204935
5,ENSG00000134057.10,69167150,5-69113787-A-G,rs164392,1,A,G,69113787,53363,68970542,69363758,143245
5,ENSG00000134057.10,69167150,5-69113787-A-T,rs164392,1,A,T,69113787,53363,68970542,69363758,143245
5,ENSG00000145545.7,6633440,5-6638007-G-A,rs1651074,1,G,A,6638007,4567,6436832,6830048,201175
5,ENSG00000164284.10,149345499,5-149339481-G-C,rs1659087,1,G,C,149339481,6018,149148891,149542107,190590
5,ENSG00000164284.10,149345499,5-149339481-G-T,rs1659087,1,G,T,149339481,6018,149148891,149542107,190590
5,ENSG00000083720.7,41870425,5-41849153-G-A,rs16871972,-1,G,A,41849153,21272,41673817,42067033,175336
5,ENSG00000083720.7,41870425,5-41849153-G-C,rs16871972,-1,G,C,41849153,21272,41673817,42067033,175336
5,ENSG00000164347.11,74767117,5-74853653-T-C,rs16872345,-1,T,C,74853653,86536,74570509,74963725,283144
5,ENSG00000145703.10,76403285,5-76544214-T-C,rs16873476,1,T,C,76544214,140929,76206677,76599893,337537
5,ENSG00000113494.12,35230487,5-35315097-C-G,rs16873579,-1,C,G,35315097,84610,35033879,35427095,281218
5,ENSG00000113494.12,35230487,5-35315097-C-A,rs16873579,-1,C,A,35315097,84610,35033879,35427095,281218
5,ENSG00000113494.12,35230487,5-35315097-C-T,rs16873579,-1,C,T,35315097,84610,35033879,35427095,281218
5,ENSG00000145536.10,5140330,5-5045634-C-T,rs16874621,1,C,T,5045634,94696,4943722,5336938,101912
5,ENSG00000242110.3,34008050,5-33995600-C-T,rs168803,-1,C,T,33995600,12450,33811442,34204658,184158
5,ENSG00000242110.3,34008050,5-33995600-C-A,rs168803,-1,C,A,33995600,12450,33811442,34204658,184158
5,ENSG00000242110.3,34008050,5-33995600-C-G,rs168803,-1,C,G,33995600,12450,33811442,34204658,184158
5,ENSG00000112902.7,9546075,5-9391525-C-A,rs16882610,-1,C,A,9391525,154550,9349467,9742683,42058
5,ENSG00000086200.10,62412763,5-62599297-A-G,rs16890857,1,A,G,62599297,186534,62216155,62609371,383142
5,ENSG00000123219.7,65563168,5-65613660-A-G,rs16894099,-1,A,G,65613660,50492,65366560,65759776,247100
5,ENSG00000168671.5,36066882,5-36067473-A-G,rs16902708,-1,A,G,36067473,591,35870274,36263490,197199
5,ENSG00000164330.11,159099916,5-159083802-T-C,rs17056549,-1,T,C,159083802,16114,158903308,159296524,180494
5,ENSG00000113719.11,172834251,5-172695123-C-G,rs17075121,1,C,G,172695123,139128,172637643,173030859,57480
5,ENSG00000113719.11,172834251,5-172695123-C-T,rs17075121,1,C,T,172695123,139128,172637643,173030859,57480
5,ENSG00000113719.11,172834251,5-172695123-C-A,rs17075121,1,C,A,172695123,139128,172637643,173030859,57480
5,ENSG00000174132.7,100535374,5-100676844-T-C,rs17158426,1,T,C,100676844,141470,100338766,100731982,338078
5,ENSG00000174132.7,100535374,5-100676844-T-G,rs17158426,1,T,G,100676844,141470,100338766,100731982,338078
5,ENSG00000120708.9,136028988,5-136178653-G-A,rs17169934,1,G,A,136178653,149665,135832380,136225596,346273
5,ENSG00000120708.9,136028988,5-136178653-G-T,rs17169934,1,G,T,136178653,149665,135832380,136225596,346273
5,ENSG00000145819.10,142770377,5-142593659-A-G,rs17217618,1,A,G,142593659,176718,142573769,142966985,19890
5,ENSG00000145819.10,142770377,5-142593659-A-T,rs17217618,1,A,T,142593659,176718,142573769,142966985,19890
5,ENSG00000152939.9,69415116,5-69409321-A-C,rs17236590,1,A,C,69409321,5795,69218508,69611724,190813
5,ENSG00000152939.9,69415116,5-69409321-A-T,rs17236590,1,A,T,69409321,5795,69218508,69611724,190813
5,ENSG00000152939.9,69415116,5-69409321-A-G,rs17236590,1,A,G,69409321,5795,69218508,69611724,190813
5,ENSG00000132357.8,40841367,5-40769985-T-C,rs17239241,1,T,C,40769985,71382,40644759,41037975,125226
5,ENSG00000132357.8,40841367,5-40769985-T-A,rs17239241,1,T,A,40769985,71382,40644759,41037975,125226
5,ENSG00000168724.10,34929559,5-34945017-A-G,rs17304200,1,A,G,34945017,15458,34732951,35126167,212066
5,ENSG00000164574.11,154190733,5-154271899-A-G,rs17552639,1,A,G,154271899,81166,153994125,154387341,277774
5,ENSG00000164574.11,154190733,5-154271899-A-C,rs17552639,1,A,C,154271899,81166,153994125,154387341,277774
5,ENSG00000164199.10,90558797,5-90745693-A-G,rs17624033,1,A,G,90745693,186896,90362189,90755405,383504
5,ENSG00000113721.7,150155845,5-150150436-C-A,rs17708682,-1,C,A,150150436,5409,149959237,150352453,191199
5,ENSG00000113721.7,150155845,5-150150436-C-T,rs17708682,-1,C,T,150150436,5409,149959237,150352453,191199
5,ENSG00000120729.5,137867860,5-137796568-A-G,rs17740890,1,A,G,137796568,71292,137671252,138064468,125316
5,ENSG00000164292.7,95731336,5-95647825-C-T,rs17790731,1,C,T,95647825,83511,95534728,95927944,113097
5,ENSG00000177453.3,43192225,5-43078116-T-C,rs178415,1,T,C,43078116,114109,42995617,43388833,82499
5,ENSG00000177453.3,43192225,5-43078116-T-A,rs178415,1,T,A,43078116,114109,42995617,43388833,82499
5,ENSG00000177453.3,43192225,5-43078116-T-G,rs178415,1,T,G,43078116,114109,42995617,43388833,82499
5,ENSG00000124275.10,7869148,5-7870860-A-G,rs1801394,1,A,G,7870860,1712,7672540,8065756,198320
5,ENSG00000164171.5,52989352,5-53011540-C-T,rs1862639,1,C,T,53011540,22188,52792744,53185960,218796
5,ENSG00000131730.11,81233322,5-81075502-A-G,rs190409,1,A,G,81075502,157820,81036714,81429930,38788
5,ENSG00000164252.8,77030404,5-76938657-C-T,rs2055628,1,C,T,76938657,91747,76833796,77227012,104861
5,ENSG00000164252.8,77030404,5-76938657-C-A,rs2055628,1,C,A,76938657,91747,76833796,77227012,104861
5,ENSG00000164404.4,132866469,5-132806585-G-A,rs2057825,-1,G,A,132806585,59884,132669861,133063077,136724
5,ENSG00000164404.4,132866469,5-132806585-G-T,rs2057825,-1,G,T,132806585,59884,132669861,133063077,136724
5,ENSG00000164172.13,53109757,5-53099480-C-T,rs2068247,-1,C,T,53099480,10277,52913149,53306365,186331
5,ENSG00000188573.6,168529305,5-168503727-G-A,rs2112326,1,G,A,168503727,25578,168332697,168725913,171030
5,ENSG00000027847.8,177600132,5-177668516-C-T,rs2133716,1,C,T,177668516,68384,177403524,177796740,264992
5,ENSG00000178913.5,141320784,5-141319490-G-A,rs2230133,-1,G,A,141319490,1294,141124176,141517392,195314
5,ENSG00000178913.5,141320784,5-141319490-G-C,rs2230133,-1,G,C,141319490,1294,141124176,141517392,195314
5,ENSG00000113108.13,140564598,5-140677950-G-A,rs2230361,-1,G,A,140677950,113352,140367990,140761206,309960
5,ENSG00000113597.12,65625027,5-65793340-G-A,rs2248213,1,G,A,65793340,168313,65428419,65821635,364921
5,ENSG00000155542.6,56909596,5-56947301-T-C,rs2255726,1,T,C,56947301,37705,56712988,57106204,234313
5,ENSG00000155542.6,56909596,5-56947301-T-A,rs2255726,1,T,A,56947301,37705,56712988,57106204,234313
5,ENSG00000146013.6,138274621,5-138165314-T-C,rs2269954,-1,T,C,138165314,109307,138078013,138471229,87301
5,ENSG00000066230.6,524449,5-469972-G-A,rs2278251,-1,G,A,469972,54477,327841,721057,142131
5,ENSG00000037749.7,154038967,5-153992616-T-C,rs2289265,1,T,C,153992616,46351,153842359,154235575,150257
5,ENSG00000037749.7,154038967,5-153992616-T-G,rs2289265,1,T,G,153992616,46351,153842359,154235575,150257
5,ENSG00000152495.6,111224384,5-111248012-G-A,rs2434723,1,G,A,111248012,23628,111027776,111420992,220236
5,ENSG00000155850.7,149960758,5-149961475-T-G,rs245056,1,T,G,149961475,717,149764150,150157366,197325
5,ENSG00000155850.7,149960758,5-149961475-T-A,rs245056,1,T,A,149961475,717,149764150,150157366,197325
5,ENSG00000133835.9,119452497,5-119564080-T-A,rs246968,1,T,A,119564080,111583,119255889,119649105,308191
5,ENSG00000133835.9,119452497,5-119564080-T-C,rs246968,1,T,C,119564080,111583,119255889,119649105,308191
5,ENSG00000013561.13,141969105,5-141964288-A-C,rs252143,1,A,C,141964288,4817,141772497,142165713,191791
5,ENSG00000013561.13,141969105,5-141964288-A-T,rs252143,1,A,T,141964288,4817,141772497,142165713,191791
5,ENSG00000131495.4,140647630,5-140741368-G-A,rs2531349,-1,G,A,140741368,93738,140451022,140844238,290346
5,ENSG00000135083.10,160312564,5-160170281-A-T,rs2546363,-1,A,T,160170281,142283,160115956,160509172,54325
5,ENSG00000204628.7,181243906,5-181238490-A-C,rs2546422,-1,A,C,181238490,5416,181047298,181440514,191192
5,ENSG00000040275.11,169583773,5-169587297-C-G,rs255824,1,C,G,169587297,3524,169387165,169780381,200132
5,ENSG00000040275.11,169583773,5-169587297-C-T,rs255824,1,C,T,169587297,3524,169387165,169780381,200132
5,ENSG00000123213.16,65722205,5-65726386-G-A,rs2561205,1,G,A,65726386,4181,65525597,65918813,200789
5,ENSG00000213523.4,140557473,5-140631730-C-G,rs2563298,-1,C,G,140631730,74257,140360865,140754081,270865
5,ENSG00000213523.4,140557473,5-140631730-C-A,rs2563298,-1,C,A,140631730,74257,140360865,140754081,270865
5,ENSG00000164307.7,96807945,5-96790207-C-T,rs26510,-1,C,T,96790207,17738,96611337,97004553,178870
5,ENSG00000164307.7,96807945,5-96790207-C-G,rs26510,-1,C,G,96790207,17738,96611337,97004553,178870
5,ENSG00000177879.10,115841935,5-115842698-C-T,rs26538,1,C,T,115842698,763,115645327,116038543,197371
5,ENSG00000073578.10,218320,5-356266-C-T,rs2672737,1,C,T,356266,137946,21712,414928,334554
5,ENSG00000073578.10,218320,5-356266-C-G,rs2672737,1,C,G,356266,137946,21712,414928,334554
5,ENSG00000164466.7,175478560,5-175490421-T-C,rs267377,1,T,C,175490421,11861,175281952,175675168,208469
5,ENSG00000164219.5,115262877,5-115334179-T-C,rs269492,-1,T,C,115334179,71302,115066269,115459485,267910
5,ENSG00000164219.5,115262877,5-115334179-T-A,rs269492,-1,T,A,115334179,71302,115066269,115459485,267910
5,ENSG00000164219.5,115262877,5-115334179-T-G,rs269492,-1,T,G,115334179,71302,115066269,115459485,267910
5,ENSG00000178015.4,95620087,5-95622199-G-C,rs28503912,1,G,C,95622199,2112,95423479,95816695,198720
5,ENSG00000178015.4,95620087,5-95622199-G-A,rs28503912,1,G,A,95622199,2112,95423479,95816695,198720
5,ENSG00000175449.7,95646777,5-95549679-T-G,rs2881773,1,T,G,95549679,97098,95450169,95843385,99510
5,ENSG00000175449.7,95646777,5-95549679-T-A,rs2881773,1,T,A,95549679,97098,95450169,95843385,99510
5,ENSG00000175449.7,95646777,5-95549679-T-C,rs2881773,1,T,C,95549679,97098,95450169,95843385,99510
5,ENSG00000113194.7,176448385,5-176441780-C-T,rs2913733,1,C,T,176441780,6605,176251777,176644993,190003
5,ENSG00000151304.5,121961975,5-121970332-A-G,rs2914605,1,A,G,121970332,8357,121765367,122158583,204965
5,ENSG00000074276.6,176549342,5-176510546-T-C,rs2963297,1,T,C,176510546,38796,176352734,176745950,157812
5,ENSG00000081059.14,134114681,5-134106318-A-G,rs30498,1,A,G,134106318,8363,133918073,134311289,188245
5,ENSG00000081059.14,134114681,5-134106318-A-C,rs30498,1,A,C,134106318,8363,133918073,134311289,188245
5,ENSG00000081059.14,134114681,5-134106318-A-T,rs30498,1,A,T,134106318,8363,133918073,134311289,188245
5,ENSG00000043462.7,170297777,5-170297763-G-C,rs315731,-1,G,C,170297763,14,170101169,170494385,196594
5,ENSG00000043462.7,170297777,5-170297763-G-A,rs315731,-1,G,A,170297763,14,170101169,170494385,196594
5,ENSG00000043462.7,170297777,5-170297763-G-T,rs315731,-1,G,T,170297763,14,170101169,170494385,196594
5,ENSG00000146066.2,176388751,5-176388781-G-C,rs3172921,1,G,C,176388781,30,176192143,176585359,196638
5,ENSG00000146066.2,176388751,5-176388781-G-A,rs3172921,1,G,A,176388781,30,176192143,176585359,196638
5,ENSG00000113758.9,177473634,5-177440275-T-C,rs335434,-1,T,C,177440275,33359,177277026,177670242,163249
5,ENSG00000164338.5,73565743,5-73565484-G-T,rs343108,1,G,T,73565484,259,73369135,73762351,196349
5,ENSG00000164338.5,73565743,5-73565484-G-A,rs343108,1,G,A,73565484,259,73369135,73762351,196349
5,ENSG00000164338.5,73565743,5-73565484-G-C,rs343108,1,G,C,73565484,259,73369135,73762351,196349
5,ENSG00000081791.4,141923871,5-141930259-G-A,rs351260,1,G,A,141930259,6388,141727263,142120479,202996
5,ENSG00000113504.13,1112063,5-1104823-C-T,rs35188965,-1,C,T,1104823,7240,915455,1308671,189368
5,ENSG00000113504.13,1112063,5-1104823-C-G,rs35188965,-1,C,G,1104823,7240,915455,1308671,189368
5,ENSG00000164904.9,126595219,5-126640586-A-G,rs35390332,-1,A,G,126640586,45367,126398611,126791827,241975
5,ENSG00000153395.5,1523960,5-1498744-A-G,rs36989,-1,A,G,1498744,25216,1327352,1720568,171392
5,ENSG00000153395.5,1523960,5-1498744-A-T,rs36989,-1,A,T,1498744,25216,1327352,1720568,171392
5,ENSG00000164615.3,134738548,5-134887903-A-G,rs3733897,1,A,G,134887903,149355,134541940,134935156,345963
5,ENSG00000164220.5,76623403,5-76592643-T-G,rs3736395,-1,T,G,76592643,30760,76426795,76820011,165848
5,ENSG00000151388.6,33891990,5-33969901-A-G,rs3756462,-1,A,G,33969901,77911,33695382,34088598,274519
5,ENSG00000112893.5,109689927,5-109690962-G-C,rs3756599,1,G,C,109690962,1035,109493319,109886535,197643
5,ENSG00000112893.5,109689927,5-109690962-G-A,rs3756599,1,G,A,109690962,1035,109493319,109886535,197643
5,ENSG00000172239.9,43557077,5-43487772-T-G,rs3776423,-1,T,G,43487772,69305,43360469,43753685,127303
5,ENSG00000172239.9,43557077,5-43487772-T-A,rs3776423,-1,T,A,43487772,69305,43360469,43753685,127303
5,ENSG00000145777.10,111071713,5-111071044-C-T,rs3806933,1,C,T,111071044,669,110875105,111268321,195939
5,ENSG00000145777.10,111071713,5-111071044-C-A,rs3806933,1,C,A,111071044,669,110875105,111268321,195939
5,ENSG00000182578.8,150086554,5-150053300-T-C,rs3828609,-1,T,C,150053300,33254,149889946,150283162,163354
5,ENSG00000169570.4,118988547,5-118809442-T-A,rs383585,-1,T,A,118809442,179105,118791939,119185155,17503
5,ENSG00000213585.6,134004975,5-134117702-T-C,rs3867425,-1,T,C,134117702,112727,133808367,134201583,309335
5,ENSG00000113558.12,134176950,5-134117702-T-C,rs3867425,-1,T,C,134117702,59248,133980342,134373558,137360
5,ENSG00000170464.5,139439525,5-139439612-C-A,rs3923060,-1,C,A,139439612,87,139242917,139636133,196695
5,ENSG00000170464.5,139439525,5-139439612-C-T,rs3923060,-1,C,T,139439612,87,139242917,139636133,196695
5,ENSG00000170469.6,139404089,5-139418036-C-A,rs3924257,-1,C,A,139418036,13947,139207481,139600697,210555
5,ENSG00000170469.6,139404089,5-139418036-C-G,rs3924257,-1,C,G,139418036,13947,139207481,139600697,210555
5,ENSG00000170469.6,139404089,5-139418036-C-T,rs3924257,-1,C,T,139418036,13947,139207481,139600697,210555
5,ENSG00000134056.6,69217760,5-69276841-C-T,rs4077460,1,C,T,69276841,59081,69021152,69414368,255689
5,ENSG00000066583.6,129094749,5-129232142-T-C,rs41492044,1,T,C,129232142,137393,128898141,129291357,334001
5,ENSG00000152413.10,79514134,5-79536259-G-A,rs41527045,-1,G,A,79536259,22125,79317526,79710742,218733
5,ENSG00000064652.6,122845613,5-123026208-C-G,rs41527147,1,C,G,123026208,180595,122649005,123042221,377203
5,ENSG00000064652.6,122845613,5-123026208-C-T,rs41527147,1,C,T,123026208,180595,122649005,123042221,377203
5,ENSG00000168246.5,172283764,5-172225859-A-G,rs41537348,-1,A,G,172225859,57905,172087156,172480372,138703
5,ENSG00000113593.7,65563296,5-65659068-T-A,rs42961,1,T,A,65659068,95772,65366688,65759904,292380
5,ENSG00000113593.7,65563296,5-65659068-T-C,rs42961,1,T,C,65659068,95772,65366688,65759904,292380
5,ENSG00000184840.7,177592203,5-177584862-T-C,rs430797,1,T,C,177584862,7341,177395595,177788811,189267
5,ENSG00000155545.14,56952123,5-56990382-T-G,rs4309923,-1,T,G,56990382,38259,56755515,57148731,234867
5,ENSG00000155545.14,56952123,5-56990382-T-C,rs4309923,-1,T,C,56990382,38259,56755515,57148731,234867
5,ENSG00000155545.14,56952123,5-56990382-T-A,rs4309923,-1,T,A,56990382,38259,56755515,57148731,234867
5,ENSG00000152348.9,81972023,5-81967703-T-C,rs4391141,1,T,C,81967703,4320,81775415,82168631,192288
5,ENSG00000152348.9,81972023,5-81967703-T-A,rs4391141,1,T,A,81967703,4320,81775415,82168631,192288
5,ENSG00000152348.9,81972023,5-81967703-T-G,rs4391141,1,T,G,81967703,4320,81775415,82168631,192288
5,ENSG00000173221.9,95822726,5-95816609-A-T,rs4561,-1,A,T,95816609,6117,95626118,96019334,190491
5,ENSG00000173221.9,95822726,5-95816609-A-G,rs4561,-1,A,G,95816609,6117,95626118,96019334,190491
5,ENSG00000198055.6,177426676,5-177450109-C-T,rs461264,1,C,T,177450109,23433,177230068,177623284,220041
5,ENSG00000142319.14,1445440,5-1423790-A-G,rs464049,-1,A,G,1423790,21650,1248832,1642048,174958
5,ENSG00000142319.14,1445440,5-1423790-A-T,rs464049,-1,A,T,1423790,21650,1248832,1642048,174958
5,ENSG00000145604.10,36152111,5-36157499-A-G,rs464812,1,A,G,36157499,5388,35955503,36348719,201996
5,ENSG00000197375.7,132369710,5-132419312-A-G,rs4705943,1,A,G,132419312,49602,132173102,132566318,246210
5,ENSG00000197375.7,132369710,5-132419312-A-C,rs4705943,1,A,C,132419312,49602,132173102,132566318,246210
5,ENSG00000197208.5,132294394,5-132419312-A-G,rs4705943,1,A,G,132419312,124918,132097786,132491002,321526
5,ENSG00000197208.5,132294394,5-132419312-A-C,rs4705943,1,A,C,132419312,124918,132097786,132491002,321526
5,ENSG00000112972.9,43313412,5-43357992-A-G,rs4866822,-1,A,G,43357992,44580,43116804,43510020,241188
5,ENSG00000113328.13,163437595,5-163372989-T-G,rs4869059,1,T,G,163372989,64606,163240987,163634203,132002
5,ENSG00000113328.13,163437595,5-163372989-T-A,rs4869059,1,T,A,163372989,64606,163240987,163634203,132002
5,ENSG00000113328.13,163437595,5-163372989-T-C,rs4869059,1,T,C,163372989,64606,163240987,163634203,132002
5,ENSG00000129625.8,112922227,5-112849794-A-T,rs497844,-1,A,T,112849794,72433,112725619,113118835,124175
5,ENSG00000129625.8,112922227,5-112849794-A-G,rs497844,-1,A,G,112849794,72433,112725619,113118835,124175
5,ENSG00000113273.11,78985310,5-79054711-A-C,rs544424,-1,A,C,79054711,69401,78788702,79181918,266009
5,ENSG00000113273.11,78985310,5-79054711-A-G,rs544424,-1,A,G,79054711,69401,78788702,79181918,266009
5,ENSG00000113273.11,78985310,5-79054711-A-T,rs544424,-1,A,T,79054711,69401,78788702,79181918,266009
5,ENSG00000234511.3,170232985,5-170414210-A-G,rs56231214,1,A,G,170414210,181225,170036377,170429593,377833
5,ENSG00000113739.6,173328414,5-173161190-T-C,rs5745164,-1,T,C,173161190,167224,173131806,173525022,29384
5,ENSG00000112977.11,10761234,5-10680885-G-A,rs5745297,-1,G,A,10680885,80349,10564626,10957842,116259
5,ENSG00000156453.9,141878410,5-142040448-T-C,rs57525651,-1,T,C,142040448,162038,141681802,142075018,358646
5,ENSG00000146063.13,181223281,5-181242275-C-T,rs59085681,1,C,T,181242275,18994,181026673,181419889,215602
5,ENSG00000068796.11,62306206,5-62285604-G-A,rs61354333,1,G,A,62285604,20602,62109598,62502814,176006
5,ENSG00000068796.11,62306206,5-62285604-G-C,rs61354333,1,G,C,62285604,20602,62109598,62502814,176006
5,ENSG00000113318.8,80654652,5-80655213-A-C,rs6151599,1,A,C,80655213,561,80458044,80851260,197169
5,ENSG00000113318.8,80654652,5-80655213-A-G,rs6151599,1,A,G,80655213,561,80458044,80851260,197169
5,ENSG00000198865.5,42756818,5-42711178-C-T,rs6178,1,C,T,42711178,45640,42560210,42953426,150968
5,ENSG00000145757.11,95682991,5-95714913-T-C,rs622266,-1,T,C,95714913,31922,95486383,95879599,228530
5,ENSG00000145757.11,95682991,5-95714913-T-A,rs622266,-1,T,A,95714913,31922,95486383,95879599,228530
5,ENSG00000171421.7,1799837,5-1824239-G-A,rs62338062,-1,G,A,1824239,24402,1603229,1996445,221010
5,ENSG00000145740.13,69094014,5-68945089-T-C,rs62354485,1,T,C,68945089,148925,68897406,69290622,47683
5,ENSG00000145592.9,40835222,5-40858140-G-A,rs62357607,-1,G,A,40858140,22918,40638614,41031830,219526
5,ENSG00000178996.8,54517759,5-54484035-T-C,rs6450211,1,T,C,54484035,33724,54321151,54714367,162884
5,ENSG00000134058.6,69234886,5-69155128-A-G,rs651076,1,A,G,69155128,79758,69038278,69431494,116850
5,ENSG00000015479.12,139293740,5-139369899-A-C,rs6596471,1,A,C,139369899,76159,139097132,139490348,272767
5,ENSG00000015479.12,139293740,5-139369899-A-T,rs6596471,1,A,T,139369899,76159,139097132,139490348,272767
5,ENSG00000015479.12,139293740,5-139369899-A-G,rs6596471,1,A,G,139369899,76159,139097132,139490348,272767
5,ENSG00000170074.14,177753206,5-177711297-A-C,rs6601075,-1,A,C,177711297,41909,177556598,177949814,154699
5,ENSG00000170074.14,177753206,5-177711297-A-G,rs6601075,-1,A,G,177711297,41909,177556598,177949814,154699
5,ENSG00000205302.2,122775080,5-122846570-G-A,rs67616210,1,G,A,122846570,71490,122578472,122971688,268098
5,ENSG00000145555.10,16936288,5-17059260-C-A,rs6862915,-1,C,A,17059260,122972,16739680,17132896,319580
5,ENSG00000145555.10,16936288,5-17059260-C-T,rs6862915,-1,C,T,17059260,122972,16739680,17132896,319580
5,ENSG00000164300.10,80256048,5-80215650-T-G,rs6863904,-1,T,G,80215650,40398,80059440,80452656,156210
5,ENSG00000164300.10,80256048,5-80215650-T-C,rs6863904,-1,T,C,80215650,40398,80059440,80452656,156210
5,ENSG00000145817.10,144170659,5-144170653-G-T,rs6864309,-1,G,T,144170653,6,143974051,144367267,196602
5,ENSG00000145817.10,144170659,5-144170653-G-A,rs6864309,-1,G,A,144170653,6,143974051,144367267,196602
5,ENSG00000175426.6,96433248,5-96562214-T-C,rs6866374,-1,T,C,96562214,128966,96236640,96629856,325574
5,ENSG00000175426.6,96433248,5-96562214-T-G,rs6866374,-1,T,G,96562214,128966,96236640,96629856,325574
5,ENSG00000113070.6,140346603,5-140280343-C-G,rs6869801,-1,C,G,140280343,66260,140149995,140543211,130348
5,ENSG00000113070.6,140346603,5-140280343-C-T,rs6869801,-1,C,T,140280343,66260,140149995,140543211,130348
5,ENSG00000113070.6,140346603,5-140280343-C-A,rs6869801,-1,C,A,140280343,66260,140149995,140543211,130348
5,ENSG00000204764.6,170862018,5-170771681-T-C,rs6870687,1,T,C,170771681,90337,170665410,171058626,106271
5,ENSG00000171617.8,74640728,5-74491055-T-C,rs6874566,-1,T,C,74491055,149673,74444120,74837336,46935
5,ENSG00000171617.8,74640728,5-74491055-T-A,rs6874566,-1,T,A,74491055,149673,74444120,74837336,46935
5,ENSG00000250722.1,42811892,5-42698979-G-A,rs6875431,-1,G,A,42698979,112913,42615284,43008500,83695
5,ENSG00000132356.7,40798374,5-40829209-C-T,rs6876367,-1,C,T,40829209,30835,40601766,40994982,227443
5,ENSG00000050748.12,180292083,5-180250545-C-T,rs6877489,-1,C,T,180250545,41538,180095475,180488691,155070
5,ENSG00000050748.12,180292083,5-180250545-C-G,rs6877489,-1,C,G,180250545,41538,180095475,180488691,155070
5,ENSG00000050748.12,180292083,5-180250545-C-A,rs6877489,-1,C,A,180250545,41538,180095475,180488691,155070
5,ENSG00000145779.6,119356019,5-119347094-C-T,rs6878879,1,C,T,119347094,8925,119159411,119552627,187683
5,ENSG00000186468.8,82278354,5-82278363-C-T,rs6880209,-1,C,T,82278363,9,82081746,82474962,196617
5,ENSG00000131507.7,142108779,5-142058392-A-G,rs6884380,1,A,G,142058392,50387,141912171,142305387,146221
5,ENSG00000131507.7,142108779,5-142058392-A-T,rs6884380,1,A,T,142058392,50387,141912171,142305387,146221
5,ENSG00000145882.6,149358046,5-149346583-A-G,rs6887230,1,A,G,149346583,11463,149161438,149554654,185145
5,ENSG00000234284.2,179023804,5-179022073-T-C,rs6888567,1,T,C,179022073,1731,178827196,179220412,194877
5,ENSG00000168938.5,123036725,5-122849838-A-G,rs6890034,-1,A,G,122849838,186887,122840117,123233333,9721
5,ENSG00000112992.10,43603180,5-43680565-A-C,rs6893250,1,A,C,43680565,77385,43406572,43799788,273993
5,ENSG00000112992.10,43603180,5-43680565-A-G,rs6893250,1,A,G,43680565,77385,43406572,43799788,273993
5,ENSG00000178338.6,178859953,5-178884992-G-A,rs6894878,1,G,A,178884992,25039,178663345,179056561,221647
5,ENSG00000145824.8,135578991,5-135631045-C-T,rs6895292,-1,C,T,135631045,52054,135382383,135775599,248662
5,ENSG00000145824.8,135578991,5-135631045-C-A,rs6895292,-1,C,A,135631045,52054,135382383,135775599,248662
5,ENSG00000135077.4,157109044,5-157114365-C-G,rs6896579,-1,C,G,157114365,5321,156912436,157305652,201929
5,ENSG00000135077.4,157109044,5-157114365-C-T,rs6896579,-1,C,T,157114365,5321,156912436,157305652,201929
5,ENSG00000164331.5,73565639,5-73568182-A-G,rs6898164,-1,A,G,73568182,2543,73369031,73762247,199151
5,ENSG00000062194.10,57174059,5-57263411-T-G,rs7168,1,T,G,57263411,89352,56977451,57370667,285960
5,ENSG00000062194.10,57174059,5-57263411-T-C,rs7168,1,T,C,57263411,89352,56977451,57370667,285960
5,ENSG00000062194.10,57174059,5-57263411-T-A,rs7168,1,T,A,57263411,89352,56977451,57370667,285960
5,ENSG00000254996.1,140401908,5-140332965-A-T,rs7268,1,A,T,140332965,68943,140205300,140598516,127665
5,ENSG00000254996.1,140401908,5-140332965-A-C,rs7268,1,A,C,140332965,68943,140205300,140598516,127665
5,ENSG00000185028.3,191495,5-89622-A-G,rs72710814,1,A,G,89622,101873,-5113,388103,94735
5,ENSG00000164258.7,53560639,5-53657454-C-T,rs72753668,1,C,T,53657454,96815,53364031,53757247,293423
5,ENSG00000213949.3,52787916,5-52890689-A-C,rs72756577,1,A,C,52890689,102773,52591308,52984524,299381
5,ENSG00000055163.14,157266123,5-157272119-A-T,rs727588,1,A,T,157272119,5996,157069515,157462731,202604
5,ENSG00000055163.14,157266123,5-157272119-A-C,rs727588,1,A,C,157272119,5996,157069515,157462731,202604
5,ENSG00000171540.6,77638713,5-77568688-C-T,rs72770940,-1,C,T,77568688,70025,77442105,77835321,126583
5,ENSG00000113083.7,122078259,5-122152274-G-C,rs72786994,-1,G,C,122152274,74015,121881651,122274867,270623
5,ENSG00000113083.7,122078259,5-122152274-G-A,rs72786994,-1,G,A,122152274,74015,121881651,122274867,270623
5,ENSG00000196743.4,151253185,5-151239432-C-T,rs72794132,1,C,T,151239432,13753,151056577,151449793,182855
5,ENSG00000170606.8,133052013,5-133108436-G-A,rs72801474,1,G,A,133108436,56423,132855405,133248621,253031
5,ENSG00000169567.7,131165256,5-131154017-T-C,rs72803754,-1,T,C,131154017,11239,130968648,131361864,185369
5,ENSG00000158402.13,138331804,5-138428660-C-T,rs72803894,-1,C,T,138428660,96856,138135196,138528412,293464
5,ENSG00000087206.11,177006779,5-177079956-G-T,rs72813142,-1,G,T,177079956,73177,176810171,177203387,269785
5,ENSG00000087206.11,177006779,5-177079956-G-C,rs72813142,-1,G,C,177079956,73177,176810171,177203387,269785
5,ENSG00000087206.11,177006779,5-177079956-G-A,rs72813142,-1,G,A,177079956,73177,176810171,177203387,269785
5,ENSG00000113734.13,173144531,5-173089762-C-T,rs72816117,1,C,T,173089762,54769,172947923,173341139,141839
5,ENSG00000129596.4,115816659,5-115638165-T-C,rs72817147,-1,T,C,115638165,178494,115620051,116013267,18114
5,ENSG00000155324.4,126423409,5-126448667-C-G,rs75108770,1,C,G,126448667,25258,126226801,126620017,221866
5,ENSG00000173210.14,149141493,5-149318287-C-T,rs75184973,1,C,T,149318287,176794,148944885,149338101,373402
5,ENSG00000146054.13,181205196,5-181199242-G-A,rs76492548,-1,G,A,181199242,5954,181008588,181401804,190654
5,ENSG00000072682.12,132227853,5-132250265-A-G,rs7701414,-1,A,G,132250265,22412,132031245,132424461,219020
5,ENSG00000164237.4,10307902,5-10306532-G-A,rs7702977,-1,G,A,10306532,1370,10111294,10504510,195238
5,ENSG00000154124.4,14664718,5-14788330-C-T,rs7703719,1,C,T,14788330,123612,14468110,14861326,320220
5,ENSG00000170091.6,174045706,5-174195860-G-C,rs7711162,1,G,C,174195860,150154,173849098,174242314,346762
5,ENSG00000170091.6,174045706,5-174195860-G-A,rs7711162,1,G,A,174195860,150154,173849098,174242314,346762
5,ENSG00000157107.8,72956041,5-72956648-A-G,rs7713398,1,A,G,72956648,607,72759433,73152649,197215
5,ENSG00000164346.5,74767249,5-74737072-T-C,rs7713812,1,T,C,74737072,30177,74570641,74963857,166431
5,ENSG00000164346.5,74767249,5-74737072-T-A,rs7713812,1,T,A,74737072,30177,74570641,74963857,166431
5,ENSG00000244234.1,178187371,5-178212941-G-C,rs7719034,-1,G,C,178212941,25570,177990763,178383979,222178
5,ENSG00000244234.1,178187371,5-178212941-G-A,rs7719034,-1,G,A,178212941,25570,177990763,178383979,222178
5,ENSG00000067113.12,55534964,5-55388522-T-A,rs7719928,-1,T,A,55388522,146442,55338356,55731572,50166
5,ENSG00000171522.5,40679915,5-40486794-G-T,rs7720838,1,G,T,40486794,193121,40483307,40876523,3487
5,ENSG00000123643.6,151447603,5-151587978-A-C,rs7723204,1,A,C,151587978,140375,151250995,151644211,336983
5,ENSG00000123643.6,151447603,5-151587978-A-T,rs7723204,1,A,T,151587978,140375,151250995,151644211,336983
5,ENSG00000123643.6,151447603,5-151587978-A-G,rs7723204,1,A,G,151587978,140375,151250995,151644211,336983
5,ENSG00000113356.6,90474864,5-90464074-T-G,rs7730433,1,T,G,90464074,10790,90278256,90671472,185818
5,ENSG00000092421.12,116574823,5-116687054-C-T,rs77843619,-1,C,T,116687054,112231,116378215,116771431,308839
5,ENSG00000134352.14,55994963,5-56123279-G-T,rs79330186,-1,G,T,56123279,128316,55798355,56191571,324924
5,ENSG00000134352.14,55994963,5-56123279-G-A,rs79330186,-1,G,A,56123279,128316,55798355,56191571,324924
5,ENSG00000172548.10,157460213,5-157600544-T-A,rs80213842,1,T,A,157600544,140331,157263605,157656821,336939
5,ENSG00000172548.10,157460213,5-157600544-T-C,rs80213842,1,T,C,157600544,140331,157263605,157656821,336939
5,ENSG00000154122.8,14871778,5-14877365-A-C,rs835153,-1,A,C,14877365,5587,14675170,15068386,202195
5,ENSG00000154122.8,14871778,5-14877365-A-T,rs835153,-1,A,T,14877365,5587,14675170,15068386,202195
5,ENSG00000154122.8,14871778,5-14877365-A-G,rs835153,-1,A,G,14877365,5587,14675170,15068386,202195
5,ENSG00000135074.11,157575775,5-157507299-C-A,rs868989,-1,C,A,157507299,68476,157379167,157772383,128132
5,ENSG00000135074.11,157575775,5-157507299-C-T,rs868989,-1,C,T,157507299,68476,157379167,157772383,128132
5,ENSG00000135074.11,157575775,5-157507299-C-G,rs868989,-1,C,G,157507299,68476,157379167,157772383,128132
5,ENSG00000249915.2,271646,5-168810-G-A,rs876950,1,G,A,168810,102836,75038,468254,93772
5,ENSG00000249915.2,271646,5-168810-G-T,rs876950,1,G,T,168810,102836,75038,468254,93772
5,ENSG00000170074.14,177753206,5-177693696-T-A,rs10060053,-1,T,A,177693696,59510,177556598,177949814,137098
5,ENSG00000170074.14,177753206,5-177693696-T-C,rs10060053,-1,T,C,177693696,59510,177556598,177949814,137098
5,ENSG00000186952.10,110726671,5-110725553-C-T,rs10061929,-1,C,T,110725553,1118,110530063,110923279,195490
5,ENSG00000164284.10,149345499,5-149395421-C-G,rs10070761,1,C,G,149395421,49922,149148891,149542107,246530
5,ENSG00000164284.10,149345499,5-149395421-C-T,rs10070761,1,C,T,149395421,49922,149148891,149542107,246530
5,ENSG00000178015.4,95620087,5-95613549-A-G,rs10075788,1,A,G,95613549,6538,95423479,95816695,190070
5,ENSG00000178015.4,95620087,5-95613549-A-T,rs10075788,1,A,T,95613549,6538,95423479,95816695,190070
5,ENSG00000178015.4,95620087,5-95613549-A-C,rs10075788,1,A,C,95613549,6538,95423479,95816695,190070
5,ENSG00000151304.5,121961975,5-121984577-T-A,rs10077959,1,T,A,121984577,22602,121765367,122158583,219210
5,ENSG00000124275.10,7869148,5-7930753-G-C,rs10440693,1,G,C,7930753,61605,7672540,8065756,258213
5,ENSG00000124275.10,7869148,5-7930753-G-A,rs10440693,1,G,A,7930753,61605,7672540,8065756,258213
5,ENSG00000151883.10,50666637,5-50721890-A-G,rs10461602,1,A,G,50721890,55253,50470029,50863245,251861
5,ENSG00000164172.13,53109757,5-53128688-G-T,rs10471373,-1,G,T,53128688,18931,52913149,53306365,215539
5,ENSG00000113494.12,35230487,5-35238263-T-C,rs10472952,-1,T,C,35238263,7776,35033879,35427095,204384
5,ENSG00000155850.7,149960758,5-149987366-G-A,rs10476926,1,G,A,149987366,26608,149764150,150157366,223216
5,ENSG00000155850.7,149960758,5-149987366-G-T,rs10476926,1,G,T,149987366,26608,149764150,150157366,223216
5,ENSG00000145907.9,151771954,5-151796187-T-C,rs10477000,1,T,C,151796187,24233,151575346,151968562,220841
5,ENSG00000129596.4,115816659,5-115732628-T-C,rs10478250,-1,T,C,115732628,84031,115620051,116013267,112577
5,ENSG00000186468.8,82278354,5-82352598-C-T,rs10514238,-1,C,T,82352598,74244,82081746,82474962,270852
5,ENSG00000037749.7,154038967,5-153992529-A-G,rs10515704,1,A,G,153992529,46438,153842359,154235575,150170
5,ENSG00000037749.7,154038967,5-153992529-A-T,rs10515704,1,A,T,153992529,46438,153842359,154235575,150170
5,ENSG00000113368.6,126777136,5-126594115-T-C,rs10519915,1,T,C,126594115,183021,126580528,126973744,13587
5,ENSG00000168621.10,37840041,5-37806428-C-T,rs10941369,-1,C,T,37806428,33613,37643433,38036649,162995
5,ENSG00000204764.6,170862018,5-170785123-G-A,rs11134652,1,G,A,170785123,76895,170665410,171058626,119713
5,ENSG00000204764.6,170862018,5-170785123-G-T,rs11134652,1,G,T,170785123,76895,170665410,171058626,119713
5,ENSG00000172548.10,157460213,5-157531282-T-C,rs11134799,1,T,C,157531282,71069,157263605,157656821,267677
5,ENSG00000131507.7,142108779,5-142099500-A-G,rs11167764,1,A,G,142099500,9279,141912171,142305387,187329
5,ENSG00000131507.7,142108779,5-142099500-A-C,rs11167764,1,A,C,142099500,9279,141912171,142305387,187329
5,ENSG00000131507.7,142108779,5-142099500-A-T,rs11167764,1,A,T,142099500,9279,141912171,142305387,187329
5,ENSG00000169131.6,178730659,5-178722949-G-A,rs112370781,-1,G,A,178722949,7710,178534051,178927267,188898
5,ENSG00000169131.6,178730659,5-178722949-G-T,rs112370781,-1,G,T,178722949,7710,178534051,178927267,188898
5,ENSG00000066583.6,129094749,5-128951488-T-C,rs11241981,1,T,C,128951488,143261,128898141,129291357,53347
5,ENSG00000228672.2,139395104,5-139431876-A-C,rs11242467,-1,A,C,139431876,36772,139198496,139591712,233380
5,ENSG00000228672.2,139395104,5-139431876-A-G,rs11242467,-1,A,G,139431876,36772,139198496,139591712,233380
5,ENSG00000175471.13,95285094,5-95255970-T-C,rs114068480,-1,T,C,95255970,29124,95088486,95481702,167484
5,ENSG00000145604.10,36152111,5-36084324-T-C,rs114136102,1,T,C,36084324,67787,35955503,36348719,128821
5,ENSG00000113552.11,142013027,5-142049411-G-A,rs114661937,-1,G,A,142049411,36384,141816419,142209635,232992
5,ENSG00000113552.11,142013027,5-142049411-G-C,rs114661937,-1,G,C,142049411,36384,141816419,142209635,232992
5,ENSG00000125347.8,132490773,5-132335767-G-A,rs11568506,-1,G,A,132335767,155006,132294165,132687381,41602
5,ENSG00000171617.8,74640728,5-74468164-T-G,rs115775918,-1,T,G,74468164,172564,74444120,74837336,24044
5,ENSG00000168246.5,172283764,5-172283127-G-A,rs115910681,-1,G,A,172283127,637,172087156,172480372,195971
5,ENSG00000131459.8,180353336,5-180414314-G-A,rs116391970,-1,G,A,180414314,60978,180156728,180549944,257586
5,ENSG00000124279.7,7869031,5-7903428-G-A,rs116620559,-1,G,A,7903428,34397,7672423,8065639,231005
5,ENSG00000160883.6,176899346,5-176858046-G-A,rs116686459,-1,G,A,176858046,41300,176702738,177095954,155308
5,ENSG00000197860.5,65722109,5-65581787-A-G,rs11740053,-1,A,G,65581787,140322,65525501,65918717,56286
5,ENSG00000185028.3,191495,5-375290-C-T,rs11744131,1,C,T,375290,183795,-5113,388103,380403
5,ENSG00000180104.9,443176,5-489084-T-C,rs11748410,1,T,C,489084,45908,246568,639784,242516
5,ENSG00000113328.13,163437595,5-163578305-G-A,rs11748774,1,G,A,163578305,140710,163240987,163634203,337318
5,ENSG00000189045.7,75611453,5-75752070-C-T,rs11750165,1,C,T,75752070,140617,75414845,75808061,337225
5,ENSG00000172568.4,157345677,5-157445408-C-T,rs11750519,-1,C,T,157445408,99731,157149069,157542285,296339
5,ENSG00000164237.4,10307902,5-10309010-A-T,rs11951923,-1,A,T,10309010,1108,10111294,10504510,197716
5,ENSG00000164237.4,10307902,5-10309010-A-G,rs11951923,-1,A,G,10309010,1108,10111294,10504510,197716
5,ENSG00000164615.3,134738548,5-134570837-C-T,rs11953143,1,C,T,134570837,167711,134541940,134935156,28897
5,ENSG00000145824.8,135578991,5-135650385-G-A,rs11960418,-1,G,A,135650385,71394,135382383,135775599,268002
5,ENSG00000082213.12,31532301,5-31484788-C-T,rs12173038,1,C,T,31484788,47513,31335693,31728909,149095
5,ENSG00000131711.10,72107475,5-72095585-A-G,rs1217820,1,A,G,72095585,11890,71910867,72304083,184718
5,ENSG00000113649.7,146447333,5-146407696-T-C,rs12517249,1,T,C,146407696,39637,146250725,146643941,156971
5,ENSG00000092421.12,116574823,5-116675596-A-G,rs12521259,-1,A,G,116675596,100773,116378215,116771431,297381
5,ENSG00000092421.12,116574823,5-116675596-A-T,rs12521259,-1,A,T,116675596,100773,116378215,116771431,297381
5,ENSG00000092421.12,116574823,5-116675596-A-C,rs12521259,-1,A,C,116675596,100773,116378215,116771431,297381
5,ENSG00000113742.8,173888349,5-173822689-T-C,rs12652980,1,T,C,173822689,65660,173691741,174084957,130948
5,ENSG00000113742.8,173888349,5-173822689-T-G,rs12652980,1,T,G,173822689,65660,173691741,174084957,130948
5,ENSG00000113742.8,173888349,5-173822689-T-A,rs12652980,1,T,A,173822689,65660,173691741,174084957,130948
5,ENSG00000185261.8,94618604,5-94572767-T-C,rs12653819,-1,T,C,94572767,45837,94421996,94815212,150771
5,ENSG00000186314.7,145835342,5-145821569-C-G,rs12658465,-1,C,G,145821569,13773,145638734,146031950,182835
5,ENSG00000186314.7,145835342,5-145821569-C-T,rs12658465,-1,C,T,145821569,13773,145638734,146031950,182835
5,ENSG00000254996.1,140401908,5-140298717-A-T,rs13153401,1,A,T,140298717,103191,140205300,140598516,93417
5,ENSG00000254996.1,140401908,5-140298717-A-G,rs13153401,1,A,G,140298717,103191,140205300,140598516,93417
5,ENSG00000168944.10,123423403,5-123408484-T-A,rs13154356,-1,T,A,123408484,14919,123226795,123620011,181689
5,ENSG00000168944.10,123423403,5-123408484-T-C,rs13154356,-1,T,C,123408484,14919,123226795,123620011,181689
5,ENSG00000164307.7,96807945,5-96775667-G-A,rs13160562,-1,G,A,96775667,32278,96611337,97004553,164330
5,ENSG00000123219.7,65563168,5-65542051-G-A,rs13178551,-1,G,A,65542051,21117,65366560,65759776,175491
5,ENSG00000048162.14,176388598,5-176401346-A-G,rs13182101,-1,A,G,176401346,12748,176191990,176585206,209356
5,ENSG00000170584.5,163460102,5-163302582-G-A,rs13183207,-1,G,A,163302582,157520,163263494,163656710,39088
5,ENSG00000168671.5,36066882,5-36086924-C-T,rs13360035,-1,C,T,36086924,20042,35870274,36263490,216650
5,ENSG00000168671.5,36066882,5-36086924-C-A,rs13360035,-1,C,A,36086924,20042,35870274,36263490,216650
5,ENSG00000145592.9,40835222,5-40912709-T-G,rs1376182,-1,T,G,40912709,77487,40638614,41031830,274095
5,ENSG00000164309.10,79689836,5-79841851-A-G,rs1428221,1,A,G,79841851,152015,79493228,79886444,348623
5,ENSG00000152495.6,111224384,5-111131801-C-T,rs1438673,1,C,T,111131801,92583,111027776,111420992,104025
5,ENSG00000129625.8,112922227,5-112931398-G-A,rs149130,-1,G,A,112931398,9171,112725619,113118835,205779
5,ENSG00000196743.4,151253185,5-151255868-A-T,rs152266,1,A,T,151255868,2683,151056577,151449793,199291
5,ENSG00000196743.4,151253185,5-151255868-A-G,rs152266,1,A,G,151255868,2683,151056577,151449793,199291
5,ENSG00000164171.5,52989352,5-53009166-A-G,rs153141,1,A,G,53009166,19814,52792744,53185960,216422
5,ENSG00000177556.7,151758631,5-151758650-A-T,rs1549921,-1,A,T,151758650,19,151562023,151955239,196627
5,ENSG00000177556.7,151758631,5-151758650-A-G,rs1549921,-1,A,G,151758650,19,151562023,151955239,196627
5,ENSG00000152422.10,83077547,5-83117014-A-G,rs1564211,1,A,G,83117014,39467,82880939,83274155,236075
5,ENSG00000154153.9,16616997,5-16522016-C-T,rs163282,-1,C,T,16522016,94981,16420389,16813605,101627
5,ENSG00000164346.5,74767249,5-74673233-A-C,rs16872173,1,A,C,74673233,94016,74570641,74963857,102592
5,ENSG00000164347.11,74767117,5-74673233-A-C,rs16872173,-1,A,C,74673233,93884,74570509,74963725,102724
5,ENSG00000198780.7,74866387,5-74830539-A-C,rs16872305,-1,A,C,74830539,35848,74669779,75062995,160760
5,ENSG00000074276.6,176549342,5-176590638-C-A,rs17078347,1,C,A,176590638,41296,176352734,176745950,237904
5,ENSG00000048140.13,176647484,5-176683658-G-A,rs17078413,1,G,A,176683658,36174,176450876,176844092,232782
5,ENSG00000183775.4,144170873,5-144152083-A-T,rs17101592,1,A,T,144152083,18790,143974265,144367481,177818
5,ENSG00000172795.11,112976798,5-112845176-T-A,rs17135042,1,T,A,112845176,131622,112780190,113173406,64986
5,ENSG00000172795.11,112976798,5-112845176-T-C,rs17135042,1,T,C,112845176,131622,112780190,113173406,64986
5,ENSG00000120708.9,136028988,5-135914735-A-G,rs17169384,1,A,G,135914735,114253,135832380,136225596,82355
5,ENSG00000153914.10,66144300,5-66302901-T-G,rs17251088,1,T,G,66302901,158601,65947692,66340908,355209
5,ENSG00000153914.10,66144300,5-66302901-T-C,rs17251088,1,T,C,66302901,158601,65947692,66340908,355209
5,ENSG00000134058.6,69234886,5-69219666-A-G,rs17331590,1,A,G,69219666,15220,69038278,69431494,181388
5,ENSG00000168938.5,123036725,5-123196696-A-C,rs17470253,-1,A,C,123196696,159971,122840117,123233333,356579
5,ENSG00000168938.5,123036725,5-123196696-A-G,rs17470253,-1,A,G,123196696,159971,122840117,123233333,356579
5,ENSG00000082074.10,39219563,5-39371973-A-G,rs17470667,-1,A,G,39371973,152410,39022955,39416171,349018
5,ENSG00000151292.13,123512099,5-123344495-G-A,rs17472832,1,G,A,123344495,167604,123315491,123708707,29004
5,ENSG00000151292.13,123512099,5-123344495-G-T,rs17472832,1,G,T,123344495,167604,123315491,123708707,29004
5,ENSG00000164404.4,132866469,5-132861019-C-T,rs17516673,-1,C,T,132861019,5450,132669861,133063077,191158
5,ENSG00000155324.4,126423409,5-126282239-C-T,rs17527123,1,C,T,126282239,141170,126226801,126620017,55438
5,ENSG00000169252.4,148826611,5-149010151-A-C,rs17641073,1,A,C,149010151,183540,148630003,149023219,380148
5,ENSG00000164463.7,173056352,5-173141368-A-G,rs17662869,1,A,G,173141368,85016,172859744,173252960,281624
5,ENSG00000072571.13,163460632,5-163610858-A-G,rs17668553,1,A,G,163610858,150226,163264024,163657240,346834
5,ENSG00000120705.8,138543236,5-138612735-T-C,rs1821257,-1,T,C,138612735,69499,138346628,138739844,266107
5,ENSG00000095015.5,56815549,5-56800488-G-C,rs1862618,1,G,C,56800488,15061,56618941,57012157,181547
5,ENSG00000164209.11,110739007,5-110608456-A-T,rs190924397,1,A,T,110608456,130551,110542399,110935615,66057
5,ENSG00000164308.12,96876500,5-96852963-A-C,rs2042381,1,A,C,96852963,23537,96679892,97073108,173071
5,ENSG00000164308.12,96876500,5-96852963-A-T,rs2042381,1,A,T,96852963,23537,96679892,97073108,173071
5,ENSG00000164308.12,96876500,5-96852963-A-G,rs2042381,1,A,G,96852963,23537,96679892,97073108,173071
5,ENSG00000142319.14,1445440,5-1416531-G-A,rs2042449,-1,G,A,1416531,28909,1248832,1642048,167699
5,ENSG00000197375.7,132369710,5-132232924-T-C,rs2077380,1,T,C,132232924,136786,132173102,132566318,59822
5,ENSG00000197375.7,132369710,5-132232924-T-G,rs2077380,1,T,G,132232924,136786,132173102,132566318,59822
5,ENSG00000169570.4,118988547,5-118976716-A-G,rs2084460,-1,A,G,118976716,11831,118791939,119185155,184777
5,ENSG00000113716.8,150000739,5-150063735-C-T,rs216140,1,C,T,150063735,62996,149804131,150197347,259604
5,ENSG00000182578.8,150086554,5-150066358-T-C,rs216146,-1,T,C,150066358,20196,149889946,150283162,176412
5,ENSG00000182578.8,150086554,5-150066358-T-A,rs216146,-1,T,A,150066358,20196,149889946,150283162,176412
5,ENSG00000182578.8,150086554,5-150066358-T-G,rs216146,-1,T,G,150066358,20196,149889946,150283162,176412
5,ENSG00000112984.7,138179112,5-138189633-A-G,rs2231480,1,A,G,138189633,10521,137982504,138375720,207129
5,ENSG00000113296.10,80035348,5-80058361-A-G,rs2241826,1,A,G,80058361,23013,79838740,80231956,219621
5,ENSG00000066230.6,524449,5-476904-T-C,rs2244223,-1,T,C,476904,47545,327841,721057,149063
5,ENSG00000081791.4,141923871,5-141936116-G-C,rs2270113,1,G,C,141936116,12245,141727263,142120479,208853
5,ENSG00000164258.7,53560639,5-53560674-G-C,rs2279516,1,G,C,53560674,35,53364031,53757247,196643
5,ENSG00000133706.12,146182650,5-146204060-A-G,rs2279895,-1,A,G,146204060,21410,145986042,146379258,218018
5,ENSG00000113068.5,140303101,5-140159929-A-G,rs2291878,-1,A,G,140159929,143172,140106493,140499709,53436
5,ENSG00000113068.5,140303101,5-140159929-A-C,rs2291878,-1,A,C,140159929,143172,140106493,140499709,53436
5,ENSG00000164574.11,154190733,5-154250889-T-C,rs2351232,1,T,C,154250889,60156,153994125,154387341,256764
5,ENSG00000153113.17,96662376,5-96660029-G-T,rs2351245,1,G,T,96660029,2347,96465768,96858984,194261
5,ENSG00000158458.14,140043299,5-140036680-C-A,rs2436389,-1,C,A,140036680,6619,139846691,140239907,189989
5,ENSG00000158458.14,140043299,5-140036680-C-G,rs2436389,-1,C,G,140036680,6619,139846691,140239907,189989
5,ENSG00000188573.6,168529305,5-168491658-G-T,rs244896,1,G,T,168491658,37647,168332697,168725913,158961
5,ENSG00000188573.6,168529305,5-168491658-G-A,rs244896,1,G,A,168491658,37647,168332697,168725913,158961
5,ENSG00000072682.12,132227853,5-132173578-A-G,rs246351,-1,A,G,132173578,54275,132031245,132424461,142333
5,ENSG00000255833.1,135452351,5-135473290-A-C,rs251556,-1,A,C,135473290,20939,135255743,135648959,217547
5,ENSG00000255833.1,135452351,5-135473290-A-T,rs251556,-1,A,T,135473290,20939,135255743,135648959,217547
5,ENSG00000113575.5,134226073,5-134236165-C-T,rs254057,-1,C,T,134236165,10092,134029465,134422681,206700
5,ENSG00000170458.9,140633175,5-140757420-C-T,rs2563265,-1,C,T,140757420,124245,140436567,140829783,320853
5,ENSG00000243056.1,140547662,5-140631730-C-G,rs2563298,1,C,G,140631730,84068,140351054,140744270,280676
5,ENSG00000243056.1,140547662,5-140631730-C-A,rs2563298,1,C,A,140631730,84068,140351054,140744270,280676
5,ENSG00000112977.11,10761234,5-10713283-G-A,rs267985,-1,G,A,10713283,47951,10564626,10957842,148657
5,ENSG00000112902.7,9546075,5-9500970-G-A,rs268502,-1,G,A,9500970,45105,9349467,9742683,151503
5,ENSG00000113441.11,96936080,5-96762440-G-T,rs27035,1,G,T,96762440,173640,96739472,97132688,22968
5,ENSG00000113441.11,96936080,5-96762440-G-A,rs27035,1,G,A,96762440,173640,96739472,97132688,22968
5,ENSG00000113441.11,96936080,5-96762440-G-C,rs27035,1,G,C,96762440,173640,96739472,97132688,22968
5,ENSG00000153395.5,1523960,5-1479563-G-A,rs27059,-1,G,A,1479563,44397,1327352,1720568,152211
5,ENSG00000153395.5,1523960,5-1479563-G-T,rs27059,-1,G,T,1479563,44397,1327352,1720568,152211
5,ENSG00000153395.5,1523960,5-1479563-G-C,rs27059,-1,G,C,1479563,44397,1327352,1720568,152211
5,ENSG00000164199.10,90558797,5-90547252-C-T,rs27656,1,C,T,90547252,11545,90362189,90755405,185063
5,ENSG00000027847.8,177600132,5-177547579-C-T,rs28626332,1,C,T,177547579,52553,177403524,177796740,144055
5,ENSG00000064651.9,128083766,5-127962365-A-G,rs28687461,1,A,G,127962365,121401,127887158,128280374,75207
5,ENSG00000164611.8,160421855,5-160411656-C-T,rs2910188,1,C,T,160411656,10199,160225247,160618463,186409
5,ENSG00000146066.2,176388751,5-176508315-T-A,rs2963672,1,T,A,176508315,119564,176192143,176585359,316172
5,ENSG00000146066.2,176388751,5-176508315-T-C,rs2963672,1,T,C,176508315,119564,176192143,176585359,316172
5,ENSG00000146066.2,176388751,5-176508315-T-G,rs2963672,1,T,G,176508315,119564,176192143,176585359,316172
5,ENSG00000249915.2,271646,5-190524-C-A,rs29681,1,C,A,190524,81122,75038,468254,115486
5,ENSG00000249915.2,271646,5-190524-C-T,rs29681,1,C,T,190524,81122,75038,468254,115486
5,ENSG00000249915.2,271646,5-190524-C-G,rs29681,1,C,G,190524,81122,75038,468254,115486
5,ENSG00000134056.6,69217760,5-69233016-A-G,rs2972357,1,A,G,69233016,15256,69021152,69414368,211864
5,ENSG00000134056.6,69217760,5-69233016-A-T,rs2972357,1,A,T,69233016,15256,69021152,69414368,211864
5,ENSG00000242110.3,34008050,5-34031909-G-A,rs299596,-1,G,A,34031909,23859,33811442,34204658,220467
5,ENSG00000177721.3,43040319,5-42902233-G-A,rs309915,-1,G,A,42902233,138086,42843711,43236927,58522
5,ENSG00000050748.12,180292083,5-180227415-T-C,rs3111519,-1,T,C,180227415,64668,180095475,180488691,131940
5,ENSG00000156453.9,141878410,5-141754378-C-G,rs32935,-1,C,G,141754378,124032,141681802,142075018,72576
5,ENSG00000156453.9,141878410,5-141754378-C-T,rs32935,-1,C,T,141754378,124032,141681802,142075018,72576
5,ENSG00000228716.2,80654983,5-80764197-G-A,rs33013,-1,G,A,80764197,109214,80458375,80851591,305822
5,ENSG00000113273.11,78985310,5-78889102-A-T,rs337884,-1,A,T,78889102,96208,78788702,79181918,100400
5,ENSG00000113273.11,78985310,5-78889102-A-G,rs337884,-1,A,G,78889102,96208,78788702,79181918,100400
5,ENSG00000113273.11,78985310,5-78889102-A-C,rs337884,-1,A,C,78889102,96208,78788702,79181918,100400
5,ENSG00000244234.1,178187371,5-178381202-T-C,rs34176122,-1,T,C,178381202,193831,177990763,178383979,390439
5,ENSG00000112874.5,103562789,5-103527826-T-G,rs34225,-1,T,G,103527826,34963,103366181,103759397,161645
5,ENSG00000113719.11,172834251,5-172769749-A-G,rs34471628,1,A,G,172769749,64502,172637643,173030859,132106
5,ENSG00000113761.7,177022696,5-177095561-C-T,rs351854,1,C,T,177095561,72865,176826088,177219304,269473
5,ENSG00000145882.6,149358046,5-149392281-G-T,rs353259,1,G,T,149392281,34235,149161438,149554654,230843
5,ENSG00000145882.6,149358046,5-149392281-G-C,rs353259,1,G,C,149392281,34235,149161438,149554654,230843
5,ENSG00000171604.7,139648349,5-139685409-G-T,rs356439,1,G,T,139685409,37060,139451741,139844957,233668
5,ENSG00000113638.8,40755961,5-40621032-G-C,rs35665260,-1,G,C,40621032,134929,40559353,40952569,61679
5,ENSG00000120733.8,138352685,5-138337315-G-A,rs3756765,1,G,A,138337315,15370,138156077,138549293,181238
5,ENSG00000120733.8,138352685,5-138337315-G-C,rs3756765,1,G,C,138337315,15370,138156077,138549293,181238
5,ENSG00000177839.4,141187161,5-141150948-G-A,rs3776096,1,G,A,141150948,36213,140990553,141383769,160395
5,ENSG00000113318.8,80654652,5-80706531-C-T,rs3776967,1,C,T,80706531,51879,80458044,80851260,248487
5,ENSG00000113595.10,65624333,5-65559126-C-G,rs378712,-1,C,G,65559126,65207,65427725,65820941,131401
5,ENSG00000113595.10,65624333,5-65559126-C-A,rs378712,-1,C,A,65559126,65207,65427725,65820941,131401
5,ENSG00000152359.9,75717437,5-75707231-A-G,rs3797580,-1,A,G,75707231,10206,75520829,75914045,186402
5,ENSG00000171368.10,693352,5-601532-G-C,rs3828570,-1,G,C,601532,91820,496744,889960,104788
5,ENSG00000171368.10,693352,5-601532-G-A,rs3828570,-1,G,A,601532,91820,496744,889960,104788
5,ENSG00000171368.10,693352,5-601532-G-T,rs3828570,-1,G,T,601532,91820,496744,889960,104788
5,ENSG00000113721.7,150155845,5-150156062-A-T,rs3828610,-1,A,T,150156062,217,149959237,150352453,196825
5,ENSG00000113721.7,150155845,5-150156062-A-G,rs3828610,-1,A,G,150156062,217,149959237,150352453,196825
5,ENSG00000113721.7,150155845,5-150156062-A-C,rs3828610,-1,A,C,150156062,217,149959237,150352453,196825
5,ENSG00000038382.12,14143342,5-14068335-C-T,rs3849080,1,C,T,14068335,75007,13946734,14339950,121601
5,ENSG00000198624.7,151224092,5-151241736-C-T,rs3857424,-1,C,T,151241736,17644,151027484,151420700,214252
5,ENSG00000198624.7,151224092,5-151241736-C-G,rs3857424,-1,C,G,151241736,17644,151027484,151420700,214252
5,ENSG00000198624.7,151224092,5-151241736-C-A,rs3857424,-1,C,A,151241736,17644,151027484,151420700,214252
5,ENSG00000198944.4,132813302,5-132770869-A-G,rs392916,1,A,G,132770869,42433,132616694,133009910,154175
5,ENSG00000198944.4,132813302,5-132770869-A-T,rs392916,1,A,T,132770869,42433,132616694,133009910,154175
5,ENSG00000169220.12,177357924,5-177370342-G-A,rs4074995,1,G,A,177370342,12418,177161316,177554532,209026
5,ENSG00000113593.7,65563296,5-65563113-A-G,rs41268429,1,A,G,65563113,183,65366688,65759904,196425
5,ENSG00000055163.14,157266123,5-157279443-G-A,rs41345045,1,G,A,157279443,13320,157069515,157462731,209928
5,ENSG00000055163.14,157266123,5-157279443-G-C,rs41345045,1,G,C,157279443,13320,157069515,157462731,209928
5,ENSG00000183323.8,69332801,5-69305204-C-G,rs4288083,-1,C,G,69305204,27597,69136193,69529409,169011
5,ENSG00000183323.8,69332801,5-69305204-C-T,rs4288083,-1,C,T,69305204,27597,69136193,69529409,169011
5,ENSG00000177453.3,43192225,5-43279470-T-C,rs4443426,1,T,C,43279470,87245,42995617,43388833,283853
5,ENSG00000160867.9,177086915,5-177084431-G-T,rs451643,1,G,T,177084431,2484,176890307,177283523,194124
5,ENSG00000069020.12,66596393,5-66567907-G-A,rs4527553,1,G,A,66567907,28486,66399785,66793001,168122
5,ENSG00000113504.13,1112063,5-1113867-T-C,rs4576192,-1,T,C,1113867,1804,915455,1308671,198412
5,ENSG00000113504.13,1112063,5-1113867-T-A,rs4576192,-1,T,A,1113867,1804,915455,1308671,198412
5,ENSG00000145757.11,95682991,5-95683235-A-G,rs460697,-1,A,G,95683235,244,95486383,95879599,196852
5,ENSG00000174136.7,98773663,5-98651703-G-A,rs469731,1,G,A,98651703,121960,98577055,98970271,74648
5,ENSG00000174136.7,98773663,5-98651703-G-T,rs469731,1,G,T,98651703,121960,98577055,98970271,74648
5,ENSG00000168724.10,34929559,5-34862436-G-A,rs4703481,1,G,A,34862436,67123,34732951,35126167,129485
5,ENSG00000113272.8,157731420,5-157674849-A-C,rs4704747,1,A,C,157674849,56571,157534812,157928028,140037
5,ENSG00000113272.8,157731420,5-157674849-A-T,rs4704747,1,A,T,157674849,56571,157534812,157928028,140037
5,ENSG00000113272.8,157731420,5-157674849-A-G,rs4704747,1,A,G,157674849,56571,157534812,157928028,140037
5,ENSG00000158985.9,131264053,5-131338383-G-A,rs4706020,1,G,A,131338383,74330,131067445,131460661,270938
5,ENSG00000158985.9,131264053,5-131338383-G-T,rs4706020,1,G,T,131338383,74330,131067445,131460661,270938
5,ENSG00000064652.6,122845613,5-122715324-A-G,rs4836191,1,A,G,122715324,130289,122649005,123042221,66319
5,ENSG00000064652.6,122845613,5-122715324-A-C,rs4836191,1,A,C,122715324,130289,122649005,123042221,66319
5,ENSG00000064652.6,122845613,5-122715324-A-T,rs4836191,1,A,T,122715324,130289,122649005,123042221,66319
5,ENSG00000205302.2,122775080,5-122715324-A-G,rs4836191,1,A,G,122715324,59756,122578472,122971688,136852
5,ENSG00000205302.2,122775080,5-122715324-A-C,rs4836191,1,A,C,122715324,59756,122578472,122971688,136852
5,ENSG00000205302.2,122775080,5-122715324-A-T,rs4836191,1,A,T,122715324,59756,122578472,122971688,136852
5,ENSG00000253910.1,141359994,5-141359694-G-T,rs4912605,1,G,T,141359694,300,141163386,141556602,196308
5,ENSG00000253910.1,141359994,5-141359694-G-A,rs4912605,1,G,A,141359694,300,141163386,141556602,196308
5,ENSG00000253910.1,141359994,5-141359694-G-C,rs4912605,1,G,C,141359694,300,141163386,141556602,196308
5,ENSG00000129595.7,112419277,5-112367782-G-A,rs4958045,-1,G,A,112367782,51495,112222669,112615885,145113
5,ENSG00000155511.10,153490670,5-153436579-G-A,rs4958650,1,G,A,153436579,54091,153294062,153687278,142517
5,ENSG00000171421.7,1799837,5-1822212-C-A,rs4975854,-1,C,A,1822212,22375,1603229,1996445,218983
5,ENSG00000171421.7,1799837,5-1822212-C-T,rs4975854,-1,C,T,1822212,22375,1603229,1996445,218983
5,ENSG00000161011.14,179820905,5-179821774-A-T,rs502729,1,A,T,179821774,869,179624297,180017513,197477
5,ENSG00000161011.14,179820905,5-179821774-A-C,rs502729,1,A,C,179821774,869,179624297,180017513,197477
5,ENSG00000161011.14,179820905,5-179821774-A-G,rs502729,1,A,G,179821774,869,179624297,180017513,197477
5,ENSG00000145545.7,6633440,5-6662832-C-T,rs523854,1,C,T,6662832,29392,6436832,6830048,226000
5,ENSG00000152409.7,79236131,5-79144349-T-C,rs55754450,1,T,C,79144349,91782,79039523,79432739,104826
5,ENSG00000079215.8,36606606,5-36691075-T-C,rs56407459,1,T,C,36691075,84469,36409998,36803214,281077
5,ENSG00000164253.8,77492316,5-77579866-G-T,rs57840239,-1,G,T,77579866,87550,77295708,77688924,284158
5,ENSG00000145777.10,111071713,5-111052064-T-G,rs58743367,1,T,G,111052064,19649,110875105,111268321,176959
5,ENSG00000145777.10,111071713,5-111052064-T-A,rs58743367,1,T,A,111052064,19649,110875105,111268321,176959
5,ENSG00000170606.8,133052013,5-133073275-G-A,rs61755724,1,G,A,133073275,21262,132855405,133248621,217870
5,ENSG00000145736.9,71067601,5-71012435-C-T,rs61757629,-1,C,T,71012435,55166,70870993,71264209,141442
5,ENSG00000113580.9,143403686,5-143400774-C-A,rs6189,-1,C,A,143400774,2912,143207078,143600294,193696
5,ENSG00000113580.9,143403686,5-143400774-C-T,rs6189,-1,C,T,143400774,2912,143207078,143600294,193696
5,ENSG00000062194.10,57174059,5-57061264-C-T,rs62356644,1,C,T,57061264,112795,56977451,57370667,83813
5,ENSG00000164904.9,126595219,5-126665279-G-T,rs62392513,-1,G,T,126665279,70060,126398611,126791827,266668
5,ENSG00000171530.8,77776339,5-77672009-C-G,rs6453341,-1,C,G,77672009,104330,77579731,77972947,92278
5,ENSG00000171530.8,77776339,5-77672009-C-T,rs6453341,-1,C,T,77672009,104330,77579731,77972947,92278
5,ENSG00000145779.6,119356019,5-119278669-C-A,rs67375044,1,C,A,119278669,77350,119159411,119552627,119258
5,ENSG00000145779.6,119356019,5-119278669-C-T,rs67375044,1,C,T,119278669,77350,119159411,119552627,119258
5,ENSG00000161055.3,180591499,5-180556602-T-C,rs6859296,-1,T,C,180556602,34897,180394891,180788107,161711
5,ENSG00000161055.3,180591499,5-180556602-T-A,rs6859296,-1,T,A,180556602,34897,180394891,180788107,161711
5,ENSG00000186687.11,131170944,5-131082494-A-G,rs6860180,1,A,G,131082494,88450,130974336,131367552,108158
5,ENSG00000164338.5,73565743,5-73618203-G-A,rs6861106,1,G,A,73618203,52460,73369135,73762351,249068
5,ENSG00000164338.5,73565743,5-73618203-G-T,rs6861106,1,G,T,73618203,52460,73369135,73762351,249068
5,ENSG00000164338.5,73565743,5-73618203-G-C,rs6861106,1,G,C,73618203,52460,73369135,73762351,249068
5,ENSG00000155329.7,133026549,5-132998891-T-C,rs6865816,-1,T,C,132998891,27658,132829941,133223157,168950
5,ENSG00000011083.4,150190062,5-150364663-A-G,rs6867136,1,A,G,150364663,174601,149993454,150386670,371209
5,ENSG00000171522.5,40679915,5-40597516-G-A,rs6869535,1,G,A,40597516,82399,40483307,40876523,114209
5,ENSG00000132357.8,40841367,5-40846564-G-A,rs6873525,1,G,A,40846564,5197,40644759,41037975,201805
5,ENSG00000164509.9,55851357,5-55733768-G-A,rs6873811,1,G,A,55733768,117589,55654749,56047965,79019
5,ENSG00000164509.9,55851357,5-55733768-G-T,rs6873811,1,G,T,55733768,117589,55654749,56047965,79019
5,ENSG00000169567.7,131165256,5-131127442-A-C,rs6874948,-1,A,C,131127442,37814,130968648,131361864,158794
5,ENSG00000132570.10,134905131,5-134820449-G-A,rs6883535,1,G,A,134820449,84682,134708523,135101739,111926
5,ENSG00000169230.5,177303799,5-177313995-C-G,rs6885410,1,C,G,177313995,10196,177107191,177500407,206804
5,ENSG00000169230.5,177303799,5-177313995-C-A,rs6885410,1,C,A,177313995,10196,177107191,177500407,206804
5,ENSG00000176783.9,179550554,5-179625184-C-T,rs6886107,1,C,T,179625184,74630,179353946,179747162,271238
5,ENSG00000176783.9,179550554,5-179625184-C-G,rs6886107,1,C,G,179625184,74630,179353946,179747162,271238
5,ENSG00000037474.10,6633044,5-6616898-C-A,rs6887702,-1,C,A,6616898,16146,6436436,6829652,180462
5,ENSG00000113657.8,147510068,5-147485132-G-A,rs6889353,-1,G,A,147485132,24936,147313460,147706676,171672
5,ENSG00000113657.8,147510068,5-147485132-G-T,rs6889353,-1,G,T,147485132,24936,147313460,147706676,171672
5,ENSG00000155858.5,157743712,5-157742988-A-G,rs6889628,1,A,G,157742988,724,157547104,157940320,195884
5,ENSG00000155858.5,157743712,5-157742988-A-T,rs6889628,1,A,T,157742988,724,157547104,157940320,195884
5,ENSG00000135074.11,157575775,5-157539556-C-T,rs6895161,-1,C,T,157539556,36219,157379167,157772383,160389
5,ENSG00000135074.11,157575775,5-157539556-C-G,rs6895161,-1,C,G,157539556,36219,157379167,157772383,160389
5,ENSG00000113734.13,173144531,5-172983655-G-T,rs6895696,1,G,T,172983655,160876,172947923,173341139,35732
5,ENSG00000113734.13,173144531,5-172983655-G-A,rs6895696,1,G,A,172983655,160876,172947923,173341139,35732
5,ENSG00000133398.3,6378547,5-6379101-G-C,rs72651087,-1,G,C,6379101,554,6181939,6575155,197162
5,ENSG00000131503.15,140401833,5-140332965-A-C,rs7268,1,A,C,140332965,68868,140205225,140598441,127740
5,ENSG00000131503.15,140401833,5-140332965-A-T,rs7268,1,A,T,140332965,68868,140205225,140598441,127740
5,ENSG00000083720.7,41870425,5-42036404-G-T,rs72748647,-1,G,T,42036404,165979,41673817,42067033,362587
5,ENSG00000083720.7,41870425,5-42036404-G-A,rs72748647,-1,G,A,42036404,165979,41673817,42067033,362587
5,ENSG00000086570.8,151591331,5-151559740-C-T,rs72798369,-1,C,T,151559740,31591,151394723,151787939,165017
5,ENSG00000158497.2,143812161,5-143692407-C-G,rs72808740,1,C,G,143692407,119754,143615553,144008769,76854
5,ENSG00000158497.2,143812161,5-143692407-C-A,rs72808740,1,C,A,143692407,119754,143615553,144008769,76854
5,ENSG00000158497.2,143812161,5-143692407-C-T,rs72808740,1,C,T,143692407,119754,143615553,144008769,76854
5,ENSG00000028310.12,892801,5-1065284-C-G,rs737154,-1,C,G,1065284,172483,696193,1089409,369091
5,ENSG00000028310.12,892801,5-1065284-C-T,rs737154,-1,C,T,1065284,172483,696193,1089409,369091
5,ENSG00000178338.6,178859953,5-178859355-C-T,rs7445694,1,C,T,178859355,598,178663345,179056561,196010
5,ENSG00000151422.8,108747897,5-108617520-A-G,rs7449365,1,A,G,108617520,130377,108551289,108944505,66231
5,ENSG00000151422.8,108747897,5-108617520-A-T,rs7449365,1,A,T,108617520,130377,108551289,108944505,66231
5,ENSG00000197208.5,132294394,5-132179971-C-A,rs754129,1,C,A,132179971,114423,132097786,132491002,82185
5,ENSG00000164300.10,80256048,5-80165604-T-C,rs75946551,-1,T,C,80165604,90444,80059440,80452656,106164
5,ENSG00000213523.4,140557473,5-140474338-C-T,rs76376634,-1,C,T,140474338,83135,140360865,140754081,113473
5,ENSG00000173221.9,95822726,5-95812425-T-G,rs7700814,-1,T,G,95812425,10301,95626118,96019334,186307
5,ENSG00000113758.9,177473634,5-177422097-T-C,rs7711038,-1,T,C,177422097,51537,177277026,177670242,145071
5,ENSG00000113758.9,177473634,5-177422097-T-A,rs7711038,-1,T,A,177422097,51537,177277026,177670242,145071
5,ENSG00000134987.7,111092348,5-111250740-C-T,rs7726469,1,C,T,111250740,158392,110895740,111288956,355000
5,ENSG00000234284.2,179023804,5-179146953-T-C,rs7727517,1,T,C,179146953,123149,178827196,179220412,319757
5,ENSG00000131844.11,71587340,5-71414620-G-A,rs7727576,1,G,A,71414620,172720,71390732,71783948,23888
5,ENSG00000131844.11,71587340,5-71414620-G-C,rs7727576,1,G,C,71414620,172720,71390732,71783948,23888
5,ENSG00000131844.11,71587340,5-71414620-G-T,rs7727576,1,G,T,71414620,172720,71390732,71783948,23888
5,ENSG00000145919.6,173616650,5-173479880-C-G,rs7733015,-1,C,G,173479880,136770,173420042,173813258,59838
5,ENSG00000145919.6,173616650,5-173479880-C-T,rs7733015,-1,C,T,173479880,136770,173420042,173813258,59838
5,ENSG00000164220.5,76623403,5-76572052-T-C,rs77373975,-1,T,C,76572052,51351,76426795,76820011,145257
5,ENSG00000197043.7,151157779,5-151168933-C-T,rs77399794,-1,C,T,151168933,11154,150961171,151354387,207762
5,ENSG00000197043.7,151157779,5-151168933-C-A,rs77399794,-1,C,A,151168933,11154,150961171,151354387,207762
5,ENSG00000172239.9,43557077,5-43727344-G-T,rs77576492,-1,G,T,43727344,170267,43360469,43753685,366875
5,ENSG00000134061.4,67196799,5-67204294-C-T,rs77760534,-1,C,T,67204294,7495,67000191,67393407,204103
5,ENSG00000164221.8,115296654,5-115251452-G-A,rs78151087,-1,G,A,115251452,45202,115100046,115493262,151406
5,ENSG00000145864.8,161546725,5-161431824-G-A,rs79091883,-1,G,A,161431824,114901,161350117,161743333,81707
5,ENSG00000132837.9,79069674,5-79139394-A-G,rs80196226,-1,A,G,79139394,69720,78873066,79266282,266328
5,ENSG00000049860.9,74685233,5-74682876-G-A,rs820866,1,G,A,74682876,2357,74488625,74881841,194251
5,ENSG00000078795.12,137889457,5-137844235-C-G,rs847821,1,C,G,137844235,45222,137692849,138086065,151386
5,ENSG00000078795.12,137889457,5-137844235-C-T,rs847821,1,C,T,137844235,45222,137692849,138086065,151386
5,ENSG00000177733.4,137754363,5-137844235-C-G,rs847821,-1,C,G,137844235,89872,137557755,137950971,286480
5,ENSG00000177733.4,137754363,5-137844235-C-T,rs847821,-1,C,T,137844235,89872,137557755,137950971,286480
5,ENSG00000145817.10,144170659,5-144208427-G-A,rs879717,-1,G,A,144208427,37768,143974051,144367267,234376
5,ENSG00000068796.11,62306206,5-62137498-G-T,rs9291749,1,G,T,62137498,168708,62109598,62502814,27900
5,ENSG00000151881.10,43483865,5-43296784-T-G,rs9292870,-1,T,G,43296784,187081,43287257,43680473,9527
5,ENSG00000151881.10,43483865,5-43296784-T-C,rs9292870,-1,T,C,43296784,187081,43287257,43680473,9527
5,ENSG00000150756.8,10249888,5-10062138-G-A,rs9312714,-1,G,A,10062138,187750,10053280,10446496,8858
5,ENSG00000164902.8,126600947,5-126752557-G-T,rs9327420,1,G,T,126752557,151610,126404339,126797555,348218
5,ENSG00000175309.10,178232802,5-178339242-A-T,rs9329143,-1,A,T,178339242,106440,178036194,178429410,303048
5,ENSG00000155542.6,56909596,5-56900777-G-A,rs96844,1,G,A,56900777,8819,56712988,57106204,187789
5,ENSG00000164236.6,10564070,5-10585175-G-T,rs9790911,1,G,T,10585175,21105,10367462,10760678,217713
5,ENSG00000164236.6,10564070,5-10585175-G-A,rs9790911,1,G,A,10585175,21105,10367462,10760678,217713
5,ENSG00000164244.14,127517640,5-127486255-A-T,rs984024,1,A,T,127486255,31385,127321032,127714248,165223
5,ENSG00000164244.14,127517640,5-127486255-A-C,rs984024,1,A,C,127486255,31385,127321032,127714248,165223
5,ENSG00000164244.14,127517640,5-127486255-A-G,rs984024,1,A,G,127486255,31385,127321032,127714248,165223
5,ENSG00000074276.6,176549342,5-176721767-C-T,rs10035561,1,C,T,176721767,172425,176352734,176745950,369033
5,ENSG00000255833.1,135452351,5-135456379-C-T,rs10039805,-1,C,T,135456379,4028,135255743,135648959,200636
5,ENSG00000145888.6,151924851,5-151976684-G-A,rs10042480,-1,G,A,151976684,51833,151728243,152121459,248441
5,ENSG00000171368.10,693352,5-592973-T-A,rs10052123,-1,T,A,592973,100379,496744,889960,96229
5,ENSG00000168944.10,123423403,5-123570118-A-G,rs10052983,-1,A,G,123570118,146715,123226795,123620011,343323
5,ENSG00000168944.10,123423403,5-123570118-A-T,rs10052983,-1,A,T,123570118,146715,123226795,123620011,343323
5,ENSG00000168944.10,123423403,5-123570118-A-C,rs10052983,-1,A,C,123570118,146715,123226795,123620011,343323
5,ENSG00000176018.8,90529584,5-90707099-C-T,rs10054261,-1,C,T,90707099,177515,90332976,90726192,374123
5,ENSG00000153395.5,1523960,5-1490894-A-G,rs10058172,-1,A,G,1490894,33066,1327352,1720568,163542
5,ENSG00000145592.9,40835222,5-40830051-T-G,rs10062565,-1,T,G,40830051,5171,40638614,41031830,191437
5,ENSG00000145592.9,40835222,5-40830051-T-C,rs10062565,-1,T,C,40830051,5171,40638614,41031830,191437
5,ENSG00000132357.8,40841367,5-40675432-G-T,rs10066459,1,G,T,40675432,165935,40644759,41037975,30673
5,ENSG00000113719.11,172834251,5-172829068-G-A,rs1006721,1,G,A,172829068,5183,172637643,173030859,191425
5,ENSG00000161010.10,179858817,5-179837731-T-C,rs10277,-1,T,C,179837731,21086,179662209,180055425,175522
5,ENSG00000161010.10,179858817,5-179837731-T-A,rs10277,-1,T,A,179837731,21086,179662209,180055425,175522
5,ENSG00000113645.8,168291645,5-168367771-T-A,rs1030182,1,T,A,168367771,76126,168095037,168488253,272734
5,ENSG00000113645.8,168291645,5-168367771-T-C,rs1030182,1,T,C,168367771,76126,168095037,168488253,272734
5,ENSG00000155324.4,126423409,5-126370184-G-T,rs10478726,1,G,T,126370184,53225,126226801,126620017,143383
5,ENSG00000155324.4,126423409,5-126370184-G-C,rs10478726,1,G,C,126370184,53225,126226801,126620017,143383
5,ENSG00000177453.3,43192225,5-43212488-C-T,rs10512821,1,C,T,43212488,20263,42995617,43388833,216871
5,ENSG00000177453.3,43192225,5-43212488-C-A,rs10512821,1,C,A,43212488,20263,42995617,43388833,216871
5,ENSG00000164615.3,134738548,5-134931867-G-C,rs10515465,1,G,C,134931867,193319,134541940,134935156,389927
5,ENSG00000113648.12,135399231,5-135491119-C-T,rs1076379,-1,C,T,135491119,91888,135202623,135595839,288496
5,ENSG00000213949.3,52787916,5-52936607-A-G,rs10940279,1,A,G,52936607,148691,52591308,52984524,345299
5,ENSG00000213949.3,52787916,5-52936607-A-C,rs10940279,1,A,C,52936607,148691,52591308,52984524,345299
5,ENSG00000164347.11,74767117,5-74888319-T-G,rs10942722,-1,T,G,74888319,121202,74570509,74963725,317810
5,ENSG00000251201.4,115626161,5-115702399-A-G,rs112010721,-1,A,G,115702399,76238,115429553,115822769,272846
5,ENSG00000015479.12,139293740,5-139426616-T-C,rs11242465,1,T,C,139426616,132876,139097132,139490348,329484
5,ENSG00000015479.12,139293740,5-139426616-T-G,rs11242465,1,T,G,139426616,132876,139097132,139490348,329484
5,ENSG00000120129.4,172771195,5-172644188-C-G,rs114505105,-1,C,G,172644188,127007,172574587,172967803,69601
5,ENSG00000120129.4,172771195,5-172644188-C-T,rs114505105,-1,C,T,172644188,127007,172574587,172967803,69601
5,ENSG00000171604.7,139648349,5-139632529-C-T,rs114613137,1,C,T,139632529,15820,139451741,139844957,180788
5,ENSG00000039600.6,157652438,5-157518911-C-T,rs11466763,-1,C,T,157518911,133527,157455830,157849046,63081
5,ENSG00000039600.6,157652438,5-157518911-C-A,rs11466763,-1,C,A,157518911,133527,157455830,157849046,63081
5,ENSG00000197860.5,65722109,5-65770656-C-T,rs114969787,-1,C,T,65770656,48547,65525501,65918717,245155
5,ENSG00000197860.5,65722109,5-65770656-C-A,rs114969787,-1,C,A,65770656,48547,65525501,65918717,245155
5,ENSG00000204764.6,170862018,5-171034433-A-G,rs114994102,1,A,G,171034433,172415,170665410,171058626,369023
5,ENSG00000171530.8,77776339,5-77902095-C-T,rs115348253,-1,C,T,77902095,125756,77579731,77972947,322364
5,ENSG00000244234.1,178187371,5-178050630-C-T,rs115471217,-1,C,T,178050630,136741,177990763,178383979,59867
5,ENSG00000145685.8,78648772,5-78646884-T-C,rs115534748,-1,T,C,78646884,1888,78452164,78845380,194720
5,ENSG00000158402.13,138331804,5-138288898-T-C,rs11567999,-1,T,C,138288898,42906,138135196,138528412,153702
5,ENSG00000112972.9,43313412,5-43480662-G-A,rs115729490,-1,G,A,43480662,167250,43116804,43510020,363858
5,ENSG00000196670.8,180861276,5-181036658-C-T,rs116131856,-1,C,T,181036658,175382,180664668,181057884,371990
5,ENSG00000169862.13,11904446,5-12010962-A-C,rs116532968,-1,A,C,12010962,106516,11707838,12101054,303124
5,ENSG00000127022.9,179698967,5-179668592-T-C,rs11744173,1,T,C,179668592,30375,179502359,179895575,166233
5,ENSG00000253537.1,141382742,5-141550595-C-T,rs11748064,1,C,T,141550595,167853,141186134,141579350,364461
5,ENSG00000164576.6,154445997,5-154597869-G-T,rs11749576,1,G,T,154597869,151872,154249389,154642605,348480
5,ENSG00000164576.6,154445997,5-154597869-G-A,rs11749576,1,G,A,154597869,151872,154249389,154642605,348480
5,ENSG00000164576.6,154445997,5-154597869-G-C,rs11749576,1,G,C,154597869,151872,154249389,154642605,348480
5,ENSG00000145740.13,69094014,5-69140676-G-T,rs11952883,1,G,T,69140676,46662,68897406,69290622,243270
5,ENSG00000168685.10,35856891,5-35920584-C-T,rs11955690,1,C,T,35920584,63693,35660283,36053499,260301
5,ENSG00000188573.6,168529305,5-168434841-G-A,rs12516671,1,G,A,168434841,94464,168332697,168725913,102144
5,ENSG00000081059.14,134114681,5-134016531-G-C,rs12521633,1,G,C,134016531,98150,133918073,134311289,98458
5,ENSG00000081059.14,134114681,5-134016531-G-A,rs12521633,1,G,A,134016531,98150,133918073,134311289,98458
5,ENSG00000177879.10,115841935,5-115947758-C-A,rs12655363,1,C,A,115947758,105823,115645327,116038543,302431
5,ENSG00000177879.10,115841935,5-115947758-C-T,rs12655363,1,C,T,115947758,105823,115645327,116038543,302431
5,ENSG00000035499.8,60700166,5-60678271-G-T,rs12655515,-1,G,T,60678271,21895,60503558,60896774,174713
5,ENSG00000035499.8,60700166,5-60678271-G-A,rs12655515,-1,G,A,60678271,21895,60503558,60896774,174713
5,ENSG00000035499.8,60700166,5-60678271-G-C,rs12655515,-1,G,C,60678271,21895,60503558,60896774,174713
5,ENSG00000253731.1,141373891,5-141509809-A-T,rs13163163,1,A,T,141509809,135918,141177283,141570499,332526
5,ENSG00000253731.1,141373891,5-141509809-A-G,rs13163163,1,A,G,141509809,135918,141177283,141570499,332526
5,ENSG00000145725.11,103120301,5-103043263-T-G,rs13187628,1,T,G,103043263,77038,102923693,103316909,119570
5,ENSG00000172548.10,157460213,5-157509541-G-A,rs1422794,1,G,A,157509541,49328,157263605,157656821,245936
5,ENSG00000172548.10,157460213,5-157509541-G-T,rs1422794,1,G,T,157509541,49328,157263605,157656821,245936
5,ENSG00000172548.10,157460213,5-157509541-G-C,rs1422794,1,G,C,157509541,49328,157263605,157656821,245936
5,ENSG00000134058.6,69234886,5-69049821-G-A,rs149292,1,G,A,69049821,185065,69038278,69431494,11543
5,ENSG00000131435.8,132257696,5-132225629-G-C,rs157578,1,G,C,132225629,32067,132061088,132454304,164541
5,ENSG00000131435.8,132257696,5-132225629-G-T,rs157578,1,G,T,132225629,32067,132061088,132454304,164541
5,ENSG00000131435.8,132257696,5-132225629-G-A,rs157578,1,G,A,132225629,32067,132061088,132454304,164541
5,ENSG00000124275.10,7869148,5-7887365-C-A,rs162040,1,C,A,7887365,18217,7672540,8065756,214825
5,ENSG00000124275.10,7869148,5-7887365-C-T,rs162040,1,C,T,7887365,18217,7672540,8065756,214825
5,ENSG00000124275.10,7869148,5-7887365-C-G,rs162040,1,C,G,7887365,18217,7672540,8065756,214825
5,ENSG00000131730.11,81233322,5-81145769-C-T,rs166061,1,C,T,81145769,87553,81036714,81429930,109055
5,ENSG00000152932.6,58583075,5-58609647-G-C,rs167132,1,G,C,58609647,26572,58386467,58779683,223180
5,ENSG00000152932.6,58583075,5-58609647-G-T,rs167132,1,G,T,58609647,26572,58386467,58779683,223180
5,ENSG00000158497.2,143812161,5-143738253-G-A,rs167801,1,G,A,143738253,73908,143615553,144008769,122700
5,ENSG00000158497.2,143812161,5-143738253-G-C,rs167801,1,G,C,143738253,73908,143615553,144008769,122700
5,ENSG00000164258.7,53560639,5-53426968-A-T,rs16881394,1,A,T,53426968,133671,53364031,53757247,62937
5,ENSG00000112902.7,9546075,5-9401289-T-G,rs16882648,-1,T,G,9401289,144786,9349467,9742683,51822
5,ENSG00000112902.7,9546075,5-9401289-T-A,rs16882648,-1,T,A,9401289,144786,9349467,9742683,51822
5,ENSG00000151388.6,33891990,5-33890905-G-A,rs16891883,-1,G,A,33890905,1085,33695382,34088598,195523
5,ENSG00000049192.9,65481920,5-65574860-A-C,rs16894005,-1,A,C,65574860,92940,65285312,65678528,289548
5,ENSG00000069020.12,66596393,5-66613760-G-C,rs16895311,1,G,C,66613760,17367,66399785,66793001,213975
5,ENSG00000069020.12,66596393,5-66613760-G-T,rs16895311,1,G,T,66613760,17367,66399785,66793001,213975
5,ENSG00000174695.5,83077394,5-83077176-G-C,rs16900155,-1,G,C,83077176,218,82880786,83274002,196390
5,ENSG00000135074.11,157575775,5-157500867-C-T,rs17054657,-1,C,T,157500867,74908,157379167,157772383,121700
5,ENSG00000262576.1,141355021,5-141390940-A-G,rs17097254,1,A,G,141390940,35919,141158413,141551629,232527
5,ENSG00000064692.12,122312237,5-122167247-C-T,rs17148904,1,C,T,122167247,144990,122115629,122508845,51618
5,ENSG00000237190.3,134411881,5-134302343-C-A,rs17165388,-1,C,A,134302343,109538,134215273,134608489,87070
5,ENSG00000170606.8,133052013,5-132868305-A-G,rs17166297,1,A,G,132868305,183708,132855405,133248621,12900
5,ENSG00000170606.8,133052013,5-132868305-A-C,rs17166297,1,A,C,132868305,183708,132855405,133248621,12900
5,ENSG00000145569.4,14581792,5-14772136-T-C,rs17251715,1,T,C,14772136,190344,14385184,14778400,386952
5,ENSG00000242419.1,141485030,5-141647245-A-C,rs17286989,1,A,C,141647245,162215,141288422,141681638,358823
5,ENSG00000164574.11,154190733,5-154146491-G-A,rs17536714,1,G,A,154146491,44242,153994125,154387341,152366
5,ENSG00000134987.7,111092348,5-111127221-A-T,rs17625012,1,A,T,111127221,34873,110895740,111288956,231481
5,ENSG00000134987.7,111092348,5-111127221-A-C,rs17625012,1,A,C,111127221,34873,110895740,111288956,231481
5,ENSG00000145703.10,76403285,5-76390160-T-A,rs17651979,1,T,A,76390160,13125,76206677,76599893,183483
5,ENSG00000145703.10,76403285,5-76390160-T-C,rs17651979,1,T,C,76390160,13125,76206677,76599893,183483
5,ENSG00000123643.6,151447603,5-151451791-A-G,rs17740674,1,A,G,151451791,4188,151250995,151644211,200796
5,ENSG00000131507.7,142108779,5-142233903-A-T,rs1860991,1,A,T,142233903,125124,141912171,142305387,321732
5,ENSG00000131507.7,142108779,5-142233903-A-G,rs1860991,1,A,G,142233903,125124,141912171,142305387,321732
5,ENSG00000164211.8,111512535,5-111646889-T-A,rs2043835,-1,T,A,111646889,134354,111315927,111709143,330962
5,ENSG00000164211.8,111512535,5-111646889-T-C,rs2043835,-1,T,C,111646889,134354,111315927,111709143,330962
5,ENSG00000069011.10,135034228,5-135219930-A-G,rs2059779,-1,A,G,135219930,185702,134837620,135230836,382310
5,ENSG00000069011.10,135034228,5-135219930-A-C,rs2059779,-1,A,C,135219930,185702,134837620,135230836,382310
5,ENSG00000062194.10,57174059,5-57280035-T-G,rs2112254,1,T,G,57280035,105976,56977451,57370667,302584
5,ENSG00000062194.10,57174059,5-57280035-T-A,rs2112254,1,T,A,57280035,105976,56977451,57370667,302584
5,ENSG00000062194.10,57174059,5-57280035-T-C,rs2112254,1,T,C,57280035,105976,56977451,57370667,302584
5,ENSG00000172795.11,112976798,5-113022796-G-A,rs2112452,1,G,A,113022796,45998,112780190,113173406,242606
5,ENSG00000172795.11,112976798,5-113022796-G-C,rs2112452,1,G,C,113022796,45998,112780190,113173406,242606
5,ENSG00000120137.6,168579368,5-168581738-C-T,rs2112562,-1,C,T,168581738,2370,168382760,168775976,198978
5,ENSG00000113716.8,150000739,5-150051660-G-A,rs216131,1,G,A,150051660,50921,149804131,150197347,247529
5,ENSG00000113716.8,150000739,5-150051660-G-C,rs216131,1,G,C,150051660,50921,149804131,150197347,247529
5,ENSG00000145757.11,95682991,5-95619898-C-T,rs2194051,-1,C,T,95619898,63093,95486383,95879599,133515
5,ENSG00000145757.11,95682991,5-95619898-C-A,rs2194051,-1,C,A,95619898,63093,95486383,95879599,133515
5,ENSG00000155850.7,149960758,5-150066556-A-C,rs2237087,1,A,C,150066556,105798,149764150,150157366,302406
5,ENSG00000113296.10,80035348,5-80085973-T-A,rs2247450,1,T,A,80085973,50625,79838740,80231956,247233
5,ENSG00000113296.10,80035348,5-80085973-T-G,rs2247450,1,T,G,80085973,50625,79838740,80231956,247233
5,ENSG00000113296.10,80035348,5-80085973-T-C,rs2247450,1,T,C,80085973,50625,79838740,80231956,247233
5,ENSG00000186468.8,82278354,5-82357662-C-T,rs224912,-1,C,T,82357662,79308,82081746,82474962,275916
5,ENSG00000234511.3,170232985,5-170236423-C-G,rs2287738,1,C,G,170236423,3438,170036377,170429593,200046
5,ENSG00000234511.3,170232985,5-170236423-C-T,rs2287738,1,C,T,170236423,3438,170036377,170429593,200046
5,ENSG00000112893.5,109689927,5-109800567-G-A,rs2301012,1,G,A,109800567,110640,109493319,109886535,307248
5,ENSG00000112893.5,109689927,5-109800567-G-T,rs2301012,1,G,T,109800567,110640,109493319,109886535,307248
5,ENSG00000133835.9,119452497,5-119424720-T-G,rs2451818,1,T,G,119424720,27777,119255889,119649105,168831
5,ENSG00000133835.9,119452497,5-119424720-T-A,rs2451818,1,T,A,119424720,27777,119255889,119649105,168831
5,ENSG00000161013.12,179806866,5-179948727-T-C,rs248330,-1,T,C,179948727,141861,179610258,180003474,338469
5,ENSG00000161013.12,179806866,5-179948727-T-A,rs248330,-1,T,A,179948727,141861,179610258,180003474,338469
5,ENSG00000173221.9,95822726,5-95849563-A-C,rs248343,-1,A,C,95849563,26837,95626118,96019334,223445
5,ENSG00000164620.4,141636997,5-141698833-G-C,rs248592,1,G,C,141698833,61836,141440389,141833605,258444
5,ENSG00000164620.4,141636997,5-141698833-G-A,rs248592,1,G,A,141698833,61836,141440389,141833605,258444
5,ENSG00000164620.4,141636997,5-141698833-G-T,rs248592,1,G,T,141698833,61836,141440389,141833605,258444
5,ENSG00000113318.8,80654652,5-80830334-A-G,rs249633,1,A,G,80830334,175682,80458044,80851260,372290
5,ENSG00000113318.8,80654652,5-80830334-A-C,rs249633,1,A,C,80830334,175682,80458044,80851260,372290
5,ENSG00000242110.3,34008050,5-33990518-C-T,rs250414,-1,C,T,33990518,17532,33811442,34204658,179076
5,ENSG00000113734.13,173144531,5-173099567-G-A,rs251230,1,G,A,173099567,44964,172947923,173341139,151644
5,ENSG00000153015.9,64768930,5-64676347-T-A,rs2548251,1,T,A,64676347,92583,64572322,64965538,104025
5,ENSG00000153015.9,64768930,5-64676347-T-G,rs2548251,1,T,G,64676347,92583,64572322,64965538,104025
5,ENSG00000153015.9,64768930,5-64676347-T-C,rs2548251,1,T,C,64676347,92583,64572322,64965538,104025
5,ENSG00000183474.10,69560191,5-69429303-T-C,rs2561159,1,T,C,69429303,130888,69363583,69756799,65720
5,ENSG00000157107.8,72956041,5-72921504-G-A,rs2602632,1,G,A,72921504,34537,72759433,73152649,162071
5,ENSG00000157107.8,72956041,5-72921504-G-T,rs2602632,1,G,T,72921504,34537,72759433,73152649,162071
5,ENSG00000120306.5,140175188,5-140011167-A-G,rs265159,1,A,G,140011167,164021,139978580,140371796,32587
5,ENSG00000120306.5,140175188,5-140011167-A-T,rs265159,1,A,T,140011167,164021,139978580,140371796,32587
5,ENSG00000172901.13,115962475,5-115842698-C-T,rs26538,1,C,T,115842698,119777,115765867,116159083,76831
5,ENSG00000185129.4,140114109,5-140135809-A-G,rs269783,1,A,G,140135809,21700,139917501,140310717,218308
5,ENSG00000072682.12,132227853,5-132313493-A-G,rs270607,-1,A,G,132313493,85640,132031245,132424461,282248
5,ENSG00000072682.12,132227853,5-132313493-A-T,rs270607,-1,A,T,132313493,85640,132031245,132424461,282248
5,ENSG00000072682.12,132227853,5-132313493-A-C,rs270607,-1,A,C,132313493,85640,132031245,132424461,282248
5,ENSG00000204956.4,141330514,5-141182193-C-A,rs2740584,1,C,A,141182193,148321,141133906,141527122,48287
5,ENSG00000204956.4,141330514,5-141182193-C-G,rs2740584,1,C,G,141182193,148321,141133906,141527122,48287
5,ENSG00000204956.4,141330514,5-141182193-C-T,rs2740584,1,C,T,141182193,148321,141133906,141527122,48287
5,ENSG00000083720.7,41870425,5-41902609-G-C,rs277411,-1,G,C,41902609,32184,41673817,42067033,228792
5,ENSG00000083720.7,41870425,5-41902609-G-A,rs277411,-1,G,A,41902609,32184,41673817,42067033,228792
5,ENSG00000164307.7,96807945,5-96757286-A-C,rs28081,-1,A,C,96757286,50659,96611337,97004553,145949
5,ENSG00000164307.7,96807945,5-96757286-A-G,rs28081,-1,A,G,96757286,50659,96611337,97004553,145949
5,ENSG00000131844.11,71587340,5-71677464-G-C,rs281131,1,G,C,71677464,90124,71390732,71783948,286732
5,ENSG00000197822.6,69492790,5-69489471-G-T,rs28616120,1,G,T,69489471,3319,69296182,69689398,193289
5,ENSG00000197822.6,69492790,5-69489471-G-A,rs28616120,1,G,A,69489471,3319,69296182,69689398,193289
5,ENSG00000197822.6,69492790,5-69489471-G-C,rs28616120,1,G,C,69489471,3319,69296182,69689398,193289
5,ENSG00000178015.4,95620087,5-95549679-T-A,rs2881773,1,T,A,95549679,70408,95423479,95816695,126200
5,ENSG00000178015.4,95620087,5-95549679-T-C,rs2881773,1,T,C,95549679,70408,95423479,95816695,126200
5,ENSG00000178015.4,95620087,5-95549679-T-G,rs2881773,1,T,G,95549679,70408,95423479,95816695,126200
5,ENSG00000164308.12,96876500,5-96867651-T-G,rs2911134,1,T,G,96867651,8849,96679892,97073108,187759
5,ENSG00000170231.11,160229506,5-160391118-C-T,rs2961932,1,C,T,160391118,161612,160032898,160426114,358220
5,ENSG00000112977.11,10761234,5-10732758-G-C,rs2964792,-1,G,C,10732758,28476,10564626,10957842,168132
5,ENSG00000112977.11,10761234,5-10732758-G-A,rs2964792,-1,G,A,10732758,28476,10564626,10957842,168132
5,ENSG00000113407.9,33440965,5-33261145-A-C,rs2967087,1,A,C,33261145,179820,33244357,33637573,16788
5,ENSG00000113407.9,33440965,5-33261145-A-T,rs2967087,1,A,T,33261145,179820,33244357,33637573,16788
5,ENSG00000164171.5,52989352,5-53072126-G-C,rs3212581,1,G,C,53072126,82774,52792744,53185960,279382
5,ENSG00000164171.5,52989352,5-53072126-G-T,rs3212581,1,G,T,53072126,82774,52792744,53185960,279382
5,ENSG00000134986.9,111757194,5-111758766-C-A,rs32333,-1,C,A,111758766,1572,111560586,111953802,198180
5,ENSG00000134986.9,111757194,5-111758766-C-G,rs32333,-1,C,G,111758766,1572,111560586,111953802,198180
5,ENSG00000153922.5,98929007,5-98944573-A-G,rs327805,-1,A,G,98944573,15566,98732399,99125615,212174
5,ENSG00000153922.5,98929007,5-98944573-A-T,rs327805,-1,A,T,98944573,15566,98732399,99125615,212174
5,ENSG00000142319.14,1445440,5-1279324-G-A,rs33963617,-1,G,A,1279324,166116,1248832,1642048,30492
5,ENSG00000112992.10,43603180,5-43612944-A-T,rs35201656,1,A,T,43612944,9764,43406572,43799788,206372
5,ENSG00000112992.10,43603180,5-43612944-A-G,rs35201656,1,A,G,43612944,9764,43406572,43799788,206372
5,ENSG00000145623.8,38846012,5-38868370-C-T,rs357281,1,C,T,38868370,22358,38649404,39042620,218966
5,ENSG00000164172.13,53109757,5-52950301-C-G,rs36000043,-1,C,G,52950301,159456,52913149,53306365,37152
5,ENSG00000164172.13,53109757,5-52950301-C-T,rs36000043,-1,C,T,52950301,159456,52913149,53306365,37152
5,ENSG00000079215.8,36606606,5-36681419-T-C,rs3733812,1,T,C,36681419,74813,36409998,36803214,271421
5,ENSG00000079215.8,36606606,5-36681419-T-A,rs3733812,1,T,A,36681419,74813,36409998,36803214,271421
5,ENSG00000197208.5,132294394,5-132292872-A-G,rs3761660,1,A,G,132292872,1522,132097786,132491002,195086
5,ENSG00000146083.7,176537402,5-176576453-C-A,rs3762966,-1,C,A,176576453,39051,176340794,176734010,235659
5,ENSG00000146083.7,176537402,5-176576453-C-T,rs3762966,-1,C,T,176576453,39051,176340794,176734010,235659
5,ENSG00000146083.7,176537402,5-176576453-C-G,rs3762966,-1,C,G,176576453,39051,176340794,176734010,235659
5,ENSG00000118985.10,95961851,5-95933064-G-A,rs3777179,-1,G,A,95933064,28787,95765243,96158459,167821
5,ENSG00000070614.9,150508131,5-150526958-G-A,rs3797620,1,G,A,150526958,18827,150311523,150704739,215435
5,ENSG00000145604.10,36152111,5-36158292-A-G,rs3804440,1,A,G,36158292,6181,35955503,36348719,202789
5,ENSG00000174136.7,98773663,5-98741946-C-G,rs3849790,1,C,G,98741946,31717,98577055,98970271,164891
5,ENSG00000160867.9,177086915,5-177090169-G-C,rs387598,1,G,C,177090169,3254,176890307,177283523,199862
5,ENSG00000160867.9,177086915,5-177090169-G-A,rs387598,1,G,A,177090169,3254,176890307,177283523,199862
5,ENSG00000154124.4,14664718,5-14561987-C-T,rs3913477,1,C,T,14561987,102731,14468110,14861326,93877
5,ENSG00000153140.4,90409756,5-90356539-A-G,rs3952709,-1,A,G,90356539,53217,90213148,90606364,143391
5,ENSG00000113013.7,138575401,5-138575524-G-C,rs41294550,-1,G,C,138575524,123,138378793,138772009,196731
5,ENSG00000113494.12,35230487,5-35369351-C-T,rs413206,-1,C,T,35369351,138864,35033879,35427095,335472
5,ENSG00000197043.7,151157779,5-151169369-T-C,rs420460,-1,T,C,151169369,11590,150961171,151354387,208198
5,ENSG00000197043.7,151157779,5-151169369-T-A,rs420460,-1,T,A,151169369,11590,150961171,151354387,208198
5,ENSG00000145715.9,87267883,5-87168687-C-G,rs4272164,1,C,G,87168687,99196,87071275,87464491,97412
5,ENSG00000145715.9,87267883,5-87168687-C-T,rs4272164,1,C,T,87168687,99196,87071275,87464491,97412
5,ENSG00000145715.9,87267883,5-87168687-C-A,rs4272164,1,C,A,87168687,99196,87071275,87464491,97412
5,ENSG00000113328.13,163437595,5-163414332-T-C,rs4307107,1,T,C,163414332,23263,163240987,163634203,173345
5,ENSG00000170234.7,160119450,5-160048469-A-T,rs4385243,-1,A,T,160048469,70981,159922842,160316058,125627
5,ENSG00000170234.7,160119450,5-160048469-A-G,rs4385243,-1,A,G,160048469,70981,159922842,160316058,125627
5,ENSG00000152620.8,36241925,5-36420813-T-A,rs4460161,-1,T,A,36420813,178888,36045317,36438533,375496
5,ENSG00000064652.6,122845613,5-123022018-G-C,rs448442,1,G,C,123022018,176405,122649005,123042221,373013
5,ENSG00000064652.6,122845613,5-123022018-G-T,rs448442,1,G,T,123022018,176405,122649005,123042221,373013
5,ENSG00000064652.6,122845613,5-123022018-G-A,rs448442,1,G,A,123022018,176405,122649005,123042221,373013
5,ENSG00000181163.9,171387849,5-171407080-G-A,rs4513711,1,G,A,171407080,19231,171191241,171584457,215839
5,ENSG00000181163.9,171387849,5-171407080-G-C,rs4513711,1,G,C,171407080,19231,171191241,171584457,215839
5,ENSG00000165671.12,177133773,5-177084431-G-T,rs451643,1,G,T,177084431,49342,176937165,177330381,147266
5,ENSG00000080709.9,114362070,5-114255620-C-T,rs4610451,1,C,T,114255620,106450,114165462,114558678,90158
5,ENSG00000080709.9,114362070,5-114255620-C-A,rs4610451,1,C,A,114255620,106450,114165462,114558678,90158
5,ENSG00000080709.9,114362070,5-114255620-C-G,rs4610451,1,C,G,114255620,106450,114165462,114558678,90158
5,ENSG00000155542.6,56909596,5-56738380-A-C,rs4700485,1,A,C,56738380,171216,56712988,57106204,25392
5,ENSG00000155542.6,56909596,5-56738380-A-T,rs4700485,1,A,T,56738380,171216,56712988,57106204,25392
5,ENSG00000155542.6,56909596,5-56738380-A-G,rs4700485,1,A,G,56738380,171216,56712988,57106204,25392
5,ENSG00000176783.9,179550554,5-179607259-G-A,rs4701140,1,G,A,179607259,56705,179353946,179747162,253313
5,ENSG00000176783.9,179550554,5-179607259-G-T,rs4701140,1,G,T,179607259,56705,179353946,179747162,253313
5,ENSG00000176783.9,179550554,5-179607259-G-C,rs4701140,1,G,C,179607259,56705,179353946,179747162,253313
5,ENSG00000164253.8,77492316,5-77433889-G-A,rs4704421,-1,G,A,77433889,58427,77295708,77688924,138181
5,ENSG00000164253.8,77492316,5-77433889-G-C,rs4704421,-1,G,C,77433889,58427,77295708,77688924,138181
5,ENSG00000164253.8,77492316,5-77433889-G-T,rs4704421,-1,G,T,77433889,58427,77295708,77688924,138181
5,ENSG00000172568.4,157345677,5-157239340-G-A,rs4704857,-1,G,A,157239340,106337,157149069,157542285,90271
5,ENSG00000169252.4,148826611,5-148832428-C-A,rs4705271,1,C,A,148832428,5817,148630003,149023219,202425
5,ENSG00000145882.6,149358046,5-149368339-G-C,rs4705336,1,G,C,149368339,10293,149161438,149554654,206901
5,ENSG00000145882.6,149358046,5-149368339-G-A,rs4705336,1,G,A,149368339,10293,149161438,149554654,206901
5,ENSG00000155846.12,149730310,5-149801803-C-A,rs4705382,1,C,A,149801803,71493,149533702,149926918,268101
5,ENSG00000155846.12,149730310,5-149801803-C-T,rs4705382,1,C,T,149801803,71493,149533702,149926918,268101
5,ENSG00000082074.10,39219563,5-39342206-C-T,rs476569,-1,C,T,39342206,122643,39022955,39416171,319251
5,ENSG00000064651.9,128083766,5-128001394-A-G,rs4835937,1,A,G,128001394,82372,127887158,128280374,114236
5,ENSG00000064651.9,128083766,5-128001394-A-T,rs4835937,1,A,T,128001394,82372,127887158,128280374,114236
5,ENSG00000064651.9,128083766,5-128001394-A-C,rs4835937,1,A,C,128001394,82372,127887158,128280374,114236
5,ENSG00000168621.10,37840041,5-37853246-T-G,rs4869553,-1,T,G,37853246,13205,37643433,38036649,209813
5,ENSG00000164187.5,36151887,5-36345489-T-G,rs4869650,-1,T,G,36345489,193602,35955279,36348495,390210
5,ENSG00000164187.5,36151887,5-36345489-T-C,rs4869650,-1,T,C,36345489,193602,35955279,36348495,390210
5,ENSG00000082213.12,31532301,5-31452892-C-T,rs491989,1,C,T,31452892,79409,31335693,31728909,117199
5,ENSG00000092421.12,116574823,5-116770530-A-G,rs4920935,-1,A,G,116770530,195707,116378215,116771431,392315
5,ENSG00000087206.11,177006779,5-176925735-C-T,rs4976665,-1,C,T,176925735,81044,176810171,177203387,115564
5,ENSG00000027847.8,177600132,5-177615619-T-C,rs4976704,1,T,C,177615619,15487,177403524,177796740,212095
5,ENSG00000028310.12,892801,5-1083419-T-C,rs4999131,-1,T,C,1083419,190618,696193,1089409,387226
5,ENSG00000113240.7,178627050,5-178595625-A-C,rs530542,-1,A,C,178595625,31425,178430442,178823658,165183
5,ENSG00000113240.7,178627050,5-178595625-A-G,rs530542,-1,A,G,178595625,31425,178430442,178823658,165183
5,ENSG00000171540.6,77638713,5-77515433-G-A,rs55921077,-1,G,A,77515433,123280,77442105,77835321,73328
5,ENSG00000145916.14,178131014,5-177964718-C-T,rs56283118,1,C,T,177964718,166296,177934406,178327622,30312
5,ENSG00000072571.13,163460632,5-163651693-T-G,rs566509,1,T,G,163651693,191061,163264024,163657240,387669
5,ENSG00000037474.10,6633044,5-6585121-T-G,rs575421,-1,T,G,6585121,47923,6436436,6829652,148685
5,ENSG00000037474.10,6633044,5-6585121-T-A,rs575421,-1,T,A,6585121,47923,6436436,6829652,148685
5,ENSG00000037474.10,6633044,5-6585121-T-C,rs575421,-1,T,C,6585121,47923,6436436,6829652,148685
5,ENSG00000113504.13,1112063,5-1097937-C-G,rs59081716,-1,C,G,1097937,14126,915455,1308671,182482
5,ENSG00000113504.13,1112063,5-1097937-C-T,rs59081716,-1,C,T,1097937,14126,915455,1308671,182482
5,ENSG00000113504.13,1112063,5-1097937-C-A,rs59081716,-1,C,A,1097937,14126,915455,1308671,182482
5,ENSG00000228716.2,80654983,5-80787046-A-G,rs6151838,-1,A,G,80787046,132063,80458375,80851591,328671
5,ENSG00000146063.13,181223281,5-181195354-G-A,rs61751566,1,G,A,181195354,27927,181026673,181419889,168681
5,ENSG00000146063.13,181223281,5-181195354-G-T,rs61751566,1,G,T,181195354,27927,181026673,181419889,168681
5,ENSG00000168246.5,172283764,5-172159238-A-T,rs6555999,-1,A,T,172159238,124526,172087156,172480372,72082
5,ENSG00000168246.5,172283764,5-172159238-A-G,rs6555999,-1,A,G,172159238,124526,172087156,172480372,72082
5,ENSG00000164332.6,159263290,5-159391737-A-G,rs6556416,1,A,G,159391737,128447,159066682,159459898,325055
5,ENSG00000164332.6,159263290,5-159391737-A-C,rs6556416,1,A,C,159391737,128447,159066682,159459898,325055
5,ENSG00000164332.6,159263290,5-159391737-A-T,rs6556416,1,A,T,159391737,128447,159066682,159459898,325055
5,ENSG00000168938.5,123036725,5-122871063-G-A,rs6595415,-1,G,A,122871063,165662,122840117,123233333,30946
5,ENSG00000168938.5,123036725,5-122871063-G-T,rs6595415,-1,G,T,122871063,165662,122840117,123233333,30946
5,ENSG00000146066.2,176388751,5-176403406-C-G,rs68144726,1,C,G,176403406,14655,176192143,176585359,211263
5,ENSG00000186314.7,145835342,5-145832582-C-T,rs681591,-1,C,T,145832582,2760,145638734,146031950,193848
5,ENSG00000186314.7,145835342,5-145832582-C-G,rs681591,-1,C,G,145832582,2760,145638734,146031950,193848
5,ENSG00000153113.17,96662376,5-96646810-A-G,rs6862521,1,A,G,96646810,15566,96465768,96858984,181042
5,ENSG00000153113.17,96662376,5-96646810-A-T,rs6862521,1,A,T,96646810,15566,96465768,96858984,181042
5,ENSG00000113460.8,34915711,5-34751918-A-C,rs6866210,1,A,C,34751918,163793,34719103,35112319,32815
5,ENSG00000113460.8,34915711,5-34751918-A-G,rs6866210,1,A,G,34751918,163793,34719103,35112319,32815
5,ENSG00000113638.8,40755961,5-40815905-A-T,rs6868112,-1,A,T,40815905,59944,40559353,40952569,256552
5,ENSG00000113638.8,40755961,5-40815905-A-C,rs6868112,-1,A,C,40815905,59944,40559353,40952569,256552
5,ENSG00000168724.10,34929559,5-34945707-A-C,rs6868348,1,A,C,34945707,16148,34732951,35126167,212756
5,ENSG00000168724.10,34929559,5-34945707-A-G,rs6868348,1,A,G,34945707,16148,34732951,35126167,212756
5,ENSG00000168724.10,34929559,5-34945707-A-T,rs6868348,1,A,T,34945707,16148,34732951,35126167,212756
5,ENSG00000066230.6,524449,5-495262-C-T,rs6868535,-1,C,T,495262,29187,327841,721057,167421
5,ENSG00000240764.2,141489081,5-141500723-G-A,rs6875791,1,G,A,141500723,11642,141292473,141685689,208250
5,ENSG00000164904.9,126595219,5-126615089-G-A,rs6886516,-1,G,A,126615089,19870,126398611,126791827,216478
5,ENSG00000177721.3,43040319,5-42897746-T-A,rs6886626,-1,T,A,42897746,142573,42843711,43236927,54035
5,ENSG00000131711.10,72107475,5-72085087-T-C,rs6897294,1,T,C,72085087,22388,71910867,72304083,174220
5,ENSG00000151883.10,50666637,5-50603263-C-T,rs6897477,1,C,T,50603263,63374,50470029,50863245,133234
5,ENSG00000151883.10,50666637,5-50603263-C-A,rs6897477,1,C,A,50603263,63374,50470029,50863245,133234
5,ENSG00000171421.7,1799837,5-1884524-C-A,rs72706718,-1,C,A,1884524,84687,1603229,1996445,281295
5,ENSG00000171421.7,1799837,5-1884524-C-T,rs72706718,-1,C,T,1884524,84687,1603229,1996445,281295
5,ENSG00000185305.5,54310573,5-54135327-T-C,rs72752124,-1,T,C,54135327,175246,54113965,54507181,21362
5,ENSG00000198624.7,151224092,5-151239432-C-T,rs72794132,-1,C,T,151239432,15340,151027484,151420700,211948
5,ENSG00000019582.10,150412910,5-150274112-C-T,rs73268749,-1,C,T,150274112,138798,150216302,150609518,57810
5,ENSG00000156427.7,171419647,5-171461107-T-A,rs74588350,1,T,A,171461107,41460,171223039,171616255,238068
5,ENSG00000156427.7,171419647,5-171461107-T-C,rs74588350,1,T,C,171461107,41460,171223039,171616255,238068
5,ENSG00000113597.12,65625027,5-65672525-G-T,rs754784,1,G,T,65672525,47498,65428419,65821635,244106
5,ENSG00000113597.12,65625027,5-65672525-G-A,rs754784,1,G,A,65672525,47498,65428419,65821635,244106
5,ENSG00000112874.5,103562789,5-103433566-A-C,rs75506008,-1,A,C,103433566,129223,103366181,103759397,67385
5,ENSG00000081791.4,141923871,5-141917613-C-G,rs758462,1,C,G,141917613,6258,141727263,142120479,190350
5,ENSG00000081791.4,141923871,5-141917613-C-A,rs758462,1,C,A,141917613,6258,141727263,142120479,190350
5,ENSG00000037280.10,180649600,5-180824882-G-A,rs75858778,-1,G,A,180824882,175282,180452992,180846208,371890
5,ENSG00000113231.9,77210680,5-77345592-A-G,rs75973464,1,A,G,77345592,134912,77014072,77407288,331520
5,ENSG00000164338.5,73565743,5-73727242-A-C,rs7703182,1,A,C,73727242,161499,73369135,73762351,358107
5,ENSG00000164338.5,73565743,5-73727242-A-G,rs7703182,1,A,G,73727242,161499,73369135,73762351,358107
5,ENSG00000123219.7,65563168,5-65457494-C-G,rs7708044,-1,C,G,65457494,105674,65366560,65759776,90934
5,ENSG00000123219.7,65563168,5-65457494-C-A,rs7708044,-1,C,A,65457494,105674,65366560,65759776,90934
5,ENSG00000123219.7,65563168,5-65457494-C-T,rs7708044,-1,C,T,65457494,105674,65366560,65759776,90934
5,ENSG00000113441.11,96936080,5-96919313-T-C,rs7714122,1,T,C,96919313,16767,96739472,97132688,179841
5,ENSG00000113580.9,143403686,5-143218355-G-T,rs7720812,-1,G,T,143218355,185331,143207078,143600294,11277
5,ENSG00000113580.9,143403686,5-143218355-G-A,rs7720812,-1,G,A,143218355,185331,143207078,143600294,11277
5,ENSG00000146005.3,139795808,5-139801476-G-A,rs7721837,1,G,A,139801476,5668,139599200,139992416,202276
5,ENSG00000132842.8,78294698,5-78250972-A-G,rs7726585,-1,A,G,78250972,43726,78098090,78491306,152882
5,ENSG00000132842.8,78294698,5-78250972-A-C,rs7726585,-1,A,C,78250972,43726,78098090,78491306,152882
5,ENSG00000145781.4,116085025,5-116083489-C-G,rs7730551,1,C,G,116083489,1536,115888417,116281633,195072
5,ENSG00000145781.4,116085025,5-116083489-C-A,rs7730551,1,C,A,116083489,1536,115888417,116281633,195072
5,ENSG00000178996.8,54517759,5-54415292-G-A,rs7731258,1,G,A,54415292,102467,54321151,54714367,94141
5,ENSG00000178996.8,54517759,5-54415292-G-T,rs7731258,1,G,T,54415292,102467,54321151,54714367,94141
5,ENSG00000180104.9,443176,5-385899-A-C,rs7731963,1,A,C,385899,57277,246568,639784,139331
5,ENSG00000164346.5,74767249,5-74696204-A-C,rs77412261,1,A,C,74696204,71045,74570641,74963857,125563
5,ENSG00000243056.1,140547662,5-140625627-T-C,rs778584,1,T,C,140625627,77965,140351054,140744270,274573
5,ENSG00000188725.3,61162468,5-61053176-A-G,rs78709717,-1,A,G,61053176,109292,60965860,61359076,87316
5,ENSG00000112964.8,42423439,5-42295155-G-A,rs78903561,1,G,A,42295155,128284,42226831,42620047,68324
5,ENSG00000153404.9,92168,5-185303-C-T,rs79713827,1,C,T,185303,93135,-104440,288776,289743
5,ENSG00000153044.5,69189583,5-69035250-A-G,rs79881090,1,A,G,69035250,154333,68992975,69386191,42275
5,ENSG00000038382.12,14143342,5-14307031-T-C,rs809565,1,T,C,14307031,163689,13946734,14339950,360297
5,ENSG00000112941.8,6713432,5-6844968-T-C,rs870346,1,T,C,6844968,131536,6516824,6910040,328144
5,ENSG00000234284.2,179023804,5-179175682-G-A,rs873987,1,G,A,179175682,151878,178827196,179220412,348486
5,ENSG00000155858.5,157743712,5-157612729-C-T,rs889056,1,C,T,157612729,130983,157547104,157940320,65625
5,ENSG00000205302.2,122775080,5-122753195-A-G,rs922140,1,A,G,122753195,21885,122578472,122971688,174723
5,ENSG00000205302.2,122775080,5-122753195-A-T,rs922140,1,A,T,122753195,21885,122578472,122971688,174723
5,ENSG00000113649.7,146447333,5-146460954-G-T,rs9791020,1,G,T,146460954,13621,146250725,146643941,210229
5,ENSG00000113649.7,146447333,5-146460954-G-A,rs9791020,1,G,A,146460954,13621,146250725,146643941,210229
4,ENSG00000109667.7,10021497,4-9982851-C-T,rs10003001,-1,C,T,9982851,38646,9824889,10218105,157962
4,ENSG00000145335.11,89837161,4-89822180-C-G,rs10005233,-1,C,G,89822180,14981,89640553,90033769,181627
4,ENSG00000145335.11,89837161,4-89822180-C-T,rs10005233,-1,C,T,89822180,14981,89640553,90033769,181627
4,ENSG00000163132.6,4859665,4-4932131-T-C,rs10007275,1,T,C,4932131,72466,4663057,5056273,269074
4,ENSG00000138796.10,107989889,4-107987355-C-A,rs10008581,1,C,A,107987355,2534,107793281,108186497,194074
4,ENSG00000138796.10,107989889,4-107987355-C-G,rs10008581,1,C,G,107987355,2534,107793281,108186497,194074
4,ENSG00000138796.10,107989889,4-107987355-C-T,rs10008581,1,C,T,107987355,2534,107793281,108186497,194074
4,ENSG00000151552.7,17512090,4-17525059-A-C,rs10020773,-1,A,C,17525059,12969,17315482,17708698,209577
4,ENSG00000151552.7,17512090,4-17525059-A-G,rs10020773,-1,A,G,17525059,12969,17315482,17708698,209577
4,ENSG00000256043.2,155953866,4-155951741-A-G,rs10024900,-1,A,G,155951741,2125,155757258,156150474,194483
4,ENSG00000256043.2,155953866,4-155951741-A-T,rs10024900,-1,A,T,155951741,2125,155757258,156150474,194483
4,ENSG00000189308.6,83010823,4-83152147-C-T,rs10033406,-1,C,T,83152147,141324,82814215,83207431,337932
4,ENSG00000154553.8,185535507,4-185586033-G-A,rs1046236,-1,G,A,185586033,50526,185338899,185732115,247134
4,ENSG00000154553.8,185535507,4-185586033-G-T,rs1046236,-1,G,T,185586033,50526,185338899,185732115,247134
4,ENSG00000163956.6,3532422,4-3512812-G-A,rs1049574,-1,G,A,3512812,19610,3335814,3729030,176998
4,ENSG00000004468.6,15778328,4-15848487-G-A,rs10516293,1,G,A,15848487,70159,15581720,15974936,266767
4,ENSG00000145337.4,88523776,4-88666226-A-T,rs10516816,-1,A,T,88666226,142450,88327168,88720384,339058
4,ENSG00000138640.10,89057185,4-88876487-G-A,rs10516823,-1,G,A,88876487,180698,88860577,89253793,15910
4,ENSG00000138640.10,89057185,4-88876487-G-T,rs10516823,-1,G,T,88876487,180698,88860577,89253793,15910
4,ENSG00000121897.9,39459056,4-39452170-A-C,rs10517522,1,A,C,39452170,6886,39262448,39655664,189722
4,ENSG00000121897.9,39459056,4-39452170-A-G,rs10517522,1,A,G,39452170,6886,39262448,39655664,189722
4,ENSG00000138764.9,77157207,4-77209068-A-C,rs10518167,1,A,C,77209068,51861,76960599,77353815,248469
4,ENSG00000138764.9,77157207,4-77209068-A-G,rs10518167,1,A,G,77209068,51861,76960599,77353815,248469
4,ENSG00000151718.11,183099257,4-183288044-A-T,rs10520554,1,A,T,183288044,188787,182902649,183295865,385395
4,ENSG00000151718.11,183099257,4-183288044-A-G,rs10520554,1,A,G,183288044,188787,182902649,183295865,385395
4,ENSG00000145241.6,67545503,4-67514352-C-T,rs1056787,-1,C,T,67514352,31151,67348895,67742111,165457
4,ENSG00000168936.6,1721323,4-1728261-G-A,rs1063743,-1,G,A,1728261,6938,1524715,1917931,203546
4,ENSG00000168936.6,1721323,4-1728261-G-T,rs1063743,-1,G,T,1728261,6938,1524715,1917931,203546
4,ENSG00000163633.6,86892422,4-86908098-A-G,rs1075989,-1,A,G,86908098,15676,86695814,87089030,212284
4,ENSG00000151466.7,129093539,4-129246487-A-T,rs11099004,-1,A,T,129246487,152948,128896931,129290147,349556
4,ENSG00000151466.7,129093539,4-129246487-A-G,rs11099004,-1,A,G,129246487,152948,128896931,129290147,349556
4,ENSG00000151466.7,129093539,4-129246487-A-C,rs11099004,-1,A,C,129246487,152948,128896931,129290147,349556
4,ENSG00000052795.8,158769026,4-158764591-C-T,rs11100197,1,C,T,158764591,4435,158572418,158965634,192173
4,ENSG00000109265.7,56049098,4-55997866-A-T,rs11133419,1,A,T,55997866,51232,55852490,56245706,145376
4,ENSG00000109265.7,56049098,4-55997866-A-G,rs11133419,1,A,G,55997866,51232,55852490,56245706,145376
4,ENSG00000163945.10,1347208,4-1347765-A-G,rs111391498,1,A,G,1347765,557,1150600,1543816,197165
4,ENSG00000169026.8,689151,4-620883-C-T,rs11248029,-1,C,T,620883,68268,492543,885759,128340
4,ENSG00000169026.8,689151,4-620883-C-G,rs11248029,-1,C,G,620883,68268,492543,885759,128340
4,ENSG00000128039.6,55346242,4-55391465-G-C,rs113058073,1,G,C,55391465,45223,55149634,55542850,241831
4,ENSG00000128039.6,55346242,4-55391465-G-A,rs113058073,1,G,A,55391465,45223,55149634,55542850,241831
4,ENSG00000124882.3,74365145,4-74526492-C-T,rs114429915,1,C,T,74526492,161347,74168537,74561753,357955
4,ENSG00000132464.7,70628744,4-70686582-C-T,rs114555989,1,C,T,70686582,57838,70432136,70825352,254446
4,ENSG00000047365.6,36244514,4-36100907-A-G,rs114690689,-1,A,G,36100907,143607,36047906,36441122,53001
4,ENSG00000182903.11,499156,4-443432-G-A,rs114734668,-1,G,A,443432,55724,302548,695764,140884
4,ENSG00000056050.6,169757944,4-169757842-T-C,rs11540095,-1,T,C,169757842,102,169561336,169954552,196506
4,ENSG00000056050.6,169757944,4-169757842-T-A,rs11540095,-1,T,A,169757842,102,169561336,169954552,196506
4,ENSG00000169288.12,77862830,4-77693272-T-C,rs115487233,1,T,C,77693272,169558,77666222,78059438,27050
4,ENSG00000170088.7,165112860,4-165049952-G-C,rs116576664,-1,G,C,165049952,62908,164916252,165309468,133700
4,ENSG00000170088.7,165112860,4-165049952-G-A,rs116576664,-1,G,A,165049952,62908,164916252,165309468,133700
4,ENSG00000151790.4,155903696,4-155946088-G-A,rs117170243,1,G,A,155946088,42392,155707088,156100304,239000
4,ENSG00000138798.7,109912883,4-109772413-G-A,rs11721403,1,G,A,109772413,140470,109716275,110109491,56138
4,ENSG00000151611.8,145619385,4-145651075-G-A,rs11721553,1,G,A,145651075,31690,145422777,145815993,228298
4,ENSG00000174125.3,38804791,4-38809148-C-T,rs11722813,-1,C,T,38809148,4357,38608183,39001399,200965
4,ENSG00000197712.6,38867806,4-38809148-C-T,rs11722813,1,C,T,38809148,58658,38671198,39064414,137950
4,ENSG00000127415.8,987044,4-971991-G-T,rs11724804,1,G,T,971991,15053,790436,1183652,181555
4,ENSG00000127415.8,987044,4-971991-G-C,rs11724804,1,G,C,971991,15053,790436,1183652,181555
4,ENSG00000127415.8,987044,4-971991-G-A,rs11724804,1,G,A,971991,15053,790436,1183652,181555
4,ENSG00000168491.5,185471733,4-185353016-T-C,rs11727346,-1,T,C,185353016,118717,185275125,185668341,77891
4,ENSG00000137462.6,153684280,4-153664770-G-A,rs11727442,1,G,A,153664770,19510,153487672,153880888,177098
4,ENSG00000170801.5,8269754,4-8229166-C-T,rs11728188,1,C,T,8229166,40588,8073146,8466362,156020
4,ENSG00000091490.6,25862988,4-25886457-C-G,rs11735368,-1,C,G,25886457,23469,25666380,26059596,220077
4,ENSG00000155275.14,8440777,4-8392736-C-T,rs11934642,1,C,T,8392736,48041,8244169,8637385,148567
4,ENSG00000155275.14,8440777,4-8392736-C-A,rs11934642,1,C,A,8392736,48041,8244169,8637385,148567
4,ENSG00000168772.9,104494894,4-104576306-C-T,rs11934708,-1,C,T,104576306,81412,104298286,104691502,278020
4,ENSG00000198189.6,87391188,4-87421217-A-T,rs11945232,-1,A,T,87421217,30029,87194580,87587796,226637
4,ENSG00000198189.6,87391188,4-87421217-A-G,rs11945232,-1,A,G,87421217,30029,87194580,87587796,226637
4,ENSG00000138639.13,85475150,4-85548407-T-G,rs11945598,1,T,G,85548407,73257,85278542,85671758,269865
4,ENSG00000197386.6,3074681,4-3033904-A-T,rs11947255,1,A,T,3033904,40777,2878073,3271289,155831
4,ENSG00000197057.4,36281616,4-36333701-A-G,rs12331547,1,A,G,36333701,52085,36085008,36478224,248693
4,ENSG00000197057.4,36281616,4-36333701-A-T,rs12331547,1,A,T,36333701,52085,36085008,36478224,248693
4,ENSG00000164162.8,145098196,4-145159187-T-C,rs12498677,-1,T,C,145159187,60991,144901588,145294804,257599
4,ENSG00000151806.9,44678420,4-44685384-A-G,rs12499960,1,A,G,44685384,6964,44481812,44875028,203572
4,ENSG00000151806.9,44678420,4-44685384-A-C,rs12499960,1,A,C,44685384,6964,44481812,44875028,203572
4,ENSG00000109452.7,142846301,4-142776994-T-G,rs12500163,-1,T,G,142776994,69307,142649693,143042909,127301
4,ENSG00000109452.7,142846301,4-142776994-T-A,rs12500163,-1,T,A,142776994,69307,142649693,143042909,127301
4,ENSG00000168421.7,40197031,4-40187705-T-C,rs12501987,1,T,C,40187705,9326,40000423,40393639,187282
4,ENSG00000124406.12,42657105,4-42654769-C-A,rs12502496,-1,C,A,42654769,2336,42460497,42853713,194272
4,ENSG00000138698.9,98261384,4-98235038-C-T,rs12503117,1,C,T,98235038,26346,98064776,98457992,170262
4,ENSG00000138698.9,98261384,4-98235038-C-A,rs12503117,1,C,A,98235038,26346,98064776,98457992,170262
4,ENSG00000109756.4,159103079,4-159047453-A-G,rs12505998,1,A,G,159047453,55626,158906471,159299687,140982
4,ENSG00000118564.10,15655357,4-15546792-C-T,rs12508186,-1,C,T,15546792,108565,15458749,15851965,88043
4,ENSG00000118564.10,15655357,4-15546792-C-A,rs12508186,-1,C,A,15546792,108565,15458749,15851965,88043
4,ENSG00000250317.3,25914220,4-25893636-C-T,rs12512962,1,C,T,25893636,20584,25717612,26110828,176024
4,ENSG00000250317.3,25914220,4-25893636-C-A,rs12512962,1,C,A,25893636,20584,25717612,26110828,176024
4,ENSG00000163694.10,40629864,4-40451335-G-T,rs12647748,-1,G,T,40451335,178529,40433256,40826472,18079
4,ENSG00000163694.10,40629864,4-40451335-G-C,rs12647748,-1,G,C,40451335,178529,40433256,40826472,18079
4,ENSG00000163694.10,40629864,4-40451335-G-A,rs12647748,-1,G,A,40451335,178529,40433256,40826472,18079
4,ENSG00000152784.9,80197503,4-80166861-A-G,rs12648190,1,A,G,80166861,30642,80000895,80394111,165966
4,ENSG00000138668.13,82373991,4-82379425-G-A,rs12711238,-1,G,A,82379425,5434,82177383,82570599,202042
4,ENSG00000138668.13,82373991,4-82379425-G-T,rs12711238,-1,G,T,82379425,5434,82177383,82570599,202042
4,ENSG00000125089.10,8199290,4-8228729-T-G,rs1281152,1,T,G,8228729,29439,8002682,8395898,226047
4,ENSG00000157426.8,56387491,4-56358353-A-T,rs13102012,-1,A,T,56358353,29138,56190883,56584099,167470
4,ENSG00000157426.8,56387491,4-56358353-A-G,rs13102012,-1,A,G,56358353,29138,56190883,56584099,167470
4,ENSG00000168826.11,4290251,4-4344646-C-T,rs13103109,1,C,T,4344646,54395,4093643,4486859,251003
4,ENSG00000002549.7,17577198,4-17565732-A-C,rs13103430,1,A,C,17565732,11466,17380590,17773806,185142
4,ENSG00000038002.4,177442437,4-177440968-C-T,rs13106192,-1,C,T,177440968,1469,177245829,177639045,195139
4,ENSG00000038002.4,177442437,4-177440968-C-G,rs13106192,-1,C,G,177440968,1469,177245829,177639045,195139
4,ENSG00000154277.8,41256928,4-41290944-A-G,rs13107512,1,A,G,41290944,34016,41060320,41453536,230624
4,ENSG00000151012.9,138242349,4-138171565-A-G,rs13120371,-1,A,G,138171565,70784,138045741,138438957,125824
4,ENSG00000145414.4,163166890,4-163082706-T-A,rs13132042,-1,T,A,163082706,84184,162970282,163363498,112424
4,ENSG00000145414.4,163166890,4-163082706-T-G,rs13132042,-1,T,G,163082706,84184,162970282,163363498,112424
4,ENSG00000145414.4,163166890,4-163082706-T-C,rs13132042,-1,T,C,163082706,84184,162970282,163363498,112424
4,ENSG00000072832.9,5893086,4-5728686-T-G,rs13132305,-1,T,G,5728686,164400,5696478,6089694,32208
4,ENSG00000072832.9,5893086,4-5728686-T-C,rs13132305,-1,T,C,5728686,164400,5696478,6089694,32208
4,ENSG00000072832.9,5893086,4-5728686-T-A,rs13132305,-1,T,A,5728686,164400,5696478,6089694,32208
4,ENSG00000145476.10,186191567,4-186199057-C-T,rs13146272,1,C,T,186199057,7490,185994959,186388175,204098
4,ENSG00000145476.10,186191567,4-186199057-C-A,rs13146272,1,C,A,186199057,7490,185994959,186388175,204098
4,ENSG00000129187.10,182917386,4-182902182-A-G,rs13147196,-1,A,G,182902182,15204,182720778,183113994,181404
4,ENSG00000145214.9,973569,4-967585-G-A,rs1377586,-1,G,A,967585,5984,776961,1170177,190624
4,ENSG00000145214.9,973569,4-967585-G-C,rs1377586,-1,G,C,967585,5984,776961,1170177,190624
4,ENSG00000145390.6,119212713,4-119206606-G-C,rs1397610,1,G,C,119206606,6107,119016105,119409321,190501
4,ENSG00000145390.6,119212713,4-119206606-G-T,rs1397610,1,G,T,119206606,6107,119016105,119409321,190501
4,ENSG00000138756.12,78776350,4-78601054-T-C,rs1466765,1,T,C,78601054,175296,78579742,78972958,21312
4,ENSG00000155016.12,107931549,4-107939750-G-A,rs1493131,1,G,A,107939750,8201,107734941,108128157,204809
4,ENSG00000169019.9,47463702,4-47340845-C-T,rs16860118,-1,C,T,47340845,122857,47267094,47660310,73751
4,ENSG00000151470.7,129096152,4-129110343-T-G,rs1699387,1,T,G,129110343,14191,128899544,129292760,210799
4,ENSG00000151470.7,129096152,4-129110343-T-A,rs1699387,1,T,A,129110343,14191,128899544,129292760,210799
4,ENSG00000151470.7,129096152,4-129110343-T-C,rs1699387,1,T,C,129110343,14191,128899544,129292760,210799
4,ENSG00000250254.1,37960398,4-37924357-T-A,rs16994074,1,T,A,37924357,36041,37763790,38157006,160567
4,ENSG00000250254.1,37960398,4-37924357-T-C,rs16994074,1,T,C,37924357,36041,37763790,38157006,160567
4,ENSG00000174796.8,75514473,4-75543844-T-C,rs17000627,1,T,C,75543844,29371,75317865,75711081,225979
4,ENSG00000255072.1,88523776,4-88546861-C-T,rs17014192,-1,C,T,88546861,23085,88327168,88720384,219693
4,ENSG00000164168.3,147617397,4-147634709-G-A,rs17023581,1,G,A,147634709,17312,147420789,147814005,213920
4,ENSG00000138823.7,99574824,4-99588164-T-G,rs17029173,1,T,G,99588164,13340,99378216,99771432,209948
4,ENSG00000138780.9,105708784,4-105703372-C-T,rs17036129,1,C,T,105703372,5412,105512176,105905392,191196
4,ENSG00000145439.7,169010255,4-168861193-T-C,rs17054543,-1,T,C,168861193,149062,168813647,169206863,47546
4,ENSG00000134852.10,55546909,4-55500787-T-A,rs17085850,-1,T,A,55500787,46122,55350301,55743517,150486
4,ENSG00000128040.6,56821701,4-56922067-C-T,rs17087265,-1,C,T,56922067,100366,56625093,57018309,296974
4,ENSG00000168924.9,1856156,4-1982757-T-C,rs17132112,-1,T,C,1982757,126601,1659548,2052764,323209
4,ENSG00000189157.8,76251721,4-76368647-G-A,rs17238882,1,G,A,76368647,116926,76055113,76448329,313534
4,ENSG00000189157.8,76251721,4-76368647-G-C,rs17238882,1,G,C,76368647,116926,76055113,76448329,313534
4,ENSG00000163319.6,83456058,4-83467762-C-T,rs17355027,1,C,T,83467762,11704,83259450,83652666,208312
4,ENSG00000050730.11,121164321,4-121200339-A-G,rs17435444,-1,A,G,121200339,36018,120967713,121360929,232626
4,ENSG00000163697.11,41214542,4-41205322-C-A,rs17443381,-1,C,A,41205322,9220,41017934,41411150,187388
4,ENSG00000163697.11,41214542,4-41205322-C-T,rs17443381,-1,C,T,41205322,9220,41017934,41411150,187388
4,ENSG00000174123.6,38782990,4-38865806-A-G,rs17582830,-1,A,G,38865806,82816,38586382,38979598,279424
4,ENSG00000188993.3,52020363,4-51854505-A-G,rs17657391,-1,A,G,51854505,165858,51823755,52216971,30750
4,ENSG00000150625.12,175812264,4-175893145-A-C,rs17667772,-1,A,C,175893145,80881,175615656,176008872,277489
4,ENSG00000118579.6,17614641,4-17655737-G-A,rs1860598,1,G,A,17655737,41096,17418033,17811249,237704
4,ENSG00000138777.15,105474062,4-105473223-C-A,rs2074396,-1,C,A,105473223,839,105277454,105670670,195769
4,ENSG00000164342.6,186069156,4-186220703-C-G,rs2102576,1,C,G,186220703,151547,185872548,186265764,348155
4,ENSG00000164342.6,186069156,4-186220703-C-T,rs2102576,1,C,T,186220703,151547,185872548,186265764,348155
4,ENSG00000073331.12,112297369,4-112212471-T-G,rs2102993,1,T,G,112212471,84898,112100761,112493977,111710
4,ENSG00000073331.12,112297369,4-112212471-T-A,rs2102993,1,T,A,112212471,84898,112100761,112493977,111710
4,ENSG00000073331.12,112297369,4-112212471-T-C,rs2102993,1,T,C,112212471,84898,112100761,112493977,111710
4,ENSG00000164163.6,145098311,4-145039315-C-A,rs2162090,1,C,A,145039315,58996,144901703,145294919,137612
4,ENSG00000164163.6,145098311,4-145039315-C-T,rs2162090,1,C,T,145039315,58996,144901703,145294919,137612
4,ENSG00000134851.7,55395957,4-55564241-A-C,rs2171618,1,A,C,55564241,168284,55199349,55592565,364892
4,ENSG00000134851.7,55395957,4-55564241-A-G,rs2171618,1,A,G,55564241,168284,55199349,55592565,364892
4,ENSG00000145354.5,102868992,4-102809336-T-C,rs223418,1,T,C,102809336,59656,102672384,103065600,136952
4,ENSG00000145354.5,102868992,4-102809336-T-G,rs223418,1,T,G,102809336,59656,102672384,103065600,136952
4,ENSG00000109323.4,102760968,4-102706811-T-C,rs223510,-1,T,C,102706811,54157,102564360,102957576,142451
4,ENSG00000109323.4,102760968,4-102706811-T-A,rs223510,-1,T,A,102706811,54157,102564360,102957576,142451
4,ENSG00000072840.8,5711201,4-5733793-T-G,rs2291154,1,T,G,5733793,22592,5514593,5907809,219200
4,ENSG00000109805.5,17810979,4-17817262-T-C,rs2302212,1,T,C,17817262,6283,17614371,18007587,202891
4,ENSG00000183423.6,109848107,4-109867583-G-T,rs2347130,1,G,T,109867583,19476,109651499,110044715,216084
4,ENSG00000183423.6,109848107,4-109867583-G-A,rs2347130,1,G,A,109867583,19476,109651499,110044715,216084
4,ENSG00000178343.4,42397488,4-42324212-T-A,rs2632690,1,T,A,42324212,73276,42200880,42594096,123332
4,ENSG00000178343.4,42397488,4-42324212-T-C,rs2632690,1,T,C,42324212,73276,42200880,42594096,123332
4,ENSG00000178343.4,42397488,4-42324212-T-G,rs2632690,1,T,G,42324212,73276,42200880,42594096,123332
4,ENSG00000137449.10,15002481,4-15080067-A-G,rs2702561,1,A,G,15080067,77586,14805873,15199089,274194
4,ENSG00000074966.6,48134250,4-48124069-T-A,rs2704439,-1,T,A,48124069,10181,47937642,48330858,186427
4,ENSG00000074966.6,48134250,4-48124069-T-G,rs2704439,-1,T,G,48124069,10181,47937642,48330858,186427
4,ENSG00000074966.6,48134250,4-48124069-T-C,rs2704439,-1,T,C,48124069,10181,47937642,48330858,186427
4,ENSG00000121895.7,39032409,4-39033166-G-C,rs2711976,-1,G,C,39033166,757,38835801,39229017,197365
4,ENSG00000121895.7,39032409,4-39033166-G-T,rs2711976,-1,G,T,39033166,757,38835801,39229017,197365
4,ENSG00000118785.8,87975714,4-87973963-A-T,rs2728127,1,A,T,87973963,1751,87779106,88172322,194857
4,ENSG00000118785.8,87975714,4-87973963-A-G,rs2728127,1,A,G,87973963,1751,87779106,88172322,194857
4,ENSG00000109163.6,67754388,4-67616683-T-C,rs28526365,-1,T,C,67616683,137705,67557780,67950996,58903
4,ENSG00000173085.9,83284798,4-83224058-C-G,rs28629807,-1,C,G,83224058,60740,83088190,83481406,135868
4,ENSG00000145287.6,83114729,4-83224058-C-G,rs28629807,-1,C,G,83224058,109329,82918121,83311337,305937
4,ENSG00000185477.3,89307800,4-89249086-G-A,rs28647517,-1,G,A,89249086,58714,89111192,89504408,137894
4,ENSG00000185477.3,89307800,4-89249086-G-T,rs28647517,-1,G,T,89249086,58714,89111192,89504408,137894
4,ENSG00000196526.6,7939861,4-7863597-T-G,rs28738908,-1,T,G,7863597,76264,7743253,8136469,120344
4,ENSG00000138685.7,122826831,4-122827461-C-G,rs2922979,1,C,G,122827461,630,122630223,123023439,197238
4,ENSG00000132406.7,4248223,4-4255528-C-T,rs2980092,-1,C,T,4255528,7305,4051615,4444831,203913
4,ENSG00000125388.14,2963571,4-2956459-A-C,rs3021146,1,A,C,2956459,7112,2766963,3160179,189496
4,ENSG00000125388.14,2963571,4-2956459-A-G,rs3021146,1,A,G,2956459,7112,2766963,3160179,189496
4,ENSG00000181004.5,122732704,4-122730874-C-A,rs309355,1,C,A,122730874,1830,122536096,122929312,194778
4,ENSG00000181004.5,122732704,4-122730874-C-T,rs309355,1,C,T,122730874,1830,122536096,122929312,194778
4,ENSG00000159788.13,3293021,4-3263983-C-G,rs3095077,1,C,G,3263983,29038,3096413,3489629,167570
4,ENSG00000159788.13,3293021,4-3263983-C-T,rs3095077,1,C,T,3263983,29038,3096413,3489629,167570
4,ENSG00000164323.8,185204000,4-185202643-C-A,rs3108297,-1,C,A,185202643,1357,185007392,185400608,195251
4,ENSG00000164323.8,185204000,4-185202643-C-G,rs3108297,-1,C,G,185202643,1357,185007392,185400608,195251
4,ENSG00000145365.8,112285904,4-112275750-T-C,rs3202899,-1,T,C,112275750,10154,112089296,112482512,186454
4,ENSG00000145365.8,112285904,4-112275750-T-A,rs3202899,-1,T,A,112275750,10154,112089296,112482512,186454
4,ENSG00000109674.3,177309874,4-177341630-A-T,rs34193982,1,A,T,177341630,31756,177113266,177506482,228364
4,ENSG00000109674.3,177309874,4-177341630-A-G,rs34193982,1,A,G,177341630,31756,177113266,177506482,228364
4,ENSG00000109674.3,177309874,4-177341630-A-C,rs34193982,1,A,C,177341630,31756,177113266,177506482,228364
4,ENSG00000164117.7,174283667,4-174387450-A-T,rs34989812,-1,A,T,174387450,103783,174087059,174480275,300391
4,ENSG00000109684.9,10684768,4-10689294-C-G,rs35755918,-1,C,G,10689294,4526,10488160,10881376,201134
4,ENSG00000109684.9,10684768,4-10689294-C-A,rs35755918,-1,C,A,10689294,4526,10488160,10881376,201134
4,ENSG00000153130.12,140373646,4-140383753-G-T,rs358316,1,G,T,140383753,10107,140177038,140570254,206715
4,ENSG00000059691.7,151761007,4-151688965-T-C,rs3749561,-1,T,C,151688965,72042,151564399,151957615,124566
4,ENSG00000109445.6,141220895,4-141230108-T-C,rs3756106,1,T,C,141230108,9213,141024287,141417503,205821
4,ENSG00000109445.6,141220895,4-141230108-T-G,rs3756106,1,T,G,141230108,9213,141024287,141417503,205821
4,ENSG00000071127.11,10116799,4-10076014-C-T,rs3775935,-1,C,T,10076014,40785,9920191,10313407,155823
4,ENSG00000071127.11,10116799,4-10076014-C-A,rs3775935,-1,C,A,10076014,40785,9920191,10313407,155823
4,ENSG00000198498.5,163494690,4-163506833-G-C,rs3816244,1,G,C,163506833,12143,163298082,163691298,208751
4,ENSG00000198498.5,163494690,4-163506833-G-A,rs3816244,1,G,A,163506833,12143,163298082,163691298,208751
4,ENSG00000109519.7,7068064,4-7068077-C-T,rs3822270,-1,C,T,7068077,13,6871456,7264672,196621
4,ENSG00000109519.7,7068064,4-7068077-C-G,rs3822270,-1,C,G,7068077,13,6871456,7264672,196621
4,ENSG00000109519.7,7068064,4-7068077-C-A,rs3822270,-1,C,A,7068077,13,6871456,7264672,196621
4,ENSG00000171476.16,56681296,4-56654209-C-T,rs3860708,-1,C,T,56654209,27087,56484688,56877904,169521
4,ENSG00000133256.8,625573,4-652620-G-T,rs3864130,1,G,T,652620,27047,428965,822181,223655
4,ENSG00000133256.8,625573,4-652620-G-A,rs3864130,1,G,A,652620,27047,428965,822181,223655
4,ENSG00000171234.9,69096474,4-69154736-A-G,rs3891754,1,A,G,69154736,58262,68899866,69293082,254870
4,ENSG00000171234.9,69096474,4-69154736-A-T,rs3891754,1,A,T,69154736,58262,68899866,69293082,254870
4,ENSG00000172007.5,139454121,4-139441777-G-A,rs4535284,1,G,A,139441777,12344,139257513,139650729,184264
4,ENSG00000127418.9,1011626,4-1010000-G-T,rs4569707,1,G,T,1010000,1626,815018,1208234,194982
4,ENSG00000127418.9,1011626,4-1010000-G-A,rs4569707,1,G,A,1010000,1626,815018,1208234,194982
4,ENSG00000127418.9,1011626,4-1010000-G-C,rs4569707,1,G,C,1010000,1626,815018,1208234,194982
4,ENSG00000151725.6,184734096,4-184703234-T-G,rs4610379,-1,T,G,184703234,30862,184537488,184930704,165746
4,ENSG00000151725.6,184734096,4-184703234-T-C,rs4610379,-1,T,C,184703234,30862,184537488,184930704,165746
4,ENSG00000151725.6,184734096,4-184703234-T-A,rs4610379,-1,T,A,184703234,30862,184537488,184930704,165746
4,ENSG00000164144.10,152779954,4-152779978-C-T,rs4619875,1,C,T,152779978,24,152583346,152976562,196632
4,ENSG00000164144.10,152779954,4-152779978-C-G,rs4619875,1,C,G,152779978,24,152583346,152976562,196632
4,ENSG00000163293.7,48016772,4-48042020-G-A,rs4695330,1,G,A,48042020,25248,47820164,48213380,221856
4,ENSG00000197410.6,154491799,4-154497495-G-A,rs4696594,-1,G,A,154497495,5696,154295191,154688407,202304
4,ENSG00000159733.9,2418645,4-2412941-A-G,rs4974710,-1,A,G,2412941,5704,2222037,2615253,190904
4,ENSG00000138772.8,78551770,4-78552886-C-A,rs4975144,1,C,A,78552886,1116,78355162,78748378,197724
4,ENSG00000163138.13,20700458,4-20683755-C-A,rs55863541,1,C,A,20683755,16703,20503850,20897066,179905
4,ENSG00000168824.10,4387102,4-4347178-C-A,rs56151717,1,C,A,4347178,39924,4190494,4583710,156684
4,ENSG00000174130.7,38856817,4-38804579-G-A,rs5743560,-1,G,A,38804579,52238,38660209,39053425,144370
4,ENSG00000174130.7,38856817,4-38804579-G-T,rs5743560,-1,G,T,38804579,52238,38660209,39053425,144370
4,ENSG00000173083.9,83334848,4-83355633-G-A,rs58257072,-1,G,A,83355633,20785,83138240,83531456,217393
4,ENSG00000197888.2,68576322,4-68500812-G-T,rs62299466,-1,G,T,68500812,75510,68379714,68772930,121098
4,ENSG00000197888.2,68576322,4-68500812-G-A,rs62299466,-1,G,A,68500812,75510,68379714,68772930,121098
4,ENSG00000196620.4,68670652,4-68500812-G-T,rs62299466,-1,G,T,68500812,169840,68474044,68867260,26768
4,ENSG00000196620.4,68670652,4-68500812-G-A,rs62299466,-1,G,A,68500812,169840,68474044,68867260,26768
4,ENSG00000181826.5,37686376,4-37658993-G-A,rs6531560,-1,G,A,37658993,27383,37489768,37882984,169225
4,ENSG00000181826.5,37686376,4-37658993-G-C,rs6531560,-1,G,C,37658993,27383,37489768,37882984,169225
4,ENSG00000145348.11,106316209,4-106281778-C-T,rs6533245,-1,C,T,106281778,34431,106119601,106512817,162177
4,ENSG00000138801.4,107720234,4-107742831-C-T,rs6533319,-1,C,T,107742831,22597,107523626,107916842,219205
4,ENSG00000138801.4,107720234,4-107742831-C-G,rs6533319,-1,C,G,107742831,22597,107523626,107916842,219205
4,ENSG00000138801.4,107720234,4-107742831-C-A,rs6533319,-1,C,A,107742831,22597,107523626,107916842,219205
4,ENSG00000164111.9,121696980,4-121688774-T-C,rs6534309,-1,T,C,121688774,8206,121500372,121893588,188402
4,ENSG00000145284.7,82798796,4-82891885-G-C,rs6535407,-1,G,C,82891885,93089,82602188,82995404,289697
4,ENSG00000145284.7,82798796,4-82891885-G-A,rs6535407,-1,G,A,82891885,93089,82602188,82995404,289697
4,ENSG00000163322.9,83485100,4-83443655-T-C,rs6535473,-1,T,C,83443655,41445,83288492,83681708,155163
4,ENSG00000169989.2,152779730,4-152803228-G-A,rs6535876,-1,G,A,152803228,23498,152583122,152976338,220106
4,ENSG00000135605.7,48269838,4-48449020-C-T,rs6810911,-1,C,T,48449020,179182,48073230,48466446,375790
4,ENSG00000164022.11,106316550,4-106316238-C-T,rs6814166,1,C,T,106316238,312,106119942,106513158,196296
4,ENSG00000164022.11,106316550,4-106316238-C-A,rs6814166,1,C,A,106316238,312,106119942,106513158,196296
4,ENSG00000123737.8,121801323,4-121742275-T-A,rs6815973,1,T,A,121742275,59048,121604715,121997931,137560
4,ENSG00000163257.6,17810757,4-17866435-T-C,rs6817306,-1,T,C,17866435,55678,17614149,18007365,252286
4,ENSG00000205129.4,185426254,4-185388603-C-T,rs6818425,1,C,T,185388603,37651,185229646,185622862,158957
4,ENSG00000205129.4,185426254,4-185388603-C-A,rs6818425,1,C,A,185388603,37651,185229646,185622862,158957
4,ENSG00000145362.11,113049653,4-113000992-A-G,rs6818733,1,A,G,113000992,48661,112853045,113246261,147947
4,ENSG00000145362.11,113049653,4-113000992-A-T,rs6818733,1,A,T,113000992,48661,112853045,113246261,147947
4,ENSG00000138670.10,81471907,4-81506692-A-C,rs6819303,-1,A,C,81506692,34785,81275299,81668515,231393
4,ENSG00000138744.8,75941013,4-75949076-C-T,rs6826085,-1,C,T,75949076,8063,75744405,76137621,204671
4,ENSG00000145331.9,99564039,4-99518879-T-C,rs6828637,-1,T,C,99518879,45160,99367431,99760647,151448
4,ENSG00000250312.2,124501,4-156885-G-A,rs6830247,1,G,A,156885,32384,-72107,321109,228992
4,ENSG00000109689.10,26860841,4-26870838-G-A,rs6833053,1,G,A,26870838,9997,26664233,27057449,206605
4,ENSG00000163104.12,94207865,4-94065351-G-A,rs6837513,1,G,A,94065351,142514,94011257,94404473,54094
4,ENSG00000014824.7,41990530,4-41855243-A-G,rs6839478,1,A,G,41855243,135287,41793922,42187138,61321
4,ENSG00000174780.10,56467617,4-56463770-T-C,rs6849183,1,T,C,56463770,3847,56271009,56664225,192761
4,ENSG00000138792.5,110476155,4-110669805-C-T,rs6850879,1,C,T,110669805,193650,110279547,110672763,390258
4,ENSG00000145358.2,100190468,4-100182037-A-C,rs6856947,-1,A,C,100182037,8431,99993860,100387076,188177
4,ENSG00000145358.2,100190468,4-100182037-A-G,rs6856947,-1,A,G,100182037,8431,99993860,100387076,188177
4,ENSG00000163069.8,52038299,4-51862158-G-T,rs6856974,-1,G,T,51862158,176141,51841691,52234907,20467
4,ENSG00000138785.10,105708689,4-105725192-A-G,rs72671852,-1,A,G,105725192,16503,105512081,105905297,213111
4,ENSG00000168564.5,183444636,4-183520494-A-G,rs72689391,1,A,G,183520494,75858,183248028,183641244,272466
4,ENSG00000150627.9,176065841,4-176083775-C-G,rs72706340,1,C,G,176083775,17934,175869233,176262449,214542
4,ENSG00000007062.7,16084023,4-15999584-C-T,rs73230290,-1,C,T,15999584,84439,15887415,16280631,112169
4,ENSG00000090989.13,55853648,4-55871323-G-A,rs73238378,1,G,A,55871323,17675,55657040,56050256,214283
4,ENSG00000090989.13,55853648,4-55871323-G-C,rs73238378,1,G,C,55871323,17675,55657040,56050256,214283
4,ENSG00000152969.11,6200549,4-6198343-A-T,rs7377975,-1,A,T,6198343,2206,6003941,6397157,194402
4,ENSG00000152969.11,6200549,4-6198343-A-G,rs7377975,-1,A,G,6198343,2206,6003941,6397157,194402
4,ENSG00000152969.11,6200549,4-6198343-A-C,rs7377975,-1,A,C,6198343,2206,6003941,6397157,194402
4,ENSG00000183439.5,164977657,4-164977530-C-T,rs74651789,-1,C,T,164977530,127,164781049,165174265,196481
4,ENSG00000087008.10,8440723,4-8372105-G-T,rs747582,-1,G,T,8372105,68618,8244115,8637331,127990
4,ENSG00000087008.10,8440723,4-8372105-G-A,rs747582,-1,G,A,8372105,68618,8244115,8637331,127990
4,ENSG00000077684.10,128809700,4-128676244-A-G,rs74980942,1,A,G,128676244,133456,128613092,129006308,63152
4,ENSG00000184178.11,53366061,4-53265171-T-C,rs751265,-1,T,C,53265171,100890,53169453,53562669,95718
4,ENSG00000184178.11,53366061,4-53265171-T-A,rs751265,-1,T,A,53265171,100890,53169453,53562669,95718
4,ENSG00000109794.9,186104704,4-185972808-G-A,rs75163896,1,G,A,185972808,131896,185908096,186301312,64712
4,ENSG00000013288.4,6575189,4-6606103-T-G,rs7659958,1,T,G,6606103,30914,6378581,6771797,227522
4,ENSG00000013288.4,6575189,4-6606103-T-C,rs7659958,1,T,C,6606103,30914,6378581,6771797,227522
4,ENSG00000197465.8,143905559,4-143958036-C-T,rs7662736,-1,C,T,143958036,52477,143708951,144102167,249085
4,ENSG00000197465.8,143905559,4-143958036-C-G,rs7662736,-1,C,G,143958036,52477,143708951,144102167,249085
4,ENSG00000197465.8,143905559,4-143958036-C-A,rs7662736,-1,C,A,143958036,52477,143708951,144102167,249085
4,ENSG00000164056.6,123396795,4-123350166-A-G,rs7663357,1,A,G,123350166,46629,123200187,123593403,149979
4,ENSG00000109814.7,39527439,4-39502649-C-T,rs7667751,-1,C,T,39502649,24790,39330831,39724047,171818
4,ENSG00000109814.7,39527439,4-39502649-C-G,rs7667751,-1,C,G,39502649,24790,39330831,39724047,171818
4,ENSG00000164037.11,103019705,4-102990002-A-C,rs7672319,-1,A,C,102990002,29703,102823097,103216313,166905
4,ENSG00000164037.11,103019705,4-102990002-A-T,rs7672319,-1,A,T,102990002,29703,102823097,103216313,166905
4,ENSG00000137460.4,152936323,4-152797442-G-A,rs7674637,1,G,A,152797442,138881,152739715,153132931,57727
4,ENSG00000109133.8,41935429,4-41943042-A-G,rs7681854,1,A,G,41943042,7613,41738821,42132037,204221
4,ENSG00000164116.12,155666848,4-155677233-A-G,rs7685675,1,A,G,155677233,10385,155470240,155863456,206993
4,ENSG00000164116.12,155666848,4-155677233-A-T,rs7685675,1,A,T,155677233,10385,155470240,155863456,206993
4,ENSG00000047315.10,56978896,4-56958766-A-G,rs7687767,1,A,G,56958766,20130,56782288,57175504,176478
4,ENSG00000170365.5,145481853,4-145514998-A-C,rs7694086,1,A,C,145514998,33145,145285245,145678461,229753
4,ENSG00000152990.9,22516066,4-22613789-A-G,rs7694334,-1,A,G,22613789,97723,22319458,22712674,294331
4,ENSG00000129128.8,176319966,4-176401459-C-T,rs7694651,1,C,T,176401459,81493,176123358,176516574,278101
4,ENSG00000159674.7,1172583,4-1242553-C-T,rs77001529,-1,C,T,1242553,69970,975975,1369191,266578
4,ENSG00000215375.2,677922,4-739842-G-A,rs77052907,1,G,A,739842,61920,481314,874530,258528
4,ENSG00000174473.10,171813404,4-172009284-C-G,rs77472055,1,C,G,172009284,195880,171616796,172010012,392488
4,ENSG00000174473.10,171813404,4-172009284-C-T,rs77472055,1,C,T,172009284,195880,171616796,172010012,392488
4,ENSG00000186212.2,76898144,4-76985088-C-T,rs79092945,-1,C,T,76985088,86944,76701536,77094752,283552
4,ENSG00000078177.8,40056850,4-40110992-A-G,rs793996,1,A,G,40110992,54142,39860242,40253458,250750
4,ENSG00000174137.8,1684313,4-1705720-T-C,rs798756,-1,T,C,1705720,21407,1487705,1880921,218015
4,ENSG00000090316.10,1289891,4-1218000-G-T,rs80061036,1,G,T,1218000,71891,1093283,1486499,124717
4,ENSG00000090316.10,1289891,4-1218000-G-A,rs80061036,1,G,A,1218000,71891,1093283,1486499,124717
4,ENSG00000163743.9,75514403,4-75355634-C-T,rs80276888,-1,C,T,75355634,158769,75317795,75711011,37839
4,ENSG00000085871.4,139665819,4-139675545-A-C,rs8192047,1,A,C,139675545,9726,139469211,139862427,206334
4,ENSG00000085871.4,139665819,4-139675545-A-G,rs8192047,1,A,G,139675545,9726,139469211,139862427,206334
4,ENSG00000168228.9,25312774,4-25313354-T-G,rs879008,1,T,G,25313354,580,25116166,25509382,197188
4,ENSG00000168228.9,25312774,4-25313354-T-C,rs879008,1,T,C,25313354,580,25116166,25509382,197188
4,ENSG00000138686.5,121870474,4-121912159-C-T,rs906496,-1,C,T,121912159,41685,121673866,122067082,238293
4,ENSG00000138686.5,121870474,4-121912159-C-G,rs906496,-1,C,G,121912159,41685,121673866,122067082,238293
4,ENSG00000150961.10,118836126,4-118994418-T-C,rs9307466,-1,T,C,118994418,158292,118639518,119032734,354900
4,ENSG00000145386.5,121823883,4-121907639-T-G,rs951974,-1,T,G,121907639,83756,121627275,122020491,280364
4,ENSG00000164169.8,147684163,4-147655114-A-G,rs9992593,-1,A,G,147655114,29049,147487555,147880771,167559
4,ENSG00000178988.10,6709865,4-6710074-C-G,rs9992941,-1,C,G,6710074,209,6513257,6906473,196817
4,ENSG00000137462.6,153684280,4-153652099-A-T,rs10007443,1,A,T,153652099,32181,153487672,153880888,164427
4,ENSG00000138641.10,88592480,4-88645052-C-T,rs10016030,1,C,T,88645052,52572,88395872,88789088,249180
4,ENSG00000169026.8,689151,4-581298-G-A,rs10018393,-1,G,A,581298,107853,492543,885759,88755
4,ENSG00000169026.8,689151,4-581298-G-T,rs10018393,-1,G,T,581298,107853,492543,885759,88755
4,ENSG00000138823.7,99574824,4-99563386-G-C,rs10026790,1,G,C,99563386,11438,99378216,99771432,185170
4,ENSG00000138823.7,99574824,4-99563386-G-A,rs10026790,1,G,A,99563386,11438,99378216,99771432,185170
4,ENSG00000164093.10,110623077,4-110743296-A-G,rs10027473,-1,A,G,110743296,120219,110426469,110819685,316827
4,ENSG00000145246.8,47485275,4-47421763-G-A,rs10030377,1,G,A,47421763,63512,47288667,47681883,133096
4,ENSG00000109771.11,185395924,4-185350000-G-A,rs10030392,-1,G,A,185350000,45924,185199316,185592532,150684
4,ENSG00000145390.6,119212713,4-119230297-T-C,rs10031033,1,T,C,119230297,17584,119016105,119409321,214192
4,ENSG00000145390.6,119212713,4-119230297-T-A,rs10031033,1,T,A,119230297,17584,119016105,119409321,214192
4,ENSG00000250312.2,124501,4-121227-C-T,rs10033518,1,C,T,121227,3274,-72107,321109,193334
4,ENSG00000250312.2,124501,4-121227-C-A,rs10033518,1,C,A,121227,3274,-72107,321109,193334
4,ENSG00000153130.12,140373646,4-140341682-A-G,rs1039988,1,A,G,140341682,31964,140177038,140570254,164644
4,ENSG00000174125.3,38804791,4-38766912-A-G,rs10470854,-1,A,G,38766912,37879,38608183,39001399,158729
4,ENSG00000174125.3,38804791,4-38766912-A-T,rs10470854,-1,A,T,38766912,37879,38608183,39001399,158729
4,ENSG00000174125.3,38804791,4-38766912-A-C,rs10470854,-1,A,C,38766912,37879,38608183,39001399,158729
4,ENSG00000109572.8,169620578,4-169742084-C-T,rs1047642,1,C,T,169742084,121506,169423970,169817186,318114
4,ENSG00000109572.8,169620578,4-169742084-C-G,rs1047642,1,C,G,169742084,121506,169423970,169817186,318114
4,ENSG00000109572.8,169620578,4-169742084-C-A,rs1047642,1,C,A,169742084,121506,169423970,169817186,318114
4,ENSG00000138798.7,109912883,4-109956260-A-G,rs10488881,1,A,G,109956260,43377,109716275,110109491,239985
4,ENSG00000138798.7,109912883,4-109956260-A-T,rs10488881,1,A,T,109956260,43377,109716275,110109491,239985
4,ENSG00000124406.12,42657105,4-42546243-C-A,rs10938196,-1,C,A,42546243,110862,42460497,42853713,85746
4,ENSG00000033178.7,67701155,4-67514497-G-C,rs11250,-1,G,C,67514497,186658,67504547,67897763,9950
4,ENSG00000033178.7,67701155,4-67514497-G-T,rs11250,-1,G,T,67514497,186658,67504547,67897763,9950
4,ENSG00000033178.7,67701155,4-67514497-G-A,rs11250,-1,G,A,67514497,186658,67504547,67897763,9950
4,ENSG00000175920.11,3463306,4-3598027-C-T,rs112850639,1,C,T,3598027,134721,3266698,3659914,331329
4,ENSG00000002549.7,17577198,4-17593913-A-G,rs115189991,1,A,G,17593913,16715,17380590,17773806,213323
4,ENSG00000138658.11,112636909,4-112632169-C-T,rs115274227,-1,C,T,112632169,4740,112440301,112833517,191868
4,ENSG00000138658.11,112636909,4-112632169-C-A,rs115274227,-1,C,A,112632169,4740,112440301,112833517,191868
4,ENSG00000163956.6,3532422,4-3503369-G-A,rs116262719,-1,G,A,3503369,29053,3335814,3729030,167555
4,ENSG00000109787.8,38664199,4-38732976-C-T,rs116338472,1,C,T,38732976,68777,38467591,38860807,265385
4,ENSG00000138663.4,83035183,4-83156618-G-T,rs11727330,1,G,T,83156618,121435,82838575,83231791,318043
4,ENSG00000164066.7,127632957,4-127542775-A-G,rs11730901,1,A,G,127542775,90182,127436349,127829565,106426
4,ENSG00000145214.9,973569,4-977478-T-G,rs11731377,-1,T,G,977478,3909,776961,1170177,200517
4,ENSG00000056050.6,169757944,4-169730023-C-T,rs11732885,-1,C,T,169730023,27921,169561336,169954552,168687
4,ENSG00000056050.6,169757944,4-169730023-C-A,rs11732885,-1,C,A,169730023,27921,169561336,169954552,168687
4,ENSG00000164038.10,103076761,4-103177142-G-A,rs11932885,-1,G,A,103177142,100381,102880153,103273369,296989
4,ENSG00000164038.10,103076761,4-103177142-G-C,rs11932885,-1,G,C,103177142,100381,102880153,103273369,296989
4,ENSG00000164038.10,103076761,4-103177142-G-T,rs11932885,-1,G,T,103177142,100381,102880153,103273369,296989
4,ENSG00000168785.3,98658611,4-98699556-A-G,rs11933609,-1,A,G,98699556,40945,98462003,98855219,237553
4,ENSG00000109475.12,108620576,4-108447979-C-T,rs11936528,1,C,T,108447979,172597,108423968,108817184,24011
4,ENSG00000170509.7,87322882,4-87421217-A-G,rs11945232,-1,A,G,87421217,98335,87126274,87519490,294943
4,ENSG00000170509.7,87322882,4-87421217-A-T,rs11945232,-1,A,T,87421217,98335,87126274,87519490,294943
4,ENSG00000004468.6,15778328,4-15771385-A-G,rs11945730,1,A,G,15771385,6943,15581720,15974936,189665
4,ENSG00000171476.16,56681296,4-56640619-T-C,rs11947513,-1,T,C,56640619,40677,56484688,56877904,155931
4,ENSG00000163104.12,94207865,4-94336804-A-C,rs11947921,1,A,C,94336804,128939,94011257,94404473,325547
4,ENSG00000163104.12,94207865,4-94336804-A-G,rs11947921,1,A,G,94336804,128939,94011257,94404473,325547
4,ENSG00000074966.6,48134250,4-48179155-C-T,rs12499541,-1,C,T,48179155,44905,47937642,48330858,241513
4,ENSG00000074966.6,48134250,4-48179155-C-G,rs12499541,-1,C,G,48179155,44905,47937642,48330858,241513
4,ENSG00000074966.6,48134250,4-48179155-C-A,rs12499541,-1,C,A,48179155,44905,47937642,48330858,241513
4,ENSG00000138780.9,105708784,4-105740847-A-G,rs12504088,1,A,G,105740847,32063,105512176,105905392,228671
4,ENSG00000059691.7,151761007,4-151627960-T-C,rs12504273,-1,T,C,151627960,133047,151564399,151957615,63561
4,ENSG00000197712.6,38867806,4-38900148-A-C,rs12641669,1,A,C,38900148,32342,38671198,39064414,228950
4,ENSG00000164117.7,174283667,4-174116053-A-G,rs12647583,-1,A,G,174116053,167614,174087059,174480275,28994
4,ENSG00000164117.7,174283667,4-174116053-A-T,rs12647583,-1,A,T,174116053,167614,174087059,174480275,28994
4,ENSG00000109684.9,10684768,4-10784763-A-T,rs12648975,-1,A,T,10784763,99995,10488160,10881376,296603
4,ENSG00000109684.9,10684768,4-10784763-A-C,rs12648975,-1,A,C,10784763,99995,10488160,10881376,296603
4,ENSG00000109684.9,10684768,4-10784763-A-G,rs12648975,-1,A,G,10784763,99995,10488160,10881376,296603
4,ENSG00000174599.4,117085576,4-117240299-A-G,rs12651212,-1,A,G,117240299,154723,116888968,117282184,351331
4,ENSG00000174599.4,117085576,4-117240299-A-T,rs12651212,-1,A,T,117240299,154723,116888968,117282184,351331
4,ENSG00000174473.10,171813404,4-171879872-C-T,rs13101636,1,C,T,171879872,66468,171616796,172010012,263076
4,ENSG00000174473.10,171813404,4-171879872-C-G,rs13101636,1,C,G,171879872,66468,171616796,172010012,263076
4,ENSG00000109390.7,139302477,4-139368131-A-G,rs13117654,-1,A,G,139368131,65654,139105869,139499085,262262
4,ENSG00000109390.7,139302477,4-139368131-A-C,rs13117654,-1,A,C,139368131,65654,139105869,139499085,262262
4,ENSG00000178163.3,10457426,4-10490095-A-G,rs13127079,-1,A,G,10490095,32669,10260818,10654034,229277
4,ENSG00000178163.3,10457426,4-10490095-A-T,rs13127079,-1,A,T,10490095,32669,10260818,10654034,229277
4,ENSG00000171234.9,69096474,4-69153615-T-C,rs13134261,1,T,C,69153615,57141,68899866,69293082,253749
4,ENSG00000109452.7,142846301,4-143039634-A-G,rs13136216,-1,A,G,143039634,193333,142649693,143042909,389941
4,ENSG00000153064.7,101790730,4-101815299-C-A,rs13136297,1,C,A,101815299,24569,101594122,101987338,221177
4,ENSG00000153064.7,101790730,4-101815299-C-T,rs13136297,1,C,T,101815299,24569,101594122,101987338,221177
4,ENSG00000125388.14,2963571,4-3052290-T-A,rs1313768,1,T,A,3052290,88719,2766963,3160179,285327
4,ENSG00000125388.14,2963571,4-3052290-T-C,rs1313768,1,T,C,3052290,88719,2766963,3160179,285327
4,ENSG00000138685.7,122826831,4-122789142-C-T,rs13138349,1,C,T,122789142,37689,122630223,123023439,158919
4,ENSG00000123737.8,121801323,4-121828924-C-T,rs13145213,1,C,T,121828924,27601,121604715,121997931,224209
4,ENSG00000123737.8,121801323,4-121828924-C-G,rs13145213,1,C,G,121828924,27601,121604715,121997931,224209
4,ENSG00000118564.10,15655357,4-15739122-G-C,rs13148924,-1,G,C,15739122,83765,15458749,15851965,280373
4,ENSG00000118564.10,15655357,4-15739122-G-A,rs13148924,-1,G,A,15739122,83765,15458749,15851965,280373
4,ENSG00000138722.5,89894854,4-89897942-T-A,rs1442135,1,T,A,89897942,3088,89698246,90091462,199696
4,ENSG00000138722.5,89894854,4-89897942-T-C,rs1442135,1,T,C,89897942,3088,89698246,90091462,199696
4,ENSG00000138722.5,89894854,4-89897942-T-G,rs1442135,1,T,G,89897942,3088,89698246,90091462,199696
4,ENSG00000151718.11,183099257,4-183270884-C-G,rs1473070,1,C,G,183270884,171627,182902649,183295865,368235
4,ENSG00000151718.11,183099257,4-183270884-C-T,rs1473070,1,C,T,183270884,171627,182902649,183295865,368235
4,ENSG00000138678.6,83536108,4-83594622-G-C,rs1474250,1,G,C,83594622,58514,83339500,83732716,255122
4,ENSG00000138678.6,83536108,4-83594622-G-A,rs1474250,1,G,A,83594622,58514,83339500,83732716,255122
4,ENSG00000109163.6,67754388,4-67765346-C-A,rs1484185,-1,C,A,67765346,10958,67557780,67950996,207566
4,ENSG00000109163.6,67754388,4-67765346-C-T,rs1484185,-1,C,T,67765346,10958,67557780,67950996,207566
4,ENSG00000151611.8,145619385,4-145618478-C-T,rs1497125,1,C,T,145618478,907,145422777,145815993,195701
4,ENSG00000138821.8,102345482,4-102216820-A-G,rs1540052,-1,A,G,102216820,128662,102148874,102542090,67946
4,ENSG00000168824.10,4387102,4-4344811-T-C,rs16835627,1,T,C,4344811,42291,4190494,4583710,154317
4,ENSG00000152953.8,5051480,4-5217892-G-A,rs16836902,1,G,A,5217892,166412,4854872,5248088,363020
4,ENSG00000197057.4,36281616,4-36332535-C-T,rs16992086,1,C,T,36332535,50919,36085008,36478224,247527
4,ENSG00000169116.7,74933116,4-75004440-G-T,rs17000076,1,G,T,75004440,71324,74736508,75129724,267932
4,ENSG00000169116.7,74933116,4-75004440-G-A,rs17000076,1,G,A,75004440,71324,74736508,75129724,267932
4,ENSG00000164168.3,147617397,4-147754147-A-T,rs17023744,1,A,T,147754147,136750,147420789,147814005,333358
4,ENSG00000071205.7,147732088,4-147754147-A-T,rs17023744,1,A,T,147754147,22059,147535480,147928696,218667
4,ENSG00000171497.4,158723396,4-158849904-T-C,rs17037716,-1,T,C,158849904,126508,158526788,158920004,323116
4,ENSG00000171497.4,158723396,4-158849904-T-G,rs17037716,-1,T,G,158849904,126508,158526788,158920004,323116
4,ENSG00000078177.8,40056850,4-40055669-C-T,rs1704157,1,C,T,40055669,1181,39860242,40253458,195427
4,ENSG00000078177.8,40056850,4-40055669-C-G,rs1704157,1,C,G,40055669,1181,39860242,40253458,195427
4,ENSG00000078177.8,40056850,4-40055669-C-A,rs1704157,1,C,A,40055669,1181,39860242,40253458,195427
4,ENSG00000145349.12,113761738,4-113738047-T-C,rs17046458,-1,T,C,113738047,23691,113565130,113958346,172917
4,ENSG00000109667.7,10021497,4-10003119-C-G,rs17247314,-1,C,G,10003119,18378,9824889,10218105,178230
4,ENSG00000172403.6,118888854,4-119040950-A-G,rs17330202,1,A,G,119040950,152096,118692246,119085462,348704
4,ENSG00000163322.9,83485100,4-83467762-C-T,rs17355027,-1,C,T,83467762,17338,83288492,83681708,179270
4,ENSG00000109133.8,41935429,4-41962320-A-G,rs17445354,1,A,G,41962320,26891,41738821,42132037,223499
4,ENSG00000163257.6,17810757,4-17899729-T-C,rs17518793,-1,T,C,17899729,88972,17614149,18007365,285580
4,ENSG00000163257.6,17810757,4-17899729-T-A,rs17518793,-1,T,A,17899729,88972,17614149,18007365,285580
4,ENSG00000169299.8,37826686,4-37766693-G-T,rs17578289,1,G,T,37766693,59993,37630078,38023294,136615
4,ENSG00000174130.7,38856817,4-38811255-T-C,rs17616434,-1,T,C,38811255,45562,38660209,39053425,151046
4,ENSG00000109265.7,56049098,4-55931355-A-G,rs17797565,1,A,G,55931355,117743,55852490,56245706,78865
4,ENSG00000151612.10,145938823,4-146133976-G-A,rs17812414,-1,G,A,146133976,195153,145742215,146135431,391761
4,ENSG00000172955.13,99219246,4-99144358-T-G,rs1800759,-1,T,G,99144358,74888,99022638,99415854,121720
4,ENSG00000172955.13,99219246,4-99144358-T-C,rs1800759,-1,T,C,99144358,74888,99022638,99415854,121720
4,ENSG00000169245.4,76023497,4-75960826-A-G,rs1857821,-1,A,G,75960826,62671,75826889,76220105,133937
4,ENSG00000169245.4,76023497,4-75960826-A-T,rs1857821,-1,A,T,75960826,62671,75826889,76220105,133937
4,ENSG00000164109.8,120066848,4-120112032-T-C,rs1908169,-1,T,C,120112032,45184,119870240,120263456,241792
4,ENSG00000050730.11,121164321,4-121227632-A-C,rs2044970,-1,A,C,121227632,63311,120967713,121360929,259919
4,ENSG00000050730.11,121164321,4-121227632-A-G,rs2044970,-1,A,G,121227632,63311,120967713,121360929,259919
4,ENSG00000050730.11,121164321,4-121227632-A-T,rs2044970,-1,A,T,121227632,63311,120967713,121360929,259919
4,ENSG00000138686.5,121870474,4-121819007-C-A,rs2071486,-1,C,A,121819007,51467,121673866,122067082,145141
4,ENSG00000138686.5,121870474,4-121819007-C-T,rs2071486,-1,C,T,121819007,51467,121673866,122067082,145141
4,ENSG00000151725.6,184734096,4-184688422-T-A,rs2141258,-1,T,A,184688422,45674,184537488,184930704,150934
4,ENSG00000151725.6,184734096,4-184688422-T-G,rs2141258,-1,T,G,184688422,45674,184537488,184930704,150934
4,ENSG00000151806.9,44678420,4-44725971-C-A,rs2172143,1,C,A,44725971,47551,44481812,44875028,244159
4,ENSG00000038002.4,177442437,4-177438525-T-C,rs2271100,-1,T,C,177438525,3912,177245829,177639045,192696
4,ENSG00000151470.7,129096152,4-129109489-C-T,rs2271570,1,C,T,129109489,13337,128899544,129292760,209945
4,ENSG00000137449.10,15002481,4-14900544-G-C,rs2315518,1,G,C,14900544,101937,14805873,15199089,94671
4,ENSG00000151552.7,17512090,4-17535536-T-G,rs2518649,-1,T,G,17535536,23446,17315482,17708698,220054
4,ENSG00000151552.7,17512090,4-17535536-T-A,rs2518649,-1,T,A,17535536,23446,17315482,17708698,220054
4,ENSG00000072201.8,53591486,4-53693571-C-T,rs2590783,-1,C,T,53693571,102085,53394878,53788094,298693
4,ENSG00000174137.8,1684313,4-1727698-C-G,rs2592828,-1,C,G,1727698,43385,1487705,1880921,239993
4,ENSG00000174137.8,1684313,4-1727698-C-T,rs2592828,-1,C,T,1727698,43385,1487705,1880921,239993
4,ENSG00000087008.10,8440723,4-8489207-T-C,rs2631746,-1,T,C,8489207,48484,8244115,8637331,245092
4,ENSG00000138640.10,89057185,4-89057716-T-C,rs2670625,-1,T,C,89057716,531,88860577,89253793,197139
4,ENSG00000168936.6,1721323,4-1719621-G-C,rs2854916,-1,G,C,1719621,1702,1524715,1917931,194906
4,ENSG00000168936.6,1721323,4-1719621-G-A,rs2854916,-1,G,A,1719621,1702,1524715,1917931,194906
4,ENSG00000173083.9,83334848,4-83224058-C-G,rs28629807,-1,C,G,83224058,110790,83138240,83531456,85818
4,ENSG00000163297.12,80073229,4-80152066-C-T,rs2867695,-1,C,T,80152066,78837,79876621,80269837,275445
4,ENSG00000137460.4,152936323,4-152808475-A-G,rs28769919,1,A,G,152808475,127848,152739715,153132931,68760
4,ENSG00000164323.8,185204000,4-185229100-C-T,rs3112911,-1,C,T,185229100,25100,185007392,185400608,221708
4,ENSG00000155275.14,8440777,4-8556138-C-G,rs3115378,1,C,G,8556138,115361,8244169,8637385,311969
4,ENSG00000155275.14,8440777,4-8556138-C-T,rs3115378,1,C,T,8556138,115361,8244169,8637385,311969
4,ENSG00000185619.13,705765,4-733364-C-T,rs34434107,1,C,T,733364,27599,509157,902373,224207
4,ENSG00000168152.7,82900735,4-82918709-G-T,rs35532215,1,G,T,82918709,17974,82704127,83097343,214582
4,ENSG00000168152.7,82900735,4-82918709-G-A,rs35532215,1,G,A,82918709,17974,82704127,83097343,214582
4,ENSG00000127418.9,1011626,4-1000626-G-A,rs3755955,1,G,A,1000626,11000,815018,1208234,185608
4,ENSG00000127418.9,1011626,4-1000626-G-C,rs3755955,1,G,C,1000626,11000,815018,1208234,185608
4,ENSG00000145331.9,99564039,4-99589746-A-G,rs3792683,-1,A,G,99589746,25707,99367431,99760647,222315
4,ENSG00000181826.5,37686376,4-37647223-G-A,rs3849018,-1,G,A,37647223,39153,37489768,37882984,157455
4,ENSG00000181826.5,37686376,4-37647223-G-C,rs3849018,-1,G,C,37647223,39153,37489768,37882984,157455
4,ENSG00000121895.7,39032409,4-39018574-T-A,rs3860068,-1,T,A,39018574,13835,38835801,39229017,182773
4,ENSG00000121895.7,39032409,4-39018574-T-G,rs3860068,-1,T,G,39018574,13835,38835801,39229017,182773
4,ENSG00000128050.4,56436260,4-56475096-A-C,rs4270628,1,A,C,56475096,38836,56239652,56632868,235444
4,ENSG00000109689.10,26860841,4-26848304-A-T,rs4532223,1,A,T,26848304,12537,26664233,27057449,184071
4,ENSG00000109689.10,26860841,4-26848304-A-G,rs4532223,1,A,G,26848304,12537,26664233,27057449,184071
4,ENSG00000109689.10,26860841,4-26848304-A-C,rs4532223,1,A,C,26848304,12537,26664233,27057449,184071
4,ENSG00000109501.8,6269850,4-6149527-C-T,rs4560489,1,C,T,6149527,120323,6073242,6466458,76285
4,ENSG00000159788.13,3293021,4-3361304-A-G,rs4690087,1,A,G,3361304,68283,3096413,3489629,264891
4,ENSG00000159788.13,3293021,4-3361304-A-C,rs4690087,1,A,C,3361304,68283,3096413,3489629,264891
4,ENSG00000159788.13,3293021,4-3361304-A-T,rs4690087,1,A,T,3361304,68283,3096413,3489629,264891
4,ENSG00000145416.9,164384019,4-164553467-A-C,rs4691994,-1,A,C,164553467,169448,164187411,164580627,366056
4,ENSG00000145416.9,164384019,4-164553467-A-G,rs4691994,-1,A,G,164553467,169448,164187411,164580627,366056
4,ENSG00000145416.9,164384019,4-164553467-A-T,rs4691994,-1,A,T,164553467,169448,164187411,164580627,366056
4,ENSG00000154447.10,169270956,4-169315601-T-C,rs4692568,-1,T,C,169315601,44645,169074348,169467564,241253
4,ENSG00000138642.9,88378852,4-88524755-G-T,rs4693959,1,G,T,88524755,145903,88182244,88575460,342511
4,ENSG00000138646.4,88457119,4-88524755-G-T,rs4693959,1,G,T,88524755,67636,88260511,88653727,264244
4,ENSG00000169019.9,47463702,4-47283017-C-G,rs4695209,-1,C,G,47283017,180685,47267094,47660310,15923
4,ENSG00000138744.8,75941013,4-75936235-C-T,rs4859572,-1,C,T,75936235,4778,75744405,76137621,191830
4,ENSG00000164342.6,186069156,4-185925845-G-A,rs4862596,1,G,A,185925845,143311,185872548,186265764,53297
4,ENSG00000185477.3,89307800,4-89205955-G-A,rs55730628,-1,G,A,89205955,101845,89111192,89504408,94763
4,ENSG00000013288.4,6575189,4-6614329-C-G,rs61729241,1,C,G,6614329,39140,6378581,6771797,235748
4,ENSG00000013288.4,6575189,4-6614329-C-A,rs61729241,1,C,A,6614329,39140,6378581,6771797,235748
4,ENSG00000013288.4,6575189,4-6614329-C-T,rs61729241,1,C,T,6614329,39140,6378581,6771797,235748
4,ENSG00000168491.5,185471733,4-185351567-A-G,rs61731371,-1,A,G,185351567,120166,185275125,185668341,76442
4,ENSG00000173320.5,183905307,4-183888365-C-A,rs62340434,1,C,A,183888365,16942,183708699,184101915,179666
4,ENSG00000173320.5,183905307,4-183888365-C-T,rs62340434,1,C,T,183888365,16942,183708699,184101915,179666
4,ENSG00000109814.7,39527439,4-39485681-A-G,rs6531719,-1,A,G,39485681,41758,39330831,39724047,154850
4,ENSG00000118785.8,87975714,4-87946880-C-T,rs6532036,1,C,T,87946880,28834,87779106,88172322,167774
4,ENSG00000184305.9,90127394,4-89989779-G-A,rs6532210,1,G,A,89989779,137615,89930786,90324002,58993
4,ENSG00000164032.7,99950275,4-100071685-G-A,rs6532841,-1,G,A,100071685,121410,99753667,100146883,318018
4,ENSG00000164032.7,99950275,4-100071685-G-T,rs6532841,-1,G,T,100071685,121410,99753667,100146883,318018
4,ENSG00000138772.8,78551770,4-78537383-C-A,rs6533756,1,C,A,78537383,14387,78355162,78748378,182221
4,ENSG00000138772.8,78551770,4-78537383-C-G,rs6533756,1,C,G,78537383,14387,78355162,78748378,182221
4,ENSG00000138772.8,78551770,4-78537383-C-T,rs6533756,1,C,T,78537383,14387,78355162,78748378,182221
4,ENSG00000163319.6,83456058,4-83443655-T-C,rs6535473,1,T,C,83443655,12403,83259450,83652666,184205
4,ENSG00000198189.6,87391188,4-87325048-A-C,rs66837437,-1,A,C,87325048,66140,87194580,87587796,130468
4,ENSG00000164099.3,118353003,4-118416108-A-G,rs6811485,-1,A,G,118416108,63105,118156395,118549611,259713
4,ENSG00000256043.2,155953866,4-155946328-C-T,rs6816024,-1,C,T,155946328,7538,155757258,156150474,189070
4,ENSG00000256043.2,155953866,4-155946328-C-G,rs6816024,-1,C,G,155946328,7538,155757258,156150474,189070
4,ENSG00000157869.10,13484340,4-13607859-G-A,rs6829086,-1,G,A,13607859,123519,13287732,13680948,320127
4,ENSG00000218336.3,182243402,4-182102270-T-C,rs6830046,1,T,C,182102270,141132,182046794,182440010,55476
4,ENSG00000070190.8,99816827,4-99784115-C-T,rs6831238,1,C,T,99784115,32712,99620219,100013435,163896
4,ENSG00000070190.8,99816827,4-99784115-C-A,rs6831238,1,C,A,99784115,32712,99620219,100013435,163896
4,ENSG00000174749.4,112145454,4-112177889-G-A,rs6835452,1,G,A,112177889,32435,111948846,112342062,229043
4,ENSG00000168421.7,40197031,4-40191712-T-A,rs6847288,1,T,A,40191712,5319,40000423,40393639,191289
4,ENSG00000168421.7,40197031,4-40191712-T-C,rs6847288,1,T,C,40191712,5319,40000423,40393639,191289
4,ENSG00000145358.2,100190468,4-100199315-T-C,rs6849832,-1,T,C,100199315,8847,99993860,100387076,205455
4,ENSG00000145358.2,100190468,4-100199315-T-G,rs6849832,-1,T,G,100199315,8847,99993860,100387076,205455
4,ENSG00000138796.10,107989889,4-108038126-A-C,rs6851442,1,A,C,108038126,48237,107793281,108186497,244845
4,ENSG00000138796.10,107989889,4-108038126-A-G,rs6851442,1,A,G,108038126,48237,107793281,108186497,244845
4,ENSG00000163071.6,52051304,4-51862158-G-T,rs6856974,1,G,T,51862158,189146,51854696,52247912,7462
4,ENSG00000186212.2,76898144,4-76935873-C-G,rs72665106,-1,C,G,76935873,37729,76701536,77094752,234337
4,ENSG00000186212.2,76898144,4-76935873-C-T,rs72665106,-1,C,T,76935873,37729,76701536,77094752,234337
4,ENSG00000186212.2,76898144,4-76935873-C-A,rs72665106,-1,C,A,76935873,37729,76701536,77094752,234337
4,ENSG00000168556.5,183505058,4-183521757-A-G,rs72689393,1,A,G,183521757,16699,183308450,183701666,213307
4,ENSG00000174792.6,75556066,4-75392493-G-A,rs74475117,1,G,A,75392493,163573,75359458,75752674,33035
4,ENSG00000133256.8,625573,4-559461-G-A,rs74702339,1,G,A,559461,66112,428965,822181,130496
4,ENSG00000154553.8,185535507,4-185603334-G-A,rs74702790,-1,G,A,185603334,67827,185338899,185732115,264435
4,ENSG00000071127.11,10116799,4-10151254-C-G,rs747357,-1,C,G,10151254,34455,9920191,10313407,231063
4,ENSG00000071127.11,10116799,4-10151254-C-A,rs747357,-1,C,A,10151254,34455,9920191,10313407,231063
4,ENSG00000071127.11,10116799,4-10151254-C-T,rs747357,-1,C,T,10151254,34455,9920191,10313407,231063
4,ENSG00000189184.7,137532494,4-137478117-G-A,rs75682440,-1,G,A,137478117,54377,137335886,137729102,142231
4,ENSG00000072840.8,5711201,4-5701653-C-T,rs76181588,1,C,T,5701653,9548,5514593,5907809,187060
4,ENSG00000072840.8,5711201,4-5701653-C-G,rs76181588,1,C,G,5701653,9548,5514593,5907809,187060
4,ENSG00000118762.3,88007635,4-87929063-C-T,rs76409708,1,C,T,87929063,78572,87811027,88204243,118036
4,ENSG00000118762.3,88007635,4-87929063-C-G,rs76409708,1,C,G,87929063,78572,87811027,88204243,118036
4,ENSG00000250317.3,25914220,4-25934607-G-T,rs7656432,1,G,T,25934607,20387,25717612,26110828,216995
4,ENSG00000250317.3,25914220,4-25934607-G-C,rs7656432,1,G,C,25934607,20387,25717612,26110828,216995
4,ENSG00000164144.10,152779954,4-152908101-A-G,rs7657803,1,A,G,152908101,128147,152583346,152976562,324755
4,ENSG00000164144.10,152779954,4-152908101-A-T,rs7657803,1,A,T,152908101,128147,152583346,152976562,324755
4,ENSG00000164144.10,152779954,4-152908101-A-C,rs7657803,1,A,C,152908101,128147,152583346,152976562,324755
4,ENSG00000135220.6,68951804,4-68832077-T-C,rs7662046,-1,T,C,68832077,119727,68755196,69148412,76881
4,ENSG00000163138.13,20700458,4-20659721-T-C,rs7662488,1,T,C,20659721,40737,20503850,20897066,155871
4,ENSG00000145287.6,83114729,4-83240797-C-T,rs7672528,-1,C,T,83240797,126068,82918121,83311337,322676
4,ENSG00000145287.6,83114729,4-83240797-C-A,rs7672528,-1,C,A,83240797,126068,82918121,83311337,322676
4,ENSG00000145287.6,83114729,4-83240797-C-G,rs7672528,-1,C,G,83240797,126068,82918121,83311337,322676
4,ENSG00000173085.9,83284798,4-83240797-C-T,rs7672528,-1,C,T,83240797,44001,83088190,83481406,152607
4,ENSG00000173085.9,83284798,4-83240797-C-A,rs7672528,-1,C,A,83240797,44001,83088190,83481406,152607
4,ENSG00000173085.9,83284798,4-83240797-C-G,rs7672528,-1,C,G,83240797,44001,83088190,83481406,152607
4,ENSG00000169989.2,152779730,4-152767624-C-T,rs7674876,-1,C,T,152767624,12106,152583122,152976338,184502
4,ENSG00000087274.11,2843844,4-3027896-A-G,rs7677445,1,A,G,3027896,184052,2647236,3040452,380660
4,ENSG00000164111.9,121696980,4-121702910-T-C,rs7680787,-1,T,C,121702910,5930,121500372,121893588,202538
4,ENSG00000163069.8,52038299,4-52106024-C-T,rs7682030,-1,C,T,52106024,67725,51841691,52234907,264333
4,ENSG00000173011.10,7043372,4-7187493-T-C,rs7684317,1,T,C,7187493,144121,6846764,7239980,340729
4,ENSG00000151726.8,184825968,4-184869964-T-C,rs7688770,-1,T,C,184869964,43996,184629360,185022576,240604
4,ENSG00000151726.8,184825968,4-184869964-T-G,rs7688770,-1,T,G,184869964,43996,184629360,185022576,240604
4,ENSG00000109674.3,177309874,4-177335759-C-T,rs7689099,1,C,T,177335759,25885,177113266,177506482,222493
4,ENSG00000109674.3,177309874,4-177335759-C-A,rs7689099,1,C,A,177335759,25885,177113266,177506482,222493
4,ENSG00000109674.3,177309874,4-177335759-C-G,rs7689099,1,C,G,177335759,25885,177113266,177506482,222493
4,ENSG00000168228.9,25312774,4-25309802-C-G,rs7689775,1,C,G,25309802,2972,25116166,25509382,193636
4,ENSG00000168228.9,25312774,4-25309802-C-T,rs7689775,1,C,T,25309802,2972,25116166,25509382,193636
4,ENSG00000145476.10,186191567,4-186188712-A-G,rs7689823,1,A,G,186188712,2855,185994959,186388175,193753
4,ENSG00000197894.6,99088788,4-99104482-G-A,rs7690613,-1,G,A,99104482,15694,98892180,99285396,212302
4,ENSG00000123933.9,2262109,4-2288264-T-C,rs7695321,-1,T,C,2288264,26155,2065501,2458717,222763
4,ENSG00000189157.8,76251721,4-76356337-T-C,rs77855175,1,T,C,76356337,104616,76055113,76448329,301224
4,ENSG00000188993.3,52020363,4-51885693-T-A,rs77856227,-1,T,A,51885693,134670,51823755,52216971,61938
4,ENSG00000164118.8,174283911,4-174102391-A-G,rs78227195,1,A,G,174102391,181520,174087303,174480519,15088
4,ENSG00000164303.6,184217873,4-184363983-G-A,rs78715035,-1,G,A,184363983,146110,184021265,184414481,342718
4,ENSG00000145348.11,106316209,4-106126587-T-G,rs79150233,-1,T,G,106126587,189622,106119601,106512817,6986
4,ENSG00000182552.10,183659185,4-183551637-A-G,rs79219333,-1,A,G,183551637,107548,183462577,183855793,89060
4,ENSG00000085871.4,139665819,4-139669064-A-T,rs795595,1,A,T,139669064,3245,139469211,139862427,199853
4,ENSG00000085871.4,139665819,4-139669064-A-G,rs795595,1,A,G,139669064,3245,139469211,139862427,199853
4,ENSG00000085871.4,139665819,4-139669064-A-C,rs795595,1,A,C,139669064,3245,139469211,139862427,199853
4,ENSG00000159733.9,2418645,4-2463577-G-A,rs846252,-1,G,A,2463577,44932,2222037,2615253,241540
4,ENSG00000091490.6,25862988,4-25911533-C-T,rs878552,-1,C,T,25911533,48545,25666380,26059596,245153
4,ENSG00000137441.7,15963175,4-16071598-A-T,rs908645,-1,A,T,16071598,108423,15766567,16159783,305031
4,ENSG00000137441.7,15963175,4-16071598-A-C,rs908645,-1,A,C,16071598,108423,15766567,16159783,305031
4,ENSG00000157426.8,56387491,4-56329989-C-T,rs939293,-1,C,T,56329989,57502,56190883,56584099,139106
4,ENSG00000197888.2,68576322,4-68476451-G-A,rs983745,-1,G,A,68476451,99871,68379714,68772930,96737
4,ENSG00000197888.2,68576322,4-68476451-G-C,rs983745,-1,G,C,68476451,99871,68379714,68772930,96737
4,ENSG00000196620.4,68670652,4-68476451-G-A,rs983745,-1,G,A,68476451,194201,68474044,68867260,2407
4,ENSG00000196620.4,68670652,4-68476451-G-C,rs983745,-1,G,C,68476451,194201,68474044,68867260,2407
4,ENSG00000109519.7,7068064,4-7048650-C-A,rs9985704,-1,C,A,7048650,19414,6871456,7264672,177194
4,ENSG00000109519.7,7068064,4-7048650-C-G,rs9985704,-1,C,G,7048650,19414,6871456,7264672,177194
4,ENSG00000109519.7,7068064,4-7048650-C-T,rs9985704,-1,C,T,7048650,19414,6871456,7264672,177194
4,ENSG00000121211.3,153344688,4-153214305-A-G,rs9997214,1,A,G,153214305,130383,153148080,153541296,66225
4,ENSG00000118777.6,88158639,4-88152045-A-C,rs9999111,-1,A,C,88152045,6594,87962031,88355247,190014
4,ENSG00000118777.6,88158639,4-88152045-A-T,rs9999111,-1,A,T,88152045,6594,87962031,88355247,190014
4,ENSG00000118777.6,88158639,4-88152045-A-G,rs9999111,-1,A,G,88152045,6594,87962031,88355247,190014
4,ENSG00000152953.8,5051480,4-5235425-C-T,rs10000042,1,C,T,5235425,183945,4854872,5248088,380553
4,ENSG00000151729.5,185143266,4-185124378-C-T,rs10002793,1,C,T,185124378,18888,184946658,185339874,177720
4,ENSG00000109572.8,169620578,4-169674483-T-C,rs10006566,1,T,C,169674483,53905,169423970,169817186,250513
4,ENSG00000109572.8,169620578,4-169674483-T-G,rs10006566,1,T,G,169674483,53905,169423970,169817186,250513
4,ENSG00000109572.8,169620578,4-169674483-T-A,rs10006566,1,T,A,169674483,53905,169423970,169817186,250513
4,ENSG00000063978.10,2469106,4-2403280-T-G,rs10016059,1,T,G,2403280,65826,2272498,2665714,130782
4,ENSG00000063978.10,2469106,4-2403280-T-C,rs10016059,1,T,C,2403280,65826,2272498,2665714,130782
4,ENSG00000118564.10,15655357,4-15604808-T-C,rs10214,-1,T,C,15604808,50549,15458749,15851965,146059
4,ENSG00000163132.6,4859665,4-4790522-C-T,rs10937891,1,C,T,4790522,69143,4663057,5056273,127465
4,ENSG00000118777.6,88158639,4-88076931-G-T,rs10965,-1,G,T,88076931,81708,87962031,88355247,114900
4,ENSG00000118777.6,88158639,4-88076931-G-A,rs10965,-1,G,A,88076931,81708,87962031,88355247,114900
4,ENSG00000197712.6,38867806,4-38774870-T-G,rs11096957,1,T,G,38774870,92936,38671198,39064414,103672
4,ENSG00000145365.8,112285904,4-112300458-A-T,rs11098149,-1,A,T,112300458,14554,112089296,112482512,211162
4,ENSG00000145365.8,112285904,4-112300458-A-G,rs11098149,-1,A,G,112300458,14554,112089296,112482512,211162
4,ENSG00000171476.16,56681296,4-56637767-G-A,rs112996995,-1,G,A,56637767,43529,56484688,56877904,153079
4,ENSG00000174125.3,38804791,4-38774173-A-G,rs11466657,-1,A,G,38774173,30618,38608183,39001399,165990
4,ENSG00000164116.12,155666848,4-155731696-G-T,rs116089180,1,G,T,155731696,64848,155470240,155863456,261456
4,ENSG00000168538.10,183659293,4-183589937-A-G,rs116690444,1,A,G,183589937,69356,183462685,183855901,127252
4,ENSG00000163110.10,94451942,4-94542417-T-C,rs116717930,1,T,C,94542417,90475,94255334,94648550,287083
4,ENSG00000256043.2,155953866,4-155943599-C-T,rs11722604,-1,C,T,155943599,10267,155757258,156150474,186341
4,ENSG00000256043.2,155953866,4-155943599-C-A,rs11722604,-1,C,A,155943599,10267,155757258,156150474,186341
4,ENSG00000164038.10,103076761,4-103177448-G-A,rs11724309,-1,G,A,103177448,100687,102880153,103273369,297295
4,ENSG00000072832.9,5893086,4-5701903-C-A,rs11725145,-1,C,A,5701903,191183,5696478,6089694,5425
4,ENSG00000250312.2,124501,4-231159-T-C,rs11726829,1,T,C,231159,106658,-72107,321109,303266
4,ENSG00000138801.4,107720234,4-107750567-C-A,rs11732603,-1,C,A,107750567,30333,107523626,107916842,226941
4,ENSG00000138801.4,107720234,4-107750567-C-T,rs11732603,-1,C,T,107750567,30333,107523626,107916842,226941
4,ENSG00000255072.1,88523776,4-88374011-T-C,rs11733230,-1,T,C,88374011,149765,88327168,88720384,46843
4,ENSG00000255072.1,88523776,4-88374011-T-A,rs11733230,-1,T,A,88374011,149765,88327168,88720384,46843
4,ENSG00000138678.6,83536108,4-83555707-C-T,rs11733281,1,C,T,83555707,19599,83339500,83732716,216207
4,ENSG00000138663.4,83035183,4-83211721-G-A,rs11930374,1,G,A,83211721,176538,82838575,83231791,373146
4,ENSG00000109814.7,39527439,4-39413373-A-G,rs11940694,-1,A,G,39413373,114066,39330831,39724047,82542
4,ENSG00000071127.11,10116799,4-10118985-T-C,rs12374320,-1,T,C,10118985,2186,9920191,10313407,198794
4,ENSG00000071127.11,10116799,4-10118985-T-G,rs12374320,-1,T,G,10118985,2186,9920191,10313407,198794
4,ENSG00000071127.11,10116799,4-10118985-T-A,rs12374320,-1,T,A,10118985,2186,9920191,10313407,198794
4,ENSG00000145390.6,119212713,4-119053385-C-A,rs12506805,1,C,A,119053385,159328,119016105,119409321,37280
4,ENSG00000145390.6,119212713,4-119053385-C-T,rs12506805,1,C,T,119053385,159328,119016105,119409321,37280
4,ENSG00000163312.6,83455823,4-83363045-T-A,rs12507011,-1,T,A,83363045,92778,83259215,83652431,103830
4,ENSG00000163312.6,83455823,4-83363045-T-G,rs12507011,-1,T,G,83363045,92778,83259215,83652431,103830
4,ENSG00000163312.6,83455823,4-83363045-T-C,rs12507011,-1,T,C,83363045,92778,83259215,83652431,103830
4,ENSG00000164306.6,184649738,4-184650622-C-T,rs12507711,1,C,T,184650622,884,184453130,184846346,197492
4,ENSG00000152583.7,87529376,4-87517954-G-A,rs12640408,-1,G,A,87517954,11422,87332768,87725984,185186
4,ENSG00000145331.9,99564039,4-99530784-A-T,rs12640855,-1,A,T,99530784,33255,99367431,99760647,163353
4,ENSG00000145331.9,99564039,4-99530784-A-G,rs12640855,-1,A,G,99530784,33255,99367431,99760647,163353
4,ENSG00000050730.11,121164321,4-121236341-G-A,rs12642192,-1,G,A,121236341,72020,120967713,121360929,268628
4,ENSG00000050730.11,121164321,4-121236341-G-T,rs12642192,-1,G,T,121236341,72020,120967713,121360929,268628
4,ENSG00000138771.9,76435229,4-76527447-G-A,rs13105942,1,G,A,76527447,92218,76238621,76631837,288826
4,ENSG00000125388.14,2963571,4-2997373-C-A,rs13111777,1,C,A,2997373,33802,2766963,3160179,230410
4,ENSG00000033178.7,67701155,4-67721316-T-C,rs13126601,-1,T,C,67721316,20161,67504547,67897763,216769
4,ENSG00000033178.7,67701155,4-67721316-T-A,rs13126601,-1,T,A,67721316,20161,67504547,67897763,216769
4,ENSG00000155275.14,8440777,4-8520494-T-C,rs13127781,1,T,C,8520494,79717,8244169,8637385,276325
4,ENSG00000138686.5,121870474,4-121709462-G-A,rs13132345,-1,G,A,121709462,161012,121673866,122067082,35596
4,ENSG00000138686.5,121870474,4-121709462-G-T,rs13132345,-1,G,T,121709462,161012,121673866,122067082,35596
4,ENSG00000169019.9,47463702,4-47423916-T-C,rs13138813,-1,T,C,47423916,39786,47267094,47660310,156822
4,ENSG00000159692.11,1249130,4-1338387-A-T,rs13147602,-1,A,T,1338387,89257,1052522,1445738,285865
4,ENSG00000159692.11,1249130,4-1338387-A-C,rs13147602,-1,A,C,1338387,89257,1052522,1445738,285865
4,ENSG00000159692.11,1249130,4-1338387-A-G,rs13147602,-1,A,G,1338387,89257,1052522,1445738,285865
4,ENSG00000109163.6,67754388,4-67665885-A-C,rs13151552,-1,A,C,67665885,88503,67557780,67950996,108105
4,ENSG00000109163.6,67754388,4-67665885-A-T,rs13151552,-1,A,T,67665885,88503,67557780,67950996,108105
4,ENSG00000137441.7,15963175,4-16107473-T-A,rs1443367,-1,T,A,16107473,144298,15766567,16159783,340906
4,ENSG00000137441.7,15963175,4-16107473-T-C,rs1443367,-1,T,C,16107473,144298,15766567,16159783,340906
4,ENSG00000109674.3,177309874,4-177309672-G-C,rs1489953,1,G,C,177309672,202,177113266,177506482,196406
4,ENSG00000163281.6,44726556,4-44783372-G-T,rs1491313,-1,G,T,44783372,56816,44529948,44923164,253424
4,ENSG00000150625.12,175812264,4-175899114-C-A,rs1495712,-1,C,A,175899114,86850,175615656,176008872,283458
4,ENSG00000150625.12,175812264,4-175899114-C-T,rs1495712,-1,C,T,175899114,86850,175615656,176008872,283458
4,ENSG00000157426.8,56387491,4-56434391-C-T,rs1520026,-1,C,T,56434391,46900,56190883,56584099,243508
4,ENSG00000157426.8,56387491,4-56434391-C-A,rs1520026,-1,C,A,56434391,46900,56190883,56584099,243508
4,ENSG00000087008.10,8440723,4-8352102-A-G,rs1678272,-1,A,G,8352102,88621,8244115,8637331,107987
4,ENSG00000168826.11,4290251,4-4314697-A-G,rs16835578,1,A,G,4314697,24446,4093643,4486859,221054
4,ENSG00000163956.6,3532422,4-3492768-G-A,rs16844460,-1,G,A,3492768,39654,3335814,3729030,156954
4,ENSG00000169435.9,73620436,4-73734956-T-C,rs16849934,-1,T,C,73734956,114520,73423828,73817044,311128
4,ENSG00000169435.9,73620436,4-73734956-T-G,rs16849934,-1,T,G,73734956,114520,73423828,73817044,311128
4,ENSG00000152990.9,22516066,4-22645441-T-C,rs16872876,-1,T,C,22645441,129375,22319458,22712674,325983
4,ENSG00000078177.8,40056850,4-40211942-G-A,rs16995625,1,G,A,40211942,155092,39860242,40253458,351700
4,ENSG00000152784.9,80197503,4-80263187-A-G,rs16998073,1,A,G,80263187,65684,80000895,80394111,262292
4,ENSG00000152784.9,80197503,4-80263187-A-T,rs16998073,1,A,T,80263187,65684,80000895,80394111,262292
4,ENSG00000152784.9,80197503,4-80263187-A-C,rs16998073,1,A,C,80263187,65684,80000895,80394111,262292
4,ENSG00000152795.12,82430462,4-82560571-A-G,rs17005806,-1,A,G,82560571,130109,82233854,82627070,326717
4,ENSG00000168785.3,98658611,4-98614277-T-C,rs17027858,-1,T,C,98614277,44334,98462003,98855219,152274
4,ENSG00000168772.9,104494894,4-104657130-A-G,rs17034785,-1,A,G,104657130,162236,104298286,104691502,358844
4,ENSG00000109265.7,56049098,4-55913916-A-G,rs17086165,1,A,G,55913916,135182,55852490,56245706,61426
4,ENSG00000109685.13,1871393,4-1941444-G-A,rs17132088,1,G,A,1941444,70051,1674785,2068001,266659
4,ENSG00000052795.8,158769026,4-158833208-T-C,rs17285772,1,T,C,158833208,64182,158572418,158965634,260790
4,ENSG00000163629.7,86594315,4-86674669-G-A,rs17419675,1,G,A,86674669,80354,86397707,86790923,276962
4,ENSG00000181826.5,37686376,4-37613989-G-C,rs17423188,-1,G,C,37613989,72387,37489768,37882984,124221
4,ENSG00000181826.5,37686376,4-37613989-G-A,rs17423188,-1,G,A,37613989,72387,37489768,37882984,124221
4,ENSG00000138796.10,107989889,4-108057560-C-A,rs17511536,1,C,A,108057560,67671,107793281,108186497,264279
4,ENSG00000145358.2,100190468,4-100193076-T-C,rs17544029,-1,T,C,100193076,2608,99993860,100387076,199216
4,ENSG00000188993.3,52020363,4-52129893-A-C,rs17612170,-1,A,C,52129893,109530,51823755,52216971,306138
4,ENSG00000188993.3,52020363,4-52129893-A-T,rs17612170,-1,A,T,52129893,109530,51823755,52216971,306138
4,ENSG00000178403.3,112516180,4-112409616-T-C,rs17628268,-1,T,C,112409616,106564,112319572,112712788,90044
4,ENSG00000178343.4,42397488,4-42447664-A-G,rs17630450,1,A,G,42447664,50176,42200880,42594096,246784
4,ENSG00000177432.5,88697829,4-88727319-A-C,rs1801918,-1,A,C,88727319,29490,88501221,88894437,226098
4,ENSG00000137449.10,15002481,4-14969531-T-C,rs1874205,1,T,C,14969531,32950,14805873,15199089,163658
4,ENSG00000189157.8,76251721,4-76296659-T-C,rs1876533,1,T,C,76296659,44938,76055113,76448329,241546
4,ENSG00000189157.8,76251721,4-76296659-T-G,rs1876533,1,T,G,76296659,44938,76055113,76448329,241546
4,ENSG00000189157.8,76251721,4-76296659-T-A,rs1876533,1,T,A,76296659,44938,76055113,76448329,241546
4,ENSG00000121897.9,39459056,4-39429349-C-T,rs1979283,1,C,T,39429349,29707,39262448,39655664,166901
4,ENSG00000121897.9,39459056,4-39429349-C-A,rs1979283,1,C,A,39429349,29707,39262448,39655664,166901
4,ENSG00000109321.6,74445136,4-74282653-T-C,rs2045616,1,T,C,74282653,162483,74248528,74641744,34125
4,ENSG00000181381.9,168480492,4-168376849-T-C,rs2046770,-1,T,C,168376849,103643,168283884,168677100,92965
4,ENSG00000171566.7,154550400,4-154583342-G-A,rs2070034,-1,G,A,154583342,32942,154353792,154747008,229550
4,ENSG00000170522.5,110198615,4-110008573-C-T,rs2074391,-1,C,T,110008573,190042,110002007,110395223,6566
4,ENSG00000150627.9,176065841,4-176195758-G-T,rs2170577,1,G,T,176195758,129917,175869233,176262449,326525
4,ENSG00000150627.9,176065841,4-176195758-G-C,rs2170577,1,G,C,176195758,129917,175869233,176262449,326525
4,ENSG00000150627.9,176065841,4-176195758-G-A,rs2170577,1,G,A,176195758,129917,175869233,176262449,326525
4,ENSG00000109519.7,7068064,4-7004814-G-A,rs2301819,-1,G,A,7004814,63250,6871456,7264672,133358
4,ENSG00000109519.7,7068064,4-7004814-G-T,rs2301819,-1,G,T,7004814,63250,6871456,7264672,133358
4,ENSG00000164111.9,121696980,4-121696533-T-C,rs2306416,-1,T,C,121696533,447,121500372,121893588,196161
4,ENSG00000154556.13,185656969,4-185776340-T-C,rs2310357,-1,T,C,185776340,119371,185460361,185853577,315979
4,ENSG00000154556.13,185656969,4-185776340-T-G,rs2310357,-1,T,G,185776340,119371,185460361,185853577,315979
4,ENSG00000154556.13,185656969,4-185776340-T-A,rs2310357,-1,T,A,185776340,119371,185460361,185853577,315979
4,ENSG00000151552.7,17512090,4-17500784-A-G,rs2518616,-1,A,G,17500784,11306,17315482,17708698,185302
4,ENSG00000172007.5,139454121,4-139520991-A-C,rs2592980,1,A,C,139520991,66870,139257513,139650729,263478
4,ENSG00000172007.5,139454121,4-139520991-A-G,rs2592980,1,A,G,139520991,66870,139257513,139650729,263478
4,ENSG00000138722.5,89894854,4-89812518-A-G,rs2619369,1,A,G,89812518,82336,89698246,90091462,114272
4,ENSG00000153064.7,101790730,4-101958164-G-A,rs2631246,1,G,A,101958164,167434,101594122,101987338,364042
4,ENSG00000163071.6,52051304,4-52070758-T-C,rs2680907,1,T,C,52070758,19454,51854696,52247912,216062
4,ENSG00000163071.6,52051304,4-52070758-T-G,rs2680907,1,T,G,52070758,19454,51854696,52247912,216062
4,ENSG00000163071.6,52051304,4-52070758-T-A,rs2680907,1,T,A,52070758,19454,51854696,52247912,216062
4,ENSG00000196620.4,68670652,4-68482946-A-G,rs2708695,-1,A,G,68482946,187706,68474044,68867260,8902
4,ENSG00000197888.2,68576322,4-68482946-A-G,rs2708695,-1,A,G,68482946,93376,68379714,68772930,103232
4,ENSG00000121895.7,39032409,4-39134753-G-T,rs28396323,-1,G,T,39134753,102344,38835801,39229017,298952
4,ENSG00000121895.7,39032409,4-39134753-G-A,rs28396323,-1,G,A,39134753,102344,38835801,39229017,298952
4,ENSG00000189184.7,137532494,4-137559814-G-A,rs28505426,-1,G,A,137559814,27320,137335886,137729102,223928
4,ENSG00000138685.7,122826831,4-122854222-A-G,rs28544074,1,A,G,122854222,27391,122630223,123023439,223999
4,ENSG00000205129.4,185426254,4-185465257-G-T,rs28564799,1,G,T,185465257,39003,185229646,185622862,235611
4,ENSG00000163644.9,88284561,4-88218680-C-T,rs2904185,-1,C,T,88218680,65881,88087953,88481169,130727
4,ENSG00000163644.9,88284561,4-88218680-C-G,rs2904185,-1,C,G,88218680,65881,88087953,88481169,130727
4,ENSG00000065882.9,37891084,4-37790550-T-C,rs2911901,1,T,C,37790550,100534,37694476,38087692,96074
4,ENSG00000065882.9,37891084,4-37790550-T-G,rs2911901,1,T,G,37790550,100534,37694476,38087692,96074
4,ENSG00000065882.9,37891084,4-37790550-T-A,rs2911901,1,T,A,37790550,100534,37694476,38087692,96074
4,ENSG00000132406.7,4248223,4-4194719-A-G,rs2920172,-1,A,G,4194719,53504,4051615,4444831,143104
4,ENSG00000132406.7,4248223,4-4194719-A-C,rs2920172,-1,A,C,4194719,53504,4051615,4444831,143104
4,ENSG00000132406.7,4248223,4-4194719-A-T,rs2920172,-1,A,T,4194719,53504,4051615,4444831,143104
4,ENSG00000154274.10,37453925,4-37467452-A-C,rs2973235,1,A,C,37467452,13527,37257317,37650533,210135
4,ENSG00000154274.10,37453925,4-37467452-A-T,rs2973235,1,A,T,37467452,13527,37257317,37650533,210135
4,ENSG00000154274.10,37453925,4-37467452-A-G,rs2973235,1,A,G,37467452,13527,37257317,37650533,210135
4,ENSG00000007062.7,16084023,4-16120132-T-C,rs317881,-1,T,C,16120132,36109,15887415,16280631,232717
4,ENSG00000014824.7,41990530,4-42029905-G-T,rs34936554,1,G,T,42029905,39375,41793922,42187138,235983
4,ENSG00000145476.10,186191567,4-186191156-G-A,rs35641294,1,G,A,186191156,411,185994959,186388175,196197
4,ENSG00000137463.4,139280225,4-139108229-A-G,rs35814515,-1,A,G,139108229,171996,139083617,139476833,24612
4,ENSG00000090989.13,55853648,4-55919305-A-G,rs36124169,1,A,G,55919305,65657,55657040,56050256,262265
4,ENSG00000159733.9,2418645,4-2467872-C-G,rs3762830,-1,C,G,2467872,49227,2222037,2615253,245835
4,ENSG00000145214.9,973569,4-899732-G-A,rs3775121,-1,G,A,899732,73837,776961,1170177,122771
4,ENSG00000145214.9,973569,4-899732-G-C,rs3775121,-1,G,C,899732,73837,776961,1170177,122771
4,ENSG00000118804.7,76306733,4-76307612-T-C,rs3796490,1,T,C,76307612,879,76110125,76503341,197487
4,ENSG00000118804.7,76306733,4-76307612-T-G,rs3796490,1,T,G,76307612,879,76110125,76503341,197487
4,ENSG00000137462.6,153684280,4-153703504-T-C,rs3804099,1,T,C,153703504,19224,153487672,153880888,215832
4,ENSG00000109436.7,140756385,4-140570619-T-G,rs3811791,-1,T,G,140570619,185766,140559777,140952993,10842
4,ENSG00000109436.7,140756385,4-140570619-T-C,rs3811791,-1,T,C,140570619,185766,140559777,140952993,10842
4,ENSG00000118816.5,77075989,4-77053392-C-T,rs4241599,-1,C,T,77053392,22597,76879381,77272597,174011
4,ENSG00000118816.5,77075989,4-77053392-C-A,rs4241599,-1,C,A,77053392,22597,76879381,77272597,174011
4,ENSG00000173085.9,83284798,4-83322396-A-G,rs4328905,-1,A,G,83322396,37598,83088190,83481406,234206
4,ENSG00000173085.9,83284798,4-83322396-A-T,rs4328905,-1,A,T,83322396,37598,83088190,83481406,234206
4,ENSG00000181982.11,24913042,4-25026536-G-C,rs4428268,-1,G,C,25026536,113494,24716434,25109650,310102
4,ENSG00000181982.11,24913042,4-25026536-G-T,rs4428268,-1,G,T,25026536,113494,24716434,25109650,310102
4,ENSG00000181982.11,24913042,4-25026536-G-A,rs4428268,-1,G,A,25026536,113494,24716434,25109650,310102
4,ENSG00000127418.9,1011626,4-990021-C-T,rs4690221,1,C,T,990021,21605,815018,1208234,175003
4,ENSG00000127418.9,1011626,4-990021-C-G,rs4690221,1,C,G,990021,21605,815018,1208234,175003
4,ENSG00000138668.13,82373991,4-82228325-G-A,rs4693026,-1,G,A,82228325,145666,82177383,82570599,50942
4,ENSG00000109684.9,10684768,4-10558193-A-C,rs4698070,-1,A,C,10558193,126575,10488160,10881376,70033
4,ENSG00000109684.9,10684768,4-10558193-A-T,rs4698070,-1,A,T,10558193,126575,10488160,10881376,70033
4,ENSG00000109684.9,10684768,4-10558193-A-G,rs4698070,-1,A,G,10558193,126575,10488160,10881376,70033
4,ENSG00000169245.4,76023497,4-75985821-T-G,rs4859581,-1,T,G,75985821,37676,75826889,76220105,158932
4,ENSG00000169245.4,76023497,4-75985821-T-A,rs4859581,-1,T,A,75985821,37676,75826889,76220105,158932
4,ENSG00000169245.4,76023497,4-75985821-T-C,rs4859581,-1,T,C,75985821,37676,75826889,76220105,158932
4,ENSG00000138772.8,78551770,4-78567116-G-A,rs4975147,1,G,A,78567116,15346,78355162,78748378,211954
4,ENSG00000138772.8,78551770,4-78567116-G-C,rs4975147,1,G,C,78567116,15346,78355162,78748378,211954
4,ENSG00000109794.9,186104704,4-186082605-T-G,rs5743317,1,T,G,186082605,22099,185908096,186301312,174509
4,ENSG00000138755.5,76007509,4-75924115-T-C,rs58239288,-1,T,C,75924115,83394,75810901,76204117,113214
4,ENSG00000173040.8,5708559,4-5706151-A-C,rs58983068,-1,A,C,5706151,2408,5511951,5905167,194200
4,ENSG00000173040.8,5708559,4-5706151-A-T,rs58983068,-1,A,T,5706151,2408,5511951,5905167,194200
4,ENSG00000138777.15,105474062,4-105436578-G-A,rs62317260,-1,G,A,105436578,37484,105277454,105670670,159124
4,ENSG00000091490.6,25862988,4-25950031-G-A,rs62409317,-1,G,A,25950031,87043,25666380,26059596,283651
4,ENSG00000132465.6,70666508,4-70604236-C-T,rs6422713,-1,C,T,70604236,62272,70469900,70863116,134336
4,ENSG00000013288.4,6575189,4-6607129-T-C,rs6446514,1,T,C,6607129,31940,6378581,6771797,228548
4,ENSG00000183423.6,109848107,4-109879276-G-C,rs6533472,1,G,C,109879276,31169,109651499,110044715,227777
4,ENSG00000183423.6,109848107,4-109879276-G-A,rs6533472,1,G,A,109879276,31169,109651499,110044715,227777
4,ENSG00000184178.11,53366061,4-53485520-A-G,rs6810557,-1,A,G,53485520,119459,53169453,53562669,316067
4,ENSG00000184178.11,53366061,4-53485520-A-C,rs6810557,-1,A,C,53485520,119459,53169453,53562669,316067
4,ENSG00000174796.8,75514473,4-75520720-A-C,rs6813654,1,A,C,75520720,6247,75317865,75711081,202855
4,ENSG00000174796.8,75514473,4-75520720-A-G,rs6813654,1,A,G,75520720,6247,75317865,75711081,202855
4,ENSG00000174796.8,75514473,4-75520720-A-T,rs6813654,1,A,T,75520720,6247,75317865,75711081,202855
4,ENSG00000170801.5,8269754,4-8155255-T-G,rs6816775,1,T,G,8155255,114499,8073146,8466362,82109
4,ENSG00000138744.8,75941013,4-75917955-C-T,rs6819442,-1,C,T,75917955,23058,75744405,76137621,173550
4,ENSG00000138744.8,75941013,4-75917955-C-G,rs6819442,-1,C,G,75917955,23058,75744405,76137621,173550
4,ENSG00000174130.7,38856817,4-38752568-G-T,rs6824105,-1,G,T,38752568,104249,38660209,39053425,92359
4,ENSG00000174130.7,38856817,4-38752568-G-A,rs6824105,-1,G,A,38752568,104249,38660209,39053425,92359
4,ENSG00000197057.4,36281616,4-36093897-G-A,rs6833926,1,G,A,36093897,187719,36085008,36478224,8889
4,ENSG00000145246.8,47485275,4-47554287-A-G,rs6843438,1,A,G,47554287,69012,47288667,47681883,265620
4,ENSG00000170365.5,145481853,4-145470681-T-C,rs6845722,1,T,C,145470681,11172,145285245,145678461,185436
4,ENSG00000128040.6,56821701,4-56882914-T-C,rs6848165,-1,T,C,56882914,61213,56625093,57018309,257821
4,ENSG00000174607.6,114598807,4-114623558-A-G,rs6851610,1,A,G,114623558,24751,114402199,114795415,221359
4,ENSG00000174607.6,114598807,4-114623558-A-T,rs6851610,1,A,T,114623558,24751,114402199,114795415,221359
4,ENSG00000056050.6,169757944,4-169733497-A-G,rs6854083,-1,A,G,169733497,24447,169561336,169954552,172161
4,ENSG00000164124.6,158210486,4-158385278-G-A,rs72691411,1,G,A,158385278,174792,158013878,158407094,371400
4,ENSG00000138640.10,89057185,4-88868504-C-T,rs72872196,-1,C,T,88868504,188681,88860577,89253793,7927
4,ENSG00000178950.11,932316,4-954279-G-A,rs73209899,-1,G,A,954279,21963,735708,1128924,218571
4,ENSG00000169429.6,73740569,4-73837982-C-T,rs73828860,1,C,T,73837982,97413,73543961,73937177,294021
4,ENSG00000174137.8,1684313,4-1725329-G-A,rs74776016,-1,G,A,1725329,41016,1487705,1880921,237624
4,ENSG00000175920.11,3463306,4-3526473-T-C,rs762870,1,T,C,3526473,63167,3266698,3659914,259775
4,ENSG00000109790.11,39062232,4-39140797-G-A,rs76510496,1,G,A,39140797,78565,38865624,39258840,275173
4,ENSG00000074966.6,48134250,4-48253039-T-A,rs7669018,-1,T,A,48253039,118789,47937642,48330858,315397
4,ENSG00000074966.6,48134250,4-48253039-T-C,rs7669018,-1,T,C,48253039,118789,47937642,48330858,315397
4,ENSG00000185477.3,89307800,4-89297070-G-A,rs7671122,-1,G,A,89297070,10730,89111192,89504408,185878
4,ENSG00000198189.6,87391188,4-87427870-G-T,rs7673763,-1,G,T,87427870,36682,87194580,87587796,233290
4,ENSG00000250317.3,25914220,4-25880255-C-T,rs7681279,1,C,T,25880255,33965,25717612,26110828,162643
4,ENSG00000038002.4,177442437,4-177443649-T-C,rs7682705,-1,T,C,177443649,1212,177245829,177639045,197820
4,ENSG00000038002.4,177442437,4-177443649-T-A,rs7682705,-1,T,A,177443649,1212,177245829,177639045,197820
4,ENSG00000197894.6,99088788,4-99083075-C-G,rs7683704,-1,C,G,99083075,5713,98892180,99285396,190895
4,ENSG00000197894.6,99088788,4-99083075-C-T,rs7683704,-1,C,T,99083075,5713,98892180,99285396,190895
4,ENSG00000168743.8,105895471,4-105743398-C-A,rs7685231,1,C,A,105743398,152073,105698863,106092079,44535
4,ENSG00000168743.8,105895471,4-105743398-C-T,rs7685231,1,C,T,105743398,152073,105698863,106092079,44535
4,ENSG00000168743.8,105895471,4-105743398-C-G,rs7685231,1,C,G,105743398,152073,105698863,106092079,44535
4,ENSG00000198498.5,163494690,4-163300134-C-T,rs7688754,1,C,T,163300134,194556,163298082,163691298,2052
4,ENSG00000198498.5,163494690,4-163300134-C-G,rs7688754,1,C,G,163300134,194556,163298082,163691298,2052
4,ENSG00000109133.8,41935429,4-42108378-A-T,rs7692068,1,A,T,42108378,172949,41738821,42132037,369557
4,ENSG00000137601.11,169612583,4-169654700-C-T,rs7697855,-1,C,T,169654700,42117,169415975,169809191,238725
4,ENSG00000137601.11,169612583,4-169654700-C-A,rs7697855,-1,C,A,169654700,42117,169415975,169809191,238725
4,ENSG00000061918.8,155759021,4-155689837-G-A,rs77482346,1,G,A,155689837,69184,155562413,155955629,127424
4,ENSG00000145348.11,106316209,4-106152764-G-A,rs78104935,-1,G,A,106152764,163445,106119601,106512817,33163
4,ENSG00000151611.8,145619385,4-145452738-A-G,rs78243498,1,A,G,145452738,166647,145422777,145815993,29961
4,ENSG00000109475.12,108620576,4-108746093-T-C,rs78789065,1,T,C,108746093,125517,108423968,108817184,322125
4,ENSG00000151470.7,129096152,4-129215768-C-T,rs79088961,1,C,T,129215768,119616,128899544,129292760,316224
4,ENSG00000151470.7,129096152,4-129215768-C-A,rs79088961,1,C,A,129215768,119616,128899544,129292760,316224
4,ENSG00000151470.7,129096152,4-129215768-C-G,rs79088961,1,C,G,129215768,119616,128899544,129292760,316224
4,ENSG00000198856.8,108650599,4-108525913-T-G,rs79765393,1,T,G,108525913,124686,108453991,108847207,71922
4,ENSG00000198856.8,108650599,4-108525913-T-C,rs79765393,1,T,C,108525913,124686,108453991,108847207,71922
4,ENSG00000085871.4,139665819,4-139664596-A-C,rs8192002,1,A,C,139664596,1223,139469211,139862427,195385
4,ENSG00000085871.4,139665819,4-139664596-A-G,rs8192002,1,A,G,139664596,1223,139469211,139862427,195385
4,ENSG00000163138.13,20700458,4-20620067-G-A,rs8663,1,G,A,20620067,80391,20503850,20897066,116217
4,ENSG00000151725.6,184734096,4-184734017-C-T,rs902174,-1,C,T,184734017,79,184537488,184930704,196529
4,ENSG00000151725.6,184734096,4-184734017-C-A,rs902174,-1,C,A,184734017,79,184537488,184930704,196529
4,ENSG00000109180.10,48831088,4-48845842-A-G,rs9291326,1,A,G,48845842,14754,48634480,49027696,211362
4,ENSG00000151726.8,184825968,4-184827040-A-T,rs9686055,-1,A,T,184827040,1072,184629360,185022576,197680
4,ENSG00000151726.8,184825968,4-184827040-A-G,rs9686055,-1,A,G,184827040,1072,184629360,185022576,197680
4,ENSG00000170509.7,87322882,4-87459928-T-C,rs9968511,-1,T,C,87459928,137046,87126274,87519490,333654
4,ENSG00000170509.7,87322882,4-87459928-T-A,rs9968511,-1,T,A,87459928,137046,87126274,87519490,333654
4,ENSG00000121892.10,39977911,4-39804876-C-G,rs9992906,-1,C,G,39804876,173035,39781303,40174519,23573
4,ENSG00000121892.10,39977911,4-39804876-C-T,rs9992906,-1,C,T,39804876,173035,39781303,40174519,23573
4,ENSG00000109332.15,102827551,4-102705676-T-C,rs9993014,-1,T,C,102705676,121875,102630943,103024159,74733
4,ENSG00000109689.10,26860841,4-26879017-T-C,rs9999056,1,T,C,26879017,18176,26664233,27057449,214784
3,ENSG00000114554.7,126983115,3-126961512-T-A,rs1007390,1,T,A,126961512,21603,126786507,127179723,175005
3,ENSG00000114554.7,126983115,3-126961512-T-C,rs1007390,1,T,C,126961512,21603,126786507,127179723,175005
3,ENSG00000206535.3,100401539,3-100403237-C-T,rs1036769,1,C,T,100403237,1698,100204931,100598147,198306
3,ENSG00000010322.10,52455604,3-52307110-G-A,rs10461027,1,G,A,52307110,148494,52258996,52652212,48114
3,ENSG00000010322.10,52455604,3-52307110-G-T,rs10461027,1,G,T,52307110,148494,52258996,52652212,48114
3,ENSG00000163931.10,53256022,3-53363454-C-A,rs10510763,-1,C,A,53363454,107432,53059414,53452630,304040
3,ENSG00000163931.10,53256022,3-53363454-C-T,rs10510763,-1,C,T,53363454,107432,53059414,53452630,304040
3,ENSG00000154165.3,98531978,3-98573022-G-T,rs10511168,1,G,T,98573022,41044,98335370,98728586,237652
3,ENSG00000180353.6,121660903,3-121849748-C-T,rs10511407,-1,C,T,121849748,188845,121464295,121857511,385453
3,ENSG00000058056.4,179653040,3-179529397-G-A,rs10513760,1,G,A,179529397,123643,179456432,179849648,72965
3,ENSG00000136522.9,179604638,3-179570491-G-A,rs10513761,-1,G,A,179570491,34147,179408030,179801246,162461
3,ENSG00000136518.11,179562926,3-179668956-A-G,rs10513763,1,A,G,179668956,106030,179366318,179759534,302638
3,ENSG00000188001.5,189171971,3-189317032-A-G,rs10513835,1,A,G,189317032,145061,188975363,189368579,341669
3,ENSG00000127249.10,193554895,3-193579146-A-T,rs10804955,-1,A,T,193579146,24251,193358287,193751503,220859
3,ENSG00000127249.10,193554895,3-193579146-A-C,rs10804955,-1,A,C,193579146,24251,193358287,193751503,220859
3,ENSG00000178750.2,94028597,3-94093949-G-T,rs10934674,-1,G,T,94093949,65352,93831989,94225205,261960
3,ENSG00000091513.10,133746393,3-133564240-G-A,rs10935069,1,G,A,133564240,182153,133549785,133943001,14455
3,ENSG00000114054.9,136250340,3-136132235-A-C,rs10935177,1,A,C,136132235,118105,136053732,136446948,78503
3,ENSG00000114054.9,136250340,3-136132235-A-T,rs10935177,1,A,T,136132235,118105,136053732,136446948,78503
3,ENSG00000114054.9,136250340,3-136132235-A-G,rs10935177,1,A,G,136132235,118105,136053732,136446948,78503
3,ENSG00000175040.4,143119771,3-143171550-T-A,rs10935483,1,T,A,143171550,51779,142923163,143316379,248387
3,ENSG00000175040.4,143119771,3-143171550-T-C,rs10935483,1,T,C,143171550,51779,142923163,143316379,248387
3,ENSG00000181458.6,100492619,3-100522001-G-T,rs10936221,1,G,T,100522001,29382,100296011,100689227,225990
3,ENSG00000181458.6,100492619,3-100522001-G-A,rs10936221,1,G,A,100522001,29382,100296011,100689227,225990
3,ENSG00000181458.6,100492619,3-100522001-G-C,rs10936221,1,G,C,100522001,29382,100296011,100689227,225990
3,ENSG00000175193.8,183884880,3-183845137-G-T,rs10937153,-1,G,T,183845137,39743,183688272,184081488,156865
3,ENSG00000175193.8,183884880,3-183845137-G-A,rs10937153,-1,G,A,183845137,39743,183688272,184081488,156865
3,ENSG00000163938.12,52686032,3-52862839-C-G,rs11130329,1,C,G,52862839,176807,52489424,52882640,373415
3,ENSG00000163938.12,52686032,3-52862839-C-A,rs11130329,1,C,A,52862839,176807,52489424,52882640,373415
3,ENSG00000132170.15,12289070,3-12333892-T-G,rs1122648,1,T,G,12333892,44822,12092462,12485678,241430
3,ENSG00000132170.15,12289070,3-12333892-T-C,rs1122648,1,T,C,12333892,44822,12092462,12485678,241430
3,ENSG00000144827.4,111979026,3-111992747-A-G,rs1127853,1,A,G,111992747,13721,111782418,112175634,210329
3,ENSG00000144827.4,111979026,3-111992747-A-C,rs1127853,1,A,C,111992747,13721,111782418,112175634,210329
3,ENSG00000163576.13,19934217,3-19946047-G-C,rs1133328,-1,G,C,19946047,11830,19737609,20130825,208438
3,ENSG00000163576.13,19934217,3-19946047-G-T,rs1133328,-1,G,T,19946047,11830,19737609,20130825,208438
3,ENSG00000144837.4,119597885,3-119601041-T-C,rs113440101,1,T,C,119601041,3156,119401277,119794493,199764
3,ENSG00000197885.6,23916990,3-23892999-T-C,rs1136155,-1,T,C,23892999,23991,23720382,24113598,172617
3,ENSG00000173226.12,121835060,3-121788384-A-T,rs1141528,-1,A,T,121788384,46676,121638452,122031668,149932
3,ENSG00000134070.4,10164919,3-10192381-G-T,rs1144911,1,G,T,10192381,27462,9968311,10361527,224070
3,ENSG00000134070.4,10164919,3-10192381-G-A,rs1144911,1,G,A,10192381,27462,9968311,10361527,224070
3,ENSG00000131375.5,15206246,3-15349904-C-A,rs114570696,1,C,A,15349904,143658,15009638,15402854,340266
3,ENSG00000131375.5,15206246,3-15349904-C-T,rs114570696,1,C,T,15349904,143658,15009638,15402854,340266
3,ENSG00000154783.6,14818962,3-14999695-G-A,rs114914052,1,G,A,14999695,180733,14622354,15015570,377341
3,ENSG00000114019.10,134374447,3-134299939-G-A,rs114991340,-1,G,A,134299939,74508,134177839,134571055,122100
3,ENSG00000114019.10,134374447,3-134299939-G-C,rs114991340,-1,G,C,134299939,74508,134177839,134571055,122100
3,ENSG00000080200.5,97822011,3-97941240-C-T,rs11544446,1,C,T,97941240,119229,97625403,98018619,315837
3,ENSG00000196220.9,9249646,3-9365020-G-A,rs11547584,-1,G,A,9365020,115374,9053038,9446254,311982
3,ENSG00000134072.6,9769947,3-9690321-T-C,rs115679775,-1,T,C,9690321,79626,9573339,9966555,116982
3,ENSG00000114126.13,142149544,3-142012868-G-A,rs11569181,-1,G,A,142012868,136676,141952936,142346152,59932
3,ENSG00000178567.5,36993131,3-36966744-C-T,rs116097543,-1,C,T,36966744,26387,36796523,37189739,170221
3,ENSG00000178567.5,36993131,3-36966744-C-G,rs116097543,-1,C,G,36966744,26387,36796523,37189739,170221
3,ENSG00000131389.12,14402606,3-14495227-G-T,rs116285841,1,G,T,14495227,92621,14205998,14599214,289229
3,ENSG00000131389.12,14402606,3-14495227-G-A,rs116285841,1,G,A,14495227,92621,14205998,14599214,289229
3,ENSG00000077092.13,25428263,3-25538424-A-G,rs11707637,1,A,G,25538424,110161,25231655,25624871,306769
3,ENSG00000077092.13,25428263,3-25538424-A-C,rs11707637,1,A,C,25538424,110161,25231655,25624871,306769
3,ENSG00000077092.13,25428263,3-25538424-A-T,rs11707637,1,A,T,25538424,110161,25231655,25624871,306769
3,ENSG00000144711.8,13073429,3-13224683-G-A,rs11707839,-1,G,A,13224683,151254,12876821,13270037,347862
3,ENSG00000163520.9,13549125,3-13692125-G-A,rs11708412,1,G,A,13692125,143000,13352517,13745733,339608
3,ENSG00000114739.8,38453890,3-38529798-C-T,rs11711260,1,C,T,38529798,75908,38257282,38650498,272516
3,ENSG00000164045.7,48188417,3-47998793-C-T,rs11711953,-1,C,T,47998793,189624,47991809,48385025,6984
3,ENSG00000169087.6,122793831,3-122785194-A-G,rs11712252,-1,A,G,122785194,8637,122597223,122990439,187971
3,ENSG00000169087.6,122793831,3-122785194-A-T,rs11712252,-1,A,T,122785194,8637,122597223,122990439,187971
3,ENSG00000126062.3,50359521,3-50407420-C-T,rs11712474,-1,C,T,50407420,47899,50162913,50556129,244507
3,ENSG00000114631.9,127629185,3-127654743-A-G,rs11714815,1,A,G,127654743,25558,127432577,127825793,222166
3,ENSG00000172113.4,48301367,3-48321260-C-T,rs11716371,-1,C,T,48321260,19893,48104759,48497975,216501
3,ENSG00000164068.10,49689557,3-49771548-C-T,rs11717463,1,C,T,49771548,81991,49492949,49886165,278599
3,ENSG00000145194.13,184276022,3-184443627-C-A,rs11718215,1,C,A,184443627,167605,184079414,184472630,364213
3,ENSG00000145194.13,184276022,3-184443627-C-G,rs11718215,1,C,G,184443627,167605,184079414,184472630,364213
3,ENSG00000213689.5,48466230,3-48467186-T-C,rs11797,1,T,C,48467186,956,48269622,48662838,197564
3,ENSG00000078070.6,183099496,3-183018516-A-T,rs11917378,-1,A,T,183018516,80980,182902888,183296104,115628
3,ENSG00000078070.6,183099496,3-183018516-A-C,rs11917378,-1,A,C,183018516,80980,182902888,183296104,115628
3,ENSG00000078070.6,183099496,3-183018516-A-G,rs11917378,-1,A,G,183018516,80980,182902888,183296104,115628
3,ENSG00000198843.8,150603321,3-150537598-A-G,rs11921309,1,A,G,150537598,65723,150406713,150799929,130885
3,ENSG00000196542.4,161371517,3-161298599-A-T,rs12108169,-1,A,T,161298599,72918,161174909,161568125,123690
3,ENSG00000114021.6,100334757,3-100346788-G-T,rs1214375,1,G,T,100346788,12031,100138149,100531365,208639
3,ENSG00000114021.6,100334757,3-100346788-G-A,rs1214375,1,G,A,100346788,12031,100138149,100531365,208639
3,ENSG00000114423.14,105869012,3-105917188-C-T,rs12491881,-1,C,T,105917188,48176,105672404,106065620,244784
3,ENSG00000114423.14,105869012,3-105917188-C-A,rs12491881,-1,C,A,105917188,48176,105672404,106065620,244784
3,ENSG00000174928.9,155806278,3-155946166-A-G,rs12493934,-1,A,G,155946166,139888,155609670,156002886,336496
3,ENSG00000154174.6,100401089,3-100364013-C-G,rs12591,-1,C,G,100364013,37076,100204481,100597697,159532
3,ENSG00000154174.6,100401089,3-100364013-C-A,rs12591,-1,C,A,100364013,37076,100204481,100597697,159532
3,ENSG00000163320.6,88059005,3-88122078-A-C,rs12629581,-1,A,C,88122078,63073,87862397,88255613,259681
3,ENSG00000153551.9,32391853,3-32314373-A-G,rs12629727,1,A,G,32314373,77480,32195245,32588461,119128
3,ENSG00000011376.5,45388576,3-45518621-A-G,rs12630693,1,A,G,45518621,130045,45191968,45585184,326653
3,ENSG00000119227.3,196968833,3-196948008-A-G,rs12636891,-1,A,G,196948008,20825,196772225,197165441,175783
3,ENSG00000119227.3,196968833,3-196948008-A-C,rs12636891,-1,A,C,196948008,20825,196772225,197165441,175783
3,ENSG00000198919.7,108589722,3-108689767-C-T,rs13059124,1,C,T,108689767,100045,108393114,108786330,296653
3,ENSG00000163584.13,170870195,3-170865099-C-T,rs13063927,-1,C,T,170865099,5096,170673587,171066803,191512
3,ENSG00000164054.10,48504174,3-48436629-T-C,rs13069724,-1,T,C,48436629,67545,48307566,48700782,129063
3,ENSG00000177646.12,128879620,3-128848099-C-T,rs13088146,1,C,T,128848099,31521,128683012,129076228,165087
3,ENSG00000177646.12,128879620,3-128848099-C-A,rs13088146,1,C,A,128848099,31521,128683012,129076228,165087
3,ENSG00000244607.1,42773253,3-42771455-C-T,rs13090185,-1,C,T,42771455,1798,42576645,42969861,194810
3,ENSG00000184897.4,129316286,3-129326057-A-G,rs13095008,-1,A,G,129326057,9771,129119678,129512894,206379
3,ENSG00000163755.4,149129638,3-149197375-A-G,rs13095262,1,A,G,149197375,67737,148933030,149326246,264345
3,ENSG00000182568.11,18425339,3-18441066-T-C,rs1328542,-1,T,C,18441066,15727,18228731,18621947,212335
3,ENSG00000182568.11,18425339,3-18441066-T-A,rs1328542,-1,T,A,18441066,15727,18228731,18621947,212335
3,ENSG00000230301.3,98264244,3-98239791-A-C,rs13321188,1,A,C,98239791,24453,98067636,98460852,172155
3,ENSG00000168038.6,41962103,3-41873450-G-T,rs13325965,-1,G,T,41873450,88653,41765495,42158711,107955
3,ENSG00000168038.6,41962103,3-41873450-G-C,rs13325965,-1,G,C,41873450,88653,41765495,42158711,107955
3,ENSG00000168038.6,41962103,3-41873450-G-A,rs13325965,-1,G,A,41873450,88653,41765495,42158711,107955
3,ENSG00000174013.7,196568660,3-196559784-T-A,rs1355533,1,T,A,196559784,8876,196372052,196765268,187732
3,ENSG00000174013.7,196568660,3-196559784-T-C,rs1355533,1,T,C,196559784,8876,196372052,196765268,187732
3,ENSG00000164078.7,49903873,3-49722606-T-A,rs1466685,-1,T,A,49722606,181267,49707265,50100481,15341
3,ENSG00000164078.7,49903873,3-49722606-T-C,rs1466685,-1,T,C,49722606,181267,49707265,50100481,15341
3,ENSG00000164078.7,49903873,3-49722606-T-G,rs1466685,-1,T,G,49722606,181267,49707265,50100481,15341
3,ENSG00000075975.11,12557087,3-12538445-G-T,rs1466835,1,G,T,12538445,18642,12360479,12753695,177966
3,ENSG00000145020.10,49422473,3-49602370-G-C,rs1491983,-1,G,C,49602370,179897,49225865,49619081,376505
3,ENSG00000145020.10,49422473,3-49602370-G-T,rs1491983,-1,G,T,49602370,179897,49225865,49619081,376505
3,ENSG00000145020.10,49422473,3-49602370-G-A,rs1491983,-1,G,A,49602370,179897,49225865,49619081,376505
3,ENSG00000152952.7,146161184,3-146194512-C-A,rs1512902,-1,C,A,146194512,33328,145964576,146357792,229936
3,ENSG00000152952.7,146161184,3-146194512-C-T,rs1512902,-1,C,T,146194512,33328,145964576,146357792,229936
3,ENSG00000093217.5,38346785,3-38340857-C-A,rs151629,1,C,A,38340857,5928,38150177,38543393,190680
3,ENSG00000093217.5,38346785,3-38340857-C-T,rs151629,1,C,T,38340857,5928,38150177,38543393,190680
3,ENSG00000073711.6,135965728,3-136023525-A-G,rs1523594,1,A,G,136023525,57797,135769120,136162336,254405
3,ENSG00000073711.6,135965728,3-136023525-A-C,rs1523594,1,A,C,136023525,57797,135769120,136162336,254405
3,ENSG00000073711.6,135965728,3-136023525-A-T,rs1523594,1,A,T,136023525,57797,135769120,136162336,254405
3,ENSG00000197584.6,178536436,3-178644895-C-T,rs1542526,1,C,T,178644895,108459,178339828,178733044,305067
3,ENSG00000197584.6,178536436,3-178644895-C-A,rs1542526,1,C,A,178644895,108459,178339828,178733044,305067
3,ENSG00000197584.6,178536436,3-178644895-C-G,rs1542526,1,C,G,178644895,108459,178339828,178733044,305067
3,ENSG00000172215.5,45943464,3-45952481-C-T,rs1552489,1,C,T,45952481,9017,45746856,46140072,205625
3,ENSG00000172215.5,45943464,3-45952481-C-G,rs1552489,1,C,G,45952481,9017,45746856,46140072,205625
3,ENSG00000136068.10,58008422,3-57959147-C-T,rs1675381,1,C,T,57959147,49275,57811814,58205030,147333
3,ENSG00000136068.10,58008422,3-57959147-C-A,rs1675381,1,C,A,57959147,49275,57811814,58205030,147333
3,ENSG00000177565.10,177197482,3-177074378-G-A,rs1681655,-1,G,A,177074378,123104,177000874,177394090,73504
3,ENSG00000177565.10,177197482,3-177074378-G-C,rs1681655,-1,G,C,177074378,123104,177000874,177394090,73504
3,ENSG00000163659.8,156674590,3-156500005-T-C,rs16826321,1,T,C,156500005,174585,156477982,156871198,22023
3,ENSG00000232382.1,98463201,3-98498868-G-T,rs16839818,1,G,T,98498868,35667,98266593,98659809,232275
3,ENSG00000232382.1,98463201,3-98498868-G-C,rs16839818,1,G,C,98498868,35667,98266593,98659809,232275
3,ENSG00000018408.10,149658025,3-149604261-G-A,rs16862021,-1,G,A,149604261,53764,149461417,149854633,142844
3,ENSG00000144893.8,151085664,3-151185335-G-A,rs16863238,1,G,A,151185335,99671,150889056,151282272,296279
3,ENSG00000144893.8,151085664,3-151185335-G-T,rs16863238,1,G,T,151185335,99671,150889056,151282272,296279
3,ENSG00000163428.3,120349354,3-120395790-C-A,rs1700,-1,C,A,120395790,46436,120152746,120545962,243044
3,ENSG00000163428.3,120349354,3-120395790-C-T,rs1700,-1,C,T,120395790,46436,120152746,120545962,243044
3,ENSG00000144560.9,11643915,3-11615804-A-G,rs17034817,-1,A,G,11615804,28111,11447307,11840523,168497
3,ENSG00000144677.10,37861880,3-37776619-A-T,rs17036944,1,A,T,37776619,85261,37665272,38058488,111347
3,ENSG00000144677.10,37861880,3-37776619-A-G,rs17036944,1,A,G,37776619,85261,37665272,38058488,111347
3,ENSG00000168036.12,41199505,3-41174997-G-A,rs17053751,1,G,A,41174997,24508,41002897,41396113,172100
3,ENSG00000160746.8,43622011,3-43533870-T-C,rs17075780,-1,T,C,43533870,88141,43425403,43818619,108467
3,ENSG00000160746.8,43622011,3-43533870-T-A,rs17075780,-1,T,A,43533870,88141,43425403,43818619,108467
3,ENSG00000144791.5,45594751,3-45462835-G-A,rs17077856,1,G,A,45462835,131916,45398143,45791359,64692
3,ENSG00000174579.3,136196335,3-136334490-A-G,rs17199849,-1,A,G,136334490,138155,135999727,136392943,334763
3,ENSG00000163389.6,119468963,3-119486370-T-G,rs17203139,1,T,G,119486370,17407,119272355,119665571,214015
3,ENSG00000138495.2,119677406,3-119636564-C-T,rs17203235,-1,C,T,119636564,40842,119480798,119874014,155766
3,ENSG00000163608.9,113019671,3-113139105-G-A,rs17318371,-1,G,A,113139105,119434,112823063,113216279,316042
3,ENSG00000152601.13,152268929,3-152459934-C-T,rs17437475,1,C,T,152459934,191005,152072321,152465537,387613
3,ENSG00000114416.12,180912670,3-180934134-A-G,rs17537540,1,A,G,180934134,21464,180716062,181109278,218072
3,ENSG00000179564.3,50279087,3-50403121-C-A,rs17606778,1,C,A,50403121,124034,50082479,50475695,320642
3,ENSG00000178053.13,158571194,3-158693892-C-T,rs17642107,1,C,T,158693892,122698,158374586,158767802,319306
3,ENSG00000118849.5,158732457,3-158709270-T-A,rs17642880,-1,T,A,158709270,23187,158535849,158929065,173421
3,ENSG00000118849.5,158732457,3-158709270-T-C,rs17642880,-1,T,C,158709270,23187,158535849,158929065,173421
3,ENSG00000152492.9,191329394,3-191389031-C-G,rs17811727,1,C,G,191389031,59637,191132786,191526002,256245
3,ENSG00000182179.6,49813953,3-49812290-G-A,rs1799843,-1,G,A,49812290,1663,49617345,50010561,194945
3,ENSG00000182179.6,49813953,3-49812290-G-C,rs1799843,-1,G,C,49812290,1663,49617345,50010561,194945
3,ENSG00000163913.6,129440224,3-129544297-A-G,rs1872111,1,A,G,129544297,104073,129243616,129636832,300681
3,ENSG00000163960.7,196432427,3-196586080-T-C,rs1872353,-1,T,C,196586080,153653,196235819,196629035,350261
3,ENSG00000163960.7,196432427,3-196586080-T-G,rs1872353,-1,T,G,196586080,153653,196235819,196629035,350261
3,ENSG00000129055.8,134485985,3-134486229-G-C,rs1874883,-1,G,C,134486229,244,134289377,134682593,196852
3,ENSG00000129055.8,134485985,3-134486229-G-T,rs1874883,-1,G,T,134486229,244,134289377,134682593,196852
3,ENSG00000173230.10,121749741,3-121895328-G-A,rs1881998,-1,G,A,121895328,145587,121553133,121946349,342195
3,ENSG00000145191.6,184135358,3-184158724-A-T,rs1969253,1,A,T,184158724,23366,183938750,184331966,219974
3,ENSG00000145191.6,184135358,3-184158724-A-G,rs1969253,1,A,G,184158724,23366,183938750,184331966,219974
3,ENSG00000145191.6,184135358,3-184158724-A-C,rs1969253,1,A,C,184158724,23366,183938750,184331966,219974
3,ENSG00000004838.9,50345732,3-50341515-A-T,rs1989839,-1,A,T,50341515,4217,50149124,50542340,192391
3,ENSG00000004838.9,50345732,3-50341515-A-C,rs1989839,-1,A,C,50341515,4217,50149124,50542340,192391
3,ENSG00000004838.9,50345732,3-50341515-A-G,rs1989839,-1,A,G,50341515,4217,50149124,50542340,192391
3,ENSG00000114904.8,52770940,3-52792531-C-A,rs2017352,-1,C,A,52792531,21591,52574332,52967548,218199
3,ENSG00000121858.6,172523430,3-172497847-T-C,rs2041692,-1,T,C,172497847,25583,172326822,172720038,171025
3,ENSG00000144843.7,119579492,3-119582292-C-T,rs20568,1,C,T,119582292,2800,119382884,119776100,199408
3,ENSG00000079257.3,158672648,3-158651371-T-C,rs2060017,-1,T,C,158651371,21277,158476040,158869256,175331
3,ENSG00000012223.6,46464905,3-46479902-G-T,rs2139634,-1,G,T,46479902,14997,46268297,46661513,211605
3,ENSG00000012223.6,46464905,3-46479902-G-C,rs2139634,-1,G,C,46479902,14997,46268297,46661513,211605
3,ENSG00000144566.5,19947097,3-19941001-G-A,rs2170341,1,G,A,19941001,6096,19750489,20143705,190512
3,ENSG00000172340.9,67654612,3-67653678-G-A,rs2198015,-1,G,A,67653678,934,67458004,67851220,195674
3,ENSG00000172340.9,67654612,3-67653678-G-C,rs2198015,-1,G,C,67653678,934,67458004,67851220,195674
3,ENSG00000164077.9,49929811,3-49902645-C-T,rs2230593,-1,C,T,49902645,27166,49733203,50126419,169442
3,ENSG00000114395.6,50350862,3-50351176-C-G,rs2233474,1,C,G,50351176,314,50154254,50547470,196922
3,ENSG00000114395.6,50350862,3-50351176-C-A,rs2233474,1,C,A,50351176,314,50154254,50547470,196922
3,ENSG00000061938.12,195908551,3-195872214-T-C,rs2241413,-1,T,C,195872214,36337,195711943,196105159,160271
3,ENSG00000163933.5,53130435,3-53021826-G-A,rs2244461,-1,G,A,53021826,108609,52933827,53327043,87999
3,ENSG00000170017.8,105366909,3-105527928-G-A,rs2252459,1,G,A,105527928,161019,105170301,105563517,357627
3,ENSG00000170017.8,105366909,3-105527928-G-T,rs2252459,1,G,T,105527928,161019,105170301,105563517,357627
3,ENSG00000170017.8,105366909,3-105527928-G-C,rs2252459,1,G,C,105527928,161019,105170301,105563517,357627
3,ENSG00000114491.9,124730452,3-124637087-C-T,rs2276741,1,C,T,124637087,93365,124533844,124927060,103243
3,ENSG00000144597.9,15427598,3-15479132-T-A,rs2290538,1,T,A,15479132,51534,15230990,15624206,248142
3,ENSG00000144597.9,15427598,3-15479132-T-G,rs2290538,1,T,G,15479132,51534,15230990,15624206,248142
3,ENSG00000154813.5,16264943,3-16301487-C-G,rs2292616,-1,C,G,16301487,36544,16068335,16461551,233152
3,ENSG00000154813.5,16264943,3-16301487-C-T,rs2292616,-1,C,T,16301487,36544,16068335,16461551,233152
3,ENSG00000163634.7,63863805,3-63911539-C-T,rs2292662,-1,C,T,63911539,47734,63667197,64060413,244342
3,ENSG00000161217.6,196287726,3-196460737-G-C,rs2342371,-1,G,C,196460737,173011,196091118,196484334,369619
3,ENSG00000161217.6,196287726,3-196460737-G-A,rs2342371,-1,G,A,196460737,173011,196091118,196484334,369619
3,ENSG00000177873.7,40477122,3-40292756-T-C,rs2371183,1,T,C,40292756,184366,40280514,40673730,12242
3,ENSG00000163807.4,44761619,3-44772581-A-G,rs2372827,-1,A,G,44772581,10962,44565011,44958227,207570
3,ENSG00000163807.4,44761619,3-44772581-A-T,rs2372827,-1,A,T,44772581,10962,44565011,44958227,207570
3,ENSG00000163807.4,44761619,3-44772581-A-C,rs2372827,-1,A,C,44772581,10962,44565011,44958227,207570
3,ENSG00000225526.2,12545499,3-12560995-G-A,rs2450855,-1,G,A,12560995,15496,12348891,12742107,212104
3,ENSG00000206561.6,15521706,3-15708837-A-G,rs2470514,-1,A,G,15708837,187131,15325098,15718314,383739
3,ENSG00000206561.6,15521706,3-15708837-A-C,rs2470514,-1,A,C,15708837,187131,15325098,15718314,383739
3,ENSG00000206561.6,15521706,3-15708837-A-T,rs2470514,-1,A,T,15708837,187131,15325098,15718314,383739
3,ENSG00000114353.11,50236204,3-50151624-T-G,rs2526394,1,T,G,50151624,84580,50039596,50432812,112028
3,ENSG00000114353.11,50236204,3-50151624-T-A,rs2526394,1,T,A,50151624,84580,50039596,50432812,112028
3,ENSG00000114353.11,50236204,3-50151624-T-C,rs2526394,1,T,C,50151624,84580,50039596,50432812,112028
3,ENSG00000158163.9,138115608,3-138090472-A-T,rs2622719,-1,A,T,138090472,25136,137919000,138312216,171472
3,ENSG00000158163.9,138115608,3-138090472-A-C,rs2622719,-1,A,C,138090472,25136,137919000,138312216,171472
3,ENSG00000158163.9,138115608,3-138090472-A-G,rs2622719,-1,A,G,138090472,25136,137919000,138312216,171472
3,ENSG00000134077.10,9363054,3-9379503-G-C,rs2648550,1,G,C,9379503,16449,9166446,9559662,213057
3,ENSG00000134077.10,9363054,3-9379503-G-A,rs2648550,1,G,A,9379503,16449,9166446,9559662,213057
3,ENSG00000134077.10,9363054,3-9379503-G-T,rs2648550,1,G,T,9379503,16449,9166446,9559662,213057
3,ENSG00000055957.6,52777599,3-52801470-A-G,rs2710336,1,A,G,52801470,23871,52580991,52974207,220479
3,ENSG00000154767.9,14178601,3-14147200-C-A,rs2733533,-1,C,A,14147200,31401,13981993,14375209,165207
3,ENSG00000170860.3,14178817,3-14125372-C-T,rs2733580,1,C,T,14125372,53445,13982209,14375425,143163
3,ENSG00000170819.4,133400056,3-133466990-T-A,rs2737717,1,T,A,133466990,66934,133203448,133596664,263542
3,ENSG00000170819.4,133400056,3-133466990-T-C,rs2737717,1,T,C,133466990,66934,133203448,133596664,263542
3,ENSG00000170819.4,133400056,3-133466990-T-G,rs2737717,1,T,G,133466990,66934,133203448,133596664,263542
3,ENSG00000171135.9,9890610,3-9911104-T-A,rs279571,1,T,A,9911104,20494,9694002,10087218,217102
3,ENSG00000171135.9,9890610,3-9911104-T-C,rs279571,1,T,C,9911104,20494,9694002,10087218,217102
3,ENSG00000177463.11,14947583,3-15116326-G-A,rs28615988,1,G,A,15116326,168743,14750975,15144191,365351
3,ENSG00000177463.11,14947583,3-15116326-G-T,rs28615988,1,G,T,15116326,168743,14750975,15144191,365351
3,ENSG00000196428.6,150408298,3-150365224-C-T,rs2868425,1,C,T,150365224,43074,150211690,150604906,153534
3,ENSG00000196428.6,150408298,3-150365224-C-G,rs2868425,1,C,G,150365224,43074,150211690,150604906,153534
3,ENSG00000180611.6,192917856,3-192898911-T-G,rs2886870,-1,T,G,192898911,18945,192721248,193114464,177663
3,ENSG00000180611.6,192917856,3-192898911-T-A,rs2886870,-1,T,A,192898911,18945,192721248,193114464,177663
3,ENSG00000162244.5,51995895,3-51987300-A-G,rs323895,-1,A,G,51987300,8595,51799287,52192503,188013
3,ENSG00000114529.8,112086389,3-112115906-G-A,rs340163,1,G,A,112115906,29517,111889781,112282997,226125
3,ENSG00000114529.8,112086389,3-112115906-G-T,rs340163,1,G,T,112115906,29517,111889781,112282997,226125
3,ENSG00000225697.5,48635461,3-48682020-A-C,rs34096717,-1,A,C,48682020,46559,48438853,48832069,243167
3,ENSG00000197980.6,156826353,3-156828886-T-A,rs344072,1,T,A,156828886,2533,156629745,157022961,199141
3,ENSG00000197980.6,156826353,3-156828886-T-G,rs344072,1,T,G,156828886,2533,156629745,157022961,199141
3,ENSG00000197980.6,156826353,3-156828886-T-C,rs344072,1,T,C,156828886,2533,156629745,157022961,199141
3,ENSG00000088538.10,50674927,3-50504338-G-C,rs34762184,1,G,C,50504338,170589,50478319,50871535,26019
3,ENSG00000088538.10,50674927,3-50504338-G-A,rs34762184,1,G,A,50504338,170589,50478319,50871535,26019
3,ENSG00000170266.10,33097146,3-33045856-C-T,rs34840292,-1,C,T,33045856,51290,32900538,33293754,145318
3,ENSG00000170266.10,33097146,3-33045856-C-G,rs34840292,-1,C,G,33045856,51290,32900538,33293754,145318
3,ENSG00000170266.10,33097146,3-33045856-C-A,rs34840292,-1,C,A,33045856,51290,32900538,33293754,145318
3,ENSG00000173890.12,170037995,3-170036207-C-G,rs35204505,1,C,G,170036207,1788,169841387,170234603,194820
3,ENSG00000173890.12,170037995,3-170036207-C-A,rs35204505,1,C,A,170036207,1788,169841387,170234603,194820
3,ENSG00000163701.13,9902848,3-9893069-A-G,rs35365817,1,A,G,9893069,9779,9706240,10099456,186829
3,ENSG00000144820.3,100609601,3-100789345-A-C,rs35476532,1,A,C,100789345,179744,100412993,100806209,376352
3,ENSG00000144820.3,100609601,3-100789345-A-G,rs35476532,1,A,G,100789345,179744,100412993,100806209,376352
3,ENSG00000157017.11,10292947,3-10286566-A-C,rs35683,-1,A,C,10286566,6381,10096339,10489555,190227
3,ENSG00000157017.11,10292947,3-10286566-A-G,rs35683,-1,A,G,10286566,6381,10096339,10489555,190227
3,ENSG00000158234.8,138608771,3-138628322-T-G,rs361073,1,T,G,138628322,19551,138412163,138805379,216159
3,ENSG00000158234.8,138608771,3-138628322-T-C,rs361073,1,T,C,138628322,19551,138412163,138805379,216159
3,ENSG00000158234.8,138608771,3-138628322-T-A,rs361073,1,T,A,138628322,19551,138412163,138805379,216159
3,ENSG00000154928.12,134795260,3-134957234-G-A,rs36132,1,G,A,134957234,161974,134598652,134991868,358582
3,ENSG00000144895.7,150546787,3-150602806-A-G,rs3745,1,A,G,150602806,56019,150350179,150743395,252627
3,ENSG00000169964.5,44861912,3-44916633-A-G,rs3749193,1,A,G,44916633,54721,44665304,45058520,251329
3,ENSG00000072756.12,3126940,3-3146332-A-T,rs3762760,1,A,T,3146332,19392,2930332,3323548,216000
3,ENSG00000072756.12,3126940,3-3146332-A-G,rs3762760,1,A,G,3146332,19392,2930332,3323548,216000
3,ENSG00000072756.12,3126940,3-3146332-A-C,rs3762760,1,A,C,3146332,19392,2930332,3323548,216000
3,ENSG00000114480.7,81761645,3-81759451-C-A,rs3772882,-1,C,A,81759451,2194,81565037,81958253,194414
3,ENSG00000114480.7,81761645,3-81759451-C-G,rs3772882,-1,C,G,81759451,2194,81565037,81958253,194414
3,ENSG00000114757.13,180036937,3-179889342-T-A,rs3774246,-1,T,A,179889342,147595,179840329,180233545,49013
3,ENSG00000056736.5,53846568,3-53796740-G-A,rs3774605,1,G,A,53796740,49828,53649960,54043176,146780
3,ENSG00000056736.5,53846568,3-53796740-G-C,rs3774605,1,G,C,53796740,49828,53649960,54043176,146780
3,ENSG00000088543.10,50567747,3-50626330-C-A,rs3792327,-1,C,A,50626330,58583,50371139,50764355,255191
3,ENSG00000088543.10,50567747,3-50626330-C-T,rs3792327,-1,C,T,50626330,58583,50371139,50764355,255191
3,ENSG00000083937.4,87227309,3-87252113-T-A,rs3804602,1,T,A,87252113,24804,87030701,87423917,221412
3,ENSG00000083937.4,87227309,3-87252113-T-C,rs3804602,1,T,C,87252113,24804,87030701,87423917,221412
3,ENSG00000154743.12,12484480,3-12484507-G-A,rs3806662,1,G,A,12484507,27,12287872,12681088,196635
3,ENSG00000153558.9,33277442,3-33396052-T-G,rs3817476,1,T,G,33396052,118610,33080834,33474050,315218
3,ENSG00000153558.9,33277442,3-33396052-T-C,rs3817476,1,T,C,33396052,118610,33080834,33474050,315218
3,ENSG00000041802.6,194672191,3-194648851-C-A,rs3821403,-1,C,A,194648851,23340,194475583,194868799,173268
3,ENSG00000113812.9,53882152,3-53856760-G-T,rs3821867,-1,G,T,53856760,25392,53685544,54078760,171216
3,ENSG00000113812.9,53882152,3-53856760-G-A,rs3821867,-1,G,A,53856760,25392,53685544,54078760,171216
3,ENSG00000163378.9,69013684,3-69077344-T-C,rs3853156,-1,T,C,69077344,63660,68817076,69210292,260268
3,ENSG00000163378.9,69013684,3-69077344-T-A,rs3853156,-1,T,A,69077344,63660,68817076,69210292,260268
3,ENSG00000144559.6,11846885,3-11844891-T-A,rs392621,-1,T,A,11844891,1994,11650277,12043493,194614
3,ENSG00000144559.6,11846885,3-11844891-T-C,rs392621,-1,T,C,11844891,1994,11650277,12043493,194614
3,ENSG00000138496.10,122564300,3-122577094-A-C,rs4147495,-1,A,C,122577094,12794,122367692,122760908,209402
3,ENSG00000138496.10,122564300,3-122577094-A-T,rs4147495,-1,A,T,122577094,12794,122367692,122760908,209402
3,ENSG00000173200.7,122577650,3-122577094-A-C,rs4147495,1,A,C,122577094,556,122381042,122774258,196052
3,ENSG00000173200.7,122577650,3-122577094-A-T,rs4147495,1,A,T,122577094,556,122381042,122774258,196052
3,ENSG00000163840.5,122564338,3-122577094-A-C,rs4147495,1,A,C,122577094,12756,122367730,122760946,209364
3,ENSG00000163840.5,122564338,3-122577094-A-T,rs4147495,1,A,T,122577094,12756,122367730,122760946,209364
3,ENSG00000073849.10,186930526,3-187040795-C-A,rs4234598,1,C,A,187040795,110269,186733918,187127134,306877
3,ENSG00000073849.10,186930526,3-187040795-C-G,rs4234598,1,C,G,187040795,110269,186733918,187127134,306877
3,ENSG00000114812.8,42502643,3-42478068-A-G,rs427048,1,A,G,42478068,24575,42306035,42699251,172033
3,ENSG00000114812.8,42502643,3-42478068-A-T,rs427048,1,A,T,42478068,24575,42306035,42699251,172033
3,ENSG00000184307.9,113948013,3-113833610-C-T,rs4339084,1,C,T,113833610,114403,113751405,114144621,82205
3,ENSG00000114573.4,113747035,3-113927810-C-T,rs4422272,1,C,T,113927810,180775,113550427,113943643,377383
3,ENSG00000031081.5,119294383,3-119172827-A-G,rs4446196,1,A,G,119172827,121556,119097775,119490991,75052
3,ENSG00000031081.5,119294383,3-119172827-A-T,rs4446196,1,A,T,119172827,121556,119097775,119490991,75052
3,ENSG00000163380.11,69122595,3-69231752-C-A,rs4447768,-1,C,A,69231752,109157,68925987,69319203,305765
3,ENSG00000163380.11,69122595,3-69231752-C-T,rs4447768,-1,C,T,69231752,109157,68925987,69319203,305765
3,ENSG00000255423.1,73061659,3-73040434-T-C,rs4676898,1,T,C,73040434,21225,72865051,73258267,175383
3,ENSG00000255423.1,73061659,3-73040434-T-A,rs4676898,1,T,A,73040434,21225,72865051,73258267,175383
3,ENSG00000114805.12,155745071,3-155634885-G-T,rs4680205,-1,G,T,155634885,110186,155548463,155941679,86422
3,ENSG00000163687.8,58210972,3-58209984-G-A,rs4681668,-1,G,A,58209984,988,58014364,58407580,195620
3,ENSG00000163687.8,58210972,3-58209984-G-T,rs4681668,-1,G,T,58209984,988,58014364,58407580,195620
3,ENSG00000182923.11,134486057,3-134316165-G-A,rs4682662,1,G,A,134316165,169892,134289449,134682665,26716
3,ENSG00000182923.11,134486057,3-134316165-G-C,rs4682662,1,G,C,134316165,169892,134289449,134682665,26716
3,ENSG00000163814.3,45146378,3-45136389-G-A,rs4682770,-1,G,A,45136389,9989,44949770,45342986,186619
3,ENSG00000163814.3,45146378,3-45136389-G-T,rs4682770,-1,G,T,45136389,9989,44949770,45342986,186619
3,ENSG00000163808.11,44761794,3-44777944-T-C,rs4682996,1,T,C,44777944,16150,44565186,44958402,212758
3,ENSG00000178038.12,46693679,3-46682061-G-A,rs4683310,-1,G,A,46682061,11618,46497071,46890287,184990
3,ENSG00000144455.8,4467269,3-4361853-C-T,rs4685744,-1,C,T,4361853,105416,4270661,4663877,91192
3,ENSG00000183833.11,119703022,3-119705975-C-A,rs4688028,1,C,A,119705975,2953,119506414,119899630,199561
3,ENSG00000183833.11,119703022,3-119705975-C-T,rs4688028,1,C,T,119705975,2953,119506414,119899630,199561
3,ENSG00000004399.8,129606676,3-129590420-T-C,rs4688807,-1,T,C,129590420,16256,129410068,129803284,180352
3,ENSG00000151967.14,159839861,3-160028076-T-C,rs485499,1,T,C,160028076,188215,159643253,160036469,384823
3,ENSG00000136521.8,179604794,3-179503619-T-C,rs4855081,1,T,C,179503619,101175,179408186,179801402,95433
3,ENSG00000114455.9,108296490,3-108266539-T-A,rs4855632,1,T,A,108266539,29951,108099882,108493098,166657
3,ENSG00000114455.9,108296490,3-108266539-T-G,rs4855632,1,T,G,108266539,29951,108099882,108493098,166657
3,ENSG00000114455.9,108296490,3-108266539-T-C,rs4855632,1,T,C,108266539,29951,108099882,108493098,166657
3,ENSG00000232112.3,48440257,3-48373517-C-G,rs4858793,1,C,G,48373517,66740,48243649,48636865,129868
3,ENSG00000172667.6,179071809,3-179069343-C-T,rs4955806,-1,C,T,179069343,2466,178875201,179268417,194142
3,ENSG00000172667.6,179071809,3-179069343-C-A,rs4955806,-1,C,A,179069343,2466,178875201,179268417,194142
3,ENSG00000172667.6,179071809,3-179069343-C-G,rs4955806,-1,C,G,179069343,2466,178875201,179268417,194142
3,ENSG00000196653.6,44712660,3-44721338-A-G,rs56084453,1,A,G,44721338,8678,44516052,44909268,205286
3,ENSG00000186446.6,44729635,3-44721338-A-G,rs56084453,1,A,G,44721338,8297,44533027,44926243,188311
3,ENSG00000168811.2,159988835,3-160015196-T-A,rs574808,1,T,A,160015196,26361,159792227,160185443,222969
3,ENSG00000168811.2,159988835,3-160015196-T-C,rs574808,1,T,C,160015196,26361,159792227,160185443,222969
3,ENSG00000131370.11,15332586,3-15362621-T-C,rs58163887,-1,T,C,15362621,30035,15135978,15529194,226643
3,ENSG00000131370.11,15332586,3-15362621-T-A,rs58163887,-1,T,A,15362621,30035,15135978,15529194,226643
3,ENSG00000163686.8,58237792,3-58237565-T-C,rs58433687,1,T,C,58237565,227,58041184,58434400,196381
3,ENSG00000163686.8,58237792,3-58237565-T-G,rs58433687,1,T,G,58237565,227,58041184,58434400,196381
3,ENSG00000163959.5,196216534,3-196234383-C-T,rs60631199,1,C,T,196234383,17849,196019926,196413142,214457
3,ENSG00000240303.3,132659809,3-132562429-C-T,rs61023005,-1,C,T,132562429,97380,132463201,132856417,99228
3,ENSG00000129048.5,132597270,3-132499231-C-T,rs61748102,1,C,T,132499231,98039,132400662,132793878,98569
3,ENSG00000082781.6,124887365,3-124766412-G-T,rs61761676,-1,G,T,124766412,120953,124690757,125083973,75655
3,ENSG00000082781.6,124887365,3-124766412-G-A,rs61761676,-1,G,A,124766412,120953,124690757,125083973,75655
3,ENSG00000180914.6,8769613,3-8768776-C-T,rs62243375,-1,C,T,8768776,837,8573005,8966221,195771
3,ENSG00000160799.6,46976745,3-46919101-C-T,rs62248423,-1,C,T,46919101,57644,46780137,47173353,138964
3,ENSG00000188315.3,49277232,3-49135764-C-T,rs62262521,-1,C,T,49135764,141468,49080624,49473840,55140
3,ENSG00000163870.10,127590733,3-127681974-A-G,rs62264157,-1,A,G,127681974,91241,127394125,127787341,287849
3,ENSG00000114013.11,122055362,3-121994937-C-T,rs62269206,1,C,T,121994937,60425,121858754,122251970,136183
3,ENSG00000138246.10,132417502,3-132593322-C-A,rs62291489,1,C,A,132593322,175820,132220894,132614110,372428
3,ENSG00000138246.10,132417502,3-132593322-C-T,rs62291489,1,C,T,132593322,175820,132220894,132614110,372428
3,ENSG00000091527.11,133573686,3-133500935-G-T,rs6439416,1,G,T,133500935,72751,133377078,133770294,123857
3,ENSG00000091527.11,133573686,3-133500935-G-A,rs6439416,1,G,A,133500935,72751,133377078,133770294,123857
3,ENSG00000177311.6,141368504,3-141220586-T-C,rs6439982,1,T,C,141220586,147918,141171896,141565112,48690
3,ENSG00000138468.11,101513212,3-101462184-G-A,rs6441608,-1,G,A,101462184,51028,101316604,101709820,145580
3,ENSG00000138468.11,101513212,3-101462184-G-T,rs6441608,-1,G,T,101462184,51028,101316604,101709820,145580
3,ENSG00000186448.9,44625036,3-44768615-C-G,rs6441867,1,C,G,44768615,143579,44428428,44821644,340187
3,ENSG00000186448.9,44625036,3-44768615-C-T,rs6441867,1,C,T,44768615,143579,44428428,44821644,340187
3,ENSG00000186448.9,44625036,3-44768615-C-A,rs6441867,1,C,A,44768615,143579,44428428,44821644,340187
3,ENSG00000121879.3,179148357,3-179273093-C-T,rs6443634,1,C,T,179273093,124736,178951749,179344965,321344
3,ENSG00000043093.8,182980538,3-183162323-A-G,rs6443856,-1,A,G,183162323,181785,182783930,183177146,378393
3,ENSG00000043093.8,182980538,3-183162323-A-C,rs6443856,-1,A,C,183162323,181785,182783930,183177146,378393
3,ENSG00000157388.8,53494611,3-53599298-A-G,rs6445589,1,A,G,53599298,104687,53298003,53691219,301295
3,ENSG00000114541.10,69386088,3-69372697-T-A,rs6549211,-1,T,A,69372697,13391,69189480,69582696,183217
3,ENSG00000114541.10,69386088,3-69372697-T-C,rs6549211,-1,T,C,69372697,13391,69189480,69582696,183217
3,ENSG00000074416.8,127822515,3-127755187-G-A,rs664910,-1,G,A,127755187,67328,127625907,128019123,129280
3,ENSG00000163823.3,46208313,3-46062803-C-A,rs6764189,-1,C,A,46062803,145510,46011705,46404921,51098
3,ENSG00000163823.3,46208313,3-46062803-C-T,rs6764189,-1,C,T,46062803,145510,46011705,46404921,51098
3,ENSG00000163823.3,46208313,3-46062803-C-G,rs6764189,-1,C,G,46062803,145510,46011705,46404921,51098
3,ENSG00000114450.5,179451470,3-179343798-A-G,rs6770147,-1,A,G,179343798,107672,179254862,179648078,88936
3,ENSG00000114315.3,194136148,3-193986084-C-G,rs6770661,1,C,G,193986084,150064,193939540,194332756,46544
3,ENSG00000114315.3,194136148,3-193986084-C-T,rs6770661,1,C,T,193986084,150064,193939540,194332756,46544
3,ENSG00000144712.7,12796680,3-12756064-C-T,rs6770851,1,C,T,12756064,40616,12600072,12993288,155992
3,ENSG00000131379.5,14675141,3-14728091-C-G,rs6771179,1,C,G,14728091,52950,14478533,14871749,249558
3,ENSG00000164082.10,51707068,3-51592433-A-G,rs6771194,1,A,G,51592433,114635,51510460,51903676,81973
3,ENSG00000164082.10,51707068,3-51592433-A-T,rs6771194,1,A,T,51592433,114635,51510460,51903676,81973
3,ENSG00000197938.4,98282505,3-98213209-C-T,rs6771271,1,C,T,98213209,69296,98085897,98479113,127312
3,ENSG00000163923.5,187139496,3-186964536-T-G,rs6771438,-1,T,G,186964536,174960,186942888,187336104,21648
3,ENSG00000163820.10,45995824,3-46101567-A-G,rs6772051,-1,A,G,46101567,105743,45799216,46192432,302351
3,ENSG00000174738.7,23945286,3-23845838-G-A,rs6776568,1,G,A,23845838,99448,23748678,24141894,97160
3,ENSG00000185909.9,49171598,3-49279905-T-C,rs6778080,1,T,C,49279905,108307,48974990,49368206,304915
3,ENSG00000114120.7,140941836,3-140795180-T-C,rs6779600,1,T,C,140795180,146656,140745228,141138444,49952
3,ENSG00000198218.5,49094071,3-49110040-T-C,rs6780307,-1,T,C,49110040,15969,48897463,49290679,212577
3,ENSG00000198218.5,49094071,3-49110040-T-G,rs6780307,-1,T,G,49110040,15969,48897463,49290679,212577
3,ENSG00000157036.8,38496340,3-38513687-G-C,rs6780349,1,G,C,38513687,17347,38299732,38692948,213955
3,ENSG00000157036.8,38496340,3-38513687-G-A,rs6780349,1,G,A,38513687,17347,38299732,38692948,213955
3,ENSG00000131373.10,15601569,3-15557776-T-A,rs6781430,-1,T,A,15557776,43793,15404961,15798177,152815
3,ENSG00000131373.10,15601569,3-15557776-T-G,rs6781430,-1,T,G,15557776,43793,15404961,15798177,152815
3,ENSG00000144824.14,111859265,3-111874737-G-A,rs6786077,1,G,A,111874737,15472,111662657,112055873,212080
3,ENSG00000144824.14,111859265,3-111874737-G-C,rs6786077,1,G,C,111874737,15472,111662657,112055873,212080
3,ENSG00000169313.8,151384753,3-151381953-A-C,rs6787801,-1,A,C,151381953,2800,151188145,151581361,193808
3,ENSG00000169313.8,151384753,3-151381953-A-G,rs6787801,-1,A,G,151381953,2800,151188145,151581361,193808
3,ENSG00000188306.6,169812870,3-169817478-G-A,rs6793160,1,G,A,169817478,4608,169616262,170009478,201216
3,ENSG00000188306.6,169812870,3-169817478-G-C,rs6793160,1,G,C,169817478,4608,169616262,170009478,201216
3,ENSG00000188306.6,169812870,3-169817478-G-T,rs6793160,1,G,T,169817478,4608,169616262,170009478,201216
3,ENSG00000114125.9,141738298,3-141717109-A-G,rs6795259,1,A,G,141717109,21189,141541690,141934906,175419
3,ENSG00000145016.9,197736904,3-197720783-C-T,rs6796856,-1,C,T,197720783,16121,197540296,197933512,180487
3,ENSG00000164048.8,48241104,3-48156124-A-C,rs6797587,1,A,C,48156124,84980,48044496,48437712,111628
3,ENSG00000164048.8,48241104,3-48156124-A-G,rs6797587,1,A,G,48156124,84980,48044496,48437712,111628
3,ENSG00000164048.8,48241104,3-48156124-A-T,rs6797587,1,A,T,48156124,84980,48044496,48437712,111628
3,ENSG00000145088.4,121835209,3-121781144-T-C,rs6798415,1,T,C,121781144,54065,121638601,122031817,142543
3,ENSG00000169251.7,161221311,3-161354159-A-G,rs6800515,1,A,G,161354159,132848,161024703,161417919,329456
3,ENSG00000114796.10,183635623,3-183516371-C-T,rs6801457,1,C,T,183516371,119252,183439015,183832231,77356
3,ENSG00000113811.6,53891859,3-53842191-A-G,rs6801605,-1,A,G,53842191,49668,53695251,54088467,146940
3,ENSG00000168297.9,58332892,3-58231310-G-C,rs6802482,1,G,C,58231310,101582,58136284,58529500,95026
3,ENSG00000168297.9,58332892,3-58231310-G-A,rs6802482,1,G,A,58231310,101582,58136284,58529500,95026
3,ENSG00000168297.9,58332892,3-58231310-G-T,rs6802482,1,G,T,58231310,101582,58136284,58529500,95026
3,ENSG00000227124.4,75785549,3-75910143-G-T,rs6803458,-1,G,T,75910143,124594,75588941,75982157,321202
3,ENSG00000227124.4,75785549,3-75910143-G-A,rs6803458,-1,G,A,75910143,124594,75588941,75982157,321202
3,ENSG00000169814.8,15601745,3-15602228-A-G,rs6804782,1,A,G,15602228,483,15405137,15798353,197091
3,ENSG00000131378.8,16513699,3-16372691-G-A,rs689662,-1,G,A,16372691,141008,16317091,16710307,55600
3,ENSG00000004534.9,49940150,3-49831725-A-C,rs695238,1,A,C,49831725,108425,49743542,50136758,88183
3,ENSG00000004534.9,49940150,3-49831725-A-G,rs695238,1,A,G,49831725,108425,49743542,50136758,88183
3,ENSG00000114446.4,108222424,3-108124634-C-T,rs721328,-1,C,T,108124634,97790,108025816,108419032,98818
3,ENSG00000196776.10,108091031,3-108124634-C-T,rs721328,-1,C,T,108124634,33603,107894423,108287639,230211
3,ENSG00000114354.7,100709494,3-100723015-T-G,rs72930703,1,T,G,100723015,13521,100512886,100906102,210129
3,ENSG00000188846.8,40457339,3-40315807-G-T,rs73073561,1,G,T,40315807,141532,40260731,40653947,55076
3,ENSG00000010256.6,48609646,3-48578858-G-A,rs73078310,-1,G,A,48578858,30788,48413038,48806254,165820
3,ENSG00000010256.6,48609646,3-48578858-G-T,rs73078310,-1,G,T,48578858,30788,48413038,48806254,165820
3,ENSG00000185798.6,196568554,3-196655823-T-C,rs73084956,-1,T,C,196655823,87269,196371946,196765162,283877
3,ENSG00000163347.4,190322446,3-190315724-C-T,rs73190602,-1,C,T,190315724,6722,190125838,190519054,189886
3,ENSG00000251287.4,130081831,3-130123032-G-A,rs73210765,1,G,A,130123032,41201,129885223,130278439,237809
3,ENSG00000014257.11,132317407,3-132287493-T-C,rs73213820,1,T,C,132287493,29914,132120799,132514015,166694
3,ENSG00000163961.4,196503768,3-196499772-G-A,rs73219645,-1,G,A,196499772,3996,196307160,196700376,192612
3,ENSG00000174500.8,112133248,3-112297542-C-A,rs73225616,-1,C,A,112297542,164294,111936640,112329856,360902
3,ENSG00000174500.8,112133248,3-112297542-C-T,rs73225616,-1,C,T,112297542,164294,111936640,112329856,360902
3,ENSG00000073803.9,185363136,3-185318876-T-C,rs7432310,1,T,C,185318876,44260,185166528,185559744,152348
3,ENSG00000073803.9,185363136,3-185318876-T-G,rs7432310,1,T,G,185318876,44260,185166528,185559744,152348
3,ENSG00000073803.9,185363136,3-185318876-T-A,rs7432310,1,T,A,185318876,44260,185166528,185559744,152348
3,ENSG00000121797.8,46407259,3-46399486-T-A,rs743661,1,T,A,46399486,7773,46210651,46603867,188835
3,ENSG00000121797.8,46407259,3-46399486-T-C,rs743661,1,T,C,46399486,7773,46210651,46603867,188835
3,ENSG00000186792.11,50299405,3-50405910-C-T,rs74448976,-1,C,T,50405910,106505,50102797,50496013,303113
3,ENSG00000114853.8,42653697,3-42492291-G-A,rs74796215,1,G,A,42492291,161406,42457089,42850305,35202
3,ENSG00000152642.6,32106620,3-32107224-G-T,rs748607,1,G,T,32107224,604,31910012,32303228,197212
3,ENSG00000206527.5,123585053,3-123585847-G-A,rs75085211,-1,G,A,123585847,794,123388445,123781661,197402
3,ENSG00000129810.10,20186206,3-20255630-C-T,rs75335460,-1,C,T,20255630,69424,19989598,20382814,266032
3,ENSG00000153767.5,120742744,3-120816040-G-A,rs75542933,1,G,A,120816040,73296,120546136,120939352,269904
3,ENSG00000114473.9,197959991,3-197811677-G-A,rs75865926,-1,G,A,197811677,148314,197763383,198156599,48294
3,ENSG00000114473.9,197959991,3-197811677-G-C,rs75865926,-1,G,C,197811677,148314,197763383,198156599,48294
3,ENSG00000145107.10,196338388,3-196451835-C-T,rs75898376,-1,C,T,196451835,113447,196141780,196534996,310055
3,ENSG00000181061.9,42804490,3-42778956-G-A,rs7612614,-1,G,A,42778956,25534,42607882,43001098,171074
3,ENSG00000181061.9,42804490,3-42778956-G-T,rs7612614,-1,G,T,42778956,25534,42607882,43001098,171074
3,ENSG00000181061.9,42804490,3-42778956-G-C,rs7612614,-1,G,C,42778956,25534,42607882,43001098,171074
3,ENSG00000168268.6,52533857,3-52532898-C-A,rs7614981,-1,C,A,52532898,959,52337249,52730465,195649
3,ENSG00000163754.12,148991540,3-148975613-G-C,rs7615371,1,G,C,148975613,15927,148794932,149188148,180681
3,ENSG00000163754.12,148991540,3-148975613-G-A,rs7615371,1,G,A,148975613,15927,148794932,149188148,180681
3,ENSG00000168356.7,39051944,3-39006621-G-A,rs7615849,-1,G,A,39006621,45323,38855336,39248552,151285
3,ENSG00000169255.9,161105349,3-161137811-T-A,rs7618924,-1,T,A,161137811,32462,160908741,161301957,229070
3,ENSG00000169255.9,161105349,3-161137811-T-C,rs7618924,-1,T,C,161137811,32462,160908741,161301957,229070
3,ENSG00000145029.6,49429324,3-49438830-T-A,rs7619789,-1,T,A,49438830,9506,49232716,49625932,206114
3,ENSG00000145029.6,49429324,3-49438830-T-C,rs7619789,-1,T,C,49438830,9506,49232716,49625932,206114
3,ENSG00000145029.6,49429324,3-49438830-T-G,rs7619789,-1,T,G,49438830,9506,49232716,49625932,206114
3,ENSG00000178149.12,49018580,3-48876805-G-A,rs7623023,-1,G,A,48876805,141775,48821972,49215188,54833
3,ENSG00000178149.12,49018580,3-48876805-G-C,rs7623023,-1,G,C,48876805,141775,48821972,49215188,54833
3,ENSG00000144655.9,39153591,3-39149451-C-T,rs7623800,-1,C,T,39149451,4140,38956983,39350199,192468
3,ENSG00000160801.9,46877721,3-46726984-C-T,rs7626129,1,C,T,46726984,150737,46681113,47074329,45871
3,ENSG00000188313.7,146544607,3-146376839-G-A,rs7626996,-1,G,A,146376839,167768,146347999,146741215,28840
3,ENSG00000114850.2,156555117,3-156652144-T-G,rs7628802,-1,T,G,156652144,97027,156358509,156751725,293635
3,ENSG00000145103.7,122022247,3-122185364-G-T,rs7628990,-1,G,T,122185364,163117,121825639,122218855,359725
3,ENSG00000145103.7,122022247,3-122185364-G-C,rs7628990,-1,G,C,122185364,163117,121825639,122218855,359725
3,ENSG00000174007.7,196712250,3-196711065-T-A,rs7628991,-1,T,A,196711065,1185,196515642,196908858,195423
3,ENSG00000174007.7,196712250,3-196711065-T-C,rs7628991,-1,T,C,196711065,1185,196515642,196908858,195423
3,ENSG00000174007.7,196712250,3-196711065-T-G,rs7628991,-1,T,G,196711065,1185,196515642,196908858,195423
3,ENSG00000041880.10,51942363,3-51979226-T-C,rs7636204,1,T,C,51979226,36863,51745755,52138971,233471
3,ENSG00000154781.10,14651762,3-14820278-G-A,rs7636593,1,G,A,14820278,168516,14455154,14848370,365124
3,ENSG00000173905.4,168095924,3-168048703-C-A,rs7639014,-1,C,A,168048703,47221,167899316,168292532,149387
3,ENSG00000163864.10,139677972,3-139673526-T-C,rs7639511,-1,T,C,139673526,4446,139481364,139874580,192162
3,ENSG00000163864.10,139677972,3-139673526-T-A,rs7639511,-1,T,A,139673526,4446,139481364,139874580,192162
3,ENSG00000181804.9,143848468,3-143823166-G-A,rs7641634,-1,G,A,143823166,25302,143651860,144045076,171306
3,ENSG00000145014.13,194633419,3-194631296-C-T,rs7645514,-1,C,T,194631296,2123,194436811,194830027,194485
3,ENSG00000254999.2,10115675,3-10115684-C-T,rs7645759,1,C,T,10115684,9,9919067,10312283,196617
3,ENSG00000178075.14,113838788,3-113824234-A-T,rs7646203,1,A,T,113824234,14554,113642180,114035396,182054
3,ENSG00000178075.14,113838788,3-113824234-A-G,rs7646203,1,A,G,113824234,14554,113642180,114035396,182054
3,ENSG00000168028.8,39406720,3-39328456-T-C,rs7647254,1,T,C,39328456,78264,39210112,39603328,118344
3,ENSG00000144647.5,43106079,3-43132737-G-A,rs7648947,-1,G,A,43132737,26658,42909471,43302687,223266
3,ENSG00000144647.5,43106079,3-43132737-G-T,rs7648947,-1,G,T,43132737,26658,42909471,43302687,223266
3,ENSG00000184220.6,99817862,3-100006785-A-C,rs7649349,1,A,C,100006785,188923,99621254,100014470,385531
3,ENSG00000184220.6,99817862,3-100006785-A-T,rs7649349,1,A,T,100006785,188923,99621254,100014470,385531
3,ENSG00000184220.6,99817862,3-100006785-A-G,rs7649349,1,A,G,100006785,188923,99621254,100014470,385531
3,ENSG00000175110.7,139344020,3-139392125-G-A,rs77016755,1,G,A,139392125,48105,139147412,139540628,244713
3,ENSG00000175110.7,139344020,3-139392125-G-C,rs77016755,1,G,C,139392125,48105,139147412,139540628,244713
3,ENSG00000114626.12,127672952,3-127716963-T-A,rs782449,1,T,A,127716963,44011,127476344,127869560,240619
3,ENSG00000114626.12,127672952,3-127716963-T-C,rs782449,1,T,C,127716963,44011,127476344,127869560,240619
3,ENSG00000144741.12,66221001,3-66304145-A-G,rs782743,1,A,G,66304145,83144,66024393,66417609,279752
3,ENSG00000144741.12,66221001,3-66304145-A-T,rs782743,1,A,T,66304145,83144,66024393,66417609,279752
3,ENSG00000187672.8,56468467,3-56655270-C-T,rs78638441,-1,C,T,56655270,186803,56271859,56665075,383411
3,ENSG00000175697.6,120285222,3-120280774-T-G,rs787202,-1,T,G,120280774,4448,120088614,120481830,192160
3,ENSG00000175697.6,120285222,3-120280774-T-C,rs787202,-1,T,C,120280774,4448,120088614,120481830,192160
3,ENSG00000175697.6,120285222,3-120280774-T-A,rs787202,-1,T,A,120280774,4448,120088614,120481830,192160
3,ENSG00000163702.14,9917098,3-10112101-G-A,rs79677720,1,G,A,10112101,195003,9720490,10113706,391611
3,ENSG00000138231.8,138174921,3-138131046-C-T,rs79791762,-1,C,T,138131046,43875,137978313,138371529,152733
3,ENSG00000205981.2,180989736,3-180912884-C-T,rs80057905,-1,C,T,180912884,76852,180793128,181186344,119756
3,ENSG00000070476.10,126475891,3-126455428-G-C,rs813556,-1,G,C,126455428,20463,126279283,126672499,176145
3,ENSG00000070476.10,126475891,3-126455428-G-A,rs813556,-1,G,A,126455428,20463,126279283,126672499,176145
3,ENSG00000178700.3,94062916,3-93894473-A-G,rs8178639,-1,A,G,93894473,168443,93866308,94259524,28165
3,ENSG00000169359.8,155854427,3-155970238-T-C,rs819856,-1,T,C,155970238,115811,155657819,156051035,312419
3,ENSG00000008324.6,42590860,3-42657875-G-C,rs82755,1,G,C,42657875,67015,42394252,42787468,263623
3,ENSG00000008324.6,42590860,3-42657875-G-A,rs82755,1,G,A,42657875,67015,42394252,42787468,263623
3,ENSG00000008324.6,42590860,3-42657875-G-T,rs82755,1,G,T,42657875,67015,42394252,42787468,263623
3,ENSG00000168329.8,39280036,3-39394374-G-T,rs870843,-1,G,T,39394374,114338,39083428,39476644,310946
3,ENSG00000168329.8,39280036,3-39394374-G-C,rs870843,-1,G,C,39394374,114338,39083428,39476644,310946
3,ENSG00000168329.8,39280036,3-39394374-G-A,rs870843,-1,G,A,39394374,114338,39083428,39476644,310946
3,ENSG00000114405.6,62319022,3-62122552-C-G,rs880416,1,C,G,62122552,196470,62122414,62515630,138
3,ENSG00000114405.6,62319022,3-62122552-C-T,rs880416,1,C,T,62122552,196470,62122414,62515630,138
3,ENSG00000114405.6,62319022,3-62122552-C-A,rs880416,1,C,A,62122552,196470,62122414,62515630,138
3,ENSG00000187715.9,127915232,3-127903893-T-C,rs891885,1,T,C,127903893,11339,127718624,128111840,185269
3,ENSG00000187715.9,127915232,3-127903893-T-G,rs891885,1,T,G,127903893,11339,127718624,128111840,185269
3,ENSG00000159685.6,126704240,3-126749978-C-T,rs895825,1,C,T,126749978,45738,126507632,126900848,242346
3,ENSG00000163607.8,112990984,3-112998472-A-T,rs9288967,1,A,T,112998472,7488,112794376,113187592,204096
3,ENSG00000163607.8,112990984,3-112998472-A-C,rs9288967,1,A,C,112998472,7488,112794376,113187592,204096
3,ENSG00000196981.2,122416062,3-122416042-T-A,rs9289193,-1,T,A,122416042,20,122219454,122612670,196588
3,ENSG00000196981.2,122416062,3-122416042-T-G,rs9289193,-1,T,G,122416042,20,122219454,122612670,196588
3,ENSG00000114770.11,184017884,3-184004187-C-T,rs9290779,-1,C,T,184004187,13697,183821276,184214492,182911
3,ENSG00000114770.11,184017884,3-184004187-C-A,rs9290779,-1,C,A,184004187,13697,183821276,184214492,182911
3,ENSG00000163947.7,56801949,3-56920493-G-A,rs9311631,-1,G,A,56920493,118544,56605341,56998557,315152
3,ENSG00000163947.7,56801949,3-56920493-G-C,rs9311631,-1,G,C,56920493,118544,56605341,56998557,315152
3,ENSG00000121594.7,119559614,3-119393712-A-G,rs935616,-1,A,G,119393712,165902,119363006,119756222,30706
3,ENSG00000121594.7,119559614,3-119393712-A-T,rs935616,-1,A,T,119393712,165902,119363006,119756222,30706
3,ENSG00000187068.2,185153060,3-185064414-T-C,rs9755247,-1,T,C,185064414,88646,184956452,185349668,107962
3,ENSG00000187068.2,185153060,3-185064414-T-A,rs9755247,-1,T,A,185064414,88646,184956452,185349668,107962
3,ENSG00000144642.15,29281071,3-29283977-C-A,rs9815887,1,C,A,29283977,2906,29084463,29477679,199514
3,ENSG00000187118.8,28241619,3-28068855-G-A,rs9823676,1,G,A,28068855,172764,28045011,28438227,23844
3,ENSG00000173193.8,122680839,3-122811722-A-G,rs9830096,1,A,G,122811722,130883,122484231,122877447,327491
3,ENSG00000151093.3,25790090,3-25782526-G-C,rs983481,1,G,C,25782526,7564,25593482,25986698,189044
3,ENSG00000151093.3,25790090,3-25782526-G-A,rs983481,1,G,A,25782526,7564,25593482,25986698,189044
3,ENSG00000144659.5,39383370,3-39377990-A-T,rs9837442,1,A,T,39377990,5380,39186762,39579978,191228
3,ENSG00000179934.5,39329709,3-39378254-A-G,rs9837944,1,A,G,39378254,48545,39133101,39526317,245153
3,ENSG00000175792.6,128123812,3-128044373-T-C,rs9839328,-1,T,C,128044373,79439,127927204,128320420,117169
3,ENSG00000164049.9,48372219,3-48423559-G-T,rs9841713,1,G,T,48423559,51340,48175611,48568827,247948
3,ENSG00000164049.9,48372219,3-48423559-G-A,rs9841713,1,G,A,48423559,51340,48175611,48568827,247948
3,ENSG00000118855.12,158802054,3-158668800-A-G,rs9844619,1,A,G,158668800,133254,158605446,158998662,63354
3,ENSG00000158092.2,136862208,3-136887429-T-C,rs9846691,1,T,C,136887429,25221,136665600,137058816,221829
3,ENSG00000163528.8,14124870,3-14108914-A-C,rs9847221,-1,A,C,14108914,15956,13928262,14321478,180652
3,ENSG00000164087.3,52154423,3-52075652-C-T,rs9857878,-1,C,T,52075652,78771,51957815,52351031,117837
3,ENSG00000114503.6,196942528,3-196966244-C-T,rs9858636,-1,C,T,196966244,23716,196745920,197139136,220324
3,ENSG00000249992.1,45226287,3-45406220-A-G,rs9861724,-1,A,G,45406220,179933,45029679,45422895,376541
3,ENSG00000114670.8,131026877,3-131029889-A-G,rs9864242,1,A,G,131029889,3012,130830269,131223485,199620
3,ENSG00000114670.8,131026877,3-131029889-A-C,rs9864242,1,A,C,131029889,3012,130830269,131223485,199620
3,ENSG00000180376.12,56557175,3-56650620-C-T,rs9867302,1,C,T,56650620,93445,56360567,56753783,290053
3,ENSG00000181744.4,143971823,3-144040212-C-T,rs9868954,1,C,T,144040212,68389,143775215,144168431,264997
3,ENSG00000171109.13,179347709,3-179392605-G-A,rs9874433,1,G,A,179392605,44896,179151101,179544317,241504
3,ENSG00000171121.12,179251114,3-179264721-A-G,rs9875304,-1,A,G,179264721,13607,179054506,179447722,210215
3,ENSG00000093167.13,37174582,3-37042249-A-G,rs9876116,-1,A,G,37042249,132333,36977974,37371190,64275
3,ENSG00000093167.13,37174582,3-37042249-A-T,rs9876116,-1,A,T,37042249,132333,36977974,37371190,64275
3,ENSG00000171757.10,169812904,3-169812170-A-G,rs9878797,-1,A,G,169812170,734,169616296,170009512,195874
3,ENSG00000171757.10,169812904,3-169812170-A-C,rs9878797,-1,A,C,169812170,734,169616296,170009512,195874
3,ENSG00000171757.10,169812904,3-169812170-A-T,rs9878797,-1,A,T,169812170,734,169616296,170009512,195874
3,ENSG00000176945.11,195720978,3-195627293-G-A,rs9886958,1,G,A,195627293,93685,195524370,195917586,102923
3,ENSG00000176945.11,195720978,3-195627293-G-T,rs9886958,1,G,T,195627293,93685,195524370,195917586,102923
3,ENSG00000176945.11,195720978,3-195627293-G-C,rs9886958,1,G,C,195627293,93685,195524370,195917586,102923
3,ENSG00000196083.5,190514085,3-190464733-C-T,rs1019440,1,C,T,190464733,49352,190317477,190710693,147256
3,ENSG00000173540.8,49723951,3-49857648-T-C,rs10510756,-1,T,C,49857648,133697,49527343,49920559,330305
3,ENSG00000163755.4,149129638,3-149186647-T-G,rs1053709,1,T,G,149186647,57009,148933030,149326246,253617
3,ENSG00000173193.8,122680839,3-122729356-C-A,rs10934615,1,C,A,122729356,48517,122484231,122877447,245125
3,ENSG00000173193.8,122680839,3-122729356-C-T,rs10934615,1,C,T,122729356,48517,122484231,122877447,245125
3,ENSG00000173193.8,122680839,3-122729356-C-G,rs10934615,1,C,G,122729356,48517,122484231,122877447,245125
3,ENSG00000129048.5,132597270,3-132695152-T-C,rs10935028,1,T,C,132695152,97882,132400662,132793878,294490
3,ENSG00000163864.10,139677972,3-139721283-C-A,rs10935347,-1,C,A,139721283,43311,139481364,139874580,239919
3,ENSG00000163864.10,139677972,3-139721283-C-T,rs10935347,-1,C,T,139721283,43311,139481364,139874580,239919
3,ENSG00000065518.7,120596336,3-120683734-G-A,rs1108897,1,G,A,120683734,87398,120399728,120792944,284006
3,ENSG00000065518.7,120596336,3-120683734-G-T,rs1108897,1,G,T,120683734,87398,120399728,120792944,284006
3,ENSG00000163378.9,69013684,3-69096481-T-A,rs11128111,-1,T,A,69096481,82797,68817076,69210292,279405
3,ENSG00000163378.9,69013684,3-69096481-T-C,rs11128111,-1,T,C,69096481,82797,68817076,69210292,279405
3,ENSG00000163378.9,69013684,3-69096481-T-G,rs11128111,-1,T,G,69096481,82797,68817076,69210292,279405
3,ENSG00000168038.6,41962103,3-42138187-T-C,rs11129941,-1,T,C,42138187,176084,41765495,42158711,372692
3,ENSG00000076201.8,47381021,3-47557173-G-A,rs11130138,1,G,A,47557173,176152,47184413,47577629,372760
3,ENSG00000076201.8,47381021,3-47557173-G-C,rs11130138,1,G,C,47557173,176152,47184413,47577629,372760
3,ENSG00000164049.9,48372219,3-48421052-G-A,rs11130171,1,G,A,48421052,48833,48175611,48568827,245441
3,ENSG00000164049.9,48372219,3-48421052-G-T,rs11130171,1,G,T,48421052,48833,48175611,48568827,245441
3,ENSG00000067560.6,49411976,3-49578191-G-T,rs11130208,-1,G,T,49578191,166215,49215368,49608584,362823
3,ENSG00000067560.6,49411976,3-49578191-G-C,rs11130208,-1,G,C,49578191,166215,49215368,49608584,362823
3,ENSG00000067560.6,49411976,3-49578191-G-A,rs11130208,-1,G,A,49578191,166215,49215368,49608584,362823
3,ENSG00000186432.4,160565571,3-160720652-A-G,rs111325110,-1,A,G,160720652,155081,160368963,160762179,351689
3,ENSG00000182580.2,184561785,3-184576552-T-C,rs111611525,1,T,C,184576552,14767,184365177,184758393,211375
3,ENSG00000163380.11,69122595,3-69108943-T-G,rs1131960,-1,T,G,69108943,13652,68925987,69319203,182956
3,ENSG00000004838.9,50345732,3-50292249-G-A,rs113502427,-1,G,A,50292249,53483,50149124,50542340,143125
3,ENSG00000004838.9,50345732,3-50292249-G-T,rs113502427,-1,G,T,50292249,53483,50149124,50542340,143125
3,ENSG00000151092.12,25783443,3-25915413-G-A,rs114506229,-1,G,A,25915413,131970,25586835,25980051,328578
3,ENSG00000119227.3,196968833,3-196948045-A-G,rs1147240,-1,A,G,196948045,20788,196772225,197165441,175820
3,ENSG00000119227.3,196968833,3-196948045-A-C,rs1147240,-1,A,C,196948045,20788,196772225,197165441,175820
3,ENSG00000119227.3,196968833,3-196948045-A-T,rs1147240,-1,A,T,196948045,20788,196772225,197165441,175820
3,ENSG00000114779.14,51974049,3-51971622-G-A,rs114730569,-1,G,A,51971622,2427,51777441,52170657,194181
3,ENSG00000163430.4,120450992,3-120400599-C-G,rs1147695,-1,C,G,120400599,50393,120254384,120647600,146215
3,ENSG00000163430.4,120450992,3-120400599-C-T,rs1147695,-1,C,T,120400599,50393,120254384,120647600,146215
3,ENSG00000163412.7,71725402,3-71732507-G-A,rs115153300,-1,G,A,71732507,7105,71528794,71922010,203713
3,ENSG00000145016.9,197736904,3-197742612-C-T,rs115188262,-1,C,T,197742612,5708,197540296,197933512,202316
3,ENSG00000113946.3,190388163,3-190216195-A-G,rs115451822,1,A,G,190216195,171968,190191555,190584771,24640
3,ENSG00000163536.7,167735721,3-167622022-A-G,rs116240517,1,A,G,167622022,113699,167539113,167932329,82909
3,ENSG00000227124.4,75785549,3-75838593-C-T,rs11706909,-1,C,T,75838593,53044,75588941,75982157,249652
3,ENSG00000227124.4,75785549,3-75838593-C-G,rs11706909,-1,C,G,75838593,53044,75588941,75982157,249652
3,ENSG00000180376.12,56557175,3-56516593-G-A,rs11719298,1,G,A,56516593,40582,56360567,56753783,156026
3,ENSG00000163508.7,27722323,3-27668148-G-T,rs11916078,-1,G,T,27668148,54175,27525715,27918931,142433
3,ENSG00000163508.7,27722323,3-27668148-G-A,rs11916078,-1,G,A,27668148,54175,27525715,27918931,142433
3,ENSG00000113790.5,185254049,3-185291116-C-G,rs11918469,-1,C,G,185291116,37067,185057441,185450657,233675
3,ENSG00000113790.5,185254049,3-185291116-C-T,rs11918469,-1,C,T,185291116,37067,185057441,185450657,233675
3,ENSG00000114850.2,156555117,3-156619496-A-G,rs11919879,-1,A,G,156619496,64379,156358509,156751725,260987
3,ENSG00000082781.6,124887365,3-125050952-C-T,rs11921016,-1,C,T,125050952,163587,124690757,125083973,360195
3,ENSG00000058866.9,186362234,3-186241827-T-C,rs11921893,-1,T,C,186241827,120407,186165626,186558842,76201
3,ENSG00000163947.7,56801949,3-56868802-T-A,rs11923190,-1,T,A,56868802,66853,56605341,56998557,263461
3,ENSG00000163947.7,56801949,3-56868802-T-G,rs11923190,-1,T,G,56868802,66853,56605341,56998557,263461
3,ENSG00000163946.9,56683265,3-56823759-C-T,rs11929318,-1,C,T,56823759,140494,56486657,56879873,337102
3,ENSG00000173890.12,170037995,3-169958966-G-A,rs12107902,1,G,A,169958966,79029,169841387,170234603,117579
3,ENSG00000173890.12,170037995,3-169958966-G-T,rs12107902,1,G,T,169958966,79029,169841387,170234603,117579
3,ENSG00000206535.3,100401539,3-100346788-G-A,rs1214375,1,G,A,100346788,54751,100204931,100598147,141857
3,ENSG00000206535.3,100401539,3-100346788-G-T,rs1214375,1,G,T,100346788,54751,100204931,100598147,141857
3,ENSG00000152642.6,32106620,3-32076496-C-T,rs12490791,1,C,T,32076496,30124,31910012,32303228,166484
3,ENSG00000053524.6,183428619,3-183396220-T-C,rs12490878,-1,T,C,183396220,32399,183232011,183625227,164209
3,ENSG00000188846.8,40457339,3-40584877-A-G,rs12492728,1,A,G,40584877,127538,40260731,40653947,324146
3,ENSG00000251287.4,130081831,3-130135147-A-G,rs12496397,1,A,G,130135147,53316,129885223,130278439,249924
3,ENSG00000163659.8,156674590,3-156646047-G-A,rs12497720,1,G,A,156646047,28543,156477982,156871198,168065
3,ENSG00000163659.8,156674590,3-156646047-G-T,rs12497720,1,G,T,156646047,28543,156477982,156871198,168065
3,ENSG00000206527.5,123585053,3-123632637-A-G,rs1254398,-1,A,G,123632637,47584,123388445,123781661,244192
3,ENSG00000160796.10,46979666,3-47088413-C-G,rs12631730,1,C,G,47088413,108747,46783058,47176274,305355
3,ENSG00000160796.10,46979666,3-47088413-C-T,rs12631730,1,C,T,47088413,108747,46783058,47176274,305355
3,ENSG00000160796.10,46979666,3-47088413-C-A,rs12631730,1,C,A,47088413,108747,46783058,47176274,305355
3,ENSG00000168301.8,58492096,3-58559641-G-A,rs12633192,1,G,A,58559641,67545,58295488,58688704,264153
3,ENSG00000168301.8,58492096,3-58559641-G-C,rs12633192,1,G,C,58559641,67545,58295488,58688704,264153
3,ENSG00000161217.6,196287726,3-196278573-G-A,rs12637288,-1,G,A,196278573,9153,196091118,196484334,187455
3,ENSG00000161217.6,196287726,3-196278573-G-C,rs12637288,-1,G,C,196278573,9153,196091118,196484334,187455
3,ENSG00000161217.6,196287726,3-196278573-G-T,rs12637288,-1,G,T,196278573,9153,196091118,196484334,187455
3,ENSG00000188306.6,169812870,3-169759718-A-G,rs12638862,1,A,G,169759718,53152,169616262,170009478,143456
3,ENSG00000129055.8,134485985,3-134650874-C-G,rs13060869,-1,C,G,134650874,164889,134289377,134682593,361497
3,ENSG00000129055.8,134485985,3-134650874-C-A,rs13060869,-1,C,A,134650874,164889,134289377,134682593,361497
3,ENSG00000163814.3,45146378,3-45147423-T-G,rs13066534,-1,T,G,45147423,1045,44949770,45342986,197653
3,ENSG00000163389.6,119468963,3-119547946-A-C,rs13071247,1,A,C,119547946,78983,119272355,119665571,275591
3,ENSG00000158092.2,136862208,3-136786990-C-T,rs13075615,1,C,T,136786990,75218,136665600,137058816,121390
3,ENSG00000144597.9,15427598,3-15408893-C-T,rs13075694,1,C,T,15408893,18705,15230990,15624206,177903
3,ENSG00000145012.8,188154157,3-187980545-T-C,rs13086331,1,T,C,187980545,173612,187957549,188350765,22996
3,ENSG00000047457.9,149221829,3-149227783-G-A,rs13096289,-1,G,A,149227783,5954,149025221,149418437,202562
3,ENSG00000168334.8,39192595,3-39282352-T-A,rs13098237,-1,T,A,39282352,89757,38995987,39389203,286365
3,ENSG00000168334.8,39192595,3-39282352-T-C,rs13098237,-1,T,C,39282352,89757,38995987,39389203,286365
3,ENSG00000144647.5,43106079,3-43150523-T-G,rs13318004,-1,T,G,43150523,44444,42909471,43302687,241052
3,ENSG00000018408.10,149658025,3-149655593-T-C,rs13325622,-1,T,C,149655593,2432,149461417,149854633,194176
3,ENSG00000173402.6,49470267,3-49664224-T-C,rs13326722,1,T,C,49664224,193957,49273659,49666875,390565
3,ENSG00000164081.8,51671252,3-51530414-C-T,rs13353437,1,C,T,51530414,140838,51474644,51867860,55770
3,ENSG00000144659.5,39383370,3-39224630-C-T,rs1344220,1,C,T,39224630,158740,39186762,39579978,37868
3,ENSG00000144659.5,39383370,3-39224630-C-G,rs1344220,1,C,G,39224630,158740,39186762,39579978,37868
3,ENSG00000154917.6,133895882,3-133765344-C-T,rs1358024,-1,C,T,133765344,130538,133699274,134092490,66070
3,ENSG00000154917.6,133895882,3-133765344-C-G,rs1358024,-1,C,G,133765344,130538,133699274,134092490,66070
3,ENSG00000230301.3,98264244,3-98231933-G-A,rs1391152,1,G,A,98231933,32311,98067636,98460852,164297
3,ENSG00000075914.8,44976244,3-44907182-G-T,rs1395388,1,G,T,44907182,69062,44779636,45172852,127546
3,ENSG00000075914.8,44976244,3-44907182-G-C,rs1395388,1,G,C,44907182,69062,44779636,45172852,127546
3,ENSG00000163807.4,44761619,3-44645808-G-A,rs1402752,-1,G,A,44645808,115811,44565011,44958227,80797
3,ENSG00000163807.4,44761619,3-44645808-G-C,rs1402752,-1,G,C,44645808,115811,44565011,44958227,80797
3,ENSG00000085274.10,169773396,3-169632945-C-T,rs1421004,1,C,T,169632945,140451,169576788,169970004,56157
3,ENSG00000182568.11,18425339,3-18620985-T-C,rs1440968,-1,T,C,18620985,195646,18228731,18621947,392254
3,ENSG00000144868.9,133038391,3-133165371-A-G,rs1450053,1,A,G,133165371,126980,132841783,133234999,323588
3,ENSG00000174007.7,196712250,3-196727148-C-T,rs1463628,-1,C,T,196727148,14898,196515642,196908858,211506
3,ENSG00000075975.11,12557087,3-12747439-G-C,rs1467025,1,G,C,12747439,190352,12360479,12753695,386960
3,ENSG00000075975.11,12557087,3-12747439-G-A,rs1467025,1,G,A,12747439,190352,12360479,12753695,386960
3,ENSG00000163634.7,63863805,3-63763768-A-G,rs1472337,-1,A,G,63763768,100037,63667197,64060413,96571
3,ENSG00000163634.7,63863805,3-63763768-A-T,rs1472337,-1,A,T,63763768,100037,63667197,64060413,96571
3,ENSG00000163634.7,63863805,3-63763768-A-C,rs1472337,-1,A,C,63763768,100037,63667197,64060413,96571
3,ENSG00000261796.1,129161036,3-129053371-A-G,rs1482410,-1,A,G,129053371,107665,128964428,129357644,88943
3,ENSG00000114529.8,112086389,3-112141375-A-G,rs1492480,1,A,G,112141375,54986,111889781,112282997,251594
3,ENSG00000114529.8,112086389,3-112141375-A-T,rs1492480,1,A,T,112141375,54986,111889781,112282997,251594
3,ENSG00000114812.8,42502643,3-42462128-G-A,rs1508209,1,G,A,42462128,40515,42306035,42699251,156093
3,ENSG00000114812.8,42502643,3-42462128-G-C,rs1508209,1,G,C,42462128,40515,42306035,42699251,156093
3,ENSG00000163884.3,126357408,3-126457706-A-G,rs1552640,-1,A,G,126457706,100298,126160800,126554016,296906
3,ENSG00000145029.6,49429324,3-49483525-A-G,rs1568661,-1,A,G,49483525,54201,49232716,49625932,250809
3,ENSG00000145029.6,49429324,3-49483525-A-T,rs1568661,-1,A,T,49483525,54201,49232716,49625932,250809
3,ENSG00000138468.11,101513212,3-101557058-A-C,rs1609159,-1,A,C,101557058,43846,101316604,101709820,240454
3,ENSG00000231861.1,98497681,3-98498868-G-C,rs16839818,1,G,C,98498868,1187,98301073,98694289,197795
3,ENSG00000231861.1,98497681,3-98498868-G-T,rs16839818,1,G,T,98498868,1187,98301073,98694289,197795
3,ENSG00000091513.10,133746393,3-133693516-C-G,rs16840612,1,C,G,133693516,52877,133549785,133943001,143731
3,ENSG00000091513.10,133746393,3-133693516-C-T,rs16840612,1,C,T,133693516,52877,133549785,133943001,143731
3,ENSG00000091513.10,133746393,3-133693516-C-A,rs16840612,1,C,A,133693516,52877,133549785,133943001,143731
3,ENSG00000114796.10,183635623,3-183489337-C-A,rs16857674,1,C,A,183489337,146286,183439015,183832231,50322
3,ENSG00000157087.11,10505586,3-10465199-C-A,rs17032929,-1,C,A,10465199,40387,10308978,10702194,156221
3,ENSG00000157087.11,10505586,3-10465199-C-T,rs17032929,-1,C,T,10465199,40387,10308978,10702194,156221
3,ENSG00000132170.15,12289070,3-12312912-T-G,rs17036281,1,T,G,12312912,23842,12092462,12485678,220450
3,ENSG00000132170.15,12289070,3-12312912-T-C,rs17036281,1,T,C,12312912,23842,12092462,12485678,220450
3,ENSG00000225526.2,12545499,3-12465902-T-C,rs17036788,-1,T,C,12465902,79597,12348891,12742107,117011
3,ENSG00000168374.6,57597344,3-57421488-T-C,rs17058102,-1,T,C,57421488,175856,57400736,57793952,20752
3,ENSG00000168374.6,57597344,3-57421488-T-A,rs17058102,-1,T,A,57421488,175856,57400736,57793952,20752
3,ENSG00000113924.7,120682239,3-120784621-C-G,rs17184204,-1,C,G,120784621,102382,120485631,120878847,298990
3,ENSG00000196776.10,108091031,3-108110715-C-T,rs17231712,-1,C,T,108110715,19684,107894423,108287639,216292
3,ENSG00000196776.10,108091031,3-108110715-C-G,rs17231712,-1,C,G,108110715,19684,107894423,108287639,216292
3,ENSG00000114021.6,100334757,3-100335646-G-T,rs17279967,1,G,T,100335646,889,100138149,100531365,197497
3,ENSG00000114021.6,100334757,3-100335646-G-C,rs17279967,1,G,C,100335646,889,100138149,100531365,197497
3,ENSG00000121577.9,119660589,3-119629283-G-C,rs17281751,-1,G,C,119629283,31306,119463981,119857197,165302
3,ENSG00000173175.10,123449090,3-123503521-A-G,rs17296876,-1,A,G,123503521,54431,123252482,123645698,251039
3,ENSG00000163428.3,120349354,3-120384162-C-G,rs1733324,-1,C,G,120384162,34808,120152746,120545962,231416
3,ENSG00000163428.3,120349354,3-120384162-C-T,rs1733324,-1,C,T,120384162,34808,120152746,120545962,231416
3,ENSG00000163689.13,59050025,3-59049363-T-G,rs17643242,-1,T,G,59049363,662,58853417,59246633,195946
3,ENSG00000185565.6,116445487,3-116305177-T-C,rs17645807,-1,T,C,116305177,140310,116248879,116642095,56298
3,ENSG00000071282.7,8501823,3-8551575-G-A,rs17728158,1,G,A,8551575,49752,8305215,8698431,246360
3,ENSG00000180914.6,8769613,3-8904551-G-A,rs17791487,-1,G,A,8904551,134938,8573005,8966221,331546
3,ENSG00000180914.6,8769613,3-8904551-G-T,rs17791487,-1,G,T,8904551,134938,8573005,8966221,331546
3,ENSG00000093167.13,37174582,3-36993455-G-A,rs1800734,-1,G,A,36993455,181127,36977974,37371190,15481
3,ENSG00000093167.13,37174582,3-36993455-G-C,rs1800734,-1,G,C,36993455,181127,36977974,37371190,15481
3,ENSG00000205981.2,180989736,3-180975952-G-C,rs1805626,-1,G,C,180975952,13784,180793128,181186344,182824
3,ENSG00000114446.4,108222424,3-108382476-A-T,rs1870011,-1,A,T,108382476,160052,108025816,108419032,356660
3,ENSG00000114446.4,108222424,3-108382476-A-C,rs1870011,-1,A,C,108382476,160052,108025816,108419032,356660
3,ENSG00000114446.4,108222424,3-108382476-A-G,rs1870011,-1,A,G,108382476,160052,108025816,108419032,356660
3,ENSG00000121797.8,46407259,3-46394124-T-C,rs1894389,1,T,C,46394124,13135,46210651,46603867,183473
3,ENSG00000172020.8,115623510,3-115648119-C-T,rs2028248,1,C,T,115648119,24609,115426902,115820118,221217
3,ENSG00000180370.5,196739857,3-196827149-C-G,rs2084386,1,C,G,196827149,87292,196543249,196936465,283900
3,ENSG00000180370.5,196739857,3-196827149-C-T,rs2084386,1,C,T,196827149,87292,196543249,196936465,283900
3,ENSG00000180370.5,196739857,3-196827149-C-A,rs2084386,1,C,A,196827149,87292,196543249,196936465,283900
3,ENSG00000213689.5,48466230,3-48542740-A-G,rs2109181,1,A,G,48542740,76510,48269622,48662838,273118
3,ENSG00000163576.13,19934217,3-19967806-C-A,rs2127956,-1,C,A,19967806,33589,19737609,20130825,230197
3,ENSG00000003756.11,50088919,3-50136592-T-C,rs2189691,1,T,C,50136592,47673,49892311,50285527,244281
3,ENSG00000213672.3,48685915,3-48518906-G-A,rs2267846,-1,G,A,48518906,167009,48489307,48882523,29599
3,ENSG00000157017.11,10292947,3-10249969-C-T,rs2270452,-1,C,T,10249969,42978,10096339,10489555,153630
3,ENSG00000144655.9,39153591,3-39189506-A-G,rs2271487,-1,A,G,39189506,35915,38956983,39350199,232523
3,ENSG00000144655.9,39153591,3-39189506-A-T,rs2271487,-1,A,T,39189506,35915,38956983,39350199,232523
3,ENSG00000004399.8,129606676,3-129584229-G-A,rs2285371,-1,G,A,129584229,22447,129410068,129803284,174161
3,ENSG00000144736.9,72848445,3-72660251-A-C,rs2322574,-1,A,C,72660251,188194,72651837,73045053,8414
3,ENSG00000144736.9,72848445,3-72660251-A-G,rs2322574,-1,A,G,72660251,188194,72651837,73045053,8414
3,ENSG00000163320.6,88059005,3-88039526-C-T,rs2344185,-1,C,T,88039526,19479,87862397,88255613,177129
3,ENSG00000163320.6,88059005,3-88039526-C-A,rs2344185,-1,C,A,88039526,19479,87862397,88255613,177129
3,ENSG00000164048.8,48241104,3-48358338-C-T,rs2362451,1,C,T,48358338,117234,48044496,48437712,313842
3,ENSG00000157014.5,10248459,3-10342312-G-C,rs241508,1,G,C,10342312,93853,10051851,10445067,290461
3,ENSG00000157014.5,10248459,3-10342312-G-A,rs241508,1,G,A,10342312,93853,10051851,10445067,290461
3,ENSG00000214706.6,50292429,3-50143702-T-C,rs2526385,-1,T,C,50143702,148727,50095821,50489037,47881
3,ENSG00000214706.6,50292429,3-50143702-T-G,rs2526385,-1,T,G,50143702,148727,50095821,50489037,47881
3,ENSG00000163710.3,142889083,3-142916776-G-A,rs2581626,-1,G,A,142916776,27693,142692475,143085691,224301
3,ENSG00000163710.3,142889083,3-142916776-G-C,rs2581626,-1,G,C,142916776,27693,142692475,143085691,224301
3,ENSG00000196220.9,9249646,3-9360377-C-T,rs2600178,-1,C,T,9360377,110731,9053038,9446254,307339
3,ENSG00000196220.9,9249646,3-9360377-C-G,rs2600178,-1,C,G,9360377,110731,9053038,9446254,307339
3,ENSG00000196220.9,9249646,3-9360377-C-A,rs2600178,-1,C,A,9360377,110731,9053038,9446254,307339
3,ENSG00000134070.4,10164919,3-10174266-T-G,rs2619508,1,T,G,10174266,9347,9968311,10361527,205955
3,ENSG00000163870.10,127590733,3-127702011-C-T,rs2630210,-1,C,T,127702011,111278,127394125,127787341,307886
3,ENSG00000114670.8,131026877,3-131177577-G-A,rs2718877,1,G,A,131177577,150700,130830269,131223485,347308
3,ENSG00000114670.8,131026877,3-131177577-G-C,rs2718877,1,G,C,131177577,150700,130830269,131223485,347308
3,ENSG00000170876.7,14125052,3-14126788-A-G,rs2733584,1,A,G,14126788,1736,13928444,14321660,198344
3,ENSG00000170876.7,14125052,3-14126788-A-T,rs2733584,1,A,T,14126788,1736,13928444,14321660,198344
3,ENSG00000198836.4,193593208,3-193709992-G-A,rs280537,1,G,A,193709992,116784,193396600,193789816,313392
3,ENSG00000173200.7,122577650,3-122532991-C-A,rs28403550,1,C,A,122532991,44659,122381042,122774258,151949
3,ENSG00000173200.7,122577650,3-122532991-C-G,rs28403550,1,C,G,122532991,44659,122381042,122774258,151949
3,ENSG00000163902.6,128650818,3-128801708-C-G,rs28407141,-1,C,G,128801708,150890,128454210,128847426,347498
3,ENSG00000114026.15,9749952,3-9837913-C-T,rs28461387,1,C,T,9837913,87961,9553344,9946560,284569
3,ENSG00000163827.8,46566302,3-46551497-A-G,rs28687398,-1,A,G,46551497,14805,46369694,46762910,181803
3,ENSG00000144712.7,12796680,3-12788580-G-T,rs28690499,1,G,T,12788580,8100,12600072,12993288,188508
3,ENSG00000114166.7,20040446,3-20003869-A-T,rs2948104,1,A,T,20003869,36577,19843838,20237054,160031
3,ENSG00000114166.7,20040446,3-20003869-A-G,rs2948104,1,A,G,20003869,36577,19843838,20237054,160031
3,ENSG00000114166.7,20040446,3-20003869-A-C,rs2948104,1,A,C,20003869,36577,19843838,20237054,160031
3,ENSG00000144455.8,4467269,3-4336519-G-T,rs308734,-1,G,T,4336519,130750,4270661,4663877,65858
3,ENSG00000144455.8,4467269,3-4336519-G-A,rs308734,-1,G,A,4336519,130750,4270661,4663877,65858
3,ENSG00000144455.8,4467269,3-4336519-G-C,rs308734,-1,G,C,4336519,130750,4270661,4663877,65858
3,ENSG00000164054.10,48504174,3-48466268-T-A,rs3135941,-1,T,A,48466268,37906,48307566,48700782,158702
3,ENSG00000164054.10,48504174,3-48466268-T-C,rs3135941,-1,T,C,48466268,37906,48307566,48700782,158702
3,ENSG00000164054.10,48504174,3-48466268-T-G,rs3135941,-1,T,G,48466268,37906,48307566,48700782,158702
3,ENSG00000225697.5,48635461,3-48694054-G-T,rs3172494,-1,G,T,48694054,58593,48438853,48832069,255201
3,ENSG00000189058.4,195583940,3-195588069-C-T,rs34605848,-1,C,T,195588069,4129,195387332,195780548,200737
3,ENSG00000114757.13,180036937,3-180178557-C-T,rs35214500,-1,C,T,180178557,141620,179840329,180233545,338228
3,ENSG00000168028.8,39406720,3-39392312-G-A,rs35283414,1,G,A,39392312,14408,39210112,39603328,182200
3,ENSG00000151967.14,159839861,3-159942555-C-T,rs35379497,1,C,T,159942555,102694,159643253,160036469,299302
3,ENSG00000163959.5,196216534,3-196323963-C-T,rs35643777,1,C,T,196323963,107429,196019926,196413142,304037
3,ENSG00000163959.5,196216534,3-196323963-C-G,rs35643777,1,C,G,196323963,107429,196019926,196413142,304037
3,ENSG00000114107.4,138594260,3-138628322-T-C,rs361073,-1,T,C,138628322,34062,138397652,138790868,230670
3,ENSG00000114107.4,138594260,3-138628322-T-A,rs361073,-1,T,A,138628322,34062,138397652,138790868,230670
3,ENSG00000114107.4,138594260,3-138628322-T-G,rs361073,-1,T,G,138628322,34062,138397652,138790868,230670
3,ENSG00000171109.13,179347709,3-179229537-A-C,rs3729692,1,A,C,179229537,118172,179151101,179544317,78436
3,ENSG00000181458.6,100492619,3-100364801-A-G,rs3772687,1,A,G,100364801,127818,100296011,100689227,68790
3,ENSG00000163687.8,58210972,3-58200992-C-G,rs3772985,-1,C,G,58200992,9980,58014364,58407580,186628
3,ENSG00000163687.8,58210972,3-58200992-C-A,rs3772985,-1,C,A,58200992,9980,58014364,58407580,186628
3,ENSG00000163975.7,197029817,3-197139871-T-C,rs3773853,-1,T,C,197139871,110054,196833209,197226425,306662
3,ENSG00000163975.7,197029817,3-197139871-T-A,rs3773853,-1,T,A,197139871,110054,196833209,197226425,306662
3,ENSG00000162244.5,51995895,3-51947005-C-T,rs3774344,-1,C,T,51947005,48890,51799287,52192503,147718
3,ENSG00000177352.9,49166331,3-49297335-G-A,rs3774800,-1,G,A,49297335,131004,48969723,49362939,327612
3,ENSG00000177352.9,49166331,3-49297335-G-C,rs3774800,-1,G,C,49297335,131004,48969723,49362939,327612
3,ENSG00000177352.9,49166331,3-49297335-G-T,rs3774800,-1,G,T,49297335,131004,48969723,49362939,327612
3,ENSG00000152952.7,146161184,3-146092621-G-A,rs3804664,-1,G,A,146092621,68563,145964576,146357792,128045
3,ENSG00000144834.7,111998922,3-111997348-G-A,rs3811705,1,G,A,111997348,1574,111802314,112195530,195034
3,ENSG00000182923.11,134486057,3-134606694-G-T,rs4074521,1,G,T,134606694,120637,134289449,134682665,317245
3,ENSG00000182923.11,134486057,3-134606694-G-A,rs4074521,1,G,A,134606694,120637,134289449,134682665,317245
3,ENSG00000163833.6,121593379,3-121757201-A-G,rs4234145,1,A,G,121757201,163822,121396771,121789987,360430
3,ENSG00000163833.6,121593379,3-121757201-A-C,rs4234145,1,A,C,121757201,163822,121396771,121789987,360430
3,ENSG00000145088.4,121835209,3-121795314-T-C,rs4311252,1,T,C,121795314,39895,121638601,122031817,156713
3,ENSG00000071794.10,149086533,3-148966607-G-A,rs4401324,-1,G,A,148966607,119926,148889925,149283141,76682
3,ENSG00000041880.10,51942363,3-51907769-C-T,rs4416372,1,C,T,51907769,34594,51745755,52138971,162014
3,ENSG00000041880.10,51942363,3-51907769-C-G,rs4416372,1,C,G,51907769,34594,51745755,52138971,162014
3,ENSG00000114786.11,51975060,3-51907769-C-T,rs4416372,1,C,T,51907769,67291,51778452,52171668,129317
3,ENSG00000114786.11,51975060,3-51907769-C-G,rs4416372,1,C,G,51907769,67291,51778452,52171668,129317
3,ENSG00000154310.12,171460405,3-171306733-A-G,rs4455343,-1,A,G,171306733,153672,171263797,171657013,42936
3,ENSG00000197885.6,23916990,3-23934090-C-G,rs4490300,-1,C,G,23934090,17100,23720382,24113598,213708
3,ENSG00000197885.6,23916990,3-23934090-C-T,rs4490300,-1,C,T,23934090,17100,23720382,24113598,213708
3,ENSG00000144824.14,111859265,3-111898714-A-G,rs4516579,1,A,G,111898714,39449,111662657,112055873,236057
3,ENSG00000055955.10,52830672,3-52963855-T-A,rs4519686,-1,T,A,52963855,133183,52634064,53027280,329791
3,ENSG00000055955.10,52830672,3-52963855-T-C,rs4519686,-1,T,C,52963855,133183,52634064,53027280,329791
3,ENSG00000197980.6,156826353,3-156856463-T-C,rs453219,1,T,C,156856463,30110,156629745,157022961,226718
3,ENSG00000197980.6,156826353,3-156856463-T-A,rs453219,1,T,A,156856463,30110,156629745,157022961,226718
3,ENSG00000197980.6,156826353,3-156856463-T-G,rs453219,1,T,G,156856463,30110,156629745,157022961,226718
3,ENSG00000255423.1,73061659,3-73075649-G-A,rs4676902,1,G,A,73075649,13990,72865051,73258267,210598
3,ENSG00000255423.1,73061659,3-73075649-G-T,rs4676902,1,G,T,73075649,13990,72865051,73258267,210598
3,ENSG00000169359.8,155854427,3-155986141-A-C,rs4680225,-1,A,C,155986141,131714,155657819,156051035,328322
3,ENSG00000169359.8,155854427,3-155986141-A-T,rs4680225,-1,A,T,155986141,131714,155657819,156051035,328322
3,ENSG00000169359.8,155854427,3-155986141-A-G,rs4680225,-1,A,G,155986141,131714,155657819,156051035,328322
3,ENSG00000077097.8,25664907,3-25587258-G-T,rs4681028,-1,G,T,25587258,77649,25468299,25861515,118959
3,ENSG00000175040.4,143119771,3-143074993-A-G,rs4683728,1,A,G,143074993,44778,142923163,143316379,151830
3,ENSG00000183833.11,119703022,3-119740004-C-T,rs4688033,1,C,T,119740004,36982,119506414,119899630,233590
3,ENSG00000136522.9,179604638,3-179450674-C-T,rs4855074,-1,C,T,179450674,153964,179408030,179801246,42644
3,ENSG00000136522.9,179604638,3-179450674-C-A,rs4855074,-1,C,A,179450674,153964,179408030,179801246,42644
3,ENSG00000114455.9,108296490,3-108366911-C-T,rs4855644,1,C,T,108366911,70421,108099882,108493098,267029
3,ENSG00000114455.9,108296490,3-108366911-C-A,rs4855644,1,C,A,108366911,70421,108099882,108493098,267029
3,ENSG00000121858.6,172523430,3-172515579-A-G,rs4894559,-1,A,G,172515579,7851,172326822,172720038,188757
3,ENSG00000121858.6,172523430,3-172515579-A-T,rs4894559,-1,A,T,172515579,7851,172326822,172720038,188757
3,ENSG00000153551.9,32391853,3-32485841-G-T,rs4955157,1,G,T,32485841,93988,32195245,32588461,290596
3,ENSG00000073849.10,186930526,3-187017902-A-C,rs5001409,1,A,C,187017902,87376,186733918,187127134,283984
3,ENSG00000078081.3,183162734,3-183153676-A-G,rs500288,-1,A,G,183153676,9058,182966126,183359342,187550
3,ENSG00000181804.9,143848468,3-143809670-A-C,rs56166522,-1,A,C,143809670,38798,143651860,144045076,157810
3,ENSG00000163930.5,52410008,3-52226388-C-A,rs5743839,-1,C,A,52226388,183620,52213400,52606616,12988
3,ENSG00000163930.5,52410008,3-52226388-C-T,rs5743839,-1,C,T,52226388,183620,52213400,52606616,12988
3,ENSG00000168329.8,39280036,3-39327476-G-A,rs59744905,-1,G,A,39327476,47440,39083428,39476644,244048
3,ENSG00000240303.3,132659809,3-132499231-C-T,rs61748102,-1,C,T,132499231,160578,132463201,132856417,36030
3,ENSG00000184220.6,99817862,3-99691817-C-G,rs621061,1,C,G,99691817,126045,99621254,100014470,70563
3,ENSG00000184220.6,99817862,3-99691817-C-T,rs621061,1,C,T,99691817,126045,99621254,100014470,70563
3,ENSG00000114646.5,47578865,3-47615615-T-C,rs62262085,-1,T,C,47615615,36750,47382257,47775473,233358
3,ENSG00000144852.12,119782101,3-119808059-C-T,rs62264686,1,C,T,119808059,25958,119585493,119978709,222566
3,ENSG00000144852.12,119782101,3-119808059-C-A,rs62264686,1,C,A,119808059,25958,119585493,119978709,222566
3,ENSG00000145014.13,194633419,3-194633785-A-T,rs6437394,-1,A,T,194633785,366,194436811,194830027,196974
3,ENSG00000145014.13,194633419,3-194633785-A-G,rs6437394,-1,A,G,194633785,366,194436811,194830027,196974
3,ENSG00000145014.13,194633419,3-194633785-A-C,rs6437394,-1,A,C,194633785,366,194436811,194830027,196974
3,ENSG00000206530.4,113441493,3-113419233-A-G,rs6438148,-1,A,G,113419233,22260,113244885,113638101,174348
3,ENSG00000173226.12,121835060,3-121766392-G-T,rs6438656,-1,G,T,121766392,68668,121638452,122031668,127940
3,ENSG00000173226.12,121835060,3-121766392-G-A,rs6438656,-1,G,A,121766392,68668,121638452,122031668,127940
3,ENSG00000181322.9,138329851,3-138196362-C-T,rs6439792,-1,C,T,138196362,133489,138133243,138526459,63119
3,ENSG00000079257.3,158672648,3-158581766-T-A,rs6441208,-1,T,A,158581766,90882,158476040,158869256,105726
3,ENSG00000144792.5,44584964,3-44653014-G-T,rs6441863,1,G,T,44653014,68050,44388356,44781572,264658
3,ENSG00000144792.5,44584964,3-44653014-G-A,rs6441863,1,G,A,44653014,68050,44388356,44781572,264658
3,ENSG00000144792.5,44584964,3-44653014-G-C,rs6441863,1,G,C,44653014,68050,44388356,44781572,264658
3,ENSG00000196653.6,44712660,3-44768615-C-G,rs6441867,1,C,G,44768615,55955,44516052,44909268,252563
3,ENSG00000196653.6,44712660,3-44768615-C-T,rs6441867,1,C,T,44768615,55955,44516052,44909268,252563
3,ENSG00000196653.6,44712660,3-44768615-C-A,rs6441867,1,C,A,44768615,55955,44516052,44909268,252563
3,ENSG00000113838.8,186567339,3-186608039-C-G,rs6444150,-1,C,G,186608039,40700,186370731,186763947,237308
3,ENSG00000113838.8,186567339,3-186608039-C-A,rs6444150,-1,C,A,186608039,40700,186370731,186763947,237308
3,ENSG00000113838.8,186567339,3-186608039-C-T,rs6444150,-1,C,T,186608039,40700,186370731,186763947,237308
3,ENSG00000114841.11,52316319,3-52133157-G-A,rs6445259,1,G,A,52133157,183162,52119711,52512927,13446
3,ENSG00000144959.5,172711067,3-172695097-G-A,rs651165,-1,G,A,172695097,15970,172514459,172907675,180638
3,ENSG00000163961.4,196503768,3-196576790-G-A,rs6583322,-1,G,A,196576790,73022,196307160,196700376,269630
3,ENSG00000114405.6,62319022,3-62127409-C-A,rs67068291,1,C,A,62127409,191613,62122414,62515630,4995
3,ENSG00000163820.10,45995824,3-46062803-C-T,rs6764189,-1,C,T,46062803,66979,45799216,46192432,263587
3,ENSG00000163820.10,45995824,3-46062803-C-G,rs6764189,-1,C,G,46062803,66979,45799216,46192432,263587
3,ENSG00000163820.10,45995824,3-46062803-C-A,rs6764189,-1,C,A,46062803,66979,45799216,46192432,263587
3,ENSG00000144843.7,119579492,3-119533391-C-T,rs6767853,1,C,T,119533391,46101,119382884,119776100,150507
3,ENSG00000114739.8,38453890,3-38636518-A-G,rs6768135,1,A,G,38636518,182628,38257282,38650498,379236
3,ENSG00000168036.12,41199505,3-41246975-G-A,rs6769117,1,G,A,41246975,47470,41002897,41396113,244078
3,ENSG00000114859.10,184361605,3-184347276-G-C,rs6770808,-1,G,C,184347276,14329,184164997,184558213,182279
3,ENSG00000114859.10,184361605,3-184347276-G-A,rs6770808,-1,G,A,184347276,14329,184164997,184558213,182279
3,ENSG00000168237.12,52287828,3-52433195-C-A,rs6771643,1,C,A,52433195,145367,52091220,52484436,341975
3,ENSG00000069849.6,141876643,3-141865633-A-G,rs6773662,1,A,G,141865633,11010,141680035,142073251,185598
3,ENSG00000144741.12,66221001,3-66260027-C-T,rs6777571,1,C,T,66260027,39026,66024393,66417609,235634
3,ENSG00000182606.9,42091357,3-42080137-G-C,rs6779231,1,G,C,42080137,11220,41894749,42287965,185388
3,ENSG00000182606.9,42091357,3-42080137-G-T,rs6779231,1,G,T,42080137,11220,41894749,42287965,185388
3,ENSG00000182606.9,42091357,3-42080137-G-A,rs6779231,1,G,A,42080137,11220,41894749,42287965,185388
3,ENSG00000058056.4,179653040,3-179540568-C-A,rs6779495,1,C,A,179540568,112472,179456432,179849648,84136
3,ENSG00000058056.4,179653040,3-179540568-C-T,rs6779495,1,C,T,179540568,112472,179456432,179849648,84136
3,ENSG00000196981.2,122416062,3-122531317-T-G,rs6780909,-1,T,G,122531317,115255,122219454,122612670,311863
3,ENSG00000171121.12,179251114,3-179241356-C-T,rs6786049,-1,C,T,179241356,9758,179054506,179447722,186850
3,ENSG00000144674.12,37243271,3-37199280-G-A,rs6789232,1,G,A,37199280,43991,37046663,37439879,152617
3,ENSG00000131373.10,15601569,3-15581564-G-C,rs6794169,-1,G,C,15581564,20005,15404961,15798177,176603
3,ENSG00000131373.10,15601569,3-15581564-G-T,rs6794169,-1,G,T,15581564,20005,15404961,15798177,176603
3,ENSG00000131373.10,15601569,3-15581564-G-A,rs6794169,-1,G,A,15581564,20005,15404961,15798177,176603
3,ENSG00000198585.7,131381774,3-131372157-T-C,rs6796004,1,T,C,131372157,9617,131185166,131578382,186991
3,ENSG00000160801.9,46877721,3-46825376-G-A,rs6796502,1,G,A,46825376,52345,46681113,47074329,144263
3,ENSG00000160801.9,46877721,3-46825376-G-T,rs6796502,1,G,T,46825376,52345,46681113,47074329,144263
3,ENSG00000160801.9,46877721,3-46825376-G-C,rs6796502,1,G,C,46825376,52345,46681113,47074329,144263
3,ENSG00000182504.6,101724614,3-101824759-G-A,rs6797522,1,G,A,101824759,100145,101528006,101921222,296753
3,ENSG00000127249.10,193554895,3-193528134-G-A,rs6799489,-1,G,A,193528134,26761,193358287,193751503,169847
3,ENSG00000144711.8,13073429,3-13088896-G-C,rs6801338,-1,G,C,13088896,15467,12876821,13270037,212075
3,ENSG00000144711.8,13073429,3-13088896-G-A,rs6801338,-1,G,A,13088896,15467,12876821,13270037,212075
3,ENSG00000114251.8,55487306,3-55648698-C-T,rs709336,-1,C,T,55648698,161392,55290698,55683914,358000
3,ENSG00000114251.8,55487306,3-55648698-C-G,rs709336,-1,C,G,55648698,161392,55290698,55683914,358000
3,ENSG00000154165.3,98531978,3-98579756-C-T,rs7103,1,C,T,98579756,47778,98335370,98728586,244386
3,ENSG00000163528.8,14124870,3-13964408-C-T,rs73018877,-1,C,T,13964408,160462,13928262,14321478,36146
3,ENSG00000008226.15,38039208,3-37992025-C-T,rs73060805,1,C,T,37992025,47183,37842600,38235816,149425
3,ENSG00000004534.9,49940150,3-50024528-C-A,rs73079076,1,C,A,50024528,84378,49743542,50136758,280986
3,ENSG00000232382.1,98463201,3-98546594-C-G,rs73144182,1,C,G,98546594,83393,98266593,98659809,280001
3,ENSG00000198829.4,151873643,3-151698140-C-T,rs73164654,1,C,T,151698140,175503,151677035,152070251,21105
3,ENSG00000114544.10,126084124,3-125908289-C-T,rs73196253,-1,C,T,125908289,175835,125887516,126280732,20773
3,ENSG00000182899.10,197950190,3-197907152-G-A,rs73210173,1,G,A,197907152,43038,197753582,198146798,153570
3,ENSG00000169313.8,151384753,3-151383379-C-T,rs7429509,-1,C,T,151383379,1374,151188145,151581361,195234
3,ENSG00000169313.8,151384753,3-151383379-C-G,rs7429509,-1,C,G,151383379,1374,151188145,151581361,195234
3,ENSG00000080200.5,97822011,3-98003904-A-G,rs74470022,1,A,G,98003904,181893,97625403,98018619,378501
3,ENSG00000080200.5,97822011,3-98003904-A-C,rs74470022,1,A,C,98003904,181893,97625403,98018619,378501
3,ENSG00000163898.5,185552588,3-185547397-T-C,rs74474250,-1,T,C,185547397,5191,185355980,185749196,191417
3,ENSG00000074416.8,127822515,3-127896934-A-G,rs74505202,-1,A,G,127896934,74419,127625907,128019123,271027
3,ENSG00000196353.7,132035014,3-131841312-G-A,rs750048,-1,G,A,131841312,193702,131838406,132231622,2906
3,ENSG00000160145.10,124033369,3-124115976-G-T,rs75386492,1,G,T,124115976,82607,123836761,124229977,279215
3,ENSG00000010256.6,48609646,3-48420121-G-A,rs75665465,-1,G,A,48420121,189525,48413038,48806254,7083
3,ENSG00000181788.3,150763169,3-150667395-G-A,rs7611154,-1,G,A,150667395,95774,150566561,150959777,100834
3,ENSG00000181788.3,150763169,3-150667395-G-T,rs7611154,-1,G,T,150667395,95774,150566561,150959777,100834
3,ENSG00000051382.4,138834928,3-138849749-A-T,rs7613579,-1,A,T,138849749,14821,138638320,139031536,211429
3,ENSG00000051382.4,138834928,3-138849749-A-G,rs7613579,-1,A,G,138849749,14821,138638320,139031536,211429
3,ENSG00000051382.4,138834928,3-138849749-A-C,rs7613579,-1,A,C,138849749,14821,138638320,139031536,211429
3,ENSG00000131370.11,15332586,3-15353512-T-C,rs7614350,-1,T,C,15353512,20926,15135978,15529194,217534
3,ENSG00000175166.11,184299241,3-184190973-C-T,rs7614381,1,C,T,184190973,108268,184102633,184495849,88340
3,ENSG00000144559.6,11846885,3-11819466-C-G,rs7615782,-1,C,G,11819466,27419,11650277,12043493,169189
3,ENSG00000144559.6,11846885,3-11819466-C-A,rs7615782,-1,C,A,11819466,27419,11650277,12043493,169189
3,ENSG00000144559.6,11846885,3-11819466-C-T,rs7615782,-1,C,T,11819466,27419,11650277,12043493,169189
3,ENSG00000138495.2,119677406,3-119699696-C-A,rs7617290,-1,C,A,119699696,22290,119480798,119874014,218898
3,ENSG00000138495.2,119677406,3-119699696-C-T,rs7617290,-1,C,T,119699696,22290,119480798,119874014,218898
3,ENSG00000041802.6,194672191,3-194685471-G-T,rs7619052,-1,G,T,194685471,13280,194475583,194868799,209888
3,ENSG00000041802.6,194672191,3-194685471-G-A,rs7619052,-1,G,A,194685471,13280,194475583,194868799,209888
3,ENSG00000041802.6,194672191,3-194685471-G-C,rs7619052,-1,G,C,194685471,13280,194475583,194868799,209888
3,ENSG00000134109.5,5187707,3-5291289-G-T,rs7621509,1,G,T,5291289,103582,4991099,5384315,300190
3,ENSG00000134109.5,5187707,3-5291289-G-C,rs7621509,1,G,C,5291289,103582,4991099,5384315,300190
3,ENSG00000008324.6,42590860,3-42541650-G-A,rs7622205,1,G,A,42541650,49210,42394252,42787468,147398
3,ENSG00000008324.6,42590860,3-42541650-G-C,rs7622205,1,G,C,42541650,49210,42394252,42787468,147398
3,ENSG00000154813.5,16264943,3-16155787-C-A,rs7624605,-1,C,A,16155787,109156,16068335,16461551,87452
3,ENSG00000154813.5,16264943,3-16155787-C-G,rs7624605,-1,C,G,16155787,109156,16068335,16461551,87452
3,ENSG00000091527.11,133573686,3-133478427-G-A,rs7625229,1,G,A,133478427,95259,133377078,133770294,101349
3,ENSG00000091527.11,133573686,3-133478427-G-C,rs7625229,1,G,C,133478427,95259,133377078,133770294,101349
3,ENSG00000152580.7,151461061,3-151499707-T-C,rs7629172,-1,T,C,151499707,38646,151264453,151657669,235254
3,ENSG00000144645.9,31981262,3-31973735-G-A,rs7631762,-1,G,A,31973735,7527,31784654,32177870,189081
3,ENSG00000163584.13,170870195,3-170808843-T-C,rs7632259,-1,T,C,170808843,61352,170673587,171066803,135256
3,ENSG00000163584.13,170870195,3-170808843-T-A,rs7632259,-1,T,A,170808843,61352,170673587,171066803,135256
3,ENSG00000163840.5,122564338,3-122577800-G-A,rs7632426,1,G,A,122577800,13462,122367730,122760946,210070
3,ENSG00000163684.6,58306245,3-58454509-T-C,rs7633553,1,T,C,58454509,148264,58109637,58502853,344872
3,ENSG00000163684.6,58306245,3-58454509-T-A,rs7633553,1,T,A,58454509,148264,58109637,58502853,344872
3,ENSG00000163684.6,58306245,3-58454509-T-G,rs7633553,1,T,G,58454509,148264,58109637,58502853,344872
3,ENSG00000168297.9,58332892,3-58454509-T-C,rs7633553,1,T,C,58454509,121617,58136284,58529500,318225
3,ENSG00000168297.9,58332892,3-58454509-T-A,rs7633553,1,T,A,58454509,121617,58136284,58529500,318225
3,ENSG00000168297.9,58332892,3-58454509-T-G,rs7633553,1,T,G,58454509,121617,58136284,58529500,318225
3,ENSG00000168811.2,159988835,3-160037000-G-A,rs7638274,1,G,A,160037000,48165,159792227,160185443,244773
3,ENSG00000168811.2,159988835,3-160037000-G-T,rs7638274,1,G,T,160037000,48165,159792227,160185443,244773
3,ENSG00000174013.7,196568660,3-196531081-T-C,rs7638562,1,T,C,196531081,37579,196372052,196765268,159029
3,ENSG00000175697.6,120285222,3-120149728-A-G,rs7641727,-1,A,G,120149728,135494,120088614,120481830,61114
3,ENSG00000047849.17,48016416,3-48058260-G-T,rs7642590,-1,G,T,48058260,41844,47819808,48213024,238452
3,ENSG00000047849.17,48016416,3-48058260-G-A,rs7642590,-1,G,A,48058260,41844,47819808,48213024,238452
3,ENSG00000047849.17,48016416,3-48058260-G-C,rs7642590,-1,G,C,48058260,41844,47819808,48213024,238452
3,ENSG00000138496.10,122564300,3-122491205-C-T,rs7644540,-1,C,T,122491205,73095,122367692,122760908,123513
3,ENSG00000163607.8,112990984,3-113035779-C-T,rs7650483,1,C,T,113035779,44795,112794376,113187592,241403
3,ENSG00000163607.8,112990984,3-113035779-C-A,rs7650483,1,C,A,113035779,44795,112794376,113187592,241403
3,ENSG00000168026.11,39107680,3-38969735-A-G,rs7651646,1,A,G,38969735,137945,38911072,39304288,58663
3,ENSG00000180611.6,192917856,3-192921839-G-A,rs769584,-1,G,A,192921839,3983,192721248,193114464,200591
3,ENSG00000180611.6,192917856,3-192921839-G-C,rs769584,-1,G,C,192921839,3983,192721248,193114464,200591
3,ENSG00000145191.6,184135358,3-184035176-A-C,rs77099580,1,A,C,184035176,100182,183938750,184331966,96426
3,ENSG00000114209.10,167734892,3-167627286-G-A,rs77319753,-1,G,A,167627286,107606,167538284,167931500,89002
3,ENSG00000114209.10,167734892,3-167627286-G-T,rs77319753,-1,G,T,167627286,107606,167538284,167931500,89002
3,ENSG00000114209.10,167734892,3-167627286-G-C,rs77319753,-1,G,C,167627286,107606,167538284,167931500,89002
3,ENSG00000113812.9,53882152,3-53907720-G-A,rs77606615,-1,G,A,53907720,25568,53685544,54078760,222176
3,ENSG00000113812.9,53882152,3-53907720-G-T,rs77606615,-1,G,T,53907720,25568,53685544,54078760,222176
3,ENSG00000114737.11,50611774,3-50660110-A-G,rs78104031,-1,A,G,50660110,48336,50415166,50808382,244944
3,ENSG00000114473.9,197959991,3-197851707-A-G,rs78110111,-1,A,G,197851707,108284,197763383,198156599,88324
3,ENSG00000114541.10,69386088,3-69473740-G-A,rs78202567,-1,G,A,69473740,87652,69189480,69582696,284260
3,ENSG00000114541.10,69386088,3-69473740-G-C,rs78202567,-1,G,C,69473740,87652,69189480,69582696,284260
3,ENSG00000144724.13,61561571,3-61582527-A-G,rs78288380,1,A,G,61582527,20956,61364963,61758179,217564
3,ENSG00000197938.4,98282505,3-98392143-G-C,rs79116017,1,G,C,98392143,109638,98085897,98479113,306246
3,ENSG00000170142.7,23805955,3-23822230-G-A,rs79170330,1,G,A,23822230,16275,23609347,24002563,212883
3,ENSG00000168314.12,39467680,3-39441662-G-A,rs80250798,1,G,A,39441662,26018,39271072,39664288,170590
3,ENSG00000178700.3,94062916,3-93957719-C-G,rs8178595,-1,C,G,93957719,105197,93866308,94259524,91411
3,ENSG00000178700.3,94062916,3-93957719-C-T,rs8178595,-1,C,T,93957719,105197,93866308,94259524,91411
3,ENSG00000178700.3,94062916,3-93957719-C-A,rs8178595,-1,C,A,93957719,105197,93866308,94259524,91411
3,ENSG00000093217.5,38346785,3-38364294-C-T,rs818838,1,C,T,38364294,17509,38150177,38543393,214117
3,ENSG00000093217.5,38346785,3-38364294-C-A,rs818838,1,C,A,38364294,17509,38150177,38543393,214117
3,ENSG00000176945.11,195720978,3-195756205-A-T,rs842223,1,A,T,195756205,35227,195524370,195917586,231835
3,ENSG00000176945.11,195720978,3-195756205-A-G,rs842223,1,A,G,195756205,35227,195524370,195917586,231835
3,ENSG00000145194.13,184276022,3-184228486-T-C,rs843350,1,T,C,184228486,47536,184079414,184472630,149072
3,ENSG00000161267.7,197555968,3-197550256-C-T,rs891668,-1,C,T,197550256,5712,197359360,197752576,190896
3,ENSG00000161267.7,197555968,3-197550256-C-G,rs891668,-1,C,G,197550256,5712,197359360,197752576,190896
3,ENSG00000206561.6,15521706,3-15568563-C-T,rs905650,-1,C,T,15568563,46857,15325098,15718314,243465
3,ENSG00000170819.4,133400056,3-133462302-T-A,rs9289447,1,T,A,133462302,62246,133203448,133596664,258854
3,ENSG00000114767.6,51941904,3-51941561-C-T,rs929533,-1,C,T,51941561,343,51745296,52138512,196265
3,ENSG00000114767.6,51941904,3-51941561-C-A,rs929533,-1,C,A,51941561,343,51745296,52138512,196265
3,ENSG00000114767.6,51941904,3-51941561-C-G,rs929533,-1,C,G,51941561,343,51745296,52138512,196265
3,ENSG00000172037.8,49133050,3-49176204-C-G,rs9586,-1,C,G,49176204,43154,48936442,49329658,239762
3,ENSG00000172037.8,49133050,3-49176204-C-T,rs9586,-1,C,T,49176204,43154,48936442,49329658,239762
3,ENSG00000144935.9,142724034,3-142818839-G-A,rs9683118,1,G,A,142818839,94805,142527426,142920642,291413
3,ENSG00000144566.5,19947097,3-19938523-T-A,rs9810613,1,T,A,19938523,8574,19750489,20143705,188034
3,ENSG00000144566.5,19947097,3-19938523-T-C,rs9810613,1,T,C,19938523,8574,19750489,20143705,188034
3,ENSG00000144566.5,19947097,3-19938523-T-G,rs9810613,1,T,G,19938523,8574,19750489,20143705,188034
3,ENSG00000214021.10,9810262,3-9785085-C-G,rs9813445,1,C,G,9785085,25177,9613654,10006870,171431
3,ENSG00000214021.10,9810262,3-9785085-C-T,rs9813445,1,C,T,9785085,25177,9613654,10006870,171431
3,ENSG00000183624.8,129278870,3-129346842-C-T,rs9816963,1,C,T,129346842,67972,129082262,129475478,264580
3,ENSG00000155903.6,141487027,3-141487958-C-T,rs9819371,1,C,T,141487958,931,141290419,141683635,197539
3,ENSG00000188001.5,189171971,3-189319559-C-T,rs9820955,1,C,T,189319559,147588,188975363,189368579,344196
3,ENSG00000075420.8,172039578,3-172146805-G-A,rs9821928,1,G,A,172146805,107227,171842970,172236186,303835
3,ENSG00000075420.8,172039578,3-172146805-G-C,rs9821928,1,G,C,172146805,107227,171842970,172236186,303835
3,ENSG00000075420.8,172039578,3-172146805-G-T,rs9821928,1,G,T,172146805,107227,171842970,172236186,303835
3,ENSG00000169255.9,161105349,3-161101672-A-C,rs9826857,-1,A,C,161101672,3677,160908741,161301957,192931
3,ENSG00000198919.7,108589722,3-108492348-C-T,rs9827747,1,C,T,108492348,97374,108393114,108786330,99234
3,ENSG00000070087.9,149970895,3-150059882-A-G,rs9837142,-1,A,G,150059882,88987,149774287,150167503,285595
3,ENSG00000070087.9,149970895,3-150059882-A-T,rs9837142,-1,A,T,150059882,88987,149774287,150167503,285595
3,ENSG00000163788.9,43286540,3-43434843-T-C,rs9844641,1,T,C,43434843,148303,43089932,43483148,344911
3,ENSG00000163788.9,43286540,3-43434843-T-G,rs9844641,1,T,G,43434843,148303,43089932,43483148,344911
3,ENSG00000131378.8,16513699,3-16375235-G-A,rs9851148,-1,G,A,16375235,138464,16317091,16710307,58144
3,ENSG00000206560.6,15797979,3-15926143-G-A,rs9852108,-1,G,A,15926143,128164,15601371,15994587,324772
3,ENSG00000206560.6,15797979,3-15926143-G-C,rs9852108,-1,G,C,15926143,128164,15601371,15994587,324772
3,ENSG00000114450.5,179451470,3-179278838-G-A,rs9856476,-1,G,A,179278838,172632,179254862,179648078,23976
3,ENSG00000070476.10,126475891,3-126413437-T-G,rs9864203,-1,T,G,126413437,62454,126279283,126672499,134154
3,ENSG00000070476.10,126475891,3-126413437-T-A,rs9864203,-1,T,A,126413437,62454,126279283,126672499,134154
3,ENSG00000070476.10,126475891,3-126413437-T-C,rs9864203,-1,T,C,126413437,62454,126279283,126672499,134154
3,ENSG00000113811.6,53891859,3-53907137-G-A,rs9864389,-1,G,A,53907137,15278,53695251,54088467,211886
3,ENSG00000129810.10,20186206,3-20250151-T-C,rs9866621,-1,T,C,20250151,63945,19989598,20382814,260553
3,ENSG00000129810.10,20186206,3-20250151-T-G,rs9866621,-1,T,G,20250151,63945,19989598,20382814,260553
3,ENSG00000129810.10,20186206,3-20250151-T-A,rs9866621,-1,T,A,20250151,63945,19989598,20382814,260553
3,ENSG00000177494.5,111595346,3-111619322-G-C,rs9868266,-1,G,C,111619322,23976,111398738,111791954,220584
3,ENSG00000177494.5,111595346,3-111619322-G-T,rs9868266,-1,G,T,111619322,23976,111398738,111791954,220584
3,ENSG00000178732.4,194399266,3-194345057-A-T,rs9868662,-1,A,T,194345057,54209,194202658,194595874,142399
3,ENSG00000178732.4,194399266,3-194345057-A-G,rs9868662,-1,A,G,194345057,54209,194202658,194595874,142399
3,ENSG00000131379.5,14675141,3-14715223-A-C,rs9869372,1,A,C,14715223,40082,14478533,14871749,236690
3,ENSG00000131379.5,14675141,3-14715223-A-T,rs9869372,1,A,T,14715223,40082,14478533,14871749,236690
3,ENSG00000131379.5,14675141,3-14715223-A-G,rs9869372,1,A,G,14715223,40082,14478533,14871749,236690
3,ENSG00000136059.9,37990786,3-38086034-G-A,rs9875897,1,G,A,38086034,95248,37794178,38187394,291856
3,ENSG00000144820.3,100609601,3-100778254-C-T,rs9877951,1,C,T,100778254,168653,100412993,100806209,365261
3,ENSG00000144820.3,100609601,3-100778254-C-A,rs9877951,1,C,A,100778254,168653,100412993,100806209,365261
3,ENSG00000206527.5,123585053,3-123528607-T-A,rs1006669,-1,T,A,123528607,56446,123388445,123781661,140162
3,ENSG00000206527.5,123585053,3-123528607-T-C,rs1006669,-1,T,C,123528607,56446,123388445,123781661,140162
3,ENSG00000173200.7,122577650,3-122574362-C-T,rs1045089,1,C,T,122574362,3288,122381042,122774258,193320
3,ENSG00000157014.5,10248459,3-10293461-T-A,rs10490815,1,T,A,10293461,45002,10051851,10445067,241610
3,ENSG00000157014.5,10248459,3-10293461-T-G,rs10490815,1,T,G,10293461,45002,10051851,10445067,241610
3,ENSG00000157014.5,10248459,3-10293461-T-C,rs10490815,1,T,C,10293461,45002,10051851,10445067,241610
3,ENSG00000114455.9,108296490,3-108395725-C-T,rs10511271,1,C,T,108395725,99235,108099882,108493098,295843
3,ENSG00000114455.9,108296490,3-108395725-C-A,rs10511271,1,C,A,108395725,99235,108099882,108493098,295843
3,ENSG00000114455.9,108296490,3-108395725-C-G,rs10511271,1,C,G,108395725,99235,108099882,108493098,295843
3,ENSG00000196981.2,122416062,3-122408942-C-T,rs10511409,-1,C,T,122408942,7120,122219454,122612670,189488
3,ENSG00000174564.8,136957983,3-136955626-A-G,rs10513018,1,A,G,136955626,2357,136761375,137154591,194251
3,ENSG00000144827.4,111979026,3-112052101-G-A,rs10934131,1,G,A,112052101,73075,111782418,112175634,269683
3,ENSG00000129810.10,20186206,3-20117707-G-A,rs11128940,-1,G,A,20117707,68499,19989598,20382814,128109
3,ENSG00000072756.12,3126940,3-3245738-T-C,rs11129510,1,T,C,3245738,118798,2930332,3323548,315406
3,ENSG00000016864.11,52705791,3-52862839-C-A,rs11130329,-1,C,A,52862839,157048,52509183,52902399,353656
3,ENSG00000016864.11,52705791,3-52862839-C-G,rs11130329,-1,C,G,52862839,157048,52509183,52902399,353656
3,ENSG00000163807.4,44761619,3-44579363-C-T,rs111593586,-1,C,T,44579363,182256,44565011,44958227,14352
3,ENSG00000176597.7,183253253,3-183214010-G-A,rs111955606,1,G,A,183214010,39243,183056645,183449861,157365
3,ENSG00000173175.10,123449090,3-123320961-G-A,rs112520557,-1,G,A,123320961,128129,123252482,123645698,68479
3,ENSG00000181744.4,143971823,3-144134680-A-C,rs114750214,1,A,C,144134680,162857,143775215,144168431,359465
3,ENSG00000056736.5,53846568,3-54000656-C-A,rs115203281,1,C,A,54000656,154088,53649960,54043176,350696
3,ENSG00000056736.5,53846568,3-54000656-C-T,rs115203281,1,C,T,54000656,154088,53649960,54043176,350696
3,ENSG00000056736.5,53846568,3-54000656-C-G,rs115203281,1,C,G,54000656,154088,53649960,54043176,350696
3,ENSG00000163705.8,10108255,3-9928437-C-T,rs115419420,-1,C,T,9928437,179818,9911647,10304863,16790
3,ENSG00000239388.3,57292685,3-57269656-A-G,rs11544593,-1,A,G,57269656,23029,57096077,57489293,173579
3,ENSG00000206531.6,112846864,3-112970386-T-C,rs1156147,-1,T,C,112970386,123522,112650256,113043472,320130
3,ENSG00000188306.6,169812870,3-169944087-G-A,rs116409830,1,G,A,169944087,131217,169616262,170009478,327825
3,ENSG00000181847.7,114294028,3-114374042-G-A,rs116424487,1,G,A,114374042,80014,114097420,114490636,276622
3,ENSG00000114744.4,149752489,3-149602538-G-A,rs116470871,-1,G,A,149602538,149951,149555881,149949097,46657
3,ENSG00000114395.6,50350862,3-50302191-C-T,rs116482870,1,C,T,50302191,48671,50154254,50547470,147937
3,ENSG00000010256.6,48609646,3-48692770-C-T,rs116781404,-1,C,T,48692770,83124,48413038,48806254,279732
3,ENSG00000132155.7,12664117,3-12545634-A-G,rs11706408,-1,A,G,12545634,118483,12467509,12860725,78125
3,ENSG00000132155.7,12664117,3-12545634-A-T,rs11706408,-1,A,T,12545634,118483,12467509,12860725,78125
3,ENSG00000091317.7,32502852,3-32668215-C-T,rs11707195,-1,C,T,32668215,165363,32306244,32699460,361971
3,ENSG00000144677.10,37861880,3-38006189-G-A,rs11707277,1,G,A,38006189,144309,37665272,38058488,340917
3,ENSG00000144677.10,37861880,3-38006189-G-C,rs11707277,1,G,C,38006189,144309,37665272,38058488,340917
3,ENSG00000221955.6,125212748,3-125342046-G-A,rs11708180,-1,G,A,125342046,129298,125016140,125409356,325906
3,ENSG00000174748.12,23917132,3-24040281-G-T,rs11709614,1,G,T,24040281,123149,23720524,24113740,319757
3,ENSG00000174748.12,23917132,3-24040281-G-A,rs11709614,1,G,A,24040281,123149,23720524,24113740,319757
3,ENSG00000171109.13,179347709,3-179464684-G-A,rs11711055,1,G,A,179464684,116975,179151101,179544317,313583
3,ENSG00000168334.8,39192595,3-39186552-T-G,rs11711871,-1,T,G,39186552,6043,38995987,39389203,190565
3,ENSG00000145103.7,122022247,3-122087978-T-A,rs11717893,-1,T,A,122087978,65731,121825639,122218855,262339
3,ENSG00000145103.7,122022247,3-122087978-T-C,rs11717893,-1,T,C,122087978,65731,121825639,122218855,262339
3,ENSG00000144857.10,113211557,3-113188123-A-G,rs11718413,1,A,G,113188123,23434,113014949,113408165,173174
3,ENSG00000144857.10,113211557,3-113188123-A-C,rs11718413,1,A,C,113188123,23434,113014949,113408165,173174
3,ENSG00000047457.9,149221829,3-149133446-G-A,rs11719396,-1,G,A,149133446,88383,149025221,149418437,108225
3,ENSG00000163755.4,149129638,3-149133446-G-A,rs11719396,1,G,A,149133446,3808,148933030,149326246,200416
3,ENSG00000163608.9,113019671,3-113071018-G-T,rs11918021,-1,G,T,113071018,51347,112823063,113216279,247955
3,ENSG00000161203.8,184174855,3-184006670-G-C,rs11926347,1,G,C,184006670,168185,183978247,184371463,28423
3,ENSG00000161203.8,184174855,3-184006670-G-T,rs11926347,1,G,T,184006670,168185,183978247,184371463,28423
3,ENSG00000161203.8,184174855,3-184006670-G-A,rs11926347,1,G,A,184006670,168185,183978247,184371463,28423
3,ENSG00000114805.12,155745071,3-155683902-G-A,rs11928132,-1,G,A,155683902,61169,155548463,155941679,135439
3,ENSG00000114805.12,155745071,3-155683902-G-T,rs11928132,-1,G,T,155683902,61169,155548463,155941679,135439
3,ENSG00000181458.6,100492619,3-100346788-G-T,rs1214375,1,G,T,100346788,145831,100296011,100689227,50777
3,ENSG00000181458.6,100492619,3-100346788-G-A,rs1214375,1,G,A,100346788,145831,100296011,100689227,50777
3,ENSG00000072858.6,113532555,3-113596175-G-A,rs12490723,1,G,A,113596175,63620,113335947,113729163,260228
3,ENSG00000072858.6,113532555,3-113596175-G-C,rs12490723,1,G,C,113596175,63620,113335947,113729163,260228
3,ENSG00000114026.15,9749952,3-9748794-G-A,rs125701,1,G,A,9748794,1158,9553344,9946560,195450
3,ENSG00000163428.3,120349354,3-120396439-T-A,rs1259328,-1,T,A,120396439,47085,120152746,120545962,243693
3,ENSG00000163428.3,120349354,3-120396439-T-C,rs1259328,-1,T,C,120396439,47085,120152746,120545962,243693
3,ENSG00000163428.3,120349354,3-120396439-T-G,rs1259328,-1,T,G,120396439,47085,120152746,120545962,243693
3,ENSG00000179021.4,88149959,3-88122078-A-C,rs12629581,1,A,C,88122078,27881,87953351,88346567,168727
3,ENSG00000157152.11,12004388,3-11875765-C-A,rs12631353,1,C,A,11875765,128623,11807780,12200996,67985
3,ENSG00000157152.11,12004388,3-11875765-C-T,rs12631353,1,C,T,11875765,128623,11807780,12200996,67985
3,ENSG00000180914.6,8769613,3-8861497-G-A,rs12632905,-1,G,A,8861497,91884,8573005,8966221,288492
3,ENSG00000144908.9,126180586,3-126317109-C-T,rs12633128,-1,C,T,126317109,136523,125983978,126377194,333131
3,ENSG00000163975.7,197029817,3-196948008-A-G,rs12636891,-1,A,G,196948008,81809,196833209,197226425,114799
3,ENSG00000163975.7,197029817,3-196948008-A-C,rs12636891,-1,A,C,196948008,81809,196833209,197226425,114799
3,ENSG00000121864.5,179323031,3-179347428-C-T,rs13061218,1,C,T,179347428,24397,179126423,179519639,221005
3,ENSG00000179934.5,39329709,3-39276422-T-G,rs13062158,1,T,G,39276422,53287,39133101,39526317,143321
3,ENSG00000179934.5,39329709,3-39276422-T-A,rs13062158,1,T,A,39276422,53287,39133101,39526317,143321
3,ENSG00000179934.5,39329709,3-39276422-T-C,rs13062158,1,T,C,39276422,53287,39133101,39526317,143321
3,ENSG00000163584.13,170870195,3-170824941-A-G,rs13073591,-1,A,G,170824941,45254,170673587,171066803,151354
3,ENSG00000163584.13,170870195,3-170824941-A-C,rs13073591,-1,A,C,170824941,45254,170673587,171066803,151354
3,ENSG00000163584.13,170870195,3-170824941-A-T,rs13073591,-1,A,T,170824941,45254,170673587,171066803,151354
3,ENSG00000168291.8,58433832,3-58602292-C-T,rs13076420,-1,C,T,58602292,168460,58237224,58630440,365068
3,ENSG00000182580.2,184561785,3-184620030-A-G,rs13085530,1,A,G,184620030,58245,184365177,184758393,254853
3,ENSG00000163823.3,46208313,3-46142068-T-A,rs13089543,-1,T,A,46142068,66245,46011705,46404921,130363
3,ENSG00000163823.3,46208313,3-46142068-T-G,rs13089543,-1,T,G,46142068,66245,46011705,46404921,130363
3,ENSG00000255423.1,73061659,3-72952449-G-A,rs13091067,1,G,A,72952449,109210,72865051,73258267,87398
3,ENSG00000163961.4,196503768,3-196464022-T-A,rs13094241,-1,T,A,196464022,39746,196307160,196700376,156862
3,ENSG00000163961.4,196503768,3-196464022-T-G,rs13094241,-1,T,G,196464022,39746,196307160,196700376,156862
3,ENSG00000196428.6,150408298,3-150361882-A-G,rs13097358,1,A,G,150361882,46416,150211690,150604906,150192
3,ENSG00000175697.6,120285222,3-120412915-G-T,rs13097755,-1,G,T,120412915,127693,120088614,120481830,324301
3,ENSG00000175697.6,120285222,3-120412915-G-A,rs13097755,-1,G,A,120412915,127693,120088614,120481830,324301
3,ENSG00000144455.8,4467269,3-4304082-C-T,rs13099918,-1,C,T,4304082,163187,4270661,4663877,33421
3,ENSG00000041802.6,194672191,3-194682542-A-G,rs13318131,-1,A,G,194682542,10351,194475583,194868799,206959
3,ENSG00000152492.9,191329394,3-191334194-A-T,rs1347400,1,A,T,191334194,4800,191132786,191526002,201408
3,ENSG00000152492.9,191329394,3-191334194-A-C,rs1347400,1,A,C,191334194,4800,191132786,191526002,201408
3,ENSG00000152492.9,191329394,3-191334194-A-G,rs1347400,1,A,G,191334194,4800,191132786,191526002,201408
3,ENSG00000163412.7,71725402,3-71727896-T-A,rs1349028,-1,T,A,71727896,2494,71528794,71922010,199102
3,ENSG00000169087.6,122793831,3-122678217-G-T,rs1355562,-1,G,T,122678217,115614,122597223,122990439,80994
3,ENSG00000121577.9,119660589,3-119500732-T-C,rs149492706,-1,T,C,119500732,159857,119463981,119857197,36751
3,ENSG00000196542.4,161371517,3-161558788-C-A,rs1506469,-1,C,A,161558788,187271,161174909,161568125,383879
3,ENSG00000114850.2,156555117,3-156582935-C-T,rs1510272,-1,C,T,156582935,27818,156358509,156751725,224426
3,ENSG00000114850.2,156555117,3-156582935-C-G,rs1510272,-1,C,G,156582935,27818,156358509,156751725,224426
3,ENSG00000114790.8,154121390,3-153952749-A-G,rs1521302,1,A,G,153952749,168641,153924782,154317998,27967
3,ENSG00000091513.10,133746393,3-133858425-A-G,rs1534167,1,A,G,133858425,112032,133549785,133943001,308640
3,ENSG00000213186.3,160449786,3-160605934-G-A,rs16831286,-1,G,A,160605934,156148,160253178,160646394,352756
3,ENSG00000114520.6,125520202,3-125567371-C-G,rs16836866,-1,C,G,125567371,47169,125323594,125716810,243777
3,ENSG00000114520.6,125520202,3-125567371-C-T,rs16836866,-1,C,T,125567371,47169,125323594,125716810,243777
3,ENSG00000081307.8,132660329,3-132785115-C-G,rs16839604,1,C,G,132785115,124786,132463721,132856937,321394
3,ENSG00000081307.8,132660329,3-132785115-C-A,rs16839604,1,C,A,132785115,124786,132463721,132856937,321394
3,ENSG00000081307.8,132660329,3-132785115-C-T,rs16839604,1,C,T,132785115,124786,132463721,132856937,321394
3,ENSG00000154165.3,98531978,3-98558853-T-A,rs16839940,1,T,A,98558853,26875,98335370,98728586,223483
3,ENSG00000154165.3,98531978,3-98558853-T-C,rs16839940,1,T,C,98558853,26875,98335370,98728586,223483
3,ENSG00000114125.9,141738298,3-141796708-T-C,rs16851809,1,T,C,141796708,58410,141541690,141934906,255018
3,ENSG00000114529.8,112086389,3-112232856-T-G,rs16859355,1,T,G,112232856,146467,111889781,112282997,343075
3,ENSG00000113812.9,53882152,3-53734178-T-C,rs17030975,-1,T,C,53734178,147974,53685544,54078760,48634
3,ENSG00000144597.9,15427598,3-15294706-C-T,rs17040969,1,C,T,15294706,132892,15230990,15624206,63716
3,ENSG00000144597.9,15427598,3-15294706-C-G,rs17040969,1,C,G,15294706,132892,15230990,15624206,63716
3,ENSG00000164091.7,52278649,3-52318848-C-T,rs17052068,-1,C,T,52318848,40199,52082041,52475257,236807
3,ENSG00000114812.8,42502643,3-42391813-T-C,rs17074351,1,T,C,42391813,110830,42306035,42699251,85778
3,ENSG00000011198.3,43690938,3-43769468-C-T,rs17076015,1,C,T,43769468,78530,43494330,43887546,275138
3,ENSG00000169981.6,44648732,3-44667517-T-C,rs17076906,1,T,C,44667517,18785,44452124,44845340,215393
3,ENSG00000163810.7,44874608,3-44720237-A-C,rs17076938,1,A,C,44720237,154371,44678000,45071216,42237
3,ENSG00000163810.7,44874608,3-44720237-A-G,rs17076938,1,A,G,44720237,154371,44678000,45071216,42237
3,ENSG00000164045.7,48188417,3-48156821-T-C,rs17079998,-1,T,C,48156821,31596,47991809,48385025,165012
3,ENSG00000175792.6,128123812,3-127965905-C-A,rs17203687,-1,C,A,127965905,157907,127927204,128320420,38701
3,ENSG00000175792.6,128123812,3-127965905-C-T,rs17203687,-1,C,T,127965905,157907,127927204,128320420,38701
3,ENSG00000175792.6,128123812,3-127965905-C-G,rs17203687,-1,C,G,127965905,157907,127927204,128320420,38701
3,ENSG00000144674.12,37243271,3-37437066-T-A,rs17207235,1,T,A,37437066,193795,37046663,37439879,390403
3,ENSG00000144674.12,37243271,3-37437066-T-G,rs17207235,1,T,G,37437066,193795,37046663,37439879,390403
3,ENSG00000187672.8,56468467,3-56548523-G-T,rs17216671,-1,G,T,56548523,80056,56271859,56665075,276664
3,ENSG00000187672.8,56468467,3-56548523-G-C,rs17216671,-1,G,C,56548523,80056,56271859,56665075,276664
3,ENSG00000197980.6,156826353,3-156775056-C-T,rs17380639,1,C,T,156775056,51297,156629745,157022961,145311
3,ENSG00000068028.13,50340836,3-50403121-C-A,rs17606778,-1,C,A,50403121,62285,50144228,50537444,258893
3,ENSG00000164048.8,48241104,3-48138448-G-A,rs17647531,1,G,A,48138448,102656,48044496,48437712,93952
3,ENSG00000163840.5,122564338,3-122678360-T-G,rs1818438,1,T,G,122678360,114022,122367730,122760946,310630
3,ENSG00000163840.5,122564338,3-122678360-T-C,rs1818438,1,T,C,122678360,114022,122367730,122760946,310630
3,ENSG00000153283.7,111542197,3-111620660-G-T,rs183503496,1,G,T,111620660,78463,111345589,111738805,275071
3,ENSG00000153283.7,111542197,3-111620660-G-A,rs183503496,1,G,A,111620660,78463,111345589,111738805,275071
3,ENSG00000132170.15,12289070,3-12146743-T-C,rs1867012,1,T,C,12146743,142327,12092462,12485678,54281
3,ENSG00000132170.15,12289070,3-12146743-T-A,rs1867012,1,T,A,12146743,142327,12092462,12485678,54281
3,ENSG00000241553.5,9793082,3-9712650-C-T,rs187310,1,C,T,9712650,80432,9596474,9989690,116176
3,ENSG00000145088.4,121835209,3-121728053-G-A,rs1919555,1,G,A,121728053,107156,121638601,122031817,89452
3,ENSG00000071282.7,8501823,3-8454130-T-C,rs2029121,1,T,C,8454130,47693,8305215,8698431,148915
3,ENSG00000071282.7,8501823,3-8454130-T-A,rs2029121,1,T,A,8454130,47693,8305215,8698431,148915
3,ENSG00000163666.4,57199978,3-57068487-T-G,rs2171504,-1,T,G,57068487,131491,57003370,57396586,65117
3,ENSG00000058866.9,186362234,3-186230539-C-T,rs2268839,-1,C,T,186230539,131695,186165626,186558842,64913
3,ENSG00000058866.9,186362234,3-186230539-C-A,rs2268839,-1,C,A,186230539,131695,186165626,186558842,64913
3,ENSG00000088538.10,50674927,3-50560517-G-A,rs2269505,1,G,A,50560517,114410,50478319,50871535,82198
3,ENSG00000088538.10,50674927,3-50560517-G-C,rs2269505,1,G,C,50560517,114410,50478319,50871535,82198
3,ENSG00000088538.10,50674927,3-50560517-G-T,rs2269505,1,G,T,50560517,114410,50478319,50871535,82198
3,ENSG00000144741.12,66221001,3-66380387-T-G,rs2279290,1,T,G,66380387,159386,66024393,66417609,355994
3,ENSG00000144741.12,66221001,3-66380387-T-C,rs2279290,1,T,C,66380387,159386,66024393,66417609,355994
3,ENSG00000144741.12,66221001,3-66380387-T-A,rs2279290,1,T,A,66380387,159386,66024393,66417609,355994
3,ENSG00000080200.5,97822011,3-97793576-C-T,rs2279896,1,C,T,97793576,28435,97625403,98018619,168173
3,ENSG00000080200.5,97822011,3-97793576-C-G,rs2279896,1,C,G,97793576,28435,97625403,98018619,168173
3,ENSG00000114650.13,47475941,3-47417260-C-T,rs2306628,-1,C,T,47417260,58681,47279333,47672549,137927
3,ENSG00000114650.13,47475941,3-47417260-C-G,rs2306628,-1,C,G,47417260,58681,47279333,47672549,137927
3,ENSG00000160801.9,46877721,3-46961441-G-C,rs2385868,1,G,C,46961441,83720,46681113,47074329,280328
3,ENSG00000160801.9,46877721,3-46961441-G-T,rs2385868,1,G,T,46961441,83720,46681113,47074329,280328
3,ENSG00000160801.9,46877721,3-46961441-G-A,rs2385868,1,G,A,46961441,83720,46681113,47074329,280328
3,ENSG00000144815.9,101779211,3-101726274-A-C,rs2554962,1,A,C,101726274,52937,101582603,101975819,143671
3,ENSG00000144815.9,101779211,3-101726274-A-G,rs2554962,1,A,G,101726274,52937,101582603,101975819,143671
3,ENSG00000144815.9,101779211,3-101726274-A-T,rs2554962,1,A,T,101726274,52937,101582603,101975819,143671
3,ENSG00000254999.2,10115675,3-10148977-A-C,rs2600005,1,A,C,10148977,33302,9919067,10312283,229910
3,ENSG00000254999.2,10115675,3-10148977-A-T,rs2600005,1,A,T,10148977,33302,9919067,10312283,229910
3,ENSG00000254999.2,10115675,3-10148977-A-G,rs2600005,1,A,G,10148977,33302,9919067,10312283,229910
3,ENSG00000163528.8,14124870,3-14193785-C-G,rs2607744,-1,C,G,14193785,68915,13928262,14321478,265523
3,ENSG00000163528.8,14124870,3-14193785-C-T,rs2607744,-1,C,T,14193785,68915,13928262,14321478,265523
3,ENSG00000175193.8,183884880,3-183829177-C-T,rs263003,-1,C,T,183829177,55703,183688272,184081488,140905
3,ENSG00000175193.8,183884880,3-183829177-C-G,rs263003,-1,C,G,183829177,55703,183688272,184081488,140905
3,ENSG00000156976.10,186783577,3-186708097-A-G,rs266721,1,A,G,186708097,75480,186586969,186980185,121128
3,ENSG00000156976.10,186783577,3-186708097-A-C,rs266721,1,A,C,186708097,75480,186586969,186980185,121128
3,ENSG00000157017.11,10292947,3-10373630-G-A,rs26796,-1,G,A,10373630,80683,10096339,10489555,277291
3,ENSG00000144837.4,119597885,3-119600675-G-A,rs2688637,1,G,A,119600675,2790,119401277,119794493,199398
3,ENSG00000144837.4,119597885,3-119600675-G-C,rs2688637,1,G,C,119600675,2790,119401277,119794493,199398
3,ENSG00000163702.14,9917098,3-9928758-C-T,rs279547,1,C,T,9928758,11660,9720490,10113706,208268
3,ENSG00000156990.10,9844016,3-9862222-G-T,rs279593,-1,G,T,9862222,18206,9647408,10040624,214814
3,ENSG00000156990.10,9844016,3-9862222-G-A,rs279593,-1,G,A,9862222,18206,9647408,10040624,214814
3,ENSG00000168026.11,39107680,3-39108083-C-T,rs28362641,1,C,T,39108083,403,38911072,39304288,197011
3,ENSG00000168026.11,39107680,3-39108083-C-G,rs28362641,1,C,G,39108083,403,38911072,39304288,197011
3,ENSG00000114279.7,192727541,3-192898911-T-A,rs2886870,-1,T,A,192898911,171370,192530933,192924149,367978
3,ENSG00000114279.7,192727541,3-192898911-T-G,rs2886870,-1,T,G,192898911,171370,192530933,192924149,367978
3,ENSG00000172020.8,115623510,3-115777995-G-A,rs2918227,1,G,A,115777995,154485,115426902,115820118,351093
3,ENSG00000154743.12,12484480,3-12526926-T-G,rs299630,1,T,G,12526926,42446,12287872,12681088,239054
3,ENSG00000186265.5,112499472,3-112461779-T-A,rs3112269,-1,T,A,112461779,37693,112302864,112696080,158915
3,ENSG00000186265.5,112499472,3-112461779-T-G,rs3112269,-1,T,G,112461779,37693,112302864,112696080,158915
3,ENSG00000186265.5,112499472,3-112461779-T-C,rs3112269,-1,T,C,112461779,37693,112302864,112696080,158915
3,ENSG00000232112.3,48440257,3-48466268-T-C,rs3135941,1,T,C,48466268,26011,48243649,48636865,222619
3,ENSG00000232112.3,48440257,3-48466268-T-G,rs3135941,1,T,G,48466268,26011,48243649,48636865,222619
3,ENSG00000232112.3,48440257,3-48466268-T-A,rs3135941,1,T,A,48466268,26011,48243649,48636865,222619
3,ENSG00000213689.5,48466230,3-48466268-T-C,rs3135941,1,T,C,48466268,38,48269622,48662838,196646
3,ENSG00000213689.5,48466230,3-48466268-T-G,rs3135941,1,T,G,48466268,38,48269622,48662838,196646
3,ENSG00000213689.5,48466230,3-48466268-T-A,rs3135941,1,T,A,48466268,38,48269622,48662838,196646
3,ENSG00000168268.6,52533857,3-52547419-T-C,rs3199918,-1,T,C,52547419,13562,52337249,52730465,210170
3,ENSG00000114115.5,139539742,3-139671234-C-T,rs34321703,-1,C,T,139671234,131492,139343134,139736350,328100
3,ENSG00000255154.2,58306520,3-58176219-A-G,rs34327759,1,A,G,58176219,130301,58109912,58503128,66307
3,ENSG00000255154.2,58306520,3-58176219-A-C,rs34327759,1,A,C,58176219,130301,58109912,58503128,66307
3,ENSG00000129055.8,134485985,3-134484758-T-G,rs35782477,-1,T,G,134484758,1227,134289377,134682593,195381
3,ENSG00000172113.4,48301367,3-48184019-T-C,rs3731503,-1,T,C,48184019,117348,48104759,48497975,79260
3,ENSG00000163833.6,121593379,3-121696873-T-G,rs3732410,1,T,G,121696873,103494,121396771,121789987,300102
3,ENSG00000163833.6,121593379,3-121696873-T-C,rs3732410,1,T,C,121696873,103494,121396771,121789987,300102
3,ENSG00000163960.7,196432427,3-196472333-G-C,rs3796129,-1,G,C,196472333,39906,196235819,196629035,236514
3,ENSG00000163960.7,196432427,3-196472333-G-T,rs3796129,-1,G,T,196472333,39906,196235819,196629035,236514
3,ENSG00000113924.7,120682239,3-120864786-C-T,rs390950,-1,C,T,120864786,182547,120485631,120878847,379155
3,ENSG00000163687.8,58210972,3-58184167-C-G,rs3935428,-1,C,G,58184167,26805,58014364,58407580,169803
3,ENSG00000163687.8,58210972,3-58184167-C-A,rs3935428,-1,C,A,58184167,26805,58014364,58407580,169803
3,ENSG00000163687.8,58210972,3-58184167-C-T,rs3935428,-1,C,T,58184167,26805,58014364,58407580,169803
3,ENSG00000164049.9,48372219,3-48270912-T-C,rs3937,1,T,C,48270912,101307,48175611,48568827,95301
3,ENSG00000164049.9,48372219,3-48270912-T-A,rs3937,1,T,A,48270912,101307,48175611,48568827,95301
3,ENSG00000151576.6,114056737,3-114056663-T-G,rs41271379,1,T,G,114056663,74,113860129,114253345,196534
3,ENSG00000151093.3,25790090,3-25790103-A-C,rs41285081,1,A,C,25790103,13,25593482,25986698,196621
3,ENSG00000151093.3,25790090,3-25790103-A-G,rs41285081,1,A,G,25790103,13,25593482,25986698,196621
3,ENSG00000151093.3,25790090,3-25790103-A-T,rs41285081,1,A,T,25790103,13,25593482,25986698,196621
3,ENSG00000065485.13,123067025,3-122875255-A-G,rs41372252,1,A,G,122875255,191770,122870417,123263633,4838
3,ENSG00000144711.8,13073429,3-13069036-A-C,rs417123,-1,A,C,13069036,4393,12876821,13270037,192215
3,ENSG00000186446.6,44729635,3-44725387-G-A,rs4234448,1,G,A,44725387,4248,44533027,44926243,192360
3,ENSG00000186446.6,44729635,3-44725387-G-C,rs4234448,1,G,C,44725387,4248,44533027,44926243,192360
3,ENSG00000186446.6,44729635,3-44725387-G-T,rs4234448,1,G,T,44725387,4248,44533027,44926243,192360
3,ENSG00000114446.4,108222424,3-108400224-T-C,rs4273371,-1,T,C,108400224,177800,108025816,108419032,374408
3,ENSG00000114446.4,108222424,3-108400224-T-A,rs4273371,-1,T,A,108400224,177800,108025816,108419032,374408
3,ENSG00000080822.11,98522902,3-98414635-T-G,rs4298080,-1,T,G,98414635,108267,98326294,98719510,88341
3,ENSG00000080822.11,98522902,3-98414635-T-C,rs4298080,-1,T,C,98414635,108267,98326294,98719510,88341
3,ENSG00000080822.11,98522902,3-98414635-T-A,rs4298080,-1,T,A,98414635,108267,98326294,98719510,88341
3,ENSG00000184220.6,99817862,3-99968429-G-T,rs4361315,1,G,T,99968429,150567,99621254,100014470,347175
3,ENSG00000184220.6,99817862,3-99968429-G-C,rs4361315,1,G,C,99968429,150567,99621254,100014470,347175
3,ENSG00000184220.6,99817862,3-99968429-G-A,rs4361315,1,G,A,99968429,150567,99621254,100014470,347175
3,ENSG00000172667.6,179071809,3-179067001-A-G,rs4416420,-1,A,G,179067001,4808,178875201,179268417,191800
3,ENSG00000075975.11,12557087,3-12699720-T-A,rs4444694,1,T,A,12699720,142633,12360479,12753695,339241
3,ENSG00000075975.11,12557087,3-12699720-T-C,rs4444694,1,T,C,12699720,142633,12360479,12753695,339241
3,ENSG00000075975.11,12557087,3-12699720-T-G,rs4444694,1,T,G,12699720,142633,12360479,12753695,339241
3,ENSG00000172340.9,67654612,3-67461527-A-G,rs4479607,-1,A,G,67461527,193085,67458004,67851220,3523
3,ENSG00000172340.9,67654612,3-67461527-A-T,rs4479607,-1,A,T,67461527,193085,67458004,67851220,3523
3,ENSG00000134108.7,5122292,3-5125933-G-C,rs4499578,1,G,C,5125933,3641,4925684,5318900,200249
3,ENSG00000134108.7,5122292,3-5125933-G-A,rs4499578,1,G,A,5125933,3641,4925684,5318900,200249
3,ENSG00000163864.10,139677972,3-139685327-T-G,rs4518082,-1,T,G,139685327,7355,139481364,139874580,203963
3,ENSG00000187091.9,38029642,3-38100028-A-G,rs4552305,-1,A,G,38100028,70386,37833034,38226250,266994
3,ENSG00000187091.9,38029642,3-38100028-A-C,rs4552305,-1,A,C,38100028,70386,37833034,38226250,266994
3,ENSG00000134070.4,10164919,3-10209512-A-G,rs459864,1,A,G,10209512,44593,9968311,10361527,241201
3,ENSG00000163882.5,184361710,3-184419441-G-A,rs4640598,1,G,A,184419441,57731,184165102,184558318,254339
3,ENSG00000082781.6,124887365,3-124821985-C-T,rs4678167,-1,C,T,124821985,65380,124690757,125083973,131228
3,ENSG00000082781.6,124887365,3-124821985-C-G,rs4678167,-1,C,G,124821985,65380,124690757,125083973,131228
3,ENSG00000158163.9,138115608,3-138003033-A-G,rs4678398,-1,A,G,138003033,112575,137919000,138312216,84033
3,ENSG00000070476.10,126475891,3-126409253-C-A,rs4679239,-1,C,A,126409253,66638,126279283,126672499,129970
3,ENSG00000070476.10,126475891,3-126409253-C-G,rs4679239,-1,C,G,126409253,66638,126279283,126672499,129970
3,ENSG00000070476.10,126475891,3-126409253-C-T,rs4679239,-1,C,T,126409253,66638,126279283,126672499,129970
3,ENSG00000174928.9,155806278,3-155754945-T-G,rs4680216,-1,T,G,155754945,51333,155609670,156002886,145275
3,ENSG00000174928.9,155806278,3-155754945-T-C,rs4680216,-1,T,C,155754945,51333,155609670,156002886,145275
3,ENSG00000174928.9,155806278,3-155754945-T-A,rs4680216,-1,T,A,155754945,51333,155609670,156002886,145275
3,ENSG00000163814.3,45146378,3-45162404-C-T,rs4683072,-1,C,T,45162404,16026,44949770,45342986,212634
3,ENSG00000011376.5,45388576,3-45429182-A-T,rs4683111,1,A,T,45429182,40606,45191968,45585184,237214
3,ENSG00000011376.5,45388576,3-45429182-A-G,rs4683111,1,A,G,45429182,40606,45191968,45585184,237214
3,ENSG00000069849.6,141876643,3-141844434-A-G,rs4683630,1,A,G,141844434,32209,141680035,142073251,164399
3,ENSG00000069849.6,141876643,3-141844434-A-T,rs4683630,1,A,T,141844434,32209,141680035,142073251,164399
3,ENSG00000163710.3,142889083,3-142882417-T-A,rs4683700,-1,T,A,142882417,6666,142692475,143085691,189942
3,ENSG00000144559.6,11846885,3-11848313-C-T,rs4684823,-1,C,T,11848313,1428,11650277,12043493,198036
3,ENSG00000144559.6,11846885,3-11848313-C-A,rs4684823,-1,C,A,11848313,1428,11650277,12043493,198036
3,ENSG00000073849.10,186930526,3-187025265-A-G,rs4686838,1,A,G,187025265,94739,186733918,187127134,291347
3,ENSG00000073849.10,186930526,3-187025265-A-C,rs4686838,1,A,C,187025265,94739,186733918,187127134,291347
3,ENSG00000068001.9,50322745,3-50484632-G-A,rs4688718,-1,G,A,50484632,161887,50126137,50519353,358495
3,ENSG00000068001.9,50322745,3-50484632-G-T,rs4688718,-1,G,T,50484632,161887,50126137,50519353,358495
3,ENSG00000175040.4,143119771,3-143203122-G-A,rs4839620,1,G,A,143203122,83351,142923163,143316379,279959
3,ENSG00000175040.4,143119771,3-143203122-G-T,rs4839620,1,G,T,143203122,83351,142923163,143316379,279959
3,ENSG00000175040.4,143119771,3-143203122-G-C,rs4839620,1,G,C,143203122,83351,142923163,143316379,279959
3,ENSG00000144821.5,108510596,3-108396189-G-T,rs4855559,-1,G,T,108396189,114407,108313988,108707204,82201
3,ENSG00000119227.3,196968833,3-196959053-C-G,rs495253,-1,C,G,196959053,9780,196772225,197165441,186828
3,ENSG00000119227.3,196968833,3-196959053-C-T,rs495253,-1,C,T,196959053,9780,196772225,197165441,186828
3,ENSG00000131378.8,16513699,3-16367158-G-A,rs553681,-1,G,A,16367158,146541,16317091,16710307,50067
3,ENSG00000131378.8,16513699,3-16367158-G-T,rs553681,-1,G,T,16367158,146541,16317091,16710307,50067
3,ENSG00000172037.8,49133050,3-48944902-C-T,rs55786114,-1,C,T,48944902,188148,48936442,49329658,8460
3,ENSG00000114251.8,55487306,3-55517036-C-T,rs570374,-1,C,T,55517036,29730,55290698,55683914,226338
3,ENSG00000240303.3,132659809,3-132709856-A-G,rs59376040,-1,A,G,132709856,50047,132463201,132856417,246655
3,ENSG00000169313.8,151384753,3-151541833-G-C,rs59477756,-1,G,C,151541833,157080,151188145,151581361,353688
3,ENSG00000169313.8,151384753,3-151541833-G-A,rs59477756,-1,G,A,151541833,157080,151188145,151581361,353688
3,ENSG00000163686.8,58237792,3-58131997-G-A,rs60183346,1,G,A,58131997,105795,58041184,58434400,90813
3,ENSG00000177565.10,177197482,3-177190785-T-C,rs60604475,-1,T,C,177190785,6697,177000874,177394090,189911
3,ENSG00000131386.12,16174680,3-16322022-G-A,rs61129840,1,G,A,16322022,147342,15978072,16371288,343950
3,ENSG00000144713.8,12841565,3-13013270-T-C,rs62242719,-1,T,C,13013270,171705,12644957,13038173,368313
3,ENSG00000187288.6,9880253,3-9884326-G-A,rs62247505,-1,G,A,9884326,4073,9683645,10076861,200681
3,ENSG00000163380.11,69122595,3-69221881-G-T,rs62254461,-1,G,T,69221881,99286,68925987,69319203,295894
3,ENSG00000163380.11,69122595,3-69221881-G-C,rs62254461,-1,G,C,69221881,99286,68925987,69319203,295894
3,ENSG00000163380.11,69122595,3-69221881-G-A,rs62254461,-1,G,A,69221881,99286,68925987,69319203,295894
3,ENSG00000227124.4,75785549,3-75777035-G-T,rs62269663,-1,G,T,75777035,8514,75588941,75982157,188094
3,ENSG00000227124.4,75785549,3-75777035-G-A,rs62269663,-1,G,A,75777035,8514,75588941,75982157,188094
3,ENSG00000227124.4,75785549,3-75777035-G-C,rs62269663,-1,G,C,75777035,8514,75588941,75982157,188094
3,ENSG00000061938.12,195908551,3-195921614-C-A,rs62284390,-1,C,A,195921614,13063,195711943,196105159,209671
3,ENSG00000061938.12,195908551,3-195921614-C-T,rs62284390,-1,C,T,195921614,13063,195711943,196105159,209671
3,ENSG00000163655.8,155870650,3-155867331-G-C,rs62286789,1,G,C,155867331,3319,155674042,156067258,193289
3,ENSG00000170819.4,133400056,3-133500935-G-T,rs6439416,1,G,T,133500935,100879,133203448,133596664,297487
3,ENSG00000170819.4,133400056,3-133500935-G-A,rs6439416,1,G,A,133500935,100879,133203448,133596664,297487
3,ENSG00000164051.9,48440119,3-48274544-A-T,rs6442112,-1,A,T,48274544,165575,48243511,48636727,31033
3,ENSG00000164051.9,48440119,3-48274544-A-G,rs6442112,-1,A,G,48274544,165575,48243511,48636727,31033
3,ENSG00000131389.12,14402606,3-14234259-C-G,rs6442433,1,C,G,14234259,168347,14205998,14599214,28261
3,ENSG00000145191.6,184135358,3-184084809-G-A,rs6443942,1,G,A,184084809,50549,183938750,184331966,146059
3,ENSG00000171757.10,169812904,3-169893288-C-T,rs6444881,-1,C,T,169893288,80384,169616296,170009512,276992
3,ENSG00000171757.10,169812904,3-169893288-C-A,rs6444881,-1,C,A,169893288,80384,169616296,170009512,276992
3,ENSG00000144802.7,101849514,3-101828295-C-T,rs665631,1,C,T,101828295,21219,101652906,102046122,175389
3,ENSG00000144802.7,101849514,3-101828295-C-A,rs665631,1,C,A,101828295,21219,101652906,102046122,175389
3,ENSG00000180611.6,192917856,3-192895447-C-G,rs67168132,-1,C,G,192895447,22409,192721248,193114464,174199
3,ENSG00000180611.6,192917856,3-192895447-C-A,rs67168132,-1,C,A,192895447,22409,192721248,193114464,174199
3,ENSG00000169255.9,161105349,3-161208834-G-T,rs6762064,-1,G,T,161208834,103485,160908741,161301957,300093
3,ENSG00000131375.5,15206246,3-15390960-C-A,rs6762954,1,C,A,15390960,184714,15009638,15402854,381322
3,ENSG00000131375.5,15206246,3-15390960-C-G,rs6762954,1,C,G,15390960,184714,15009638,15402854,381322
3,ENSG00000163536.7,167735721,3-167572856-C-A,rs6764809,1,C,A,167572856,162865,167539113,167932329,33743
3,ENSG00000163536.7,167735721,3-167572856-C-T,rs6764809,1,C,T,167572856,162865,167539113,167932329,33743
3,ENSG00000163536.7,167735721,3-167572856-C-G,rs6764809,1,C,G,167572856,162865,167539113,167932329,33743
3,ENSG00000129048.5,132597270,3-132715307-T-C,rs6765919,1,T,C,132715307,118037,132400662,132793878,314645
3,ENSG00000185798.6,196568554,3-196527870-G-T,rs6765975,-1,G,T,196527870,40684,196371946,196765162,155924
3,ENSG00000185798.6,196568554,3-196527870-G-A,rs6765975,-1,G,A,196527870,40684,196371946,196765162,155924
3,ENSG00000181322.9,138329851,3-138294088-A-G,rs6767873,-1,A,G,138294088,35763,138133243,138526459,160845
3,ENSG00000187068.2,185153060,3-185096656-A-C,rs6770129,-1,A,C,185096656,56404,184956452,185349668,140204
3,ENSG00000187068.2,185153060,3-185096656-A-G,rs6770129,-1,A,G,185096656,56404,184956452,185349668,140204
3,ENSG00000187068.2,185153060,3-185096656-A-T,rs6770129,-1,A,T,185096656,56404,184956452,185349668,140204
3,ENSG00000163389.6,119468963,3-119386134-A-G,rs6770936,1,A,G,119386134,82829,119272355,119665571,113779
3,ENSG00000164081.8,51671252,3-51592433-A-T,rs6771194,1,A,T,51592433,78819,51474644,51867860,117789
3,ENSG00000164081.8,51671252,3-51592433-A-G,rs6771194,1,A,G,51592433,78819,51474644,51867860,117789
3,ENSG00000163959.5,196216534,3-196296514-A-T,rs6778879,1,A,T,196296514,79980,196019926,196413142,276588
3,ENSG00000163959.5,196216534,3-196296514-A-G,rs6778879,1,A,G,196296514,79980,196019926,196413142,276588
3,ENSG00000136521.8,179604794,3-179534756-C-A,rs6779664,1,C,A,179534756,70038,179408186,179801402,126570
3,ENSG00000136521.8,179604794,3-179534756-C-T,rs6779664,1,C,T,179534756,70038,179408186,179801402,126570
3,ENSG00000138463.8,122795069,3-122876930-G-A,rs6780615,1,G,A,122876930,81861,122598461,122991677,278469
3,ENSG00000138463.8,122795069,3-122876930-G-T,rs6780615,1,G,T,122876930,81861,122598461,122991677,278469
3,ENSG00000132153.10,47803138,3-47689877-A-C,rs6781193,1,A,C,47689877,113261,47606530,47999746,83347
3,ENSG00000206561.6,15521706,3-15557776-T-G,rs6781430,-1,T,G,15557776,36070,15325098,15718314,232678
3,ENSG00000206561.6,15521706,3-15557776-T-A,rs6781430,-1,T,A,15557776,36070,15325098,15718314,232678
3,ENSG00000244405.3,186109089,3-186135286-T-C,rs6783586,-1,T,C,186135286,26197,185912481,186305697,222805
3,ENSG00000244405.3,186109089,3-186135286-T-G,rs6783586,-1,T,G,186135286,26197,185912481,186305697,222805
3,ENSG00000173890.12,170037995,3-170052799-T-C,rs6784040,1,T,C,170052799,14804,169841387,170234603,211412
3,ENSG00000152642.6,32106620,3-31929326-A-G,rs6796265,1,A,G,31929326,177294,31910012,32303228,19314
3,ENSG00000152642.6,32106620,3-31929326-A-T,rs6796265,1,A,T,31929326,177294,31910012,32303228,19314
3,ENSG00000161217.6,196287726,3-196403134-A-G,rs6799210,-1,A,G,196403134,115408,196091118,196484334,312016
3,ENSG00000164047.3,48223495,3-48284943-T-C,rs6801801,1,T,C,48284943,61448,48026887,48420103,258056
3,ENSG00000138246.10,132417502,3-132283990-G-C,rs6802577,1,G,C,132283990,133512,132220894,132614110,63096
3,ENSG00000164077.9,49929811,3-49803490-C-T,rs6807837,-1,C,T,49803490,126321,49733203,50126419,70287
3,ENSG00000184307.9,113948013,3-113979423-T-G,rs6809991,1,T,G,113979423,31410,113751405,114144621,228018
3,ENSG00000168811.2,159988835,3-159981785-C-T,rs692890,1,C,T,159981785,7050,159792227,160185443,189558
3,ENSG00000158234.8,138608771,3-138690334-C-T,rs693293,1,C,T,138690334,81563,138412163,138805379,278171
3,ENSG00000158234.8,138608771,3-138690334-C-G,rs693293,1,C,G,138690334,81563,138412163,138805379,278171
3,ENSG00000163923.5,187139496,3-187231000-A-C,rs710451,-1,A,C,187231000,91504,186942888,187336104,288112
3,ENSG00000075914.8,44976244,3-44801451-C-A,rs72875734,1,C,A,44801451,174793,44779636,45172852,21815
3,ENSG00000075914.8,44976244,3-44801451-C-T,rs72875734,1,C,T,44801451,174793,44779636,45172852,21815
3,ENSG00000144642.15,29281071,3-29259807-C-A,rs73072008,1,C,A,29259807,21264,29084463,29477679,175344
3,ENSG00000144642.15,29281071,3-29259807-C-T,rs73072008,1,C,T,29259807,21264,29084463,29477679,175344
3,ENSG00000154781.10,14651762,3-14716632-A-C,rs73137412,1,A,C,14716632,64870,14455154,14848370,261478
3,ENSG00000154781.10,14651762,3-14716632-A-G,rs73137412,1,A,G,14716632,64870,14455154,14848370,261478
3,ENSG00000231861.1,98497681,3-98546594-C-G,rs73144182,1,C,G,98546594,48913,98301073,98694289,245521
3,ENSG00000178750.2,94028597,3-94184615-C-T,rs73161420,-1,C,T,94184615,156018,93831989,94225205,352626
3,ENSG00000178750.2,94028597,3-94184615-C-A,rs73161420,-1,C,A,94184615,156018,93831989,94225205,352626
3,ENSG00000121858.6,172523430,3-172379580-A-G,rs73167297,-1,A,G,172379580,143850,172326822,172720038,52758
3,ENSG00000145194.13,184276022,3-184257921-G-T,rs73185796,1,G,T,184257921,18101,184079414,184472630,178507
3,ENSG00000145194.13,184276022,3-184257921-G-A,rs73185796,1,G,A,184257921,18101,184079414,184472630,178507
3,ENSG00000182923.11,134486057,3-134556605-G-C,rs73221365,1,G,C,134556605,70548,134289449,134682665,267156
3,ENSG00000114742.9,39052016,3-38964857-C-T,rs73828758,1,C,T,38964857,87159,38855408,39248624,109449
3,ENSG00000214706.6,50292429,3-50140578-G-A,rs739983,-1,G,A,50140578,151851,50095821,50489037,44757
3,ENSG00000214706.6,50292429,3-50140578-G-C,rs739983,-1,G,C,50140578,151851,50095821,50489037,44757
3,ENSG00000157036.8,38496340,3-38604932-C-T,rs7428779,1,C,T,38604932,108592,38299732,38692948,305200
3,ENSG00000077097.8,25664907,3-25585025-T-C,rs74318739,-1,T,C,25585025,79882,25468299,25861515,116726
3,ENSG00000198218.5,49094071,3-48995534-C-G,rs7434187,-1,C,G,48995534,98537,48897463,49290679,98071
3,ENSG00000198218.5,49094071,3-48995534-C-T,rs7434187,-1,C,T,48995534,98537,48897463,49290679,98071
3,ENSG00000198218.5,49094071,3-48995534-C-A,rs7434187,-1,C,A,48995534,98537,48897463,49290679,98071
3,ENSG00000163827.8,46566302,3-46609211-C-T,rs74349719,-1,C,T,46609211,42909,46369694,46762910,239517
3,ENSG00000163913.6,129440224,3-129575725-G-A,rs746210,1,G,A,129575725,135501,129243616,129636832,332109
3,ENSG00000176945.11,195720978,3-195893937-G-C,rs74861414,1,G,C,195893937,172959,195524370,195917586,369567
3,ENSG00000114573.4,113747035,3-113880441-T-C,rs75283103,1,T,C,113880441,133406,113550427,113943643,330014
3,ENSG00000168356.7,39051944,3-39203613-A-C,rs76021224,-1,A,C,39203613,151669,38855336,39248552,348277
3,ENSG00000168356.7,39051944,3-39203613-A-G,rs76021224,-1,A,G,39203613,151669,38855336,39248552,348277
3,ENSG00000211456.5,45689396,3-45859129-A-G,rs7614952,1,A,G,45859129,169733,45492788,45886004,366341
3,ENSG00000034533.6,131026825,3-131114550-A-G,rs7615213,-1,A,G,131114550,87725,130830217,131223433,284333
3,ENSG00000174007.7,196712250,3-196525866-C-G,rs7615630,-1,C,G,196525866,186384,196515642,196908858,10224
3,ENSG00000174007.7,196712250,3-196525866-C-T,rs7615630,-1,C,T,196525866,186384,196515642,196908858,10224
3,ENSG00000152952.7,146161184,3-146160194-C-A,rs76160069,-1,C,A,146160194,990,145964576,146357792,195618
3,ENSG00000152952.7,146161184,3-146160194-C-T,rs76160069,-1,C,T,146160194,990,145964576,146357792,195618
3,ENSG00000183763.4,49856564,3-49901325-A-T,rs7616171,-1,A,T,49901325,44761,49659956,50053172,241369
3,ENSG00000154310.12,171460405,3-171649157-T-C,rs7616430,-1,T,C,171649157,188752,171263797,171657013,385360
3,ENSG00000247596.3,52239158,3-52245578-G-T,rs7618915,-1,G,T,52245578,6420,52042550,52435766,203028
3,ENSG00000247596.3,52239158,3-52245578-G-C,rs7618915,-1,G,C,52245578,6420,52042550,52435766,203028
3,ENSG00000247596.3,52239158,3-52245578-G-A,rs7618915,-1,G,A,52245578,6420,52042550,52435766,203028
3,ENSG00000162244.5,51995895,3-51921947-A-G,rs76199570,-1,A,G,51921947,73948,51799287,52192503,122660
3,ENSG00000162244.5,51995895,3-51921947-A-C,rs76199570,-1,A,C,51921947,73948,51799287,52192503,122660
3,ENSG00000206560.6,15797979,3-15797254-G-A,rs7625615,-1,G,A,15797254,725,15601371,15994587,195883
3,ENSG00000131368.3,15065315,3-15026426-A-G,rs7631007,-1,A,G,15026426,38889,14868707,15261923,157719
3,ENSG00000152580.7,151461061,3-151565858-T-A,rs7631281,-1,T,A,151565858,104797,151264453,151657669,301405
3,ENSG00000152580.7,151461061,3-151565858-T-G,rs7631281,-1,T,G,151565858,104797,151264453,151657669,301405
3,ENSG00000152580.7,151461061,3-151565858-T-C,rs7631281,-1,T,C,151565858,104797,151264453,151657669,301405
3,ENSG00000057019.10,98901695,3-99021685-G-A,rs7634027,-1,G,A,99021685,119990,98705087,99098303,316598
3,ENSG00000114786.11,51975060,3-51979226-T-C,rs7636204,1,T,C,51979226,4166,51778452,52171668,200774
3,ENSG00000244607.1,42773253,3-42712474-T-C,rs7639170,-1,T,C,42712474,60779,42576645,42969861,135829
3,ENSG00000244607.1,42773253,3-42712474-T-A,rs7639170,-1,T,A,42712474,60779,42576645,42969861,135829
3,ENSG00000154783.6,14818962,3-14630804-C-T,rs7640236,1,C,T,14630804,188158,14622354,15015570,8450
3,ENSG00000114021.6,100334757,3-100491665-G-A,rs7640470,1,G,A,100491665,156908,100138149,100531365,353516
3,ENSG00000114021.6,100334757,3-100491665-G-T,rs7640470,1,G,T,100491665,156908,100138149,100531365,353516
3,ENSG00000114021.6,100334757,3-100491665-G-C,rs7640470,1,G,C,100491665,156908,100138149,100531365,353516
3,ENSG00000127249.10,193554895,3-193588763-T-C,rs7642165,-1,T,C,193588763,33868,193358287,193751503,230476
3,ENSG00000154928.12,134795260,3-134858673-C-G,rs7645894,1,C,G,134858673,63413,134598652,134991868,260021
3,ENSG00000154928.12,134795260,3-134858673-C-A,rs7645894,1,C,A,134858673,63413,134598652,134991868,260021
3,ENSG00000154928.12,134795260,3-134858673-C-T,rs7645894,1,C,T,134858673,63413,134598652,134991868,260021
3,ENSG00000183624.8,129278870,3-129300402-G-A,rs7646150,1,G,A,129300402,21532,129082262,129475478,218140
3,ENSG00000168329.8,39280036,3-39328456-T-C,rs7647254,-1,T,C,39328456,48420,39083428,39476644,245028
3,ENSG00000114019.10,134374447,3-134452129-A-G,rs7650509,-1,A,G,134452129,77682,134177839,134571055,274290
3,ENSG00000114019.10,134374447,3-134452129-A-T,rs7650509,-1,A,T,134452129,77682,134177839,134571055,274290
3,ENSG00000114019.10,134374447,3-134452129-A-C,rs7650509,-1,A,C,134452129,77682,134177839,134571055,274290
3,ENSG00000163714.11,143001570,3-143054220-C-A,rs7652745,1,C,A,143054220,52650,142804962,143198178,249258
3,ENSG00000163714.11,143001570,3-143054220-C-T,rs7652745,1,C,T,143054220,52650,142804962,143198178,249258
3,ENSG00000163714.11,143001570,3-143054220-C-G,rs7652745,1,C,G,143054220,52650,142804962,143198178,249258
3,ENSG00000182606.9,42091357,3-42089399-T-C,rs76733823,1,T,C,42089399,1958,41894749,42287965,194650
3,ENSG00000163347.4,190322446,3-190489120-C-T,rs76821364,-1,C,T,190489120,166674,190125838,190519054,363282
3,ENSG00000114631.9,127629185,3-127546066-C-A,rs768854,1,C,A,127546066,83119,127432577,127825793,113489
3,ENSG00000114631.9,127629185,3-127546066-C-T,rs768854,1,C,T,127546066,83119,127432577,127825793,113489
3,ENSG00000239732.1,52225645,3-52126159-G-A,rs77559399,-1,G,A,52126159,99486,52029037,52422253,97122
3,ENSG00000114107.4,138594260,3-138595170-G-A,rs77947724,-1,G,A,138595170,910,138397652,138790868,197518
3,ENSG00000114268.7,48556803,3-48562712-C-A,rs78159609,-1,C,A,48562712,5909,48360195,48753411,202517
3,ENSG00000114268.7,48556803,3-48562712-C-T,rs78159609,-1,C,T,48562712,5909,48360195,48753411,202517
3,ENSG00000114541.10,69386088,3-69235870-C-T,rs78166695,-1,C,T,69235870,150218,69189480,69582696,46390
3,ENSG00000114541.10,69386088,3-69235870-C-A,rs78166695,-1,C,A,69235870,150218,69189480,69582696,46390
3,ENSG00000174013.7,196568660,3-196513851-C-T,rs78284331,1,C,T,196513851,54809,196372052,196765268,141799
3,ENSG00000145198.10,184229585,3-184385934-A-G,rs79419884,1,A,G,184385934,156349,184032977,184426193,352957
3,ENSG00000169964.5,44861912,3-44894593-G-A,rs79770344,1,G,A,44894593,32681,44665304,45058520,229289
3,ENSG00000114867.14,184314606,3-184405485-C-T,rs79866321,1,C,T,184405485,90879,184117998,184511214,287487
3,ENSG00000145029.6,49429324,3-49562469-T-C,rs80031977,-1,T,C,49562469,133145,49232716,49625932,329753
3,ENSG00000168028.8,39406720,3-39425703-A-T,rs816506,1,A,T,39425703,18983,39210112,39603328,215591
3,ENSG00000168028.8,39406720,3-39425703-A-G,rs816506,1,A,G,39425703,18983,39210112,39603328,215591
3,ENSG00000168028.8,39406720,3-39425703-A-C,rs816506,1,A,C,39425703,18983,39210112,39603328,215591
3,ENSG00000184203.3,195543325,3-195535470-G-A,rs823508,-1,G,A,195535470,7855,195346717,195739933,188753
3,ENSG00000152601.13,152268929,3-152262498-G-A,rs842051,1,G,A,152262498,6431,152072321,152465537,190177
3,ENSG00000014257.11,132317407,3-132325508-C-T,rs860264,1,C,T,132325508,8101,132120799,132514015,204709
3,ENSG00000014257.11,132317407,3-132325508-C-G,rs860264,1,C,G,132325508,8101,132120799,132514015,204709
3,ENSG00000144647.5,43106079,3-43029274-T-C,rs870238,-1,T,C,43029274,76805,42909471,43302687,119803
3,ENSG00000180370.5,196739857,3-196829972-G-A,rs9109,1,G,A,196829972,90115,196543249,196936465,286723
3,ENSG00000180370.5,196739857,3-196829972-G-C,rs9109,1,G,C,196829972,90115,196543249,196936465,286723
3,ENSG00000180370.5,196739857,3-196829972-G-T,rs9109,1,G,T,196829972,90115,196543249,196936465,286723
3,ENSG00000154175.11,100993421,3-100804515-G-A,rs9290224,-1,G,A,100804515,188906,100796813,101190029,7702
3,ENSG00000163935.8,53046073,3-52953629-T-C,rs9311485,-1,T,C,52953629,92444,52849465,53242681,104164
3,ENSG00000163935.8,53046073,3-52953629-T-G,rs9311485,-1,T,G,52953629,92444,52849465,53242681,104164
3,ENSG00000180376.12,56557175,3-56621914-G-A,rs9311608,1,G,A,56621914,64739,56360567,56753783,261347
3,ENSG00000131370.11,15332586,3-15336425-G-A,rs9812546,-1,G,A,15336425,3839,15135978,15529194,200447
3,ENSG00000169860.4,152835131,3-153028434-A-T,rs9814144,1,A,T,153028434,193303,152638523,153031739,389911
3,ENSG00000169860.4,152835131,3-153028434-A-C,rs9814144,1,A,C,153028434,193303,152638523,153031739,389911
3,ENSG00000144645.9,31981262,3-31873871-T-C,rs9816424,-1,T,C,31873871,107391,31784654,32177870,89217
3,ENSG00000144645.9,31981262,3-31873871-T-G,rs9816424,-1,T,G,31873871,107391,31784654,32177870,89217
3,ENSG00000160796.10,46979666,3-47062986-C-T,rs9826669,1,C,T,47062986,83320,46783058,47176274,279928
3,ENSG00000114354.7,100709494,3-100586256-G-A,rs9830610,1,G,A,100586256,123238,100512886,100906102,73370
3,ENSG00000091986.10,112641143,3-112540146-A-G,rs9831088,-1,A,G,112540146,100997,112444535,112837751,95611
3,ENSG00000091986.10,112641143,3-112540146-A-C,rs9831088,-1,A,C,112540146,100997,112444535,112837751,95611
3,ENSG00000188001.5,189171971,3-189304353-A-G,rs9834698,1,A,G,189304353,132382,188975363,189368579,328990
3,ENSG00000174946.5,151203216,3-151020968-A-C,rs9837084,-1,A,C,151020968,182248,151006608,151399824,14360
3,ENSG00000168301.8,58492096,3-58627651-T-G,rs9846601,1,T,G,58627651,135555,58295488,58688704,332163
3,ENSG00000145012.8,188154157,3-188080402-A-T,rs9849004,1,A,T,188080402,73755,187957549,188350765,122853
3,ENSG00000145012.8,188154157,3-188080402-A-G,rs9849004,1,A,G,188080402,73755,187957549,188350765,122853
3,ENSG00000249992.1,45226287,3-45382486-C-A,rs9856664,-1,C,A,45382486,156199,45029679,45422895,352807
3,ENSG00000249992.1,45226287,3-45382486-C-T,rs9856664,-1,C,T,45382486,156199,45029679,45422895,352807
3,ENSG00000144791.5,45594751,3-45764574-C-T,rs9857669,1,C,T,45764574,169823,45398143,45791359,366431
3,ENSG00000136059.9,37990786,3-37989859-C-T,rs9858321,1,C,T,37989859,927,37794178,38187394,195681
3,ENSG00000178053.13,158571194,3-158745257-T-C,rs9861938,1,T,C,158745257,174063,158374586,158767802,370671
3,ENSG00000079257.3,158672648,3-158745257-T-C,rs9861938,-1,T,C,158745257,72609,158476040,158869256,269217
3,ENSG00000138459.4,112562045,3-112722101-A-G,rs9863500,1,A,G,112722101,160056,112365437,112758653,356664
3,ENSG00000138459.4,112562045,3-112722101-A-C,rs9863500,1,A,C,112722101,160056,112365437,112758653,356664
3,ENSG00000138459.4,112562045,3-112722101-A-T,rs9863500,1,A,T,112722101,160056,112365437,112758653,356664
3,ENSG00000008226.15,38039208,3-37926170-G-A,rs9868023,1,G,A,37926170,113038,37842600,38235816,83570
3,ENSG00000206530.4,113441493,3-113427424-T-C,rs9869318,-1,T,C,113427424,14069,113244885,113638101,182539
3,ENSG00000075651.11,171810483,3-171911479-C-T,rs9873456,-1,C,T,171911479,100996,171613875,172007091,297604
3,ENSG00000145014.13,194633419,3-194665071-T-C,rs9876550,-1,T,C,194665071,31652,194436811,194830027,228260
3,ENSG00000074416.8,127822515,3-127810687-G-A,rs9877819,-1,G,A,127810687,11828,127625907,128019123,184780
3,ENSG00000172215.5,45943464,3-46082347-T-G,rs9990063,1,T,G,46082347,138883,45746856,46140072,335491
3,ENSG00000121797.8,46407259,3-46298321-A-G,rs9990343,1,A,G,46298321,108938,46210651,46603867,87670
3,ENSG00000121797.8,46407259,3-46298321-A-T,rs9990343,1,A,T,46298321,108938,46210651,46603867,87670
2,ENSG00000118257.11,205682501,2-205682821-T-C,rs10090,1,T,C,205682821,320,205485893,205879109,196928
2,ENSG00000115840.9,171894244,2-171963793-T-A,rs10165126,-1,T,A,171963793,69549,171697636,172090852,266157
2,ENSG00000115840.9,171894244,2-171963793-T-C,rs10165126,-1,T,C,171963793,69549,171697636,172090852,266157
2,ENSG00000071073.6,98731132,2-98685370-T-C,rs10165386,-1,T,C,98685370,45762,98534524,98927740,150846
2,ENSG00000071073.6,98731132,2-98685370-T-A,rs10165386,-1,T,A,98685370,45762,98534524,98927740,150846
2,ENSG00000204262.6,189179761,2-189083088-C-T,rs10166301,-1,C,T,189083088,96673,188983153,189376369,99935
2,ENSG00000204262.6,189179761,2-189083088-C-G,rs10166301,-1,C,G,189083088,96673,188983153,189376369,99935
2,ENSG00000204262.6,189179761,2-189083088-C-A,rs10166301,-1,C,A,189083088,96673,188983153,189376369,99935
2,ENSG00000143727.10,264947,2-70187-G-A,rs10170011,1,G,A,70187,194760,68339,461555,1848
2,ENSG00000115457.5,216633420,2-216795048-G-A,rs10170674,1,G,A,216795048,161628,216436812,216830028,358236
2,ENSG00000082153.12,200811910,2-200637672-T-A,rs10172572,1,T,A,200637672,174238,200615302,201008518,22370
2,ENSG00000082153.12,200811910,2-200637672-T-C,rs10172572,1,T,C,200637672,174238,200615302,201008518,22370
2,ENSG00000173744.11,227472156,2-227462618-A-C,rs10175782,1,A,C,227462618,9538,227275548,227668764,187070
2,ENSG00000115977.13,69643739,2-69567851-C-T,rs10178273,-1,C,T,69567851,75888,69447131,69840347,120720
2,ENSG00000183091.13,151734476,2-151815740-G-A,rs10179630,-1,G,A,151815740,81264,151537868,151931084,277872
2,ENSG00000168887.6,85612066,2-85694429-G-T,rs10181739,-1,G,T,85694429,82363,85415458,85808674,278971
2,ENSG00000168887.6,85612066,2-85694429-G-A,rs10181739,-1,G,A,85694429,82363,85415458,85808674,278971
2,ENSG00000118961.9,20823101,2-20684826-G-A,rs10182643,-1,G,A,20684826,138275,20626493,21019709,58333
2,ENSG00000118961.9,20823101,2-20684826-G-C,rs10182643,-1,G,C,20684826,138275,20626493,21019709,58333
2,ENSG00000170035.9,180980605,2-181081388-A-T,rs10184839,1,A,T,181081388,100783,180783997,181177213,297391
2,ENSG00000170035.9,180980605,2-181081388-A-G,rs10184839,1,A,G,181081388,100783,180783997,181177213,297391
2,ENSG00000170035.9,180980605,2-181081388-A-C,rs10184839,1,A,C,181081388,100783,180783997,181177213,297391
2,ENSG00000144115.11,88170346,2-88163718-T-C,rs10185660,1,T,C,88163718,6628,87973738,88366954,189980
2,ENSG00000136717.10,127107154,2-127084193-C-G,rs10200967,-1,C,G,127084193,22961,126910546,127303762,173647
2,ENSG00000136717.10,127107154,2-127084193-C-T,rs10200967,-1,C,T,127084193,22961,126910546,127303762,173647
2,ENSG00000136717.10,127107154,2-127084193-C-A,rs10200967,-1,C,A,127084193,22961,126910546,127303762,173647
2,ENSG00000155749.8,201357345,2-201338068-A-T,rs10201587,-1,A,T,201338068,19277,201160737,201553953,177331
2,ENSG00000155749.8,201357345,2-201338068-A-G,rs10201587,-1,A,G,201338068,19277,201160737,201553953,177331
2,ENSG00000135953.6,102736888,2-102560955-C-T,rs10202404,-1,C,T,102560955,175933,102540280,102933496,20675
2,ENSG00000183281.10,87021844,2-87051761-G-A,rs10203656,-1,G,A,87051761,29917,86825236,87218452,226525
2,ENSG00000144395.12,196639715,2-196651663-T-C,rs10204260,1,T,C,196651663,11948,196443107,196836323,208556
2,ENSG00000144395.12,196639715,2-196651663-T-G,rs10204260,1,T,G,196651663,11948,196443107,196836323,208556
2,ENSG00000144395.12,196639715,2-196651663-T-A,rs10204260,1,T,A,196651663,11948,196443107,196836323,208556
2,ENSG00000169047.4,226799820,2-226749289-C-T,rs10205233,-1,C,T,226749289,50531,226603212,226996428,146077
2,ENSG00000063660.4,240435663,2-240426048-G-A,rs10205560,1,G,A,240426048,9615,240239055,240632271,186993
2,ENSG00000138375.8,216412484,2-216397237-C-T,rs10211039,1,C,T,216397237,15247,216215876,216609092,181361
2,ENSG00000077380.11,171687469,2-171512890-T-C,rs10490603,1,T,C,171512890,174579,171490861,171884077,22029
2,ENSG00000178295.9,17754138,2-17703228-C-T,rs1065381,1,C,T,17703228,50910,17557530,17950746,145698
2,ENSG00000138439.10,202634969,2-202691105-C-T,rs10755019,1,C,T,202691105,56136,202438361,202831577,252744
2,ENSG00000095002.7,47403156,2-47338656-T-G,rs10865224,1,T,G,47338656,64500,47206548,47599764,132108
2,ENSG00000095002.7,47403156,2-47338656-T-C,rs10865224,1,T,C,47338656,64500,47206548,47599764,132108
2,ENSG00000178662.10,165469698,2-165579850-C-T,rs10930172,1,C,T,165579850,110152,165273090,165666306,306760
2,ENSG00000178662.10,165469698,2-165579850-C-G,rs10930172,1,C,G,165579850,110152,165273090,165666306,306760
2,ENSG00000163492.9,179050137,2-178998979-G-C,rs10930850,-1,G,C,178998979,51158,178853529,179246745,145450
2,ENSG00000163492.9,179050137,2-178998979-G-A,rs10930850,-1,G,A,178998979,51158,178853529,179246745,145450
2,ENSG00000125618.12,113278921,2-113226726-T-C,rs11123172,-1,T,C,113226726,52195,113082313,113475529,144413
2,ENSG00000115526.6,100417668,2-100319814-A-T,rs11123826,-1,A,T,100319814,97854,100221060,100614276,98754
2,ENSG00000115526.6,100417668,2-100319814-A-C,rs11123826,-1,A,C,100319814,97854,100221060,100614276,98754
2,ENSG00000115526.6,100417668,2-100319814-A-G,rs11123826,-1,A,G,100319814,97854,100221060,100614276,98754
2,ENSG00000214711.5,31217515,2-31217504-C-T,rs11124255,-1,C,T,31217504,11,31020907,31414123,196597
2,ENSG00000218739.4,37196496,2-37272146-T-C,rs11124574,1,T,C,37272146,75650,36999888,37393104,272258
2,ENSG00000243244.1,48530154,2-48553788-T-A,rs11125176,1,T,A,48553788,23634,48333546,48726762,220242
2,ENSG00000243244.1,48530154,2-48553788-T-G,rs11125176,1,T,G,48553788,23634,48333546,48726762,220242
2,ENSG00000132300.14,86106235,2-86227791-C-T,rs11127018,1,C,T,86227791,121556,85909627,86302843,318164
2,ENSG00000132300.14,86106235,2-86227791-C-A,rs11127018,1,C,A,86227791,121556,85909627,86302843,318164
2,ENSG00000138395.10,201806537,2-201883717-C-T,rs112621228,1,C,T,201883717,77180,201609929,202003145,273788
2,ENSG00000219626.4,24123469,2-24119662-G-A,rs1134516,1,G,A,24119662,3807,23926861,24320077,192801
2,ENSG00000151353.10,677406,2-708876-A-C,rs114064458,-1,A,C,708876,31470,480798,874014,228078
2,ENSG00000151353.10,677406,2-708876-A-T,rs114064458,-1,A,T,708876,31470,480798,874014,228078
2,ENSG00000135625.6,73293548,2-73161330-T-C,rs114596492,-1,T,C,73161330,132218,73096940,73490156,64390
2,ENSG00000136710.5,130342164,2-130343161-G-A,rs11542411,-1,G,A,130343161,997,130145556,130538772,197605
2,ENSG00000054219.9,159904756,2-159747941-C-T,rs11555185,-1,C,T,159747941,156815,159708148,160101364,39793
2,ENSG00000150540.9,137964473,2-137964059-G-A,rs11569722,1,G,A,137964059,414,137767865,138161081,196194
2,ENSG00000144040.8,73071712,2-72906716-A-G,rs115749085,-1,A,G,72906716,164996,72875104,73268320,31612
2,ENSG00000144040.8,73071712,2-72906716-A-T,rs115749085,-1,A,T,72906716,164996,72875104,73268320,31612
2,ENSG00000182600.5,232870284,2-233023317-C-T,rs115874184,1,C,T,233023317,153033,232673676,233066892,349641
2,ENSG00000172086.7,88055783,2-88186480-C-T,rs115884283,-1,C,T,88186480,130697,87859175,88252391,327305
2,ENSG00000155760.1,202033855,2-201903976-A-C,rs116333240,1,A,C,201903976,129879,201837247,202230463,66729
2,ENSG00000138399.13,169573865,2-169508120-C-T,rs116649447,-1,C,T,169508120,65745,169377257,169770473,130863
2,ENSG00000144120.7,119679201,2-119659211-C-T,rs11678053,1,C,T,119659211,19990,119482593,119875809,176618
2,ENSG00000144120.7,119679201,2-119659211-C-A,rs11678053,1,C,A,119659211,19990,119482593,119875809,176618
2,ENSG00000144120.7,119679201,2-119659211-C-G,rs11678053,1,C,G,119659211,19990,119482593,119875809,176618
2,ENSG00000123607.10,165953776,2-165867785-T-C,rs116813114,-1,T,C,165867785,85991,165757168,166150384,110617
2,ENSG00000177917.5,152718620,2-152862547-C-T,rs11686247,1,C,T,152862547,143927,152522012,152915228,340535
2,ENSG00000177917.5,152718620,2-152862547-C-G,rs11686247,1,C,G,152862547,143927,152522012,152915228,340535
2,ENSG00000115525.11,85888990,2-85940555-G-T,rs11689401,-1,G,T,85940555,51565,85692382,86085598,248173
2,ENSG00000115525.11,85888990,2-85940555-G-A,rs11689401,-1,G,A,85940555,51565,85692382,86085598,248173
2,ENSG00000171951.3,223602361,2-223688177-A-T,rs11693143,-1,A,T,223688177,85816,223405753,223798969,282424
2,ENSG00000171951.3,223602361,2-223688177-A-G,rs11693143,-1,A,G,223688177,85816,223405753,223798969,282424
2,ENSG00000163328.8,174487029,2-174298251-T-C,rs11693554,-1,T,C,174298251,188778,174290421,174683637,7830
2,ENSG00000163328.8,174487029,2-174298251-T-G,rs11693554,-1,T,G,174298251,188778,174290421,174683637,7830
2,ENSG00000163328.8,174487029,2-174298251-T-A,rs11693554,-1,T,A,174298251,188778,174290421,174683637,7830
2,ENSG00000186132.10,119366834,2-119365701-C-T,rs11693629,-1,C,T,119365701,1133,119170226,119563442,195475
2,ENSG00000127838.9,218270519,2-218369982-T-C,rs11695562,1,T,C,218369982,99463,218073911,218467127,296071
2,ENSG00000156973.9,231781282,2-231720097-A-G,rs11695646,-1,A,G,231720097,61185,231584674,231977890,135423
2,ENSG00000155729.8,200510068,2-200477893-C-A,rs117996228,-1,C,A,200477893,32175,200313460,200706676,164433
2,ENSG00000155729.8,200510068,2-200477893-C-T,rs117996228,-1,C,T,200477893,32175,200313460,200706676,164433
2,ENSG00000144445.10,210171409,2-210340694-A-C,rs11887149,-1,A,C,210340694,169285,209974801,210368017,365893
2,ENSG00000144445.10,210171409,2-210340694-A-G,rs11887149,-1,A,G,210340694,169285,209974801,210368017,365893
2,ENSG00000144445.10,210171409,2-210340694-A-T,rs11887149,-1,A,T,210340694,169285,209974801,210368017,365893
2,ENSG00000065548.12,186486260,2-186681856-T-G,rs11891192,1,T,G,186681856,195596,186289652,186682868,392204
2,ENSG00000240344.4,200889077,2-200908822-T-G,rs11894842,-1,T,G,200908822,19745,200692469,201085685,216353
2,ENSG00000240344.4,200889077,2-200908822-T-C,rs11894842,-1,T,C,200908822,19745,200692469,201085685,216353
2,ENSG00000144579.3,218399868,2-218370501-C-T,rs11899020,1,C,T,218370501,29367,218203260,218596476,167241
2,ENSG00000158089.10,31138440,2-31123880-T-C,rs11903753,-1,T,C,31123880,14560,30941832,31335048,182048
2,ENSG00000158089.10,31138440,2-31123880-T-G,rs11903753,-1,T,G,31123880,14560,30941832,31335048,182048
2,ENSG00000158089.10,31138440,2-31123880-T-A,rs11903753,-1,T,A,31123880,14560,30941832,31335048,182048
2,ENSG00000178074.5,199911293,2-199727787-G-A,rs12052622,1,G,A,199727787,183506,199714685,200107901,13102
2,ENSG00000178074.5,199911293,2-199727787-G-C,rs12052622,1,G,C,199727787,183506,199714685,200107901,13102
2,ENSG00000178074.5,199911293,2-199727787-G-T,rs12052622,1,G,T,199727787,183506,199714685,200107901,13102
2,ENSG00000135631.11,73112948,2-73248305-G-A,rs1246168,-1,G,A,73248305,135357,72916340,73309556,331965
2,ENSG00000124831.13,237627587,2-237596453-C-T,rs12464142,1,C,T,237596453,31134,237430979,237824195,165474
2,ENSG00000124831.13,237627587,2-237596453-C-A,rs12464142,1,C,A,237596453,31134,237430979,237824195,165474
2,ENSG00000152056.12,223837582,2-223954753-T-C,rs12465843,-1,T,C,223954753,117171,223640974,224034190,313779
2,ENSG00000061676.9,183038457,2-182867636-C-T,rs12469777,-1,C,T,182867636,170821,182841849,183235065,25787
2,ENSG00000061676.9,183038457,2-182867636-C-G,rs12469777,-1,C,G,182867636,170821,182841849,183235065,25787
2,ENSG00000197756.4,216498844,2-216516683-C-A,rs12472569,1,C,A,216516683,17839,216302236,216695452,214447
2,ENSG00000197756.4,216498844,2-216516683-C-T,rs12472569,1,C,T,216516683,17839,216302236,216695452,214447
2,ENSG00000171103.6,28870309,2-28807140-T-G,rs12475612,-1,T,G,28807140,63169,28673701,29066917,133439
2,ENSG00000138363.10,215312059,2-215439661-T-A,rs1250229,1,T,A,215439661,127602,215115451,215508667,324210
2,ENSG00000138363.10,215312059,2-215439661-T-C,rs1250229,1,T,C,215439661,127602,215115451,215508667,324210
2,ENSG00000079150.12,178478600,2-178486838-C-G,rs12613303,-1,C,G,178486838,8238,178281992,178675208,204846
2,ENSG00000079150.12,178478600,2-178486838-C-T,rs12613303,-1,C,T,178486838,8238,178281992,178675208,204846
2,ENSG00000135973.1,105241743,2-105393395-G-A,rs12614625,1,G,A,105393395,151652,105045135,105438351,348260
2,ENSG00000135972.4,105038069,2-105098729-C-G,rs12616421,1,C,G,105098729,60660,104841461,105234677,257268
2,ENSG00000135972.4,105038069,2-105098729-C-A,rs12616421,1,C,A,105098729,60660,104841461,105234677,257268
2,ENSG00000173272.9,131492397,2-131507516-G-A,rs12617520,-1,G,A,131507516,15119,131295789,131689005,211727
2,ENSG00000085760.8,55269231,2-55288967-G-A,rs12619486,-1,G,A,55288967,19736,55072623,55465839,216344
2,ENSG00000085760.8,55269231,2-55288967-G-C,rs12619486,-1,G,C,55288967,19736,55072623,55465839,216344
2,ENSG00000156966.6,231395710,2-231268271-C-A,rs12621280,1,C,A,231268271,127439,231199102,231592318,69169
2,ENSG00000156966.6,231395710,2-231268271-C-G,rs12621280,1,C,G,231268271,127439,231199102,231592318,69169
2,ENSG00000155755.13,201643503,2-201686972-G-C,rs12621886,-1,G,C,201686972,43469,201446895,201840111,240077
2,ENSG00000155755.13,201643503,2-201686972-G-A,rs12621886,-1,G,A,201686972,43469,201446895,201840111,240077
2,ENSG00000144320.8,176002267,2-175873812-C-A,rs12693085,-1,C,A,175873812,128455,175805659,176198875,68153
2,ENSG00000144320.8,176002267,2-175873812-C-G,rs12693085,-1,C,G,175873812,128455,175805659,176198875,68153
2,ENSG00000144320.8,176002267,2-175873812-C-T,rs12693085,-1,C,T,175873812,128455,175805659,176198875,68153
2,ENSG00000198130.10,190319826,2-190337911-A-T,rs12693568,-1,A,T,190337911,18085,190123218,190516434,214693
2,ENSG00000198130.10,190319826,2-190337911-A-G,rs12693568,-1,A,G,190337911,18085,190123218,190516434,214693
2,ENSG00000116120.8,222656092,2-222579391-G-A,rs12694581,-1,G,A,222579391,76701,222459484,222852700,119907
2,ENSG00000171853.10,3379694,2-3557878-A-G,rs12711976,1,A,G,3557878,178184,3183086,3576302,374792
2,ENSG00000171853.10,3379694,2-3557878-A-C,rs12711976,1,A,C,3557878,178184,3183086,3576302,374792
2,ENSG00000118640.6,85577586,2-85560218-C-A,rs12714145,1,C,A,85560218,17368,85380978,85774194,179240
2,ENSG00000118640.6,85577586,2-85560218-C-T,rs12714145,1,C,T,85560218,17368,85380978,85774194,179240
2,ENSG00000115486.6,85561493,2-85560218-C-A,rs12714145,-1,C,A,85560218,1275,85364885,85758101,195333
2,ENSG00000115486.6,85561493,2-85560218-C-T,rs12714145,-1,C,T,85560218,1275,85364885,85758101,195333
2,ENSG00000125629.10,118088471,2-118088243-G-A,rs12986752,1,G,A,118088243,228,117891863,118285079,196380
2,ENSG00000162927.8,61018255,2-61017528-A-C,rs12988616,-1,A,C,61017528,727,60821647,61214863,195881
2,ENSG00000135913.6,218568351,2-218633205-A-C,rs12989189,-1,A,C,218633205,64854,218371743,218764959,261462
2,ENSG00000124357.7,71068648,2-71071208-C-T,rs12996507,1,C,T,71071208,2560,70872040,71265256,199168
2,ENSG00000250565.2,46542577,2-46531607-T-A,rs12997164,-1,T,A,46531607,10970,46345969,46739185,185638
2,ENSG00000250565.2,46542577,2-46531607-T-G,rs12997164,-1,T,G,46531607,10970,46345969,46739185,185638
2,ENSG00000115232.8,181457386,2-181548532-A-T,rs12997453,1,A,T,181548532,91146,181260778,181653994,287754
2,ENSG00000115232.8,181457386,2-181548532-A-G,rs12997453,1,A,G,181548532,91146,181260778,181653994,287754
2,ENSG00000119771.10,23385179,2-23383306-A-G,rs12997821,1,A,G,23383306,1873,23188571,23581787,194735
2,ENSG00000135951.10,99154942,2-99249085-G-A,rs12999417,-1,G,A,99249085,94143,98958334,99351550,290751
2,ENSG00000135951.10,99154942,2-99249085-G-T,rs12999417,-1,G,T,99249085,94143,98958334,99351550,290751
2,ENSG00000135951.10,99154942,2-99249085-G-C,rs12999417,-1,G,C,99249085,94143,98958334,99351550,290751
2,ENSG00000151692.9,6917412,2-6822251-G-C,rs13012767,1,G,C,6822251,95161,6720804,7114020,101447
2,ENSG00000151692.9,6917412,2-6822251-G-A,rs13012767,1,G,A,6822251,95161,6720804,7114020,101447
2,ENSG00000151692.9,6917412,2-6822251-G-T,rs13012767,1,G,T,6822251,95161,6720804,7114020,101447
2,ENSG00000115946.3,68157888,2-68265654-A-G,rs13019043,1,A,G,68265654,107766,67961280,68354496,304374
2,ENSG00000115946.3,68157888,2-68265654-A-T,rs13019043,1,A,T,68265654,107766,67961280,68354496,304374
2,ENSG00000075884.8,143129419,2-143257524-T-C,rs13022541,1,T,C,143257524,128105,142932811,143326027,324713
2,ENSG00000171132.9,45651675,2-45824543-G-A,rs13026162,1,G,A,45824543,172868,45455067,45848283,369476
2,ENSG00000171132.9,45651675,2-45824543-G-C,rs13026162,1,G,C,45824543,172868,45455067,45848283,369476
2,ENSG00000135930.9,232550689,2-232379271-A-C,rs13026692,1,A,C,232379271,171418,232354081,232747297,25190
2,ENSG00000135930.9,232550689,2-232379271-A-T,rs13026692,1,A,T,232379271,171418,232354081,232747297,25190
2,ENSG00000163029.11,17753810,2-17792171-A-G,rs13031876,-1,A,G,17792171,38361,17557202,17950418,234969
2,ENSG00000116044.10,177264727,2-177334037-C-A,rs13032354,-1,C,A,177334037,69310,177068119,177461335,265918
2,ENSG00000075340.15,70768200,2-70611058-C-T,rs13389582,-1,C,T,70611058,157142,70571592,70964808,39466
2,ENSG00000115368.5,189441474,2-189437052-C-T,rs13391984,1,C,T,189437052,4422,189244866,189638082,192186
2,ENSG00000169994.13,127535683,2-127533461-A-C,rs13399362,1,A,C,127533461,2222,127339075,127732291,194386
2,ENSG00000169994.13,127535683,2-127533461-A-G,rs13399362,1,A,G,127533461,2222,127339075,127732291,194386
2,ENSG00000170634.7,53971113,2-54155198-A-T,rs13399590,1,A,T,54155198,184085,53774505,54167721,380693
2,ENSG00000170634.7,53971113,2-54155198-A-G,rs13399590,1,A,G,54155198,184085,53774505,54167721,380693
2,ENSG00000169621.5,68467585,2-68484301-A-G,rs13400980,1,A,G,68484301,16716,68270977,68664193,213324
2,ENSG00000169621.5,68467585,2-68484301-A-C,rs13400980,1,A,C,68484301,16716,68270977,68664193,213324
2,ENSG00000163171.6,37671642,2-37628294-G-A,rs13401336,-1,G,A,37628294,43348,37475034,37868250,153260
2,ENSG00000134326.7,6865907,2-6743326-T-C,rs13407528,-1,T,C,6743326,122581,6669299,7062515,74027
2,ENSG00000134321.7,6877777,2-6743326-T-C,rs13407528,1,T,C,6743326,134451,6681169,7074385,62157
2,ENSG00000124383.3,71130634,2-71142494-C-T,rs13407937,1,C,T,71142494,11860,70934026,71327242,208468
2,ENSG00000124383.3,71130634,2-71142494-C-A,rs13407937,1,C,A,71142494,11860,70934026,71327242,208468
2,ENSG00000084710.8,25042076,2-25139815-G-T,rs13408745,1,G,T,25139815,97739,24845468,25238684,294347
2,ENSG00000084710.8,25042076,2-25139815-G-A,rs13408745,1,G,A,25139815,97739,24845468,25238684,294347
2,ENSG00000114982.12,96638312,2-96603861-C-T,rs13413510,-1,C,T,96603861,34451,96441704,96834920,162157
2,ENSG00000114982.12,96638312,2-96603861-C-G,rs13413510,-1,C,G,96603861,34451,96441704,96834920,162157
2,ENSG00000153561.8,86720291,2-86755076-C-T,rs13416756,1,C,T,86755076,34785,86523683,86916899,231393
2,ENSG00000163040.10,131527888,2-131576368-T-C,rs13417184,1,T,C,131576368,48480,131331280,131724496,245088
2,ENSG00000163040.10,131527888,2-131576368-T-G,rs13417184,1,T,G,131576368,48480,131331280,131724496,245088
2,ENSG00000163040.10,131527888,2-131576368-T-A,rs13417184,1,T,A,131576368,48480,131331280,131724496,245088
2,ENSG00000151690.9,190408355,2-190545862-G-A,rs13417310,1,G,A,190545862,137507,190211747,190604963,334115
2,ENSG00000151690.9,190408355,2-190545862-G-T,rs13417310,1,G,T,190545862,137507,190211747,190604963,334115
2,ENSG00000115649.11,219176925,2-219104375-A-G,rs13419740,-1,A,G,219104375,72550,218980317,219373533,124058
2,ENSG00000115970.12,43596038,2-43411699-A-C,rs13429458,-1,A,C,43411699,184339,43399430,43792646,12269
2,ENSG00000168899.4,85584431,2-85570542-A-G,rs13429968,1,A,G,85570542,13889,85387823,85781039,182719
2,ENSG00000168874.8,85753991,2-85743580-C-A,rs13430978,1,C,A,85743580,10411,85557383,85950599,186197
2,ENSG00000168874.8,85753991,2-85743580-C-G,rs13430978,1,C,G,85743580,10411,85557383,85950599,186197
2,ENSG00000168874.8,85753991,2-85743580-C-T,rs13430978,1,C,T,85743580,10411,85557383,85950599,186197
2,ENSG00000204128.5,231037523,2-231195839-G-A,rs13431424,1,G,A,231195839,158316,230840915,231234131,354924
2,ENSG00000123983.9,222861036,2-223023646-C-G,rs1347998,1,C,G,223023646,162610,222664428,223057644,359218
2,ENSG00000123983.9,222861036,2-223023646-C-A,rs1347998,1,C,A,223023646,162610,222664428,223057644,359218
2,ENSG00000172954.8,30447246,2-30473341-A-G,rs1357849,1,A,G,30473341,26095,30250638,30643854,222703
2,ENSG00000144118.8,120252852,2-120257013-C-T,rs1370379,1,C,T,120257013,4161,120056244,120449460,200769
2,ENSG00000035141.3,70302067,2-70316254-T-C,rs1382457,-1,T,C,70316254,14187,70105459,70498675,210795
2,ENSG00000071909.12,170178147,2-170173181-C-A,rs1424652,1,C,A,170173181,4966,169981539,170374755,191642
2,ENSG00000071909.12,170178147,2-170173181-C-T,rs1424652,1,C,T,170173181,4966,169981539,170374755,191642
2,ENSG00000138036.12,43774039,2-43675618-C-T,rs143787127,1,C,T,43675618,98421,43577431,43970647,98187
2,ENSG00000138036.12,43774039,2-43675618-C-G,rs143787127,1,C,G,43675618,98421,43577431,43970647,98187
2,ENSG00000077044.5,233354494,2-233363838-A-G,rs1441093,1,A,G,233363838,9344,233157886,233551102,205952
2,ENSG00000077044.5,233354494,2-233363838-A-T,rs1441093,1,A,T,233363838,9344,233157886,233551102,205952
2,ENSG00000077044.5,233354494,2-233363838-A-C,rs1441093,1,A,C,233363838,9344,233157886,233551102,205952
2,ENSG00000128641.12,191245404,2-191237092-C-T,rs1454761,1,C,T,191237092,8312,191048796,191442012,188296
2,ENSG00000035115.15,264032,2-224192-A-C,rs1474052,-1,A,C,224192,39840,67424,460640,156768
2,ENSG00000035115.15,264032,2-224192-A-G,rs1474052,-1,A,G,224192,39840,67424,460640,156768
2,ENSG00000035115.15,264032,2-224192-A-T,rs1474052,-1,A,T,224192,39840,67424,460640,156768
2,ENSG00000146205.9,241188677,2-241357034-A-G,rs1476698,1,A,G,241357034,168357,240992069,241385285,364965
2,ENSG00000146205.9,241188677,2-241357034-A-T,rs1476698,1,A,T,241357034,168357,240992069,241385285,364965
2,ENSG00000172985.8,109129205,2-109219138-G-T,rs1560386,1,G,T,109219138,89933,108932597,109325813,286541
2,ENSG00000172985.8,109129205,2-109219138-G-A,rs1560386,1,G,A,109219138,89933,108932597,109325813,286541
2,ENSG00000067066.11,230416201,2-230331417-C-T,rs16827136,1,C,T,230331417,84784,230219593,230612809,111824
2,ENSG00000067066.11,230416201,2-230331417-C-A,rs16827136,1,C,A,230331417,84784,230219593,230612809,111824
2,ENSG00000115415.13,191014171,2-190822469-A-C,rs16832982,-1,A,C,190822469,191702,190817563,191210779,4906
2,ENSG00000115020.11,208266255,2-208142031-A-T,rs16840549,1,A,T,208142031,124224,208069647,208462863,72384
2,ENSG00000115020.11,208266255,2-208142031-A-C,rs16840549,1,A,C,208142031,124224,208069647,208462863,72384
2,ENSG00000115687.9,241149472,2-241091675-G-A,rs16843241,-1,G,A,241091675,57797,240952864,241346080,138811
2,ENSG00000078098.8,162243445,2-162195194-G-A,rs16846353,-1,G,A,162195194,48251,162046837,162440053,148357
2,ENSG00000078098.8,162243445,2-162195194-G-C,rs16846353,-1,G,C,162195194,48251,162046837,162440053,148357
2,ENSG00000172292.10,168456272,2-168483619-T-G,rs16855379,1,T,G,168483619,27347,168259664,168652880,223955
2,ENSG00000172292.10,168456272,2-168483619-T-C,rs16855379,1,T,C,168483619,27347,168259664,168652880,223955
2,ENSG00000127837.5,218270137,2-218158594-C-A,rs16858736,-1,C,A,218158594,111543,218073529,218466745,85065
2,ENSG00000127837.5,218270137,2-218158594-C-T,rs16858736,-1,C,T,218158594,111543,218073529,218466745,85065
2,ENSG00000134308.8,9630997,2-9762773-A-G,rs16867155,-1,A,G,9762773,131776,9434389,9827605,328384
2,ENSG00000134308.8,9630997,2-9762773-A-T,rs16867155,-1,A,T,9762773,131776,9434389,9827605,328384
2,ENSG00000240857.1,18560653,2-18504215-C-T,rs16985169,-1,C,T,18504215,56438,18364045,18757261,140170
2,ENSG00000143869.5,20667144,2-20588293-T-A,rs16987857,1,T,A,20588293,78851,20470536,20863752,117757
2,ENSG00000189350.7,28981298,2-29039306-G-A,rs17007486,1,G,A,29039306,58008,28784690,29177906,254616
2,ENSG00000171055.10,36598168,2-36556456-T-A,rs17019087,-1,T,A,36556456,41712,36401560,36794776,154896
2,ENSG00000171055.10,36598168,2-36556456-T-G,rs17019087,-1,T,G,36556456,41712,36401560,36794776,154896
2,ENSG00000171055.10,36598168,2-36556456-T-C,rs17019087,-1,T,C,36556456,41712,36401560,36794776,154896
2,ENSG00000068724.10,46941224,2-46944183-A-G,rs17035912,1,A,G,46944183,2959,46744616,47137832,199567
2,ENSG00000153094.15,111120914,2-111194199-T-G,rs17041909,1,T,G,111194199,73285,110924306,111317522,269893
2,ENSG00000162994.11,55232293,2-55232237-T-C,rs17046778,-1,T,C,55232237,56,55035685,55428901,196552
2,ENSG00000162994.11,55232293,2-55232237-T-G,rs17046778,-1,T,G,55232237,56,55035685,55428901,196552
2,ENSG00000162994.11,55232293,2-55232237-T-A,rs17046778,-1,T,A,55232237,56,55035685,55428901,196552
2,ENSG00000153253.10,165204050,2-165295879-G-A,rs17183814,-1,G,A,165295879,91829,165007442,165400658,288437
2,ENSG00000071967.7,171522474,2-171527478-G-A,rs17288042,1,G,A,171527478,5004,171325866,171719082,201612
2,ENSG00000237651.2,61162188,2-61150884-A-G,rs1729652,1,A,G,61150884,11304,60965580,61358796,185304
2,ENSG00000170745.7,17878667,2-17867386-C-T,rs17316177,1,C,T,17867386,11281,17682059,18075275,185327
2,ENSG00000144021.2,96266225,2-96293878-A-G,rs17420101,1,A,G,96293878,27653,96069617,96462833,224261
2,ENSG00000135940.2,97646062,2-97830475-T-C,rs17424579,1,T,C,97830475,184413,97449454,97842670,381021
2,ENSG00000135637.9,74482998,2-74624016-G-A,rs17667404,-1,G,A,74624016,141018,74286390,74679606,337626
2,ENSG00000197635.5,162074215,2-162073199-T-G,rs1861978,-1,T,G,162073199,1016,161877607,162270823,195592
2,ENSG00000152256.8,172556090,2-172581538-A-C,rs1869922,1,A,C,172581538,25448,172359482,172752698,222056
2,ENSG00000152256.8,172556090,2-172581538-A-G,rs1869922,1,A,G,172581538,25448,172359482,172752698,222056
2,ENSG00000081052.10,227164205,2-227165646-C-T,rs1922022,-1,C,T,227165646,1441,226967597,227360813,198049
2,ENSG00000169031.13,227164624,2-227198236-G-A,rs1950134,1,G,A,227198236,33612,226968016,227361232,230220
2,ENSG00000115944.9,42361217,2-42350030-A-G,rs1981664,-1,A,G,42350030,11187,42164609,42557825,185421
2,ENSG00000115944.9,42361217,2-42350030-A-T,rs1981664,-1,A,T,42350030,11187,42164609,42557825,185421
2,ENSG00000196659.7,177552796,2-177641710-C-G,rs1997207,-1,C,G,177641710,88914,177356188,177749404,285522
2,ENSG00000196659.7,177552796,2-177641710-C-T,rs1997207,-1,C,T,177641710,88914,177356188,177749404,285522
2,ENSG00000196659.7,177552796,2-177641710-C-A,rs1997207,-1,C,A,177641710,88914,177356188,177749404,285522
2,ENSG00000196141.7,200306693,2-200457305-C-T,rs2043768,1,C,T,200457305,150612,200110085,200503301,347220
2,ENSG00000115364.9,75646783,2-75673943-A-G,rs2051942,1,A,G,75673943,27160,75450175,75843391,223768
2,ENSG00000118004.12,3595112,2-3580793-C-G,rs2071639,1,C,G,3580793,14319,3398504,3791720,182289
2,ENSG00000118004.12,3595112,2-3580793-C-A,rs2071639,1,C,A,3580793,14319,3398504,3791720,182289
2,ENSG00000168890.9,85602698,2-85668215-T-G,rs2077079,-1,T,G,85668215,65517,85406090,85799306,262125
2,ENSG00000168890.9,85602698,2-85668215-T-A,rs2077079,-1,T,A,85668215,65517,85406090,85799306,262125
2,ENSG00000221944.3,232550557,2-232545584-C-T,rs2099489,-1,C,T,232545584,4973,232353949,232747165,191635
2,ENSG00000115350.7,74958643,2-74956130-G-A,rs2129604,1,G,A,74956130,2513,74762035,75155251,194095
2,ENSG00000084754.6,26244632,2-26189025-C-G,rs2241739,-1,C,G,26189025,55607,26048024,26441240,141001
2,ENSG00000084754.6,26244632,2-26189025-C-T,rs2241739,-1,C,T,26189025,55607,26048024,26441240,141001
2,ENSG00000084754.6,26244632,2-26189025-C-A,rs2241739,-1,C,A,26189025,55607,26048024,26441240,141001
2,ENSG00000144488.10,238100340,2-238083155-C-T,rs2278742,1,C,T,238083155,17185,237903732,238296948,179423
2,ENSG00000196151.6,159286703,2-159227962-A-C,rs2288110,-1,A,C,159227962,58741,159090095,159483311,137867
2,ENSG00000115850.4,135837184,2-135666334-C-G,rs2289959,-1,C,G,135666334,170850,135640576,136033792,25758
2,ENSG00000115850.4,135837184,2-135666334-C-T,rs2289959,-1,C,T,135666334,170850,135640576,136033792,25758
2,ENSG00000198925.6,219229636,2-219146370-A-C,rs2293081,-1,A,C,219146370,83266,219033028,219426244,113342
2,ENSG00000115750.10,9843474,2-9843557-G-A,rs2303914,1,G,A,9843557,83,9646866,10040082,196691
2,ENSG00000115750.10,9843474,2-9843557-G-T,rs2303914,1,G,T,9843557,83,9646866,10040082,196691
2,ENSG00000115750.10,9843474,2-9843557-G-C,rs2303914,1,G,C,9843557,83,9646866,10040082,196691
2,ENSG00000162882.10,42792583,2-42704077-A-C,rs2304658,-1,A,C,42704077,88506,42595975,42989191,108102
2,ENSG00000162882.10,42792583,2-42704077-A-T,rs2304658,-1,A,T,42704077,88506,42595975,42989191,108102
2,ENSG00000114988.7,96740064,2-96747751-C-A,rs2314398,-1,C,A,96747751,7687,96543456,96936672,204295
2,ENSG00000114988.7,96740064,2-96747751-C-G,rs2314398,-1,C,G,96747751,7687,96543456,96936672,204295
2,ENSG00000115963.9,150487667,2-150435090-A-C,rs2334310,-1,A,C,150435090,52577,150291059,150684275,144031
2,ENSG00000163541.7,84459280,2-84312797-G-T,rs2364922,-1,G,T,84312797,146483,84262672,84655888,50125
2,ENSG00000163541.7,84459280,2-84312797-G-A,rs2364922,-1,G,A,84312797,146483,84262672,84655888,50125
2,ENSG00000152291.9,85327989,2-85324656-G-A,rs2366404,-1,G,A,85324656,3333,85131381,85524597,193275
2,ENSG00000138071.8,65227831,2-65293958-G-C,rs2422474,1,G,C,65293958,66127,65031223,65424439,262735
2,ENSG00000138071.8,65227831,2-65293958-G-A,rs2422474,1,G,A,65293958,66127,65031223,65424439,262735
2,ENSG00000119862.7,64454162,2-64294232-C-T,rs2433390,1,C,T,64294232,159930,64257554,64650770,36678
2,ENSG00000119862.7,64454162,2-64294232-C-G,rs2433390,1,C,G,64294232,159930,64257554,64650770,36678
2,ENSG00000144401.9,207625378,2-207633241-T-A,rs2464975,-1,T,A,207633241,7863,207428770,207821986,204471
2,ENSG00000144401.9,207625378,2-207633241-T-C,rs2464975,-1,T,C,207633241,7863,207428770,207821986,204471
2,ENSG00000144401.9,207625378,2-207633241-T-G,rs2464975,-1,T,G,207633241,7863,207428770,207821986,204471
2,ENSG00000152133.9,37084518,2-37063516-A-G,rs2541009,1,A,G,37063516,21002,36887910,37281126,175606
2,ENSG00000135974.5,105337540,2-105343876-C-A,rs2576767,1,C,A,105343876,6336,105140932,105534148,202944
2,ENSG00000135974.5,105337540,2-105343876-C-T,rs2576767,1,C,T,105343876,6336,105140932,105534148,202944
2,ENSG00000138085.11,27212041,2-27209632-T-G,rs2580759,1,T,G,27209632,2409,27015433,27408649,194199
2,ENSG00000115310.13,55050451,2-54991669-G-C,rs2580772,-1,G,C,54991669,58782,54853843,55247059,137826
2,ENSG00000115310.13,55050451,2-54991669-G-T,rs2580772,-1,G,T,54991669,58782,54853843,55247059,137826
2,ENSG00000115183.9,158968640,2-159022837-C-T,rs264577,1,C,T,159022837,54197,158772032,159165248,250805
2,ENSG00000123600.13,171433990,2-171564609-C-T,rs2674489,-1,C,T,171564609,130619,171237382,171630598,327227
2,ENSG00000163002.8,183124443,2-183113821-A-G,rs2675058,1,A,G,183113821,10622,182927835,183321051,185986
2,ENSG00000154518.5,175181710,2-175203668-A-G,rs268174,-1,A,G,175203668,21958,174985102,175378318,218566
2,ENSG00000136536.9,159712506,2-159811597-A-G,rs2729726,1,A,G,159811597,99091,159515898,159909114,295699
2,ENSG00000136536.9,159712506,2-159811597-A-T,rs2729726,1,A,T,159811597,99091,159515898,159909114,295699
2,ENSG00000136536.9,159712506,2-159811597-A-C,rs2729726,1,A,C,159811597,99091,159515898,159909114,295699
2,ENSG00000116016.9,46297407,2-46204246-C-G,rs281512,1,C,G,46204246,93161,46100799,46494015,103447
2,ENSG00000116016.9,46297407,2-46204246-C-T,rs281512,1,C,T,46204246,93161,46100799,46494015,103447
2,ENSG00000204120.9,232697331,2-232793599-C-T,rs283468,1,C,T,232793599,96268,232500723,232893939,292876
2,ENSG00000115170.9,157876330,2-157840017-G-T,rs2883605,-1,G,T,157840017,36313,157679722,158072938,160295
2,ENSG00000115306.10,54456327,2-54641346-C-T,rs2941583,1,C,T,54641346,185019,54259719,54652935,381627
2,ENSG00000135916.11,230864942,2-230912836-G-C,rs2969126,1,G,C,230912836,47894,230668334,231061550,244502
2,ENSG00000135916.11,230864942,2-230912836-G-T,rs2969126,1,G,T,230912836,47894,230668334,231061550,244502
2,ENSG00000135916.11,230864942,2-230912836-G-A,rs2969126,1,G,A,230912836,47894,230668334,231061550,244502
2,ENSG00000115307.11,74529706,2-74640403-C-A,rs3025981,-1,C,A,74640403,110697,74333098,74726314,307305
2,ENSG00000115307.11,74529706,2-74640403-C-T,rs3025981,-1,C,T,74640403,110697,74333098,74726314,307305
2,ENSG00000115325.9,74554720,2-74640403-C-A,rs3025981,1,C,A,74640403,85683,74358112,74751328,282291
2,ENSG00000115325.9,74554720,2-74640403-C-T,rs3025981,1,C,T,74640403,85683,74358112,74751328,282291
2,ENSG00000162989.3,154698695,2-154698578-G-A,rs3111034,1,G,A,154698578,117,154502087,154895303,196491
2,ENSG00000144026.6,95159848,2-95156702-A-G,rs3112998,-1,A,G,95156702,3146,94963240,95356456,193462
2,ENSG00000173166.12,203535301,2-203705416-G-A,rs3181097,-1,G,A,203705416,170115,203338693,203731909,366723
2,ENSG00000173166.12,203535301,2-203705416-G-T,rs3181097,-1,G,T,203705416,170115,203338693,203731909,366723
2,ENSG00000162929.9,61065871,2-61145372-A-T,rs34279970,1,A,T,61145372,79501,60869263,61262479,276109
2,ENSG00000162929.9,61065871,2-61145372-A-G,rs34279970,1,A,G,61145372,79501,60869263,61262479,276109
2,ENSG00000115363.9,75560939,2-75551764-G-A,rs34644221,-1,G,A,75551764,9175,75364331,75757547,187433
2,ENSG00000115363.9,75560939,2-75551764-G-C,rs34644221,-1,G,C,75551764,9175,75364331,75757547,187433
2,ENSG00000143797.7,9003684,2-9099506-C-T,rs35132160,-1,C,T,9099506,95822,8807076,9200292,292430
2,ENSG00000118260.8,207529962,2-207498953-G-A,rs35224925,1,G,A,207498953,31009,207333354,207726570,165599
2,ENSG00000115267.4,162318684,2-162142431-G-A,rs35328019,-1,G,A,162142431,176253,162122076,162515292,20355
2,ENSG00000115919.9,142877664,2-143072817-A-G,rs354692,1,A,G,143072817,195153,142681056,143074272,391761
2,ENSG00000142330.15,240586734,2-240761259-G-A,rs35945835,1,G,A,240761259,174525,240390126,240783342,371133
2,ENSG00000115318.7,74553942,2-74683576-G-A,rs363645,-1,G,A,74683576,129634,74357334,74750550,326242
2,ENSG00000115318.7,74553942,2-74683576-G-T,rs363645,-1,G,T,74683576,129634,74357334,74750550,326242
2,ENSG00000114993.11,74441937,2-74624241-G-A,rs363699,-1,G,A,74624241,182304,74245329,74638545,378912
2,ENSG00000114993.11,74441937,2-74624241-G-C,rs363699,-1,G,C,74624241,182304,74245329,74638545,378912
2,ENSG00000075292.11,71331782,2-71176051-G-T,rs370068,1,G,T,71176051,155731,71135174,71528390,40877
2,ENSG00000075292.11,71331782,2-71176051-G-A,rs370068,1,G,A,71176051,155731,71135174,71528390,40877
2,ENSG00000075292.11,71331782,2-71176051-G-C,rs370068,1,G,C,71176051,155731,71135174,71528390,40877
2,ENSG00000163596.12,202871766,2-202955552-T-C,rs3731695,-1,T,C,202955552,83786,202675158,203068374,280394
2,ENSG00000204186.3,206274663,2-206309592-T-C,rs3732084,1,T,C,206309592,34929,206078055,206471271,231537
2,ENSG00000187231.8,179264832,2-179399974-T-C,rs3749124,-1,T,C,179399974,135142,179068224,179461440,331750
2,ENSG00000091436.12,173075846,2-173100568-G-A,rs3754747,1,G,A,173100568,24722,172879238,173272454,221330
2,ENSG00000115756.8,10302904,2-10413751-A-T,rs3755262,1,A,T,10413751,110847,10106296,10499512,307455
2,ENSG00000115756.8,10302904,2-10413751-A-G,rs3755262,1,A,G,10413751,110847,10106296,10499512,307455
2,ENSG00000115282.14,74483081,2-74513834-C-T,rs3755448,1,C,T,74513834,30753,74286473,74679689,227361
2,ENSG00000115282.14,74483081,2-74513834-C-G,rs3755448,1,C,G,74513834,30753,74286473,74679689,227361
2,ENSG00000163449.6,216081919,2-216115437-G-C,rs3770521,1,G,C,216115437,33518,215885311,216278527,230126
2,ENSG00000163449.6,216081919,2-216115437-G-A,rs3770521,1,G,A,216115437,33518,215885311,216278527,230126
2,ENSG00000115677.12,241315672,2-241264871-T-C,rs3771343,-1,T,C,241264871,50801,241119064,241512280,145807
2,ENSG00000115677.12,241315672,2-241264871-T-A,rs3771343,-1,T,A,241264871,50801,241119064,241512280,145807
2,ENSG00000176946.6,241637158,2-241461587-T-C,rs3771586,-1,T,C,241461587,175571,241440550,241833766,21037
2,ENSG00000176946.6,241637158,2-241461587-T-G,rs3771586,-1,T,G,241461587,175571,241440550,241833766,21037
2,ENSG00000144283.15,158456952,2-158558467-A-G,rs3771604,1,A,G,158558467,101515,158260344,158653560,298123
2,ENSG00000144283.15,158456952,2-158558467-A-C,rs3771604,1,A,C,158558467,101515,158260344,158653560,298123
2,ENSG00000144283.15,158456952,2-158558467-A-T,rs3771604,1,A,T,158558467,101515,158260344,158653560,298123
2,ENSG00000123609.6,151289668,2-151282235-A-T,rs3771887,-1,A,T,151282235,7433,151093060,151486276,189175
2,ENSG00000123609.6,151289668,2-151282235-A-G,rs3771887,-1,A,G,151282235,7433,151093060,151486276,189175
2,ENSG00000128708.8,171922461,2-171978695-T-A,rs3791342,1,T,A,171978695,56234,171725853,172119069,252842
2,ENSG00000128708.8,171922461,2-171978695-T-G,rs3791342,1,T,G,171978695,56234,171725853,172119069,252842
2,ENSG00000179921.10,218261015,2-218400673-C-T,rs3795985,1,C,T,218400673,139658,218064407,218457623,336266
2,ENSG00000138400.8,206765328,2-206768278-A-T,rs3815686,-1,A,T,206768278,2950,206568720,206961936,199558
2,ENSG00000138400.8,206765328,2-206768278-A-G,rs3815686,-1,A,G,206768278,2950,206568720,206961936,199558
2,ENSG00000144354.9,173354872,2-173238700-C-T,rs3820831,1,C,T,173238700,116172,173158264,173551480,80436
2,ENSG00000144354.9,173354872,2-173238700-C-A,rs3820831,1,C,A,173238700,116172,173158264,173551480,80436
2,ENSG00000163162.4,101308701,2-101294923-A-G,rs3828194,-1,A,G,101294923,13778,101112093,101505309,182830
2,ENSG00000163249.5,207711640,2-207659476-A-T,rs3845812,1,A,T,207659476,52164,207515032,207908248,144444
2,ENSG00000163249.5,207711640,2-207659476-A-G,rs3845812,1,A,G,207659476,52164,207515032,207908248,144444
2,ENSG00000163251.3,207769906,2-207659476-A-T,rs3845812,-1,A,T,207659476,110430,207573298,207966514,86178
2,ENSG00000163251.3,207769906,2-207659476-A-G,rs3845812,-1,A,G,207659476,110430,207573298,207966514,86178
2,ENSG00000091106.14,32264886,2-32264782-T-C,rs385076,-1,T,C,32264782,104,32068278,32461494,196504
2,ENSG00000091106.14,32264886,2-32264782-T-A,rs385076,-1,T,A,32264782,104,32068278,32461494,196504
2,ENSG00000228486.2,97669713,2-97608974-A-G,rs3906948,1,A,G,97608974,60739,97473105,97866321,135869
2,ENSG00000115604.6,102355796,2-102165169-G-A,rs3917286,1,G,A,102165169,190627,102159188,102552404,5981
2,ENSG00000042445.9,85354528,2-85335049-C-T,rs3923229,-1,C,T,85335049,19479,85157920,85551136,177129
2,ENSG00000042445.9,85354528,2-85335049-C-A,rs3923229,-1,C,A,85335049,19479,85157920,85551136,177129
2,ENSG00000042445.9,85354528,2-85335049-C-G,rs3923229,-1,C,G,85335049,19479,85157920,85551136,177129
2,ENSG00000134317.13,9951693,2-9962606-T-G,rs41264179,1,T,G,9962606,10913,9755085,10148301,207521
2,ENSG00000134317.13,9951693,2-9962606-T-C,rs41264179,1,T,C,9962606,10913,9755085,10148301,207521
2,ENSG00000124019.9,224402107,2-224313411-C-T,rs41443452,-1,C,T,224313411,88696,224205499,224598715,107912
2,ENSG00000163803.8,28496060,2-28515626-T-C,rs4233726,1,T,C,28515626,19566,28299452,28692668,216174
2,ENSG00000163803.8,28496060,2-28515626-T-A,rs4233726,1,T,A,28515626,19566,28299452,28692668,216174
2,ENSG00000172554.7,950849,2-908708-T-C,rs4241338,1,T,C,908708,42141,754241,1147457,154467
2,ENSG00000172554.7,950849,2-908708-T-G,rs4241338,1,T,G,908708,42141,754241,1147457,154467
2,ENSG00000172554.7,950849,2-908708-T-A,rs4241338,1,T,A,908708,42141,754241,1147457,154467
2,ENSG00000185304.11,87825796,2-88007164-T-C,rs4246597,-1,T,C,88007164,181368,87629188,88022404,377976
2,ENSG00000185304.11,87825796,2-88007164-T-A,rs4246597,-1,T,A,88007164,181368,87629188,88022404,377976
2,ENSG00000170264.8,61854060,2-61853877-A-T,rs4270331,-1,A,T,61853877,183,61657452,62050668,196425
2,ENSG00000170264.8,61854060,2-61853877-A-C,rs4270331,-1,A,C,61853877,183,61657452,62050668,196425
2,ENSG00000163806.11,28810834,2-28877776-A-T,rs4358081,1,A,T,28877776,66942,28614226,29007442,263550
2,ENSG00000163806.11,28810834,2-28877776-A-G,rs4358081,1,A,G,28877776,66942,28614226,29007442,263550
2,ENSG00000163806.11,28810834,2-28877776-A-C,rs4358081,1,A,C,28877776,66942,28614226,29007442,263550
2,ENSG00000119041.6,196799683,2-196764190-G-A,rs4380257,-1,G,A,196764190,35493,196603075,196996291,161115
2,ENSG00000151665.8,46617041,2-46562375-A-G,rs4384837,-1,A,G,46562375,54666,46420433,46813649,141942
2,ENSG00000130294.9,240820219,2-240741216-G-A,rs4414678,-1,G,A,240741216,79003,240623611,241016827,117605
2,ENSG00000130294.9,240820219,2-240741216-G-C,rs4414678,-1,G,C,240741216,79003,240623611,241016827,117605
2,ENSG00000130294.9,240820219,2-240741216-G-T,rs4414678,-1,G,T,240741216,79003,240623611,241016827,117605
2,ENSG00000198380.7,69387227,2-69340209-C-T,rs4428054,-1,C,T,69340209,47018,69190619,69583835,149590
2,ENSG00000198380.7,69387227,2-69340209-C-G,rs4428054,-1,C,G,69340209,47018,69190619,69583835,149590
2,ENSG00000003402.12,201116164,2-201157024-T-C,rs4482462,1,T,C,201157024,40860,200919556,201312772,237468
2,ENSG00000138380.11,202912275,2-202870143-C-A,rs4510208,1,C,A,202870143,42132,202715667,203108883,154476
2,ENSG00000071051.9,105744912,2-105844358-G-C,rs4627591,1,G,C,105844358,99446,105548304,105941520,296054
2,ENSG00000071051.9,105744912,2-105844358-G-T,rs4627591,1,G,T,105844358,99446,105548304,105941520,296054
2,ENSG00000115884.6,20225130,2-20185472-G-A,rs4632301,-1,G,A,20185472,39658,20028522,20421738,156950
2,ENSG00000115884.6,20225130,2-20185472-G-T,rs4632301,-1,G,T,20185472,39658,20028522,20421738,156950
2,ENSG00000136731.8,128091200,2-127998259-C-T,rs4662765,1,C,T,127998259,92941,127894592,128287808,103667
2,ENSG00000136731.8,128091200,2-127998259-C-A,rs4662765,1,C,A,127998259,92941,127894592,128287808,103667
2,ENSG00000153250.13,160493807,2-160432064-T-A,rs4664326,-1,T,A,160432064,61743,160297199,160690415,134865
2,ENSG00000153250.13,160493807,2-160432064-T-C,rs4664326,-1,T,C,160432064,61743,160297199,160690415,134865
2,ENSG00000123610.3,151357592,2-151336845-A-C,rs4664349,1,A,C,151336845,20747,151160984,151554200,175861
2,ENSG00000136560.8,161160428,2-161044790-T-G,rs4664395,1,T,G,161044790,115638,160963820,161357036,80970
2,ENSG00000136560.8,161160428,2-161044790-T-A,rs4664395,1,T,A,161044790,115638,160963820,161357036,80970
2,ENSG00000136560.8,161160428,2-161044790-T-C,rs4664395,1,T,C,161044790,115638,160963820,161357036,80970
2,ENSG00000163811.7,28894667,2-28941156-G-A,rs4666141,1,G,A,28941156,46489,28698059,29091275,243097
2,ENSG00000163811.7,28894667,2-28941156-G-C,rs4666141,1,G,C,28941156,46489,28698059,29091275,243097
2,ENSG00000163811.7,28894667,2-28941156-G-T,rs4666141,1,G,T,28941156,46489,28698059,29091275,243097
2,ENSG00000205795.4,10080411,2-10093628-G-A,rs4669527,-1,G,A,10093628,13217,9883803,10277019,209825
2,ENSG00000205795.4,10080411,2-10093628-G-C,rs4669527,-1,G,C,10093628,13217,9883803,10277019,209825
2,ENSG00000205795.4,10080411,2-10093628-G-T,rs4669527,-1,G,T,10093628,13217,9883803,10277019,209825
2,ENSG00000011523.8,65056416,2-64917523-C-A,rs4671629,1,C,A,64917523,138893,64859808,65253024,57715
2,ENSG00000011523.8,65056416,2-64917523-C-T,rs4671629,1,C,T,64917523,138893,64859808,65253024,57715
2,ENSG00000011523.8,65056416,2-64917523-C-G,rs4671629,1,C,G,64917523,138893,64859808,65253024,57715
2,ENSG00000115902.5,64989399,2-64917653-G-A,rs4671631,1,G,A,64917653,71746,64792791,65186007,124862
2,ENSG00000115902.5,64989399,2-64917653-G-C,rs4671631,1,G,C,64917653,71746,64792791,65186007,124862
2,ENSG00000068878.10,53970993,2-54126207-G-A,rs4671869,-1,G,A,54126207,155214,53774385,54167601,351822
2,ENSG00000135926.6,218292503,2-218296518-C-T,rs4674284,-1,C,T,218296518,4015,218095895,218489111,200623
2,ENSG00000003393.10,201780933,2-201768215-T-C,rs4675226,-1,T,C,201768215,12718,201584325,201977541,183890
2,ENSG00000163600.8,203936763,2-203977745-A-C,rs4675391,1,A,C,203977745,40982,203740155,204133371,237590
2,ENSG00000142327.6,240568484,2-240621671-G-C,rs4676411,1,G,C,240621671,53187,240371876,240765092,249795
2,ENSG00000142327.6,240568484,2-240621671-G-A,rs4676411,1,G,A,240621671,53187,240371876,240765092,249795
2,ENSG00000142327.6,240568484,2-240621671-G-T,rs4676411,1,G,T,240621671,53187,240371876,240765092,249795
2,ENSG00000119185.8,9423528,2-9406676-C-T,rs4798,-1,C,T,9406676,16852,9226920,9620136,179756
2,ENSG00000115561.10,86563443,2-86751772-G-T,rs4832311,-1,G,T,86751772,188329,86366835,86760051,384937
2,ENSG00000115561.10,86563443,2-86751772-G-C,rs4832311,-1,G,C,86751772,188329,86366835,86760051,384937
2,ENSG00000115107.14,119223834,2-119293439-A-T,rs4848546,1,A,T,119293439,69605,119027226,119420442,266213
2,ENSG00000115107.14,119223834,2-119293439-A-G,rs4848546,1,A,G,119293439,69605,119027226,119420442,266213
2,ENSG00000115109.9,120013077,2-120133111-A-C,rs4848573,1,A,C,120133111,120034,119816469,120209685,316642
2,ENSG00000115109.9,120013077,2-120133111-A-G,rs4848573,1,A,G,120133111,120034,119816469,120209685,316642
2,ENSG00000136689.14,113127598,2-113090997-G-A,rs4849152,1,G,A,113090997,36601,112930990,113324206,160007
2,ENSG00000088205.7,117814691,2-117864651-A-C,rs4849631,1,A,C,117864651,49960,117618083,118011299,246568
2,ENSG00000088205.7,117814691,2-117864651-A-G,rs4849631,1,A,G,117864651,49960,117618083,118011299,246568
2,ENSG00000088205.7,117814691,2-117864651-A-T,rs4849631,1,A,T,117864651,49960,117618083,118011299,246568
2,ENSG00000115539.9,100562993,2-100543299-G-A,rs4851329,1,G,A,100543299,19694,100366385,100759601,176914
2,ENSG00000144034.10,73737345,2-73700804-A-G,rs4852974,-1,A,G,73700804,36541,73540737,73933953,160067
2,ENSG00000144034.10,73737345,2-73700804-A-C,rs4852974,-1,A,C,73700804,36541,73540737,73933953,160067
2,ENSG00000144034.10,73737345,2-73700804-A-T,rs4852974,-1,A,T,73700804,36541,73540737,73933953,160067
2,ENSG00000151689.8,190343589,2-190354547-A-G,rs4853694,1,A,G,190354547,10958,190146981,190540197,207566
2,ENSG00000151689.8,190343589,2-190354547-A-T,rs4853694,1,A,T,190354547,10958,190146981,190540197,207566
2,ENSG00000163219.6,68734811,2-68790692-T-C,rs4854516,1,T,C,68790692,55881,68538203,68931419,252489
2,ENSG00000168763.10,96816268,2-96883931-A-G,rs4907254,1,A,G,96883931,67663,96619660,97012876,264271
2,ENSG00000163072.10,168802637,2-168881876-A-C,rs494859,1,A,C,168881876,79239,168606029,168999245,275847
2,ENSG00000068781.14,48580607,2-48513056-A-G,rs4953589,1,A,G,48513056,67551,48383999,48777215,129057
2,ENSG00000152253.4,168890430,2-168881402-A-C,rs525428,-1,A,C,168881402,9028,168693822,169087038,187580
2,ENSG00000152253.4,168890430,2-168881402-A-T,rs525428,-1,A,T,168881402,9028,168693822,169087038,187580
2,ENSG00000152253.4,168890430,2-168881402-A-G,rs525428,-1,A,G,168881402,9028,168693822,169087038,187580
2,ENSG00000184898.6,151261863,2-151261757-G-A,rs55775354,-1,G,A,151261757,106,151065255,151458471,196502
2,ENSG00000169599.8,69437435,2-69464470-C-A,rs55902961,-1,C,A,69464470,27035,69240827,69634043,223643
2,ENSG00000180228.8,178451175,2-178530340-C-G,rs56207956,-1,C,G,178530340,79165,178254567,178647783,275773
2,ENSG00000124374.8,71227103,2-71202595-T-C,rs56871884,-1,T,C,71202595,24508,71030495,71423711,172100
2,ENSG00000128699.9,189784339,2-189832198-A-G,rs5743072,-1,A,G,189832198,47859,189587731,189980947,244467
2,ENSG00000136709.7,127811171,2-127790874-T-C,rs57992231,-1,T,C,127790874,20297,127614563,128007779,176311
2,ENSG00000168280.12,148875227,2-149044480-C-T,rs59021681,1,C,T,149044480,169253,148678619,149071835,365861
2,ENSG00000115339.9,165794247,2-165719832-C-T,rs59775523,-1,C,T,165719832,74415,165597639,165990855,122193
2,ENSG00000175701.6,110212547,2-110215689-T-A,rs61730258,-1,T,A,110215689,3142,110015939,110409155,199750
2,ENSG00000144580.9,218568839,2-218737817-G-T,rs61733652,1,G,T,218737817,168978,218372231,218765447,365586
2,ENSG00000068784.8,45611267,2-45433364-A-T,rs62127105,-1,A,T,45433364,177903,45414659,45807875,18705
2,ENSG00000138018.13,26346143,2-26269499-C-T,rs62130490,1,C,T,26269499,76644,26149535,26542751,119964
2,ENSG00000153563.10,86790913,2-86747566-A-G,rs62148507,-1,A,G,86747566,43347,86594305,86987521,153261
2,ENSG00000125538.7,112836779,2-112801723-G-C,rs62157430,-1,G,C,112801723,35056,112640171,113033387,161552
2,ENSG00000125538.7,112836779,2-112801723-G-A,rs62157430,-1,G,A,112801723,35056,112640171,113033387,161552
2,ENSG00000144161.7,112255042,2-112061027-C-T,rs62157786,-1,C,T,112061027,194015,112058434,112451650,2593
2,ENSG00000163466.11,218217189,2-218358010-G-A,rs62182089,1,G,A,218358010,140821,218020581,218413797,337429
2,ENSG00000085982.8,233566782,2-233566769-G-A,rs62192778,-1,G,A,233566769,13,233370174,233763390,196595
2,ENSG00000136682.9,113437691,2-113371307-A-G,rs6542129,1,A,G,113371307,66384,113241083,113634299,130224
2,ENSG00000136682.9,113437691,2-113371307-A-T,rs6542129,1,A,T,113371307,66384,113241083,113634299,130224
2,ENSG00000163001.7,55519718,2-55588861-T-C,rs6545508,1,T,C,55588861,69143,55323110,55716326,265751
2,ENSG00000163001.7,55519718,2-55588861-T-A,rs6545508,1,T,A,55588861,69143,55323110,55716326,265751
2,ENSG00000119866.15,60553654,2-60396660-A-C,rs6545811,-1,A,C,60396660,156994,60357046,60750262,39614
2,ENSG00000119866.15,60553654,2-60396660-A-G,rs6545811,-1,A,G,60396660,156994,60357046,60750262,39614
2,ENSG00000138029.9,26244939,2-26359830-G-T,rs6546936,1,G,T,26359830,114891,26048331,26441547,311499
2,ENSG00000123485.5,233854535,2-233859357-T-C,rs657658,-1,T,C,233859357,4822,233657927,234051143,201430
2,ENSG00000123485.5,233854535,2-233859357-T-A,rs657658,-1,T,A,233859357,4822,233657927,234051143,201430
2,ENSG00000168894.5,85595745,2-85597128-T-C,rs6643,1,T,C,85597128,1383,85399137,85792353,197991
2,ENSG00000168894.5,85595745,2-85597128-T-A,rs6643,1,T,A,85597128,1383,85399137,85792353,197991
2,ENSG00000198142.3,109614364,2-109621489-G-A,rs6705503,1,G,A,109621489,7125,109417756,109810972,203733
2,ENSG00000135912.6,218710835,2-218636156-T-C,rs6710896,1,T,C,218636156,74679,218514227,218907443,121929
2,ENSG00000072135.7,130356056,2-130363576-A-G,rs6713511,1,A,G,130363576,7520,130159448,130552664,204128
2,ENSG00000072135.7,130356056,2-130363576-A-T,rs6713511,1,A,T,130363576,7520,130159448,130552664,204128
2,ENSG00000184731.5,46505,2-81986-G-A,rs6714203,-1,G,A,81986,35481,-150103,243113,232089
2,ENSG00000115216.8,27428631,2-27360406-A-T,rs6716894,1,A,T,27360406,68225,27232023,27625239,128383
2,ENSG00000115216.8,27428631,2-27360406-A-G,rs6716894,1,A,G,27360406,68225,27232023,27625239,128383
2,ENSG00000079785.8,15591868,2-15603594-A-G,rs6717251,1,A,G,15603594,11726,15395260,15788476,208334
2,ENSG00000079785.8,15591868,2-15603594-A-T,rs6717251,1,A,T,15603594,11726,15395260,15788476,208334
2,ENSG00000079785.8,15591868,2-15603594-A-C,rs6717251,1,A,C,15603594,11726,15395260,15788476,208334
2,ENSG00000116062.7,47783145,2-47618384-C-T,rs6723080,1,C,T,47618384,164761,47586537,47979753,31847
2,ENSG00000127824.9,219253918,2-219079124-G-A,rs6724465,-1,G,A,219079124,174794,219057310,219450526,21814
2,ENSG00000186453.8,24175053,2-24344421-C-T,rs6729160,1,C,T,24344421,169368,23978445,24371661,365976
2,ENSG00000173349.4,127701497,2-127762973-G-C,rs6731093,1,G,C,127762973,61476,127504889,127898105,258084
2,ENSG00000173349.4,127701497,2-127762973-G-A,rs6731093,1,G,A,127762973,61476,127504889,127898105,258084
2,ENSG00000221823.5,68252532,2-68275912-G-A,rs6731373,-1,G,A,68275912,23380,68055924,68449140,219988
2,ENSG00000130414.6,240025342,2-240015555-C-A,rs6735806,-1,C,A,240015555,9787,239828734,240221950,186821
2,ENSG00000197557.4,177618742,2-177615586-T-C,rs6736390,-1,T,C,177615586,3156,177422134,177815350,193452
2,ENSG00000197557.4,177618742,2-177615586-T-A,rs6736390,-1,T,A,177615586,3156,177422134,177815350,193452
2,ENSG00000138031.8,24920237,2-24915171-A-C,rs6737082,-1,A,C,24915171,5066,24723629,25116845,191542
2,ENSG00000081320.5,196171578,2-196233914-C-T,rs6740409,-1,C,T,196233914,62336,195974970,196368186,258944
2,ENSG00000042493.10,85410366,2-85375941-G-A,rs6741368,-1,G,A,85375941,34425,85213758,85606974,162183
2,ENSG00000042493.10,85410366,2-85375941-G-C,rs6741368,-1,G,C,85375941,34425,85213758,85606974,162183
2,ENSG00000132329.6,237859623,2-237890564-C-G,rs6741923,1,C,G,237890564,30941,237663015,238056231,227549
2,ENSG00000132329.6,237859623,2-237890564-C-T,rs6741923,1,C,T,237890564,30941,237663015,238056231,227549
2,ENSG00000115138.6,25168580,2-25143380-C-G,rs6742181,-1,C,G,25143380,25200,24971972,25365188,171408
2,ENSG00000115138.6,25168580,2-25143380-C-T,rs6742181,-1,C,T,25143380,25200,24971972,25365188,171408
2,ENSG00000168906.7,85539168,2-85594081-A-C,rs6742887,1,A,C,85594081,54913,85342560,85735776,251521
2,ENSG00000168906.7,85539168,2-85594081-A-G,rs6742887,1,A,G,85594081,54913,85342560,85735776,251521
2,ENSG00000143971.7,67397333,2-67263506-C-A,rs6745786,1,C,A,67263506,133827,67200725,67593941,62781
2,ENSG00000143971.7,67397333,2-67263506-C-T,rs6745786,1,C,T,67263506,133827,67200725,67593941,62781
2,ENSG00000135624.10,73234308,2-73306492-G-A,rs6745973,1,G,A,73306492,72184,73037700,73430916,268792
2,ENSG00000135624.10,73234308,2-73306492-G-T,rs6745973,1,G,T,73306492,72184,73037700,73430916,268792
2,ENSG00000154252.11,241776822,2-241768747-C-T,rs6746151,1,C,T,241768747,8075,241580214,241973430,188533
2,ENSG00000157992.8,27442381,2-27464044-T-C,rs6747190,1,T,C,27464044,21663,27245773,27638989,218271
2,ENSG00000132305.15,86195462,2-86172969-G-T,rs6749439,-1,G,T,86172969,22493,85998854,86392070,174115
2,ENSG00000132305.15,86195462,2-86172969-G-A,rs6749439,-1,G,A,86172969,22493,85998854,86392070,174115
2,ENSG00000115825.5,37324833,2-37302604-T-C,rs6749793,-1,T,C,37302604,22229,37128225,37521441,174379
2,ENSG00000091428.11,172735845,2-172560527-A-G,rs6752257,1,A,G,172560527,175318,172539237,172932453,21290
2,ENSG00000144231.5,127858155,2-127830399-C-G,rs67525852,-1,C,G,127830399,27756,127661547,128054763,168852
2,ENSG00000144231.5,127858155,2-127830399-C-A,rs67525852,-1,C,A,127830399,27756,127661547,128054763,168852
2,ENSG00000152154.5,39665917,2-39525017-C-T,rs6753798,1,C,T,39525017,140900,39469309,39862525,55708
2,ENSG00000152154.5,39665917,2-39525017-C-G,rs6753798,1,C,G,39525017,140900,39469309,39862525,55708
2,ENSG00000169967.12,127387975,2-127437668-G-A,rs6754772,-1,G,A,127437668,49693,127191367,127584583,246301
2,ENSG00000169967.12,127387975,2-127437668-G-T,rs6754772,-1,G,T,127437668,49693,127191367,127584583,246301
2,ENSG00000138095.13,43995989,2-43908858-C-A,rs6756365,-1,C,A,43908858,87131,43799381,44192597,109477
2,ENSG00000138095.13,43995989,2-43908858-C-T,rs6756365,-1,C,T,43908858,87131,43799381,44192597,109477
2,ENSG00000138095.13,43995989,2-43908858-C-G,rs6756365,-1,C,G,43908858,87131,43799381,44192597,109477
2,ENSG00000138413.9,208255071,2-208088086-C-T,rs6758890,-1,C,T,208088086,166985,208058463,208451679,29623
2,ENSG00000138413.9,208255071,2-208088086-C-G,rs6758890,-1,C,G,208088086,166985,208058463,208451679,29623
2,ENSG00000226124.2,199851192,2-199756040-T-A,rs6759018,-1,T,A,199756040,95152,199654584,200047800,101456
2,ENSG00000226124.2,199851192,2-199756040-T-C,rs6759018,-1,T,C,199756040,95152,199654584,200047800,101456
2,ENSG00000115241.8,27409591,2-27356364-T-C,rs6760828,-1,T,C,27356364,53227,27212983,27606199,143381
2,ENSG00000125637.10,113173971,2-113184697-C-A,rs6761202,1,C,A,113184697,10726,112977363,113370579,207334
2,ENSG00000125637.10,113173971,2-113184697-C-G,rs6761202,1,C,G,113184697,10726,112977363,113370579,207334
2,ENSG00000180902.11,241734630,2-241759875-C-T,rs71430382,1,C,T,241759875,25245,241538022,241931238,221853
2,ENSG00000134313.9,8837613,2-8878281-T-G,rs72771515,-1,T,G,8878281,40668,8641005,9034221,237276
2,ENSG00000176732.6,24123334,2-24092815-A-C,rs72783627,-1,A,C,24092815,30519,23926726,24319942,166089
2,ENSG00000176732.6,24123334,2-24092815-A-T,rs72783627,-1,A,T,24092815,30519,23926726,24319942,166089
2,ENSG00000163026.7,24047391,2-24092815-A-C,rs72783627,-1,A,C,24092815,45424,23850783,24243999,242032
2,ENSG00000163026.7,24047391,2-24092815-A-T,rs72783627,-1,A,T,24092815,45424,23850783,24243999,242032
2,ENSG00000144043.7,70994873,2-70984287-C-G,rs72832792,-1,C,G,70984287,10586,70798265,71191481,186022
2,ENSG00000163006.6,108786771,2-108857894-T-C,rs72836521,1,T,C,108857894,71123,108590163,108983379,267731
2,ENSG00000116005.7,70258137,2-70187609-T-C,rs72841131,1,T,C,70187609,70528,70061529,70454745,126080
2,ENSG00000197223.7,68063004,2-68059504-C-A,rs72906862,-1,C,A,68059504,3500,67866396,68259612,193108
2,ENSG00000197223.7,68063004,2-68059504-C-G,rs72906862,-1,C,G,68059504,3500,67866396,68259612,193108
2,ENSG00000173559.7,191678136,2-191670816-T-G,rs73063325,1,T,G,191670816,7320,191481528,191874744,189288
2,ENSG00000198612.6,237085889,2-237114333-G-A,rs73085508,1,G,A,237114333,28444,236889281,237282497,225052
2,ENSG00000204099.6,241809193,2-241813206-G-A,rs73108258,1,G,A,241813206,4013,241612585,242005801,200621
2,ENSG00000204099.6,241809193,2-241813206-G-T,rs73108258,1,G,T,241813206,4013,241612585,242005801,200621
2,ENSG00000135898.5,230925242,2-230946983-A-G,rs7340358,-1,A,G,230946983,21741,230728634,231121850,218349
2,ENSG00000115129.9,24084834,2-24055674-C-T,rs74326069,-1,C,T,24055674,29160,23888226,24281442,167448
2,ENSG00000088179.4,119759922,2-119617194-G-A,rs74521588,1,G,A,119617194,142728,119563314,119956530,53880
2,ENSG00000115112.6,121285202,2-121303429-A-G,rs74593207,-1,A,G,121303429,18227,121088594,121481810,214835
2,ENSG00000115758.7,10448327,2-10313704-A-G,rs74899716,-1,A,G,10313704,134623,10251719,10644935,61985
2,ENSG00000135956.3,96265997,2-96129975-G-C,rs749459,-1,G,C,96129975,136022,96069389,96462605,60586
2,ENSG00000135956.3,96265997,2-96129975-G-A,rs749459,-1,G,A,96129975,136022,96069389,96462605,60586
2,ENSG00000135905.12,225042468,2-224928118-G-A,rs7558808,-1,G,A,224928118,114350,224845860,225239076,82258
2,ENSG00000183891.5,19901983,2-19897175-C-A,rs7563410,-1,C,A,19897175,4808,19705375,20098591,191800
2,ENSG00000119844.10,64524305,2-64538425-C-T,rs7567596,1,C,T,64538425,14120,64327697,64720913,210728
2,ENSG00000073737.11,169069563,2-168937193-C-A,rs7568243,1,C,A,168937193,132370,168872955,169266171,64238
2,ENSG00000073737.11,169069563,2-168937193-C-T,rs7568243,1,C,T,168937193,132370,168872955,169266171,64238
2,ENSG00000204843.7,74380311,2-74551517-C-T,rs7569357,-1,C,T,74551517,171206,74183703,74576919,367814
2,ENSG00000186889.5,62506195,2-62512844-T-C,rs7570024,-1,T,C,62512844,6649,62309587,62702803,203257
2,ENSG00000072163.12,127675530,2-127530712-A-G,rs75724169,-1,A,G,127530712,144818,127478922,127872138,51790
2,ENSG00000115423.13,84516498,2-84468879-A-G,rs7575751,1,A,G,84468879,47619,84319890,84713106,148989
2,ENSG00000116127.13,73385836,2-73384153-A-G,rs7576824,1,A,G,73384153,1683,73189228,73582444,194925
2,ENSG00000152292.11,85418714,2-85420498-C-T,rs75770276,1,C,T,85420498,1784,85222106,85615322,198392
2,ENSG00000152292.11,85418714,2-85420498-C-A,rs75770276,1,C,A,85420498,1784,85222106,85615322,198392
2,ENSG00000068697.6,20051628,2-20139347-G-T,rs75772582,-1,G,T,20139347,87719,19855020,20248236,284327
2,ENSG00000068697.6,20051628,2-20139347-G-A,rs75772582,-1,G,A,20139347,87719,19855020,20248236,284327
2,ENSG00000168542.8,188974373,2-188997322-G-C,rs7579815,1,G,C,188997322,22949,188777765,189170981,219557
2,ENSG00000132313.9,86199457,2-86220150-T-G,rs7583021,1,T,G,86220150,20693,86002849,86396065,217301
2,ENSG00000132313.9,86199457,2-86220150-T-C,rs7583021,1,T,C,86220150,20693,86002849,86396065,217301
2,ENSG00000198369.5,65432599,2-65373033-C-T,rs7583316,-1,C,T,65373033,59566,65235991,65629207,137042
2,ENSG00000011566.8,39437285,2-39508758-A-G,rs7585512,-1,A,G,39508758,71473,39240677,39633893,268081
2,ENSG00000011566.8,39437285,2-39508758-A-T,rs7585512,-1,A,T,39508758,71473,39240677,39633893,268081
2,ENSG00000170485.12,100820139,2-100836378-C-T,rs7587573,1,C,T,100836378,16239,100623531,101016747,212847
2,ENSG00000152518.5,43226606,2-43312986-T-G,rs7590268,-1,T,G,43312986,86380,43029998,43423214,282988
2,ENSG00000138386.12,190649083,2-190714847-T-A,rs7590384,1,T,A,190714847,65764,190452475,190845691,262372
2,ENSG00000138386.12,190649083,2-190714847-T-C,rs7590384,1,T,C,190714847,65764,190452475,190845691,262372
2,ENSG00000018699.7,32628050,2-32675263-A-G,rs7594173,1,A,G,32675263,47213,32431442,32824658,243821
2,ENSG00000153574.6,88691673,2-88727257-C-T,rs7596685,1,C,T,88727257,35584,88495065,88888281,232192
2,ENSG00000119013.4,201072001,2-200977287-G-A,rs7597440,1,G,A,200977287,94714,200875393,201268609,101894
2,ENSG00000119878.5,46617215,2-46629946-T-C,rs7598578,1,T,C,46629946,12731,46420607,46813823,209339
2,ENSG00000119878.5,46617215,2-46629946-T-A,rs7598578,1,T,A,46629946,12731,46420607,46813823,209339
2,ENSG00000119878.5,46617215,2-46629946-T-G,rs7598578,1,T,G,46629946,12731,46420607,46813823,209339
2,ENSG00000169564.5,70087477,2-70024862-T-G,rs7604106,1,T,G,70024862,62615,69890869,70284085,133993
2,ENSG00000138028.9,27119128,2-27122616-G-A,rs7605526,-1,G,A,27122616,3488,26922520,27315736,200096
2,ENSG00000138030.8,27086772,2-27122616-G-A,rs7605526,1,G,A,27122616,35844,26890164,27283380,232452
2,ENSG00000226479.3,120223400,2-120287271-T-C,rs76316712,-1,T,C,120287271,63871,120026792,120420008,260479
2,ENSG00000162976.8,11155467,2-11179724-T-C,rs76651240,1,T,C,11179724,24257,10958859,11352075,220865
2,ENSG00000075568.12,97995948,2-98104295-T-C,rs76793380,-1,T,C,98104295,108347,97799340,98192556,304955
2,ENSG00000136002.12,130836914,2-130967982-G-A,rs76805414,1,G,A,130967982,131068,130640306,131033522,327676
2,ENSG00000163359.10,237414164,2-237378645-C-T,rs77181645,-1,C,T,237378645,35519,237217556,237610772,161089
2,ENSG00000163359.10,237414164,2-237378645-C-A,rs77181645,-1,C,A,237378645,35519,237217556,237610772,161089
2,ENSG00000198885.5,96325317,2-96325754-A-C,rs772174,1,A,C,96325754,437,96128709,96521925,197045
2,ENSG00000198885.5,96325317,2-96325754-A-G,rs772174,1,A,G,96325754,437,96128709,96521925,197045
2,ENSG00000198885.5,96325317,2-96325754-A-T,rs772174,1,A,T,96325754,437,96128709,96521925,197045
2,ENSG00000119737.5,53859967,2-53749066-G-C,rs77662424,-1,G,C,53749066,110901,53663359,54056575,85707
2,ENSG00000119737.5,53859967,2-53749066-G-A,rs77662424,-1,G,A,53749066,110901,53663359,54056575,85707
2,ENSG00000144048.6,73780157,2-73707517-G-C,rs78071540,-1,G,C,73707517,72640,73583549,73976765,123968
2,ENSG00000144048.6,73780157,2-73707517-G-A,rs78071540,-1,G,A,73707517,72640,73583549,73976765,123968
2,ENSG00000128656.9,175005381,2-174983279-T-G,rs78093511,-1,T,G,174983279,22102,174808773,175201989,174506
2,ENSG00000138035.9,55693844,2-55684985-T-C,rs782572,-1,T,C,55684985,8859,55497236,55890452,187749
2,ENSG00000172059.6,10043550,2-10034265-G-A,rs78389260,1,G,A,10034265,9285,9846942,10240158,187323
2,ENSG00000019169.8,118942194,2-119131054-C-T,rs78780094,1,C,T,119131054,188860,118745586,119138802,385468
2,ENSG00000138050.10,39779258,2-39657530-C-G,rs79046700,-1,C,G,39657530,121728,39582650,39975866,74880
2,ENSG00000138050.10,39779258,2-39657530-C-T,rs79046700,-1,C,T,39657530,121728,39582650,39975866,74880
2,ENSG00000144015.4,95592001,2-95711578-C-T,rs79102712,1,C,T,95711578,119577,95395393,95788609,316185
2,ENSG00000143870.8,10812785,2-10800512-T-C,rs79135340,-1,T,C,10800512,12273,10616177,11009393,184335
2,ENSG00000186522.9,109613966,2-109701275-C-T,rs79415204,-1,C,T,109701275,87309,109417358,109810574,283917
2,ENSG00000115590.9,101991960,2-101916417-A-C,rs79676986,1,A,C,101916417,75543,101795352,102188568,121065
2,ENSG00000184261.3,47570985,2-47725638-C-T,rs797685,-1,C,T,47725638,154653,47374377,47767593,351261
2,ENSG00000152128.12,134719000,2-134660613-T-C,rs80076499,-1,T,C,134660613,58387,134522392,134915608,138221
2,ENSG00000115295.13,29115415,2-29287657-T-G,rs80317127,1,T,G,29287657,172242,28918807,29312023,368850
2,ENSG00000115155.11,26558756,2-26477505-G-A,rs80356569,-1,G,A,26477505,81251,26362148,26755364,115357
2,ENSG00000163795.9,27380734,2-27432253-T-C,rs811904,-1,T,C,27432253,51519,27184126,27577342,248127
2,ENSG00000153201.10,108719482,2-108784803-C-T,rs826556,1,C,T,108784803,65321,108522874,108916090,261929
2,ENSG00000114978.12,74178879,2-74145551-A-C,rs828888,-1,A,C,74145551,33328,73982271,74375487,163280
2,ENSG00000114978.12,74178879,2-74145551-A-G,rs828888,-1,A,G,74145551,33328,73982271,74375487,163280
2,ENSG00000119787.9,38377273,2-38285380-C-T,rs875653,-1,C,T,38285380,91893,38180665,38573881,104715
2,ENSG00000153832.7,229922503,2-229781982-A-T,rs927594,1,A,T,229781982,140521,229725895,230119111,56087
2,ENSG00000153832.7,229922503,2-229781982-A-C,rs927594,1,A,C,229781982,140521,229725895,230119111,56087
2,ENSG00000153832.7,229922503,2-229781982-A-G,rs927594,1,A,G,229781982,140521,229725895,230119111,56087
2,ENSG00000125611.11,112584609,2-112554706-T-C,rs9308673,1,T,C,112554706,29903,112388001,112781217,166705
2,ENSG00000125611.11,112584609,2-112554706-T-A,rs9308673,1,T,A,112554706,29903,112388001,112781217,166705
2,ENSG00000115841.15,37925287,2-37837451-C-G,rs934207,1,C,G,37837451,87836,37728679,38121895,108772
2,ENSG00000115841.15,37925287,2-37837451-C-T,rs934207,1,C,T,37837451,87836,37728679,38121895,108772
2,ENSG00000065911.7,74198615,2-74168944-A-G,rs9677593,1,A,G,74168944,29671,74002007,74395223,166937
2,ENSG00000143889.10,38602928,2-38574105-T-G,rs969876,-1,T,G,38574105,28823,38406320,38799536,167785
2,ENSG00000143889.10,38602928,2-38574105-T-A,rs969876,-1,T,A,38574105,28823,38406320,38799536,167785
2,ENSG00000182551.7,3519531,2-3505916-G-A,rs9750132,-1,G,A,3505916,13615,3322923,3716139,182993
2,ENSG00000079263.11,230225736,2-230251075-G-A,rs9989746,1,G,A,230251075,25339,230029128,230422344,221947
2,ENSG00000163171.6,37671642,2-37636998-T-A,rs1013292,-1,T,A,37636998,34644,37475034,37868250,161964
2,ENSG00000163171.6,37671642,2-37636998-T-G,rs1013292,-1,T,G,37636998,34644,37475034,37868250,161964
2,ENSG00000144115.11,88170346,2-88163636-C-A,rs10173112,1,C,A,88163636,6710,87973738,88366954,189898
2,ENSG00000144115.11,88170346,2-88163636-C-G,rs10173112,1,C,G,88163636,6710,87973738,88366954,189898
2,ENSG00000144115.11,88170346,2-88163636-C-T,rs10173112,1,C,T,88163636,6710,87973738,88366954,189898
2,ENSG00000115310.13,55050451,2-55031568-C-T,rs10173203,-1,C,T,55031568,18883,54853843,55247059,177725
2,ENSG00000115310.13,55050451,2-55031568-C-G,rs10173203,-1,C,G,55031568,18883,54853843,55247059,177725
2,ENSG00000115310.13,55050451,2-55031568-C-A,rs10173203,-1,C,A,55031568,18883,54853843,55247059,177725
2,ENSG00000115368.5,189441474,2-189350801-A-C,rs10177513,1,A,C,189350801,90673,189244866,189638082,105935
2,ENSG00000115368.5,189441474,2-189350801-A-G,rs10177513,1,A,G,189350801,90673,189244866,189638082,105935
2,ENSG00000173567.10,26346789,2-26481539-T-C,rs10177760,-1,T,C,26481539,134750,26150181,26543397,331358
2,ENSG00000218739.4,37196496,2-37285825-C-A,rs10177970,1,C,A,37285825,89329,36999888,37393104,285937
2,ENSG00000218739.4,37196496,2-37285825-C-T,rs10177970,1,C,T,37285825,89329,36999888,37393104,285937
2,ENSG00000218739.4,37196496,2-37285825-C-G,rs10177970,1,C,G,37285825,89329,36999888,37393104,285937
2,ENSG00000163251.3,207769906,2-207892701-G-T,rs10196699,-1,G,T,207892701,122795,207573298,207966514,319403
2,ENSG00000163251.3,207769906,2-207892701-G-C,rs10196699,-1,G,C,207892701,122795,207573298,207966514,319403
2,ENSG00000163006.6,108786771,2-108704520-A-T,rs10197130,1,A,T,108704520,82251,108590163,108983379,114357
2,ENSG00000163006.6,108786771,2-108704520-A-G,rs10197130,1,A,G,108704520,82251,108590163,108983379,114357
2,ENSG00000163006.6,108786771,2-108704520-A-C,rs10197130,1,A,C,108704520,82251,108590163,108983379,114357
2,ENSG00000138411.5,196593554,2-196658242-G-A,rs10197202,-1,G,A,196658242,64688,196396946,196790162,261296
2,ENSG00000138411.5,196593554,2-196658242-G-T,rs10197202,-1,G,T,196658242,64688,196396946,196790162,261296
2,ENSG00000132329.6,237859623,2-237907946-T-G,rs10199956,1,T,G,237907946,48323,237663015,238056231,244931
2,ENSG00000132329.6,237859623,2-237907946-T-A,rs10199956,1,T,A,237907946,48323,237663015,238056231,244931
2,ENSG00000118965.10,19990105,2-19848236-A-C,rs10200756,-1,A,C,19848236,141869,19793497,20186713,54739
2,ENSG00000118965.10,19990105,2-19848236-A-G,rs10200756,-1,A,G,19848236,141869,19793497,20186713,54739
2,ENSG00000118965.10,19990105,2-19848236-A-T,rs10200756,-1,A,T,19848236,141869,19793497,20186713,54739
2,ENSG00000183891.5,19901983,2-19884372-A-G,rs10204428,-1,A,G,19884372,17611,19705375,20098591,178997
2,ENSG00000152527.9,43637260,2-43720621-T-C,rs10206389,1,T,C,43720621,83361,43440652,43833868,279969
2,ENSG00000138448.6,186590056,2-186523931-T-A,rs10208166,1,T,A,186523931,66125,186393448,186786664,130483
2,ENSG00000144231.5,127858155,2-127677758-T-C,rs10211103,-1,T,C,127677758,180397,127661547,128054763,16211
2,ENSG00000144231.5,127858155,2-127677758-T-A,rs10211103,-1,T,A,127677758,180397,127661547,128054763,16211
2,ENSG00000115363.9,75560939,2-75481829-C-A,rs10439503,-1,C,A,75481829,79110,75364331,75757547,117498
2,ENSG00000115363.9,75560939,2-75481829-C-T,rs10439503,-1,C,T,75481829,79110,75364331,75757547,117498
2,ENSG00000153561.8,86720291,2-86616799-A-T,rs10451632,1,A,T,86616799,103492,86523683,86916899,93116
2,ENSG00000153561.8,86720291,2-86616799-A-G,rs10451632,1,A,G,86616799,103492,86523683,86916899,93116
2,ENSG00000115165.5,157444089,2-157454291-T-C,rs10497186,-1,T,C,157454291,10202,157247481,157640697,206810
2,ENSG00000115935.11,174597804,2-174496073-A-T,rs10497409,-1,A,T,174496073,101731,174401196,174794412,94877
2,ENSG00000115935.11,174597804,2-174496073-A-G,rs10497409,-1,A,G,174496073,101731,174401196,174794412,94877
2,ENSG00000196290.9,200889371,2-200989452-C-A,rs10497854,1,C,A,200989452,100081,200692763,201085979,296689
2,ENSG00000204186.3,206274663,2-206429792-C-G,rs10515945,1,C,G,206429792,155129,206078055,206471271,351737
2,ENSG00000054356.6,219309401,2-219445905-G-A,rs1078166,-1,G,A,219445905,136504,219112793,219506009,333112
2,ENSG00000244617.1,69961631,2-69864114-T-A,rs10865380,-1,T,A,69864114,97517,69765023,70158239,99091
2,ENSG00000244617.1,69961631,2-69864114-T-C,rs10865380,-1,T,C,69864114,97517,69765023,70158239,99091
2,ENSG00000115649.11,219176925,2-219032259-C-G,rs10932793,-1,C,G,219032259,144666,218980317,219373533,51942
2,ENSG00000115649.11,219176925,2-219032259-C-A,rs10932793,-1,C,A,219032259,144666,218980317,219373533,51942
2,ENSG00000198130.10,190319826,2-190369464-C-A,rs1108939,-1,C,A,190369464,49638,190123218,190516434,246246
2,ENSG00000198130.10,190319826,2-190369464-C-T,rs1108939,-1,C,T,190369464,49638,190123218,190516434,246246
2,ENSG00000125618.12,113278921,2-113236840-G-A,rs1110839,-1,G,A,113236840,42081,113082313,113475529,154527
2,ENSG00000125618.12,113278921,2-113236840-G-T,rs1110839,-1,G,T,113236840,42081,113082313,113475529,154527
2,ENSG00000125618.12,113278921,2-113236840-G-C,rs1110839,-1,G,C,113236840,42081,113082313,113475529,154527
2,ENSG00000013016.10,31234152,2-31217504-C-T,rs11124255,1,C,T,31217504,16648,31037544,31430760,179960
2,ENSG00000172086.7,88055783,2-88034746-T-C,rs11127081,-1,T,C,88034746,21037,87859175,88252391,175571
2,ENSG00000172086.7,88055783,2-88034746-T-A,rs11127081,-1,T,A,88034746,21037,87859175,88252391,175571
2,ENSG00000071051.9,105744912,2-105759776-T-C,rs1114475,1,T,C,105759776,14864,105548304,105941520,211472
2,ENSG00000071051.9,105744912,2-105759776-T-G,rs1114475,1,T,G,105759776,14864,105548304,105941520,211472
2,ENSG00000071051.9,105744912,2-105759776-T-A,rs1114475,1,T,A,105759776,14864,105548304,105941520,211472
2,ENSG00000204406.7,148021091,2-148067310-T-C,rs112184638,1,T,C,148067310,46219,147824483,148217699,242827
2,ENSG00000196843.9,96536752,2-96647504-C-T,rs113370809,1,C,T,96647504,110752,96340144,96733360,307360
2,ENSG00000176732.6,24123334,2-24119662-G-A,rs1134516,-1,G,A,24119662,3672,23926726,24319942,192936
2,ENSG00000179921.10,218261015,2-218129680-C-A,rs113602504,1,C,A,218129680,131335,218064407,218457623,65273
2,ENSG00000179921.10,218261015,2-218129680-C-T,rs113602504,1,C,T,218129680,131335,218064407,218457623,65273
2,ENSG00000154518.5,175181710,2-175059456-C-G,rs1145068,-1,C,G,175059456,122254,174985102,175378318,74354
2,ENSG00000187699.6,190180863,2-190084481-G-A,rs114794899,1,G,A,190084481,96382,189984255,190377471,100226
2,ENSG00000163481.3,218672002,2-218626907-C-T,rs115001095,-1,C,T,218626907,45095,218475394,218868610,151513
2,ENSG00000135624.10,73234308,2-73122919-C-G,rs115150178,1,C,G,73122919,111389,73037700,73430916,85219
2,ENSG00000152102.12,131093460,2-131017730-G-A,rs115214719,-1,G,A,131017730,75730,130896852,131290068,120878
2,ENSG00000152102.12,131093460,2-131017730-G-T,rs115214719,-1,G,T,131017730,75730,130896852,131290068,120878
2,ENSG00000171227.6,119431854,2-119246503-G-A,rs115704924,1,G,A,119246503,185351,119235246,119628462,11257
2,ENSG00000188738.8,185738804,2-185610844-C-T,rs115834632,1,C,T,185610844,127960,185542196,185935412,68648
2,ENSG00000186889.5,62506195,2-62548472-A-G,rs115837610,-1,A,G,62548472,42277,62309587,62702803,238885
2,ENSG00000186889.5,62506195,2-62548472-A-C,rs115837610,-1,A,C,62548472,42277,62309587,62702803,238885
2,ENSG00000153214.5,112055269,2-111886554-T-G,rs11678089,1,T,G,111886554,168715,111858661,112251877,27893
2,ENSG00000153214.5,112055269,2-111886554-T-A,rs11678089,1,T,A,111886554,168715,111858661,112251877,27893
2,ENSG00000135925.4,218880852,2-218885201-G-A,rs11680244,1,G,A,218885201,4349,218684244,219077460,200957
2,ENSG00000119812.13,33599299,2-33727554-G-A,rs11684598,-1,G,A,33727554,128255,33402691,33795907,324863
2,ENSG00000119729.6,46542490,2-46406528-A-G,rs11689675,1,A,G,46406528,135962,46345882,46739098,60646
2,ENSG00000119729.6,46542490,2-46406528-A-C,rs11689675,1,A,C,46406528,135962,46345882,46739098,60646
2,ENSG00000119729.6,46542490,2-46406528-A-T,rs11689675,1,A,T,46406528,135962,46345882,46739098,60646
2,ENSG00000144021.2,96266225,2-96159625-G-A,rs1168968,1,G,A,96159625,106600,96069617,96462833,90008
2,ENSG00000159399.4,74834127,2-74771987-G-A,rs11691168,1,G,A,74771987,62140,74637519,75030735,134468
2,ENSG00000144040.8,73071712,2-72974894-C-T,rs11692971,-1,C,T,72974894,96818,72875104,73268320,99790
2,ENSG00000116095.5,178480457,2-178548725-G-A,rs11694623,1,G,A,178548725,68268,178283849,178677065,264876
2,ENSG00000135974.5,105337540,2-105244501-A-G,rs11695535,1,A,G,105244501,93039,105140932,105534148,103569
2,ENSG00000162928.7,61017720,2-60847926-A-T,rs1177204,1,A,T,60847926,169794,60821112,61214328,26814
2,ENSG00000162928.7,61017720,2-60847926-A-G,rs1177204,1,A,G,60847926,169794,60821112,61214328,26814
2,ENSG00000162928.7,61017720,2-60847926-A-C,rs1177204,1,A,C,60847926,169794,60821112,61214328,26814
2,ENSG00000233087.4,131364168,2-131379704-G-A,rs117940763,-1,G,A,131379704,15536,131167560,131560776,212144
2,ENSG00000233087.4,131364168,2-131379704-G-T,rs117940763,-1,G,T,131379704,15536,131167560,131560776,212144
2,ENSG00000075426.7,28392858,2-28556222-C-T,rs118175241,1,C,T,28556222,163364,28196250,28589466,359972
2,ENSG00000218819.3,21123968,2-21082715-A-C,rs11886946,1,A,C,21082715,41253,20927360,21320576,155355
2,ENSG00000144031.7,70978630,2-71066998-A-T,rs11890238,1,A,T,71066998,88368,70782022,71175238,284976
2,ENSG00000144031.7,70978630,2-71066998-A-G,rs11890238,1,A,G,71066998,88368,70782022,71175238,284976
2,ENSG00000226479.3,120223400,2-120260961-A-T,rs11893187,-1,A,T,120260961,37561,120026792,120420008,234169
2,ENSG00000226479.3,120223400,2-120260961-A-G,rs11893187,-1,A,G,120260961,37561,120026792,120420008,234169
2,ENSG00000180398.7,46915806,2-46910128-A-G,rs11894319,-1,A,G,46910128,5678,46719198,47112414,190930
2,ENSG00000198369.5,65432599,2-65296655-G-T,rs11897123,-1,G,T,65296655,135944,65235991,65629207,60664
2,ENSG00000198369.5,65432599,2-65296655-G-A,rs11897123,-1,G,A,65296655,135944,65235991,65629207,60664
2,ENSG00000198369.5,65432599,2-65296655-G-C,rs11897123,-1,G,C,65296655,135944,65235991,65629207,60664
2,ENSG00000136689.14,113127598,2-113065995-A-C,rs11898158,1,A,C,113065995,61603,112930990,113324206,135005
2,ENSG00000136689.14,113127598,2-113065995-A-G,rs11898158,1,A,G,113065995,61603,112930990,113324206,135005
2,ENSG00000163510.9,180007297,2-180009120-T-C,rs11900886,-1,T,C,180009120,1823,179810689,180203905,198431
2,ENSG00000138434.11,181891730,2-182020469-C-A,rs1196184,1,C,A,182020469,128739,181695122,182088338,325347
2,ENSG00000138434.11,181891730,2-182020469-C-T,rs1196184,1,C,T,182020469,128739,181695122,182088338,325347
2,ENSG00000115020.11,208266255,2-208204579-A-G,rs12373582,1,A,G,208204579,61676,208069647,208462863,134932
2,ENSG00000163811.7,28894667,2-28952109-T-A,rs12464147,1,T,A,28952109,57442,28698059,29091275,254050
2,ENSG00000163811.7,28894667,2-28952109-T-C,rs12464147,1,T,C,28952109,57442,28698059,29091275,254050
2,ENSG00000163811.7,28894667,2-28952109-T-G,rs12464147,1,T,G,28952109,57442,28698059,29091275,254050
2,ENSG00000114988.7,96740064,2-96878199-T-G,rs12473528,-1,T,G,96878199,138135,96543456,96936672,334743
2,ENSG00000114988.7,96740064,2-96878199-T-A,rs12473528,-1,T,A,96878199,138135,96543456,96936672,334743
2,ENSG00000114988.7,96740064,2-96878199-T-C,rs12473528,-1,T,C,96878199,138135,96543456,96936672,334743
2,ENSG00000169554.9,144520119,2-144558730-A-G,rs1256916,-1,A,G,144558730,38611,144323511,144716727,235219
2,ENSG00000169554.9,144520119,2-144558730-A-C,rs1256916,-1,A,C,144558730,38611,144323511,144716727,235219
2,ENSG00000169554.9,144520119,2-144558730-A-T,rs1256916,-1,A,T,144558730,38611,144323511,144716727,235219
2,ENSG00000152082.9,130182262,2-130278164-G-A,rs12612434,1,G,A,130278164,95902,129985654,130378870,292510
2,ENSG00000115685.10,241150467,2-241130658-A-T,rs12613100,1,A,T,241130658,19809,240953859,241347075,176799
2,ENSG00000115685.10,241150467,2-241130658-A-G,rs12613100,1,A,G,241130658,19809,240953859,241347075,176799
2,ENSG00000153563.10,86790913,2-86670378-A-T,rs12613610,-1,A,T,86670378,120535,86594305,86987521,76073
2,ENSG00000153563.10,86790913,2-86670378-A-C,rs12613610,-1,A,C,86670378,120535,86594305,86987521,76073
2,ENSG00000153563.10,86790913,2-86670378-A-G,rs12613610,-1,A,G,86670378,120535,86594305,86987521,76073
2,ENSG00000151690.9,190408355,2-190479037-T-G,rs12613807,1,T,G,190479037,70682,190211747,190604963,267290
2,ENSG00000151690.9,190408355,2-190479037-T-A,rs12613807,1,T,A,190479037,70682,190211747,190604963,267290
2,ENSG00000151690.9,190408355,2-190479037-T-C,rs12613807,1,T,C,190479037,70682,190211747,190604963,267290
2,ENSG00000130508.6,1744515,2-1754994-A-G,rs12614997,-1,A,G,1754994,10479,1547907,1941123,207087
2,ENSG00000130508.6,1744515,2-1754994-A-T,rs12614997,-1,A,T,1754994,10479,1547907,1941123,207087
2,ENSG00000197635.5,162074215,2-161958313-A-G,rs12619850,-1,A,G,161958313,115902,161877607,162270823,80706
2,ENSG00000115841.15,37925287,2-37833060-G-A,rs12620064,1,G,A,37833060,92227,37728679,38121895,104381
2,ENSG00000115841.15,37925287,2-37833060-G-C,rs12620064,1,G,C,37833060,92227,37728679,38121895,104381
2,ENSG00000115841.15,37925287,2-37833060-G-T,rs12620064,1,G,T,37833060,92227,37728679,38121895,104381
2,ENSG00000082153.12,200811910,2-200773924-A-G,rs12622452,1,A,G,200773924,37986,200615302,201008518,158622
2,ENSG00000035141.3,70302067,2-70200325-A-C,rs12713689,-1,A,C,70200325,101742,70105459,70498675,94866
2,ENSG00000035141.3,70302067,2-70200325-A-G,rs12713689,-1,A,G,70200325,101742,70105459,70498675,94866
2,ENSG00000115486.6,85561493,2-85586711-A-G,rs12714147,-1,A,G,85586711,25218,85364885,85758101,221826
2,ENSG00000188760.6,219544028,2-219574956-C-G,rs12720063,1,C,G,219574956,30928,219347420,219740636,227536
2,ENSG00000188760.6,219544028,2-219574956-C-T,rs12720063,1,C,T,219574956,30928,219347420,219740636,227536
2,ENSG00000138028.9,27119128,2-27151141-G-C,rs1275509,-1,G,C,27151141,32013,26922520,27315736,228621
2,ENSG00000138028.9,27119128,2-27151141-G-A,rs1275509,-1,G,A,27151141,32013,26922520,27315736,228621
2,ENSG00000143994.9,27123815,2-27148102-T-A,rs1275513,1,T,A,27148102,24287,26927207,27320423,220895
2,ENSG00000143994.9,27123815,2-27148102-T-C,rs1275513,1,T,C,27148102,24287,26927207,27320423,220895
2,ENSG00000151353.10,677406,2-674963-G-A,rs12990777,-1,G,A,674963,2443,480798,874014,194165
2,ENSG00000115652.10,106194301,2-106298695-C-T,rs12996465,-1,C,T,106298695,104394,105997693,106390909,301002
2,ENSG00000115091.5,113890089,2-113896439-C-G,rs13009390,1,C,G,113896439,6350,113693481,114086697,202958
2,ENSG00000143869.5,20667144,2-20637172-G-C,rs13013492,1,G,C,20637172,29972,20470536,20863752,166636
2,ENSG00000143869.5,20667144,2-20637172-G-T,rs13013492,1,G,T,20637172,29972,20470536,20863752,166636
2,ENSG00000143869.5,20667144,2-20637172-G-A,rs13013492,1,G,A,20637172,29972,20470536,20863752,166636
2,ENSG00000138356.9,200586014,2-200484908-G-A,rs13019534,1,G,A,200484908,101106,200389406,200782622,95502
2,ENSG00000088205.7,117814691,2-117827203-C-T,rs13020804,1,C,T,117827203,12512,117618083,118011299,209120
2,ENSG00000115919.9,142877664,2-142953436-A-G,rs13024113,1,A,G,142953436,75772,142681056,143074272,272380
2,ENSG00000115919.9,142877664,2-142953436-A-C,rs13024113,1,A,C,142953436,75772,142681056,143074272,272380
2,ENSG00000163170.7,74147912,2-74110226-T-G,rs13025827,-1,T,G,74110226,37686,73951304,74344520,158922
2,ENSG00000163170.7,74147912,2-74110226-T-A,rs13025827,-1,T,A,74110226,37686,73951304,74344520,158922
2,ENSG00000163170.7,74147912,2-74110226-T-C,rs13025827,-1,T,C,74110226,37686,73951304,74344520,158922
2,ENSG00000081479.7,169362534,2-169390826-A-G,rs13029871,-1,A,G,169390826,28292,169165926,169559142,224900
2,ENSG00000081479.7,169362534,2-169390826-A-C,rs13029871,-1,A,C,169390826,28292,169165926,169559142,224900
2,ENSG00000162989.3,154698695,2-154507751-G-A,rs13033023,1,G,A,154507751,190944,154502087,154895303,5664
2,ENSG00000084754.6,26244632,2-26160476-C-G,rs13383267,-1,C,G,26160476,84156,26048024,26441240,112452
2,ENSG00000084754.6,26244632,2-26160476-C-A,rs13383267,-1,C,A,26160476,84156,26048024,26441240,112452
2,ENSG00000084754.6,26244632,2-26160476-C-T,rs13383267,-1,C,T,26160476,84156,26048024,26441240,112452
2,ENSG00000119862.7,64454162,2-64457529-A-G,rs13391620,1,A,G,64457529,3367,64257554,64650770,199975
2,ENSG00000154252.11,241776822,2-241772819-C-A,rs13392946,1,C,A,241772819,4003,241580214,241973430,192605
2,ENSG00000154252.11,241776822,2-241772819-C-T,rs13392946,1,C,T,241772819,4003,241580214,241973430,192605
2,ENSG00000154252.11,241776822,2-241772819-C-G,rs13392946,1,C,G,241772819,4003,241580214,241973430,192605
2,ENSG00000171103.6,28870309,2-28733818-C-A,rs13394863,-1,C,A,28733818,136491,28673701,29066917,60117
2,ENSG00000171103.6,28870309,2-28733818-C-G,rs13394863,-1,C,G,28733818,136491,28673701,29066917,60117
2,ENSG00000135951.10,99154942,2-98995305-T-G,rs13396584,-1,T,G,98995305,159637,98958334,99351550,36971
2,ENSG00000213639.5,28751830,2-28671694-A-G,rs13400746,1,A,G,28671694,80136,28555222,28948438,116472
2,ENSG00000170417.10,102762031,2-102740675-T-C,rs13402431,1,T,C,102740675,21356,102565423,102958639,175252
2,ENSG00000135905.12,225042468,2-224963646-C-T,rs13402952,-1,C,T,224963646,78822,224845860,225239076,117786
2,ENSG00000151665.8,46617041,2-46578234-A-G,rs13404342,-1,A,G,46578234,38807,46420433,46813649,157801
2,ENSG00000158435.3,101252886,2-101138894-A-G,rs13412911,1,A,G,101138894,113992,101056278,101449494,82616
2,ENSG00000170634.7,53971113,2-54135589-A-T,rs13417064,1,A,T,54135589,164476,53774505,54167721,361084
2,ENSG00000170634.7,53971113,2-54135589-A-G,rs13417064,1,A,G,54135589,164476,53774505,54167721,361084
2,ENSG00000170634.7,53971113,2-54135589-A-C,rs13417064,1,A,C,54135589,164476,53774505,54167721,361084
2,ENSG00000152154.5,39665917,2-39506824-T-C,rs13420542,1,T,C,39506824,159093,39469309,39862525,37515
2,ENSG00000135926.6,218292503,2-218248366-G-C,rs13430006,-1,G,C,218248366,44137,218095895,218489111,152471
2,ENSG00000135926.6,218292503,2-218248366-G-T,rs13430006,-1,G,T,218248366,44137,218095895,218489111,152471
2,ENSG00000135926.6,218292503,2-218248366-G-A,rs13430006,-1,G,A,218248366,44137,218095895,218489111,152471
2,ENSG00000119844.10,64524305,2-64476152-C-A,rs1345516,1,C,A,64476152,48153,64327697,64720913,148455
2,ENSG00000119801.8,30147007,2-30184700-G-A,rs1355207,1,G,A,30184700,37693,29950399,30343615,234301
2,ENSG00000119801.8,30147007,2-30184700-G-C,rs1355207,1,G,C,30184700,37693,29950399,30343615,234301
2,ENSG00000019169.8,118942194,2-119062468-T-A,rs1371563,1,T,A,119062468,120274,118745586,119138802,316882
2,ENSG00000019169.8,118942194,2-119062468-T-G,rs1371563,1,T,G,119062468,120274,118745586,119138802,316882
2,ENSG00000138030.8,27086772,2-26930006-C-T,rs1371614,1,C,T,26930006,156766,26890164,27283380,39842
2,ENSG00000186854.6,84881084,2-84877023-T-A,rs1478782,-1,T,A,84877023,4061,84684476,85077692,192547
2,ENSG00000179528.10,74499603,2-74688535-C-G,rs150139,-1,C,G,74688535,188932,74302995,74696211,385540
2,ENSG00000179528.10,74499603,2-74688535-C-A,rs150139,-1,C,A,74688535,188932,74302995,74696211,385540
2,ENSG00000138386.12,190649083,2-190639338-A-C,rs1558473,1,A,C,190639338,9745,190452475,190845691,186863
2,ENSG00000115232.8,181457386,2-181625027-G-C,rs1596023,1,G,C,181625027,167641,181260778,181653994,364249
2,ENSG00000115232.8,181457386,2-181625027-G-A,rs1596023,1,G,A,181625027,167641,181260778,181653994,364249
2,ENSG00000115232.8,181457386,2-181625027-G-T,rs1596023,1,G,T,181625027,167641,181260778,181653994,364249
2,ENSG00000169047.4,226799820,2-226783067-A-G,rs16822638,-1,A,G,226783067,16753,226603212,226996428,179855
2,ENSG00000169047.4,226799820,2-226783067-A-C,rs16822638,-1,A,C,226783067,16753,226603212,226996428,179855
2,ENSG00000135932.6,230712842,2-230818223-T-C,rs16827587,1,T,C,230818223,105381,230516234,230909450,301989
2,ENSG00000115053.10,231464484,2-231336638-T-C,rs16827953,-1,T,C,231336638,127846,231267876,231661092,68762
2,ENSG00000115963.9,150487667,2-150457333-A-G,rs16828206,-1,A,G,150457333,30334,150291059,150684275,166274
2,ENSG00000128699.9,189784339,2-189721291-T-C,rs16831909,-1,T,C,189721291,63048,189587731,189980947,133560
2,ENSG00000128699.9,189784339,2-189721291-T-G,rs16831909,-1,T,G,189721291,63048,189587731,189980947,133560
2,ENSG00000151689.8,190343589,2-190326122-C-T,rs16832572,1,C,T,190326122,17467,190146981,190540197,179141
2,ENSG00000013441.10,200864658,2-200939596-C-G,rs16836058,-1,C,G,200939596,74938,200668050,201061266,271546
2,ENSG00000114933.10,206086174,2-206198058-G-T,rs16838046,-1,G,T,206198058,111884,205889566,206282782,308492
2,ENSG00000138395.10,201806537,2-201780215-A-G,rs16838146,1,A,G,201780215,26322,201609929,202003145,170286
2,ENSG00000155760.1,202033855,2-201862313-G-A,rs16838316,1,G,A,201862313,171542,201837247,202230463,25066
2,ENSG00000155760.1,202033855,2-201862313-G-T,rs16838316,1,G,T,201862313,171542,201837247,202230463,25066
2,ENSG00000173166.12,203535301,2-203663404-C-T,rs16839999,-1,C,T,203663404,128103,203338693,203731909,324711
2,ENSG00000144452.10,215138626,2-215086682-G-A,rs16853334,-1,G,A,215086682,51944,214942018,215335234,144664
2,ENSG00000205795.4,10080411,2-10244163-C-T,rs16856020,-1,C,T,10244163,163752,9883803,10277019,360360
2,ENSG00000205795.4,10080411,2-10244163-C-G,rs16856020,-1,C,G,10244163,163752,9883803,10277019,360360
2,ENSG00000163093.7,169479494,2-169480287-G-A,rs16856972,1,G,A,169480287,793,169282886,169676102,197401
2,ENSG00000116120.8,222656092,2-222579042-T-G,rs16863911,-1,T,G,222579042,77050,222459484,222852700,119558
2,ENSG00000116120.8,222656092,2-222579042-T-A,rs16863911,-1,T,A,222579042,77050,222459484,222852700,119558
2,ENSG00000116120.8,222656092,2-222579042-T-C,rs16863911,-1,T,C,222579042,77050,222459484,222852700,119558
2,ENSG00000163082.9,222424543,2-222592474-C-T,rs16863916,1,C,T,222592474,167931,222227935,222621151,364539
2,ENSG00000185013.11,18589569,2-18504215-C-T,rs16985169,-1,C,T,18504215,85354,18392961,18786177,111254
2,ENSG00000115241.8,27409591,2-27386144-C-A,rs17006046,-1,C,A,27386144,23447,27212983,27606199,173161
2,ENSG00000005448.12,74421730,2-74253532-C-T,rs17009774,1,C,T,74253532,168198,74225122,74618338,28410
2,ENSG00000005448.12,74421730,2-74253532-C-A,rs17009774,1,C,A,74253532,168198,74225122,74618338,28410
2,ENSG00000135637.9,74482998,2-74488311-T-C,rs17009977,-1,T,C,74488311,5313,74286390,74679606,201921
2,ENSG00000071073.6,98731132,2-98639438-A-G,rs17021689,-1,A,G,98639438,91694,98534524,98927740,104914
2,ENSG00000115590.9,101991960,2-102045710-C-T,rs17026510,1,C,T,102045710,53750,101795352,102188568,250358
2,ENSG00000183281.10,87021844,2-87094919-G-A,rs17041053,-1,G,A,87094919,73075,86825236,87218452,269683
2,ENSG00000198885.5,96325317,2-96142810-T-C,rs1724121,1,T,C,96142810,182507,96128709,96521925,14101
2,ENSG00000168899.4,85584431,2-85647722-G-A,rs17508843,1,G,A,85647722,63291,85387823,85781039,259899
2,ENSG00000155729.8,200510068,2-200572325-A-G,rs17532665,-1,A,G,200572325,62257,200313460,200706676,258865
2,ENSG00000138050.10,39779258,2-39897235-G-A,rs17540476,-1,G,A,39897235,117977,39582650,39975866,314585
2,ENSG00000138050.10,39779258,2-39897235-G-C,rs17540476,-1,G,C,39897235,117977,39582650,39975866,314585
2,ENSG00000135914.4,231125042,2-231114544-A-G,rs17586405,-1,A,G,231114544,10498,230928434,231321650,186110
2,ENSG00000125637.10,113173971,2-113174985-C-A,rs17624171,1,C,A,113174985,1014,112977363,113370579,197622
2,ENSG00000136682.9,113437691,2-113379965-G-A,rs17628215,1,G,A,113379965,57726,113241083,113634299,138882
2,ENSG00000173272.9,131492397,2-131567218-T-C,rs17673497,-1,T,C,131567218,74821,131295789,131689005,271429
2,ENSG00000173272.9,131492397,2-131567218-T-G,rs17673497,-1,T,G,131567218,74821,131295789,131689005,271429
2,ENSG00000159374.13,74648330,2-74761442-A-G,rs17675669,-1,A,G,74761442,113112,74451722,74844938,309720
2,ENSG00000143727.10,264947,2-285471-G-A,rs17714252,1,G,A,285471,20524,68339,461555,217132
2,ENSG00000119878.5,46617215,2-46636110-A-C,rs17768132,1,A,C,46636110,18895,46420607,46813823,215503
2,ENSG00000138092.6,24793425,2-24773846-T-A,rs17799110,1,T,A,24773846,19579,24596817,24990033,177029
2,ENSG00000250565.2,46542577,2-46541420-G-A,rs1868844,-1,G,A,46541420,1157,46345969,46739185,195451
2,ENSG00000115977.13,69643739,2-69531795-C-T,rs1985342,-1,C,T,69531795,111944,69447131,69840347,84664
2,ENSG00000138069.12,65130106,2-64966257-C-T,rs2017320,-1,C,T,64966257,163849,64933498,65326714,32759
2,ENSG00000085982.8,233566782,2-233455780-T-C,rs2034761,-1,T,C,233455780,111002,233370174,233763390,85606
2,ENSG00000085982.8,233566782,2-233455780-T-A,rs2034761,-1,T,A,233455780,111002,233370174,233763390,85606
2,ENSG00000085982.8,233566782,2-233455780-T-G,rs2034761,-1,T,G,233455780,111002,233370174,233763390,85606
2,ENSG00000115594.7,102142746,2-102081900-A-G,rs2041751,1,A,G,102081900,60846,101946138,102339354,135762
2,ENSG00000196151.6,159286703,2-159227713-G-C,rs2042494,-1,G,C,159227713,58990,159090095,159483311,137618
2,ENSG00000196151.6,159286703,2-159227713-G-A,rs2042494,-1,G,A,159227713,58990,159090095,159483311,137618
2,ENSG00000196975.9,69742134,2-69709503-C-G,rs2048255,1,C,G,69709503,32631,69545526,69938742,163977
2,ENSG00000196975.9,69742134,2-69709503-C-A,rs2048255,1,C,A,69709503,32631,69545526,69938742,163977
2,ENSG00000196975.9,69742134,2-69709503-C-T,rs2048255,1,C,T,69709503,32631,69545526,69938742,163977
2,ENSG00000144043.7,70994873,2-70975947-A-G,rs2058552,-1,A,G,70975947,18926,70798265,71191481,177682
2,ENSG00000142330.15,240586734,2-240721561-T-G,rs2060193,1,T,G,240721561,134827,240390126,240783342,331435
2,ENSG00000142330.15,240586734,2-240721561-T-A,rs2060193,1,T,A,240721561,134827,240390126,240783342,331435
2,ENSG00000142330.15,240586734,2-240721561-T-C,rs2060193,1,T,C,240721561,134827,240390126,240783342,331435
2,ENSG00000162961.9,32039805,2-31987866-T-G,rs2064813,-1,T,G,31987866,51939,31843197,32236413,144669
2,ENSG00000079263.11,230225736,2-230210491-G-A,rs2114592,1,G,A,230210491,15245,230029128,230422344,181363
2,ENSG00000144218.12,100142590,2-100129933-G-C,rs2118280,-1,G,C,100129933,12657,99945982,100339198,183951
2,ENSG00000144218.12,100142590,2-100129933-G-A,rs2118280,-1,G,A,100129933,12657,99945982,100339198,183951
2,ENSG00000143971.7,67397333,2-67315322-T-C,rs2128769,1,T,C,67315322,82011,67200725,67593941,114597
2,ENSG00000143971.7,67397333,2-67315322-T-A,rs2128769,1,T,A,67315322,82011,67200725,67593941,114597
2,ENSG00000071909.12,170178147,2-170217377-G-C,rs2161916,1,G,C,170217377,39230,169981539,170374755,235838
2,ENSG00000071909.12,170178147,2-170217377-G-A,rs2161916,1,G,A,170217377,39230,169981539,170374755,235838
2,ENSG00000152689.13,33476649,2-33514230-T-G,rs2168395,1,T,G,33514230,37581,33280041,33673257,234189
2,ENSG00000152689.13,33476649,2-33514230-T-C,rs2168395,1,T,C,33514230,37581,33280041,33673257,234189
2,ENSG00000077044.5,233354494,2-233438014-G-A,rs2242102,1,G,A,233438014,83520,233157886,233551102,280128
2,ENSG00000136709.7,127811171,2-127648346-C-G,rs2243934,-1,C,G,127648346,162825,127614563,128007779,33783
2,ENSG00000136709.7,127811171,2-127648346-C-A,rs2243934,-1,C,A,127648346,162825,127614563,128007779,33783
2,ENSG00000136709.7,127811171,2-127648346-C-T,rs2243934,-1,C,T,127648346,162825,127614563,128007779,33783
2,ENSG00000198380.7,69387227,2-69532283-G-C,rs2276687,-1,G,C,69532283,145056,69190619,69583835,341664
2,ENSG00000198380.7,69387227,2-69532283-G-A,rs2276687,-1,G,A,69532283,145056,69190619,69583835,341664
2,ENSG00000138400.8,206765328,2-206768228-G-A,rs2287630,-1,G,A,206768228,2900,206568720,206961936,199508
2,ENSG00000138400.8,206765328,2-206768228-G-C,rs2287630,-1,G,C,206768228,2900,206568720,206961936,199508
2,ENSG00000138400.8,206765328,2-206768228-G-T,rs2287630,-1,G,T,206768228,2900,206568720,206961936,199508
2,ENSG00000138399.13,169573865,2-169736199-A-G,rs2288331,-1,A,G,169736199,162334,169377257,169770473,358942
2,ENSG00000144589.15,219597857,2-219633628-G-T,rs2289782,1,G,T,219633628,35771,219401249,219794465,232379
2,ENSG00000144589.15,219597857,2-219633628-G-C,rs2289782,1,G,C,219633628,35771,219401249,219794465,232379
2,ENSG00000163219.6,68734811,2-68785390-G-A,rs2311413,1,G,A,68785390,50579,68538203,68931419,247187
2,ENSG00000170745.7,17878667,2-17882190-G-C,rs2344695,1,G,C,17882190,3523,17682059,18075275,200131
2,ENSG00000170745.7,17878667,2-17882190-G-A,rs2344695,1,G,A,17882190,3523,17682059,18075275,200131
2,ENSG00000170745.7,17878667,2-17882190-G-T,rs2344695,1,G,T,17882190,3523,17682059,18075275,200131
2,ENSG00000057935.8,42568632,2-42514774-T-G,rs2374432,1,T,G,42514774,53858,42372024,42765240,142750
2,ENSG00000081052.10,227164205,2-227180276-C-A,rs2396463,-1,C,A,227180276,16071,226967597,227360813,212679
2,ENSG00000115484.10,61888656,2-61735826-A-G,rs2421433,-1,A,G,61735826,152830,61692048,62085264,43778
2,ENSG00000115484.10,61888656,2-61735826-A-T,rs2421433,-1,A,T,61735826,152830,61692048,62085264,43778
2,ENSG00000196604.7,130129222,2-130109037-G-A,rs2438682,-1,G,A,130109037,20185,129932614,130325830,176423
2,ENSG00000196604.7,130129222,2-130109037-G-T,rs2438682,-1,G,T,130109037,20185,129932614,130325830,176423
2,ENSG00000196604.7,130129222,2-130109037-G-C,rs2438682,-1,G,C,130109037,20185,129932614,130325830,176423
2,ENSG00000034510.4,84905656,2-85063500-C-A,rs2583544,1,C,A,85063500,157844,84709048,85102264,354452
2,ENSG00000085760.8,55269231,2-55255884-C-G,rs2589094,-1,C,G,55255884,13347,55072623,55465839,183261
2,ENSG00000085760.8,55269231,2-55255884-C-T,rs2589094,-1,C,T,55255884,13347,55072623,55465839,183261
2,ENSG00000121989.10,147845029,2-147971481-T-A,rs2627019,1,T,A,147971481,126452,147648421,148041637,323060
2,ENSG00000121989.10,147845029,2-147971481-T-G,rs2627019,1,T,G,147971481,126452,147648421,148041637,323060
2,ENSG00000121989.10,147845029,2-147971481-T-C,rs2627019,1,T,C,147971481,126452,147648421,148041637,323060
2,ENSG00000135973.1,105241743,2-105297986-C-T,rs2679889,1,C,T,105297986,56243,105045135,105438351,252851
2,ENSG00000144468.12,226836054,2-226666005-C-T,rs2709423,1,C,T,226666005,170049,226639446,227032662,26559
2,ENSG00000138375.8,216412484,2-216439429-T-G,rs2738278,1,T,G,216439429,26945,216215876,216609092,223553
2,ENSG00000138375.8,216412484,2-216439429-T-C,rs2738278,1,T,C,216439429,26945,216215876,216609092,223553
2,ENSG00000197756.4,216498844,2-216514127-C-T,rs284539,1,C,T,216514127,15283,216302236,216695452,211891
2,ENSG00000197756.4,216498844,2-216514127-C-A,rs284539,1,C,A,216514127,15283,216302236,216695452,211891
2,ENSG00000197756.4,216498844,2-216514127-C-G,rs284539,1,C,G,216514127,15283,216302236,216695452,211891
2,ENSG00000135930.9,232550689,2-232521519-T-C,rs2853444,1,T,C,232521519,29170,232354081,232747297,167438
2,ENSG00000135930.9,232550689,2-232521519-T-A,rs2853444,1,T,A,232521519,29170,232354081,232747297,167438
2,ENSG00000135930.9,232550689,2-232521519-T-G,rs2853444,1,T,G,232521519,29170,232354081,232747297,167438
2,ENSG00000178385.9,208025527,2-208130385-T-C,rs2854719,-1,T,C,208130385,104858,207828919,208222135,301466
2,ENSG00000178385.9,208025527,2-208130385-T-G,rs2854719,-1,T,G,208130385,104858,207828919,208222135,301466
2,ENSG00000068724.10,46941224,2-46953967-T-A,rs2881586,1,T,A,46953967,12743,46744616,47137832,209351
2,ENSG00000068724.10,46941224,2-46953967-T-C,rs2881586,1,T,C,46953967,12743,46744616,47137832,209351
2,ENSG00000115170.9,157876330,2-157880827-G-C,rs2883604,-1,G,C,157880827,4497,157679722,158072938,201105
2,ENSG00000115170.9,157876330,2-157880827-G-T,rs2883604,-1,G,T,157880827,4497,157679722,158072938,201105
2,ENSG00000214595.6,54723662,2-54677326-G-A,rs2971884,1,G,A,54677326,46336,54527054,54920270,150272
2,ENSG00000035115.15,264032,2-180171-C-T,rs300691,-1,C,T,180171,83861,67424,460640,112747
2,ENSG00000035115.15,264032,2-180171-C-A,rs300691,-1,C,A,180171,83861,67424,460640,112747
2,ENSG00000168894.5,85595745,2-85657261-T-C,rs3024831,1,T,C,85657261,61516,85399137,85792353,258124
2,ENSG00000178074.5,199911293,2-200068256-G-T,rs3094762,1,G,T,200068256,156963,199714685,200107901,353571
2,ENSG00000178074.5,199911293,2-200068256-G-A,rs3094762,1,G,A,200068256,156963,199714685,200107901,353571
2,ENSG00000162972.6,199955582,2-200051060-C-G,rs3115413,1,C,G,200051060,95478,199758974,200152190,292086
2,ENSG00000162972.6,199955582,2-200051060-C-T,rs3115413,1,C,T,200051060,95478,199758974,200152190,292086
2,ENSG00000162972.6,199955582,2-200051060-C-A,rs3115413,1,C,A,200051060,95478,199758974,200152190,292086
2,ENSG00000184898.6,151261863,2-151248577-C-G,rs34132424,-1,C,G,151248577,13286,151065255,151458471,183322
2,ENSG00000184898.6,151261863,2-151248577-C-A,rs34132424,-1,C,A,151248577,13286,151065255,151458471,183322
2,ENSG00000184898.6,151261863,2-151248577-C-T,rs34132424,-1,C,T,151248577,13286,151065255,151458471,183322
2,ENSG00000198648.6,168247595,2-168309864-C-T,rs34689978,-1,C,T,168309864,62269,168050987,168444203,258877
2,ENSG00000115657.7,219218958,2-219261923-A-C,rs34967637,-1,A,C,219261923,42965,219022350,219415566,239573
2,ENSG00000115657.7,219218958,2-219261923-A-G,rs34967637,-1,A,G,219261923,42965,219022350,219415566,239573
2,ENSG00000136732.10,126656158,2-126753521-G-A,rs35079578,1,G,A,126753521,97363,126459550,126852766,293971
2,ENSG00000138379.3,190062729,2-190036972-T-C,rs35285831,-1,T,C,190036972,25757,189866121,190259337,170851
2,ENSG00000115107.14,119223834,2-119208364-C-T,rs35741883,1,C,T,119208364,15470,119027226,119420442,181138
2,ENSG00000155657.16,178807423,2-178785681-G-A,rs35813871,-1,G,A,178785681,21742,178610815,179004031,174866
2,ENSG00000168542.8,188974373,2-189068038-G-A,rs35830636,1,G,A,189068038,93665,188777765,189170981,290273
2,ENSG00000018699.7,32628050,2-32704097-A-G,rs35985862,1,A,G,32704097,76047,32431442,32824658,272655
2,ENSG00000135900.3,223957463,2-223909431-C-T,rs36053433,1,C,T,223909431,48032,223760855,224154071,148576
2,ENSG00000115350.7,74958643,2-75047000-T-A,rs3732303,1,T,A,75047000,88357,74762035,75155251,284965
2,ENSG00000115350.7,74958643,2-75047000-T-C,rs3732303,1,T,C,75047000,88357,74762035,75155251,284965
2,ENSG00000115350.7,74958643,2-75047000-T-G,rs3732303,1,T,G,75047000,88357,74762035,75155251,284965
2,ENSG00000196141.7,200306693,2-200414918-A-C,rs3769449,1,A,C,200414918,108225,200110085,200503301,304833
2,ENSG00000196141.7,200306693,2-200414918-A-G,rs3769449,1,A,G,200414918,108225,200110085,200503301,304833
2,ENSG00000115840.9,171894244,2-171812099-G-C,rs3770453,-1,G,C,171812099,82145,171697636,172090852,114463
2,ENSG00000115840.9,171894244,2-171812099-G-A,rs3770453,-1,G,A,171812099,82145,171697636,172090852,114463
2,ENSG00000115840.9,171894244,2-171812099-G-T,rs3770453,-1,G,T,171812099,82145,171697636,172090852,114463
2,ENSG00000150938.5,36355778,2-36427629-C-A,rs3770899,1,C,A,36427629,71851,36159170,36552386,268459
2,ENSG00000150938.5,36355778,2-36427629-C-T,rs3770899,1,C,T,36427629,71851,36159170,36552386,268459
2,ENSG00000011523.8,65056416,2-65096955-A-G,rs3771105,1,A,G,65096955,40539,64859808,65253024,237147
2,ENSG00000011523.8,65056416,2-65096955-A-C,rs3771105,1,A,C,65096955,40539,64859808,65253024,237147
2,ENSG00000079785.8,15591868,2-15602186-T-G,rs3815689,1,T,G,15602186,10318,15395260,15788476,206926
2,ENSG00000079785.8,15591868,2-15602186-T-C,rs3815689,1,T,C,15602186,10318,15395260,15788476,206926
2,ENSG00000115008.5,112784493,2-112822289-T-C,rs3917386,-1,T,C,112822289,37796,112587885,112981101,234404
2,ENSG00000143942.4,53767804,2-53630261-T-C,rs3937481,1,T,C,53630261,137543,53571196,53964412,59065
2,ENSG00000143942.4,53767804,2-53630261-T-A,rs3937481,1,T,A,53630261,137543,53571196,53964412,59065
2,ENSG00000143942.4,53767804,2-53630261-T-G,rs3937481,1,T,G,53630261,137543,53571196,53964412,59065
2,ENSG00000125630.10,112542465,2-112560404-C-T,rs3961914,1,C,T,112560404,17939,112345857,112739073,214547
2,ENSG00000075292.11,71331782,2-71173887-C-T,rs397458,1,C,T,71173887,157895,71135174,71528390,38713
2,ENSG00000075292.11,71331782,2-71173887-C-A,rs397458,1,C,A,71173887,157895,71135174,71528390,38713
2,ENSG00000188389.5,241858894,2-241867263-A-C,rs4072221,-1,A,C,241867263,8369,241662286,242055502,204977
2,ENSG00000188389.5,241858894,2-241867263-A-G,rs4072221,-1,A,G,241867263,8369,241662286,242055502,204977
2,ENSG00000188389.5,241858894,2-241867263-A-T,rs4072221,-1,A,T,241867263,8369,241662286,242055502,204977
2,ENSG00000003402.12,201116164,2-201187058-G-A,rs41339752,1,G,A,201187058,70894,200919556,201312772,267502
2,ENSG00000127824.9,219253918,2-219079106-T-C,rs41398145,-1,T,C,219079106,174812,219057310,219450526,21796
2,ENSG00000127824.9,219253918,2-219079106-T-A,rs41398145,-1,T,A,219079106,174812,219057310,219450526,21796
2,ENSG00000136720.6,128318868,2-128288191-C-T,rs4143782,-1,C,T,128288191,30677,128122260,128515476,165931
2,ENSG00000073737.11,169069563,2-169025574-A-G,rs4148770,1,A,G,169025574,43989,168872955,169266171,152619
2,ENSG00000130414.6,240025342,2-240018317-G-A,rs4149541,-1,G,A,240018317,7025,239828734,240221950,189583
2,ENSG00000138036.12,43774039,2-43821981-G-C,rs4245786,1,G,C,43821981,47942,43577431,43970647,244550
2,ENSG00000138036.12,43774039,2-43821981-G-A,rs4245786,1,G,A,43821981,47942,43577431,43970647,244550
2,ENSG00000163001.7,55519718,2-55584925-A-C,rs4312532,1,A,C,55584925,65207,55323110,55716326,261815
2,ENSG00000163001.7,55519718,2-55584925-A-G,rs4312532,1,A,G,55584925,65207,55323110,55716326,261815
2,ENSG00000152256.8,172556090,2-172709602-T-C,rs4395226,1,T,C,172709602,153512,172359482,172752698,350120
2,ENSG00000172059.6,10043550,2-10053051-C-A,rs4444493,1,C,A,10053051,9501,9846942,10240158,206109
2,ENSG00000125538.7,112836779,2-112848380-C-T,rs4447608,-1,C,T,112848380,11601,112640171,113033387,208209
2,ENSG00000125538.7,112836779,2-112848380-C-A,rs4447608,-1,C,A,112848380,11601,112640171,113033387,208209
2,ENSG00000138039.9,48755724,2-48753368-G-T,rs4465809,-1,G,T,48753368,2356,48559116,48952332,194252
2,ENSG00000115750.10,9843474,2-9882887-T-C,rs447465,1,T,C,9882887,39413,9646866,10040082,236021
2,ENSG00000042493.10,85410366,2-85346892-G-C,rs4474882,-1,G,C,85346892,63474,85213758,85606974,133134
2,ENSG00000042493.10,85410366,2-85346892-G-A,rs4474882,-1,G,A,85346892,63474,85213758,85606974,133134
2,ENSG00000055332.10,37156980,2-37140558-G-A,rs4648182,-1,G,A,37140558,16422,36960372,37353588,180186
2,ENSG00000115760.9,32357023,2-32314167-T-A,rs466146,1,T,A,32314167,42856,32160415,32553631,153752
2,ENSG00000115760.9,32357023,2-32314167-T-G,rs466146,1,T,G,32314167,42856,32160415,32553631,153752
2,ENSG00000144488.10,238100340,2-237988732-G-T,rs4663819,1,G,T,237988732,111608,237903732,238296948,85000
2,ENSG00000144488.10,238100340,2-237988732-G-A,rs4663819,1,G,A,237988732,111608,237903732,238296948,85000
2,ENSG00000138029.9,26244939,2-26295728-G-A,rs4665848,1,G,A,26295728,50789,26048331,26441547,247397
2,ENSG00000138029.9,26244939,2-26295728-G-C,rs4665848,1,G,C,26295728,50789,26048331,26441547,247397
2,ENSG00000138029.9,26244939,2-26295728-G-T,rs4665848,1,G,T,26295728,50789,26048331,26441547,247397
2,ENSG00000084774.8,27217369,2-27352086-T-C,rs4665969,1,T,C,27352086,134717,27020761,27413977,331325
2,ENSG00000119185.8,9423528,2-9363036-G-A,rs4669386,-1,G,A,9363036,60492,9226920,9620136,136116
2,ENSG00000115902.5,64989399,2-64917523-C-A,rs4671629,1,C,A,64917523,71876,64792791,65186007,124732
2,ENSG00000115902.5,64989399,2-64917523-C-G,rs4671629,1,C,G,64917523,71876,64792791,65186007,124732
2,ENSG00000115902.5,64989399,2-64917523-C-T,rs4671629,1,C,T,64917523,71876,64792791,65186007,124732
2,ENSG00000162971.6,199955491,2-200050672-T-G,rs4673660,-1,T,G,200050672,95181,199758883,200152099,291789
2,ENSG00000162971.6,199955491,2-200050672-T-C,rs4673660,-1,T,C,200050672,95181,199758883,200152099,291789
2,ENSG00000163516.8,219229806,2-219359929-A-G,rs4674382,1,A,G,219359929,130123,219033198,219426414,326731
2,ENSG00000163516.8,219229806,2-219359929-A-T,rs4674382,1,A,T,219359929,130123,219033198,219426414,326731
2,ENSG00000144591.11,219498891,2-219670426-G-C,rs4674417,1,G,C,219670426,171535,219302283,219695499,368143
2,ENSG00000144591.11,219498891,2-219670426-G-A,rs4674417,1,G,A,219670426,171535,219302283,219695499,368143
2,ENSG00000135919.8,224039286,2-224057097-C-G,rs4674860,-1,C,G,224057097,17811,223842678,224235894,214419
2,ENSG00000135919.8,224039286,2-224057097-C-T,rs4674860,-1,C,T,224057097,17811,223842678,224235894,214419
2,ENSG00000152291.9,85327989,2-85443365-T-A,rs4832175,-1,T,A,85443365,115376,85131381,85524597,311984
2,ENSG00000152291.9,85327989,2-85443365-T-C,rs4832175,-1,T,C,85443365,115376,85131381,85524597,311984
2,ENSG00000214711.5,31217515,2-31219881-G-A,rs4952069,-1,G,A,31219881,2366,31020907,31414123,198974
2,ENSG00000214711.5,31217515,2-31219881-G-C,rs4952069,-1,G,C,31219881,2366,31020907,31414123,198974
2,ENSG00000162869.11,48440766,2-48546156-T-G,rs4952917,1,T,G,48546156,105390,48244158,48637374,301998
2,ENSG00000138095.13,43995989,2-43974237-T-A,rs4953042,-1,T,A,43974237,21752,43799381,44192597,174856
2,ENSG00000138095.13,43995989,2-43974237-T-C,rs4953042,-1,T,C,43974237,21752,43799381,44192597,174856
2,ENSG00000138095.13,43995989,2-43974237-T-G,rs4953042,-1,T,G,43974237,21752,43799381,44192597,174856
2,ENSG00000121966.5,136118149,2-136031909-C-T,rs4954553,-1,C,T,136031909,86240,135921541,136314757,110368
2,ENSG00000121966.5,136118149,2-136031909-C-G,rs4954553,-1,C,G,136031909,86240,135921541,136314757,110368
2,ENSG00000168280.12,148875227,2-148730699-C-T,rs4972391,1,C,T,148730699,144528,148678619,149071835,52080
2,ENSG00000168280.12,148875227,2-148730699-C-A,rs4972391,1,C,A,148730699,144528,148678619,149071835,52080
2,ENSG00000118961.9,20823101,2-20788639-T-G,rs535022,-1,T,G,20788639,34462,20626493,21019709,162146
2,ENSG00000118961.9,20823101,2-20788639-T-C,rs535022,-1,T,C,20788639,34462,20626493,21019709,162146
2,ENSG00000180228.8,178451175,2-178531435-C-G,rs56308529,-1,C,G,178531435,80260,178254567,178647783,276868
2,ENSG00000180228.8,178451175,2-178531435-C-A,rs56308529,-1,C,A,178531435,80260,178254567,178647783,276868
2,ENSG00000075886.9,131476119,2-131544182-T-C,rs60011031,1,T,C,131544182,68063,131279511,131672727,264671
2,ENSG00000198203.5,108288895,2-108258814-G-A,rs61743196,1,G,A,108258814,30081,108092287,108485503,166527
2,ENSG00000163798.9,27663471,2-27584547-C-G,rs62138961,1,C,G,27584547,78924,27466863,27860079,117684
2,ENSG00000138071.8,65227831,2-65271671-T-C,rs62139061,1,T,C,65271671,43840,65031223,65424439,240448
2,ENSG00000135638.8,72917519,2-73022759-C-T,rs62147729,1,C,T,73022759,105240,72720911,73114127,301848
2,ENSG00000115183.9,158968640,2-159114250-C-T,rs62171077,1,C,T,159114250,145610,158772032,159165248,342218
2,ENSG00000054219.9,159904756,2-159936394-T-C,rs62176715,-1,T,C,159936394,31638,159708148,160101364,228246
2,ENSG00000163040.10,131527888,2-131487580-A-G,rs62178980,1,A,G,131487580,40308,131331280,131724496,156300
2,ENSG00000163040.10,131527888,2-131487580-A-C,rs62178980,1,A,C,131487580,40308,131331280,131724496,156300
2,ENSG00000152133.9,37084518,2-37092013-A-C,rs62621388,1,A,C,37092013,7495,36887910,37281126,204103
2,ENSG00000162976.8,11155467,2-11160743-T-A,rs6432182,1,T,A,11160743,5276,10958859,11352075,201884
2,ENSG00000162976.8,11155467,2-11160743-T-G,rs6432182,1,T,G,11160743,5276,10958859,11352075,201884
2,ENSG00000162976.8,11155467,2-11160743-T-C,rs6432182,1,T,C,11160743,5276,10958859,11352075,201884
2,ENSG00000077380.11,171687469,2-171571895-C-T,rs6433299,1,C,T,171571895,115574,171490861,171884077,81034
2,ENSG00000188452.9,181657105,2-181775134-A-T,rs6433931,-1,A,T,181775134,118029,181460497,181853713,314637
2,ENSG00000188452.9,181657105,2-181775134-A-C,rs6433931,-1,A,C,181775134,118029,181460497,181853713,314637
2,ENSG00000177519.3,153478762,2-153660997-T-C,rs6434796,-1,T,C,153660997,182235,153282154,153675370,378843
2,ENSG00000177519.3,153478762,2-153660997-T-G,rs6434796,-1,T,G,153660997,182235,153282154,153675370,378843
2,ENSG00000177519.3,153478762,2-153660997-T-A,rs6434796,-1,T,A,153660997,182235,153282154,153675370,378843
2,ENSG00000163521.11,219245444,2-219309801-A-G,rs6436133,-1,A,G,219309801,64357,219048836,219442052,260965
2,ENSG00000123983.9,222861036,2-222945548-G-C,rs6436364,1,G,C,222945548,84512,222664428,223057644,281120
2,ENSG00000123983.9,222861036,2-222945548-G-A,rs6436364,1,G,A,222945548,84512,222664428,223057644,281120
2,ENSG00000123983.9,222861036,2-222945548-G-T,rs6436364,1,G,T,222945548,84512,222664428,223057644,281120
2,ENSG00000115687.9,241149472,2-241083115-G-C,rs6437235,-1,G,C,241083115,66357,240952864,241346080,130251
2,ENSG00000146205.9,241188677,2-241235916-T-G,rs6437249,1,T,G,241235916,47239,240992069,241385285,243847
2,ENSG00000146205.9,241188677,2-241235916-T-A,rs6437249,1,T,A,241235916,47239,240992069,241385285,243847
2,ENSG00000146205.9,241188677,2-241235916-T-C,rs6437249,1,T,C,241235916,47239,240992069,241385285,243847
2,ENSG00000115884.6,20225130,2-20188723-C-A,rs6531222,-1,C,A,20188723,36407,20028522,20421738,160201
2,ENSG00000169629.7,112433645,2-112434559-G-A,rs6542056,-1,G,A,112434559,914,112237037,112630253,197522
2,ENSG00000169629.7,112433645,2-112434559-G-C,rs6542056,-1,G,C,112434559,914,112237037,112630253,197522
2,ENSG00000219626.4,24123469,2-24108990-A-G,rs6545275,1,A,G,24108990,14479,23926861,24320077,182129
2,ENSG00000138035.9,55693844,2-55588861-T-C,rs6545508,-1,T,C,55588861,104983,55497236,55890452,91625
2,ENSG00000138035.9,55693844,2-55588861-T-A,rs6545508,-1,T,A,55588861,104983,55497236,55890452,91625
2,ENSG00000119866.15,60553654,2-60622286-T-C,rs6545824,-1,T,C,60622286,68632,60357046,60750262,265240
2,ENSG00000171951.3,223602361,2-223774745-G-A,rs664149,-1,G,A,223774745,172384,223405753,223798969,368992
2,ENSG00000171951.3,223602361,2-223774745-G-C,rs664149,-1,G,C,223774745,172384,223405753,223798969,368992
2,ENSG00000124357.7,71068648,2-71078326-C-G,rs6713,1,C,G,71078326,9678,70872040,71265256,206286
2,ENSG00000124357.7,71068648,2-71078326-C-A,rs6713,1,C,A,71078326,9678,70872040,71265256,206286
2,ENSG00000124357.7,71068648,2-71078326-C-T,rs6713,1,C,T,71078326,9678,70872040,71265256,206286
2,ENSG00000115353.5,75199520,2-75071228-T-G,rs6715414,-1,T,G,75071228,128292,75002912,75396128,68316
2,ENSG00000115353.5,75199520,2-75071228-T-A,rs6715414,-1,T,A,75071228,128292,75002912,75396128,68316
2,ENSG00000115353.5,75199520,2-75071228-T-C,rs6715414,-1,T,C,75071228,128292,75002912,75396128,68316
2,ENSG00000163026.7,24047391,2-24065843-T-C,rs6716256,-1,T,C,24065843,18452,23850783,24243999,215060
2,ENSG00000163026.7,24047391,2-24065843-T-G,rs6716256,-1,T,G,24065843,18452,23850783,24243999,215060
2,ENSG00000138061.7,38076151,2-37947821-A-G,rs6716296,-1,A,G,37947821,128330,37879543,38272759,68278
2,ENSG00000138061.7,38076151,2-37947821-A-T,rs6716296,-1,A,T,37947821,128330,37879543,38272759,68278
2,ENSG00000124380.6,69893956,2-69918318-A-T,rs6718298,1,A,T,69918318,24362,69697348,70090564,220970
2,ENSG00000124380.6,69893956,2-69918318-A-G,rs6718298,1,A,G,69918318,24362,69697348,70090564,220970
2,ENSG00000124380.6,69893956,2-69918318-A-C,rs6718298,1,A,C,69918318,24362,69697348,70090564,220970
2,ENSG00000023228.8,206159444,2-206101113-T-G,rs6718656,-1,T,G,206101113,58331,205962836,206356052,138277
2,ENSG00000168427.7,238138668,2-237961242-C-T,rs6723077,1,C,T,237961242,177426,237942060,238335276,19182
2,ENSG00000042445.9,85354528,2-85549032-A-G,rs6723678,-1,A,G,85549032,194504,85157920,85551136,391112
2,ENSG00000014641.13,63588963,2-63684366-C-T,rs6723875,1,C,T,63684366,95403,63392355,63785571,292011
2,ENSG00000178662.10,165469698,2-165660141-G-A,rs6724507,1,G,A,165660141,190443,165273090,165666306,387051
2,ENSG00000178662.10,165469698,2-165660141-G-C,rs6724507,1,G,C,165660141,190443,165273090,165666306,387051
2,ENSG00000178662.10,165469698,2-165660141-G-T,rs6724507,1,G,T,165660141,190443,165273090,165666306,387051
2,ENSG00000143970.11,25878487,2-25927904-T-G,rs6728684,-1,T,G,25927904,49417,25681879,26075095,246025
2,ENSG00000128641.12,191245404,2-191222164-A-T,rs6728759,1,A,T,191222164,23240,191048796,191442012,173368
2,ENSG00000128641.12,191245404,2-191222164-A-G,rs6728759,1,A,G,191222164,23240,191048796,191442012,173368
2,ENSG00000061676.9,183038457,2-182947171-T-C,rs6730183,-1,T,C,182947171,91286,182841849,183235065,105322
2,ENSG00000171132.9,45651675,2-45472462-C-T,rs6730610,1,C,T,45472462,179213,45455067,45848283,17395
2,ENSG00000171132.9,45651675,2-45472462-C-A,rs6730610,1,C,A,45472462,179213,45455067,45848283,17395
2,ENSG00000171132.9,45651675,2-45472462-C-G,rs6730610,1,C,G,45472462,179213,45455067,45848283,17395
2,ENSG00000115159.10,156436379,2-156433844-T-C,rs6732240,1,T,C,156433844,2535,156239771,156632987,194073
2,ENSG00000136731.8,128091200,2-128250758-A-C,rs6733201,1,A,C,128250758,159558,127894592,128287808,356166
2,ENSG00000118640.6,85577586,2-85600891-T-G,rs6733550,1,T,G,85600891,23305,85380978,85774194,219913
2,ENSG00000213337.4,96858016,2-96903568-G-A,rs6733826,-1,G,A,96903568,45552,96661408,97054624,242160
2,ENSG00000153832.7,229922503,2-230026935-G-A,rs6737871,1,G,A,230026935,104432,229725895,230119111,301040
2,ENSG00000153832.7,229922503,2-230026935-G-T,rs6737871,1,G,T,230026935,104432,229725895,230119111,301040
2,ENSG00000115756.8,10302904,2-10336406-T-C,rs6745569,1,T,C,10336406,33502,10106296,10499512,230110
2,ENSG00000115756.8,10302904,2-10336406-T-A,rs6745569,1,T,A,10336406,33502,10106296,10499512,230110
2,ENSG00000135898.5,230925242,2-230932834-C-T,rs6750171,-1,C,T,230932834,7592,230728634,231121850,204200
2,ENSG00000128708.8,171922461,2-172028627-A-G,rs6751078,1,A,G,172028627,106166,171725853,172119069,302774
2,ENSG00000128708.8,171922461,2-172028627-A-C,rs6751078,1,A,C,172028627,106166,171725853,172119069,302774
2,ENSG00000075884.8,143129419,2-143269422-G-C,rs6751190,1,G,C,143269422,140003,142932811,143326027,336611
2,ENSG00000075884.8,143129419,2-143269422-G-T,rs6751190,1,G,T,143269422,140003,142932811,143326027,336611
2,ENSG00000144120.7,119679201,2-119731062-A-G,rs6757316,1,A,G,119731062,51861,119482593,119875809,248469
2,ENSG00000132313.9,86199457,2-86235624-G-A,rs6758173,1,G,A,86235624,36167,86002849,86396065,232775
2,ENSG00000153094.15,111120914,2-111097681-A-C,rs6759108,1,A,C,111097681,23233,110924306,111317522,173375
2,ENSG00000153094.15,111120914,2-111097681-A-T,rs6759108,1,A,T,111097681,23233,110924306,111317522,173375
2,ENSG00000071967.7,171522474,2-171524288-A-G,rs6759240,1,A,G,171524288,1814,171325866,171719082,198422
2,ENSG00000138079.8,44275480,2-44361802-G-A,rs698775,1,G,A,44361802,86322,44078872,44472088,282930
2,ENSG00000144045.9,74526231,2-74575838-C-T,rs72818091,-1,C,T,74575838,49607,74329623,74722839,246215
2,ENSG00000197223.7,68063004,2-68001109-T-G,rs72819681,-1,T,G,68001109,61895,67866396,68259612,134713
2,ENSG00000197223.7,68063004,2-68001109-T-C,rs72819681,-1,T,C,68001109,61895,67866396,68259612,134713
2,ENSG00000196862.7,107826892,2-107999828-T-C,rs72826951,1,T,C,107999828,172936,107630284,108023500,369544
2,ENSG00000163072.10,168802637,2-168793331-G-T,rs72881773,1,G,T,168793331,9306,168606029,168999245,187302
2,ENSG00000163072.10,168802637,2-168793331-G-A,rs72881773,1,G,A,168793331,9306,168606029,168999245,187302
2,ENSG00000123600.13,171433990,2-171559866-A-G,rs72885917,-1,A,G,171559866,125876,171237382,171630598,322484
2,ENSG00000123600.13,171433990,2-171559866-A-C,rs72885917,-1,A,C,171559866,125876,171237382,171630598,322484
2,ENSG00000204923.2,68467294,2-68436367-A-C,rs72900012,-1,A,C,68436367,30927,68270686,68663902,165681
2,ENSG00000204923.2,68467294,2-68436367-A-T,rs72900012,-1,A,T,68436367,30927,68270686,68663902,165681
2,ENSG00000136542.4,157257705,2-157237323-G-A,rs72918706,1,G,A,157237323,20382,157061097,157454313,176226
2,ENSG00000176946.6,241637158,2-241506924-G-A,rs73008138,-1,G,A,241506924,130234,241440550,241833766,66374
2,ENSG00000176946.6,241637158,2-241506924-G-T,rs73008138,-1,G,T,241506924,130234,241440550,241833766,66374
2,ENSG00000156973.9,231781282,2-231662713-G-A,rs73097980,-1,G,A,231662713,118569,231584674,231977890,78039
2,ENSG00000156973.9,231781282,2-231662713-G-T,rs73097980,-1,G,T,231662713,118569,231584674,231977890,78039
2,ENSG00000221944.3,232550557,2-232523601-C-T,rs733602,-1,C,T,232523601,26956,232353949,232747165,169652
2,ENSG00000198925.6,219229636,2-219265263-C-T,rs73991446,-1,C,T,219265263,35627,219033028,219426244,232235
2,ENSG00000198925.6,219229636,2-219265263-C-G,rs73991446,-1,C,G,219265263,35627,219033028,219426244,232235
2,ENSG00000198925.6,219229636,2-219265263-C-A,rs73991446,-1,C,A,219265263,35627,219033028,219426244,232235
2,ENSG00000162994.11,55232293,2-55222276-C-G,rs74785222,-1,C,G,55222276,10017,55035685,55428901,186591
2,ENSG00000162994.11,55232293,2-55222276-C-A,rs74785222,-1,C,A,55222276,10017,55035685,55428901,186591
2,ENSG00000162994.11,55232293,2-55222276-C-T,rs74785222,-1,C,T,55222276,10017,55035685,55428901,186591
2,ENSG00000115129.9,24084834,2-24139658-T-C,rs75208176,-1,T,C,24139658,54824,23888226,24281442,251432
2,ENSG00000170396.6,184598529,2-184539611-G-A,rs75254889,1,G,A,184539611,58918,184401921,184795137,137690
2,ENSG00000144355.10,172085507,2-172252235-A-G,rs75390055,1,A,G,172252235,166728,171888899,172282115,363336
2,ENSG00000168397.11,241637693,2-241569597-A-C,rs7558942,1,A,C,241569597,68096,241441085,241834301,128512
2,ENSG00000168397.11,241637693,2-241569597-A-G,rs7558942,1,A,G,241569597,68096,241441085,241834301,128512
2,ENSG00000136717.10,127107154,2-127132061-G-A,rs7561528,-1,G,A,127132061,24907,126910546,127303762,221515
2,ENSG00000152518.5,43226606,2-43279120-G-C,rs7561670,-1,G,C,43279120,52514,43029998,43423214,249122
2,ENSG00000152518.5,43226606,2-43279120-G-A,rs7561670,-1,G,A,43279120,52514,43029998,43423214,249122
2,ENSG00000213160.4,169733832,2-169727369-G-T,rs7562456,1,G,T,169727369,6463,169537224,169930440,190145
2,ENSG00000213160.4,169733832,2-169727369-G-C,rs7562456,1,G,C,169727369,6463,169537224,169930440,190145
2,ENSG00000213160.4,169733832,2-169727369-G-A,rs7562456,1,G,A,169727369,6463,169537224,169930440,190145
2,ENSG00000119888.6,47369311,2-47196329-A-C,rs75631562,1,A,C,47196329,172982,47172703,47565919,23626
2,ENSG00000243244.1,48530154,2-48498268-T-G,rs7566996,1,T,G,48498268,31886,48333546,48726762,164722
2,ENSG00000138439.10,202634969,2-202718531-G-A,rs7571219,1,G,A,202718531,83562,202438361,202831577,280170
2,ENSG00000155438.6,121736875,2-121821936-T-G,rs7571542,-1,T,G,121821936,85061,121540267,121933483,281669
2,ENSG00000155438.6,121736875,2-121821936-T-A,rs7571542,-1,T,A,121821936,85061,121540267,121933483,281669
2,ENSG00000138378.13,191150994,2-191150346-A-G,rs7572482,-1,A,G,191150346,648,190954386,191347602,195960
2,ENSG00000138378.13,191150994,2-191150346-A-C,rs7572482,-1,A,C,191150346,648,190954386,191347602,195960
2,ENSG00000168890.9,85602698,2-85420498-C-A,rs75770276,-1,C,A,85420498,182200,85406090,85799306,14408
2,ENSG00000168890.9,85602698,2-85420498-C-T,rs75770276,-1,C,T,85420498,182200,85406090,85799306,14408
2,ENSG00000115364.9,75646783,2-75660453-C-T,rs7577196,1,C,T,75660453,13670,75450175,75843391,210278
2,ENSG00000084710.8,25042076,2-25230181-G-A,rs75781902,1,G,A,25230181,188105,24845468,25238684,384713
2,ENSG00000157833.7,26173088,2-26316938-A-G,rs75819301,1,A,G,26316938,143850,25976480,26369696,340458
2,ENSG00000072163.12,127675530,2-127532280-G-A,rs7582598,-1,G,A,127532280,143250,127478922,127872138,53358
2,ENSG00000144485.6,238240038,2-238225422-G-T,rs7584376,-1,G,T,238225422,14616,238043430,238436646,181992
2,ENSG00000115306.10,54456327,2-54501139-G-A,rs7588499,1,G,A,54501139,44812,54259719,54652935,241420
2,ENSG00000115306.10,54456327,2-54501139-G-C,rs7588499,1,G,C,54501139,44812,54259719,54652935,241420
2,ENSG00000115306.10,54456327,2-54501139-G-T,rs7588499,1,G,T,54501139,44812,54259719,54652935,241420
2,ENSG00000169621.5,68467585,2-68420607-C-T,rs7595749,1,C,T,68420607,46978,68270977,68664193,149630
2,ENSG00000135912.6,218710835,2-218801240-G-A,rs7600248,1,G,A,218801240,90405,218514227,218907443,287013
2,ENSG00000204128.5,231037523,2-231053352-G-A,rs7608781,1,G,A,231053352,15829,230840915,231234131,212437
2,ENSG00000204128.5,231037523,2-231053352-G-C,rs7608781,1,G,C,231053352,15829,230840915,231234131,212437
2,ENSG00000115946.3,68157888,2-68292883-G-A,rs76173079,1,G,A,68292883,134995,67961280,68354496,331603
2,ENSG00000115946.3,68157888,2-68292883-G-T,rs76173079,1,G,T,68292883,134995,67961280,68354496,331603
2,ENSG00000144118.8,120252852,2-120287271-T-C,rs76316712,1,T,C,120287271,34419,120056244,120449460,231027
2,ENSG00000226124.2,199851192,2-199869645-C-T,rs769952,-1,C,T,199869645,18453,199654584,200047800,215061
2,ENSG00000226124.2,199851192,2-199869645-C-A,rs769952,-1,C,A,199869645,18453,199654584,200047800,215061
2,ENSG00000226124.2,199851192,2-199869645-C-G,rs769952,-1,C,G,199869645,18453,199654584,200047800,215061
2,ENSG00000168288.7,149587775,2-149750922-G-A,rs77214271,-1,G,A,149750922,163147,149391167,149784383,359755
2,ENSG00000115155.11,26558756,2-26736699-G-T,rs77244720,-1,G,T,26736699,177943,26362148,26755364,374551
2,ENSG00000155749.8,201357345,2-201504465-C-T,rs77508965,-1,C,T,201504465,147120,201160737,201553953,343728
2,ENSG00000155749.8,201357345,2-201504465-C-G,rs77508965,-1,C,G,201504465,147120,201160737,201553953,343728
2,ENSG00000124356.10,73828961,2-73707517-G-C,rs78071540,1,G,C,73707517,121444,73632353,74025569,75164
2,ENSG00000124356.10,73828961,2-73707517-G-A,rs78071540,1,G,A,73707517,121444,73632353,74025569,75164
2,ENSG00000243910.3,219253243,2-219300805-C-T,rs79047930,1,C,T,219300805,47562,219056635,219449851,244170
2,ENSG00000151779.8,15561334,2-15638128-A-G,rs79055811,-1,A,G,15638128,76794,15364726,15757942,273402
2,ENSG00000151779.8,15561334,2-15638128-A-C,rs79055811,-1,A,C,15638128,76794,15364726,15757942,273402
2,ENSG00000143882.5,10721630,2-10800512-T-C,rs79135340,1,T,C,10800512,78882,10525022,10918238,275490
2,ENSG00000114999.6,112482156,2-112310045-A-G,rs79245040,1,A,G,112310045,172111,112285548,112678764,24497
2,ENSG00000170802.9,48314682,2-48327816-G-A,rs79247094,1,G,A,48327816,13134,48118074,48511290,209742
2,ENSG00000170802.9,48314682,2-48327816-G-C,rs79247094,1,G,C,48327816,13134,48118074,48511290,209742
2,ENSG00000163803.8,28496060,2-28577160-C-T,rs80005535,1,C,T,28577160,81100,28299452,28692668,277708
2,ENSG00000172954.8,30447246,2-30438850-A-T,rs829689,1,A,T,30438850,8396,30250638,30643854,188212
2,ENSG00000172954.8,30447246,2-30438850-A-G,rs829689,1,A,G,30438850,8396,30250638,30643854,188212
2,ENSG00000152253.4,168890430,2-168949811-A-T,rs853781,-1,A,T,168949811,59381,168693822,169087038,255989
2,ENSG00000152253.4,168890430,2-168949811-A-G,rs853781,-1,A,G,168949811,59381,168693822,169087038,255989
2,ENSG00000068024.11,239401020,2-239394311-T-G,rs870790,-1,T,G,239394311,6709,239204412,239597628,189899
2,ENSG00000068024.11,239401020,2-239394311-T-C,rs870790,-1,T,C,239394311,6709,239204412,239597628,189899
2,ENSG00000119771.10,23385179,2-23361694-C-T,rs875077,1,C,T,23361694,23485,23188571,23581787,173123
2,ENSG00000125629.10,118088471,2-118102895-C-T,rs889904,1,C,T,118102895,14424,117891863,118285079,211032
2,ENSG00000115423.13,84516498,2-84328282-T-C,rs897315,1,T,C,84328282,188216,84319890,84713106,8392
2,ENSG00000124370.6,71130229,2-71152220-C-G,rs898123,-1,C,G,71152220,21991,70933621,71326837,218599
2,ENSG00000124370.6,71130229,2-71152220-C-A,rs898123,-1,C,A,71152220,21991,70933621,71326837,218599
2,ENSG00000162882.10,42792583,2-42754099-A-G,rs930421,-1,A,G,42754099,38484,42595975,42989191,158124
2,ENSG00000091436.12,173075846,2-173068890-C-T,rs989531,1,C,T,173068890,6956,172879238,173272454,189652
2,ENSG00000003393.10,201780933,2-201800336-A-T,rs9973862,-1,A,T,201800336,19403,201584325,201977541,216011
2,ENSG00000003393.10,201780933,2-201800336-A-C,rs9973862,-1,A,C,201800336,19403,201584325,201977541,216011
2,ENSG00000135631.11,73112948,2-72930266-C-T,rs999494,-1,C,T,72930266,182682,72916340,73309556,13926
2,ENSG00000188542.5,240560357,2-240519192-A-G,rs10165759,1,A,G,240519192,41165,240363749,240756965,155443
2,ENSG00000123992.13,219387912,2-219380567-G-C,rs10175511,-1,G,C,219380567,7345,219191304,219584520,189263
2,ENSG00000123992.13,219387912,2-219380567-G-T,rs10175511,-1,G,T,219380567,7345,219191304,219584520,189263
2,ENSG00000123992.13,219387912,2-219380567-G-A,rs10175511,-1,G,A,219380567,7345,219191304,219584520,189263
2,ENSG00000138018.13,26346143,2-26412460-A-C,rs10179397,1,A,C,26412460,66317,26149535,26542751,262925
2,ENSG00000138018.13,26346143,2-26412460-A-G,rs10179397,1,A,G,26412460,66317,26149535,26542751,262925
2,ENSG00000169994.13,127535683,2-127625082-G-A,rs10180750,1,G,A,127625082,89399,127339075,127732291,286007
2,ENSG00000115590.9,101991960,2-102046427-T-G,rs10185424,1,T,G,102046427,54467,101795352,102188568,251075
2,ENSG00000136717.10,127107154,2-127082205-C-T,rs10194375,-1,C,T,127082205,24949,126910546,127303762,171659
2,ENSG00000136717.10,127107154,2-127082205-C-A,rs10194375,-1,C,A,127082205,24949,126910546,127303762,171659
2,ENSG00000116120.8,222656092,2-222653432-A-G,rs10194743,-1,A,G,222653432,2660,222459484,222852700,193948
2,ENSG00000116120.8,222656092,2-222653432-A-T,rs10194743,-1,A,T,222653432,2660,222459484,222852700,193948
2,ENSG00000153253.10,165204050,2-165311559-G-A,rs10199969,-1,G,A,165311559,107509,165007442,165400658,304117
2,ENSG00000115884.6,20225130,2-20145127-T-C,rs10205345,-1,T,C,20145127,80003,20028522,20421738,116605
2,ENSG00000115884.6,20225130,2-20145127-T-G,rs10205345,-1,T,G,20145127,80003,20028522,20421738,116605
2,ENSG00000135925.4,218880852,2-218809056-C-A,rs10206109,1,C,A,218809056,71796,218684244,219077460,124812
2,ENSG00000135925.4,218880852,2-218809056-C-T,rs10206109,1,C,T,218809056,71796,218684244,219077460,124812
2,ENSG00000115816.8,37231596,2-37226486-T-A,rs10209937,-1,T,A,37226486,5110,37034988,37428204,191498
2,ENSG00000115816.8,37231596,2-37226486-T-C,rs10209937,-1,T,C,37226486,5110,37034988,37428204,191498
2,ENSG00000138439.10,202634969,2-202692428-T-C,rs1039968,1,T,C,202692428,57459,202438361,202831577,254067
2,ENSG00000168899.4,85584431,2-85599009-G-C,rs1044158,1,G,C,85599009,14578,85387823,85781039,211186
2,ENSG00000168899.4,85584431,2-85599009-G-A,rs1044158,1,G,A,85599009,14578,85387823,85781039,211186
2,ENSG00000071967.7,171522474,2-171554763-G-C,rs10455,1,G,C,171554763,32289,171325866,171719082,228897
2,ENSG00000071967.7,171522474,2-171554763-G-A,rs10455,1,G,A,171554763,32289,171325866,171719082,228897
2,ENSG00000118246.9,206765606,2-206792429-T-G,rs1048783,1,T,G,206792429,26823,206568998,206962214,223431
2,ENSG00000118246.9,206765606,2-206792429-T-A,rs1048783,1,T,A,206792429,26823,206568998,206962214,223431
2,ENSG00000118246.9,206765606,2-206792429-T-C,rs1048783,1,T,C,206792429,26823,206568998,206962214,223431
2,ENSG00000119185.8,9423528,2-9524572-A-G,rs10495564,-1,A,G,9524572,101044,9226920,9620136,297652
2,ENSG00000116127.13,73385836,2-73445501-C-T,rs10519309,1,C,T,73445501,59665,73189228,73582444,256273
2,ENSG00000115084.8,113756642,2-113714344-A-G,rs1053413,-1,A,G,113714344,42298,113560034,113953250,154310
2,ENSG00000115084.8,113756642,2-113714344-A-C,rs1053413,-1,A,C,113714344,42298,113560034,113953250,154310
2,ENSG00000169554.9,144520119,2-144493390-C-G,rs1060451,-1,C,G,144493390,26729,144323511,144716727,169879
2,ENSG00000144320.8,176002267,2-176153143-C-T,rs1063657,-1,C,T,176153143,150876,175805659,176198875,347484
2,ENSG00000144320.8,176002267,2-176153143-C-G,rs1063657,-1,C,G,176153143,150876,175805659,176198875,347484
2,ENSG00000183891.5,19901983,2-20008651-G-A,rs10856792,-1,G,A,20008651,106668,19705375,20098591,303276
2,ENSG00000159399.4,74834127,2-74894518-C-T,rs10865404,1,C,T,74894518,60391,74637519,75030735,256999
2,ENSG00000143797.7,9003684,2-9109909-C-G,rs1109670,-1,C,G,9109909,106225,8807076,9200292,302833
2,ENSG00000143797.7,9003684,2-9109909-C-A,rs1109670,-1,C,A,9109909,106225,8807076,9200292,302833
2,ENSG00000138095.13,43995989,2-43930302-T-C,rs11124952,-1,T,C,43930302,65687,43799381,44192597,130921
2,ENSG00000119866.15,60553654,2-60400430-A-C,rs11125841,-1,A,C,60400430,153224,60357046,60750262,43384
2,ENSG00000119866.15,60553654,2-60400430-A-G,rs11125841,-1,A,G,60400430,153224,60357046,60750262,43384
2,ENSG00000115902.5,64989399,2-64940327-G-A,rs11126024,1,G,A,64940327,49072,64792791,65186007,147536
2,ENSG00000168874.8,85753991,2-85751663-G-C,rs11126998,1,G,C,85751663,2328,85557383,85950599,194280
2,ENSG00000168874.8,85753991,2-85751663-G-A,rs11126998,1,G,A,85751663,2328,85557383,85950599,194280
2,ENSG00000115274.10,74455087,2-74261343-G-A,rs112250416,1,G,A,74261343,193744,74258479,74651695,2864
2,ENSG00000115274.10,74455087,2-74261343-G-T,rs112250416,1,G,T,74261343,193744,74258479,74651695,2864
2,ENSG00000196862.7,107826892,2-107982054-G-A,rs112263283,1,G,A,107982054,155162,107630284,108023500,351770
2,ENSG00000168894.5,85595745,2-85596916-G-A,rs1127974,1,G,A,85596916,1171,85399137,85792353,197779
2,ENSG00000132330.12,238061001,2-238091242-T-C,rs1128552,1,T,C,238091242,30241,237864393,238257609,226849
2,ENSG00000132313.9,86199457,2-86038617-G-A,rs114068877,1,G,A,86038617,160840,86002849,86396065,35768
2,ENSG00000163002.8,183124443,2-183150237-G-C,rs114252768,1,G,C,183150237,25794,182927835,183321051,222402
2,ENSG00000071575.7,12716936,2-12582851-G-A,rs114373544,1,G,A,12582851,134085,12520328,12913544,62523
2,ENSG00000115155.11,26558756,2-26574051-G-A,rs1148949,-1,G,A,26574051,15295,26362148,26755364,211903
2,ENSG00000163121.5,96505357,2-96501606-C-T,rs116097873,-1,C,T,96501606,3751,96308749,96701965,192857
2,ENSG00000115963.9,150487667,2-150403900-C-T,rs116420912,-1,C,T,150403900,83767,150291059,150684275,112841
2,ENSG00000239474.2,169509702,2-169508120-C-T,rs116649447,1,C,T,169508120,1582,169313094,169706310,195026
2,ENSG00000115364.9,75646783,2-75602333-C-T,rs11675652,1,C,T,75602333,44450,75450175,75843391,152158
2,ENSG00000184182.14,237967014,2-237894836-A-G,rs11675972,1,A,G,237894836,72178,237770406,238163622,124430
2,ENSG00000184182.14,237967014,2-237894836-A-C,rs11675972,1,A,C,237894836,72178,237770406,238163622,124430
2,ENSG00000184182.14,237967014,2-237894836-A-T,rs11675972,1,A,T,237894836,72178,237770406,238163622,124430
2,ENSG00000163811.7,28894667,2-28985790-C-G,rs11676763,1,C,G,28985790,91123,28698059,29091275,287731
2,ENSG00000163811.7,28894667,2-28985790-C-T,rs11676763,1,C,T,28985790,91123,28698059,29091275,287731
2,ENSG00000163162.4,101308701,2-101349576-C-A,rs11677690,-1,C,A,101349576,40875,101112093,101505309,237483
2,ENSG00000134317.13,9951693,2-9808205-G-A,rs11682963,1,G,A,9808205,143488,9755085,10148301,53120
2,ENSG00000179833.3,64653913,2-64800490-T-C,rs11683197,-1,T,C,64800490,146577,64457305,64850521,343185
2,ENSG00000115677.12,241315672,2-241370759-T-C,rs11684105,-1,T,C,241370759,55087,241119064,241512280,251695
2,ENSG00000183281.10,87021844,2-86855556-C-T,rs11688534,-1,C,T,86855556,166288,86825236,87218452,30320
2,ENSG00000183281.10,87021844,2-86855556-C-A,rs11688534,-1,C,A,86855556,166288,86825236,87218452,30320
2,ENSG00000183281.10,87021844,2-86855556-C-G,rs11688534,-1,C,G,86855556,166288,86825236,87218452,30320
2,ENSG00000115109.9,120013077,2-119871922-C-T,rs11689019,1,C,T,119871922,141155,119816469,120209685,55453
2,ENSG00000075426.7,28392858,2-28402266-G-C,rs11689770,1,G,C,28402266,9408,28196250,28589466,206016
2,ENSG00000075426.7,28392858,2-28402266-G-T,rs11689770,1,G,T,28402266,9408,28196250,28589466,206016
2,ENSG00000150540.9,137964473,2-137881427-T-C,rs11691636,1,T,C,137881427,83046,137767865,138161081,113562
2,ENSG00000173272.9,131492397,2-131583496-T-G,rs11692870,-1,T,G,131583496,91099,131295789,131689005,287707
2,ENSG00000173272.9,131492397,2-131583496-T-C,rs11692870,-1,T,C,131583496,91099,131295789,131689005,287707
2,ENSG00000163466.11,218217189,2-218203380-C-T,rs11695527,1,C,T,218203380,13809,218020581,218413797,182799
2,ENSG00000172878.8,171999953,2-171986638-T-C,rs11695630,1,T,C,171986638,13315,171803345,172196561,183293
2,ENSG00000162929.9,61065871,2-61086885-G-A,rs1177301,1,G,A,61086885,21014,60869263,61262479,217622
2,ENSG00000138031.8,24920237,2-24896544-C-T,rs11884570,-1,C,T,24896544,23693,24723629,25116845,172915
2,ENSG00000144034.10,73737345,2-73874206-A-G,rs11886615,-1,A,G,73874206,136861,73540737,73933953,333469
2,ENSG00000127824.9,219253918,2-219295355-T-C,rs11887718,-1,T,C,219295355,41437,219057310,219450526,238045
2,ENSG00000127824.9,219253918,2-219295355-T-A,rs11887718,-1,T,A,219295355,41437,219057310,219450526,238045
2,ENSG00000168280.12,148875227,2-149063450-C-T,rs11888894,1,C,T,149063450,188223,148678619,149071835,384831
2,ENSG00000144115.11,88170346,2-88203796-G-C,rs11894676,1,G,C,88203796,33450,87973738,88366954,230058
2,ENSG00000144115.11,88170346,2-88203796-G-T,rs11894676,1,G,T,88203796,33450,87973738,88366954,230058
2,ENSG00000196504.10,152717981,2-152593615-C-T,rs11898643,-1,C,T,152593615,124366,152521373,152914589,72242
2,ENSG00000118997.8,196068837,2-196028704-G-C,rs11901422,-1,G,C,196028704,40133,195872229,196265445,156475
2,ENSG00000061676.9,183038457,2-182881029-C-A,rs12104437,-1,C,A,182881029,157428,182841849,183235065,39180
2,ENSG00000061676.9,183038457,2-182881029-C-T,rs12104437,-1,C,T,182881029,157428,182841849,183235065,39180
2,ENSG00000169629.7,112433645,2-112464923-C-T,rs12463408,-1,C,T,112464923,31278,112237037,112630253,227886
2,ENSG00000169629.7,112433645,2-112464923-C-G,rs12463408,-1,C,G,112464923,31278,112237037,112630253,227886
2,ENSG00000085760.8,55269231,2-55100414-G-T,rs12464877,-1,G,T,55100414,168817,55072623,55465839,27791
2,ENSG00000114942.9,206159895,2-206218906-C-T,rs12468934,1,C,T,206218906,59011,205963287,206356503,255619
2,ENSG00000114942.9,206159895,2-206218906-C-G,rs12468934,1,C,G,206218906,59011,205963287,206356503,255619
2,ENSG00000114942.9,206159895,2-206218906-C-A,rs12468934,1,C,A,206218906,59011,205963287,206356503,255619
2,ENSG00000168385.12,241315925,2-241249816-T-C,rs12475607,1,T,C,241249816,66109,241119317,241512533,130499
2,ENSG00000187627.9,86942118,2-86816672-A-G,rs12477946,1,A,G,86816672,125446,86745510,87138726,71162
2,ENSG00000135976.11,97113153,2-96973398-T-C,rs1257017,1,T,C,96973398,139755,96916545,97309761,56853
2,ENSG00000124370.6,71130229,2-70975503-C-T,rs12616710,-1,C,T,70975503,154726,70933621,71326837,41882
2,ENSG00000124380.6,69893956,2-69753894-A-G,rs12622388,1,A,G,69753894,140062,69697348,70090564,56546
2,ENSG00000125538.7,112836779,2-112731678-C-T,rs12622683,-1,C,T,112731678,105101,112640171,113033387,91507
2,ENSG00000125538.7,112836779,2-112731678-C-G,rs12622683,-1,C,G,112731678,105101,112640171,113033387,91507
2,ENSG00000138092.6,24793425,2-24898984-G-T,rs12713419,1,G,T,24898984,105559,24596817,24990033,302167
2,ENSG00000138092.6,24793425,2-24898984-G-C,rs12713419,1,G,C,24898984,105559,24596817,24990033,302167
2,ENSG00000138092.6,24793425,2-24898984-G-A,rs12713419,1,G,A,24898984,105559,24596817,24990033,302167
2,ENSG00000153094.15,111120914,2-111052704-A-G,rs13000374,1,A,G,111052704,68210,110924306,111317522,128398
2,ENSG00000119878.5,46617215,2-46493393-G-C,rs13001507,1,G,C,46493393,123822,46420607,46813823,72786
2,ENSG00000119878.5,46617215,2-46493393-G-A,rs13001507,1,G,A,46493393,123822,46420607,46813823,72786
2,ENSG00000028116.11,58046806,2-58110951-A-G,rs13011711,1,A,G,58110951,64145,57850198,58243414,260753
2,ENSG00000003402.12,201116164,2-201044792-A-G,rs13015798,1,A,G,201044792,71372,200919556,201312772,125236
2,ENSG00000003402.12,201116164,2-201044792-A-T,rs13015798,1,A,T,201044792,71372,200919556,201312772,125236
2,ENSG00000118257.11,205682501,2-205643415-T-G,rs13023594,1,T,G,205643415,39086,205485893,205879109,157522
2,ENSG00000118257.11,205682501,2-205643415-T-C,rs13023594,1,T,C,205643415,39086,205485893,205879109,157522
2,ENSG00000125611.11,112584609,2-112622537-A-T,rs13025131,1,A,T,112622537,37928,112388001,112781217,234536
2,ENSG00000125611.11,112584609,2-112622537-A-G,rs13025131,1,A,G,112622537,37928,112388001,112781217,234536
2,ENSG00000115649.11,219176925,2-219170396-C-A,rs13029742,-1,C,A,219170396,6529,218980317,219373533,190079
2,ENSG00000115073.5,97664044,2-97712734-C-T,rs13034349,-1,C,T,97712734,48690,97467436,97860652,245298
2,ENSG00000115073.5,97664044,2-97712734-C-G,rs13034349,-1,C,G,97712734,48690,97467436,97860652,245298
2,ENSG00000125629.10,118088471,2-118149540-A-T,rs13036218,1,A,T,118149540,61069,117891863,118285079,257677
2,ENSG00000125629.10,118088471,2-118149540-A-C,rs13036218,1,A,C,118149540,61069,117891863,118285079,257677
2,ENSG00000151353.10,677406,2-692784-G-A,rs1320334,-1,G,A,692784,15378,480798,874014,211986
2,ENSG00000151353.10,677406,2-692784-G-C,rs1320334,-1,G,C,692784,15378,480798,874014,211986
2,ENSG00000115756.8,10302904,2-10416967-G-A,rs13383253,1,G,A,10416967,114063,10106296,10499512,310671
2,ENSG00000115756.8,10302904,2-10416967-G-C,rs13383253,1,G,C,10416967,114063,10106296,10499512,310671
2,ENSG00000135914.4,231125042,2-231104206-G-T,rs13394402,-1,G,T,231104206,20836,230928434,231321650,175772
2,ENSG00000144043.7,70994873,2-70941227-T-C,rs13399615,-1,T,C,70941227,53646,70798265,71191481,142962
2,ENSG00000116096.5,72887408,2-72992678-G-T,rs13401894,1,G,T,72992678,105270,72690800,73084016,301878
2,ENSG00000116096.5,72887408,2-72992678-G-A,rs13401894,1,G,A,72992678,105270,72690800,73084016,301878
2,ENSG00000115827.8,171434226,2-171596395-G-A,rs13405265,1,G,A,171596395,162169,171237618,171630834,358777
2,ENSG00000077380.11,171687469,2-171517885-T-C,rs13406777,1,T,C,171517885,169584,171490861,171884077,27024
2,ENSG00000077380.11,171687469,2-171517885-T-G,rs13406777,1,T,G,171517885,169584,171490861,171884077,27024
2,ENSG00000077380.11,171687469,2-171517885-T-A,rs13406777,1,T,A,171517885,169584,171490861,171884077,27024
2,ENSG00000182551.7,3519531,2-3671102-C-T,rs13409104,-1,C,T,3671102,151571,3322923,3716139,348179
2,ENSG00000182551.7,3519531,2-3671102-C-A,rs13409104,-1,C,A,3671102,151571,3322923,3716139,348179
2,ENSG00000072135.7,130356056,2-130369588-T-C,rs13414462,1,T,C,130369588,13532,130159448,130552664,210140
2,ENSG00000032389.8,3377818,2-3254551-G-T,rs13419506,-1,G,T,3254551,123267,3181210,3574426,73341
2,ENSG00000204120.9,232697331,2-232661387-G-A,rs13424032,1,G,A,232661387,35944,232500723,232893939,160664
2,ENSG00000124374.8,71227103,2-71398637-G-A,rs13424541,-1,G,A,71398637,171534,71030495,71423711,368142
2,ENSG00000124374.8,71227103,2-71398637-G-T,rs13424541,-1,G,T,71398637,171534,71030495,71423711,368142
2,ENSG00000135945.5,99490017,2-99524566-C-T,rs1376444,-1,C,T,99524566,34549,99293409,99686625,231157
2,ENSG00000153246.7,160062615,2-159872623-A-C,rs1397705,-1,A,C,159872623,189992,159866007,160259223,6616
2,ENSG00000153246.7,160062615,2-159872623-A-T,rs1397705,-1,A,T,159872623,189992,159866007,160259223,6616
2,ENSG00000115414.13,215436068,2-215274650-C-A,rs1404774,-1,C,A,215274650,161418,215239460,215632676,35190
2,ENSG00000006607.8,241356285,2-241228073-A-C,rs14345,1,A,C,241228073,128212,241159677,241552893,68396
2,ENSG00000162994.11,55232293,2-55219220-A-C,rs1437391,-1,A,C,55219220,13073,55035685,55428901,183535
2,ENSG00000162994.11,55232293,2-55219220-A-G,rs1437391,-1,A,G,55219220,13073,55035685,55428901,183535
2,ENSG00000162994.11,55232293,2-55219220-A-T,rs1437391,-1,A,T,55219220,13073,55035685,55428901,183535
2,ENSG00000138378.13,191150994,2-191215374-G-A,rs1454759,-1,G,A,191215374,64380,190954386,191347602,260988
2,ENSG00000079150.12,178478600,2-178397705-G-A,rs1560870,-1,G,A,178397705,80895,178281992,178675208,115713
2,ENSG00000082126.11,201698644,2-201862313-G-T,rs16838316,-1,G,T,201862313,163669,201502036,201895252,360277
2,ENSG00000082126.11,201698644,2-201862313-G-A,rs16838316,-1,G,A,201862313,163669,201502036,201895252,360277
2,ENSG00000241399.2,159798208,2-159913914-G-C,rs16844494,-1,G,C,159913914,115706,159601600,159994816,312314
2,ENSG00000241399.2,159798208,2-159913914-G-A,rs16844494,-1,G,A,159913914,115706,159601600,159994816,312314
2,ENSG00000081320.5,196171578,2-196324966-G-A,rs16849595,-1,G,A,196324966,153388,195974970,196368186,349996
2,ENSG00000138376.6,214809683,2-214810560-G-A,rs16852821,-1,G,A,214810560,877,214613075,215006291,197485
2,ENSG00000138376.6,214809683,2-214810560-G-C,rs16852821,-1,G,C,214810560,877,214613075,215006291,197485
2,ENSG00000138376.6,214809683,2-214810560-G-T,rs16852821,-1,G,T,214810560,877,214613075,215006291,197485
2,ENSG00000144355.10,172085507,2-172023823-A-G,rs16859959,1,A,G,172023823,61684,171888899,172282115,134924
2,ENSG00000144355.10,172085507,2-172023823-A-T,rs16859959,1,A,T,172023823,61684,171888899,172282115,134924
2,ENSG00000115232.8,181457386,2-181440697-T-C,rs16867428,1,T,C,181440697,16689,181260778,181653994,179919
2,ENSG00000118960.8,20651098,2-20496481-T-G,rs16987690,-1,T,G,20496481,154617,20454490,20847706,41991
2,ENSG00000035141.3,70302067,2-70335546-A-G,rs17005494,-1,A,G,70335546,33479,70105459,70498675,230087
2,ENSG00000115423.13,84516498,2-84705742-G-T,rs17025503,1,G,T,84705742,189244,84319890,84713106,385852
2,ENSG00000115423.13,84516498,2-84705742-G-A,rs17025503,1,G,A,84705742,189244,84319890,84713106,385852
2,ENSG00000152291.9,85327989,2-85442848-C-T,rs17026335,-1,C,T,85442848,114859,85131381,85524597,311467
2,ENSG00000095002.7,47403156,2-47501926-A-G,rs17039235,1,A,G,47501926,98770,47206548,47599764,295378
2,ENSG00000115137.7,24971955,2-24945608-A-G,rs17046751,-1,A,G,24945608,26347,24775347,25168563,170261
2,ENSG00000144118.8,120252852,2-120291302-C-T,rs17050073,1,C,T,120291302,38450,120056244,120449460,235058
2,ENSG00000226479.3,120223400,2-120291302-C-T,rs17050073,-1,C,T,120291302,67902,120026792,120420008,264510
2,ENSG00000168393.7,241686815,2-241638535-G-T,rs17140248,-1,G,T,241638535,48280,241490207,241883423,148328
2,ENSG00000168393.7,241686815,2-241638535-G-A,rs17140248,-1,G,A,241638535,48280,241490207,241883423,148328
2,ENSG00000162927.8,61018255,2-61146385-G-A,rs1729658,-1,G,A,61146385,128130,60821647,61214863,324738
2,ENSG00000162927.8,61018255,2-61146385-G-C,rs1729658,-1,G,C,61146385,128130,60821647,61214863,324738
2,ENSG00000138039.9,48755724,2-48735152-G-T,rs17326656,-1,G,T,48735152,20572,48559116,48952332,176036
2,ENSG00000138036.12,43774039,2-43753492-T-C,rs17336182,1,T,C,43753492,20547,43577431,43970647,176061
2,ENSG00000128641.12,191245404,2-191311098-G-A,rs17348355,1,G,A,191311098,65694,191048796,191442012,262302
2,ENSG00000170745.7,17878667,2-17720745-A-C,rs17381041,1,A,C,17720745,157922,17682059,18075275,38686
2,ENSG00000170745.7,17878667,2-17720745-A-G,rs17381041,1,A,G,17720745,157922,17682059,18075275,38686
2,ENSG00000170745.7,17878667,2-17720745-A-T,rs17381041,1,A,T,17720745,157922,17682059,18075275,38686
2,ENSG00000115944.9,42361217,2-42397825-A-G,rs17389890,-1,A,G,42397825,36608,42164609,42557825,233216
2,ENSG00000155755.13,201643503,2-201809713-A-G,rs17469690,-1,A,G,201809713,166210,201446895,201840111,362818
2,ENSG00000155755.13,201643503,2-201809713-A-C,rs17469690,-1,A,C,201809713,166210,201446895,201840111,362818
2,ENSG00000197756.4,216498844,2-216440694-G-A,rs17486081,1,G,A,216440694,58150,216302236,216695452,138458
2,ENSG00000197756.4,216498844,2-216440694-G-T,rs17486081,1,G,T,216440694,58150,216302236,216695452,138458
2,ENSG00000071073.6,98731132,2-98630096-T-C,rs17513621,-1,T,C,98630096,101036,98534524,98927740,95572
2,ENSG00000244617.1,69961631,2-69949553-T-C,rs17573853,-1,T,C,69949553,12078,69765023,70158239,184530
2,ENSG00000196151.6,159286703,2-159231371-G-A,rs17576859,-1,G,A,159231371,55332,159090095,159483311,141276
2,ENSG00000196151.6,159286703,2-159231371-G-T,rs17576859,-1,G,T,159231371,55332,159090095,159483311,141276
2,ENSG00000119737.5,53859967,2-53714806-T-C,rs17580080,-1,T,C,53714806,145161,53663359,54056575,51447
2,ENSG00000119737.5,53859967,2-53714806-T-G,rs17580080,-1,T,G,53714806,145161,53663359,54056575,51447
2,ENSG00000071082.5,101002289,2-101020547-T-C,rs17663443,1,T,C,101020547,18258,100805681,101198897,214866
2,ENSG00000144120.7,119679201,2-119820240-A-G,rs17667952,1,A,G,119820240,141039,119482593,119875809,337647
2,ENSG00000075340.15,70768200,2-70617236-G-T,rs17697184,-1,G,T,70617236,150964,70571592,70964808,45644
2,ENSG00000168890.9,85602698,2-85638995-T-A,rs17736515,-1,T,A,85638995,36297,85406090,85799306,232905
2,ENSG00000163449.6,216081919,2-216238927-C-T,rs17770648,1,C,T,216238927,157008,215885311,216278527,353616
2,ENSG00000163040.10,131527888,2-131638971-G-A,rs17783398,1,G,A,131638971,111083,131331280,131724496,307691
2,ENSG00000115594.7,102142746,2-101963680-A-G,rs1859713,1,A,G,101963680,179066,101946138,102339354,17542
2,ENSG00000115594.7,102142746,2-101963680-A-C,rs1859713,1,A,C,101963680,179066,101946138,102339354,17542
2,ENSG00000132305.15,86195462,2-86332025-C-A,rs1863051,-1,C,A,86332025,136563,85998854,86392070,333171
2,ENSG00000132305.15,86195462,2-86332025-C-T,rs1863051,-1,C,T,86332025,136563,85998854,86392070,333171
2,ENSG00000214711.5,31217515,2-31205164-G-T,rs1867329,-1,G,T,31205164,12351,31020907,31414123,184257
2,ENSG00000042493.10,85410366,2-85427176-G-A,rs1877954,-1,G,A,85427176,16810,85213758,85606974,213418
2,ENSG00000163219.6,68734811,2-68780175-T-A,rs1878896,1,T,A,68780175,45364,68538203,68931419,241972
2,ENSG00000042445.9,85354528,2-85341687-G-C,rs1969260,-1,G,C,85341687,12841,85157920,85551136,183767
2,ENSG00000042445.9,85354528,2-85341687-G-A,rs1969260,-1,G,A,85341687,12841,85157920,85551136,183767
2,ENSG00000196834.7,130509328,2-130598922-T-G,rs199607550,-1,T,G,130598922,89594,130312720,130705936,286202
2,ENSG00000250565.2,46542577,2-46521256-T-A,rs2012022,-1,T,A,46521256,21321,46345969,46739185,175287
2,ENSG00000250565.2,46542577,2-46521256-T-C,rs2012022,-1,T,C,46521256,21321,46345969,46739185,175287
2,ENSG00000250565.2,46542577,2-46521256-T-G,rs2012022,-1,T,G,46521256,21321,46345969,46739185,175287
2,ENSG00000144040.8,73071712,2-72934422-A-G,rs2077586,-1,A,G,72934422,137290,72875104,73268320,59318
2,ENSG00000144357.11,169827454,2-169992158-G-A,rs2100851,1,G,A,169992158,164704,169630846,170024062,361312
2,ENSG00000088205.7,117814691,2-117945858-C-T,rs2161828,1,C,T,117945858,131167,117618083,118011299,327775
2,ENSG00000088205.7,117814691,2-117945858-C-G,rs2161828,1,C,G,117945858,131167,117618083,118011299,327775
2,ENSG00000088205.7,117814691,2-117945858-C-A,rs2161828,1,C,A,117945858,131167,117618083,118011299,327775
2,ENSG00000172086.7,88055783,2-88176769-A-G,rs2176569,-1,A,G,88176769,120986,87859175,88252391,317594
2,ENSG00000163798.9,27663471,2-27637684-A-T,rs2178197,1,A,T,27637684,25787,27466863,27860079,170821
2,ENSG00000163798.9,27663471,2-27637684-A-G,rs2178197,1,A,G,27637684,25787,27466863,27860079,170821
2,ENSG00000135903.13,222298998,2-222221236-G-T,rs2234675,-1,G,T,222221236,77762,222102390,222495606,118846
2,ENSG00000135903.13,222298998,2-222221236-G-A,rs2234675,-1,G,A,222221236,77762,222102390,222495606,118846
2,ENSG00000168427.7,238138668,2-238062221-C-T,rs2250045,1,C,T,238062221,76447,237942060,238335276,120161
2,ENSG00000011523.8,65056416,2-65069146-T-C,rs2252867,1,T,C,65069146,12730,64859808,65253024,209338
2,ENSG00000123610.3,151357592,2-151261443-T-A,rs2271813,1,T,A,151261443,96149,151160984,151554200,100459
2,ENSG00000123610.3,151357592,2-151261443-T-C,rs2271813,1,T,C,151261443,96149,151160984,151554200,100459
2,ENSG00000138100.8,27282429,2-27133123-G-C,rs2289358,1,G,C,27133123,149306,27085821,27479037,47302
2,ENSG00000138100.8,27282429,2-27133123-G-T,rs2289358,1,G,T,27133123,149306,27085821,27479037,47302
2,ENSG00000079785.8,15591868,2-15595295-G-A,rs2302928,1,G,A,15595295,3427,15395260,15788476,200035
2,ENSG00000152689.13,33476649,2-33520141-T-G,rs2305576,1,T,G,33520141,43492,33280041,33673257,240100
2,ENSG00000152689.13,33476649,2-33520141-T-C,rs2305576,1,T,C,33520141,43492,33280041,33673257,240100
2,ENSG00000119729.6,46542490,2-46491850-C-T,rs2346412,1,C,T,46491850,50640,46345882,46739098,145968
2,ENSG00000115525.11,85888990,2-85942866-T-C,rs2366958,-1,T,C,85942866,53876,85692382,86085598,250484
2,ENSG00000115525.11,85888990,2-85942866-T-A,rs2366958,-1,T,A,85942866,53876,85692382,86085598,250484
2,ENSG00000135966.7,105329735,2-105185194-G-A,rs2376400,-1,G,A,105185194,144541,105133127,105526343,52067
2,ENSG00000143933.11,47176511,2-47056418-G-A,rs2436772,-1,G,A,47056418,120093,46979903,47373119,76515
2,ENSG00000119771.10,23385179,2-23369348-C-T,rs2577703,1,C,T,23369348,15831,23188571,23581787,180777
2,ENSG00000119771.10,23385179,2-23369348-C-A,rs2577703,1,C,A,23369348,15831,23188571,23581787,180777
2,ENSG00000170417.10,102762031,2-102803200-A-G,rs2732817,1,A,G,102803200,41169,102565423,102958639,237777
2,ENSG00000115020.11,208266255,2-208130385-T-C,rs2854719,1,T,C,208130385,135870,208069647,208462863,60738
2,ENSG00000115020.11,208266255,2-208130385-T-G,rs2854719,1,T,G,208130385,135870,208069647,208462863,60738
2,ENSG00000184898.6,151261863,2-151149511-C-T,rs289932,-1,C,T,151149511,112352,151065255,151458471,84256
2,ENSG00000151689.8,190343589,2-190325454-C-G,rs291471,1,C,G,190325454,18135,190146981,190540197,178473
2,ENSG00000151689.8,190343589,2-190325454-C-A,rs291471,1,C,A,190325454,18135,190146981,190540197,178473
2,ENSG00000115310.13,55050451,2-55080729-C-A,rs2968821,-1,C,A,55080729,30278,54853843,55247059,226886
2,ENSG00000115310.13,55050451,2-55080729-C-T,rs2968821,-1,C,T,55080729,30278,54853843,55247059,226886
2,ENSG00000084090.9,96208827,2-96145695-T-C,rs2969489,-1,T,C,96145695,63132,96012219,96405435,133476
2,ENSG00000115850.4,135837184,2-135886330-T-C,rs309126,-1,T,C,135886330,49146,135640576,136033792,245754
2,ENSG00000162989.3,154698695,2-154685557-T-C,rs3111027,1,T,C,154685557,13138,154502087,154895303,183470
2,ENSG00000144029.7,95121808,2-95079375-G-A,rs3112989,-1,G,A,95079375,42433,94925200,95318416,154175
2,ENSG00000144029.7,95121808,2-95079375-G-C,rs3112989,-1,G,C,95079375,42433,94925200,95318416,154175
2,ENSG00000178562.12,203706639,2-203705416-G-A,rs3181097,1,G,A,203705416,1223,203510031,203903247,195385
2,ENSG00000178562.12,203706639,2-203705416-G-T,rs3181097,1,G,T,203705416,1223,203510031,203903247,195385
2,ENSG00000138061.7,38076151,2-38031684-C-G,rs336039,-1,C,G,38031684,44467,37879543,38272759,152141
2,ENSG00000138061.7,38076151,2-38031684-C-T,rs336039,-1,C,T,38031684,44467,37879543,38272759,152141
2,ENSG00000138061.7,38076151,2-38031684-C-A,rs336039,-1,C,A,38031684,44467,37879543,38272759,152141
2,ENSG00000162928.7,61017720,2-61029908-A-G,rs34223071,1,A,G,61029908,12188,60821112,61214328,208796
2,ENSG00000163806.11,28810834,2-28911039-C-G,rs34588907,1,C,G,28911039,100205,28614226,29007442,296813
2,ENSG00000115616.2,102619553,2-102687067-A-G,rs34650568,1,A,G,102687067,67514,102422945,102816161,264122
2,ENSG00000163492.9,179050137,2-178891210-A-G,rs34940894,-1,A,G,178891210,158927,178853529,179246745,37681
2,ENSG00000172554.7,950849,2-859422-C-T,rs35461543,1,C,T,859422,91427,754241,1147457,105181
2,ENSG00000171450.4,218959666,2-218963732-T-C,rs35826192,1,T,C,218963732,4066,218763058,219156274,200674
2,ENSG00000115317.7,74529933,2-74675101-A-C,rs363640,1,A,C,74675101,145168,74333325,74726541,341776
2,ENSG00000115282.14,74483081,2-74616082-G-A,rs363694,1,G,A,74616082,133001,74286473,74679689,329609
2,ENSG00000135899.11,230219984,2-230165838-T-C,rs3731723,-1,T,C,230165838,54146,230023376,230416592,142462
2,ENSG00000135899.11,230219984,2-230165838-T-G,rs3731723,-1,T,G,230165838,54146,230023376,230416592,142462
2,ENSG00000135899.11,230219984,2-230165838-T-A,rs3731723,-1,T,A,230165838,54146,230023376,230416592,142462
2,ENSG00000072195.9,219434843,2-219329195-C-T,rs3731895,1,C,T,219329195,105648,219238235,219631451,90960
2,ENSG00000178623.7,240625480,2-240630832-A-C,rs3749172,1,A,C,240630832,5352,240428872,240822088,201960
2,ENSG00000178623.7,240625480,2-240630832-A-T,rs3749172,1,A,T,240630832,5352,240428872,240822088,201960
2,ENSG00000204822.6,74472680,2-74513834-C-G,rs3755448,-1,C,G,74513834,41154,74276072,74669288,237762
2,ENSG00000204822.6,74472680,2-74513834-C-T,rs3755448,-1,C,T,74513834,41154,74276072,74669288,237762
2,ENSG00000125637.10,113173971,2-113179986-A-G,rs3762494,1,A,G,113179986,6015,112977363,113370579,202623
2,ENSG00000068784.8,45611267,2-45441531-T-C,rs3770251,-1,T,C,45441531,169736,45414659,45807875,26872
2,ENSG00000119844.10,64524305,2-64591706-A-T,rs3770721,1,A,T,64591706,67401,64327697,64720913,264009
2,ENSG00000115687.9,241149472,2-241171371-C-G,rs3771350,-1,C,G,241171371,21899,240952864,241346080,218507
2,ENSG00000115687.9,241149472,2-241171371-C-A,rs3771350,-1,C,A,241171371,21899,240952864,241346080,218507
2,ENSG00000115687.9,241149472,2-241171371-C-T,rs3771350,-1,C,T,241171371,21899,240952864,241346080,218507
2,ENSG00000163170.7,74147912,2-74285673-G-A,rs3771730,-1,G,A,74285673,137761,73951304,74344520,334369
2,ENSG00000163170.7,74147912,2-74285673-G-T,rs3771730,-1,G,T,74285673,137761,73951304,74344520,334369
2,ENSG00000068724.10,46941224,2-47022100-A-G,rs3814036,1,A,G,47022100,80876,46744616,47137832,277484
2,ENSG00000150938.5,36355778,2-36382926-G-A,rs3821165,1,G,A,36382926,27148,36159170,36552386,223756
2,ENSG00000114999.6,112482156,2-112616373-C-T,rs3849317,1,C,T,112616373,134217,112285548,112678764,330825
2,ENSG00000114999.6,112482156,2-112616373-C-A,rs3849317,1,C,A,112616373,134217,112285548,112678764,330825
2,ENSG00000184492.5,113498665,2-113553936-G-T,rs3982819,1,G,T,113553936,55271,113302057,113695273,251879
2,ENSG00000123983.9,222861036,2-222751891-T-C,rs4312478,1,T,C,222751891,109145,222664428,223057644,87463
2,ENSG00000152102.12,131093460,2-130973891-T-C,rs4314035,-1,T,C,130973891,119569,130896852,131290068,77039
2,ENSG00000152102.12,131093460,2-130973891-T-A,rs4314035,-1,T,A,130973891,119569,130896852,131290068,77039
2,ENSG00000182600.5,232870284,2-233040780-T-C,rs4374365,1,T,C,233040780,170496,232673676,233066892,367104
2,ENSG00000119888.6,47369311,2-47345021-G-A,rs4380295,1,G,A,47345021,24290,47172703,47565919,172318
2,ENSG00000198130.10,190319826,2-190482458-G-A,rs4438514,-1,G,A,190482458,162632,190123218,190516434,359240
2,ENSG00000115652.10,106194301,2-106376788-A-T,rs4513285,-1,A,T,106376788,182487,105997693,106390909,379095
2,ENSG00000115652.10,106194301,2-106376788-A-G,rs4513285,-1,A,G,106376788,182487,105997693,106390909,379095
2,ENSG00000115652.10,106194301,2-106376788-A-C,rs4513285,-1,A,C,106376788,182487,105997693,106390909,379095
2,ENSG00000138375.8,216412484,2-216540480-A-G,rs4550645,1,A,G,216540480,127996,216215876,216609092,324604
2,ENSG00000136732.10,126656158,2-126745957-A-T,rs4663044,1,A,T,126745957,89799,126459550,126852766,286407
2,ENSG00000136732.10,126656158,2-126745957-A-G,rs4663044,1,A,G,126745957,89799,126459550,126852766,286407
2,ENSG00000132329.6,237859623,2-237897728-T-C,rs4663269,1,T,C,237897728,38105,237663015,238056231,234713
2,ENSG00000132329.6,237859623,2-237897728-T-A,rs4663269,1,T,A,237897728,38105,237663015,238056231,234713
2,ENSG00000115267.4,162318684,2-162157663-G-T,rs4664450,-1,G,T,162157663,161021,162122076,162515292,35587
2,ENSG00000157833.7,26173088,2-26295728-G-C,rs4665848,1,G,C,26295728,122640,25976480,26369696,319248
2,ENSG00000157833.7,26173088,2-26295728-G-A,rs4665848,1,G,A,26295728,122640,25976480,26369696,319248
2,ENSG00000157833.7,26173088,2-26295728-G-T,rs4665848,1,G,T,26295728,122640,25976480,26369696,319248
2,ENSG00000213160.4,169733832,2-169796477-G-A,rs4668168,1,G,A,169796477,62645,169537224,169930440,259253
2,ENSG00000213160.4,169733832,2-169796477-G-T,rs4668168,1,G,T,169796477,62645,169537224,169930440,259253
2,ENSG00000071909.12,170178147,2-170369331-A-T,rs4668246,1,A,T,170369331,191184,169981539,170374755,387792
2,ENSG00000071909.12,170178147,2-170369331-A-G,rs4668246,1,A,G,170369331,191184,169981539,170374755,387792
2,ENSG00000071909.12,170178147,2-170369331-A-C,rs4668246,1,A,C,170369331,191184,169981539,170374755,387792
2,ENSG00000135926.6,218292503,2-218354349-C-T,rs4672888,-1,C,T,218354349,61846,218095895,218489111,258454
2,ENSG00000226124.2,199851192,2-199732894-C-A,rs4673449,-1,C,A,199732894,118298,199654584,200047800,78310
2,ENSG00000226124.2,199851192,2-199732894-C-G,rs4673449,-1,C,G,199732894,118298,199654584,200047800,78310
2,ENSG00000138363.10,215312059,2-215341330-A-G,rs4673990,1,A,G,215341330,29271,215115451,215508667,225879
2,ENSG00000198380.7,69387227,2-69277666-C-A,rs4854477,-1,C,A,69277666,109561,69190619,69583835,87047
2,ENSG00000198380.7,69387227,2-69277666-C-T,rs4854477,-1,C,T,69277666,109561,69190619,69583835,87047
2,ENSG00000198380.7,69387227,2-69277666-C-G,rs4854477,-1,C,G,69277666,109561,69190619,69583835,87047
2,ENSG00000152253.4,168890430,2-168912517-A-C,rs491443,-1,A,C,168912517,22087,168693822,169087038,218695
2,ENSG00000152253.4,168890430,2-168912517-A-G,rs491443,-1,A,G,168912517,22087,168693822,169087038,218695
2,ENSG00000152253.4,168890430,2-168912517-A-T,rs491443,-1,A,T,168912517,22087,168693822,169087038,218695
2,ENSG00000162881.5,42764261,2-42894713-T-C,rs4953678,-1,T,C,42894713,130452,42567653,42960869,327060
2,ENSG00000162881.5,42764261,2-42894713-T-A,rs4953678,-1,T,A,42894713,130452,42567653,42960869,327060
2,ENSG00000163072.10,168802637,2-168881341-A-G,rs524586,1,A,G,168881341,78704,168606029,168999245,275312
2,ENSG00000187736.8,219160815,2-219007084-A-G,rs55664644,-1,A,G,219007084,153731,218964207,219357423,42877
2,ENSG00000138381.4,189661459,2-189783777-G-A,rs5742923,1,G,A,189783777,122318,189464851,189858067,318926
2,ENSG00000171103.6,28870309,2-28937670-C-T,rs58905939,-1,C,T,28937670,67361,28673701,29066917,263969
2,ENSG00000173349.4,127701497,2-127621988-C-G,rs61744148,1,C,G,127621988,79509,127504889,127898105,117099
2,ENSG00000173349.4,127701497,2-127621988-C-T,rs61744148,1,C,T,127621988,79509,127504889,127898105,117099
2,ENSG00000138413.9,208255071,2-208129550-C-T,rs61751949,-1,C,T,208129550,125521,208058463,208451679,71087
2,ENSG00000135974.5,105337540,2-105426376-A-G,rs62152123,1,A,G,105426376,88836,105140932,105534148,285444
2,ENSG00000221944.3,232550557,2-232563070-C-T,rs62191570,-1,C,T,232563070,12513,232353949,232747165,209121
2,ENSG00000123607.10,165953776,2-166141331-G-C,rs6432871,-1,G,C,166141331,187555,165757168,166150384,384163
2,ENSG00000123607.10,165953776,2-166141331-G-A,rs6432871,-1,G,A,166141331,187555,165757168,166150384,384163
2,ENSG00000123607.10,165953776,2-166141331-G-T,rs6432871,-1,G,T,166141331,187555,165757168,166150384,384163
2,ENSG00000204128.5,231037523,2-231043179-C-A,rs6436995,1,C,A,231043179,5656,230840915,231234131,202264
2,ENSG00000178295.9,17754138,2-17942593-G-T,rs6531069,1,G,T,17942593,188455,17557530,17950746,385063
2,ENSG00000204634.8,101151382,2-101047475-T-C,rs6543009,-1,T,C,101047475,103907,100954774,101347990,92701
2,ENSG00000204634.8,101151382,2-101047475-T-G,rs6543009,-1,T,G,101047475,103907,100954774,101347990,92701
2,ENSG00000204634.8,101151382,2-101047475-T-A,rs6543009,-1,T,A,101047475,103907,100954774,101347990,92701
2,ENSG00000138083.3,44941702,2-44780786-A-G,rs6544769,1,A,G,44780786,160916,44745094,45138310,35692
2,ENSG00000138083.3,44941702,2-44780786-A-T,rs6544769,1,A,T,44780786,160916,44745094,45138310,35692
2,ENSG00000138083.3,44941702,2-44780786-A-C,rs6544769,1,A,C,44780786,160916,44745094,45138310,35692
2,ENSG00000169599.8,69437435,2-69481235-T-C,rs6546523,-1,T,C,69481235,43800,69240827,69634043,240408
2,ENSG00000124357.7,71068648,2-71100222-A-G,rs6546671,1,A,G,71100222,31574,70872040,71265256,228182
2,ENSG00000124357.7,71068648,2-71100222-A-T,rs6546671,1,A,T,71100222,31574,70872040,71265256,228182
2,ENSG00000124357.7,71068648,2-71100222-A-C,rs6546671,1,A,C,71100222,31574,70872040,71265256,228182
2,ENSG00000180228.8,178451175,2-178477226-G-A,rs6704545,-1,G,A,178477226,26051,178254567,178647783,222659
2,ENSG00000180228.8,178451175,2-178477226-G-C,rs6704545,-1,G,C,178477226,26051,178254567,178647783,222659
2,ENSG00000188177.8,112275597,2-112259488-C-T,rs6705046,1,C,T,112259488,16109,112078989,112472205,180499
2,ENSG00000171848.7,10122739,2-10268478-G-T,rs6707453,1,G,T,10268478,145739,9926131,10319347,342347
2,ENSG00000171848.7,10122739,2-10268478-G-A,rs6707453,1,G,A,10268478,145739,9926131,10319347,342347
2,ENSG00000171848.7,10122739,2-10268478-G-C,rs6707453,1,G,C,10268478,145739,9926131,10319347,342347
2,ENSG00000128699.9,189784339,2-189643321-C-T,rs6707560,-1,C,T,189643321,141018,189587731,189980947,55590
2,ENSG00000128699.9,189784339,2-189643321-C-G,rs6707560,-1,C,G,189643321,141018,189587731,189980947,55590
2,ENSG00000128699.9,189784339,2-189643321-C-A,rs6707560,-1,C,A,189643321,141018,189587731,189980947,55590
2,ENSG00000134326.7,6865907,2-6849902-T-C,rs6712141,-1,T,C,6849902,16005,6669299,7062515,180603
2,ENSG00000188389.5,241858894,2-241987082-T-C,rs6712567,-1,T,C,241987082,128188,241662286,242055502,324796
2,ENSG00000188389.5,241858894,2-241987082-T-G,rs6712567,-1,T,G,241987082,128188,241662286,242055502,324796
2,ENSG00000188389.5,241858894,2-241987082-T-A,rs6712567,-1,T,A,241987082,128188,241662286,242055502,324796
2,ENSG00000115138.6,25168580,2-25139325-G-A,rs6718083,-1,G,A,25139325,29255,24971972,25365188,167353
2,ENSG00000188452.9,181657105,2-181851599-G-A,rs6718469,-1,G,A,181851599,194494,181460497,181853713,391102
2,ENSG00000115548.11,86441371,2-86282378-T-C,rs6721458,1,T,C,86282378,158993,86244763,86637979,37615
2,ENSG00000186453.8,24175053,2-24168260-A-G,rs6723257,1,A,G,24168260,6793,23978445,24371661,189815
2,ENSG00000186453.8,24175053,2-24168260-A-C,rs6723257,1,A,C,24168260,6793,23978445,24371661,189815
2,ENSG00000186453.8,24175053,2-24168260-A-T,rs6723257,1,A,T,24168260,6793,23978445,24371661,189815
2,ENSG00000115421.7,60756268,2-60937594-T-G,rs6726160,1,T,G,60937594,181326,60559660,60952876,377934
2,ENSG00000115421.7,60756268,2-60937594-T-A,rs6726160,1,T,A,60937594,181326,60559660,60952876,377934
2,ENSG00000135973.1,105241743,2-105318709-A-G,rs6727677,1,A,G,105318709,76966,105045135,105438351,273574
2,ENSG00000135973.1,105241743,2-105318709-A-C,rs6727677,1,A,C,105318709,76966,105045135,105438351,273574
2,ENSG00000197635.5,162074215,2-162050722-C-T,rs6729733,-1,C,T,162050722,23493,161877607,162270823,173115
2,ENSG00000057935.8,42568632,2-42724361-C-T,rs6729750,1,C,T,42724361,155729,42372024,42765240,352337
2,ENSG00000057935.8,42568632,2-42724361-C-G,rs6729750,1,C,G,42724361,155729,42372024,42765240,352337
2,ENSG00000156973.9,231781282,2-231873048-C-T,rs6731165,-1,C,T,231873048,91766,231584674,231977890,288374
2,ENSG00000153574.6,88691673,2-88612588-C-A,rs6732073,1,C,A,88612588,79085,88495065,88888281,117523
2,ENSG00000168758.6,96870080,2-96941931-A-G,rs6732095,-1,A,G,96941931,71851,96673472,97066688,268459
2,ENSG00000136689.14,113127598,2-113083453-A-G,rs6734238,1,A,G,113083453,44145,112930990,113324206,152463
2,ENSG00000144567.5,219178275,2-219284153-C-T,rs6741986,1,C,T,219284153,105878,218981667,219374883,302486
2,ENSG00000144485.6,238240038,2-238235901-A-T,rs6744132,-1,A,T,238235901,4137,238043430,238436646,192471
2,ENSG00000144485.6,238240038,2-238235901-A-G,rs6744132,-1,A,G,238235901,4137,238043430,238436646,192471
2,ENSG00000172059.6,10043550,2-10037031-A-G,rs6747078,1,A,G,10037031,6519,9846942,10240158,190089
2,ENSG00000021826.9,210556599,2-210676340-C-T,rs6748782,1,C,T,210676340,119741,210359991,210753207,316349
2,ENSG00000021826.9,210556599,2-210676340-C-A,rs6748782,1,C,A,210676340,119741,210359991,210753207,316349
2,ENSG00000138101.13,25673577,2-25482559-T-C,rs6751254,-1,T,C,25482559,191018,25476969,25870185,5590
2,ENSG00000151690.9,190408355,2-190395747-G-A,rs6753226,1,G,A,190395747,12608,190211747,190604963,184000
2,ENSG00000213337.4,96858016,2-97046705-T-C,rs6753726,-1,T,C,97046705,188689,96661408,97054624,385297
2,ENSG00000085982.8,233566782,2-233547252-A-G,rs6756068,-1,A,G,233547252,19530,233370174,233763390,177078
2,ENSG00000085982.8,233566782,2-233547252-A-T,rs6756068,-1,A,T,233547252,19530,233370174,233763390,177078
2,ENSG00000085982.8,233566782,2-233547252-A-C,rs6756068,-1,A,C,233547252,19530,233370174,233763390,177078
2,ENSG00000163510.9,180007297,2-179890996-T-C,rs6759348,-1,T,C,179890996,116301,179810689,180203905,80307
2,ENSG00000152256.8,172556090,2-172477436-A-G,rs6759557,1,A,G,172477436,78654,172359482,172752698,117954
2,ENSG00000135932.6,230712842,2-230520071-A-C,rs699660,1,A,C,230520071,192771,230516234,230909450,3837
2,ENSG00000135932.6,230712842,2-230520071-A-G,rs699660,1,A,G,230520071,192771,230516234,230909450,3837
2,ENSG00000115919.9,142877664,2-142877388-C-G,rs718208,1,C,G,142877388,276,142681056,143074272,196332
2,ENSG00000115919.9,142877664,2-142877388-C-T,rs718208,1,C,T,142877388,276,142681056,143074272,196332
2,ENSG00000115919.9,142877664,2-142877388-C-A,rs718208,1,C,A,142877388,276,142681056,143074272,196332
2,ENSG00000118961.9,20823101,2-20679060-T-C,rs7255,-1,T,C,20679060,144041,20626493,21019709,52567
2,ENSG00000118961.9,20823101,2-20679060-T-A,rs7255,-1,T,A,20679060,144041,20626493,21019709,52567
2,ENSG00000138035.9,55693844,2-55649474-C-T,rs72805498,-1,C,T,55649474,44370,55497236,55890452,152238
2,ENSG00000138035.9,55693844,2-55649474-C-A,rs72805498,-1,C,A,55649474,44370,55497236,55890452,152238
2,ENSG00000243147.3,27771719,2-27798791-C-T,rs72810505,1,C,T,27798791,27072,27575111,27968327,223680
2,ENSG00000115194.6,27263047,2-27275976-G-A,rs72817538,-1,G,A,27275976,12929,27066439,27459655,209537
2,ENSG00000115211.10,27370338,2-27275976-G-A,rs72817538,-1,G,A,27275976,94362,27173730,27566946,102246
2,ENSG00000138071.8,65227831,2-65380069-C-T,rs72822490,1,C,T,65380069,152238,65031223,65424439,348846
2,ENSG00000144031.7,70978630,2-70833870-T-A,rs72836219,1,T,A,70833870,144760,70782022,71175238,51848
2,ENSG00000115107.14,119223834,2-119266116-G-C,rs72840936,1,G,C,119266116,42282,119027226,119420442,238890
2,ENSG00000177917.5,152718620,2-152606210-C-G,rs72871104,1,C,G,152606210,112410,152522012,152915228,84198
2,ENSG00000115685.10,241150467,2-241229747-C-T,rs73013893,1,C,T,241229747,79280,240953859,241347075,275888
2,ENSG00000115685.10,241150467,2-241229747-C-A,rs73013893,1,C,A,241229747,79280,240953859,241347075,275888
2,ENSG00000178662.10,165469698,2-165454131-C-T,rs74327339,1,C,T,165454131,15567,165273090,165666306,181041
2,ENSG00000115750.10,9843474,2-9946580-C-A,rs74420056,1,C,A,9946580,103106,9646866,10040082,299714
2,ENSG00000115750.10,9843474,2-9946580-C-T,rs74420056,1,C,T,9946580,103106,9646866,10040082,299714
2,ENSG00000091436.12,173075846,2-172965284-C-T,rs74468203,1,C,T,172965284,110562,172879238,173272454,86046
2,ENSG00000091436.12,173075846,2-172965284-C-G,rs74468203,1,C,G,172965284,110562,172879238,173272454,86046
2,ENSG00000170035.9,180980605,2-181013161-G-A,rs74538838,1,G,A,181013161,32556,180783997,181177213,229164
2,ENSG00000114993.11,74441937,2-74442388-G-T,rs7556852,-1,G,T,74442388,451,74245329,74638545,197059
2,ENSG00000114993.11,74441937,2-74442388-G-C,rs7556852,-1,G,C,74442388,451,74245329,74638545,197059
2,ENSG00000114993.11,74441937,2-74442388-G-A,rs7556852,-1,G,A,74442388,451,74245329,74638545,197059
2,ENSG00000072163.12,127675530,2-127633087-C-A,rs7559165,-1,C,A,127633087,42443,127478922,127872138,154165
2,ENSG00000072163.12,127675530,2-127633087-C-T,rs7559165,-1,C,T,127633087,42443,127478922,127872138,154165
2,ENSG00000136718.5,130342897,2-130329691-T-C,rs75596159,1,T,C,130329691,13206,130146289,130539505,183402
2,ENSG00000136718.5,130342897,2-130329691-T-A,rs75596159,1,T,A,130329691,13206,130146289,130539505,183402
2,ENSG00000132321.11,236507476,2-236495594-G-T,rs75620719,-1,G,T,236495594,11882,236310868,236704084,184726
2,ENSG00000138078.11,44361494,2-44462289-T-G,rs7562956,-1,T,G,44462289,100795,44164886,44558102,297403
2,ENSG00000154252.11,241776822,2-241773455-G-A,rs7563672,1,G,A,241773455,3367,241580214,241973430,193241
2,ENSG00000154252.11,241776822,2-241773455-G-T,rs7563672,1,G,T,241773455,3367,241580214,241973430,193241
2,ENSG00000115946.3,68157888,2-68121555-T-C,rs7564086,1,T,C,68121555,36333,67961280,68354496,160275
2,ENSG00000116095.5,178480457,2-178379833-C-A,rs7565742,1,C,A,178379833,100624,178283849,178677065,95984
2,ENSG00000118004.12,3595112,2-3613266-G-A,rs7567724,1,G,A,3613266,18154,3398504,3791720,214762
2,ENSG00000168958.15,227325251,2-227356564-A-C,rs7573035,1,A,C,227356564,31313,227128643,227521859,227921
2,ENSG00000168958.15,227325251,2-227356564-A-G,rs7573035,1,A,G,227356564,31313,227128643,227521859,227921
2,ENSG00000115808.6,36966536,2-36910903-C-A,rs7573966,-1,C,A,36910903,55633,36769928,37163144,140975
2,ENSG00000115808.6,36966536,2-36910903-C-T,rs7573966,-1,C,T,36910903,55633,36769928,37163144,140975
2,ENSG00000187944.2,196809355,2-196808311-C-T,rs7580839,-1,C,T,196808311,1044,196612747,197005963,195564
2,ENSG00000138400.8,206765328,2-206847250-T-C,rs7581388,-1,T,C,206847250,81922,206568720,206961936,278530
2,ENSG00000221823.5,68252532,2-68353849-A-G,rs7581872,-1,A,G,68353849,101317,68055924,68449140,297925
2,ENSG00000221823.5,68252532,2-68353849-A-T,rs7581872,-1,A,T,68353849,101317,68055924,68449140,297925
2,ENSG00000221823.5,68252532,2-68353849-A-C,rs7581872,-1,A,C,68353849,101317,68055924,68449140,297925
2,ENSG00000003393.10,201780933,2-201660828-C-T,rs7584026,-1,C,T,201660828,120105,201584325,201977541,76503
2,ENSG00000153832.7,229922503,2-229988849-T-G,rs7590987,1,T,G,229988849,66346,229725895,230119111,262954
2,ENSG00000153832.7,229922503,2-229988849-T-A,rs7590987,1,T,A,229988849,66346,229725895,230119111,262954
2,ENSG00000144354.9,173354872,2-173251401-T-G,rs7591449,1,T,G,173251401,103471,173158264,173551480,93137
2,ENSG00000144354.9,173354872,2-173251401-T-C,rs7591449,1,T,C,173251401,103471,173158264,173551480,93137
2,ENSG00000074054.12,121649476,2-121616983-C-T,rs7594288,-1,C,T,121616983,32493,121452868,121846084,164115
2,ENSG00000162976.8,11155467,2-11303444-C-G,rs7598990,1,C,G,11303444,147977,10958859,11352075,344585
2,ENSG00000162976.8,11155467,2-11303444-C-A,rs7598990,1,C,A,11303444,147977,10958859,11352075,344585
2,ENSG00000162976.8,11155467,2-11303444-C-T,rs7598990,1,C,T,11303444,147977,10958859,11352075,344585
2,ENSG00000171853.10,3379694,2-3378669-G-A,rs7601188,1,G,A,3378669,1025,3183086,3576302,195583
2,ENSG00000171853.10,3379694,2-3378669-G-T,rs7601188,1,G,T,3378669,1025,3183086,3576302,195583
2,ENSG00000135898.5,230925242,2-231004621-A-G,rs7603762,-1,A,G,231004621,79379,230728634,231121850,275987
2,ENSG00000171863.8,3575260,2-3605986-A-C,rs7604806,1,A,C,3605986,30726,3378652,3771868,227334
2,ENSG00000171863.8,3575260,2-3605986-A-G,rs7604806,1,A,G,3605986,30726,3378652,3771868,227334
2,ENSG00000171863.8,3575260,2-3605986-A-T,rs7604806,1,A,T,3605986,30726,3378652,3771868,227334
2,ENSG00000136542.4,157257705,2-157309745-G-A,rs7608600,1,G,A,157309745,52040,157061097,157454313,248648
2,ENSG00000136542.4,157257705,2-157309745-G-C,rs7608600,1,G,C,157309745,52040,157061097,157454313,248648
2,ENSG00000197557.4,177618742,2-177439169-G-C,rs76096651,-1,G,C,177439169,179573,177422134,177815350,17035
2,ENSG00000171132.9,45651675,2-45789912-C-T,rs76114421,1,C,T,45789912,138237,45455067,45848283,334845
2,ENSG00000156966.6,231395710,2-231469682-G-A,rs76541609,1,G,A,231469682,73972,231199102,231592318,270580
2,ENSG00000180902.11,241734630,2-241670139-C-T,rs77157539,1,C,T,241670139,64491,241538022,241931238,132117
2,ENSG00000077232.10,182716257,2-182824793-C-T,rs77634386,1,C,T,182824793,108536,182519649,182912865,305144
2,ENSG00000077232.10,182716257,2-182824793-C-A,rs77634386,1,C,A,182824793,108536,182519649,182912865,305144
2,ENSG00000135919.8,224039286,2-224051188-C-G,rs77850344,-1,C,G,224051188,11902,223842678,224235894,208510
2,ENSG00000135919.8,224039286,2-224051188-C-T,rs77850344,-1,C,T,224051188,11902,223842678,224235894,208510
2,ENSG00000158089.10,31138440,2-31189481-G-A,rs78099670,-1,G,A,31189481,51041,30941832,31335048,247649
2,ENSG00000115350.7,74958643,2-74969604-A-G,rs7881,1,A,G,74969604,10961,74762035,75155251,207569
2,ENSG00000018699.7,32628050,2-32700093-C-T,rs78860272,1,C,T,32700093,72043,32431442,32824658,268651
2,ENSG00000170264.8,61854060,2-61968266-T-C,rs79055900,-1,T,C,61968266,114206,61657452,62050668,310814
2,ENSG00000178385.9,208025527,2-208146403-T-C,rs796283,-1,T,C,208146403,120876,207828919,208222135,317484
2,ENSG00000178385.9,208025527,2-208146403-T-A,rs796283,-1,T,A,208146403,120876,207828919,208222135,317484
2,ENSG00000205795.4,10080411,2-10243018-G-A,rs79865719,-1,G,A,10243018,162607,9883803,10277019,359215
2,ENSG00000196811.6,232539692,2-232445168-G-T,rs80229452,1,G,T,232445168,94524,232343084,232736300,102084
2,ENSG00000172954.8,30447246,2-30408827-G-C,rs829610,1,G,C,30408827,38419,30250638,30643854,158189
2,ENSG00000172954.8,30447246,2-30408827-G-A,rs829610,1,G,A,30408827,38419,30250638,30643854,158189
2,ENSG00000077044.5,233354494,2-233388004-G-C,rs838718,1,G,C,233388004,33510,233157886,233551102,230118
2,ENSG00000077044.5,233354494,2-233388004-G-A,rs838718,1,G,A,233388004,33510,233157886,233551102,230118
2,ENSG00000135632.7,73214245,2-73315557-A-T,rs869927,1,A,T,73315557,101312,73017637,73410853,297920
2,ENSG00000135632.7,73214245,2-73315557-A-G,rs869927,1,A,G,73315557,101312,73017637,73410853,297920
2,ENSG00000172005.6,95025708,2-95057164-C-A,rs872580,1,C,A,95057164,31456,94829100,95222316,228064
2,ENSG00000172005.6,95025708,2-95057164-C-G,rs872580,1,C,G,95057164,31456,94829100,95222316,228064
2,ENSG00000169967.12,127387975,2-127528737-G-A,rs873099,-1,G,A,127528737,140762,127191367,127584583,337370
2,ENSG00000169967.12,127387975,2-127528737-G-C,rs873099,-1,G,C,127528737,140762,127191367,127584583,337370
2,ENSG00000169967.12,127387975,2-127528737-G-T,rs873099,-1,G,T,127528737,140762,127191367,127584583,337370
2,ENSG00000125618.12,113278921,2-113261552-G-T,rs877202,-1,G,T,113261552,17369,113082313,113475529,179239
2,ENSG00000189362.7,190534722,2-190385552-T-C,rs9288172,-1,T,C,190385552,149170,190338114,190731330,47438
2,ENSG00000198142.3,109614364,2-109522813-G-A,rs9330313,1,G,A,109522813,91551,109417756,109810972,105057
2,ENSG00000114978.12,74178879,2-74168944-A-G,rs9677593,-1,A,G,74168944,9935,73982271,74375487,186673
2,ENSG00000151692.9,6917412,2-6911850-G-C,rs9679478,1,G,C,6911850,5562,6720804,7114020,191046
2,ENSG00000151692.9,6917412,2-6911850-G-A,rs9679478,1,G,A,6911850,5562,6720804,7114020,191046
2,ENSG00000144401.9,207625378,2-207644858-T-A,rs9751478,-1,T,A,207644858,19480,207428770,207821986,216088
2,ENSG00000144401.9,207625378,2-207644858-T-C,rs9751478,-1,T,C,207644858,19480,207428770,207821986,216088
2,ENSG00000196141.7,200306693,2-200375363-A-T,rs994280,1,A,T,200375363,68670,200110085,200503301,265278
2,ENSG00000196141.7,200306693,2-200375363-A-G,rs994280,1,A,G,200375363,68670,200110085,200503301,265278
1,ENSG00000116128.5,147541501,1-147546759-G-C,rs1027423,1,G,C,147546759,5258,147344893,147738109,201866
1,ENSG00000116128.5,147541501,1-147546759-G-A,rs1027423,1,G,A,147546759,5258,147344893,147738109,201866
1,ENSG00000143363.10,151008449,1-150876627-C-T,rs10305649,1,C,T,150876627,131822,150811841,151205057,64786
1,ENSG00000143363.10,151008449,1-150876627-C-A,rs10305649,1,C,A,150876627,131822,150811841,151205057,64786
1,ENSG00000066185.8,42456022,1-42432537-T-G,rs10399812,-1,T,G,42432537,23485,42259414,42652630,173123
1,ENSG00000133048.8,203186704,1-203186952-T-G,rs10399931,-1,T,G,203186952,248,202990096,203383312,196856
1,ENSG00000133048.8,203186704,1-203186952-T-A,rs10399931,-1,T,A,203186952,248,202990096,203383312,196856
1,ENSG00000133048.8,203186704,1-203186952-T-C,rs10399931,-1,T,C,203186952,248,202990096,203383312,196856
1,ENSG00000116977.13,236523982,1-236548318-A-C,rs1041939,1,A,C,236548318,24336,236327374,236720590,220944
1,ENSG00000189266.6,23959828,1-24052181-G-A,rs10449779,1,G,A,24052181,92353,23763220,24156436,288961
1,ENSG00000189266.6,23959828,1-24052181-G-T,rs10449779,1,G,T,24052181,92353,23763220,24156436,288961
1,ENSG00000162814.5,217631344,1-217526461-A-C,rs10458467,1,A,C,217526461,104883,217434736,217827952,91725
1,ENSG00000162814.5,217631344,1-217526461-A-G,rs10458467,1,A,G,217526461,104883,217434736,217827952,91725
1,ENSG00000162814.5,217631344,1-217526461-A-T,rs10458467,1,A,T,217526461,104883,217434736,217827952,91725
1,ENSG00000197780.4,109076003,1-109062756-G-A,rs10466,-1,G,A,109062756,13247,108879395,109272611,183361
1,ENSG00000197780.4,109076003,1-109062756-G-C,rs10466,-1,G,C,109062756,13247,108879395,109272611,183361
1,ENSG00000160856.14,157700769,1-157699878-G-A,rs10489678,-1,G,A,157699878,891,157504161,157897377,195717
1,ENSG00000160856.14,157700769,1-157699878-G-T,rs10489678,-1,G,T,157699878,891,157504161,157897377,195717
1,ENSG00000160856.14,157700769,1-157699878-G-C,rs10489678,-1,G,C,157699878,891,157504161,157897377,195717
1,ENSG00000116786.7,15684320,1-15666843-A-C,rs10492987,1,A,C,15666843,17477,15487712,15880928,179131
1,ENSG00000116786.7,15684320,1-15666843-A-G,rs10492987,1,A,G,15666843,17477,15487712,15880928,179131
1,ENSG00000143498.12,222589933,1-222560629-C-T,rs10495194,-1,C,T,222560629,29304,222393325,222786541,167304
1,ENSG00000260238.1,156212982,1-156236330-G-A,rs1052067,1,G,A,156236330,23348,156016374,156409590,219956
1,ENSG00000188672.10,25420825,1-25361410-T-A,rs1053438,-1,T,A,25361410,59415,25224217,25617433,137193
1,ENSG00000188672.10,25420825,1-25361410-T-C,rs1053438,-1,T,C,25361410,59415,25224217,25617433,137193
1,ENSG00000162734.8,160205384,1-160226932-A-T,rs10732269,1,A,T,160226932,21548,160008776,160401992,218156
1,ENSG00000007341.12,112619141,1-112540817-C-T,rs10745330,-1,C,T,112540817,78324,112422533,112815749,118284
1,ENSG00000007341.12,112619141,1-112540817-C-G,rs10745330,-1,C,G,112540817,78324,112422533,112815749,118284
1,ENSG00000188641.8,97921034,1-97833919-C-G,rs10747488,-1,C,G,97833919,87115,97724426,98117642,109493
1,ENSG00000188641.8,97921034,1-97833919-C-T,rs10747488,-1,C,T,97833919,87115,97724426,98117642,109493
1,ENSG00000188641.8,97921034,1-97833919-C-A,rs10747488,-1,C,A,97833919,87115,97724426,98117642,109493
1,ENSG00000135821.10,182391790,1-182414429-T-C,rs10752871,-1,T,C,182414429,22639,182195182,182588398,219247
1,ENSG00000135821.10,182391790,1-182414429-T-A,rs10752871,-1,T,A,182414429,22639,182195182,182588398,219247
1,ENSG00000000457.8,169893896,1-169875374-T-G,rs10753798,-1,T,G,169875374,18522,169697288,170090504,178086
1,ENSG00000186409.9,42463294,1-42272261-T-A,rs10789416,1,T,A,42272261,191033,42266686,42659902,5575
1,ENSG00000186409.9,42463294,1-42272261-T-G,rs10789416,1,T,G,42272261,191033,42266686,42659902,5575
1,ENSG00000186409.9,42463294,1-42272261-T-C,rs10789416,1,T,C,42272261,191033,42266686,42659902,5575
1,ENSG00000135776.4,229558707,1-229448670-A-G,rs10799531,-1,A,G,229448670,110037,229362099,229755315,86571
1,ENSG00000169914.5,19882395,1-19886254-G-T,rs10799592,1,G,T,19886254,3859,19685787,20079003,200467
1,ENSG00000116962.10,236065090,1-235960107-T-C,rs10803172,-1,T,C,235960107,104983,235868482,236261698,91625
1,ENSG00000116962.10,236065090,1-235960107-T-G,rs10803172,-1,T,G,235960107,104983,235868482,236261698,91625
1,ENSG00000143110.7,111473984,1-111391066-A-G,rs10857881,1,A,G,111391066,82918,111277376,111670592,113690
1,ENSG00000143643.8,230978861,1-230980141-A-C,rs10864645,-1,A,C,230980141,1280,230782253,231175469,197888
1,ENSG00000143643.8,230978861,1-230980141-A-T,rs10864645,-1,A,T,230980141,1280,230782253,231175469,197888
1,ENSG00000143376.8,151612050,1-151707424-C-T,rs10888428,1,C,T,151707424,95374,151415442,151808658,291982
1,ENSG00000125703.8,62784132,1-62831090-C-T,rs10889383,1,C,T,62831090,46958,62587524,62980740,243566
1,ENSG00000116761.7,70411268,1-70412281-G-A,rs10889869,1,G,A,70412281,1013,70214660,70607876,197621
1,ENSG00000187862.6,156579723,1-156580462-T-C,rs10908509,1,T,C,156580462,739,156383115,156776331,197347
1,ENSG00000215845.6,161038964,1-161038745-C-G,rs10908821,-1,C,G,161038745,219,160842356,161235572,196389
1,ENSG00000158796.10,161132667,1-161038745-C-G,rs10908821,-1,C,G,161038745,93922,160936059,161329275,102686
1,ENSG00000158109.9,3625015,1-3622518-A-C,rs10909989,1,A,C,3622518,2497,3428407,3821623,194111
1,ENSG00000158109.9,3625015,1-3622518-A-T,rs10909989,1,A,T,3622518,2497,3428407,3821623,194111
1,ENSG00000158109.9,3625015,1-3622518-A-G,rs10909989,1,A,G,3622518,2497,3428407,3821623,194111
1,ENSG00000116991.6,232630133,1-232586958-T-C,rs10910561,-1,T,C,232586958,43175,232433525,232826741,153433
1,ENSG00000162704.10,183635783,1-183693294-T-C,rs10911412,-1,T,C,183693294,57511,183439175,183832391,254119
1,ENSG00000116679.11,185317243,1-185412459-C-T,rs10911722,-1,C,T,185412459,95216,185120635,185513851,291824
1,ENSG00000116260.12,180154869,1-180175350-G-A,rs10913939,1,G,A,180175350,20481,179958261,180351477,217089
1,ENSG00000116260.12,180154869,1-180175350-G-C,rs10913939,1,G,C,180175350,20481,179958261,180351477,217089
1,ENSG00000142910.9,31576515,1-31606073-C-G,rs10914449,1,C,G,31606073,29558,31379907,31773123,226166
1,ENSG00000143183.10,165768868,1-165687363-A-G,rs10918242,-1,A,G,165687363,81505,165572260,165965476,115103
1,ENSG00000143183.10,165768868,1-165687363-A-C,rs10918242,-1,A,C,165687363,81505,165572260,165965476,115103
1,ENSG00000143183.10,165768868,1-165687363-A-T,rs10918242,-1,A,T,165687363,81505,165572260,165965476,115103
1,ENSG00000143157.7,166839475,1-166852946-G-A,rs10918585,1,G,A,166852946,13471,166642867,167036083,210079
1,ENSG00000143157.7,166839475,1-166852946-G-C,rs10918585,1,G,C,166852946,13471,166642867,167036083,210079
1,ENSG00000143157.7,166839475,1-166852946-G-T,rs10918585,1,G,T,166852946,13471,166642867,167036083,210079
1,ENSG00000143851.11,202160602,1-202183001-C-A,rs10920358,-1,C,A,202183001,22399,201963994,202357210,219007
1,ENSG00000143851.11,202160602,1-202183001-C-T,rs10920358,-1,C,T,202183001,22399,201963994,202357210,219007
1,ENSG00000143851.11,202160602,1-202183001-C-G,rs10920358,-1,C,G,202183001,22399,201963994,202357210,219007
1,ENSG00000171492.10,89821032,1-89799594-A-G,rs10922725,1,A,G,89799594,21438,89624424,90017640,175170
1,ENSG00000171492.10,89821032,1-89799594-A-C,rs10922725,1,A,C,89799594,21438,89624424,90017640,175170
1,ENSG00000171492.10,89821032,1-89799594-A-T,rs10922725,1,A,T,89799594,21438,89624424,90017640,175170
1,ENSG00000116771.5,15585051,1-15582720-A-C,rs10927805,-1,A,C,15582720,2331,15388443,15781659,194277
1,ENSG00000116771.5,15585051,1-15582720-A-G,rs10927805,-1,A,G,15582720,2331,15388443,15781659,194277
1,ENSG00000116771.5,15585051,1-15582720-A-T,rs10927805,-1,A,T,15582720,2331,15388443,15781659,194277
1,ENSG00000117394.12,42958868,1-42915355-A-T,rs1098782,-1,A,T,42915355,43513,42762260,43155476,153095
1,ENSG00000117394.12,42958868,1-42915355-A-G,rs1098782,-1,A,G,42915355,43513,42762260,43155476,153095
1,ENSG00000135828.6,182589256,1-182574196-A-G,rs11072,-1,A,G,182574196,15060,182392648,182785864,181548
1,ENSG00000135828.6,182589256,1-182574196-A-T,rs11072,-1,A,T,182574196,15060,182392648,182785864,181548
1,ENSG00000066027.4,212285410,1-212213918-T-C,rs11119883,1,T,C,212213918,71492,212088802,212482018,125116
1,ENSG00000066027.4,212285410,1-212213918-T-G,rs11119883,1,T,G,212213918,71492,212088802,212482018,125116
1,ENSG00000162769.7,212858275,1-212858606-G-A,rs11120047,1,G,A,212858606,331,212661667,213054883,196939
1,ENSG00000162769.7,212858275,1-212858606-G-T,rs11120047,1,G,T,212858606,331,212661667,213054883,196939
1,ENSG00000162769.7,212858275,1-212858606-G-C,rs11120047,1,G,C,212858606,331,212661667,213054883,196939
1,ENSG00000162897.9,206970460,1-207103034-G-A,rs11120211,-1,G,A,207103034,132574,206773852,207167068,329182
1,ENSG00000162496.4,12618210,1-12581548-A-G,rs11121943,-1,A,G,12581548,36662,12421602,12814818,159946
1,ENSG00000116918.8,231528669,1-231429956-T-C,rs11122292,1,T,C,231429956,98713,231332061,231725277,97895
1,ENSG00000142867.6,85276632,1-85295980-G-C,rs11161585,-1,G,C,85295980,19348,85080024,85473240,215956
1,ENSG00000142867.6,85276632,1-85295980-G-A,rs11161585,-1,G,A,85295980,19348,85080024,85473240,215956
1,ENSG00000142875.13,84144271,1-84131713-T-C,rs11163907,1,T,C,84131713,12558,83947663,84340879,184050
1,ENSG00000117133.6,84479266,1-84479257-G-A,rs11163977,1,G,A,84479257,9,84282658,84675874,196599
1,ENSG00000156869.7,99766635,1-99745259-A-G,rs11166322,-1,A,G,99745259,21376,99570027,99963243,175232
1,ENSG00000134215.11,107965180,1-108011568-G-A,rs111807063,-1,G,A,108011568,46388,107768572,108161788,242996
1,ENSG00000134215.11,107965180,1-108011568-G-T,rs111807063,-1,G,T,108011568,46388,107768572,108161788,242996
1,ENSG00000134709.6,59814949,1-59778361-G-T,rs11207514,1,G,T,59778361,36588,59618341,60011557,160020
1,ENSG00000134709.6,59814949,1-59778361-G-A,rs11207514,1,G,A,59778361,36588,59618341,60011557,160020
1,ENSG00000142864.10,67430402,1-67540468-T-A,rs11209108,-1,T,A,67540468,110066,67233794,67627010,306674
1,ENSG00000142864.10,67430402,1-67540468-T-G,rs11209108,-1,T,G,67540468,110066,67233794,67627010,306674
1,ENSG00000142864.10,67430402,1-67540468-T-C,rs11209108,-1,T,C,67540468,110066,67233794,67627010,306674
1,ENSG00000065978.12,42682418,1-42689391-G-T,rs11210696,1,G,T,42689391,6973,42485810,42879026,203581
1,ENSG00000065978.12,42682418,1-42689391-G-C,rs11210696,1,G,C,42689391,6973,42485810,42879026,203581
1,ENSG00000070785.12,44986595,1-44809879-A-C,rs11211037,-1,A,C,44809879,176716,44789987,45183203,19892
1,ENSG00000070785.12,44986595,1-44809879-A-T,rs11211037,-1,A,T,44809879,176716,44789987,45183203,19892
1,ENSG00000070785.12,44986595,1-44809879-A-G,rs11211037,-1,A,G,44809879,176716,44789987,45183203,19892
1,ENSG00000070759.11,45491163,1-45457996-T-C,rs11211113,-1,T,C,45457996,33167,45294555,45687771,163441
1,ENSG00000159596.6,45688181,1-45760677-A-G,rs11211177,1,A,G,45760677,72496,45491573,45884789,269104
1,ENSG00000159596.6,45688181,1-45760677-A-C,rs11211177,1,A,C,45760677,72496,45491573,45884789,269104
1,ENSG00000079277.14,46604268,1-46522941-C-G,rs11211299,-1,C,G,46522941,81327,46407660,46800876,115281
1,ENSG00000116731.15,13700188,1-13834823-G-A,rs112362960,1,G,A,13834823,134635,13503580,13896796,331243
1,ENSG00000116731.15,13700188,1-13834823-G-T,rs112362960,1,G,T,13834823,134635,13503580,13896796,331243
1,ENSG00000049245.8,7771296,1-7694591-G-A,rs112434103,1,G,A,7694591,76705,7574688,7967904,119903
1,ENSG00000049245.8,7771296,1-7694591-G-T,rs112434103,1,G,T,7694591,76705,7574688,7967904,119903
1,ENSG00000142675.11,26177491,1-26191282-T-C,rs11247865,1,T,C,26191282,13791,25980883,26374099,210399
1,ENSG00000037637.6,16352480,1-16159316-C-T,rs11260822,-1,C,T,16159316,193164,16155872,16549088,3444
1,ENSG00000037637.6,16352480,1-16159316-C-G,rs11260822,-1,C,G,16159316,193164,16155872,16549088,3444
1,ENSG00000185090.10,37793847,1-37734325-G-C,rs11264095,1,G,C,37734325,59522,37597239,37990455,137086
1,ENSG00000132694.14,157045742,1-156932886-G-A,rs11264585,-1,G,A,156932886,112856,156849134,157242350,83752
1,ENSG00000143578.11,153967902,1-154022171-C-T,rs11264875,1,C,T,154022171,54269,153771294,154164510,250877
1,ENSG00000143549.14,154192100,1-154184614-T-A,rs11265251,-1,T,A,154184614,7486,153995492,154388708,189122
1,ENSG00000143549.14,154192100,1-154184614-T-C,rs11265251,-1,T,C,154184614,7486,153995492,154388708,189122
1,ENSG00000186283.9,179082070,1-179095990-C-T,rs1128952,1,C,T,179095990,13920,178885462,179278678,210528
1,ENSG00000162520.10,32702770,1-32677093-C-T,rs1136258,-1,C,T,32677093,25677,32506162,32899378,170931
1,ENSG00000198520.5,44674714,1-44760412-G-A,rs1140279,1,G,A,44760412,85698,44478106,44871322,282306
1,ENSG00000117153.11,202927234,1-202927014-G-T,rs114170147,-1,G,T,202927014,220,202730626,203123842,196388
1,ENSG00000117153.11,202927234,1-202927014-G-A,rs114170147,-1,G,A,202927014,220,202730626,203123842,196388
1,ENSG00000117153.11,202927234,1-202927014-G-C,rs114170147,-1,G,C,202927014,220,202730626,203123842,196388
1,ENSG00000184163.3,1246722,1-1260503-G-A,rs114569858,-1,G,A,1260503,13781,1050114,1443330,210389
1,ENSG00000186891.9,1206592,1-1206007-C-T,rs11466681,-1,C,T,1206007,585,1009984,1403200,196023
1,ENSG00000158156.7,27959973,1-27886368-A-C,rs11485,1,A,C,27886368,73605,27763365,28156581,123003
1,ENSG00000183347.11,89364059,1-89201241-C-T,rs115017409,1,C,T,89201241,162818,89167451,89560667,33790
1,ENSG00000183598.3,149813693,1-149926400-A-G,rs115070660,-1,A,G,149926400,112707,149617085,150010301,309315
1,ENSG00000184270.3,149887965,1-149926400-A-G,rs115070660,-1,A,G,149926400,38435,149691357,150084573,235043
1,ENSG00000169418.7,153678688,1-153613715-G-A,rs115270699,1,G,A,153613715,64973,153482080,153875296,131635
1,ENSG00000183888.4,16004236,1-16134201-G-A,rs115292598,1,G,A,16134201,129965,15807628,16200844,326573
1,ENSG00000248333.2,1659004,1-1845638-T-C,rs115361377,-1,T,C,1845638,186634,1462396,1855612,383242
1,ENSG00000248333.2,1659004,1-1845638-T-A,rs115361377,-1,T,A,1845638,186634,1462396,1855612,383242
1,ENSG00000143633.7,231241175,1-231166664-G-T,rs115461650,-1,G,T,231166664,74511,231044567,231437783,122097
1,ENSG00000130764.5,3796498,1-3781099-C-T,rs11547615,-1,C,T,3781099,15399,3599890,3993106,181209
1,ENSG00000169962.4,1331280,1-1407014-G-C,rs11548045,1,G,C,1407014,75734,1134672,1527888,272342
1,ENSG00000169962.4,1331280,1-1407014-G-A,rs11548045,1,G,A,1407014,75734,1134672,1527888,272342
1,ENSG00000243725.1,54715861,1-54722709-C-T,rs11550481,1,C,T,54722709,6848,54519253,54912469,203456
1,ENSG00000123685.4,212699840,1-212696194-C-T,rs1156058,-1,C,T,212696194,3646,212503232,212896448,192962
1,ENSG00000123685.4,212699840,1-212696194-C-A,rs1156058,-1,C,A,212696194,3646,212503232,212896448,192962
1,ENSG00000203943.4,84301708,1-84298566-A-G,rs1156085,1,A,G,84298566,3142,84105100,84498316,193466
1,ENSG00000157870.9,2586777,1-2529125-C-T,rs115638831,1,C,T,2529125,57652,2390169,2783385,138956
1,ENSG00000157870.9,2586777,1-2529125-C-A,rs115638831,1,C,A,2529125,57652,2390169,2783385,138956
1,ENSG00000197921.5,2530263,1-2529125-C-T,rs115638831,-1,C,T,2529125,1138,2333655,2726871,195470
1,ENSG00000197921.5,2530263,1-2529125-C-A,rs115638831,-1,C,A,2529125,1138,2333655,2726871,195470
1,ENSG00000162775.9,110339377,1-110398888-C-A,rs115744932,1,C,A,110398888,59511,110142769,110535985,256119
1,ENSG00000162775.9,110339377,1-110398888-C-T,rs115744932,1,C,T,110398888,59511,110142769,110535985,256119
1,ENSG00000158481.7,158289923,1-158260018-C-G,rs11575806,1,C,G,158260018,29905,158093315,158486531,166703
1,ENSG00000143248.7,163202916,1-163303960-A-G,rs11582541,-1,A,G,163303960,101044,163006308,163399524,297652
1,ENSG00000085998.9,46198434,1-46191391-T-C,rs11584436,-1,T,C,46191391,7043,46001826,46395042,189565
1,ENSG00000240386.2,152775140,1-152866438-G-T,rs115867607,1,G,T,152866438,91298,152578532,152971748,287906
1,ENSG00000197084.3,152806651,1-152866438-G-T,rs115867607,-1,G,T,152866438,59787,152610043,153003259,256395
1,ENSG00000196734.5,152811971,1-152866438-G-T,rs115867607,1,G,T,152866438,54467,152615363,153008579,251075
1,ENSG00000185436.7,24187289,1-24190390-G-T,rs11587500,-1,G,T,24190390,3101,23990681,24383897,199709
1,ENSG00000185436.7,24187289,1-24190390-G-A,rs11587500,-1,G,A,24190390,3101,23990681,24383897,199709
1,ENSG00000131697.12,5992425,1-5971884-C-A,rs11588889,-1,C,A,5971884,20541,5795817,6189033,176067
1,ENSG00000131697.12,5992425,1-5971884-C-G,rs11588889,-1,C,G,5971884,20541,5795817,6189033,176067
1,ENSG00000157184.5,53196824,1-53187279-T-C,rs11590250,1,T,C,53187279,9545,53000216,53393432,187063
1,ENSG00000197721.11,207645133,1-207617072-G-C,rs116125277,1,G,C,207617072,28061,207448525,207841741,168547
1,ENSG00000189334.4,153616325,1-153641001-G-A,rs116282810,-1,G,A,153641001,24676,153419717,153812933,221284
1,ENSG00000143669.8,235866906,1-236024318-C-T,rs116324777,-1,C,T,236024318,157412,235670298,236063514,354020
1,ENSG00000135835.6,180912897,1-181088213-G-T,rs116437604,1,G,T,181088213,175316,180716289,181109505,371924
1,ENSG00000143028.7,109466546,1-109636098-C-T,rs116532364,1,C,T,109636098,169552,109269938,109663154,366160
1,ENSG00000143028.7,109466546,1-109636098-C-A,rs116532364,1,C,A,109636098,169552,109269938,109663154,366160
1,ENSG00000121900.12,32901389,1-32988663-G-A,rs116583478,-1,G,A,32988663,87274,32704781,33097997,283882
1,ENSG00000121900.12,32901389,1-32988663-G-C,rs116583478,-1,G,C,32988663,87274,32704781,33097997,283882
1,ENSG00000162614.13,77888624,1-77926761-G-A,rs1166698,1,G,A,77926761,38137,77692016,78085232,234745
1,ENSG00000134245.12,112508965,1-112410719-T-C,rs1175630,1,T,C,112410719,98246,112312357,112705573,98362
1,ENSG00000134245.12,112508965,1-112410719-T-G,rs1175630,1,T,G,112410719,98246,112312357,112705573,98362
1,ENSG00000134245.12,112508965,1-112410719-T-A,rs1175630,1,T,A,112410719,98246,112312357,112705573,98362
1,ENSG00000143369.10,150508109,1-150363264-A-G,rs11799813,1,A,G,150363264,144845,150311501,150704717,51763
1,ENSG00000153904.12,85465159,1-85278006-G-A,rs11800577,-1,G,A,85278006,187153,85268551,85661767,9455
1,ENSG00000203737.2,174447964,1-174563951-T-G,rs11802744,1,T,G,174563951,115987,174251356,174644572,312595
1,ENSG00000203737.2,174447964,1-174563951-T-C,rs11802744,1,T,C,174563951,115987,174251356,174644572,312595
1,ENSG00000066056.7,43300982,1-43405921-G-T,rs11803612,1,G,T,43405921,104939,43104374,43497590,301547
1,ENSG00000009724.12,11047239,1-11220866-G-A,rs11803882,-1,G,A,11220866,173627,10850631,11243847,370235
1,ENSG00000163563.7,158831351,1-158846948-C-G,rs11805139,1,C,G,158846948,15597,158634743,159027959,212205
1,ENSG00000171680.14,6491667,1-6490445-C-T,rs11806429,-1,C,T,6490445,1222,6295059,6688275,195386
1,ENSG00000134184.7,109687817,1-109718120-T-C,rs11807,1,T,C,109718120,30303,109491209,109884425,226911
1,ENSG00000143776.12,227318492,1-227327207-T-G,rs11807068,-1,T,G,227327207,8715,227121884,227515100,205323
1,ENSG00000118200.10,200738893,1-200623167-C-T,rs11807125,1,C,T,200623167,115726,200542285,200935501,80882
1,ENSG00000118200.10,200738893,1-200623167-C-A,rs11807125,1,C,A,200623167,115726,200542285,200935501,80882
1,ENSG00000198912.6,3900272,1-3892859-G-A,rs11807227,-1,G,A,3892859,7413,3703664,4096880,189195
1,ENSG00000162396.5,54764523,1-54760173-T-G,rs1180955,-1,T,G,54760173,4350,54567915,54961131,192258
1,ENSG00000162396.5,54764523,1-54760173-T-C,rs1180955,-1,T,C,54760173,4350,54567915,54961131,192258
1,ENSG00000176393.6,201982648,1-201981821-T-C,rs11810017,1,T,C,201981821,827,201786040,202179256,195781
1,ENSG00000176393.6,201982648,1-201981821-T-A,rs11810017,1,T,A,201981821,827,201786040,202179256,195781
1,ENSG00000058804.9,53838296,1-53840860-A-G,rs1181209,-1,A,G,53840860,2564,53641688,54034904,199172
1,ENSG00000116983.7,39691433,1-39652365-T-A,rs1182964,-1,T,A,39652365,39068,39494825,39888041,157540
1,ENSG00000116983.7,39691433,1-39652365-T-C,rs1182964,-1,T,C,39652365,39068,39494825,39888041,157540
1,ENSG00000119280.12,230868521,1-230876879-G-C,rs1202592,-1,G,C,230876879,8358,230671913,231065129,204966
1,ENSG00000119280.12,230868521,1-230876879-G-A,rs1202592,-1,G,A,230876879,8358,230671913,231065129,204966
1,ENSG00000163218.10,153348841,1-153355280-G-T,rs12027903,-1,G,T,153355280,6439,153152233,153545449,203047
1,ENSG00000121486.7,185156953,1-185171530-A-G,rs12028809,-1,A,G,185171530,14577,184960345,185353561,211185
1,ENSG00000117009.7,241532378,1-241540180-T-A,rs12030573,1,T,A,241540180,7802,241335770,241728986,204410
1,ENSG00000117009.7,241532378,1-241540180-T-G,rs12030573,1,T,G,241540180,7802,241335770,241728986,204410
1,ENSG00000117009.7,241532378,1-241540180-T-C,rs12030573,1,T,C,241540180,7802,241335770,241728986,204410
1,ENSG00000163444.7,203007374,1-202859552-A-G,rs12031797,1,A,G,202859552,147822,202810766,203203982,48786
1,ENSG00000186564.5,47438044,1-47434787-G-A,rs12035995,1,G,A,47434787,3257,47241436,47634652,193351
1,ENSG00000171612.5,9539465,1-9534611-A-C,rs12037667,1,A,C,9534611,4854,9342857,9736073,191754
1,ENSG00000143153.7,169106690,1-169045197-C-A,rs12038274,1,C,A,169045197,61493,168910082,169303298,135115
1,ENSG00000143153.7,169106690,1-169045197-C-T,rs12038274,1,C,T,169045197,61493,168910082,169303298,135115
1,ENSG00000143153.7,169106690,1-169045197-C-G,rs12038274,1,C,G,169045197,61493,168910082,169303298,135115
1,ENSG00000067334.8,93879206,1-93871379-C-T,rs12041975,-1,C,T,93871379,7827,93682598,94075814,188781
1,ENSG00000198700.5,201829157,1-201847444-G-A,rs12042456,1,G,A,201847444,18287,201632549,202025765,214895
1,ENSG00000162946.14,231626790,1-231681096-C-T,rs12042938,1,C,T,231681096,54306,231430182,231823398,250914
1,ENSG00000160058.13,32394441,1-32564306-A-G,rs12044277,-1,A,G,32564306,169865,32197833,32591049,366473
1,ENSG00000157911.5,2412564,1-2274142-C-A,rs12045693,-1,C,A,2274142,138422,2215956,2609172,58186
1,ENSG00000157911.5,2412564,1-2274142-C-G,rs12045693,-1,C,G,2274142,138422,2215956,2609172,58186
1,ENSG00000085491.11,108200343,1-108184285-G-A,rs12047867,-1,G,A,108184285,16058,108003735,108396951,180550
1,ENSG00000159363.13,17011928,1-16965909-A-G,rs12059633,-1,A,G,16965909,46019,16815320,17208536,150589
1,ENSG00000118197.8,200669907,1-200681111-G-A,rs12061556,-1,G,A,200681111,11204,200473299,200866515,207812
1,ENSG00000118197.8,200669907,1-200681111-G-C,rs12061556,-1,G,C,200681111,11204,200473299,200866515,207812
1,ENSG00000118197.8,200669907,1-200681111-G-T,rs12061556,-1,G,T,200681111,11204,200473299,200866515,207812
1,ENSG00000214114.4,38873348,1-38921118-C-G,rs12061842,-1,C,G,38921118,47770,38676740,39069956,244378
1,ENSG00000187144.7,16437424,1-16443454-G-A,rs12064256,-1,G,A,16443454,6030,16240816,16634032,202638
1,ENSG00000122218.10,160343250,1-160160730-C-T,rs12064269,-1,C,T,160160730,182520,160146642,160539858,14088
1,ENSG00000122218.10,160343250,1-160160730-C-G,rs12064269,-1,C,G,160160730,182520,160146642,160539858,14088
1,ENSG00000122218.10,160343250,1-160160730-C-A,rs12064269,-1,C,A,160160730,182520,160146642,160539858,14088
1,ENSG00000118873.10,220272453,1-220360394-C-T,rs12064931,-1,C,T,220360394,87941,220075845,220469061,284549
1,ENSG00000118873.10,220272453,1-220360394-C-G,rs12064931,-1,C,G,220360394,87941,220075845,220469061,284549
1,ENSG00000158747.9,19644311,1-19466033-A-C,rs12066114,1,A,C,19466033,178278,19447703,19840919,18330
1,ENSG00000158747.9,19644311,1-19466033-A-G,rs12066114,1,A,G,19466033,178278,19447703,19840919,18330
1,ENSG00000142871.10,85580761,1-85596539-C-T,rs12072027,1,C,T,85596539,15778,85384153,85777369,212386
1,ENSG00000116237.9,6235964,1-6233830-G-A,rs12073932,-1,G,A,6233830,2134,6039356,6432572,194474
1,ENSG00000143815.10,225428038,1-225435824-C-T,rs12076606,-1,C,T,225435824,7786,225231430,225624646,204394
1,ENSG00000143815.10,225428038,1-225435824-C-A,rs12076606,-1,C,A,225435824,7786,225231430,225624646,204394
1,ENSG00000118655.4,113905326,1-113901972-T-C,rs12079716,1,T,C,113901972,3354,113708718,114101934,193254
1,ENSG00000118655.4,113905326,1-113901972-T-G,rs12079716,1,T,G,113901972,3354,113708718,114101934,193254
1,ENSG00000143353.7,219173878,1-219286645-T-C,rs12080335,1,T,C,219286645,112767,218977270,219370486,309375
1,ENSG00000143158.6,167937072,1-167963822-T-G,rs12095210,-1,T,G,167963822,26750,167740464,168133680,223358
1,ENSG00000177674.10,11736136,1-11737129-T-C,rs12095517,1,T,C,11737129,993,11539528,11932744,197601
1,ENSG00000240563.1,62194849,1-62191858-T-G,rs12116810,1,T,G,62191858,2991,61998241,62391457,193617
1,ENSG00000174529.6,205084460,1-205071815-C-G,rs12117194,-1,C,G,205071815,12645,204887852,205281068,183963
1,ENSG00000085840.7,52404423,1-52587287-C-A,rs12120268,-1,C,A,52587287,182864,52207815,52601031,379472
1,ENSG00000043514.9,39883504,1-39837955-C-T,rs12123609,-1,C,T,39837955,45549,39686896,40080112,151059
1,ENSG00000054523.11,10210570,1-10361820-A-G,rs12125492,1,A,G,10361820,151250,10013962,10407178,347858
1,ENSG00000069702.6,91886151,1-91753511-G-A,rs12127644,-1,G,A,91753511,132640,91689543,92082759,63968
1,ENSG00000069702.6,91886151,1-91753511-G-T,rs12127644,-1,G,T,91753511,132640,91689543,92082759,63968
1,ENSG00000187733.6,103749898,1-103570536-C-T,rs12132911,1,C,T,103570536,179362,103553290,103946506,17246
1,ENSG00000168159.7,228487382,1-228515535-T-C,rs12136157,1,T,C,228515535,28153,228290774,228683990,224761
1,ENSG00000171806.7,169794907,1-169860963-G-T,rs12136425,-1,G,T,169860963,66056,169598299,169991515,262664
1,ENSG00000171806.7,169794907,1-169860963-G-A,rs12136425,-1,G,A,169860963,66056,169598299,169991515,262664
1,ENSG00000171806.7,169794907,1-169860963-G-C,rs12136425,-1,G,C,169860963,66056,169598299,169991515,262664
1,ENSG00000130775.11,27872544,1-27861750-G-T,rs12142239,1,G,T,27861750,10794,27675936,28069152,185814
1,ENSG00000130775.11,27872544,1-27861750-G-A,rs12142239,1,G,A,27861750,10794,27675936,28069152,185814
1,ENSG00000171603.11,9823965,1-9848211-C-A,rs1220395,-1,C,A,9848211,24246,9627357,10020573,220854
1,ENSG00000171603.11,9823965,1-9848211-C-T,rs1220395,-1,C,T,9848211,24246,9627357,10020573,220854
1,ENSG00000178585.10,9910269,1-9948163-G-A,rs1220421,-1,G,A,9948163,37894,9713661,10106877,234502
1,ENSG00000178585.10,9910269,1-9948163-G-C,rs1220421,-1,G,C,9948163,37894,9713661,10106877,234502
1,ENSG00000143190.14,167220886,1-167273666-G-A,rs12239612,1,G,A,167273666,52780,167024278,167417494,249388
1,ENSG00000117408.5,43946950,1-44047084-A-G,rs12240184,1,A,G,44047084,100134,43750342,44143558,296742
1,ENSG00000162441.6,9943391,1-9943262-G-A,rs1234694,-1,G,A,9943262,129,9746783,10139999,196479
1,ENSG00000162441.6,9943391,1-9943262-G-C,rs1234694,-1,G,C,9943262,129,9746783,10139999,196479
1,ENSG00000189195.5,92080345,1-92129343-G-A,rs12385692,1,G,A,92129343,48998,91883737,92276953,245606
1,ENSG00000185523.6,212847649,1-212753667-A-G,rs12404618,-1,A,G,212753667,93982,212651041,213044257,102626
1,ENSG00000052723.7,114780685,1-114592888-C-T,rs12405486,-1,C,T,114592888,187797,114584077,114977293,8811
1,ENSG00000164010.9,42817122,1-42844968-A-G,rs12406279,1,A,G,42844968,27846,42620514,43013730,224454
1,ENSG00000168509.13,146021735,1-145887112-T-G,rs12410298,-1,T,G,145887112,134623,145825127,146218343,61985
1,ENSG00000168509.13,146021735,1-145887112-T-C,rs12410298,-1,T,C,145887112,134623,145825127,146218343,61985
1,ENSG00000121310.11,52921740,1-52886344-G-A,rs1242198,-1,G,A,52886344,35396,52725132,53118348,161212
1,ENSG00000189181.3,248682328,1-248779833-T-A,rs12563983,-1,T,A,248779833,97505,248485720,248878936,294113
1,ENSG00000189181.3,248682328,1-248779833-T-C,rs12563983,-1,T,C,248779833,97505,248485720,248878936,294113
1,ENSG00000197965.7,167721982,1-167727822-C-A,rs12566176,1,C,A,167727822,5840,167525374,167918590,202448
1,ENSG00000197965.7,167721982,1-167727822-C-T,rs12566176,1,C,T,167727822,5840,167525374,167918590,202448
1,ENSG00000097046.7,91500851,1-91316019-C-A,rs12568483,1,C,A,91316019,184832,91304243,91697459,11776
1,ENSG00000142765.12,27342022,1-27355990-G-A,rs12569127,1,G,A,27355990,13968,27145414,27538630,210576
1,ENSG00000085465.10,111427735,1-111449473-C-T,rs1264899,-1,C,T,111449473,21738,111231127,111624343,218346
1,ENSG00000085465.10,111427735,1-111449473-C-G,rs1264899,-1,C,G,111449473,21738,111231127,111624343,218346
1,ENSG00000090432.5,20508151,1-20472127-A-G,rs12724366,-1,A,G,20472127,36024,20311543,20704759,160584
1,ENSG00000135778.6,232950611,1-232955717-T-A,rs12725558,1,T,A,232955717,5106,232754003,233147219,201714
1,ENSG00000116198.8,3857211,1-3857748-T-G,rs12726906,-1,T,G,3857748,537,3660603,4053819,197145
1,ENSG00000116198.8,3857211,1-3857748-T-C,rs12726906,-1,T,C,3857748,537,3660603,4053819,197145
1,ENSG00000156875.9,100038095,1-99900293-G-C,rs12734255,1,G,C,99900293,137802,99841487,100234703,58806
1,ENSG00000156875.9,100038095,1-99900293-G-A,rs12734255,1,G,A,99900293,137802,99841487,100234703,58806
1,ENSG00000135823.9,181022870,1-180971776-G-A,rs12740112,-1,G,A,180971776,51094,180826262,181219478,145514
1,ENSG00000054282.10,243256041,1-243264850-T-G,rs12741781,1,T,G,243264850,8809,243059433,243452649,205417
1,ENSG00000171502.10,86156772,1-86083516-C-T,rs12754154,-1,C,T,86083516,73256,85960164,86353380,123352
1,ENSG00000162777.12,111200646,1-111200219-A-G,rs12756391,-1,A,G,111200219,427,111004038,111397254,196181
1,ENSG00000134255.9,111140223,1-111200219-A-G,rs12756391,1,A,G,111200219,59996,110943615,111336831,256604
1,ENSG00000198162.6,117367449,1-117336057-T-C,rs1289852,1,T,C,117336057,31392,117170841,117564057,165216
1,ENSG00000198162.6,117367449,1-117336057-T-G,rs1289852,1,T,G,117336057,31392,117170841,117564057,165216
1,ENSG00000198162.6,117367449,1-117336057-T-A,rs1289852,1,T,A,117336057,31392,117170841,117564057,165216
1,ENSG00000158195.6,27490167,1-27644991-A-C,rs1292081,-1,A,C,27644991,154824,27293559,27686775,351432
1,ENSG00000158195.6,27490167,1-27644991-A-G,rs1292081,-1,A,G,27644991,154824,27293559,27686775,351432
1,ENSG00000196407.6,151853712,1-151707120-G-C,rs1308153,-1,G,C,151707120,146592,151657104,152050320,50016
1,ENSG00000196407.6,151853712,1-151707120-G-A,rs1308153,-1,G,A,151707120,146592,151657104,152050320,50016
1,ENSG00000116874.7,119140653,1-119041345-T-A,rs1325939,-1,T,A,119041345,99308,118944045,119337261,97300
1,ENSG00000116874.7,119140653,1-119041345-T-G,rs1325939,-1,T,G,119041345,99308,118944045,119337261,97300
1,ENSG00000116874.7,119140653,1-119041345-T-C,rs1325939,-1,T,C,119041345,99308,118944045,119337261,97300
1,ENSG00000187642.5,981029,1-953779-A-C,rs13302945,-1,A,C,953779,27250,784421,1177637,169358
1,ENSG00000187961.7,960584,1-956565-A-G,rs13303106,1,A,G,956565,4019,763976,1157192,192589
1,ENSG00000187961.7,960584,1-956565-A-C,rs13303106,1,A,C,956565,4019,763976,1157192,192589
1,ENSG00000116885.14,36450451,1-36417489-G-T,rs13375417,-1,G,T,36417489,32962,36253843,36647059,163646
1,ENSG00000162746.10,161721563,1-161707180-A-T,rs1340978,1,A,T,161707180,14383,161524955,161918171,182225
1,ENSG00000162746.10,161721563,1-161707180-A-G,rs1340978,1,A,G,161707180,14383,161524955,161918171,182225
1,ENSG00000162746.10,161721563,1-161707180-A-C,rs1340978,1,A,C,161707180,14383,161524955,161918171,182225
1,ENSG00000132185.12,161707229,1-161707180-A-T,rs1340978,1,A,T,161707180,49,161510621,161903837,196559
1,ENSG00000132185.12,161707229,1-161707180-A-G,rs1340978,1,A,G,161707180,49,161510621,161903837,196559
1,ENSG00000132185.12,161707229,1-161707180-A-C,rs1340978,1,A,C,161707180,49,161510621,161903837,196559
1,ENSG00000162836.6,147670524,1-147647471-G-A,rs1344,-1,G,A,147647471,23053,147473916,147867132,173555
1,ENSG00000143226.8,161505457,1-161593764-A-G,rs139529340,1,A,G,161593764,88307,161308849,161702065,284915
1,ENSG00000143147.10,168136930,1-168138805-A-G,rs1406822,-1,A,G,168138805,1875,167940322,168333538,198483
1,ENSG00000116815.11,116571026,1-116524285-A-G,rs1414275,-1,A,G,116524285,46741,116374418,116767634,149867
1,ENSG00000116729.9,68232523,1-68188593-T-A,rs1430741,-1,T,A,68188593,43930,68035915,68429131,152678
1,ENSG00000116729.9,68232523,1-68188593-T-C,rs1430741,-1,T,C,68188593,43930,68035915,68429131,152678
1,ENSG00000160075.9,1574863,1-1450709-C-G,rs149262155,-1,C,G,1450709,124154,1378255,1771471,72454
1,ENSG00000160075.9,1574863,1-1450709-C-T,rs149262155,-1,C,T,1450709,124154,1378255,1771471,72454
1,ENSG00000143228.8,163321954,1-163339843-T-C,rs1509023,1,T,C,163339843,17889,163125346,163518562,214497
1,ENSG00000117174.6,85708433,1-85707615-C-T,rs1539444,-1,C,T,85707615,818,85511825,85905041,195790
1,ENSG00000125945.9,23369836,1-23560714-T-C,rs1555026,-1,T,C,23560714,190878,23173228,23566444,387486
1,ENSG00000142794.11,21440137,1-21440170-G-C,rs1566523,1,G,C,21440170,33,21243529,21636745,196641
1,ENSG00000142794.11,21440137,1-21440170-G-T,rs1566523,1,G,T,21440170,33,21243529,21636745,196641
1,ENSG00000143156.9,169367797,1-169296598-C-T,rs1591733,-1,C,T,169296598,71199,169171189,169564405,125409
1,ENSG00000049247.8,7853065,1-7921974-T-C,rs161827,-1,T,C,7921974,68909,7656457,8049673,265517
1,ENSG00000142686.6,35718884,1-35754957-C-G,rs16822339,-1,C,G,35754957,36073,35522276,35915492,232681
1,ENSG00000142686.6,35718884,1-35754957-C-A,rs16822339,-1,C,A,35754957,36073,35522276,35915492,232681
1,ENSG00000090686.11,21783149,1-21727934-C-A,rs16825896,-1,C,A,21727934,55215,21586541,21979757,141393
1,ENSG00000186141.4,145824200,1-145868002-T-C,rs16827032,1,T,C,145868002,43802,145627592,146020808,240410
1,ENSG00000143387.8,150808260,1-150766283-T-C,rs16827671,-1,T,C,150766283,41977,150611652,151004868,154631
1,ENSG00000007968.6,23531233,1-23439435-A-G,rs16828494,-1,A,G,23439435,91798,23334625,23727841,104810
1,ENSG00000142959.4,44788170,1-44743989-A-G,rs16832210,-1,A,G,44743989,44181,44591562,44984778,152427
1,ENSG00000159445.8,151909511,1-151945688-C-A,rs16833668,-1,C,A,151945688,36177,151712903,152106119,232785
1,ENSG00000159445.8,151909511,1-151945688-C-G,rs16833668,-1,C,G,151945688,36177,151712903,152106119,232785
1,ENSG00000025800.8,32108056,1-32000730-C-T,rs16834799,1,C,T,32000730,107326,31911448,32304664,89282
1,ENSG00000143624.9,153728050,1-153558806-C-G,rs16835437,1,C,G,153558806,169244,153531442,153924658,27364
1,ENSG00000116819.6,35573314,1-35453577-T-C,rs16837364,1,T,C,35453577,119737,35376706,35769922,76871
1,ENSG00000213047.6,197775480,1-197824352-T-C,rs16841984,-1,T,C,197824352,48872,197578872,197972088,245480
1,ENSG00000120332.10,175067833,1-175123014-G-A,rs16847820,1,G,A,175123014,55181,174871225,175264441,251789
1,ENSG00000169905.7,179877803,1-179794476-A-G,rs16854720,-1,A,G,179794476,83327,179681195,180074411,113281
1,ENSG00000117477.8,169427474,1-169464882-T-C,rs16862199,-1,T,C,169464882,37408,169230866,169624082,234016
1,ENSG00000162522.6,32741830,1-32775688-T-C,rs16866009,1,T,C,32775688,33858,32545222,32938438,230466
1,ENSG00000162757.3,209784559,1-209805432-T-C,rs17015250,-1,T,C,209805432,20873,209587951,209981167,217481
1,ENSG00000162757.3,209784559,1-209805432-T-G,rs17015250,-1,T,G,209805432,20873,209587951,209981167,217481
1,ENSG00000170385.9,211579161,1-211697168-G-C,rs17017943,-1,G,C,211697168,118007,211382553,211775769,314615
1,ENSG00000123684.8,211830763,1-211697168-G-C,rs17017943,-1,G,C,211697168,133595,211634155,212027371,63013
1,ENSG00000163349.15,113929324,1-113989835-A-G,rs17032085,1,A,G,113989835,60511,113732716,114125932,257119
1,ENSG00000134247.8,116909916,1-117094538-C-T,rs17036849,1,C,T,117094538,184622,116713308,117106524,381230
1,ENSG00000137955.10,75786256,1-75975837-A-T,rs17097780,1,A,T,75975837,189581,75589648,75982864,386189
1,ENSG00000122432.11,84506397,1-84512749-T-C,rs17110590,1,T,C,84512749,6352,84309789,84703005,202960
1,ENSG00000055732.7,85048500,1-85019487-C-G,rs17119333,-1,C,G,85019487,29013,84851892,85245108,167595
1,ENSG00000131591.12,1116089,1-1050520-C-G,rs17160776,-1,C,G,1050520,65569,919481,1312697,131039
1,ENSG00000131591.12,1116089,1-1050520-C-T,rs17160776,-1,C,T,1050520,65569,919481,1312697,131039
1,ENSG00000186063.8,222712491,1-222719897-T-C,rs17163447,-1,T,C,222719897,7406,222515883,222909099,204014
1,ENSG00000117748.5,27914575,1-27893147-C-G,rs17185038,-1,C,G,27893147,21428,27717967,28111183,175180
1,ENSG00000117748.5,27914575,1-27893147-C-T,rs17185038,-1,C,T,27893147,21428,27717967,28111183,175180
1,ENSG00000162604.6,61725141,1-61723869-T-C,rs17312971,-1,T,C,61723869,1272,61528533,61921749,195336
1,ENSG00000143479.11,206635536,1-206700389-C-T,rs17350838,1,C,T,206700389,64853,206438928,206832144,261461
1,ENSG00000074800.8,8878686,1-8956243-T-G,rs17389460,-1,T,G,8956243,77557,8682078,9075294,274165
1,ENSG00000081721.6,161749786,1-161758137-C-T,rs17415505,1,C,T,161758137,8351,161553178,161946394,204959
1,ENSG00000079335.13,100352506,1-100353172-T-G,rs17420882,1,T,G,100353172,666,100155898,100549114,197274
1,ENSG00000079335.13,100352506,1-100353172-T-C,rs17420882,1,T,C,100353172,666,100155898,100549114,197274
1,ENSG00000117226.7,89022866,1-89009135-A-G,rs17433780,-1,A,G,89009135,13731,88826258,89219474,182877
1,ENSG00000142623.8,17205128,1-17196740-T-C,rs17456119,1,T,C,17196740,8388,17008520,17401736,188220
1,ENSG00000134262.8,113904799,1-113901277-G-A,rs17464525,-1,G,A,113901277,3522,113708191,114101407,193086
1,ENSG00000162813.12,220089788,1-220219070-A-C,rs17565134,-1,A,C,220219070,129282,219893180,220286396,325890
1,ENSG00000162813.12,220089788,1-220219070-A-G,rs17565134,-1,A,G,220219070,129282,219893180,220286396,325890
1,ENSG00000143079.7,112396214,1-112421990-G-T,rs1759684,1,G,T,112421990,25776,112199606,112592822,222384
1,ENSG00000143079.7,112396214,1-112421990-G-C,rs1759684,1,G,C,112421990,25776,112199606,112592822,222384
1,ENSG00000143079.7,112396214,1-112421990-G-A,rs1759684,1,G,A,112421990,25776,112199606,112592822,222384
1,ENSG00000184908.12,16043782,1-16012430-T-C,rs1763605,1,T,C,16012430,31352,15847174,16240390,165256
1,ENSG00000184908.12,16043782,1-16012430-T-G,rs1763605,1,T,G,16012430,31352,15847174,16240390,165256
1,ENSG00000184908.12,16043782,1-16012430-T-A,rs1763605,1,T,A,16012430,31352,15847174,16240390,165256
1,ENSG00000173641.12,16018043,1-16012430-T-C,rs1763605,-1,T,C,16012430,5613,15821435,16214651,190995
1,ENSG00000173641.12,16018043,1-16012430-T-G,rs1763605,-1,T,G,16012430,5613,15821435,16214651,190995
1,ENSG00000173641.12,16018043,1-16012430-T-A,rs1763605,-1,T,A,16012430,5613,15821435,16214651,190995
1,ENSG00000092607.8,118988343,1-118924504-C-A,rs1779437,-1,C,A,118924504,63839,118791735,119184951,132769
1,ENSG00000092607.8,118988343,1-118924504-C-T,rs1779437,-1,C,T,118924504,63839,118791735,119184951,132769
1,ENSG00000092607.8,118988343,1-118924504-C-G,rs1779437,-1,C,G,118924504,63839,118791735,119184951,132769
1,ENSG00000171729.8,15153747,1-15151369-G-A,rs1883761,1,G,A,15151369,2378,14957139,15350355,194230
1,ENSG00000171729.8,15153747,1-15151369-G-T,rs1883761,1,G,T,15151369,2378,14957139,15350355,194230
1,ENSG00000171729.8,15153747,1-15151369-G-C,rs1883761,1,G,C,15151369,2378,14957139,15350355,194230
1,ENSG00000162739.9,160523255,1-160339874-T-A,rs1886419,-1,T,A,160339874,183381,160326647,160719863,13227
1,ENSG00000162739.9,160523255,1-160339874-T-G,rs1886419,-1,T,G,160339874,183381,160326647,160719863,13227
1,ENSG00000163874.7,37474580,1-37298985-C-G,rs1888698,1,C,G,37298985,175595,37277972,37671188,21013
1,ENSG00000163874.7,37474580,1-37298985-C-T,rs1888698,1,C,T,37298985,175595,37277972,37671188,21013
1,ENSG00000116954.7,38859772,1-38859187-C-A,rs1925679,-1,C,A,38859187,585,38663164,39056380,196023
1,ENSG00000116954.7,38859772,1-38859187-C-G,rs1925679,-1,C,G,38859187,585,38663164,39056380,196023
1,ENSG00000163568.9,159076766,1-159080313-G-A,rs1935067,-1,G,A,159080313,3547,158880158,159273374,200155
1,ENSG00000116514.11,32964809,1-32943950-C-T,rs194644,-1,C,T,32943950,20859,32768201,33161417,175749
1,ENSG00000116514.11,32964809,1-32943950-C-A,rs194644,-1,C,A,32943950,20859,32768201,33161417,175749
1,ENSG00000072694.13,161663143,1-161707945-T-G,rs1954172,1,T,G,161707945,44802,161466535,161859751,241410
1,ENSG00000072694.13,161663143,1-161707945-T-C,rs1954172,1,T,C,161707945,44802,161466535,161859751,241410
1,ENSG00000117602.6,24502836,1-24483579-A-C,rs195700,1,A,C,24483579,19257,24306228,24699444,177351
1,ENSG00000117602.6,24502836,1-24483579-A-G,rs195700,1,A,G,24483579,19257,24306228,24699444,177351
1,ENSG00000158055.11,24319357,1-24457707-T-C,rs195718,1,T,C,24457707,138350,24122749,24515965,334958
1,ENSG00000158055.11,24319357,1-24457707-T-A,rs195718,1,T,A,24457707,138350,24122749,24515965,334958
1,ENSG00000197852.7,111739395,1-111749022-C-T,rs197377,-1,C,T,111749022,9627,111542787,111936003,206235
1,ENSG00000197852.7,111739395,1-111749022-C-A,rs197377,-1,C,A,111749022,9627,111542787,111936003,206235
1,ENSG00000197852.7,111739395,1-111749022-C-G,rs197377,-1,C,G,111749022,9627,111542787,111936003,206235
1,ENSG00000143195.7,166975540,1-166931958-T-G,rs2014854,-1,T,G,166931958,43582,166778932,167172148,153026
1,ENSG00000143195.7,166975540,1-166931958-T-C,rs2014854,-1,T,C,166931958,43582,166778932,167172148,153026
1,ENSG00000116406.13,184754858,1-184684499-T-G,rs2024766,-1,T,G,184684499,70359,184558250,184951466,126249
1,ENSG00000116406.13,184754858,1-184684499-T-C,rs2024766,-1,T,C,184684499,70359,184558250,184951466,126249
1,ENSG00000159023.13,28914569,1-28818612-G-T,rs204047,1,G,T,28818612,95957,28717961,29111177,100651
1,ENSG00000159023.13,28914569,1-28818612-G-C,rs204047,1,G,C,28818612,95957,28717961,29111177,100651
1,ENSG00000136643.7,213051241,1-212889455-A-G,rs2047291,1,A,G,212889455,161786,212854633,213247849,34822
1,ENSG00000177628.8,155241249,1-155225189-T-C,rs2049805,-1,T,C,155225189,16060,155044641,155437857,180548
1,ENSG00000177628.8,155241249,1-155225189-T-A,rs2049805,-1,T,A,155225189,16060,155044641,155437857,180548
1,ENSG00000177628.8,155241249,1-155225189-T-G,rs2049805,-1,T,G,155225189,16060,155044641,155437857,180548
1,ENSG00000179178.6,43269983,1-43360428-A-G,rs2069385,1,A,G,43360428,90445,43073375,43466591,287053
1,ENSG00000143155.8,168178962,1-168199512-A-C,rs2072778,1,A,C,168199512,20550,167982354,168375570,217158
1,ENSG00000143155.8,168178962,1-168199512-A-G,rs2072778,1,A,G,168199512,20550,167982354,168375570,217158
1,ENSG00000204219.5,23424748,1-23451869-C-G,rs2077066,-1,C,G,23451869,27121,23228140,23621356,223729
1,ENSG00000204219.5,23424748,1-23451869-C-T,rs2077066,-1,C,T,23451869,27121,23228140,23621356,223729
1,ENSG00000121903.8,33472645,1-33586065-G-T,rs2077821,1,G,T,33586065,113420,33276037,33669253,310028
1,ENSG00000001460.12,24413782,1-24401188-C-T,rs2078445,-1,C,T,24401188,12594,24217174,24610390,184014
1,ENSG00000001460.12,24413782,1-24401188-C-G,rs2078445,-1,C,G,24401188,12594,24217174,24610390,184014
1,ENSG00000163462.12,155173849,1-154988972-T-G,rs2089247,1,T,G,154988972,184877,154977241,155370457,11731
1,ENSG00000121644.14,244653126,1-244825104-A-G,rs2101871,1,A,G,244825104,171978,244456518,244849734,368586
1,ENSG00000127423.6,25859457,1-25862134-G-T,rs213637,-1,G,T,25862134,2677,25662849,26056065,199285
1,ENSG00000127423.6,25859457,1-25862134-G-A,rs213637,-1,G,A,25862134,2677,25662849,26056065,199285
1,ENSG00000082512.10,211326833,1-211332403-T-A,rs2175633,1,T,A,211332403,5570,211130225,211523441,202178
1,ENSG00000082512.10,211326833,1-211332403-T-C,rs2175633,1,T,C,211332403,5570,211130225,211523441,202178
1,ENSG00000082512.10,211326833,1-211332403-T-G,rs2175633,1,T,G,211332403,5570,211130225,211523441,202178
1,ENSG00000142632.10,16212652,1-16203554-C-T,rs221045,-1,C,T,16203554,9098,16016044,16409260,187510
1,ENSG00000132881.5,16237183,1-16210794-T-C,rs221063,-1,T,C,16210794,26389,16040575,16433791,170219
1,ENSG00000132881.5,16237183,1-16210794-T-A,rs221063,-1,T,A,16210794,26389,16040575,16433791,170219
1,ENSG00000132881.5,16237183,1-16210794-T-G,rs221063,-1,T,G,16210794,26389,16040575,16433791,170219
1,ENSG00000187801.9,40450476,1-40307451-G-A,rs2228567,1,G,A,40307451,143025,40253868,40647084,53583
1,ENSG00000187801.9,40450476,1-40307451-G-C,rs2228567,1,G,C,40307451,143025,40253868,40647084,53583
1,ENSG00000187801.9,40450476,1-40307451-G-T,rs2228567,1,G,T,40307451,143025,40253868,40647084,53583
1,ENSG00000134202.6,109741038,1-109714968-T-C,rs2229059,-1,T,C,109714968,26070,109544430,109937646,170538
1,ENSG00000134202.6,109741038,1-109714968-T-A,rs2229059,-1,T,A,109714968,26070,109544430,109937646,170538
1,ENSG00000010165.13,171781660,1-171796451-G-A,rs2232826,1,G,A,171796451,14791,171585052,171978268,211399
1,ENSG00000010165.13,171781660,1-171796451-G-T,rs2232826,1,G,T,171796451,14791,171585052,171978268,211399
1,ENSG00000010165.13,171781660,1-171796451-G-C,rs2232826,1,G,C,171796451,14791,171585052,171978268,211399
1,ENSG00000157881.8,2526596,1-2562891-G-C,rs2234167,-1,G,C,2562891,36295,2329988,2723204,232903
1,ENSG00000157881.8,2526596,1-2562891-G-A,rs2234167,-1,G,A,2562891,36295,2329988,2723204,232903
1,ENSG00000117115.8,17119451,1-17098350-C-A,rs2235914,-1,C,A,17098350,21101,16922843,17316059,175507
1,ENSG00000117115.8,17119451,1-17098350-C-T,rs2235914,-1,C,T,17098350,21101,16922843,17316059,175507
1,ENSG00000157873.11,2556371,1-2559459-C-A,rs2257763,1,C,A,2559459,3088,2359763,2752979,199696
1,ENSG00000157873.11,2556371,1-2559459-C-G,rs2257763,1,C,G,2559459,3088,2359763,2752979,199696
1,ENSG00000157873.11,2556371,1-2559459-C-T,rs2257763,1,C,T,2559459,3088,2359763,2752979,199696
1,ENSG00000178028.8,44213471,1-44357036-G-A,rs226070,1,G,A,44357036,143565,44016863,44410079,340173
1,ENSG00000143850.6,204359929,1-204490400-C-T,rs2271417,-1,C,T,204490400,130471,204163321,204556537,327079
1,ENSG00000049089.9,40317286,1-40314169-G-T,rs2273195,-1,G,T,40314169,3117,40120678,40513894,193491
1,ENSG00000225828.1,32362485,1-32366691-A-G,rs2273376,-1,A,G,32366691,4206,32165877,32559093,200814
1,ENSG00000242485.1,1407293,1-1407232-G-C,rs2275915,-1,G,C,1407232,61,1210685,1603901,196547
1,ENSG00000242485.1,1407293,1-1407232-G-A,rs2275915,-1,G,A,1407232,61,1210685,1603901,196547
1,ENSG00000242485.1,1407293,1-1407232-G-T,rs2275915,-1,G,T,1407232,61,1210685,1603901,196547
1,ENSG00000197147.6,89524829,1-89582573-T-C,rs2279085,1,T,C,89582573,57744,89328221,89721437,254352
1,ENSG00000049249.4,7940839,1-7857497-T-C,rs228636,-1,T,C,7857497,83342,7744231,8137447,113266
1,ENSG00000049249.4,7940839,1-7857497-T-A,rs228636,-1,T,A,7857497,83342,7744231,8137447,113266
1,ENSG00000160781.9,156248056,1-156260415-C-G,rs2287024,-1,C,G,156260415,12359,156051448,156444664,208967
1,ENSG00000160781.9,156248056,1-156260415-C-A,rs2287024,-1,C,A,156260415,12359,156051448,156444664,208967
1,ENSG00000158286.8,6206119,1-6212753-C-G,rs2294711,1,C,G,6212753,6634,6009511,6402727,203242
1,ENSG00000158286.8,6206119,1-6212753-C-T,rs2294711,1,C,T,6212753,6634,6009511,6402727,203242
1,ENSG00000222009.4,44808482,1-44827194-G-A,rs2295996,1,G,A,44827194,18712,44611874,45005090,215320
1,ENSG00000222009.4,44808482,1-44827194-G-C,rs2295996,1,G,C,44827194,18712,44611874,45005090,215320
1,ENSG00000222009.4,44808482,1-44827194-G-T,rs2295996,1,G,T,44827194,18712,44611874,45005090,215320
1,ENSG00000183856.6,156572565,1-156416995-T-C,rs2296373,-1,T,C,156416995,155570,156375957,156769173,41038
1,ENSG00000183856.6,156572565,1-156416995-T-A,rs2296373,-1,T,A,156416995,155570,156375957,156769173,41038
1,ENSG00000162384.7,53220634,1-53235909-A-G,rs2297656,-1,A,G,53235909,15275,53024026,53417242,211883
1,ENSG00000162384.7,53220634,1-53235909-A-T,rs2297656,-1,A,T,53235909,15275,53024026,53417242,211883
1,ENSG00000162384.7,53220634,1-53235909-A-C,rs2297656,-1,A,C,53235909,15275,53024026,53417242,211883
1,ENSG00000116985.6,39788865,1-39790200-T-G,rs230280,-1,T,G,39790200,1335,39592257,39985473,197943
1,ENSG00000198754.4,39771348,1-39790200-T-G,rs230280,-1,T,G,39790200,18852,39574740,39967956,215460
1,ENSG00000188396.2,44807351,1-44700841-T-A,rs2355710,-1,T,A,44700841,106510,44610743,45003959,90098
1,ENSG00000188396.2,44807351,1-44700841-T-C,rs2355710,-1,T,C,44700841,106510,44610743,45003959,90098
1,ENSG00000188396.2,44807351,1-44700841-T-G,rs2355710,-1,T,G,44700841,106510,44610743,45003959,90098
1,ENSG00000143319.11,156728766,1-156645402-G-T,rs2365716,-1,G,T,156645402,83364,156532158,156925374,113244
1,ENSG00000143319.11,156728766,1-156645402-G-C,rs2365716,-1,G,C,156645402,83364,156532158,156925374,113244
1,ENSG00000143319.11,156728766,1-156645402-G-A,rs2365716,-1,G,A,156645402,83364,156532158,156925374,113244
1,ENSG00000198734.6,169586481,1-169759150-T-G,rs2420506,-1,T,G,169759150,172669,169389873,169783089,369277
1,ENSG00000198734.6,169586481,1-169759150-T-C,rs2420506,-1,T,C,169759150,172669,169389873,169783089,369277
1,ENSG00000198734.6,169586481,1-169759150-T-A,rs2420506,-1,T,A,169759150,172669,169389873,169783089,369277
1,ENSG00000057757.5,23778418,1-23786206-A-C,rs2473381,1,A,C,23786206,7788,23581810,23975026,204396
1,ENSG00000057757.5,23778418,1-23786206-A-T,rs2473381,1,A,T,23786206,7788,23581810,23975026,204396
1,ENSG00000086619.9,236281958,1-236221641-C-G,rs2477586,-1,C,G,236221641,60317,236085350,236478566,136291
1,ENSG00000086619.9,236281958,1-236221641-C-T,rs2477586,-1,C,T,236221641,60317,236085350,236478566,136291
1,ENSG00000160049.6,10472529,1-10507601-C-T,rs2480786,-1,C,T,10507601,35072,10275921,10669137,231680
1,ENSG00000160049.6,10472529,1-10507601-C-A,rs2480786,-1,C,A,10507601,35072,10275921,10669137,231680
1,ENSG00000160049.6,10472529,1-10507601-C-G,rs2480786,-1,C,G,10507601,35072,10275921,10669137,231680
1,ENSG00000133063.11,203229673,1-203269440-A-G,rs2486928,-1,A,G,203269440,39767,203033065,203426281,236375
1,ENSG00000213085.5,159900165,1-159895867-G-C,rs2494488,-1,G,C,159895867,4298,159703557,160096773,192310
1,ENSG00000213085.5,159900165,1-159895867-G-A,rs2494488,-1,G,A,159895867,4298,159703557,160096773,192310
1,ENSG00000213085.5,159900165,1-159895867-G-T,rs2494488,-1,G,T,159895867,4298,159703557,160096773,192310
1,ENSG00000143207.14,176207286,1-176075081-A-T,rs2502827,-1,A,T,176075081,132205,176010678,176403894,64403
1,ENSG00000143207.14,176207286,1-176075081-A-C,rs2502827,-1,A,C,176075081,132205,176010678,176403894,64403
1,ENSG00000143207.14,176207286,1-176075081-A-G,rs2502827,-1,A,G,176075081,132205,176010678,176403894,64403
1,ENSG00000159527.3,153312952,1-153330351-T-C,rs2570440,-1,T,C,153330351,17399,153116344,153509560,214007
1,ENSG00000159527.3,153312952,1-153330351-T-A,rs2570440,-1,T,A,153330351,17399,153116344,153509560,214007
1,ENSG00000159527.3,153312952,1-153330351-T-G,rs2570440,-1,T,G,153330351,17399,153116344,153509560,214007
1,ENSG00000076356.6,208244384,1-208166028-T-C,rs2590684,-1,T,C,208166028,78356,208047776,208440992,118252
1,ENSG00000076356.6,208244384,1-208166028-T-A,rs2590684,-1,T,A,208166028,78356,208047776,208440992,118252
1,ENSG00000076356.6,208244384,1-208166028-T-G,rs2590684,-1,T,G,208166028,78356,208047776,208440992,118252
1,ENSG00000185155.6,226223664,1-226305728-T-A,rs2615803,1,T,A,226305728,82064,226027056,226420272,278672
1,ENSG00000185155.6,226223664,1-226305728-T-C,rs2615803,1,T,C,226305728,82064,226027056,226420272,278672
1,ENSG00000177272.7,110674940,1-110667697-C-A,rs2640482,-1,C,A,110667697,7243,110478332,110871548,189365
1,ENSG00000177272.7,110674940,1-110667697-C-T,rs2640482,-1,C,T,110667697,7243,110478332,110871548,189365
1,ENSG00000171385.5,111989668,1-112086238-T-C,rs269101,-1,T,C,112086238,96570,111793060,112186276,293178
1,ENSG00000171385.5,111989668,1-112086238-T-A,rs269101,-1,T,A,112086238,96570,111793060,112186276,293178
1,ENSG00000171385.5,111989668,1-112086238-T-G,rs269101,-1,T,G,112086238,96570,111793060,112186276,293178
1,ENSG00000159166.9,201399324,1-201401119-G-A,rs2719178,-1,G,A,201401119,1795,201202716,201595932,198403
1,ENSG00000159166.9,201399324,1-201401119-G-C,rs2719178,-1,G,C,201401119,1795,201202716,201595932,198403
1,ENSG00000117335.13,207752054,1-207767846-G-C,rs2724374,1,G,C,207767846,15792,207555446,207948662,212400
1,ENSG00000117335.13,207752054,1-207767846-G-A,rs2724374,1,G,A,207767846,15792,207555446,207948662,212400
1,ENSG00000117335.13,207752054,1-207767846-G-T,rs2724374,1,G,T,207767846,15792,207555446,207948662,212400
1,ENSG00000163041.5,226062716,1-226000198-C-G,rs2755093,1,C,G,226000198,62518,225866108,226259324,134090
1,ENSG00000163041.5,226062716,1-226000198-C-T,rs2755093,1,C,T,226000198,62518,225866108,226259324,134090
1,ENSG00000116704.6,67054148,1-67051339-T-A,rs2755259,-1,T,A,67051339,2809,66857540,67250756,193799
1,ENSG00000116704.6,67054148,1-67051339-T-G,rs2755259,-1,T,G,67051339,2809,66857540,67250756,193799
1,ENSG00000116704.6,67054148,1-67051339-T-C,rs2755259,-1,T,C,67051339,2809,66857540,67250756,193799
1,ENSG00000162896.5,206946466,1-206980414-G-A,rs2791714,-1,G,A,206980414,33948,206749858,207143074,230556
1,ENSG00000143337.11,179882285,1-179838803-T-C,rs2794582,1,T,C,179838803,43482,179685677,180078893,153126
1,ENSG00000143337.11,179882285,1-179838803-T-A,rs2794582,1,T,A,179838803,43482,179685677,180078893,153126
1,ENSG00000177868.7,42817397,1-42802299-T-C,rs2816602,-1,T,C,42802299,15098,42620789,43014005,181510
1,ENSG00000143194.7,166989280,1-166908272-G-A,rs2837,1,G,A,166908272,81008,166792672,167185888,115600
1,ENSG00000143614.7,153922972,1-154045025-T-G,rs2841102,-1,T,G,154045025,122053,153726364,154119580,318661
1,ENSG00000143614.7,153922972,1-154045025-T-C,rs2841102,-1,T,C,154045025,122053,153726364,154119580,318661
1,ENSG00000116809.6,15976101,1-16090531-G-C,rs28429281,-1,G,C,16090531,114430,15779493,16172709,311038
1,ENSG00000116809.6,15976101,1-16090531-G-T,rs28429281,-1,G,T,16090531,114430,15779493,16172709,311038
1,ENSG00000116809.6,15976101,1-16090531-G-A,rs28429281,-1,G,A,16090531,114430,15779493,16172709,311038
1,ENSG00000159388.5,203305519,1-203453530-G-T,rs28495422,1,G,T,203453530,148011,203108911,203502127,344619
1,ENSG00000188558.4,248508073,1-248680577-T-C,rs28520471,1,T,C,248680577,172504,248311465,248704681,369112
1,ENSG00000204084.6,37947053,1-37901235-T-C,rs28739509,-1,T,C,37901235,45818,37750445,38143661,150790
1,ENSG00000143476.12,212035748,1-211993848-G-A,rs2884428,1,G,A,211993848,41900,211839140,212232356,154708
1,ENSG00000116791.9,74733050,1-74742350-C-A,rs28879157,-1,C,A,74742350,9300,74536442,74929658,205908
1,ENSG00000116791.9,74733050,1-74742350-C-G,rs28879157,-1,C,G,74742350,9300,74536442,74929658,205908
1,ENSG00000116791.9,74733050,1-74742350-C-T,rs28879157,-1,C,T,74742350,9300,74536442,74929658,205908
1,ENSG00000117640.13,25819954,1-25929240-T-C,rs298438,1,T,C,25929240,109286,25623346,26016562,305894
1,ENSG00000117632.16,25906419,1-25963989-G-A,rs298450,-1,G,A,25963989,57570,25709811,26103027,254178
1,ENSG00000117632.16,25906419,1-25963989-G-C,rs298450,-1,G,C,25963989,57570,25709811,26103027,254178
1,ENSG00000197747.4,151993859,1-151999021-C-T,rs2999531,-1,C,T,151999021,5162,151797251,152190467,201770
1,ENSG00000163191.5,152037004,1-152042009-T-G,rs2999555,-1,T,G,152042009,5005,151840396,152233612,201613
1,ENSG00000225556.1,151840557,1-151973153-T-A,rs3007700,-1,T,A,151973153,132596,151643949,152037165,329204
1,ENSG00000117151.7,84574440,1-84547718-C-G,rs3021402,-1,C,G,84547718,26722,84377832,84771048,169886
1,ENSG00000117151.7,84574440,1-84547718-C-T,rs3021402,-1,C,T,84547718,26722,84377832,84771048,169886
1,ENSG00000142224.11,206770773,1-206768184-T-C,rs3024498,1,T,C,206768184,2589,206574165,206967381,194019
1,ENSG00000117298.10,21290463,1-21305977-C-T,rs3026845,-1,C,T,21305977,15514,21093855,21487071,212122
1,ENSG00000075151.13,21176897,1-21255486-C-A,rs3026883,-1,C,A,21255486,78589,20980289,21373505,275197
1,ENSG00000075151.13,21176897,1-21255486-C-T,rs3026883,-1,C,T,21255486,78589,20980289,21373505,275197
1,ENSG00000075151.13,21176897,1-21255486-C-G,rs3026883,-1,C,G,21255486,78589,20980289,21373505,275197
1,ENSG00000035687.8,244451909,1-244409279-T-A,rs3087609,-1,T,A,244409279,42630,244255301,244648517,153978
1,ENSG00000035687.8,244451909,1-244409279-T-C,rs3087609,-1,T,C,244409279,42630,244255301,244648517,153978
1,ENSG00000116663.6,11664200,1-11658138-A-G,rs3125816,1,A,G,11658138,6062,11467592,11860808,190546
1,ENSG00000132879.9,11654877,1-11658138-A-G,rs3125816,1,A,G,11658138,3261,11458269,11851485,199869
1,ENSG00000185420.13,246507279,1-246524284-C-T,rs3129586,-1,C,T,246524284,17005,246310671,246703887,213613
1,ENSG00000185420.13,246507279,1-246524284-C-G,rs3129586,-1,C,G,246524284,17005,246310671,246703887,213613
1,ENSG00000131238.10,40097252,1-40089649-C-T,rs3131651,-1,C,T,40089649,7603,39900644,40293860,189005
1,ENSG00000131238.10,40097252,1-40089649-C-A,rs3131651,-1,C,A,40089649,7603,39900644,40293860,189005
1,ENSG00000137996.8,100266216,1-100252204-C-G,rs3131837,1,C,G,100252204,14012,100069608,100462824,182596
1,ENSG00000137996.8,100266216,1-100252204-C-A,rs3131837,1,C,A,100252204,14012,100069608,100462824,182596
1,ENSG00000123080.6,50970245,1-50972693-C-T,rs3176466,1,C,T,50972693,2448,50773637,51166853,199056
1,ENSG00000142676.8,23691806,1-23522655-C-T,rs3218162,1,C,T,23522655,169151,23495198,23888414,27457
1,ENSG00000186603.4,45326895,1-45330682-G-T,rs3219492,1,G,T,45330682,3787,45130287,45523503,200395
1,ENSG00000204160.5,26826688,1-26877692-T-C,rs34204245,1,T,C,26877692,51004,26630080,27023296,247612
1,ENSG00000142583.11,9069635,1-9041096-T-G,rs34488100,-1,T,G,9041096,28539,8873027,9266243,168069
1,ENSG00000143420.12,150629612,1-150766559-C-A,rs34711732,-1,C,A,150766559,136947,150433004,150826220,333555
1,ENSG00000143420.12,150629612,1-150766559-C-T,rs34711732,-1,C,T,150766559,136947,150433004,150826220,333555
1,ENSG00000000938.7,27635185,1-27631828-C-T,rs34806307,-1,C,T,27631828,3357,27438577,27831793,193251
1,ENSG00000179163.10,23868290,1-23865710-A-G,rs34902309,-1,A,G,23865710,2580,23671682,24064898,194028
1,ENSG00000179163.10,23868290,1-23865710-A-T,rs34902309,-1,A,T,23865710,2580,23671682,24064898,194028
1,ENSG00000116489.8,112619832,1-112512037-C-T,rs351370,1,C,T,112512037,107795,112423224,112816440,88813
1,ENSG00000116489.8,112619832,1-112512037-C-A,rs351370,1,C,A,112512037,107795,112423224,112816440,88813
1,ENSG00000117091.5,160711822,1-160712046-C-G,rs352685,-1,C,G,160712046,224,160515214,160908430,196832
1,ENSG00000117091.5,160711822,1-160712046-C-T,rs352685,-1,C,T,160712046,224,160515214,160908430,196832
1,ENSG00000162461.7,15736258,1-15735471-G-A,rs35352784,1,G,A,15735471,787,15539650,15932866,195821
1,ENSG00000162373.7,48776891,1-48592045-T-C,rs35615859,-1,T,C,48592045,184846,48580283,48973499,11762
1,ENSG00000162373.7,48776891,1-48592045-T-G,rs35615859,-1,T,G,48592045,184846,48580283,48973499,11762
1,ENSG00000158748.3,19664875,1-19745589-C-T,rs35760408,1,C,T,19745589,80714,19468267,19861483,277322
1,ENSG00000143537.8,155051316,1-155070410-T-G,rs35902694,1,T,G,155070410,19094,154854708,155247924,215702
1,ENSG00000143537.8,155051316,1-155070410-T-A,rs35902694,1,T,A,155070410,19094,154854708,155247924,215702
1,ENSG00000157978.6,25543606,1-25549972-A-G,rs35983441,1,A,G,25549972,6366,25346998,25740214,202974
1,ENSG00000189409.7,1632173,1-1689421-G-A,rs3737622,1,G,A,1689421,57248,1435565,1828781,253856
1,ENSG00000163485.11,203127726,1-203174267-T-A,rs3737872,1,T,A,203174267,46541,202931118,203324334,243149
1,ENSG00000163485.11,203127726,1-203174267-T-C,rs3737872,1,T,C,203174267,46541,202931118,203324334,243149
1,ENSG00000157193.10,53328070,1-53250744-G-A,rs3737983,-1,G,A,53250744,77326,53131462,53524678,119282
1,ENSG00000157193.10,53328070,1-53250744-G-T,rs3737983,-1,G,T,53250744,77326,53131462,53524678,119282
1,ENSG00000160716.4,154567778,1-154600943-C-T,rs3738032,1,C,T,154600943,33165,154371170,154764386,229773
1,ENSG00000162378.8,52726453,1-52698877-C-A,rs374662,1,C,A,52698877,27576,52529845,52923061,169032
1,ENSG00000143013.7,87328880,1-87343666-C-T,rs3753290,1,C,T,87343666,14786,87132272,87525488,211394
1,ENSG00000187608.5,1013497,1-1208816-T-C,rs3753350,1,T,C,1208816,195319,816889,1210105,391927
1,ENSG00000117262.14,145607988,1-145716953-T-C,rs3753436,1,T,C,145716953,108965,145411380,145804596,305573
1,ENSG00000117262.14,145607988,1-145716953-T-A,rs3753436,1,T,A,145716953,108965,145411380,145804596,305573
1,ENSG00000203668.1,241640369,1-241615528-T-A,rs3765815,-1,T,A,241615528,24841,241443761,241836977,171767
1,ENSG00000203668.1,241640369,1-241615528-T-C,rs3765815,-1,T,C,241615528,24841,241443761,241836977,171767
1,ENSG00000117090.8,160647044,1-160645421-G-A,rs3766365,-1,G,A,160645421,1623,160450436,160843652,194985
1,ENSG00000182004.8,203861599,1-203774525-C-T,rs3766748,1,C,T,203774525,87074,203664991,204058207,109534
1,ENSG00000143418.14,150974835,1-150842935-G-A,rs3768013,-1,G,A,150842935,131900,150778227,151171443,64708
1,ENSG00000143418.14,150974835,1-150842935-G-T,rs3768013,-1,G,T,150842935,131900,150778227,151171443,64708
1,ENSG00000168653.6,39026350,1-39026790-C-T,rs3768324,1,C,T,39026790,440,38829742,39222958,197048
1,ENSG00000143772.5,226739282,1-226712714-G-A,rs3768405,-1,G,A,226712714,26568,226542674,226935890,170040
1,ENSG00000126091.15,43707536,1-43584333-G-A,rs3791137,1,G,A,43584333,123203,43510928,43904144,73405
1,ENSG00000126091.15,43707536,1-43584333-G-C,rs3791137,1,G,C,43584333,123203,43510928,43904144,73405
1,ENSG00000197956.4,153535991,1-153658595-G-C,rs3806234,-1,G,C,153658595,122604,153339383,153732599,319212
1,ENSG00000197956.4,153535991,1-153658595-G-A,rs3806234,-1,G,A,153658595,122604,153339383,153732599,319212
1,ENSG00000142920.11,33081153,1-33080995-A-T,rs3806246,1,A,T,33080995,158,32884545,33277761,196450
1,ENSG00000142920.11,33081153,1-33080995-A-G,rs3806246,1,A,G,33080995,158,32884545,33277761,196450
1,ENSG00000143575.10,154272629,1-154191663-A-C,rs3811454,1,A,C,154191663,80966,154076021,154469237,115642
1,ENSG00000203705.5,212791894,1-212920399-C-A,rs3816954,1,C,A,212920399,128505,212595286,212988502,325113
1,ENSG00000203705.5,212791894,1-212920399-C-G,rs3816954,1,C,G,212920399,128505,212595286,212988502,325113
1,ENSG00000203705.5,212791894,1-212920399-C-T,rs3816954,1,C,T,212920399,128505,212595286,212988502,325113
1,ENSG00000134256.8,117001760,1-117001562-A-G,rs3818446,1,A,G,117001562,198,116805152,117198368,196410
1,ENSG00000134256.8,117001760,1-117001562-A-C,rs3818446,1,A,C,117001562,198,116805152,117198368,196410
1,ENSG00000134256.8,117001760,1-117001562-A-T,rs3818446,1,A,T,117001562,198,116805152,117198368,196410
1,ENSG00000163531.10,204828652,1-204991111-C-G,rs3820336,1,C,G,204991111,162459,204632044,205025260,359067
1,ENSG00000163531.10,204828652,1-204991111-C-T,rs3820336,1,C,T,204991111,162459,204632044,205025260,359067
1,ENSG00000116661.8,11654429,1-11663463-A-G,rs3820340,-1,A,G,11663463,9034,11457821,11851037,205642
1,ENSG00000117791.11,220748322,1-220714617-G-A,rs386755,1,G,A,220714617,33705,220551714,220944930,162903
1,ENSG00000117791.11,220748322,1-220714617-G-C,rs386755,1,G,C,220714617,33705,220551714,220944930,162903
1,ENSG00000162817.6,220690363,1-220714617-G-A,rs386755,1,G,A,220714617,24254,220493755,220886971,220862
1,ENSG00000162817.6,220690363,1-220714617-G-C,rs386755,1,G,C,220714617,24254,220493755,220886971,220862
1,ENSG00000186205.8,220786913,1-220714617-G-A,rs386755,1,G,A,220714617,72296,220590305,220983521,124312
1,ENSG00000186205.8,220786913,1-220714617-G-C,rs386755,1,G,C,220714617,72296,220590305,220983521,124312
1,ENSG00000174574.9,38991276,1-39045386-G-C,rs3901310,1,G,C,39045386,54110,38794668,39187884,250718
1,ENSG00000174574.9,38991276,1-39045386-G-T,rs3901310,1,G,T,39045386,54110,38794668,39187884,250718
1,ENSG00000174574.9,38991276,1-39045386-G-A,rs3901310,1,G,A,39045386,54110,38794668,39187884,250718
1,ENSG00000158715.5,205680509,1-205669917-A-G,rs3902968,-1,A,G,205669917,10592,205483901,205877117,186016
1,ENSG00000158715.5,205680509,1-205669917-A-C,rs3902968,-1,A,C,205669917,10592,205483901,205877117,186016
1,ENSG00000118733.11,101996926,1-102011574-T-A,rs3918870,-1,T,A,102011574,14648,101800318,102193534,211256
1,ENSG00000126070.12,35931105,1-36088072-A-G,rs399393,1,A,G,36088072,156967,35734497,36127713,353575
1,ENSG00000160087.16,1273854,1-1268558-T-G,rs4018608,-1,T,G,1268558,5296,1077246,1470462,191312
1,ENSG00000160087.16,1273854,1-1268558-T-C,rs4018608,-1,T,C,1268558,5296,1077246,1470462,191312
1,ENSG00000160087.16,1273854,1-1268558-T-A,rs4018608,-1,T,A,1268558,5296,1077246,1470462,191312
1,ENSG00000001461.11,24415802,1-24580924-G-A,rs4073051,1,G,A,24580924,165122,24219194,24612410,361730
1,ENSG00000186226.7,152786257,1-152786180-C-A,rs41268482,1,C,A,152786180,77,152589649,152982865,196531
1,ENSG00000055070.11,16367242,1-16403813-G-A,rs41269193,1,G,A,16403813,36571,16170634,16563850,233179
1,ENSG00000055070.11,16367242,1-16403813-G-T,rs41269193,1,G,T,16403813,36571,16170634,16563850,233179
1,ENSG00000212916.3,232805416,1-232805469-A-G,rs41271527,1,A,G,232805469,53,232608808,233002024,196661
1,ENSG00000215910.3,11762193,1-11775499-C-T,rs41275456,1,C,T,11775499,13306,11565585,11958801,209914
1,ENSG00000215910.3,11762193,1-11775499-C-A,rs41275456,1,C,A,11775499,13306,11565585,11958801,209914
1,ENSG00000177000.6,11805964,1-11775499-C-T,rs41275456,-1,C,T,11775499,30465,11609356,12002572,166143
1,ENSG00000177000.6,11805964,1-11775499-C-A,rs41275456,-1,C,A,11775499,30465,11609356,12002572,166143
1,ENSG00000171357.5,46203334,1-46343180-C-T,rs41293287,1,C,T,46343180,139846,46006726,46399942,336454
1,ENSG00000171357.5,46203334,1-46343180-C-G,rs41293287,1,C,G,46343180,139846,46006726,46399942,336454
1,ENSG00000126088.7,45012254,1-45016794-C-G,rs41306607,1,C,G,45016794,4540,44815646,45208862,201148
1,ENSG00000117308.9,23800754,1-23696521-C-T,rs41310397,-1,C,T,23696521,104233,23604146,23997362,92375
1,ENSG00000163155.7,151165902,1-151002495-T-G,rs41310885,-1,T,G,151002495,163407,150969294,151362510,33201
1,ENSG00000163155.7,151165902,1-151002495-T-A,rs41310885,-1,T,A,151002495,163407,150969294,151362510,33201
1,ENSG00000186364.6,145845630,1-145872994-T-G,rs41315701,1,T,G,145872994,27364,145649022,146042238,223972
1,ENSG00000186364.6,145845630,1-145872994-T-C,rs41315701,1,T,C,145872994,27364,145649022,146042238,223972
1,ENSG00000143198.7,165631234,1-165630909-G-C,rs4147592,1,G,C,165630909,325,165434626,165827842,196283
1,ENSG00000143198.7,165631234,1-165630909-G-T,rs4147592,1,G,T,165630909,325,165434626,165827842,196283
1,ENSG00000143198.7,165631234,1-165630909-G-A,rs4147592,1,G,A,165630909,325,165434626,165827842,196283
1,ENSG00000162391.5,54623525,1-54571211-A-G,rs41503150,-1,A,G,54571211,52314,54426917,54820133,144294
1,ENSG00000187583.5,966482,1-949435-A-G,rs4246503,1,A,G,949435,17047,769874,1163090,179561
1,ENSG00000187583.5,966482,1-949435-A-T,rs4246503,1,A,T,949435,17047,769874,1163090,179561
1,ENSG00000154305.11,222618097,1-222779028-G-A,rs4256814,1,G,A,222779028,160931,222421489,222814705,357539
1,ENSG00000154305.11,222618097,1-222779028-G-T,rs4256814,1,G,T,222779028,160931,222421489,222814705,357539
1,ENSG00000154305.11,222618097,1-222779028-G-C,rs4256814,1,G,C,222779028,160931,222421489,222814705,357539
1,ENSG00000143222.7,161153978,1-161279997-G-T,rs4271232,1,G,T,161279997,126019,160957370,161350586,322627
1,ENSG00000143222.7,161153978,1-161279997-G-C,rs4271232,1,G,C,161279997,126019,160957370,161350586,322627
1,ENSG00000143222.7,161153978,1-161279997-G-A,rs4271232,1,G,A,161279997,126019,160957370,161350586,322627
1,ENSG00000162885.6,235504452,1-235517074-G-C,rs429328,-1,G,C,235517074,12622,235307844,235701060,209230
1,ENSG00000162885.6,235504452,1-235517074-G-T,rs429328,-1,G,T,235517074,12622,235307844,235701060,209230
1,ENSG00000084636.11,31704017,1-31707759-G-A,rs4295917,-1,G,A,31707759,3742,31507409,31900625,200350
1,ENSG00000160679.8,153634066,1-153770841-G-T,rs4345834,1,G,T,153770841,136775,153437458,153830674,333383
1,ENSG00000160679.8,153634066,1-153770841-G-A,rs4345834,1,G,A,153770841,136775,153437458,153830674,333383
1,ENSG00000162627.12,98661721,1-98701125-A-C,rs4351664,1,A,C,98701125,39404,98465113,98858329,236012
1,ENSG00000162627.12,98661721,1-98701125-A-T,rs4351664,1,A,T,98701125,39404,98465113,98858329,236012
1,ENSG00000162627.12,98661721,1-98701125-A-G,rs4351664,1,A,G,98701125,39404,98465113,98858329,236012
1,ENSG00000204060.4,41361931,1-41439678-G-A,rs4397649,1,G,A,41439678,77747,41165323,41558539,274355
1,ENSG00000173947.9,111346622,1-111292111-C-T,rs4406630,1,C,T,111292111,54511,111150014,111543230,142097
1,ENSG00000162620.10,74198176,1-74198465-T-G,rs4422957,-1,T,G,74198465,289,74001568,74394784,196897
1,ENSG00000162620.10,74198176,1-74198465-T-A,rs4422957,-1,T,A,74198465,289,74001568,74394784,196897
1,ENSG00000162620.10,74198176,1-74198465-T-C,rs4422957,-1,T,C,74198465,289,74001568,74394784,196897
1,ENSG00000142669.8,26280086,1-26388741-G-A,rs4436378,1,G,A,26388741,108655,26083478,26476694,305263
1,ENSG00000142669.8,26280086,1-26388741-G-C,rs4436378,1,G,C,26388741,108655,26083478,26476694,305263
1,ENSG00000142669.8,26280086,1-26388741-G-T,rs4436378,1,G,T,26388741,108655,26083478,26476694,305263
1,ENSG00000027869.7,156816848,1-156743720-C-T,rs4437869,-1,C,T,156743720,73128,156620240,157013456,123480
1,ENSG00000027869.7,156816848,1-156743720-C-A,rs4437869,-1,C,A,156743720,73128,156620240,157013456,123480
1,ENSG00000027869.7,156816848,1-156743720-C-G,rs4437869,-1,C,G,156743720,73128,156620240,157013456,123480
1,ENSG00000215912.6,2801717,1-2607961-T-C,rs4445406,-1,T,C,2607961,193756,2605109,2998325,2852
1,ENSG00000215912.6,2801717,1-2607961-T-G,rs4445406,-1,T,G,2607961,193756,2605109,2998325,2852
1,ENSG00000162377.4,52698347,1-52684524-C-T,rs453501,-1,C,T,52684524,13823,52501739,52894955,182785
1,ENSG00000175137.9,248825915,1-248880451-A-T,rs4584434,-1,A,T,248880451,54536,248629307,249022523,251144
1,ENSG00000175137.9,248825915,1-248880451-A-C,rs4584434,-1,A,C,248880451,54536,248629307,249022523,251144
1,ENSG00000184022.2,248597700,1-248702256-G-A,rs4587597,-1,G,A,248702256,104556,248401092,248794308,301164
1,ENSG00000173846.7,44800377,1-44615094-G-A,rs459420,1,G,A,44615094,185283,44603769,44996985,11325
1,ENSG00000132906.12,15524215,1-15504965-T-G,rs4646049,-1,T,G,15504965,19250,15327607,15720823,177358
1,ENSG00000132906.12,15524215,1-15504965-T-C,rs4646049,-1,T,C,15504965,19250,15327607,15720823,177358
1,ENSG00000169885.5,1915260,1-1906439-C-G,rs4648732,1,C,G,1906439,8821,1718652,2111868,187787
1,ENSG00000169885.5,1915260,1-1906439-C-A,rs4648732,1,C,A,1906439,8821,1718652,2111868,187787
1,ENSG00000169885.5,1915260,1-1906439-C-T,rs4648732,1,C,T,1906439,8821,1718652,2111868,187787
1,ENSG00000054118.9,36224443,1-36290890-A-G,rs4653175,1,A,G,36290890,66447,36027835,36421051,263055
1,ENSG00000054118.9,36224443,1-36290890-A-T,rs4653175,1,A,T,36290890,66447,36027835,36421051,263055
1,ENSG00000163875.11,37514766,1-37513172-T-A,rs4653296,-1,T,A,37513172,1594,37318158,37711374,195014
1,ENSG00000163875.11,37514766,1-37513172-T-C,rs4653296,-1,T,C,37513172,1594,37318158,37711374,195014
1,ENSG00000162594.9,67166454,1-67145930-G-A,rs4655683,1,G,A,67145930,20524,66969846,67363062,176084
1,ENSG00000162594.9,67166454,1-67145930-G-T,rs4655683,1,G,T,67145930,20524,66969846,67363062,176084
1,ENSG00000198771.6,167630232,1-167642133-A-G,rs4656547,1,A,G,167642133,11901,167433624,167826840,208509
1,ENSG00000198771.6,167630232,1-167642133-A-T,rs4656547,1,A,T,167642133,11901,167433624,167826840,208509
1,ENSG00000198771.6,167630232,1-167642133-A-C,rs4656547,1,A,C,167642133,11901,167433624,167826840,208509
1,ENSG00000122223.8,160862887,1-160855523-C-G,rs4656938,-1,C,G,160855523,7364,160666279,161059495,189244
1,ENSG00000122223.8,160862887,1-160855523-C-T,rs4656938,-1,C,T,160855523,7364,160666279,161059495,189244
1,ENSG00000118217.5,161766320,1-161768273-A-T,rs4657100,1,A,T,161768273,1953,161569712,161962928,198561
1,ENSG00000118217.5,161766320,1-161768273-A-G,rs4657100,1,A,G,161768273,1953,161569712,161962928,198561
1,ENSG00000169442.4,26317958,1-26220884-T-C,rs4659413,1,T,C,26220884,97074,26121350,26514566,99534
1,ENSG00000169442.4,26317958,1-26220884-T-A,rs4659413,1,T,A,26220884,97074,26121350,26514566,99534
1,ENSG00000132780.11,45584041,1-45764213-T-A,rs4660314,1,T,A,45764213,180172,45387433,45780649,376780
1,ENSG00000132780.11,45584041,1-45764213-T-C,rs4660314,1,T,C,45764213,180172,45387433,45780649,376780
1,ENSG00000117013.10,40783787,1-40799954-C-T,rs4660463,1,C,T,40799954,16167,40587179,40980395,212775
1,ENSG00000116473.10,111619789,1-111643715-T-C,rs472159,1,T,C,111643715,23926,111423181,111816397,220534
1,ENSG00000116473.10,111619789,1-111643715-T-A,rs472159,1,T,A,111643715,23926,111423181,111816397,220534
1,ENSG00000177551.5,115841126,1-115663802-G-C,rs4839469,-1,G,C,115663802,177324,115644518,116037734,19284
1,ENSG00000177551.5,115841126,1-115663802-G-A,rs4839469,-1,G,A,115663802,177324,115644518,116037734,19284
1,ENSG00000196754.5,153565844,1-153656550-G-C,rs4845563,-1,G,C,153656550,90706,153369236,153762452,287314
1,ENSG00000196754.5,153565844,1-153656550-G-A,rs4845563,-1,G,A,153656550,90706,153369236,153762452,287314
1,ENSG00000196754.5,153565844,1-153656550-G-T,rs4845563,-1,G,T,153656550,90706,153369236,153762452,287314
1,ENSG00000163344.5,154936719,1-154938781-C-G,rs4845693,-1,C,G,154938781,2062,154740111,155133327,198670
1,ENSG00000163344.5,154936719,1-154938781-C-T,rs4845693,-1,C,T,154938781,2062,154740111,155133327,198670
1,ENSG00000117500.7,93180413,1-93162170-T-A,rs4847235,-1,T,A,93162170,18243,92983805,93377021,178365
1,ENSG00000117500.7,93180413,1-93162170-T-C,rs4847235,-1,T,C,93162170,18243,92983805,93377021,178365
1,ENSG00000117505.7,93345907,1-93292893-C-A,rs4847406,1,C,A,93292893,53014,93149299,93542515,143594
1,ENSG00000117505.7,93345907,1-93292893-C-T,rs4847406,1,C,T,93292893,53014,93149299,93542515,143594
1,ENSG00000162643.8,85062327,1-85065181-A-C,rs4907020,1,A,C,85065181,2854,84865719,85258935,199462
1,ENSG00000162643.8,85062327,1-85065181-A-T,rs4907020,1,A,T,85065181,2854,84865719,85258935,199462
1,ENSG00000053371.8,19312144,1-19311596-G-A,rs4911983,-1,G,A,19311596,548,19115536,19508752,196060
1,ENSG00000053371.8,19312144,1-19311596-G-C,rs4911983,-1,G,C,19311596,548,19115536,19508752,196060
1,ENSG00000162482.4,19288770,1-19311596-G-A,rs4911983,-1,G,A,19311596,22826,19092162,19485378,219434
1,ENSG00000162482.4,19288770,1-19311596-G-C,rs4911983,-1,G,C,19311596,22826,19092162,19485378,219434
1,ENSG00000143847.10,203026491,1-203052562-C-T,rs4950875,1,C,T,203052562,26071,202829883,203223099,222679
1,ENSG00000143847.10,203026491,1-203052562-C-G,rs4950875,1,C,G,203052562,26071,202829883,203223099,222679
1,ENSG00000065600.8,212414886,1-212413978-T-C,rs4951595,-1,T,C,212413978,908,212218278,212611494,195700
1,ENSG00000026751.11,160739247,1-160753466-A-T,rs495706,1,A,T,160753466,14219,160542639,160935855,210827
1,ENSG00000026751.11,160739247,1-160753466-A-C,rs495706,1,A,C,160753466,14219,160542639,160935855,210827
1,ENSG00000026751.11,160739247,1-160753466-A-G,rs495706,1,A,G,160753466,14219,160542639,160935855,210827
1,ENSG00000107404.12,1349418,1-1159358-A-C,rs4970362,-1,A,C,1159358,190060,1152810,1546026,6548
1,ENSG00000107404.12,1349418,1-1159358-A-T,rs4970362,-1,A,T,1159358,190060,1152810,1546026,6548
1,ENSG00000107404.12,1349418,1-1159358-A-G,rs4970362,-1,A,G,1159358,190060,1152810,1546026,6548
1,ENSG00000031698.8,109213918,1-109214673-G-A,rs4970829,1,G,A,109214673,755,109017310,109410526,197363
1,ENSG00000188404.4,169711620,1-169696410-G-T,rs4987358,-1,G,T,169696410,15210,169515012,169908228,181398
1,ENSG00000188404.4,169711620,1-169696410-G-A,rs4987358,-1,G,A,169696410,15210,169515012,169908228,181398
1,ENSG00000162909.12,223712539,1-223653639-A-C,rs4993742,1,A,C,223653639,58900,223515931,223909147,137708
1,ENSG00000175206.6,11847783,1-11845917-A-T,rs5068,-1,A,T,11845917,1866,11651175,12044391,194742
1,ENSG00000175206.6,11847783,1-11845917-A-G,rs5068,-1,A,G,11845917,1866,11651175,12044391,194742
1,ENSG00000171488.9,89633120,1-89757841-C-A,rs519989,1,C,A,89757841,124721,89436512,89829728,321329
1,ENSG00000203666.8,244969682,1-244996437-A-T,rs522595,1,A,T,244996437,26755,244773074,245166290,223363
1,ENSG00000203666.8,244969682,1-244996437-A-G,rs522595,1,A,G,244996437,26755,244773074,245166290,223363
1,ENSG00000203666.8,244969682,1-244996437-A-C,rs522595,1,A,C,244996437,26755,244773074,245166290,223363
1,ENSG00000153936.11,86914635,1-86885238-C-G,rs527289,1,C,G,86885238,29397,86718027,87111243,167211
1,ENSG00000181754.6,109509727,1-109519003-T-C,rs534135,-1,T,C,109519003,9276,109313119,109706335,205884
1,ENSG00000142751.7,26890283,1-26800452-T-C,rs55748276,-1,T,C,26800452,89831,26693675,27086891,106777
1,ENSG00000134369.10,201648249,1-201514986-A-G,rs55898420,1,A,G,201514986,133263,201451641,201844857,63345
1,ENSG00000134369.10,201648249,1-201514986-A-C,rs55898420,1,A,C,201514986,133263,201451641,201844857,63345
1,ENSG00000162543.5,20186096,1-20090385-C-G,rs565503,1,C,G,20090385,95711,19989488,20382704,100897
1,ENSG00000162543.5,20186096,1-20090385-C-T,rs565503,1,C,T,20090385,95711,19989488,20382704,100897
1,ENSG00000162543.5,20186096,1-20090385-C-A,rs565503,1,C,A,20090385,95711,19989488,20382704,100897
1,ENSG00000117620.7,99969996,1-99849298-A-G,rs566460,1,A,G,99849298,120698,99773388,100166604,75910
1,ENSG00000117620.7,99969996,1-99849298-A-C,rs566460,1,A,C,99849298,120698,99773388,100166604,75910
1,ENSG00000168765.10,109656099,1-109631153-G-A,rs568686,1,G,A,109631153,24946,109459491,109852707,171662
1,ENSG00000168765.10,109656099,1-109631153-G-T,rs568686,1,G,T,109631153,24946,109459491,109852707,171662
1,ENSG00000213366.6,109668057,1-109670892-A-T,rs574344,1,A,T,109670892,2835,109471449,109864665,199443
1,ENSG00000213366.6,109668057,1-109670892-A-C,rs574344,1,A,C,109670892,2835,109471449,109864665,199443
1,ENSG00000213366.6,109668057,1-109670892-A-G,rs574344,1,A,G,109670892,2835,109471449,109864665,199443
1,ENSG00000122224.10,160796174,1-160766024-A-G,rs574491,1,A,G,160766024,30150,160599566,160992782,166458
1,ENSG00000153898.8,84997113,1-84971243-G-C,rs574954,-1,G,C,84971243,25870,84800505,85193721,170738
1,ENSG00000153898.8,84997113,1-84971243-G-A,rs574954,-1,G,A,84971243,25870,84800505,85193721,170738
1,ENSG00000134243.7,109397918,1-109553275-A-G,rs577953,-1,A,G,109553275,155357,109201310,109594526,351965
1,ENSG00000134243.7,109397918,1-109553275-A-T,rs577953,-1,A,T,109553275,155357,109201310,109594526,351965
1,ENSG00000197982.10,37807790,1-37790494-G-A,rs579689,1,G,A,37790494,17296,37611182,38004398,179312
1,ENSG00000162654.8,89198942,1-89150296-C-T,rs586609,-1,C,T,89150296,48646,89002334,89395550,147962
1,ENSG00000116396.9,110210314,1-110176467-A-T,rs589540,1,A,T,110176467,33847,110013706,110406922,162761
1,ENSG00000116396.9,110210314,1-110176467-A-G,rs589540,1,A,G,110176467,33847,110013706,110406922,162761
1,ENSG00000117016.5,40665682,1-40600072-A-T,rs590775,-1,A,T,40600072,65610,40469074,40862290,130998
1,ENSG00000117016.5,40665682,1-40600072-A-G,rs590775,-1,A,G,40600072,65610,40469074,40862290,130998
1,ENSG00000081692.7,227735302,1-227808608-T-C,rs59541986,-1,T,C,227808608,73306,227538694,227931910,269914
1,ENSG00000081692.7,227735302,1-227808608-T-G,rs59541986,-1,T,G,227808608,73306,227538694,227931910,269914
1,ENSG00000158828.5,20633458,1-20654387-G-A,rs607254,1,G,A,20654387,20929,20436850,20830066,217537
1,ENSG00000215717.4,109090764,1-109150268-C-A,rs609031,1,C,A,109150268,59504,108894156,109287372,256112
1,ENSG00000215717.4,109090764,1-109150268-C-T,rs609031,1,C,T,109150268,59504,108894156,109287372,256112
1,ENSG00000117650.8,211675621,1-211552051-T-C,rs609832,-1,T,C,211552051,123570,211479013,211872229,73038
1,ENSG00000178104.13,148889564,1-148989863-G-A,rs611160,1,G,A,148989863,100299,148692956,149086172,296907
1,ENSG00000178104.13,148889564,1-148989863-G-T,rs611160,1,G,T,148989863,100299,148692956,149086172,296907
1,ENSG00000197472.9,247008057,1-247008088-C-G,rs61373194,-1,C,G,247008088,31,246811449,247204665,196639
1,ENSG00000243710.3,43172330,1-43216790-G-A,rs613956,1,G,A,43216790,44460,42975722,43368938,241068
1,ENSG00000117597.12,209827972,1-209828241-A-C,rs616227,1,A,C,209828241,269,209631364,210024580,196877
1,ENSG00000117597.12,209827972,1-209828241-A-G,rs616227,1,A,G,209828241,269,209631364,210024580,196877
1,ENSG00000183386.5,38005514,1-37995647-C-A,rs61776719,-1,C,A,37995647,9867,37808906,38202122,186741
1,ENSG00000158825.5,20589097,1-20592369-A-G,rs61781231,1,A,G,20592369,3272,20392489,20785705,199880
1,ENSG00000160783.13,156213007,1-156049284-G-T,rs61813293,1,G,T,156049284,163723,156016399,156409615,32885
1,ENSG00000160783.13,156213007,1-156049284-G-C,rs61813293,1,G,C,156049284,163723,156016399,156409615,32885
1,ENSG00000160783.13,156213007,1-156049284-G-A,rs61813293,1,G,A,156049284,163723,156016399,156409615,32885
1,ENSG00000196449.3,37808208,1-37779089-C-A,rs626352,-1,C,A,37779089,29119,37611600,38004816,167489
1,ENSG00000162688.11,99850361,1-99866705-G-C,rs628842,1,G,C,99866705,16344,99653753,100046969,212952
1,ENSG00000162688.11,99850361,1-99866705-G-A,rs628842,1,G,A,99866705,16344,99653753,100046969,212952
1,ENSG00000162688.11,99850361,1-99866705-G-T,rs628842,1,G,T,99866705,16344,99653753,100046969,212952
1,ENSG00000054277.8,241640369,1-241636236-G-A,rs631143,-1,G,A,241636236,4133,241443761,241836977,192475
1,ENSG00000054277.8,241640369,1-241636236-G-C,rs631143,-1,G,C,241636236,4133,241443761,241836977,192475
1,ENSG00000117395.5,43172290,1-43060354-A-G,rs636747,-1,A,G,43060354,111936,42975682,43368898,84672
1,ENSG00000156171.9,111140093,1-111185663-T-C,rs641379,-1,T,C,111185663,45570,110943485,111336701,242178
1,ENSG00000117593.8,173824673,1-173717214-A-G,rs6413827,1,A,G,173717214,107459,173628065,174021281,89149
1,ENSG00000127472.6,20070194,1-20164025-T-A,rs6426616,1,T,A,20164025,93831,19873586,20266802,290439
1,ENSG00000127472.6,20070194,1-20164025-T-C,rs6426616,1,T,C,20164025,93831,19873586,20266802,290439
1,ENSG00000127472.6,20070194,1-20164025-T-G,rs6426616,1,T,G,20164025,93831,19873586,20266802,290439
1,ENSG00000196420.3,153540934,1-153704237-C-G,rs6426989,-1,C,G,153704237,163303,153344326,153737542,359911
1,ENSG00000196420.3,153540934,1-153704237-C-T,rs6426989,-1,C,T,153704237,163303,153344326,153737542,359911
1,ENSG00000196420.3,153540934,1-153704237-C-A,rs6426989,-1,C,A,153704237,163303,153344326,153737542,359911
1,ENSG00000000460.11,169795040,1-169744005-A-G,rs6427213,1,A,G,169744005,51035,169598432,169991648,145573
1,ENSG00000000460.11,169795040,1-169744005-A-C,rs6427213,1,A,C,169744005,51035,169598432,169991648,145573
1,ENSG00000158769.11,161021152,1-161043921-G-C,rs6427573,-1,G,C,161043921,22769,160824544,161217760,219377
1,ENSG00000158769.11,161021152,1-161043921-G-T,rs6427573,-1,G,T,161043921,22769,160824544,161217760,219377
1,ENSG00000158769.11,161021152,1-161043921-G-A,rs6427573,-1,G,A,161043921,22769,160824544,161217760,219377
1,ENSG00000116741.6,192809039,1-192795758-T-G,rs6428136,1,T,G,192795758,13281,192612431,193005647,183327
1,ENSG00000186197.7,236394286,1-236333385-G-A,rs6428952,1,G,A,236333385,60901,236197678,236590894,135707
1,ENSG00000187147.11,44405255,1-44394552-G-A,rs6429539,1,G,A,44394552,10703,44208647,44601863,185905
1,ENSG00000171608.9,9651731,1-9475560-A-T,rs6541069,1,A,T,9475560,176171,9455123,9848339,20437
1,ENSG00000171608.9,9651731,1-9475560-A-G,rs6541069,1,A,G,9475560,176171,9455123,9848339,20437
1,ENSG00000173409.9,230979094,1-230943635-A-G,rs6541239,1,A,G,230943635,35459,230782486,231175702,161149
1,ENSG00000173409.9,230979094,1-230943635-A-C,rs6541239,1,A,C,230943635,35459,230782486,231175702,161149
1,ENSG00000173409.9,230979094,1-230943635-A-T,rs6541239,1,A,T,230943635,35459,230782486,231175702,161149
1,ENSG00000172456.11,59297094,1-59307712-C-T,rs6587853,1,C,T,59307712,10618,59100486,59493702,207226
1,ENSG00000172456.11,59297094,1-59307712-C-G,rs6587853,1,C,G,59307712,10618,59100486,59493702,207226
1,ENSG00000172456.11,59297094,1-59307712-C-A,rs6587853,1,C,A,59307712,10618,59100486,59493702,207226
1,ENSG00000187815.5,40477290,1-40474348-A-T,rs6600339,1,A,T,40474348,2942,40280682,40673898,193666
1,ENSG00000187815.5,40477290,1-40474348-A-G,rs6600339,1,A,G,40474348,2942,40280682,40673898,193666
1,ENSG00000118454.8,70354722,1-70431500-G-T,rs663649,-1,G,T,70431500,76778,70158114,70551330,273386
1,ENSG00000143119.7,110873148,1-110829022-T-C,rs6655953,1,T,C,110829022,44126,110676540,111069756,152482
1,ENSG00000175087.5,26111824,1-26060369-G-A,rs6656100,1,G,A,26060369,51455,25915216,26308432,145153
1,ENSG00000084070.6,40373727,1-40383149-G-A,rs6656226,1,G,A,40383149,9422,40177119,40570335,206030
1,ENSG00000143553.6,153658703,1-153490790-A-G,rs6658948,1,A,G,153490790,167913,153462095,153855311,28695
1,ENSG00000162711.12,247416173,1-247445495-T-G,rs6659500,1,T,G,247445495,29322,247219565,247612781,225930
1,ENSG00000162711.12,247416173,1-247445495-T-C,rs6659500,1,T,C,247445495,29322,247219565,247612781,225930
1,ENSG00000135845.4,172444069,1-172425061-G-A,rs6660051,-1,G,A,172425061,19008,172247461,172640677,177600
1,ENSG00000135845.4,172444069,1-172425061-G-T,rs6660051,-1,G,T,172425061,19008,172247461,172640677,177600
1,ENSG00000135845.4,172444069,1-172425061-G-C,rs6660051,-1,G,C,172425061,19008,172247461,172640677,177600
1,ENSG00000085552.11,159945613,1-159896000-G-A,rs6660528,-1,G,A,159896000,49613,159749005,160142221,146995
1,ENSG00000185519.8,16073651,1-16173418-C-T,rs6661012,-1,C,T,16173418,99767,15877043,16270259,296375
1,ENSG00000158711.8,205632011,1-205641646-C-T,rs6661827,-1,C,T,205641646,9635,205435403,205828619,206243
1,ENSG00000158711.8,205632011,1-205641646-C-G,rs6661827,-1,C,G,205641646,9635,205435403,205828619,206243
1,ENSG00000196182.6,36385924,1-36486834-T-G,rs6662501,-1,T,G,36486834,100910,36189316,36582532,297518
1,ENSG00000196182.6,36385924,1-36486834-T-A,rs6662501,-1,T,A,36486834,100910,36189316,36582532,297518
1,ENSG00000196182.6,36385924,1-36486834-T-C,rs6662501,-1,T,C,36486834,100910,36189316,36582532,297518
1,ENSG00000116459.6,111449464,1-111361872-A-G,rs6663292,1,A,G,111361872,87592,111252856,111646072,109016
1,ENSG00000162616.7,78004939,1-78056081-C-G,rs6669039,1,C,G,78056081,51142,77808331,78201547,247750
1,ENSG00000162616.7,78004939,1-78056081-C-A,rs6669039,1,C,A,78056081,51142,77808331,78201547,247750
1,ENSG00000125944.12,23344284,1-23264158-A-C,rs667311,-1,A,C,23264158,80126,23147676,23540892,116482
1,ENSG00000125944.12,23344284,1-23264158-A-T,rs667311,-1,A,T,23264158,80126,23147676,23540892,116482
1,ENSG00000125944.12,23344284,1-23264158-A-G,rs667311,-1,A,G,23264158,80126,23147676,23540892,116482
1,ENSG00000117569.12,96721784,1-96649493-G-C,rs6673531,1,G,C,96649493,72291,96525176,96918392,124317
1,ENSG00000117569.12,96721784,1-96649493-G-A,rs6673531,1,G,A,96649493,72291,96525176,96918392,124317
1,ENSG00000117569.12,96721784,1-96649493-G-T,rs6673531,1,G,T,96649493,72291,96525176,96918392,124317
1,ENSG00000143443.8,151047751,1-151066444-C-T,rs6674232,1,C,T,151066444,18693,150851143,151244359,215301
1,ENSG00000143443.8,151047751,1-151066444-C-A,rs6674232,1,C,A,151066444,18693,150851143,151244359,215301
1,ENSG00000132128.11,46303616,1-46295717-G-A,rs6676038,-1,G,A,46295717,7899,46107008,46500224,188709
1,ENSG00000116133.6,54887195,1-54858165-G-A,rs6676774,-1,G,A,54858165,29030,54690587,55083803,167578
1,ENSG00000162892.11,206897443,1-206881987-C-T,rs6677741,1,C,T,206881987,15456,206700835,207094051,181152
1,ENSG00000143801.12,226870616,1-226819752-T-C,rs6678134,1,T,C,226819752,50864,226674008,227067224,145744
1,ENSG00000188931.3,161367876,1-161418623-A-C,rs6678315,-1,A,C,161418623,50747,161171268,161564484,247355
1,ENSG00000126106.9,44674481,1-44672031-G-T,rs6678831,-1,G,T,44672031,2450,44477873,44871089,194158
1,ENSG00000126106.9,44674481,1-44672031-G-A,rs6678831,-1,G,A,44672031,2450,44477873,44871089,194158
1,ENSG00000171517.5,84893206,1-84926641-C-T,rs6681025,-1,C,T,84926641,33435,84696598,85089814,230043
1,ENSG00000137936.11,93681837,1-93572574-A-C,rs6681200,-1,A,C,93572574,109263,93485229,93878445,87345
1,ENSG00000130695.8,26234200,1-26216455-C-T,rs6682532,1,C,T,26216455,17745,26037592,26430808,178863
1,ENSG00000251503.2,10430435,1-10573188-G-T,rs6687430,1,G,T,10573188,142753,10233827,10627043,339361
1,ENSG00000251503.2,10430435,1-10573188-G-A,rs6687430,1,G,A,10573188,142753,10233827,10627043,339361
1,ENSG00000116852.8,201023714,1-201000638-G-A,rs6692235,-1,G,A,201000638,23076,200827106,201220322,173532
1,ENSG00000116852.8,201023714,1-201000638-G-C,rs6692235,-1,G,C,201000638,23076,200827106,201220322,173532
1,ENSG00000143401.10,150236112,1-150194509-G-A,rs6692738,-1,G,A,150194509,41603,150039504,150432720,155005
1,ENSG00000081985.6,67307873,1-67334335-G-C,rs6693065,1,G,C,67334335,26462,67111265,67504481,223070
1,ENSG00000081985.6,67307873,1-67334335-G-A,rs6693065,1,G,A,67334335,26462,67111265,67504481,223070
1,ENSG00000143458.6,151070761,1-151063152-A-C,rs6694357,1,A,C,151063152,7609,150874153,151267369,188999
1,ENSG00000188290.6,1000097,1-981454-G-C,rs6694632,-1,G,C,981454,18643,803489,1196705,177965
1,ENSG00000188290.6,1000097,1-981454-G-A,rs6694632,-1,G,A,981454,18643,803489,1196705,177965
1,ENSG00000116990.9,39901917,1-40086073-C-T,rs6694800,-1,C,T,40086073,184156,39705309,40098525,380764
1,ENSG00000178922.11,43453931,1-43310324-C-T,rs6694837,-1,C,T,43310324,143607,43257323,43650539,53001
1,ENSG00000159352.10,151254734,1-151206015-G-A,rs6695344,1,G,A,151206015,48719,151058126,151451342,147889
1,ENSG00000159352.10,151254734,1-151206015-G-C,rs6695344,1,G,C,151206015,48719,151058126,151451342,147889
1,ENSG00000118193.7,200620751,1-200642582-C-T,rs6695836,-1,C,T,200642582,21831,200424143,200817359,218439
1,ENSG00000118193.7,200620751,1-200642582-C-A,rs6695836,-1,C,A,200642582,21831,200424143,200817359,218439
1,ENSG00000088035.8,63367627,1-63427723-A-T,rs6697508,1,A,T,63427723,60096,63171019,63564235,256704
1,ENSG00000088035.8,63367627,1-63427723-A-G,rs6697508,1,A,G,63427723,60096,63171019,63564235,256704
1,ENSG00000116213.10,3650103,1-3654319-C-T,rs6697769,-1,C,T,3654319,4216,3453495,3846711,200824
1,ENSG00000116213.10,3650103,1-3654319-C-A,rs6697769,-1,C,A,3654319,4216,3453495,3846711,200824
1,ENSG00000116213.10,3650103,1-3654319-C-G,rs6697769,-1,C,G,3654319,4216,3453495,3846711,200824
1,ENSG00000011007.7,23743471,1-23825506-C-A,rs6697805,1,C,A,23825506,82035,23546863,23940079,278643
1,ENSG00000011007.7,23743471,1-23825506-C-G,rs6697805,1,C,G,23825506,82035,23546863,23940079,278643
1,ENSG00000011007.7,23743471,1-23825506-C-T,rs6697805,1,C,T,23825506,82035,23546863,23940079,278643
1,ENSG00000187942.7,21812265,1-21917530-C-A,rs6698486,1,C,A,21917530,105265,21615657,22008873,301873
1,ENSG00000187942.7,21812265,1-21917530-C-T,rs6698486,1,C,T,21917530,105265,21615657,22008873,301873
1,ENSG00000198216.6,181483517,1-181428007-A-G,rs6703397,1,A,G,181428007,55510,181286909,181680125,141098
1,ENSG00000154451.10,89272860,1-89184141-A-G,rs674903,-1,A,G,89184141,88719,89076252,89469468,107889
1,ENSG00000185483.6,63774017,1-63829061-G-A,rs67716815,1,G,A,63829061,55044,63577409,63970625,251652
1,ENSG00000117481.5,46340807,1-46341744-T-G,rs68083747,1,T,G,46341744,937,46144199,46537415,197545
1,ENSG00000196878.7,209652425,1-209685334-G-C,rs701950,-1,G,C,209685334,32909,209455817,209849033,229517
1,ENSG00000196878.7,209652425,1-209685334-G-A,rs701950,-1,G,A,209685334,32909,209455817,209849033,229517
1,ENSG00000196878.7,209652425,1-209685334-G-T,rs701950,-1,G,T,209685334,32909,209455817,209849033,229517
1,ENSG00000235098.4,1421276,1-1237527-C-T,rs715643,-1,C,T,1237527,183749,1224668,1617884,12859
1,ENSG00000235098.4,1421276,1-1237527-C-G,rs715643,-1,C,G,1237527,183749,1224668,1617884,12859
1,ENSG00000162374.12,50108920,1-50185522-T-A,rs71651139,1,T,A,50185522,76602,49912312,50305528,273210
1,ENSG00000162545.5,20486210,1-20648675-C-G,rs71653623,-1,C,G,20648675,162465,20289602,20682818,359073
1,ENSG00000162545.5,20486210,1-20648675-C-T,rs71653623,-1,C,T,20648675,162465,20289602,20682818,359073
1,ENSG00000162545.5,20486210,1-20648675-C-A,rs71653623,-1,C,A,20648675,162465,20289602,20682818,359073
1,ENSG00000189339.7,1692795,1-1665581-C-G,rs72634820,-1,C,G,1665581,27214,1496187,1889403,169394
1,ENSG00000198830.6,26472440,1-26656770-C-T,rs72651555,1,C,T,26656770,184330,26275832,26669048,380938
1,ENSG00000187010.13,25272509,1-25257119-C-G,rs72660908,1,C,G,25257119,15390,25075901,25469117,181218
1,ENSG00000131778.12,147242684,1-147245205-C-G,rs72691015,1,C,G,147245205,2521,147046076,147439292,199129
1,ENSG00000131778.12,147242684,1-147245205-C-A,rs72691015,1,C,A,147245205,2521,147046076,147439292,199129
1,ENSG00000185104.13,50960267,1-51129361-G-A,rs72692278,-1,G,A,51129361,169094,50763659,51156875,365702
1,ENSG00000162695.6,100896090,1-100927481-A-G,rs72734259,1,A,G,100927481,31391,100699482,101092698,227999
1,ENSG00000154309.7,222815039,1-222883796-C-G,rs72742233,1,C,G,222883796,68757,222618431,223011647,265365
1,ENSG00000154309.7,222815039,1-222883796-C-A,rs72742233,1,C,A,222883796,68757,222618431,223011647,265365
1,ENSG00000159658.5,46719114,1-46527531-A-G,rs72894662,-1,A,G,46527531,191583,46522506,46915722,5025
1,ENSG00000079739.9,63593411,1-63465140-C-A,rs72918611,1,C,A,63465140,128271,63396803,63790019,68337
1,ENSG00000079739.9,63593411,1-63465140-C-T,rs72918611,1,C,T,63465140,128271,63396803,63790019,68337
1,ENSG00000131791.6,147172470,1-147278083-T-C,rs72999651,-1,T,C,147278083,105613,146975862,147369078,302221
1,ENSG00000198860.7,184051730,1-184144111-T-C,rs732812,1,T,C,184144111,92381,183855122,184248338,288989
1,ENSG00000198860.7,184051730,1-184144111-T-G,rs732812,1,T,G,184144111,92381,183855122,184248338,288989
1,ENSG00000198860.7,184051730,1-184144111-T-A,rs732812,1,T,A,184144111,92381,183855122,184248338,288989
1,ENSG00000049239.7,9234774,1-9249687-G-T,rs732950,1,G,T,9249687,14913,9038166,9431382,211521
1,ENSG00000058453.11,16921931,1-16892990-G-T,rs74055949,1,G,T,16892990,28941,16725323,17118539,167667
1,ENSG00000177181.9,42380792,1-42411025-C-T,rs7418303,1,C,T,42411025,30233,42184184,42577400,226841
1,ENSG00000162923.10,224434797,1-224314264-C-T,rs74793582,-1,C,T,224314264,120533,224238189,224631405,76075
1,ENSG00000143740.9,227735435,1-227759733-G-A,rs748405,1,G,A,227759733,24298,227538827,227932043,220906
1,ENSG00000162542.8,19799916,1-19811628-C-T,rs7513083,-1,C,T,19811628,11712,19603308,19996524,208320
1,ENSG00000154511.6,92961462,1-92969168-G-C,rs7517539,-1,G,C,92969168,7706,92764854,93158070,204314
1,ENSG00000154511.6,92961462,1-92969168-G-A,rs7517539,-1,G,A,92969168,7706,92764854,93158070,204314
1,ENSG00000117228.8,89065208,1-89041299-G-A,rs7519963,-1,G,A,89041299,23909,88868600,89261816,172699
1,ENSG00000117228.8,89065208,1-89041299-G-T,rs7519963,-1,G,T,89041299,23909,88868600,89261816,172699
1,ENSG00000116199.7,179025894,1-179020329-G-A,rs7520456,1,G,A,179020329,5565,178829286,179222502,191043
1,ENSG00000186501.8,27322163,1-27261682-T-C,rs7521203,1,T,C,27261682,60481,27125555,27518771,136127
1,ENSG00000117480.10,46394317,1-46343819-C-T,rs75216726,1,C,T,46343819,50498,46197709,46590925,146110
1,ENSG00000171161.7,248838224,1-248904493-T-C,rs7521920,1,T,C,248904493,66269,248641616,249034832,262877
1,ENSG00000168275.9,234373456,1-234375757-A-G,rs7523348,1,A,G,234375757,2301,234176848,234570064,198909
1,ENSG00000143653.8,246724409,1-246734832-C-T,rs7526237,1,C,T,246734832,10423,246527801,246921017,207031
1,ENSG00000174371.11,241848204,1-241685745-A-G,rs7527828,1,A,G,241685745,162459,241651596,242044812,34149
1,ENSG00000162714.7,247331867,1-247412466-G-A,rs7529058,-1,G,A,247412466,80599,247135259,247528475,277207
1,ENSG00000162714.7,247331867,1-247412466-G-T,rs7529058,-1,G,T,247412466,80599,247135259,247528475,277207
1,ENSG00000036549.8,77682658,1-77557488-C-T,rs7536433,-1,C,T,77557488,125170,77486050,77879266,71438
1,ENSG00000036549.8,77682658,1-77557488-C-A,rs7536433,-1,C,A,77557488,125170,77486050,77879266,71438
1,ENSG00000173110.5,161524540,1-161542941-G-A,rs7539036,1,G,A,161542941,18401,161327932,161721148,215009
1,ENSG00000169504.9,24745447,1-24576015-A-G,rs7539229,1,A,G,24576015,169432,24548839,24942055,27176
1,ENSG00000117020.12,243850243,1-243849026-G-A,rs75405615,-1,G,A,243849026,1217,243653635,244046851,195391
1,ENSG00000142694.6,36323645,1-36203548-T-C,rs7541007,-1,T,C,36203548,120097,36127037,36520253,76511
1,ENSG00000196539.2,248473351,1-248359594-G-A,rs7541216,1,G,A,248359594,113757,248276743,248669959,82851
1,ENSG00000173660.7,46303698,1-46329775-G-T,rs7543052,1,G,T,46329775,26077,46107090,46500306,222685
1,ENSG00000173660.7,46303698,1-46329775-G-A,rs7543052,1,G,A,46329775,26077,46107090,46500306,222685
1,ENSG00000183615.5,32247222,1-32239514-C-T,rs7544661,1,C,T,32239514,7708,32050614,32443830,188900
1,ENSG00000197915.5,152224193,1-152220810-G-A,rs7545406,-1,G,A,152220810,3383,152027585,152420801,193225
1,ENSG00000197915.5,152224193,1-152220810-G-T,rs7545406,-1,G,T,152220810,3383,152027585,152420801,193225
1,ENSG00000143149.8,165698562,1-165686867-C-A,rs7546215,-1,C,A,165686867,11695,165501954,165895170,184913
1,ENSG00000143149.8,165698562,1-165686867-C-T,rs7546215,-1,C,T,165686867,11695,165501954,165895170,184913
1,ENSG00000142657.14,10399064,1-10358768-G-T,rs7546368,1,G,T,10358768,40296,10202456,10595672,156312
1,ENSG00000142657.14,10399064,1-10358768-G-C,rs7546368,1,G,C,10358768,40296,10202456,10595672,156312
1,ENSG00000142657.14,10399064,1-10358768-G-A,rs7546368,1,G,A,10358768,40296,10202456,10595672,156312
1,ENSG00000121454.4,180230264,1-180281203-T-G,rs75468761,1,T,G,180281203,50939,180033656,180426872,247547
1,ENSG00000076864.12,21669357,1-21814537-C-T,rs75506362,-1,C,T,21814537,145180,21472749,21865965,341788
1,ENSG00000152382.5,166876264,1-166906842-T-C,rs7552562,-1,T,C,166906842,30578,166679656,167072872,227186
1,ENSG00000183831.6,173669851,1-173798305-A-G,rs7552939,-1,A,G,173798305,128454,173473243,173866459,325062
1,ENSG00000183831.6,173669851,1-173798305-A-T,rs7552939,-1,A,T,173798305,128454,173473243,173866459,325062
1,ENSG00000174514.8,205569014,1-205593074-G-A,rs7553871,1,G,A,205593074,24060,205372406,205765622,220668
1,ENSG00000174514.8,205569014,1-205593074-G-T,rs7553871,1,G,T,205593074,24060,205372406,205765622,220668
1,ENSG00000143554.9,153775407,1-153725593-A-G,rs7556155,1,A,G,153725593,49814,153578799,153972015,146794
1,ENSG00000143344.9,183805120,1-183829667-G-A,rs7556229,1,G,A,183829667,24547,183608512,184001728,221155
1,ENSG00000143344.9,183805120,1-183829667-G-T,rs7556229,1,G,T,183829667,24547,183608512,184001728,221155
1,ENSG00000131584.13,1307930,1-1247525-G-C,rs75668831,-1,G,C,1247525,60405,1111322,1504538,136203
1,ENSG00000131584.13,1307930,1-1247525-G-A,rs75668831,-1,G,A,1247525,60405,1111322,1504538,136203
1,ENSG00000162736.10,160343383,1-160406749-T-G,rs75695145,1,T,G,160406749,63366,160146775,160539991,259974
1,ENSG00000162398.7,54806063,1-54929419-T-A,rs76181476,1,T,A,54929419,123356,54609455,55002671,319964
1,ENSG00000162398.7,54806063,1-54929419-T-C,rs76181476,1,T,C,54929419,123356,54609455,55002671,319964
1,ENSG00000075391.11,178094104,1-178160818-G-A,rs76233263,1,G,A,178160818,66714,177897496,178290712,263322
1,ENSG00000123091.4,51236273,1-51370246-C-T,rs76455383,1,C,T,51370246,133973,51039665,51432881,330581
1,ENSG00000198892.6,201888898,1-201850966-G-A,rs76577526,1,G,A,201850966,37932,201692290,202085506,158676
1,ENSG00000040487.8,19312326,1-19392330-G-A,rs7667,1,G,A,19392330,80004,19115718,19508934,276612
1,ENSG00000196189.6,156153585,1-156177535-T-C,rs7695,1,T,C,156177535,23950,155956977,156350193,220558
1,ENSG00000196189.6,156153585,1-156177535-T-A,rs7695,1,T,A,156177535,23950,155956977,156350193,220558
1,ENSG00000198691.6,94121148,1-94157711-T-G,rs77144892,-1,T,G,94157711,36563,93924540,94317756,233171
1,ENSG00000131236.11,40040729,1-40015826-T-C,rs77425966,1,T,C,40015826,24903,39844121,40237337,171705
1,ENSG00000127054.12,1324660,1-1223644-C-T,rs77472198,-1,C,T,1223644,101016,1128052,1521268,95592
1,ENSG00000176022.3,1232237,1-1223644-C-T,rs77472198,1,C,T,1223644,8593,1035629,1428845,188015
1,ENSG00000185220.7,248906235,1-248736853-G-A,rs77479833,1,G,A,248736853,169382,248709627,249102843,27226
1,ENSG00000248485.1,161258745,1-161261431-C-T,rs77515554,1,C,T,161261431,2686,161062137,161455353,199294
1,ENSG00000162433.10,65148203,1-65172742-C-T,rs77603267,1,C,T,65172742,24539,64951595,65344811,221147
1,ENSG00000162694.9,100894842,1-100888830-T-C,rs77649301,-1,T,C,100888830,6012,100698234,101091450,190596
1,ENSG00000178821.7,1919279,1-1752730-C-A,rs7796,-1,C,A,1752730,166549,1722671,2115887,30059
1,ENSG00000178821.7,1919279,1-1752730-C-G,rs7796,-1,C,G,1752730,166549,1722671,2115887,30059
1,ENSG00000178821.7,1919279,1-1752730-C-T,rs7796,-1,C,T,1752730,166549,1722671,2115887,30059
1,ENSG00000162772.12,212608761,1-212601238-T-C,rs78276076,1,T,C,212601238,7523,212412153,212805369,189085
1,ENSG00000162631.12,107141039,1-106979924-T-A,rs78409645,1,T,A,106979924,161115,106944431,107337647,35493
1,ENSG00000143178.7,168280877,1-168267380-C-T,rs78458169,1,C,T,168267380,13497,168084269,168477485,183111
1,ENSG00000198837.5,153946718,1-153816674-C-A,rs78740769,-1,C,A,153816674,130044,153750110,154143326,66564
1,ENSG00000162645.8,89126114,1-89118685-G-T,rs78904295,-1,G,T,89118685,7429,88929506,89322722,189179
1,ENSG00000162645.8,89126114,1-89118685-G-C,rs78904295,-1,G,C,89118685,7429,88929506,89322722,189179
1,ENSG00000162645.8,89126114,1-89118685-G-A,rs78904295,-1,G,A,89118685,7429,88929506,89322722,189179
1,ENSG00000198198.9,43389899,1-43354522-G-A,rs79064184,1,G,A,43354522,35377,43193291,43586507,161231
1,ENSG00000119285.6,236604516,1-236708028-G-T,rs79108886,-1,G,T,236708028,103512,236407908,236801124,300120
1,ENSG00000143786.3,224616317,1-224763020-C-A,rs79264717,1,C,A,224763020,146703,224419709,224812925,343311
1,ENSG00000064703.7,111755901,1-111873300-C-T,rs79330097,1,C,T,111873300,117399,111559293,111952509,314007
1,ENSG00000159214.8,43991599,1-43994960-G-C,rs79401056,1,G,C,43994960,3361,43794991,44188207,199969
1,ENSG00000134698.10,35808016,1-35927557-A-G,rs797000,1,A,G,35927557,119541,35611408,36004624,316149
1,ENSG00000134698.10,35808016,1-35927557-A-T,rs797000,1,A,T,35927557,119541,35611408,36004624,316149
1,ENSG00000171621.9,9292894,1-9183752-G-C,rs797257,1,G,C,9183752,109142,9096286,9489502,87466
1,ENSG00000171621.9,9292894,1-9183752-G-T,rs797257,1,G,T,9183752,109142,9096286,9489502,87466
1,ENSG00000135750.10,233614106,1-233500276-C-G,rs79748833,1,C,G,233500276,113830,233417498,233810714,82778
1,ENSG00000135750.10,233614106,1-233500276-C-T,rs79748833,1,C,T,233500276,113830,233417498,233810714,82778
1,ENSG00000180758.9,9129102,1-9010125-C-T,rs79843700,-1,C,T,9010125,118977,8932494,9325710,77631
1,ENSG00000143127.7,145910050,1-146014328-G-A,rs79906727,-1,G,A,146014328,104278,145713442,146106658,300886
1,ENSG00000182749.5,25875708,1-25870572-C-T,rs807067,-1,C,T,25870572,5136,25679100,26072316,191472
1,ENSG00000182749.5,25875708,1-25870572-C-G,rs807067,-1,C,G,25870572,5136,25679100,26072316,191472
1,ENSG00000133065.6,205813198,1-205828905-G-C,rs823085,-1,G,C,205828905,15707,205616590,206009806,212315
1,ENSG00000133065.6,205813198,1-205828905-G-T,rs823085,-1,G,T,205828905,15707,205616590,206009806,212315
1,ENSG00000133065.6,205813198,1-205828905-G-A,rs823085,-1,G,A,205828905,15707,205616590,206009806,212315
1,ENSG00000117280.8,205775482,1-205720679-T-C,rs823094,-1,T,C,205720679,54803,205578874,205972090,141805
1,ENSG00000117280.8,205775482,1-205720679-T-G,rs823094,-1,T,G,205720679,54803,205578874,205972090,141805
1,ENSG00000117280.8,205775482,1-205720679-T-A,rs823094,-1,T,A,205720679,54803,205578874,205972090,141805
1,ENSG00000116857.11,201154474,1-201179905-C-T,rs831768,-1,C,T,201179905,25431,200957866,201351082,222039
1,ENSG00000116157.5,52602371,1-52598362-G-A,rs835342,1,G,A,52598362,4009,52405763,52798979,192599
1,ENSG00000116157.5,52602371,1-52598362-G-C,rs835342,1,G,C,52598362,4009,52405763,52798979,192599
1,ENSG00000159479.12,43389800,1-43391429-G-C,rs839757,-1,G,C,43391429,1629,43193192,43586408,198237
1,ENSG00000159479.12,43389800,1-43391429-G-A,rs839757,-1,G,A,43391429,1629,43193192,43586408,198237
1,ENSG00000116750.7,193059360,1-192933285-T-C,rs842796,-1,T,C,192933285,126075,192862752,193255968,70533
1,ENSG00000203965.7,63523525,1-63603824-G-A,rs855316,1,G,A,63603824,80299,63326917,63720133,276907
1,ENSG00000203965.7,63523525,1-63603824-G-C,rs855316,1,G,C,63603824,80299,63326917,63720133,276907
1,ENSG00000163565.14,159009907,1-158914729-C-T,rs860637,1,C,T,158914729,95178,158813299,159206515,101430
1,ENSG00000163565.14,159009907,1-158914729-C-A,rs860637,1,C,A,158914729,95178,158813299,159206515,101430
1,ENSG00000116833.8,200027710,1-200149311-C-T,rs871446,1,C,T,200149311,121601,199831102,200224318,318209
1,ENSG00000203995.5,52842760,1-52679671-A-T,rs873844,1,A,T,52679671,163089,52646152,53039368,33519
1,ENSG00000203995.5,52842760,1-52679671-A-G,rs873844,1,A,G,52679671,163089,52646152,53039368,33519
1,ENSG00000116981.3,39672107,1-39667123-T-C,rs873917,-1,T,C,39667123,4984,39475499,39868715,191624
1,ENSG00000116981.3,39672107,1-39667123-T-G,rs873917,-1,T,G,39667123,4984,39475499,39868715,191624
1,ENSG00000182827.8,226186741,1-226348944-C-G,rs874583,-1,C,G,226348944,162203,225990133,226383349,358811
1,ENSG00000182827.8,226186741,1-226348944-C-T,rs874583,-1,C,T,226348944,162203,225990133,226383349,358811
1,ENSG00000142684.7,26169908,1-26170849-A-G,rs8768,1,A,G,26170849,941,25973300,26366516,197549
1,ENSG00000142684.7,26169908,1-26170849-A-C,rs8768,1,A,C,26170849,941,25973300,26366516,197549
1,ENSG00000142684.7,26169908,1-26170849-A-T,rs8768,1,A,T,26170849,941,25973300,26366516,197549
1,ENSG00000156150.5,110070672,1-110064053-G-A,rs904023,-1,G,A,110064053,6619,109874064,110267280,189989
1,ENSG00000130770.12,28236124,1-28193722-C-G,rs905907,1,C,G,28193722,42402,28039516,28432732,154206
1,ENSG00000173726.6,235128837,1-235091308-T-C,rs9287215,-1,T,C,235091308,37529,234932229,235325445,159079
1,ENSG00000142856.12,63523225,1-63339451-G-T,rs932748,-1,G,T,63339451,183774,63326617,63719833,12834
1,ENSG00000142856.12,63523225,1-63339451-G-A,rs932748,-1,G,A,63339451,183774,63326617,63719833,12834
1,ENSG00000142856.12,63523225,1-63339451-G-C,rs932748,-1,G,C,63339451,183774,63326617,63719833,12834
1,ENSG00000179456.8,244051283,1-243922508-C-T,rs938565,1,C,T,243922508,128775,243854675,244247891,67833
1,ENSG00000179456.8,244051283,1-243922508-C-G,rs938565,1,C,G,243922508,128775,243854675,244247891,67833
1,ENSG00000179456.8,244051283,1-243922508-C-A,rs938565,1,C,A,243922508,128775,243854675,244247891,67833
1,ENSG00000196154.6,153545806,1-153741942-C-T,rs9426891,-1,C,T,153741942,196136,153349198,153742414,392744
1,ENSG00000064886.8,111227713,1-111248881-G-C,rs942697,1,G,C,111248881,21168,111031105,111424321,217776
1,ENSG00000064886.8,111227713,1-111248881-G-A,rs942697,1,G,A,111248881,21168,111031105,111424321,217776
1,ENSG00000064886.8,111227713,1-111248881-G-T,rs942697,1,G,T,111248881,21168,111031105,111424321,217776
1,ENSG00000198890.5,107056674,1-107008758-T-C,rs9435436,1,T,C,107008758,47916,106860066,107253282,148692
1,ENSG00000198890.5,107056674,1-107008758-T-G,rs9435436,1,T,G,107008758,47916,106860066,107253282,148692
1,ENSG00000198890.5,107056674,1-107008758-T-A,rs9435436,1,T,A,107008758,47916,106860066,107253282,148692
1,ENSG00000186510.6,16022036,1-16021917-T-A,rs945425,1,T,A,16021917,119,15825428,16218644,196489
1,ENSG00000186510.6,16022036,1-16021917-T-C,rs945425,1,T,C,16021917,119,15825428,16218644,196489
1,ENSG00000253831.1,157099808,1-157100866-G-A,rs9659081,-1,G,A,157100866,1058,156903200,157296416,197666
1,ENSG00000066136.13,40691704,1-40688735-G-A,rs965949,1,G,A,40688735,2969,40495096,40888312,193639
1,ENSG00000066136.13,40691704,1-40688735-G-C,rs965949,1,G,C,40688735,2969,40495096,40888312,193639
1,ENSG00000137941.11,83999132,1-83827947-G-A,rs976457,-1,G,A,83827947,171185,83802524,84195740,25423
1,ENSG00000116353.8,29230934,1-29253836-C-T,rs997550,-1,C,T,29253836,22902,29034326,29427542,219510
1,ENSG00000189171.8,153627505,1-153627648-T-C,rs999418,-1,T,C,153627648,143,153430897,153824113,196751
1,ENSG00000189171.8,153627505,1-153627648-T-G,rs999418,-1,T,G,153627648,143,153430897,153824113,196751
1,ENSG00000121766.10,31297032,1-31429571-A-G,rs10047085,1,A,G,31429571,132539,31100424,31493640,329147
1,ENSG00000143228.8,163321954,1-163275703-G-A,rs10158993,1,G,A,163275703,46251,163125346,163518562,150357
1,ENSG00000183856.6,156572565,1-156510532-T-C,rs10159180,-1,T,C,156510532,62033,156375957,156769173,134575
1,ENSG00000066185.8,42456022,1-42580086-T-A,rs1016544,-1,T,A,42580086,124064,42259414,42652630,320672
1,ENSG00000066185.8,42456022,1-42580086-T-C,rs1016544,-1,T,C,42580086,124064,42259414,42652630,320672
1,ENSG00000066185.8,42456022,1-42580086-T-G,rs1016544,-1,T,G,42580086,124064,42259414,42652630,320672
1,ENSG00000215910.3,11762193,1-11838976-G-T,rs1023252,1,G,T,11838976,76783,11565585,11958801,273391
1,ENSG00000215910.3,11762193,1-11838976-G-A,rs1023252,1,G,A,11838976,76783,11565585,11958801,273391
1,ENSG00000177000.6,11805964,1-11838976-G-T,rs1023252,-1,G,T,11838976,33012,11609356,12002572,229620
1,ENSG00000177000.6,11805964,1-11838976-G-A,rs1023252,-1,G,A,11838976,33012,11609356,12002572,229620
1,ENSG00000011009.5,23791145,1-23761638-G-A,rs1045017,1,G,A,23761638,29507,23594537,23987753,167101
1,ENSG00000011009.5,23791145,1-23761638-G-C,rs1045017,1,G,C,23761638,29507,23594537,23987753,167101
1,ENSG00000116761.7,70411268,1-70455490-G-T,rs10458561,1,G,T,70455490,44222,70214660,70607876,240830
1,ENSG00000116761.7,70411268,1-70455490-G-A,rs10458561,1,G,A,70455490,44222,70214660,70607876,240830
1,ENSG00000143119.7,110873148,1-110947279-A-C,rs1046260,1,A,C,110947279,74131,110676540,111069756,270739
1,ENSG00000162836.6,147670524,1-147552273-G-A,rs10494250,-1,G,A,147552273,118251,147473916,147867132,78357
1,ENSG00000117036.7,157138395,1-157148629-T-C,rs10494309,-1,T,C,157148629,10234,156941787,157335003,206842
1,ENSG00000067533.5,218285293,1-218342968-G-A,rs10495098,1,G,A,218342968,57675,218088685,218481901,254283
1,ENSG00000067533.5,218285293,1-218342968-G-T,rs10495098,1,G,T,218342968,57675,218088685,218481901,254283
1,ENSG00000183814.10,226309164,1-226199917-G-A,rs10495244,-1,G,A,226199917,109247,226112556,226505772,87361
1,ENSG00000183814.10,226309164,1-226199917-G-C,rs10495244,-1,G,C,226199917,109247,226112556,226505772,87361
1,ENSG00000121940.11,108963484,1-108930151-G-A,rs1051868,-1,G,A,108930151,33333,108766876,109160092,163275
1,ENSG00000187010.13,25272509,1-25361410-T-C,rs1053438,1,T,C,25361410,88901,25075901,25469117,285509
1,ENSG00000187010.13,25272509,1-25361410-T-A,rs1053438,1,T,A,25361410,88901,25075901,25469117,285509
1,ENSG00000162600.6,58546726,1-58576716-C-G,rs1062964,-1,C,G,58576716,29990,58350118,58743334,226598
1,ENSG00000185155.6,226223664,1-226073398-G-A,rs10732206,1,G,A,226073398,150266,226027056,226420272,46342
1,ENSG00000185155.6,226223664,1-226073398-G-T,rs10732206,1,G,T,226073398,150266,226027056,226420272,46342
1,ENSG00000117228.8,89065208,1-89043816-A-T,rs1074541,-1,A,T,89043816,21392,88868600,89261816,175216
1,ENSG00000117228.8,89065208,1-89043816-A-G,rs1074541,-1,A,G,89043816,21392,88868600,89261816,175216
1,ENSG00000123685.4,212699840,1-212826359-C-T,rs10746436,-1,C,T,212826359,126519,212503232,212896448,323127
1,ENSG00000123685.4,212699840,1-212826359-C-G,rs10746436,-1,C,G,212826359,126519,212503232,212896448,323127
1,ENSG00000123685.4,212699840,1-212826359-C-A,rs10746436,-1,C,A,212826359,126519,212503232,212896448,323127
1,ENSG00000074800.8,8878686,1-8994525-G-T,rs10746482,-1,G,T,8994525,115839,8682078,9075294,312447
1,ENSG00000074800.8,8878686,1-8994525-G-A,rs10746482,-1,G,A,8994525,115839,8682078,9075294,312447
1,ENSG00000069702.6,91886151,1-91711837-T-A,rs10782997,-1,T,A,91711837,174314,91689543,92082759,22294
1,ENSG00000162517.8,31644876,1-31631487-G-T,rs10798880,-1,G,T,31631487,13389,31448268,31841484,183219
1,ENSG00000162517.8,31644876,1-31631487-G-A,rs10798880,-1,G,A,31631487,13389,31448268,31841484,183219
1,ENSG00000135776.4,229558707,1-229425689-A-G,rs10799528,-1,A,G,229425689,133018,229362099,229755315,63590
1,ENSG00000135776.4,229558707,1-229425689-A-T,rs10799528,-1,A,T,229425689,133018,229362099,229755315,63590
1,ENSG00000135776.4,229558707,1-229425689-A-C,rs10799528,-1,A,C,229425689,133018,229362099,229755315,63590
1,ENSG00000174307.5,201469188,1-201433866-C-A,rs10800780,-1,C,A,201433866,35322,201272580,201665796,161286
1,ENSG00000174307.5,201469188,1-201433866-C-T,rs10800780,-1,C,T,201433866,35322,201272580,201665796,161286
1,ENSG00000174307.5,201469188,1-201433866-C-G,rs10800780,-1,C,G,201433866,35322,201272580,201665796,161286
1,ENSG00000117226.7,89022866,1-89035632-C-A,rs10801706,-1,C,A,89035632,12766,88826258,89219474,209374
1,ENSG00000117226.7,89022866,1-89035632-C-T,rs10801706,-1,C,T,89035632,12766,88826258,89219474,209374
1,ENSG00000117226.7,89022866,1-89035632-C-G,rs10801706,-1,C,G,89035632,12766,88826258,89219474,209374
1,ENSG00000203666.8,244969682,1-244998766-T-C,rs10803250,1,T,C,244998766,29084,244773074,245166290,225692
1,ENSG00000156150.5,110070672,1-110052906-C-G,rs10857809,-1,C,G,110052906,17766,109874064,110267280,178842
1,ENSG00000156150.5,110070672,1-110052906-C-T,rs10857809,-1,C,T,110052906,17766,109874064,110267280,178842
1,ENSG00000156150.5,110070672,1-110052906-C-A,rs10857809,-1,C,A,110052906,17766,109874064,110267280,178842
1,ENSG00000143479.11,206635536,1-206652260-T-C,rs10863766,1,T,C,206652260,16724,206438928,206832144,213332
1,ENSG00000143479.11,206635536,1-206652260-T-G,rs10863766,1,T,G,206652260,16724,206438928,206832144,213332
1,ENSG00000066027.4,212285410,1-212178127-C-A,rs10863950,1,C,A,212178127,107283,212088802,212482018,89325
1,ENSG00000066027.4,212285410,1-212178127-C-T,rs10863950,1,C,T,212178127,107283,212088802,212482018,89325
1,ENSG00000066027.4,212285410,1-212178127-C-G,rs10863950,1,C,G,212178127,107283,212088802,212482018,89325
1,ENSG00000173409.9,230979094,1-230987305-C-G,rs10864647,1,C,G,230987305,8211,230782486,231175702,204819
1,ENSG00000173409.9,230979094,1-230987305-C-A,rs10864647,1,C,A,230987305,8211,230782486,231175702,204819
1,ENSG00000117569.12,96721784,1-96817477-T-C,rs10875034,1,T,C,96817477,95693,96525176,96918392,292301
1,ENSG00000117569.12,96721784,1-96817477-T-G,rs10875034,1,T,G,96817477,95693,96525176,96918392,292301
1,ENSG00000116863.8,36088892,1-36219343-T-C,rs1088201,1,T,C,36219343,130451,35892284,36285500,327059
1,ENSG00000168653.6,39026350,1-39006913-A-G,rs10888621,1,A,G,39006913,19437,38829742,39222958,177171
1,ENSG00000131238.10,40097252,1-40095799-C-A,rs10889147,-1,C,A,40095799,1453,39900644,40293860,195155
1,ENSG00000131238.10,40097252,1-40095799-C-T,rs10889147,-1,C,T,40095799,1453,39900644,40293860,195155
1,ENSG00000131238.10,40097252,1-40095799-C-G,rs10889147,-1,C,G,40095799,1453,39900644,40293860,195155
1,ENSG00000134716.5,59926773,1-59942897-C-A,rs10889164,-1,C,A,59942897,16124,59730165,60123381,212732
1,ENSG00000079277.14,46604268,1-46470751-G-A,rs10890401,-1,G,A,46470751,133517,46407660,46800876,63091
1,ENSG00000135828.6,182589256,1-182460860-C-A,rs10911080,-1,C,A,182460860,128396,182392648,182785864,68212
1,ENSG00000135838.8,182789773,1-182958550-T-G,rs10911167,1,T,G,182958550,168777,182593165,182986381,365385
1,ENSG00000135838.8,182789773,1-182958550-T-C,rs10911167,1,T,C,182958550,168777,182593165,182986381,365385
1,ENSG00000143344.9,183805120,1-183919724-G-A,rs10911469,1,G,A,183919724,114604,183608512,184001728,311212
1,ENSG00000158825.5,20589097,1-20608886-C-A,rs10916829,1,C,A,20608886,19789,20392489,20785705,216397
1,ENSG00000184677.11,22451851,1-22382643-T-C,rs10917221,1,T,C,22382643,69208,22255243,22648459,127400
1,ENSG00000143199.11,167914134,1-167779148-A-G,rs10918763,-1,A,G,167779148,134986,167717526,168110742,61622
1,ENSG00000143851.11,202160602,1-202203466-C-T,rs10920360,-1,C,T,202203466,42864,201963994,202357210,239472
1,ENSG00000162851.6,246566261,1-246538517-G-C,rs10924774,-1,G,C,246538517,27744,246369653,246762869,168864
1,ENSG00000162851.6,246566261,1-246538517-G-A,rs10924774,-1,G,A,246538517,27744,246369653,246762869,168864
1,ENSG00000054267.15,235328179,1-235345148-C-T,rs10925503,-1,C,T,235345148,16969,235131571,235524787,213577
1,ENSG00000035687.8,244451909,1-244353032-A-C,rs10927202,-1,A,C,244353032,98877,244255301,244648517,97731
1,ENSG00000035687.8,244451909,1-244353032-A-T,rs10927202,-1,A,T,244353032,98877,244255301,244648517,97731
1,ENSG00000035687.8,244451909,1-244353032-A-G,rs10927202,-1,A,G,244353032,98877,244255301,244648517,97731
1,ENSG00000058668.10,203626832,1-203642035-C-T,rs1106891,1,C,T,203642035,15203,203430224,203823440,211811
1,ENSG00000168765.10,109656099,1-109639007-T-C,rs11101976,1,T,C,109639007,17092,109459491,109852707,179516
1,ENSG00000116299.11,109114115,1-109186746-T-C,rs11102951,1,T,C,109186746,72631,108917507,109310723,269239
1,ENSG00000049245.8,7771296,1-7730228-T-A,rs11121007,1,T,A,7730228,41068,7574688,7967904,155540
1,ENSG00000049245.8,7771296,1-7730228-T-C,rs11121007,1,T,C,7730228,41068,7574688,7967904,155540
1,ENSG00000054523.11,10210570,1-10211630-C-G,rs11121529,1,C,G,10211630,1060,10013962,10407178,197668
1,ENSG00000162490.6,11691710,1-11740421-T-G,rs11121816,1,T,G,11740421,48711,11495102,11888318,245319
1,ENSG00000162490.6,11691710,1-11740421-T-A,rs11121816,1,T,A,11740421,48711,11495102,11888318,245319
1,ENSG00000177674.10,11736136,1-11740421-T-G,rs11121816,1,T,G,11740421,4285,11539528,11932744,200893
1,ENSG00000177674.10,11736136,1-11740421-T-A,rs11121816,1,T,A,11740421,4285,11539528,11932744,200893
1,ENSG00000175206.6,11847783,1-11800063-T-A,rs11121832,-1,T,A,11800063,47720,11651175,12044391,148888
1,ENSG00000175206.6,11847783,1-11800063-T-C,rs11121832,-1,T,C,11800063,47720,11651175,12044391,148888
1,ENSG00000162946.14,231626790,1-231699864-A-C,rs11122321,1,A,C,231699864,73074,231430182,231823398,269682
1,ENSG00000058453.11,16921931,1-16980204-T-A,rs111384013,1,T,A,16980204,58273,16725323,17118539,254881
1,ENSG00000137992.8,100249834,1-100159473-C-T,rs11166406,-1,C,T,100159473,90361,100053226,100446442,106247
1,ENSG00000079335.13,100352506,1-100460077-C-T,rs11166456,1,C,T,100460077,107571,100155898,100549114,304179
1,ENSG00000143442.16,151459494,1-151584655-T-C,rs11204853,-1,T,C,151584655,125161,151262886,151656102,321769
1,ENSG00000182183.10,52633168,1-52636461-G-A,rs11205983,1,G,A,52636461,3293,52436560,52829776,199901
1,ENSG00000121310.11,52921740,1-52794278-G-T,rs11206019,-1,G,T,52794278,127462,52725132,53118348,69146
1,ENSG00000121310.11,52921740,1-52794278-G-A,rs11206019,-1,G,A,52794278,127462,52725132,53118348,69146
1,ENSG00000198754.4,39771348,1-39750562-A-G,rs11206754,-1,A,G,39750562,20786,39574740,39967956,175822
1,ENSG00000116985.6,39788865,1-39750562-A-G,rs11206754,-1,A,G,39750562,38303,39592257,39985473,158305
1,ENSG00000162434.7,64966549,1-65042741-G-A,rs11208574,-1,G,A,65042741,76192,64769941,65163157,272800
1,ENSG00000179862.5,40862363,1-40860129-G-A,rs11209041,-1,G,A,40860129,2234,40665755,41058971,194374
1,ENSG00000162620.10,74198176,1-74238829-T-A,rs11210443,-1,T,A,74238829,40653,74001568,74394784,237261
1,ENSG00000162620.10,74198176,1-74238829-T-C,rs11210443,-1,T,C,74238829,40653,74001568,74394784,237261
1,ENSG00000222009.4,44808482,1-44814141-T-C,rs11211038,1,T,C,44814141,5659,44611874,45005090,202267
1,ENSG00000132763.9,45500300,1-45496737-T-C,rs11211124,1,T,C,45496737,3563,45303692,45696908,193045
1,ENSG00000159588.10,45624054,1-45697975-C-T,rs11211168,-1,C,T,45697975,73921,45427446,45820662,270529
1,ENSG00000159588.10,45624054,1-45697975-C-A,rs11211168,-1,C,A,45697975,73921,45427446,45820662,270529
1,ENSG00000159588.10,45624054,1-45697975-C-G,rs11211168,-1,C,G,45697975,73921,45427446,45820662,270529
1,ENSG00000133065.6,205813198,1-205838885-C-T,rs11240572,-1,C,T,205838885,25687,205616590,206009806,222295
1,ENSG00000133065.6,205813198,1-205838885-C-A,rs11240572,-1,C,A,205838885,25687,205616590,206009806,222295
1,ENSG00000175087.5,26111824,1-26193473-A-G,rs11247868,1,A,G,26193473,81649,25915216,26308432,278257
1,ENSG00000130775.11,27872544,1-27783712-G-T,rs112485554,1,G,T,27783712,88832,27675936,28069152,107776
1,ENSG00000162694.9,100894842,1-100897026-C-G,rs112578365,-1,C,G,100897026,2184,100698234,101091450,198792
1,ENSG00000162694.9,100894842,1-100897026-C-A,rs112578365,-1,C,A,100897026,2184,100698234,101091450,198792
1,ENSG00000162694.9,100894842,1-100897026-C-T,rs112578365,-1,C,T,100897026,2184,100698234,101091450,198792
1,ENSG00000187144.7,16437424,1-16433542-C-T,rs11260757,-1,C,T,16433542,3882,16240816,16634032,192726
1,ENSG00000143621.12,153670993,1-153686004-G-A,rs11264236,-1,G,A,153686004,15011,153474385,153867601,211619
1,ENSG00000169231.8,155207897,1-155287701-C-G,rs11264355,-1,C,G,155287701,79804,155011289,155404505,276412
1,ENSG00000125459.9,155610218,1-155442246-C-G,rs11264371,1,C,G,155442246,167972,155413610,155806826,28636
1,ENSG00000125459.9,155610218,1-155442246-C-A,rs11264371,1,C,A,155442246,167972,155413610,155806826,28636
1,ENSG00000125459.9,155610218,1-155442246-C-T,rs11264371,1,C,T,155442246,167972,155413610,155806826,28636
1,ENSG00000027869.7,156816848,1-156836208-T-G,rs11264571,-1,T,G,156836208,19360,156620240,157013456,215968
1,ENSG00000132688.9,156677407,1-156856782-G-T,rs11264574,-1,G,T,156856782,179375,156480799,156874015,375983
1,ENSG00000143258.11,161159500,1-161210722-A-G,rs11265565,1,A,G,161210722,51222,160962892,161356108,247830
1,ENSG00000143224.11,161166426,1-161163031-C-A,rs1127525,1,C,A,161163031,3395,160969818,161363034,193213
1,ENSG00000158195.6,27490167,1-27550907-G-A,rs113173951,-1,G,A,27550907,60740,27293559,27686775,257348
1,ENSG00000183780.8,233904676,1-233805822-C-A,rs113801949,1,C,A,233805822,98854,233708068,234101284,97754
1,ENSG00000175984.8,114670049,1-114552458-C-A,rs114506551,-1,C,A,114552458,117591,114473441,114866657,79017
1,ENSG00000143158.6,167937072,1-168096451-A-G,rs114884205,-1,A,G,168096451,159379,167740464,168133680,355987
1,ENSG00000162654.8,89198942,1-89201241-C-T,rs115017409,-1,C,T,89201241,2299,89002334,89395550,198907
1,ENSG00000107404.12,1349418,1-1180224-C-T,rs115023808,-1,C,T,1180224,169194,1152810,1546026,27414
1,ENSG00000107404.12,1349418,1-1180224-C-A,rs115023808,-1,C,A,1180224,169194,1152810,1546026,27414
1,ENSG00000189339.7,1692795,1-1671797-G-C,rs11523819,-1,G,C,1671797,20998,1496187,1889403,175610
1,ENSG00000189339.7,1692795,1-1671797-G-T,rs11523819,-1,G,T,1671797,20998,1496187,1889403,175610
1,ENSG00000189339.7,1692795,1-1671797-G-A,rs11523819,-1,G,A,1671797,20998,1496187,1889403,175610
1,ENSG00000163216.6,153041120,1-153141417-G-A,rs115264490,-1,G,A,153141417,100297,152844512,153237728,296905
1,ENSG00000067208.8,92785108,1-92609713-C-T,rs115575692,-1,C,T,92609713,175395,92588500,92981716,21213
1,ENSG00000177606.5,58784047,1-58930375-G-T,rs115595326,-1,G,T,58930375,146328,58587439,58980655,342936
1,ENSG00000137965.6,78649831,1-78641282-C-T,rs11577394,1,C,T,78641282,8549,78453223,78846439,188059
1,ENSG00000137965.6,78649831,1-78641282-C-A,rs11577394,1,C,A,78641282,8549,78453223,78846439,188059
1,ENSG00000143195.7,166975540,1-166989473-T-A,rs11578336,-1,T,A,166989473,13933,166778932,167172148,210541
1,ENSG00000143195.7,166975540,1-166989473-T-G,rs11578336,-1,T,G,166989473,13933,166778932,167172148,210541
1,ENSG00000143106.8,109426448,1-109580891-G-T,rs11583330,-1,G,T,109580891,154443,109229840,109623056,351051
1,ENSG00000203685.5,226548764,1-226488598-T-C,rs11588657,1,T,C,226488598,60166,226352156,226745372,136442
1,ENSG00000197959.8,171841498,1-171805343-A-G,rs11588833,1,A,G,171805343,36155,171644890,172038106,160453
1,ENSG00000010165.13,171781660,1-171805343-A-G,rs11588833,1,A,G,171805343,23683,171585052,171978268,220291
1,ENSG00000122482.15,91022035,1-91200673-C-T,rs116035375,-1,C,T,91200673,178638,90825427,91218643,375246
1,ENSG00000121851.8,145964690,1-146125988-C-A,rs116110276,1,C,A,146125988,161298,145768082,146161298,357906
1,ENSG00000121851.8,145964690,1-146125988-C-G,rs116110276,1,C,G,146125988,161298,145768082,146161298,357906
1,ENSG00000060642.6,26787950,1-26614660-G-A,rs116391184,1,G,A,26614660,173290,26591342,26984558,23318
1,ENSG00000239887.3,162381728,1-162476071-A-G,rs116408421,1,A,G,162476071,94343,162185120,162578336,290951
1,ENSG00000119285.6,236604516,1-236496235-C-T,rs116412151,-1,C,T,236496235,108281,236407908,236801124,88327
1,ENSG00000162551.9,21509423,1-21672944-T-C,rs116413838,1,T,C,21672944,163521,21312815,21706031,360129
1,ENSG00000130695.8,26234200,1-26076202-G-A,rs116676637,1,G,A,26076202,157998,26037592,26430808,38610
1,ENSG00000159208.11,150282554,1-150338351-A-C,rs11806171,1,A,C,150338351,55797,150085946,150479162,252405
1,ENSG00000159208.11,150282554,1-150338351-A-T,rs11806171,1,A,T,150338351,55797,150085946,150479162,252405
1,ENSG00000118298.5,150257774,1-150131106-C-T,rs11806879,1,C,T,150131106,126668,150061166,150454382,69940
1,ENSG00000213366.6,109668057,1-109718120-T-C,rs11807,1,T,C,109718120,50063,109471449,109864665,246671
1,ENSG00000043514.9,39883504,1-39893054-G-A,rs11811998,-1,G,A,39893054,9550,39686896,40080112,206158
1,ENSG00000146463.7,35268709,1-35450997-G-A,rs1188637,1,G,A,35450997,182288,35072101,35465317,378896
1,ENSG00000159479.12,43389800,1-43319285-A-G,rs1199039,-1,A,G,43319285,70515,43193192,43586408,126093
1,ENSG00000160058.13,32394441,1-32485035-C-A,rs12023137,-1,C,A,32485035,90594,32197833,32591049,287202
1,ENSG00000160058.13,32394441,1-32485035-C-T,rs12023137,-1,C,T,32485035,90594,32197833,32591049,287202
1,ENSG00000162433.10,65148203,1-65178503-T-A,rs12030227,1,T,A,65178503,30300,64951595,65344811,226908
1,ENSG00000162433.10,65148203,1-65178503-T-C,rs12030227,1,T,C,65178503,30300,64951595,65344811,226908
1,ENSG00000054116.7,36149486,1-36077598-T-C,rs12031376,-1,T,C,36077598,71888,35952878,36346094,124720
1,ENSG00000116819.6,35573314,1-35503298-A-T,rs1203148,1,A,T,35503298,70016,35376706,35769922,126592
1,ENSG00000116819.6,35573314,1-35503298-A-G,rs1203148,1,A,G,35503298,70016,35376706,35769922,126592
1,ENSG00000116819.6,35573314,1-35503298-A-C,rs1203148,1,A,C,35503298,70016,35376706,35769922,126592
1,ENSG00000143321.13,156751675,1-156693333-G-C,rs12035162,-1,G,C,156693333,58342,156555067,156948283,138266
1,ENSG00000122223.8,160862887,1-160862856-A-G,rs12036607,-1,A,G,160862856,31,160666279,161059495,196577
1,ENSG00000122223.8,160862887,1-160862856-A-T,rs12036607,-1,A,T,160862856,31,160666279,161059495,196577
1,ENSG00000127483.12,20787307,1-20607103-C-T,rs12036993,-1,C,T,20607103,180204,20590699,20983915,16404
1,ENSG00000142856.12,63523225,1-63607743-A-G,rs12038165,-1,A,G,63607743,84518,63326617,63719833,281126
1,ENSG00000142856.12,63523225,1-63607743-A-T,rs12038165,-1,A,T,63607743,84518,63326617,63719833,281126
1,ENSG00000154429.6,229343047,1-229381508-T-G,rs12040086,-1,T,G,229381508,38461,229146439,229539655,235069
1,ENSG00000143157.7,166839475,1-166829292-T-G,rs12040139,1,T,G,166829292,10183,166642867,167036083,186425
1,ENSG00000162413.11,6602869,1-6572891-T-C,rs12041318,-1,T,C,6572891,29978,6406261,6799477,166630
1,ENSG00000177628.8,155241249,1-155437305-C-T,rs12041534,-1,C,T,155437305,196056,155044641,155437857,392664
1,ENSG00000177628.8,155241249,1-155437305-C-G,rs12041534,-1,C,G,155437305,196056,155044641,155437857,392664
1,ENSG00000177628.8,155241249,1-155437305-C-A,rs12041534,-1,C,A,155437305,196056,155044641,155437857,392664
1,ENSG00000159166.9,201399324,1-201409360-G-A,rs12048410,-1,G,A,201409360,10036,201202716,201595932,206644
1,ENSG00000160783.13,156213007,1-156063096-G-A,rs12049195,1,G,A,156063096,149911,156016399,156409615,46697
1,ENSG00000123080.6,50970245,1-51157025-T-C,rs12070851,1,T,C,51157025,186780,50773637,51166853,383388
1,ENSG00000215912.6,2801717,1-2825926-A-G,rs12071313,-1,A,G,2825926,24209,2605109,2998325,220817
1,ENSG00000134369.10,201648249,1-201756317-G-A,rs12073345,1,G,A,201756317,108068,201451641,201844857,304676
1,ENSG00000014914.14,149936879,1-149931717-G-A,rs12078573,-1,G,A,149931717,5162,149740271,150133487,191446
1,ENSG00000143341.7,185734391,1-185851620-G-A,rs1208452,1,G,A,185851620,117229,185537783,185930999,313837
1,ENSG00000076258.5,171314183,1-171137135-G-A,rs12091596,1,G,A,171137135,177048,171117575,171510791,19560
1,ENSG00000242485.1,1407293,1-1243545-G-A,rs12093154,-1,G,A,1243545,163748,1210685,1603901,32860
1,ENSG00000163041.5,226062716,1-226088853-G-A,rs12096737,1,G,A,226088853,26137,225866108,226259324,222745
1,ENSG00000163041.5,226062716,1-226088853-G-T,rs12096737,1,G,T,226088853,26137,225866108,226259324,222745
1,ENSG00000131697.12,5992425,1-5934274-C-T,rs12118405,-1,C,T,5934274,58151,5795817,6189033,138457
1,ENSG00000143537.8,155051316,1-155125086-C-G,rs12119678,1,C,G,155125086,73770,154854708,155247924,270378
1,ENSG00000162897.9,206970460,1-206958226-T-G,rs12119983,-1,T,G,206958226,12234,206773852,207167068,184374
1,ENSG00000116786.7,15684320,1-15811564-T-A,rs12121764,1,T,A,15811564,127244,15487712,15880928,323852
1,ENSG00000116786.7,15684320,1-15811564-T-C,rs12121764,1,T,C,15811564,127244,15487712,15880928,323852
1,ENSG00000116791.9,74733050,1-74703926-T-A,rs12122137,-1,T,A,74703926,29124,74536442,74929658,167484
1,ENSG00000116791.9,74733050,1-74703926-T-C,rs12122137,-1,T,C,74703926,29124,74536442,74929658,167484
1,ENSG00000169442.4,26317958,1-26223257-G-A,rs12122527,1,G,A,26223257,94701,26121350,26514566,101907
1,ENSG00000169442.4,26317958,1-26223257-G-C,rs12122527,1,G,C,26223257,94701,26121350,26514566,101907
1,ENSG00000116990.9,39901917,1-39783259-A-G,rs12123153,-1,A,G,39783259,118658,39705309,40098525,77950
1,ENSG00000177868.7,42817397,1-42824366-T-A,rs12126596,-1,T,A,42824366,6969,42620789,43014005,203577
1,ENSG00000177868.7,42817397,1-42824366-T-C,rs12126596,-1,T,C,42824366,6969,42620789,43014005,203577
1,ENSG00000177868.7,42817397,1-42824366-T-G,rs12126596,-1,T,G,42824366,6969,42620789,43014005,203577
1,ENSG00000169885.5,1915260,1-1846651-T-C,rs12126768,1,T,C,1846651,68609,1718652,2111868,127999
1,ENSG00000169885.5,1915260,1-1846651-T-G,rs12126768,1,T,G,1846651,68609,1718652,2111868,127999
1,ENSG00000169885.5,1915260,1-1846651-T-A,rs12126768,1,T,A,1846651,68609,1718652,2111868,127999
1,ENSG00000196189.6,156153585,1-156157577-T-C,rs12128066,1,T,C,156157577,3992,155956977,156350193,200600
1,ENSG00000243480.3,103617427,1-103570536-C-T,rs12132911,1,C,T,103570536,46891,103420819,103814035,149717
1,ENSG00000142684.7,26169908,1-26193801-G-T,rs12138368,1,G,T,26193801,23893,25973300,26366516,220501
1,ENSG00000162378.8,52726453,1-52590515-G-T,rs12138419,1,G,T,52590515,135938,52529845,52923061,60670
1,ENSG00000162378.8,52726453,1-52590515-G-A,rs12138419,1,G,A,52590515,135938,52529845,52923061,60670
1,ENSG00000117054.8,75724709,1-75636236-T-C,rs12144212,1,T,C,75636236,88473,75528101,75921317,108135
1,ENSG00000126709.10,27672192,1-27564022-A-T,rs12146138,-1,A,T,27564022,108170,27475584,27868800,88438
1,ENSG00000126709.10,27672192,1-27564022-A-G,rs12146138,-1,A,G,27564022,108170,27475584,27868800,88438
1,ENSG00000163344.5,154936719,1-154837554-A-C,rs1218578,-1,A,C,154837554,99165,154740111,155133327,97443
1,ENSG00000163344.5,154936719,1-154837554-A-G,rs1218578,-1,A,G,154837554,99165,154740111,155133327,97443
1,ENSG00000137968.11,75611114,1-75450141-G-A,rs12402118,-1,G,A,75450141,160973,75414506,75807722,35635
1,ENSG00000143149.8,165698562,1-165698544-T-C,rs12408101,-1,T,C,165698544,18,165501954,165895170,196590
1,ENSG00000143149.8,165698562,1-165698544-T-G,rs12408101,-1,T,G,165698544,18,165501954,165895170,196590
1,ENSG00000142224.11,206770773,1-206809585-A-C,rs12409577,1,A,C,206809585,38812,206574165,206967381,235420
1,ENSG00000142224.11,206770773,1-206809585-A-T,rs12409577,1,A,T,206809585,38812,206574165,206967381,235420
1,ENSG00000203995.5,52842760,1-52820341-A-T,rs1241980,1,A,T,52820341,22419,52646152,53039368,174189
1,ENSG00000203995.5,52842760,1-52820341-A-G,rs1241980,1,A,G,52820341,22419,52646152,53039368,174189
1,ENSG00000116171.11,52927276,1-52820341-A-T,rs1241980,1,A,T,52820341,106935,52730668,53123884,89673
1,ENSG00000116171.11,52927276,1-52820341-A-G,rs1241980,1,A,G,52820341,106935,52730668,53123884,89673
1,ENSG00000184022.2,248597700,1-248779833-T-A,rs12563983,-1,T,A,248779833,182133,248401092,248794308,378741
1,ENSG00000184022.2,248597700,1-248779833-T-C,rs12563983,-1,T,C,248779833,182133,248401092,248794308,378741
1,ENSG00000162545.5,20486210,1-20556710-T-C,rs12565883,-1,T,C,20556710,70500,20289602,20682818,267108
1,ENSG00000212916.3,232805416,1-232805608-G-T,rs12567597,1,G,T,232805608,192,232608808,233002024,196800
1,ENSG00000143110.7,111473984,1-111431271-C-A,rs1264914,1,C,A,111431271,42713,111277376,111670592,153895
1,ENSG00000143110.7,111473984,1-111431271-C-T,rs1264914,1,C,T,111431271,42713,111277376,111670592,153895
1,ENSG00000123843.7,207088860,1-207089635-T-G,rs12711513,1,T,G,207089635,775,206892252,207285468,197383
1,ENSG00000123843.7,207088860,1-207089635-T-A,rs12711513,1,T,A,207089635,775,206892252,207285468,197383
1,ENSG00000187801.9,40450476,1-40449693-T-C,rs12727226,1,T,C,40449693,783,40253868,40647084,195825
1,ENSG00000162714.7,247331867,1-247428873-C-A,rs12728998,-1,C,A,247428873,97006,247135259,247528475,293614
1,ENSG00000162714.7,247331867,1-247428873-C-T,rs12728998,-1,C,T,247428873,97006,247135259,247528475,293614
1,ENSG00000197147.6,89524829,1-89530509-A-T,rs12739645,1,A,T,89530509,5680,89328221,89721437,202288
1,ENSG00000197147.6,89524829,1-89530509-A-G,rs12739645,1,A,G,89530509,5680,89328221,89721437,202288
1,ENSG00000121753.8,31764340,1-31930402-C-T,rs12739816,-1,C,T,31930402,166062,31567732,31960948,362670
1,ENSG00000066135.8,43650149,1-43788915-G-A,rs12741964,1,G,A,43788915,138766,43453541,43846757,335374
1,ENSG00000162437.10,64745095,1-64653226-C-T,rs12742304,1,C,T,64653226,91869,64548487,64941703,104739
1,ENSG00000092607.8,118988343,1-118983165-G-C,rs12742627,-1,G,C,118983165,5178,118791735,119184951,191430
1,ENSG00000092607.8,118988343,1-118983165-G-A,rs12742627,-1,G,A,118983165,5178,118791735,119184951,191430
1,ENSG00000142765.12,27342022,1-27167188-T-C,rs12751422,1,T,C,27167188,174834,27145414,27538630,21774
1,ENSG00000134202.6,109741038,1-109740350-G-T,rs1332018,-1,G,T,109740350,688,109544430,109937646,195920
1,ENSG00000134202.6,109741038,1-109740350-G-A,rs1332018,-1,G,A,109740350,688,109544430,109937646,195920
1,ENSG00000132185.12,161707229,1-161691699-C-G,rs1340976,1,C,G,161691699,15530,161510621,161903837,181078
1,ENSG00000132185.12,161707229,1-161691699-C-A,rs1340976,1,C,A,161691699,15530,161510621,161903837,181078
1,ENSG00000072694.13,161663143,1-161707180-A-G,rs1340978,1,A,G,161707180,44037,161466535,161859751,240645
1,ENSG00000072694.13,161663143,1-161707180-A-C,rs1340978,1,A,C,161707180,44037,161466535,161859751,240645
1,ENSG00000072694.13,161663143,1-161707180-A-T,rs1340978,1,A,T,161707180,44037,161466535,161859751,240645
1,ENSG00000116830.5,117060326,1-117143870-C-A,rs13505,1,C,A,117143870,83544,116863718,117256934,280152
1,ENSG00000116830.5,117060326,1-117143870-C-G,rs13505,1,C,G,117143870,83544,116863718,117256934,280152
1,ENSG00000243725.1,54715861,1-54641346-G-A,rs1368882,1,G,A,54641346,74515,54519253,54912469,122093
1,ENSG00000243725.1,54715861,1-54641346-G-C,rs1368882,1,G,C,54641346,74515,54519253,54912469,122093
1,ENSG00000197747.4,151993859,1-151982416-T-A,rs1387835,-1,T,A,151982416,11443,151797251,152190467,185165
1,ENSG00000197747.4,151993859,1-151982416-T-C,rs1387835,-1,T,C,151982416,11443,151797251,152190467,185165
1,ENSG00000134375.6,201955503,1-201922126-C-A,rs1390398,1,C,A,201922126,33377,201758895,202152111,163231
1,ENSG00000001460.12,24413782,1-24400745-C-T,rs1408559,-1,C,T,24400745,13037,24217174,24610390,183571
1,ENSG00000177272.7,110674940,1-110535950-T-A,rs1419293,-1,T,A,110535950,138990,110478332,110871548,57618
1,ENSG00000177272.7,110674940,1-110535950-T-C,rs1419293,-1,T,C,110535950,138990,110478332,110871548,57618
1,ENSG00000177272.7,110674940,1-110535950-T-G,rs1419293,-1,T,G,110535950,138990,110478332,110871548,57618
1,ENSG00000171385.5,111989668,1-112101158-T-A,rs1440176,-1,T,A,112101158,111490,111793060,112186276,308098
1,ENSG00000171385.5,111989668,1-112101158-T-C,rs1440176,-1,T,C,112101158,111490,111793060,112186276,308098
1,ENSG00000171517.5,84893206,1-84916424-G-C,rs1536120,-1,G,C,84916424,23218,84696598,85089814,219826
1,ENSG00000171517.5,84893206,1-84916424-G-A,rs1536120,-1,G,A,84916424,23218,84696598,85089814,219826
1,ENSG00000188015.5,153549258,1-153662243-C-A,rs15407,-1,C,A,153662243,112985,153352650,153745866,309593
1,ENSG00000162688.11,99850361,1-99965164-G-A,rs1541042,1,G,A,99965164,114803,99653753,100046969,311411
1,ENSG00000158859.8,161199054,1-161081344-T-G,rs1556257,-1,T,G,161081344,117710,161002446,161395662,78898
1,ENSG00000158859.8,161199054,1-161081344-T-C,rs1556257,-1,T,C,161081344,117710,161002446,161395662,78898
1,ENSG00000122218.10,160343250,1-160276695-C-T,rs1557524,-1,C,T,160276695,66555,160146642,160539858,130053
1,ENSG00000117419.9,44355257,1-44314319-C-G,rs161726,-1,C,G,44314319,40938,44158649,44551865,155670
1,ENSG00000117419.9,44355257,1-44314319-C-T,rs161726,-1,C,T,44314319,40938,44158649,44551865,155670
1,ENSG00000158887.11,161309968,1-161363458-G-T,rs16832859,-1,G,T,161363458,53490,161113360,161506576,250098
1,ENSG00000163191.5,152037004,1-152126240-G-A,rs16833852,-1,G,A,152126240,89236,151840396,152233612,285844
1,ENSG00000142910.9,31576515,1-31510359-G-A,rs16834529,1,G,A,31510359,66156,31379907,31773123,130452
1,ENSG00000222046.2,32209089,1-32192846-G-A,rs16834916,1,G,A,32192846,16243,32012481,32405697,180365
1,ENSG00000142920.11,33081153,1-33220797-G-A,rs16835313,1,G,A,33220797,139644,32884545,33277761,336252
1,ENSG00000184678.8,149886682,1-149916132-A-G,rs16835710,-1,A,G,149916132,29450,149690074,150083290,226058
1,ENSG00000163518.6,157598085,1-157542629-G-A,rs16838773,-1,G,A,157542629,55456,157401477,157794693,141152
1,ENSG00000158477.6,158254424,1-158393897-G-T,rs16840119,1,G,T,158393897,139473,158057816,158451032,336081
1,ENSG00000158477.6,158254424,1-158393897-G-C,rs16840119,1,G,C,158393897,139473,158057816,158451032,336081
1,ENSG00000163554.6,158686715,1-158839791-A-G,rs16841144,-1,A,G,158839791,153076,158490107,158883323,349684
1,ENSG00000213047.6,197775480,1-197944027-C-T,rs16842169,-1,C,T,197944027,168547,197578872,197972088,365155
1,ENSG00000176393.6,201982648,1-202007900-T-C,rs16849558,1,T,C,202007900,25252,201786040,202179256,221860
1,ENSG00000162779.14,179365971,1-179394140-C-A,rs16854064,1,C,A,179394140,28169,179169363,179562579,224777
1,ENSG00000143337.11,179882285,1-179980679-A-G,rs16855048,1,A,G,179980679,98394,179685677,180078893,295002
1,ENSG00000152382.5,166876264,1-166861054-G-A,rs16858144,-1,G,A,166861054,15210,166679656,167072872,181398
1,ENSG00000067704.8,220094132,1-220115616-A-C,rs17007135,1,A,C,220115616,21484,219897524,220290740,218092
1,ENSG00000117691.5,212432920,1-212445955-G-A,rs17019084,1,G,A,212445955,13035,212236312,212629528,209643
1,ENSG00000162772.12,212608761,1-212540065-A-G,rs17019266,1,A,G,212540065,68696,212412153,212805369,127912
1,ENSG00000203710.5,207496157,1-207631132-C-A,rs17048122,1,C,A,207631132,134975,207299549,207692765,331583
1,ENSG00000198162.6,117367449,1-117330007-A-C,rs1707113,1,A,C,117330007,37442,117170841,117564057,159166
1,ENSG00000198162.6,117367449,1-117330007-A-G,rs1707113,1,A,G,117330007,37442,117170841,117564057,159166
1,ENSG00000198162.6,117367449,1-117330007-A-T,rs1707113,1,A,T,117330007,37442,117170841,117564057,159166
1,ENSG00000162373.7,48776891,1-48964233-G-A,rs17105327,-1,G,A,48964233,187342,48580283,48973499,383950
1,ENSG00000157193.10,53328070,1-53482195-C-T,rs17108559,-1,C,T,53482195,154125,53131462,53524678,350733
1,ENSG00000188641.8,97921034,1-97764035-C-T,rs17117118,-1,C,T,97764035,156999,97724426,98117642,39609
1,ENSG00000122477.7,100178256,1-100179332-G-A,rs17122019,-1,G,A,100179332,1076,99981648,100374864,197684
1,ENSG00000175707.6,26960468,1-26880121-T-C,rs17162324,-1,T,C,26880121,80347,26763860,27157076,116261
1,ENSG00000130766.4,28259518,1-28287738-G-A,rs17163118,1,G,A,28287738,28220,28062910,28456126,224828
1,ENSG00000130768.8,27935000,1-27893973-C-A,rs17257252,1,C,A,27893973,41027,27738392,28131608,155581
1,ENSG00000158156.7,27959973,1-28032579-C-A,rs17257329,1,C,A,28032579,72606,27763365,28156581,269214
1,ENSG00000158156.7,27959973,1-28032579-C-T,rs17257329,1,C,T,28032579,72606,27763365,28156581,269214
1,ENSG00000086619.9,236281958,1-236270824-T-C,rs1726622,-1,T,C,236270824,11134,236085350,236478566,185474
1,ENSG00000116157.5,52602371,1-52579768-G-A,rs17365357,1,G,A,52579768,22603,52405763,52798979,174005
1,ENSG00000242252.1,156242184,1-156409352-G-A,rs17383726,1,G,A,156409352,167168,156045576,156438792,363776
1,ENSG00000117016.5,40665682,1-40564792-A-G,rs17403513,-1,A,G,40564792,100890,40469074,40862290,95718
1,ENSG00000142794.11,21440137,1-21467568-C-T,rs17420195,1,C,T,21467568,27431,21243529,21636745,224039
1,ENSG00000183520.7,38012734,1-37949835-A-G,rs17531077,1,A,G,37949835,62899,37816126,38209342,133709
1,ENSG00000183520.7,38012734,1-37949835-A-T,rs17531077,1,A,T,37949835,62899,37816126,38209342,133709
1,ENSG00000085491.11,108200343,1-108203129-C-A,rs17574098,-1,C,A,108203129,2786,108003735,108396951,199394
1,ENSG00000085491.11,108200343,1-108203129-C-G,rs17574098,-1,C,G,108203129,2786,108003735,108396951,199394
1,ENSG00000203814.5,149812370,1-149882774-T-C,rs17581380,-1,T,C,149882774,70404,149615762,150008978,267012
1,ENSG00000134245.12,112508965,1-112421990-G-A,rs1759684,1,G,A,112421990,86975,112312357,112705573,109633
1,ENSG00000134245.12,112508965,1-112421990-G-T,rs1759684,1,G,T,112421990,86975,112312357,112705573,109633
1,ENSG00000134245.12,112508965,1-112421990-G-C,rs1759684,1,G,C,112421990,86975,112312357,112705573,109633
1,ENSG00000163131.5,150765778,1-150685811-A-G,rs17599629,-1,A,G,150685811,79967,150569170,150962386,116641
1,ENSG00000162777.12,111200646,1-111257063-A-G,rs17654531,-1,A,G,111257063,56417,111004038,111397254,253025
1,ENSG00000153898.8,84997113,1-85091108-G-A,rs1770691,-1,G,A,85091108,93995,84800505,85193721,290603
1,ENSG00000153898.8,84997113,1-85091108-G-C,rs1770691,-1,G,C,85091108,93995,84800505,85193721,290603
1,ENSG00000153898.8,84997113,1-85091108-G-T,rs1770691,-1,G,T,85091108,93995,84800505,85193721,290603
1,ENSG00000169962.4,1331280,1-1322213-A-C,rs1810745,1,A,C,1322213,9067,1134672,1527888,187541
1,ENSG00000169962.4,1331280,1-1322213-A-G,rs1810745,1,A,G,1322213,9067,1134672,1527888,187541
1,ENSG00000117650.8,211675621,1-211660697-G-C,rs1822568,-1,G,C,211660697,14924,211479013,211872229,181684
1,ENSG00000117650.8,211675621,1-211660697-G-A,rs1822568,-1,G,A,211660697,14924,211479013,211872229,181684
1,ENSG00000117650.8,211675621,1-211660697-G-T,rs1822568,-1,G,T,211660697,14924,211479013,211872229,181684
1,ENSG00000162643.8,85062327,1-85136729-T-C,rs1870327,1,T,C,85136729,74402,84865719,85258935,271010
1,ENSG00000162643.8,85062327,1-85136729-T-A,rs1870327,1,T,A,85136729,74402,84865719,85258935,271010
1,ENSG00000197084.3,152806651,1-152780320-A-G,rs1888962,-1,A,G,152780320,26331,152610043,153003259,170277
1,ENSG00000121900.12,32901389,1-32943950-C-T,rs194644,-1,C,T,32943950,42561,32704781,33097997,239169
1,ENSG00000121900.12,32901389,1-32943950-C-A,rs194644,-1,C,A,32943950,42561,32704781,33097997,239169
1,ENSG00000186226.7,152786257,1-152752340-T-C,rs1953057,1,T,C,152752340,33917,152589649,152982865,162691
1,ENSG00000162746.10,161721563,1-161707945-T-G,rs1954172,1,T,G,161707945,13618,161524955,161918171,182990
1,ENSG00000162746.10,161721563,1-161707945-T-C,rs1954172,1,T,C,161707945,13618,161524955,161918171,182990
1,ENSG00000117479.7,169485944,1-169476945-A-G,rs1983546,-1,A,G,169476945,8999,169289336,169682552,187609
1,ENSG00000170989.7,101237019,1-101215912-A-T,rs1999134,1,A,T,101215912,21107,101040411,101433627,175501
1,ENSG00000170989.7,101237019,1-101215912-A-C,rs1999134,1,A,C,101215912,21107,101040411,101433627,175501
1,ENSG00000090432.5,20508151,1-20531137-G-A,rs2000366,-1,G,A,20531137,22986,20311543,20704759,219594
1,ENSG00000158769.11,161021152,1-161015918-A-C,rs2039223,-1,A,C,161015918,5234,160824544,161217760,191374
1,ENSG00000158769.11,161021152,1-161015918-A-G,rs2039223,-1,A,G,161015918,5234,160824544,161217760,191374
1,ENSG00000158769.11,161021152,1-161015918-A-T,rs2039223,-1,A,T,161015918,5234,160824544,161217760,191374
1,ENSG00000197965.7,167721982,1-167753081-G-A,rs2069059,1,G,A,167753081,31099,167525374,167918590,227707
1,ENSG00000162607.8,62437049,1-62394639-G-C,rs2095403,1,G,C,62394639,42410,62240441,62633657,154198
1,ENSG00000162607.8,62437049,1-62394639-G-T,rs2095403,1,G,T,62394639,42410,62240441,62633657,154198
1,ENSG00000162607.8,62437049,1-62394639-G-A,rs2095403,1,G,A,62394639,42410,62240441,62633657,154198
1,ENSG00000084070.6,40373727,1-40397159-G-A,rs209598,1,G,A,40397159,23432,40177119,40570335,220040
1,ENSG00000143631.9,152325239,1-152381144-C-T,rs2104179,-1,C,T,152381144,55905,152128631,152521847,252513
1,ENSG00000143631.9,152325239,1-152381144-C-G,rs2104179,-1,C,G,152381144,55905,152128631,152521847,252513
1,ENSG00000127423.6,25859457,1-25855791-T-A,rs213644,-1,T,A,25855791,3666,25662849,26056065,192942
1,ENSG00000127423.6,25859457,1-25855791-T-C,rs213644,-1,T,C,25855791,3666,25662849,26056065,192942
1,ENSG00000143434.10,151146631,1-151064340-A-C,rs2140709,-1,A,C,151064340,82291,150950023,151343239,114317
1,ENSG00000143434.10,151146631,1-151064340-A-T,rs2140709,-1,A,T,151064340,82291,150950023,151343239,114317
1,ENSG00000143434.10,151146631,1-151064340-A-G,rs2140709,-1,A,G,151064340,82291,150950023,151343239,114317
1,ENSG00000116679.11,185317243,1-185402808-G-A,rs2144291,-1,G,A,185402808,85565,185120635,185513851,282173
1,ENSG00000157916.12,2391841,1-2308567-T-G,rs2173049,1,T,G,2308567,83274,2195233,2588449,113334
1,ENSG00000157916.12,2391841,1-2308567-T-C,rs2173049,1,T,C,2308567,83274,2195233,2588449,113334
1,ENSG00000157916.12,2391841,1-2308567-T-A,rs2173049,1,T,A,2308567,83274,2195233,2588449,113334
1,ENSG00000120332.10,175067833,1-175180412-G-A,rs2179036,1,G,A,175180412,112579,174871225,175264441,309187
1,ENSG00000116459.6,111449464,1-111348570-C-A,rs2184884,1,C,A,111348570,100894,111252856,111646072,95714
1,ENSG00000162909.12,223712539,1-223713843-T-C,rs2186006,1,T,C,223713843,1304,223515931,223909147,197912
1,ENSG00000162909.12,223712539,1-223713843-T-A,rs2186006,1,T,A,223713843,1304,223515931,223909147,197912
1,ENSG00000143178.7,168280877,1-168246267-A-G,rs2205698,1,A,G,168246267,34610,168084269,168477485,161998
1,ENSG00000143178.7,168280877,1-168246267-A-C,rs2205698,1,A,C,168246267,34610,168084269,168477485,161998
1,ENSG00000160856.14,157700769,1-157699203-C-T,rs2210913,-1,C,T,157699203,1566,157504161,157897377,195042
1,ENSG00000162482.4,19288770,1-19311815-A-T,rs2227295,-1,A,T,19311815,23045,19092162,19485378,219653
1,ENSG00000162482.4,19288770,1-19311815-A-G,rs2227295,-1,A,G,19311815,23045,19092162,19485378,219653
1,ENSG00000053371.8,19312144,1-19311815-A-T,rs2227295,-1,A,T,19311815,329,19115536,19508752,196279
1,ENSG00000053371.8,19312144,1-19311815-A-G,rs2227295,-1,A,G,19311815,329,19115536,19508752,196279
1,ENSG00000196878.7,209652425,1-209625860-A-G,rs2229465,-1,A,G,209625860,26565,209455817,209849033,170043
1,ENSG00000187815.5,40477290,1-40417423-C-T,rs2235701,1,C,T,40417423,59867,40280682,40673898,136741
1,ENSG00000143740.9,227735435,1-227747743-A-G,rs2236359,1,A,G,227747743,12308,227538827,227932043,208916
1,ENSG00000135821.10,182391790,1-182343622-C-T,rs2246475,-1,C,T,182343622,48168,182195182,182588398,148440
1,ENSG00000160781.9,156248056,1-156258269-T-C,rs2253358,-1,T,C,156258269,10213,156051448,156444664,206821
1,ENSG00000122483.13,93180724,1-93180876-T-C,rs2255722,1,T,C,93180876,152,92984116,93377332,196760
1,ENSG00000122483.13,93180724,1-93180876-T-G,rs2255722,1,T,G,93180876,152,92984116,93377332,196760
1,ENSG00000122483.13,93180724,1-93180876-T-A,rs2255722,1,T,A,93180876,152,92984116,93377332,196760
1,ENSG00000116701.9,183590459,1-183590569-A-C,rs2274065,-1,A,C,183590569,110,183393851,183787067,196718
1,ENSG00000133069.10,205227946,1-205384087-C-G,rs2274704,1,C,G,205384087,156141,205031338,205424554,352749
1,ENSG00000133069.10,205227946,1-205384087-C-T,rs2274704,1,C,T,205384087,156141,205031338,205424554,352749
1,ENSG00000143314.8,156741088,1-156648176-G-A,rs2277873,-1,G,A,156648176,92912,156544480,156937696,103696
1,ENSG00000117602.6,24502836,1-24454757-T-A,rs2281188,1,T,A,24454757,48079,24306228,24699444,148529
1,ENSG00000117602.6,24502836,1-24454757-T-C,rs2281188,1,T,C,24454757,48079,24306228,24699444,148529
1,ENSG00000163479.9,156020951,1-155898834-G-T,rs2282301,-1,G,T,155898834,122117,155824343,156217559,74491
1,ENSG00000163479.9,156020951,1-155898834-G-A,rs2282301,-1,G,A,155898834,122117,155824343,156217559,74491
1,ENSG00000153029.10,181033983,1-181058987-A-G,rs2282349,1,A,G,181058987,25004,180837375,181230591,221612
1,ENSG00000116663.6,11664200,1-11661797-C-T,rs2294641,1,C,T,11661797,2403,11467592,11860808,194205
1,ENSG00000160752.10,155308866,1-155309691-T-G,rs2297480,1,T,G,155309691,825,155112258,155505474,197433
1,ENSG00000160752.10,155308866,1-155309691-T-A,rs2297480,1,T,A,155309691,825,155112258,155505474,197433
1,ENSG00000116198.8,3857211,1-3839510-C-A,rs2298225,-1,C,A,3839510,17701,3660603,4053819,178907
1,ENSG00000116198.8,3857211,1-3839510-C-G,rs2298225,-1,C,G,3839510,17701,3660603,4053819,178907
1,ENSG00000116198.8,3857211,1-3839510-C-T,rs2298225,-1,C,T,3839510,17701,3660603,4053819,178907
1,ENSG00000084072.12,39738882,1-39790200-T-G,rs230280,1,T,G,39790200,51318,39542274,39935490,247926
1,ENSG00000196449.3,37808208,1-37794831-C-T,rs2306627,-1,C,T,37794831,13377,37611600,38004816,183231
1,ENSG00000196449.3,37808208,1-37794831-C-G,rs2306627,-1,C,G,37794831,13377,37611600,38004816,183231
1,ENSG00000007341.12,112619141,1-112698430-T-C,rs2306940,-1,T,C,112698430,79289,112422533,112815749,275897
1,ENSG00000081985.6,67307873,1-67367844-G-T,rs2307145,1,G,T,67367844,59971,67111265,67504481,256579
1,ENSG00000081985.6,67307873,1-67367844-G-A,rs2307145,1,G,A,67367844,59971,67111265,67504481,256579
1,ENSG00000081985.6,67307873,1-67367844-G-C,rs2307145,1,G,C,67367844,59971,67111265,67504481,256579
1,ENSG00000188290.6,1000097,1-991929-T-G,rs2341362,-1,T,G,991929,8168,803489,1196705,188440
1,ENSG00000188290.6,1000097,1-991929-T-A,rs2341362,-1,T,A,991929,8168,803489,1196705,188440
1,ENSG00000188290.6,1000097,1-991929-T-C,rs2341362,-1,T,C,991929,8168,803489,1196705,188440
1,ENSG00000116574.4,228735479,1-228821573-G-T,rs241341,1,G,T,228821573,86094,228538871,228932087,282702
1,ENSG00000116574.4,228735479,1-228821573-G-C,rs241341,1,G,C,228821573,86094,228538871,228932087,282702
1,ENSG00000116574.4,228735479,1-228821573-G-A,rs241341,1,G,A,228821573,86094,228538871,228932087,282702
1,ENSG00000187642.5,981029,1-1055037-T-C,rs2465136,-1,T,C,1055037,74008,784421,1177637,270616
1,ENSG00000188822.6,23913362,1-23937754-C-A,rs2501430,-1,C,A,23937754,24392,23716754,24109970,221000
1,ENSG00000188822.6,23913362,1-23937754-C-G,rs2501430,-1,C,G,23937754,24392,23716754,24109970,221000
1,ENSG00000188931.3,161367876,1-161265175-G-C,rs2501879,-1,G,C,161265175,102701,161171268,161564484,93907
1,ENSG00000188931.3,161367876,1-161265175-G-A,rs2501879,-1,G,A,161265175,102701,161171268,161564484,93907
1,ENSG00000188931.3,161367876,1-161265175-G-T,rs2501879,-1,G,T,161265175,102701,161171268,161564484,93907
1,ENSG00000162892.11,206897443,1-207005555-C-T,rs2629646,1,C,T,207005555,108112,206700835,207094051,304720
1,ENSG00000162892.11,206897443,1-207005555-C-A,rs2629646,1,C,A,207005555,108112,206700835,207094051,304720
1,ENSG00000059588.5,234479179,1-234465173-G-A,rs270505,-1,G,A,234465173,14006,234282571,234675787,182602
1,ENSG00000198520.5,44674714,1-44611536-C-T,rs272549,1,C,T,44611536,63178,44478106,44871322,133430
1,ENSG00000198520.5,44674714,1-44611536-C-G,rs272549,1,C,G,44611536,63178,44478106,44871322,133430
1,ENSG00000198520.5,44674714,1-44611536-C-A,rs272549,1,C,A,44611536,63178,44478106,44871322,133430
1,ENSG00000142694.6,36323645,1-36158970-G-T,rs272831,-1,G,T,36158970,164675,36127037,36520253,31933
1,ENSG00000116731.15,13700188,1-13868627-T-C,rs2744671,1,T,C,13868627,168439,13503580,13896796,365047
1,ENSG00000116731.15,13700188,1-13868627-T-A,rs2744671,1,T,A,13868627,168439,13503580,13896796,365047
1,ENSG00000066136.13,40691704,1-40690337-C-T,rs2744800,1,C,T,40690337,1367,40495096,40888312,195241
1,ENSG00000116213.10,3650103,1-3631572-T-C,rs2760321,-1,T,C,3631572,18531,3453495,3846711,178077
1,ENSG00000116191.11,178725244,1-178699977-A-T,rs2773098,1,A,T,178699977,25267,178528636,178921852,171341
1,ENSG00000116191.11,178725244,1-178699977-A-C,rs2773098,1,A,C,178699977,25267,178528636,178921852,171341
1,ENSG00000162623.9,74733152,1-74811884-T-G,rs277385,1,T,G,74811884,78732,74536544,74929760,275340
1,ENSG00000116254.11,6180321,1-6138685-T-G,rs2785585,-1,T,G,6138685,41636,5983713,6376929,154972
1,ENSG00000116254.11,6180321,1-6138685-T-A,rs2785585,-1,T,A,6138685,41636,5983713,6376929,154972
1,ENSG00000116254.11,6180321,1-6138685-T-C,rs2785585,-1,T,C,6138685,41636,5983713,6376929,154972
1,ENSG00000127124.9,41918922,1-41805492-A-T,rs2786480,-1,A,T,41805492,113430,41722314,42115530,83178
1,ENSG00000127124.9,41918922,1-41805492-A-C,rs2786480,-1,A,C,41805492,113430,41722314,42115530,83178
1,ENSG00000156869.7,99766635,1-99759761-C-T,rs2788517,-1,C,T,99759761,6874,99570027,99963243,189734
1,ENSG00000163568.9,159076766,1-159062465-G-C,rs2793845,-1,G,C,159062465,14301,158880158,159273374,182307
1,ENSG00000163568.9,159076766,1-159062465-G-A,rs2793845,-1,G,A,159062465,14301,158880158,159273374,182307
1,ENSG00000163568.9,159076766,1-159062465-G-T,rs2793845,-1,G,T,159062465,14301,158880158,159273374,182307
1,ENSG00000116473.10,111619789,1-111591288-C-T,rs2800881,1,C,T,111591288,28501,111423181,111816397,168107
1,ENSG00000162664.10,89995110,1-89874110-A-G,rs2802031,1,A,G,89874110,121000,89798502,90191718,75608
1,ENSG00000078369.9,1891087,1-1922670-A-G,rs2803348,-1,A,G,1922670,31583,1694479,2087695,228191
1,ENSG00000163875.11,37514766,1-37464693-C-A,rs2811642,-1,C,A,37464693,50073,37318158,37711374,146535
1,ENSG00000163563.7,158831351,1-158872781-A-G,rs2820172,1,A,G,158872781,41430,158634743,159027959,238038
1,ENSG00000143315.5,160031990,1-160036052-G-A,rs2820556,-1,G,A,160036052,4062,159835382,160228598,200670
1,ENSG00000143315.5,160031990,1-160036052-G-C,rs2820556,-1,G,C,160036052,4062,159835382,160228598,200670
1,ENSG00000143315.5,160031990,1-160036052-G-T,rs2820556,-1,G,T,160036052,4062,159835382,160228598,200670
1,ENSG00000117676.7,26529761,1-26569311-A-T,rs282175,1,A,T,26569311,39550,26333153,26726369,236158
1,ENSG00000117676.7,26529761,1-26569311-A-G,rs282175,1,A,G,26569311,39550,26333153,26726369,236158
1,ENSG00000196240.2,248445512,1-248349447-G-C,rs28377739,1,G,C,248349447,96065,248248904,248642120,100543
1,ENSG00000196240.2,248445512,1-248349447-G-A,rs28377739,1,G,A,248349447,96065,248248904,248642120,100543
1,ENSG00000183310.2,248574757,1-248680577-T-C,rs28520471,-1,T,C,248680577,105820,248378149,248771365,302428
1,ENSG00000149527.10,2476289,1-2645520-C-T,rs28547181,1,C,T,2645520,169231,2279681,2672897,365839
1,ENSG00000149527.10,2476289,1-2645520-C-G,rs28547181,1,C,G,2645520,169231,2279681,2672897,365839
1,ENSG00000197780.4,109076003,1-109068704-T-C,rs28634276,-1,T,C,109068704,7299,108879395,109272611,189309
1,ENSG00000197780.4,109076003,1-109068704-T-A,rs28634276,-1,T,A,109068704,7299,108879395,109272611,189309
1,ENSG00000197780.4,109076003,1-109068704-T-G,rs28634276,-1,T,G,109068704,7299,108879395,109272611,189309
1,ENSG00000142632.10,16212652,1-16234684-C-T,rs2863845,-1,C,T,16234684,22032,16016044,16409260,218640
1,ENSG00000142632.10,16212652,1-16234684-C-A,rs2863845,-1,C,A,16234684,22032,16016044,16409260,218640
1,ENSG00000142676.8,23691806,1-23677712-C-A,rs2864704,1,C,A,23677712,14094,23495198,23888414,182514
1,ENSG00000143384.7,150579610,1-150548774-T-C,rs28678181,-1,T,C,150548774,30836,150383002,150776218,165772
1,ENSG00000143384.7,150579610,1-150548774-T-A,rs28678181,-1,T,A,150548774,30836,150383002,150776218,165772
1,ENSG00000092621.6,119711934,1-119855157-A-G,rs2885848,1,A,G,119855157,143223,119515326,119908542,339831
1,ENSG00000162572.14,1280436,1-1220751-T-C,rs2887286,1,T,C,1220751,59685,1083828,1477044,136923
1,ENSG00000143155.8,168178962,1-168148628-A-G,rs2902569,1,A,G,168148628,30334,167982354,168375570,166274
1,ENSG00000143155.8,168178962,1-168148628-A-T,rs2902569,1,A,T,168148628,30334,167982354,168375570,166274
1,ENSG00000163154.5,151156649,1-151054339-C-T,rs2902810,1,C,T,151054339,102310,150960041,151353257,94298
1,ENSG00000163154.5,151156649,1-151054339-C-G,rs2902810,1,C,G,151054339,102310,150960041,151353257,94298
1,ENSG00000117151.7,84574440,1-84605022-A-T,rs2911602,-1,A,T,84605022,30582,84377832,84771048,227190
1,ENSG00000117151.7,84574440,1-84605022-A-G,rs2911602,-1,A,G,84605022,30582,84377832,84771048,227190
1,ENSG00000126106.9,44674481,1-44700235-C-T,rs2983712,-1,C,T,44700235,25754,44477873,44871089,222362
1,ENSG00000155380.7,112956196,1-112873500-C-A,rs2996294,-1,C,A,112873500,82696,112759588,113152804,113912
1,ENSG00000162819.7,222712564,1-222677672-G-C,rs3008635,1,G,C,222677672,34892,222515956,222909172,161716
1,ENSG00000162819.7,222712564,1-222677672-G-A,rs3008635,1,G,A,222677672,34892,222515956,222909172,161716
1,ENSG00000162819.7,222712564,1-222677672-G-T,rs3008635,1,G,T,222677672,34892,222515956,222909172,161716
1,ENSG00000162889.6,206684905,1-206770623-C-A,rs3024493,1,C,A,206770623,85718,206488297,206881513,282326
1,ENSG00000162889.6,206684905,1-206770623-C-T,rs3024493,1,C,T,206770623,85718,206488297,206881513,282326
1,ENSG00000126091.15,43707536,1-43712399-T-C,rs304303,1,T,C,43712399,4863,43510928,43904144,201471
1,ENSG00000126091.15,43707536,1-43712399-T-A,rs304303,1,T,A,43712399,4863,43510928,43904144,201471
1,ENSG00000126091.15,43707536,1-43712399-T-G,rs304303,1,T,G,43712399,4863,43510928,43904144,201471
1,ENSG00000123473.10,47314147,1-47323972-G-A,rs3125635,-1,G,A,47323972,9825,47117539,47510755,206433
1,ENSG00000123473.10,47314147,1-47323972-G-T,rs3125635,-1,G,T,47323972,9825,47117539,47510755,206433
1,ENSG00000171680.14,6491667,1-6466866-G-T,rs3176900,-1,G,T,6466866,24801,6295059,6688275,171807
1,ENSG00000171680.14,6491667,1-6466866-G-A,rs3176900,-1,G,A,6466866,24801,6295059,6688275,171807
1,ENSG00000197785.8,1512162,1-1315577-G-A,rs34054191,1,G,A,1315577,196585,1315554,1708770,23
1,ENSG00000054392.8,210328902,1-210360084-T-G,rs34326582,1,T,G,210360084,31182,210132294,210525510,227790
1,ENSG00000134668.7,31816022,1-31794190-C-G,rs34341430,-1,C,G,31794190,21832,31619414,32012630,174776
1,ENSG00000134668.7,31816022,1-31794190-C-T,rs34341430,-1,C,T,31794190,21832,31619414,32012630,174776
1,ENSG00000090104.6,192575773,1-192597217-G-C,rs34558449,1,G,C,192597217,21444,192379165,192772381,218052
1,ENSG00000127074.10,192636147,1-192597217-G-C,rs34558449,1,G,C,192597217,38930,192439539,192832755,157678
1,ENSG00000158711.8,205632011,1-205631216-C-A,rs34851857,-1,C,A,205631216,795,205435403,205828619,195813
1,ENSG00000158711.8,205632011,1-205631216-C-T,rs34851857,-1,C,T,205631216,795,205435403,205828619,195813
1,ENSG00000180098.5,28553085,1-28744147-C-G,rs34929894,1,C,G,28744147,191062,28356477,28749693,387670
1,ENSG00000180098.5,28553085,1-28744147-C-T,rs34929894,1,C,T,28744147,191062,28356477,28749693,387670
1,ENSG00000259030.1,74198235,1-74393124-G-A,rs34961661,1,G,A,74393124,194889,74001627,74394843,391497
1,ENSG00000224051.2,1324802,1-1334606-G-A,rs35424002,1,G,A,1334606,9804,1128194,1521410,206412
1,ENSG00000160803.6,156053798,1-156207998-A-C,rs35498542,-1,A,C,156207998,154200,155857190,156250406,350808
1,ENSG00000177181.9,42380792,1-42402289-A-T,rs35665433,1,A,T,42402289,21497,42184184,42577400,218105
1,ENSG00000177181.9,42380792,1-42402289-A-G,rs35665433,1,A,G,42402289,21497,42184184,42577400,218105
1,ENSG00000066294.10,160579496,1-160546869-C-G,rs3733266,-1,C,G,160546869,32627,160382888,160776104,163981
1,ENSG00000066294.10,160579496,1-160546869-C-A,rs3733266,-1,C,A,160546869,32627,160382888,160776104,163981
1,ENSG00000160710.11,154608186,1-154600943-C-T,rs3738032,-1,C,T,154600943,7243,154411578,154804794,189365
1,ENSG00000198771.6,167630232,1-167630983-T-C,rs3738222,1,T,C,167630983,751,167433624,167826840,197359
1,ENSG00000163050.10,226940294,1-226986509-T-G,rs3738725,1,T,G,226986509,46215,226743686,227136902,242823
1,ENSG00000163050.10,226940294,1-226986509-T-C,rs3738725,1,T,C,226986509,46215,226743686,227136902,242823
1,ENSG00000117118.5,17054032,1-17005181-A-T,rs3738814,-1,A,T,17005181,48851,16857424,17250640,147757
1,ENSG00000117118.5,17054032,1-17005181-A-G,rs3738814,-1,A,G,17005181,48851,16857424,17250640,147757
1,ENSG00000067334.8,93879206,1-93992865-T-C,rs3747961,-1,T,C,93992865,113659,93682598,94075814,310267
1,ENSG00000134697.6,37595937,1-37583772-C-T,rs3753372,-1,C,T,37583772,12165,37399329,37792545,184443
1,ENSG00000134697.6,37595937,1-37583772-C-A,rs3753372,-1,C,A,37583772,12165,37399329,37792545,184443
1,ENSG00000143742.8,225777826,1-225884054-T-C,rs3753668,1,T,C,225884054,106228,225581218,225974434,302836
1,ENSG00000171812.5,36125222,1-36150736-T-C,rs3754080,-1,T,C,36150736,25514,35928614,36321830,222122
1,ENSG00000143458.6,151070761,1-150979381-G-C,rs3754211,1,G,C,150979381,91380,150874153,151267369,105228
1,ENSG00000143458.6,151070761,1-150979381-G-A,rs3754211,1,G,A,150979381,91380,150874153,151267369,105228
1,ENSG00000143458.6,151070761,1-150979381-G-T,rs3754211,1,G,T,150979381,91380,150874153,151267369,105228
1,ENSG00000065600.8,212414886,1-212364211-G-A,rs3767861,-1,G,A,212364211,50675,212218278,212611494,145933
1,ENSG00000187017.10,6424776,1-6344171-A-G,rs3789479,1,A,G,6344171,80605,6228168,6621384,116003
1,ENSG00000182134.11,151790500,1-151771692-T-C,rs3790514,-1,T,C,151771692,18808,151593892,151987108,177800
1,ENSG00000160679.8,153634066,1-153662949-G-A,rs3795396,1,G,A,153662949,28883,153437458,153830674,225491
1,ENSG00000117091.5,160711822,1-160682940-T-A,rs3796502,-1,T,A,160682940,28882,160515214,160908430,167726
1,ENSG00000117091.5,160711822,1-160682940-T-C,rs3796502,-1,T,C,160682940,28882,160515214,160908430,167726
1,ENSG00000158286.8,6206119,1-6102573-C-T,rs3810991,1,C,T,6102573,103546,6009511,6402727,93062
1,ENSG00000132879.9,11654877,1-11663463-A-G,rs3820340,1,A,G,11663463,8586,11458269,11851485,205194
1,ENSG00000204084.6,37947053,1-37802725-T-C,rs3845498,-1,T,C,37802725,144328,37750445,38143661,52280
1,ENSG00000119535.13,36482913,1-36480112-C-T,rs3917922,-1,C,T,36480112,2801,36286305,36679521,193807
1,ENSG00000189171.8,153627505,1-153616367-G-A,rs4072425,-1,G,A,153616367,11138,153430897,153824113,185470
1,ENSG00000160678.7,153628434,1-153630077-C-T,rs41265183,1,C,T,153630077,1643,153431826,153825042,198251
1,ENSG00000143412.5,150982292,1-151036732-A-G,rs41266605,1,A,G,151036732,54440,150785684,151178900,251048
1,ENSG00000132881.5,16237183,1-16206003-G-A,rs41269185,-1,G,A,16206003,31180,16040575,16433791,165428
1,ENSG00000116691.6,12019498,1-11828016-C-T,rs41275480,1,C,T,11828016,191482,11822890,12216106,5126
1,ENSG00000117480.10,46394317,1-46352830-A-G,rs41294480,1,A,G,46352830,41487,46197709,46590925,155121
1,ENSG00000143653.8,246724409,1-246767817-A-G,rs41310575,1,A,G,246767817,43408,246527801,246921017,240016
1,ENSG00000134684.6,32817358,1-32713555-A-T,rs419145,-1,A,T,32713555,103803,32620750,33013966,92805
1,ENSG00000134684.6,32817358,1-32713555-A-C,rs419145,-1,A,C,32713555,103803,32620750,33013966,92805
1,ENSG00000134684.6,32817358,1-32713555-A-G,rs419145,-1,A,G,32713555,103803,32620750,33013966,92805
1,ENSG00000117791.11,220748322,1-220692403-A-G,rs427216,1,A,G,220692403,55919,220551714,220944930,140689
1,ENSG00000117791.11,220748322,1-220692403-A-T,rs427216,1,A,T,220692403,55919,220551714,220944930,140689
1,ENSG00000117791.11,220748322,1-220692403-A-C,rs427216,1,A,C,220692403,55919,220551714,220944930,140689
1,ENSG00000162817.6,220690363,1-220692403-A-G,rs427216,1,A,G,220692403,2040,220493755,220886971,198648
1,ENSG00000162817.6,220690363,1-220692403-A-T,rs427216,1,A,T,220692403,2040,220493755,220886971,198648
1,ENSG00000162817.6,220690363,1-220692403-A-C,rs427216,1,A,C,220692403,2040,220493755,220886971,198648
1,ENSG00000186205.8,220786913,1-220692403-A-G,rs427216,1,A,G,220692403,94510,220590305,220983521,102098
1,ENSG00000186205.8,220786913,1-220692403-A-T,rs427216,1,A,T,220692403,94510,220590305,220983521,102098
1,ENSG00000186205.8,220786913,1-220692403-A-C,rs427216,1,A,C,220692403,94510,220590305,220983521,102098
1,ENSG00000169914.5,19882395,1-19840848-G-A,rs4272591,1,G,A,19840848,41547,19685787,20079003,155061
1,ENSG00000169914.5,19882395,1-19840848-G-T,rs4272591,1,G,T,19840848,41547,19685787,20079003,155061
1,ENSG00000118733.11,101996926,1-102072324-G-T,rs4326642,-1,G,T,102072324,75398,101800318,102193534,272006
1,ENSG00000118733.11,101996926,1-102072324-G-A,rs4326642,-1,G,A,102072324,75398,101800318,102193534,272006
1,ENSG00000042781.8,216423448,1-216484506-G-A,rs4348785,-1,G,A,216484506,61058,216226840,216620056,257666
1,ENSG00000042781.8,216423448,1-216484506-G-C,rs4348785,-1,G,C,216484506,61058,216226840,216620056,257666
1,ENSG00000121905.5,32886491,1-32982619-A-C,rs4412566,1,A,C,32982619,96128,32689883,33083099,292736
1,ENSG00000121905.5,32886491,1-32982619-A-G,rs4412566,1,A,G,32982619,96128,32689883,33083099,292736
1,ENSG00000094975.8,172533150,1-172422125-G-A,rs4417109,1,G,A,172422125,111025,172336542,172729758,85583
1,ENSG00000094975.8,172533150,1-172422125-G-T,rs4417109,1,G,T,172422125,111025,172336542,172729758,85583
1,ENSG00000134243.7,109397918,1-109308505-A-G,rs444387,-1,A,G,109308505,89413,109201310,109594526,107195
1,ENSG00000134243.7,109397918,1-109308505-A-C,rs444387,-1,A,C,109308505,89413,109201310,109594526,107195
1,ENSG00000143578.11,153967902,1-153852732-A-G,rs4540690,1,A,G,153852732,115170,153771294,154164510,81438
1,ENSG00000143126.6,109249539,1-109251630-T-G,rs454107,1,T,G,109251630,2091,109052931,109446147,198699
1,ENSG00000143126.6,109249539,1-109251630-T-A,rs454107,1,T,A,109251630,2091,109052931,109446147,198699
1,ENSG00000143126.6,109249539,1-109251630-T-C,rs454107,1,T,C,109251630,2091,109052931,109446147,198699
1,ENSG00000183386.5,38005514,1-37999643-G-A,rs4634868,-1,G,A,37999643,5871,37808906,38202122,190737
1,ENSG00000143079.7,112396214,1-112478596-G-A,rs4644492,1,G,A,112478596,82382,112199606,112592822,278990
1,ENSG00000143079.7,112396214,1-112478596-G-T,rs4644492,1,G,T,112478596,82382,112199606,112592822,278990
1,ENSG00000189266.6,23959828,1-24062723-T-G,rs4648931,1,T,G,24062723,102895,23763220,24156436,299503
1,ENSG00000189266.6,23959828,1-24062723-T-C,rs4648931,1,T,C,24062723,102895,23763220,24156436,299503
1,ENSG00000135837.11,179954810,1-180132949-T-C,rs4652470,1,T,C,180132949,178139,179758202,180151418,374747
1,ENSG00000135837.11,179954810,1-180132949-T-A,rs4652470,1,T,A,180132949,178139,179758202,180151418,374747
1,ENSG00000135837.11,179954810,1-180132949-T-G,rs4652470,1,T,G,180132949,178139,179758202,180151418,374747
1,ENSG00000143819.8,225810124,1-225891215-A-G,rs4653437,1,A,G,225891215,81091,225613516,226006732,277699
1,ENSG00000143819.8,225810124,1-225891215-A-T,rs4653437,1,A,T,225891215,81091,225613516,226006732,277699
1,ENSG00000143756.7,224114111,1-224081784-A-C,rs4653923,1,A,C,224081784,32327,223917503,224310719,164281
1,ENSG00000143756.7,224114111,1-224081784-A-G,rs4653923,1,A,G,224081784,32327,223917503,224310719,164281
1,ENSG00000116704.6,67054148,1-67194213-G-T,rs4655690,-1,G,T,67194213,140065,66857540,67250756,336673
1,ENSG00000116704.6,67054148,1-67194213-G-A,rs4655690,-1,G,A,67194213,140065,66857540,67250756,336673
1,ENSG00000116704.6,67054148,1-67194213-G-C,rs4655690,-1,G,C,67194213,140065,66857540,67250756,336673
1,ENSG00000081721.6,161749786,1-161768448-A-T,rs4657101,1,A,T,161768448,18662,161553178,161946394,215270
1,ENSG00000081721.6,161749786,1-161768448-A-C,rs4657101,1,A,C,161768448,18662,161553178,161946394,215270
1,ENSG00000162885.6,235504452,1-235501194-T-C,rs4659905,-1,T,C,235501194,3258,235307844,235701060,193350
1,ENSG00000116962.10,236065090,1-236049599-A-G,rs4660151,-1,A,G,236049599,15491,235868482,236261698,181117
1,ENSG00000116962.10,236065090,1-236049599-A-C,rs4660151,-1,A,C,236049599,15491,235868482,236261698,181117
1,ENSG00000076356.6,208244384,1-208169341-C-G,rs4844413,-1,C,G,208169341,75043,208047776,208440992,121565
1,ENSG00000076356.6,208244384,1-208169341-C-A,rs4844413,-1,C,A,208169341,75043,208047776,208440992,121565
1,ENSG00000076356.6,208244384,1-208169341-C-T,rs4844413,-1,C,T,208169341,75043,208047776,208440992,121565
1,ENSG00000130940.9,10796646,1-10707322-G-T,rs4845952,-1,G,T,10707322,89324,10600038,10993254,107284
1,ENSG00000130940.9,10796646,1-10707322-G-A,rs4845952,-1,G,A,10707322,89324,10600038,10993254,107284
1,ENSG00000049246.8,7784291,1-7657582-C-A,rs4908666,1,C,A,7657582,126709,7587683,7980899,69899
1,ENSG00000049246.8,7784291,1-7657582-C-G,rs4908666,1,C,G,7657582,126709,7587683,7980899,69899
1,ENSG00000049239.7,9234774,1-9237812-A-G,rs4908830,1,A,G,9237812,3038,9038166,9431382,199646
1,ENSG00000162408.10,6554513,1-6579787-G-T,rs4908932,-1,G,T,6579787,25274,6357905,6751121,221882
1,ENSG00000122224.10,160796174,1-160820458-A-G,rs492874,1,A,G,160820458,24284,160599566,160992782,220892
1,ENSG00000168528.7,31413213,1-31511735-A-T,rs4949419,1,A,T,31511735,98522,31216605,31609821,295130
1,ENSG00000168528.7,31413213,1-31511735-A-G,rs4949419,1,A,G,31511735,98522,31216605,31609821,295130
1,ENSG00000168528.7,31413213,1-31511735-A-C,rs4949419,1,A,C,31511735,98522,31216605,31609821,295130
1,ENSG00000117174.6,85708433,1-85597228-G-A,rs4949911,-1,G,A,85597228,111205,85511825,85905041,85403
1,ENSG00000122481.12,95234210,1-95251198-A-G,rs4949946,1,A,G,95251198,16988,95037602,95430818,213596
1,ENSG00000143862.3,202144737,1-201954255-C-T,rs4950744,-1,C,T,201954255,190482,201948129,202341345,6126
1,ENSG00000133059.12,205211702,1-205166306-A-G,rs4950984,-1,A,G,205166306,45396,205015094,205408310,151212
1,ENSG00000134186.7,108692310,1-108730988-G-A,rs4970810,1,G,A,108730988,38678,108495702,108888918,235286
1,ENSG00000143443.8,151047751,1-151190841-G-A,rs4970944,1,G,A,151190841,143090,150851143,151244359,339698
1,ENSG00000143420.12,150629612,1-150611627-G-T,rs4970966,-1,G,T,150611627,17985,150433004,150826220,178623
1,ENSG00000117448.9,45550826,1-45571685-C-A,rs518216,1,C,A,45571685,20859,45354218,45747434,217467
1,ENSG00000117448.9,45550826,1-45571685-C-T,rs518216,1,C,T,45571685,20859,45354218,45747434,217467
1,ENSG00000070759.11,45491163,1-45544980-A-T,rs518365,-1,A,T,45544980,53817,45294555,45687771,250425
1,ENSG00000070759.11,45491163,1-45544980-A-C,rs518365,-1,A,C,45544980,53817,45294555,45687771,250425
1,ENSG00000070759.11,45491163,1-45544980-A-G,rs518365,-1,A,G,45544980,53817,45294555,45687771,250425
1,ENSG00000162543.5,20186096,1-20138951-C-T,rs518588,1,C,T,20138951,47145,19989488,20382704,149463
1,ENSG00000162511.6,30757774,1-30645894-A-G,rs522294,-1,A,G,30645894,111880,30561166,30954382,84728
1,ENSG00000116983.7,39691433,1-39693156-C-T,rs546422,-1,C,T,39693156,1723,39494825,39888041,198331
1,ENSG00000171161.7,248838224,1-248787099-A-C,rs55826813,1,A,C,248787099,51125,248641616,249034832,145483
1,ENSG00000171161.7,248838224,1-248787099-A-T,rs55826813,1,A,T,248787099,51125,248641616,249034832,145483
1,ENSG00000183317.11,37765120,1-37761596-G-T,rs56276182,-1,G,T,37761596,3524,37568512,37961728,193084
1,ENSG00000163879.8,37556940,1-37588539-G-A,rs56365156,1,G,A,37588539,31599,37360332,37753548,228207
1,ENSG00000163879.8,37556940,1-37588539-G-T,rs56365156,1,G,T,37588539,31599,37360332,37753548,228207
1,ENSG00000069275.11,205750182,1-205668531-T-C,rs57021717,-1,T,C,205668531,81651,205553574,205946790,114957
1,ENSG00000134184.7,109687817,1-109670892-A-T,rs574344,1,A,T,109670892,16925,109491209,109884425,179683
1,ENSG00000134184.7,109687817,1-109670892-A-C,rs574344,1,A,C,109670892,16925,109491209,109884425,179683
1,ENSG00000134184.7,109687817,1-109670892-A-G,rs574344,1,A,G,109670892,16925,109491209,109884425,179683
1,ENSG00000142875.13,84144271,1-84038737-C-G,rs581864,1,C,G,84038737,105534,83947663,84340879,91074
1,ENSG00000142875.13,84144271,1-84038737-C-T,rs581864,1,C,T,84038737,105534,83947663,84340879,91074
1,ENSG00000131781.8,147225339,1-147409534-G-A,rs58671552,-1,G,A,147409534,184195,147028731,147421947,380803
1,ENSG00000131781.8,147225339,1-147409534-G-C,rs58671552,-1,G,C,147409534,184195,147028731,147421947,380803
1,ENSG00000163141.13,151036586,1-151001835-G-T,rs59942146,1,G,T,151001835,34751,150839978,151233194,161857
1,ENSG00000163141.13,151036586,1-151001835-G-A,rs59942146,1,G,A,151001835,34751,150839978,151233194,161857
1,ENSG00000121774.11,32013868,1-31926308-A-G,rs601261,1,A,G,31926308,87560,31817260,32210476,109048
1,ENSG00000187733.6,103749898,1-103803865-G-C,rs60555558,1,G,C,103803865,53967,103553290,103946506,250575
1,ENSG00000187733.6,103749898,1-103803865-G-A,rs60555558,1,G,A,103803865,53967,103553290,103946506,250575
1,ENSG00000187733.6,103749898,1-103803865-G-T,rs60555558,1,G,T,103803865,53967,103553290,103946506,250575
1,ENSG00000171806.7,169794907,1-169611647-C-T,rs6131,-1,C,T,169611647,183260,169598299,169991515,13348
1,ENSG00000187608.5,1013497,1-1087734-G-A,rs61766340,1,G,A,1087734,74237,816889,1210105,270845
1,ENSG00000122432.11,84506397,1-84482283-A-G,rs61768860,1,A,G,84482283,24114,84309789,84703005,172494
1,ENSG00000090686.11,21783149,1-21825316-G-T,rs61777195,-1,G,T,21825316,42167,21586541,21979757,238775
1,ENSG00000179085.7,155140531,1-155003661-G-T,rs61811895,-1,G,T,155003661,136870,154943923,155337139,59738
1,ENSG00000117595.6,209806142,1-209991371-C-T,rs61820394,-1,C,T,209991371,185229,209609534,210002750,381837
1,ENSG00000197472.9,247008057,1-247167626-T-C,rs61837912,-1,T,C,247167626,159569,246811449,247204665,356177
1,ENSG00000197323.6,114511203,1-114331749-G-C,rs627205,-1,G,C,114331749,179454,114314595,114707811,17154
1,ENSG00000197323.6,114511203,1-114331749-G-T,rs627205,-1,G,T,114331749,179454,114314595,114707811,17154
1,ENSG00000169641.9,23177808,1-23143967-C-T,rs6426786,-1,C,T,23143967,33841,22981200,23374416,162767
1,ENSG00000143303.7,156728469,1-156835383-A-G,rs6427333,1,A,G,156835383,106914,156531861,156925077,303522
1,ENSG00000143303.7,156728469,1-156835383-A-T,rs6427333,1,A,T,156835383,106914,156531861,156925077,303522
1,ENSG00000026751.11,160739247,1-160811175-C-T,rs6427548,1,C,T,160811175,71928,160542639,160935855,268536
1,ENSG00000026751.11,160739247,1-160811175-C-A,rs6427548,1,C,A,160811175,71928,160542639,160935855,268536
1,ENSG00000126070.12,35931105,1-35908222-C-A,rs645383,1,C,A,35908222,22883,35734497,36127713,173725
1,ENSG00000126070.12,35931105,1-35908222-C-G,rs645383,1,C,G,35908222,22883,35734497,36127713,173725
1,ENSG00000116489.8,112619832,1-112675881-T-C,rs6537749,1,T,C,112675881,56049,112423224,112816440,252657
1,ENSG00000143643.8,230978861,1-230954832-G-A,rs6541240,-1,G,A,230954832,24029,230782253,231175469,172579
1,ENSG00000143643.8,230978861,1-230954832-G-C,rs6541240,-1,G,C,230954832,24029,230782253,231175469,172579
1,ENSG00000159363.13,17011928,1-16918438-A-T,rs6586560,-1,A,T,16918438,93490,16815320,17208536,103118
1,ENSG00000159363.13,17011928,1-16918438-A-C,rs6586560,-1,A,C,16918438,93490,16815320,17208536,103118
1,ENSG00000159363.13,17011928,1-16918438-A-G,rs6586560,-1,A,G,16918438,93490,16815320,17208536,103118
1,ENSG00000159352.10,151254734,1-151164668-A-G,rs6587557,1,A,G,151164668,90066,151058126,151451342,106542
1,ENSG00000116729.9,68232523,1-68343211-A-G,rs6588318,-1,A,G,68343211,110688,68035915,68429131,307296
1,ENSG00000116729.9,68232523,1-68343211-A-T,rs6588318,-1,A,T,68343211,110688,68035915,68429131,307296
1,ENSG00000162735.12,160285133,1-160189366-G-A,rs659235,-1,G,A,160189366,95767,160088525,160481741,100841
1,ENSG00000162735.12,160285133,1-160189366-G-T,rs659235,-1,G,T,160189366,95767,160088525,160481741,100841
1,ENSG00000176022.3,1232237,1-1236037-C-T,rs6603782,1,C,T,1236037,3800,1035629,1428845,200408
1,ENSG00000176022.3,1232237,1-1236037-C-G,rs6603782,1,C,G,1236037,3800,1035629,1428845,200408
1,ENSG00000176022.3,1232237,1-1236037-C-A,rs6603782,1,C,A,1236037,3800,1035629,1428845,200408
1,ENSG00000184163.3,1246722,1-1236037-C-T,rs6603782,-1,C,T,1236037,10685,1050114,1443330,185923
1,ENSG00000184163.3,1246722,1-1236037-C-G,rs6603782,-1,C,G,1236037,10685,1050114,1443330,185923
1,ENSG00000184163.3,1246722,1-1236037-C-A,rs6603782,-1,C,A,1236037,10685,1050114,1443330,185923
1,ENSG00000180488.8,77779649,1-77823277-G-A,rs6604876,1,G,A,77823277,43628,77583041,77976257,240236
1,ENSG00000180488.8,77779649,1-77823277-G-T,rs6604876,1,G,T,77823277,43628,77583041,77976257,240236
1,ENSG00000240563.1,62194849,1-62196120-G-T,rs6656763,1,G,T,62196120,1271,61998241,62391457,197879
1,ENSG00000240563.1,62194849,1-62196120-G-A,rs6656763,1,G,A,62196120,1271,61998241,62391457,197879
1,ENSG00000188157.8,1020120,1-982890-C-T,rs6659460,1,C,T,982890,37230,823512,1216728,159378
1,ENSG00000163399.10,116373244,1-116320794-A-C,rs6660103,1,A,C,116320794,52450,116176636,116569852,144158
1,ENSG00000163399.10,116373244,1-116320794-A-G,rs6660103,1,A,G,116320794,52450,116176636,116569852,144158
1,ENSG00000162769.7,212858275,1-212924599-C-T,rs6663614,1,C,T,212924599,66324,212661667,213054883,262932
1,ENSG00000162769.7,212858275,1-212924599-C-A,rs6663614,1,C,A,212924599,66324,212661667,213054883,262932
1,ENSG00000162769.7,212858275,1-212924599-C-G,rs6663614,1,C,G,212924599,66324,212661667,213054883,262932
1,ENSG00000135823.9,181022870,1-180980492-C-T,rs6665134,-1,C,T,180980492,42378,180826262,181219478,154230
1,ENSG00000135823.9,181022870,1-180980492-C-A,rs6665134,-1,C,A,180980492,42378,180826262,181219478,154230
1,ENSG00000075151.13,21176897,1-21227440-T-C,rs6665399,-1,T,C,21227440,50543,20980289,21373505,247151
1,ENSG00000181754.6,109509727,1-109497688-A-G,rs6666119,-1,A,G,109497688,12039,109313119,109706335,184569
1,ENSG00000169504.9,24745447,1-24832009-T-G,rs6667299,1,T,G,24832009,86562,24548839,24942055,283170
1,ENSG00000169504.9,24745447,1-24832009-T-C,rs6667299,1,T,C,24832009,86562,24548839,24942055,283170
1,ENSG00000171502.10,86156772,1-86101161-T-C,rs6670074,-1,T,C,86101161,55611,85960164,86353380,140997
1,ENSG00000215845.6,161038964,1-161068977-T-G,rs6671492,-1,T,G,161068977,30013,160842356,161235572,226621
1,ENSG00000215845.6,161038964,1-161068977-T-C,rs6671492,-1,T,C,161068977,30013,160842356,161235572,226621
1,ENSG00000215845.6,161038964,1-161068977-T-A,rs6671492,-1,T,A,161068977,30013,160842356,161235572,226621
1,ENSG00000179397.12,244461273,1-244286218-C-T,rs6672794,1,C,T,244286218,175055,244264665,244657881,21553
1,ENSG00000116678.14,65420668,1-65382351-A-C,rs6672992,1,A,C,65382351,38317,65224060,65617276,158291
1,ENSG00000116678.14,65420668,1-65382351-A-G,rs6672992,1,A,G,65382351,38317,65224060,65617276,158291
1,ENSG00000131778.12,147242684,1-147423187-C-G,rs6674207,1,C,G,147423187,180503,147046076,147439292,377111
1,ENSG00000131778.12,147242684,1-147423187-C-T,rs6674207,1,C,T,147423187,180503,147046076,147439292,377111
1,ENSG00000134262.8,113904799,1-113913285-G-T,rs6674384,-1,G,T,113913285,8486,113708191,114101407,205094
1,ENSG00000134262.8,113904799,1-113913285-G-A,rs6674384,-1,G,A,113913285,8486,113708191,114101407,205094
1,ENSG00000116991.6,232630133,1-232624362-T-C,rs6680892,-1,T,C,232624362,5771,232433525,232826741,190837
1,ENSG00000116954.7,38859772,1-38824387-C-T,rs6681493,-1,C,T,38824387,35385,38663164,39056380,161223
1,ENSG00000178922.11,43453931,1-43553634-C-T,rs6684279,-1,C,T,43553634,99703,43257323,43650539,296311
1,ENSG00000235169.3,3772749,1-3873250-A-C,rs66849805,1,A,C,3873250,100501,3576141,3969357,297109
1,ENSG00000132128.11,46303616,1-46332873-A-G,rs6689182,-1,A,G,46332873,29257,46107008,46500224,225865
1,ENSG00000132128.11,46303616,1-46332873-A-C,rs6689182,-1,A,C,46332873,29257,46107008,46500224,225865
1,ENSG00000117133.6,84479266,1-84532762-C-G,rs6690204,1,C,G,84532762,53496,84282658,84675874,250104
1,ENSG00000117133.6,84479266,1-84532762-C-T,rs6690204,1,C,T,84532762,53496,84282658,84675874,250104
1,ENSG00000133048.8,203186704,1-203187994-G-A,rs6691378,-1,G,A,203187994,1290,202990096,203383312,197898
1,ENSG00000169905.7,179877803,1-180020449-G-C,rs6692219,-1,G,C,180020449,142646,179681195,180074411,339254
1,ENSG00000171488.9,89633120,1-89757514-C-T,rs6694039,1,C,T,89757514,124394,89436512,89829728,321002
1,ENSG00000143198.7,165631234,1-165630314-T-C,rs6694924,1,T,C,165630314,920,165434626,165827842,195688
1,ENSG00000118197.8,200669907,1-200642582-C-T,rs6695836,-1,C,T,200642582,27325,200473299,200866515,169283
1,ENSG00000118197.8,200669907,1-200642582-C-A,rs6695836,-1,C,A,200642582,27325,200473299,200866515,169283
1,ENSG00000160716.4,154567778,1-154701279-G-A,rs6696760,1,G,A,154701279,133501,154371170,154764386,330109
1,ENSG00000158109.9,3625015,1-3654319-C-T,rs6697769,1,C,T,3654319,29304,3428407,3821623,225912
1,ENSG00000158109.9,3625015,1-3654319-C-A,rs6697769,1,C,A,3654319,29304,3428407,3821623,225912
1,ENSG00000158109.9,3625015,1-3654319-C-G,rs6697769,1,C,G,3654319,29304,3428407,3821623,225912
1,ENSG00000117153.11,202927234,1-202883973-C-T,rs6698793,-1,C,T,202883973,43261,202730626,203123842,153347
1,ENSG00000162676.7,92486925,1-92331191-A-G,rs6700072,-1,A,G,92331191,155734,92290317,92683533,40874
1,ENSG00000185220.7,248906235,1-248901731-C-T,rs6700372,1,C,T,248901731,4504,248709627,249102843,192104
1,ENSG00000185220.7,248906235,1-248901731-C-A,rs6700372,1,C,A,248901731,4504,248709627,249102843,192104
1,ENSG00000117505.7,93345907,1-93318238-A-T,rs6701250,1,A,T,93318238,27669,93149299,93542515,168939
1,ENSG00000117505.7,93345907,1-93318238-A-G,rs6701250,1,A,G,93318238,27669,93149299,93542515,168939
1,ENSG00000117505.7,93345907,1-93318238-A-C,rs6701250,1,A,C,93318238,27669,93149299,93542515,168939
1,ENSG00000055732.7,85048500,1-84952096-G-T,rs679961,-1,G,T,84952096,96404,84851892,85245108,100204
1,ENSG00000055732.7,85048500,1-84952096-G-A,rs679961,-1,G,A,84952096,96404,84851892,85245108,100204
1,ENSG00000196407.6,151853712,1-151763100-T-C,rs7007,-1,T,C,151763100,90612,151657104,152050320,105996
1,ENSG00000169972.7,1308597,1-1237527-C-G,rs715643,1,C,G,1237527,71070,1111989,1505205,125538
1,ENSG00000169972.7,1308597,1-1237527-C-T,rs715643,1,C,T,1237527,71070,1111989,1505205,125538
1,ENSG00000116251.5,6199595,1-6060247-C-T,rs71629764,-1,C,T,6060247,139348,6002987,6396203,57260
1,ENSG00000066279.11,197146669,1-196985930-C-A,rs72468006,-1,C,A,196985930,160739,196950061,197343277,35869
1,ENSG00000162520.10,32702770,1-32867503-G-A,rs726344,-1,G,A,32867503,164733,32506162,32899378,361341
1,ENSG00000162520.10,32702770,1-32867503-G-C,rs726344,-1,G,C,32867503,164733,32506162,32899378,361341
1,ENSG00000116649.4,11060018,1-11145955-A-G,rs72647298,-1,A,G,11145955,85937,10863410,11256626,282545
1,ENSG00000188672.10,25420825,1-25257119-C-G,rs72660908,-1,C,G,25257119,163706,25224217,25617433,32902
1,ENSG00000143153.7,169106690,1-169047643-C-T,rs72693515,1,C,T,169047643,59047,168910082,169303298,137561
1,ENSG00000143153.7,169106690,1-169047643-C-G,rs72693515,1,C,G,169047643,59047,168910082,169303298,137561
1,ENSG00000237763.5,103655760,1-103772836-A-G,rs72694426,1,A,G,103772836,117076,103459152,103852368,313684
1,ENSG00000174876.11,103696210,1-103772836-A-G,rs72694426,-1,A,G,103772836,76626,103499602,103892818,273234
1,ENSG00000143061.13,116667733,1-116582831-G-C,rs72697343,-1,G,C,116582831,84902,116471125,116864341,111706
1,ENSG00000143061.13,116667733,1-116582831-G-A,rs72697343,-1,G,A,116582831,84902,116471125,116864341,111706
1,ENSG00000134201.5,109712251,1-109636825-G-A,rs72705211,1,G,A,109636825,75426,109515643,109908859,121182
1,ENSG00000143322.15,179229677,1-179084092-A-G,rs72709446,-1,A,G,179084092,145585,179033069,179426285,51023
1,ENSG00000198216.6,181483517,1-181455155-G-T,rs72731213,1,G,T,181455155,28362,181286909,181680125,168246
1,ENSG00000143507.12,221742089,1-221714561-T-G,rs72736544,-1,T,G,221714561,27528,221545481,221938697,169080
1,ENSG00000143751.7,225999343,1-226020937-T-C,rs72757027,-1,T,C,226020937,21594,225802735,226195951,218202
1,ENSG00000188558.4,248508073,1-248409872-A-G,rs72766997,1,A,G,248409872,98201,248311465,248704681,98407
1,ENSG00000091483.6,241519755,1-241709164-T-G,rs72768081,-1,T,G,241709164,189409,241323147,241716363,386017
1,ENSG00000091483.6,241519755,1-241709164-T-C,rs72768081,-1,T,C,241709164,189409,241323147,241716363,386017
1,ENSG00000175756.8,1375207,1-1285621-A-G,rs72896210,-1,A,G,1285621,89586,1178599,1571815,107022
1,ENSG00000196154.6,153545806,1-153661582-G-T,rs7345,-1,G,T,153661582,115776,153349198,153742414,312384
1,ENSG00000196154.6,153545806,1-153661582-G-A,rs7345,-1,G,A,153661582,115776,153349198,153742414,312384
1,ENSG00000135842.12,184974508,1-184953929-C-G,rs7355169,-1,C,G,184953929,20579,184777900,185171116,176029
1,ENSG00000135842.12,184974508,1-184953929-C-T,rs7355169,-1,C,T,184953929,20579,184777900,185171116,176029
1,ENSG00000117519.11,94927110,1-95074006-C-T,rs74103646,-1,C,T,95074006,146896,94730502,95123718,343504
1,ENSG00000160714.5,154558662,1-154727775-C-G,rs74115846,-1,C,G,154727775,169113,154362054,154755270,365721
1,ENSG00000181773.6,27392622,1-27218139-G-T,rs74224104,1,G,T,27218139,174483,27196014,27589230,22125
1,ENSG00000181773.6,27392622,1-27218139-G-A,rs74224104,1,G,A,27218139,174483,27196014,27589230,22125
1,ENSG00000181773.6,27392622,1-27218139-G-C,rs74224104,1,G,C,27218139,174483,27196014,27589230,22125
1,ENSG00000182749.5,25875708,1-25875935-C-T,rs74378533,-1,C,T,25875935,227,25679100,26072316,196835
1,ENSG00000182749.5,25875708,1-25875935-C-A,rs74378533,-1,C,A,25875935,227,25679100,26072316,196835
1,ENSG00000049247.8,7853065,1-7874458-G-A,rs744000,-1,G,A,7874458,21393,7656457,8049673,218001
1,ENSG00000049247.8,7853065,1-7874458-G-T,rs744000,-1,G,T,7874458,21393,7656457,8049673,218001
1,ENSG00000143353.7,219173878,1-219296383-G-C,rs74585261,1,G,C,219296383,122505,218977270,219370486,319113
1,ENSG00000143353.7,219173878,1-219296383-G-A,rs74585261,1,G,A,219296383,122505,218977270,219370486,319113
1,ENSG00000143256.4,161118037,1-161275697-G-C,rs74691586,-1,G,C,161275697,157660,160921429,161314645,354268
1,ENSG00000069248.7,229508341,1-229420421-G-A,rs74753059,-1,G,A,229420421,87920,229311733,229704949,108688
1,ENSG00000197852.7,111739395,1-111547597-G-A,rs74928003,-1,G,A,111547597,191798,111542787,111936003,4810
1,ENSG00000159658.5,46719114,1-46811147-G-A,rs7513658,-1,G,A,46811147,92033,46522506,46915722,288641
1,ENSG00000117625.9,211259366,1-211334872-A-C,rs75138501,1,A,C,211334872,75506,211062758,211455974,272114
1,ENSG00000117625.9,211259366,1-211334872-A-G,rs75138501,1,A,G,211334872,75506,211062758,211455974,272114
1,ENSG00000085465.10,111427735,1-111382285-G-T,rs7513936,-1,G,T,111382285,45450,111231127,111624343,151158
1,ENSG00000085465.10,111427735,1-111382285-G-A,rs7513936,-1,G,A,111382285,45450,111231127,111624343,151158
1,ENSG00000085465.10,111427735,1-111382285-G-C,rs7513936,-1,G,C,111382285,45450,111231127,111624343,151158
1,ENSG00000162461.7,15736258,1-15711831-T-C,rs7516540,1,T,C,15711831,24427,15539650,15932866,172181
1,ENSG00000162441.6,9943391,1-9952956-A-G,rs7516611,-1,A,G,9952956,9565,9746783,10139999,206173
1,ENSG00000162441.6,9943391,1-9952956-A-C,rs7516611,-1,A,C,9952956,9565,9746783,10139999,206173
1,ENSG00000182004.8,203861599,1-203803968-A-C,rs7518201,1,A,C,203803968,57631,203664991,204058207,138977
1,ENSG00000236334.1,148483302,1-148477279-T-G,rs7518807,-1,T,G,148477279,6023,148286694,148679910,190585
1,ENSG00000236334.1,148483302,1-148477279-T-C,rs7518807,-1,T,C,148477279,6023,148286694,148679910,190585
1,ENSG00000170128.2,200872981,1-200758745-A-G,rs7519005,1,A,G,200758745,114236,200676373,201069589,82372
1,ENSG00000116260.12,180154869,1-180208131-G-T,rs7521602,1,G,T,180208131,53262,179958261,180351477,249870
1,ENSG00000116260.12,180154869,1-180208131-G-A,rs7521602,1,G,A,180208131,53262,179958261,180351477,249870
1,ENSG00000171357.5,46203334,1-46191979-T-C,rs7521880,1,T,C,46191979,11355,46006726,46399942,185253
1,ENSG00000117280.8,205775482,1-205766763-G-A,rs7522056,-1,G,A,205766763,8719,205578874,205972090,187889
1,ENSG00000142686.6,35718884,1-35549410-G-A,rs7523017,-1,G,A,35549410,169474,35522276,35915492,27134
1,ENSG00000183155.4,202889149,1-202896576-T-G,rs7523420,-1,T,G,202896576,7427,202692541,203085757,204035
1,ENSG00000168710.13,109984765,1-109790194-G-T,rs7524737,1,G,T,109790194,194571,109788157,110181373,2037
1,ENSG00000243749.1,34985353,1-34888303-G-A,rs7525948,-1,G,A,34888303,97050,34788745,35181961,99558
1,ENSG00000163545.7,205321745,1-205382575-A-T,rs7528008,-1,A,T,205382575,60830,205125137,205518353,257438
1,ENSG00000186283.9,179082070,1-179002639-T-C,rs7534481,1,T,C,179002639,79431,178885462,179278678,117177
1,ENSG00000186283.9,179082070,1-179002639-T-A,rs7534481,1,T,A,179002639,79431,178885462,179278678,117177
1,ENSG00000203705.5,212791894,1-212755719-A-T,rs7535608,1,A,T,212755719,36175,212595286,212988502,160433
1,ENSG00000203705.5,212791894,1-212755719-A-G,rs7535608,1,A,G,212755719,36175,212595286,212988502,160433
1,ENSG00000170385.9,211579161,1-211512678-C-T,rs753647,-1,C,T,211512678,66483,211382553,211775769,130125
1,ENSG00000174574.9,38991276,1-38973866-G-A,rs7537437,1,G,A,38973866,17410,38794668,39187884,179198
1,ENSG00000117009.7,241532378,1-241462563-C-T,rs7540470,1,C,T,241462563,69815,241335770,241728986,126793
1,ENSG00000186510.6,16022036,1-15992159-C-T,rs75412003,1,C,T,15992159,29877,15825428,16218644,166731
1,ENSG00000196944.3,248361665,1-248359594-G-A,rs7541216,1,G,A,248359594,2071,248165057,248558273,194537
1,ENSG00000203661.2,248488589,1-248359594-G-A,rs7541216,1,G,A,248359594,128995,248291981,248685197,67613
1,ENSG00000171603.11,9823965,1-9870902-A-G,rs7541300,-1,A,G,9870902,46937,9627357,10020573,243545
1,ENSG00000116857.11,201154474,1-201156198-T-C,rs7542768,-1,T,C,201156198,1724,200957866,201351082,198332
1,ENSG00000182866.11,32251265,1-32205036-A-C,rs7543181,1,A,C,32205036,46229,32054657,32447873,150379
1,ENSG00000204178.5,25430897,1-25551001-C-T,rs75446219,1,C,T,25551001,120104,25234289,25627505,316712
1,ENSG00000127472.6,20070194,1-20019859-T-G,rs7547676,1,T,G,20019859,50335,19873586,20266802,146273
1,ENSG00000127472.6,20070194,1-20019859-T-C,rs7547676,1,T,C,20019859,50335,19873586,20266802,146273
1,ENSG00000162783.7,181088700,1-181192048-A-G,rs7550514,1,A,G,181192048,103348,180892092,181285308,299956
1,ENSG00000133063.11,203229673,1-203274985-C-T,rs7551146,-1,C,T,203274985,45312,203033065,203426281,241920
1,ENSG00000162521.12,32651208,1-32463574-C-T,rs7552676,1,C,T,32463574,187634,32454600,32847816,8974
1,ENSG00000157911.5,2412564,1-2273316-G-A,rs7553178,-1,G,A,2273316,139248,2215956,2609172,57360
1,ENSG00000157911.5,2412564,1-2273316-G-C,rs7553178,-1,G,C,2273316,139248,2215956,2609172,57360
1,ENSG00000132781.11,45339970,1-45377414-A-T,rs7553318,-1,A,T,45377414,37444,45143362,45536578,234052
1,ENSG00000132781.11,45339970,1-45377414-A-G,rs7553318,-1,A,G,45377414,37444,45143362,45536578,234052
1,ENSG00000169418.7,153678688,1-153725593-A-G,rs7556155,1,A,G,153725593,46905,153482080,153875296,243513
1,ENSG00000159445.8,151909511,1-151875827-T-C,rs76069678,-1,T,C,151875827,33684,151712903,152106119,162924
1,ENSG00000162407.8,56579563,1-56548660-C-G,rs76294340,-1,C,G,56548660,30903,56382955,56776171,165705
1,ENSG00000162407.8,56579563,1-56548660-C-T,rs76294340,-1,C,T,56548660,30903,56382955,56776171,165705
1,ENSG00000198860.7,184051730,1-184046529-G-T,rs765224,1,G,T,184046529,5201,183855122,184248338,191407
1,ENSG00000198860.7,184051730,1-184046529-G-A,rs765224,1,G,A,184046529,5201,183855122,184248338,191407
1,ENSG00000189409.7,1632173,1-1760401-G-C,rs76601697,1,G,C,1760401,128228,1435565,1828781,324836
1,ENSG00000189409.7,1632173,1-1760401-G-A,rs76601697,1,G,A,1760401,128228,1435565,1828781,324836
1,ENSG00000142623.8,17205128,1-17115232-C-T,rs77590217,1,C,T,17115232,89896,17008520,17401736,106712
1,ENSG00000133055.4,203175826,1-203220529-A-C,rs78014816,-1,A,C,203220529,44703,202979218,203372434,241311
1,ENSG00000133055.4,203175826,1-203220529-A-G,rs78014816,-1,A,G,203220529,44703,202979218,203372434,241311
1,ENSG00000171621.9,9292894,1-9328012-A-G,rs78237381,1,A,G,9328012,35118,9096286,9489502,231726
1,ENSG00000116981.3,39672107,1-39694476-A-C,rs784192,-1,A,C,39694476,22369,39475499,39868715,218977
1,ENSG00000143554.9,153775407,1-153844304-A-G,rs78571619,1,A,G,153844304,68897,153578799,153972015,265505
1,ENSG00000116903.6,231337852,1-231202387-A-G,rs78593768,-1,A,G,231202387,135465,231141244,231534460,61143
1,ENSG00000143226.8,161505457,1-161589930-G-A,rs78603008,1,G,A,161589930,84473,161308849,161702065,281081
1,ENSG00000158161.11,28088610,1-28224028-G-A,rs78730774,-1,G,A,28224028,135418,27892002,28285218,332026
1,ENSG00000158161.11,28088610,1-28224028-G-T,rs78730774,-1,G,T,28224028,135418,27892002,28285218,332026
1,ENSG00000143771.7,224356879,1-224161395-G-A,rs78789927,1,G,A,224161395,195484,224160271,224553487,1124
1,ENSG00000117318.8,23559501,1-23402730-C-A,rs78814315,-1,C,A,23402730,156771,23362893,23756109,39837
1,ENSG00000117318.8,23559501,1-23402730-C-T,rs78814315,-1,C,T,23402730,156771,23362893,23756109,39837
1,ENSG00000158864.7,161202367,1-161206729-G-A,rs79181095,1,G,A,161206729,4362,161005759,161398975,200970
1,ENSG00000058085.9,183186264,1-183029118-G-A,rs79348617,1,G,A,183029118,157146,182989656,183382872,39462
1,ENSG00000253368.2,26993692,1-27124715-G-A,rs79540541,1,G,A,27124715,131023,26797084,27190300,327631
1,ENSG00000175793.9,26863149,1-26758084-A-G,rs79569112,1,A,G,26758084,105065,26666541,27059757,91543
1,ENSG00000116497.13,32817653,1-32788275-T-C,rs796772,1,T,C,32788275,29378,32621045,33014261,167230
1,ENSG00000186197.7,236394286,1-236255310-C-T,rs79779531,1,C,T,236255310,138976,236197678,236590894,57632
1,ENSG00000160685.9,155002802,1-154863968-C-A,rs79810698,1,C,A,154863968,138834,154806194,155199410,57774
1,ENSG00000118217.5,161766320,1-161827731-A-T,rs80318381,1,A,T,161827731,61411,161569712,161962928,258019
1,ENSG00000118217.5,161766320,1-161827731-A-G,rs80318381,1,A,G,161827731,61411,161569712,161962928,258019
1,ENSG00000143033.11,93079283,1-93045830-T-G,rs808833,1,T,G,93045830,33453,92882675,93275891,163155
1,ENSG00000143033.11,93079283,1-93045830-T-A,rs808833,1,T,A,93045830,33453,92882675,93275891,163155
1,ENSG00000143033.11,93079283,1-93045830-T-C,rs808833,1,T,C,93045830,33453,92882675,93275891,163155
1,ENSG00000117395.5,43172290,1-43030862-A-C,rs841411,-1,A,C,43030862,141428,42975682,43368898,55180
1,ENSG00000117395.5,43172290,1-43030862-A-T,rs841411,-1,A,T,43030862,141428,42975682,43368898,55180
1,ENSG00000117395.5,43172290,1-43030862-A-G,rs841411,-1,A,G,43030862,141428,42975682,43368898,55180
1,ENSG00000173641.12,16018043,1-15958847-G-A,rs848194,-1,G,A,15958847,59196,15821435,16214651,137412
1,ENSG00000116809.6,15976101,1-15960027-A-G,rs848195,-1,A,G,15960027,16074,15779493,16172709,180534
1,ENSG00000130770.12,28236124,1-28237741-A-C,rs8559,1,A,C,28237741,1617,28039516,28432732,198225
1,ENSG00000130770.12,28236124,1-28237741-A-G,rs8559,1,A,G,28237741,1617,28039516,28432732,198225
1,ENSG00000135845.4,172444069,1-172333404-C-T,rs911713,-1,C,T,172333404,110665,172247461,172640677,85943
1,ENSG00000135845.4,172444069,1-172333404-C-A,rs911713,-1,C,A,172333404,110665,172247461,172640677,85943
1,ENSG00000117335.13,207752054,1-207853632-T-A,rs926631,1,T,A,207853632,101578,207555446,207948662,298186
1,ENSG00000117335.13,207752054,1-207853632-T-C,rs926631,1,T,C,207853632,101578,207555446,207948662,298186
1,ENSG00000203965.7,63523525,1-63339458-T-C,rs932747,1,T,C,63339458,184067,63326917,63720133,12541
1,ENSG00000135778.6,232950611,1-232935887-G-A,rs9424507,1,G,A,232935887,14724,232754003,233147219,181884
1,ENSG00000196754.5,153565844,1-153746270-G-C,rs9426902,-1,G,C,153746270,180426,153369236,153762452,377034
1,ENSG00000196754.5,153565844,1-153746270-G-T,rs9426902,-1,G,T,153746270,180426,153369236,153762452,377034
1,ENSG00000196754.5,153565844,1-153746270-G-A,rs9426902,-1,G,A,153746270,180426,153369236,153762452,377034
1,ENSG00000181873.8,228165804,1-228141042-T-A,rs947086,1,T,A,228141042,24762,227969196,228362412,171846
1,ENSG00000181873.8,228165804,1-228141042-T-C,rs947086,1,T,C,228141042,24762,227969196,228362412,171846
1,ENSG00000198821.6,167518529,1-167433975-G-A,rs952963,-1,G,A,167433975,84554,167321921,167715137,112054
1,ENSG00000198821.6,167518529,1-167433975-G-C,rs952963,-1,G,C,167433975,84554,167321921,167715137,112054
1,ENSG00000163393.8,115976513,1-115908792-T-G,rs958690,1,T,G,115908792,67721,115779905,116173121,128887
1,ENSG00000163393.8,115976513,1-115908792-T-A,rs958690,1,T,A,115908792,67721,115779905,116173121,128887
1,ENSG00000064886.8,111227713,1-111235846-G-A,rs961364,1,G,A,111235846,8133,111031105,111424321,204741
1,ENSG00000154342.4,228006998,1-228006156-G-T,rs964941,1,G,T,228006156,842,227810390,228203606,195766
1,ENSG00000154342.4,228006998,1-228006156-G-A,rs964941,1,G,A,228006156,842,227810390,228203606,195766
1,ENSG00000214114.4,38873348,1-38946430-C-G,rs9659976,-1,C,G,38946430,73082,38676740,39069956,269690
1,ENSG00000214114.4,38873348,1-38946430-C-T,rs9659976,-1,C,T,38946430,73082,38676740,39069956,269690
1,ENSG00000214114.4,38873348,1-38946430-C-A,rs9659976,-1,C,A,38946430,73082,38676740,39069956,269690
1,ENSG00000174529.6,205084460,1-205280322-A-G,rs9660992,-1,A,G,205280322,195862,204887852,205281068,392470
1,ENSG00000174529.6,205084460,1-205280322-A-T,rs9660992,-1,A,T,205280322,195862,204887852,205281068,392470
1,ENSG00000117155.10,84690461,1-84810967-T-C,rs9729377,-1,T,C,84810967,120506,84493853,84887069,317114
1,ENSG00000036549.8,77682658,1-77502671-A-G,rs9787060,-1,A,G,77502671,179987,77486050,77879266,16621
1,ENSG00000117481.5,46340807,1-46256717-A-T,rs9793263,1,A,T,46256717,84090,46144199,46537415,112518
1,ENSG00000117481.5,46340807,1-46256717-A-G,rs9793263,1,A,G,46256717,84090,46144199,46537415,112518
1,ENSG00000116711.7,186828949,1-186828347-C-A,rs979924,1,C,A,186828347,602,186632341,187025557,196006
1,ENSG00000116711.7,186828949,1-186828347-C-T,rs979924,1,C,T,186828347,602,186632341,187025557,196006
1,ENSG00000116711.7,186828949,1-186828347-C-G,rs979924,1,C,G,186828347,602,186632341,187025557,196006
1,ENSG00000117013.10,40783787,1-40805265-A-G,rs9970508,1,A,G,40805265,21478,40587179,40980395,218086
1,ENSG00000171680.14,6491667,1-6482270-T-C,rs1002966,-1,T,C,6482270,9397,6295059,6688275,187211
1,ENSG00000171680.14,6491667,1-6482270-T-G,rs1002966,-1,T,G,6482270,9397,6295059,6688275,187211
1,ENSG00000118292.4,150272790,1-150238804-T-C,rs10157434,1,T,C,150238804,33986,150076182,150469398,162622
1,ENSG00000213085.5,159900165,1-159831284-A-G,rs10158752,-1,A,G,159831284,68881,159703557,160096773,127727
1,ENSG00000143167.7,167090377,1-167229299-A-G,rs1021621,-1,A,G,167229299,138922,166893769,167286985,335530
1,ENSG00000198892.6,201888898,1-201821142-A-T,rs1022361,1,A,T,201821142,67756,201692290,202085506,128852
1,ENSG00000198892.6,201888898,1-201821142-A-G,rs1022361,1,A,G,201821142,67756,201692290,202085506,128852
1,ENSG00000162643.8,85062327,1-85020085-T-C,rs10443172,1,T,C,85020085,42242,84865719,85258935,154366
1,ENSG00000203666.8,244969682,1-245087718-G-A,rs1047707,1,G,A,245087718,118036,244773074,245166290,314644
1,ENSG00000203666.8,244969682,1-245087718-G-T,rs1047707,1,G,T,245087718,118036,244773074,245166290,314644
1,ENSG00000085998.9,46198434,1-46341925-G-A,rs10489770,-1,G,A,46341925,143491,46001826,46395042,340099
1,ENSG00000085998.9,46198434,1-46341925-G-T,rs10489770,-1,G,T,46341925,143491,46001826,46395042,340099
1,ENSG00000117174.6,85708433,1-85569181-T-C,rs10493770,-1,T,C,85569181,139252,85511825,85905041,57356
1,ENSG00000197147.6,89524829,1-89504604-T-A,rs10493826,1,T,A,89504604,20225,89328221,89721437,176383
1,ENSG00000197147.6,89524829,1-89504604-T-C,rs10493826,1,T,C,89504604,20225,89328221,89721437,176383
1,ENSG00000156171.9,111140093,1-111254763-C-T,rs10494130,-1,C,T,111254763,114670,110943485,111336701,311278
1,ENSG00000156171.9,111140093,1-111254763-C-G,rs10494130,-1,C,G,111254763,114670,110943485,111336701,311278
1,ENSG00000067704.8,220094132,1-220237104-A-T,rs10495145,1,A,T,220237104,142972,219897524,220290740,339580
1,ENSG00000153898.8,84997113,1-85021837-G-A,rs10518327,-1,G,A,85021837,24724,84800505,85193721,221332
1,ENSG00000082512.10,211326833,1-211432355-G-A,rs1055565,1,G,A,211432355,105522,211130225,211523441,302130
1,ENSG00000082512.10,211326833,1-211432355-G-C,rs1055565,1,G,C,211432355,105522,211130225,211523441,302130
1,ENSG00000116497.13,32817653,1-32995270-C-G,rs10737365,1,C,G,32995270,177617,32621045,33014261,374225
1,ENSG00000116497.13,32817653,1-32995270-C-A,rs10737365,1,C,A,32995270,177617,32621045,33014261,374225
1,ENSG00000163435.10,202010587,1-201993196-T-A,rs10737576,1,T,A,201993196,17391,201813979,202207195,179217
1,ENSG00000163435.10,202010587,1-201993196-T-G,rs10737576,1,T,G,201993196,17391,201813979,202207195,179217
1,ENSG00000163435.10,202010587,1-201993196-T-C,rs10737576,1,T,C,201993196,17391,201813979,202207195,179217
1,ENSG00000117281.10,145719499,1-145777371-T-A,rs10752832,1,T,A,145777371,57872,145522891,145916107,254480
1,ENSG00000117281.10,145719499,1-145777371-T-G,rs10752832,1,T,G,145777371,57872,145522891,145916107,254480
1,ENSG00000117281.10,145719499,1-145777371-T-C,rs10752832,1,T,C,145777371,57872,145522891,145916107,254480
1,ENSG00000162600.6,58546726,1-58655364-A-C,rs10789069,-1,A,C,58655364,108638,58350118,58743334,305246
1,ENSG00000162600.6,58546726,1-58655364-A-T,rs10789069,-1,A,T,58655364,108638,58350118,58743334,305246
1,ENSG00000117448.9,45550826,1-45506087-T-C,rs10789465,1,T,C,45506087,44739,45354218,45747434,151869
1,ENSG00000117448.9,45550826,1-45506087-T-A,rs10789465,1,T,A,45506087,44739,45354218,45747434,151869
1,ENSG00000142684.7,26169908,1-26156065-T-C,rs10794522,1,T,C,26156065,13843,25973300,26366516,182765
1,ENSG00000142684.7,26169908,1-26156065-T-A,rs10794522,1,T,A,26156065,13843,25973300,26366516,182765
1,ENSG00000142684.7,26169908,1-26156065-T-G,rs10794522,1,T,G,26156065,13843,25973300,26366516,182765
1,ENSG00000158828.5,20633458,1-20664412-G-A,rs10799659,1,G,A,20664412,30954,20436850,20830066,227562
1,ENSG00000162702.5,200410036,1-200249853-T-C,rs10800686,-1,T,C,200249853,160183,200213428,200606644,36425
1,ENSG00000162630.5,193186613,1-193284030-G-A,rs10801192,-1,G,A,193284030,97417,192990005,193383221,294025
1,ENSG00000162630.5,193186613,1-193284030-G-T,rs10801192,-1,G,T,193284030,97417,192990005,193383221,294025
1,ENSG00000177551.5,115841126,1-115661243-A-C,rs10801911,-1,A,C,115661243,179883,115644518,116037734,16725
1,ENSG00000177551.5,115841126,1-115661243-A-G,rs10801911,-1,A,G,115661243,179883,115644518,116037734,16725
1,ENSG00000186197.7,236394286,1-236394112-T-G,rs10802533,1,T,G,236394112,174,236197678,236590894,196434
1,ENSG00000186197.7,236394286,1-236394112-T-C,rs10802533,1,T,C,236394112,174,236197678,236590894,196434
1,ENSG00000153936.11,86914635,1-86980595-C-A,rs10873807,1,C,A,86980595,65960,86718027,87111243,262568
1,ENSG00000153936.11,86914635,1-86980595-C-T,rs10873807,1,C,T,86980595,65960,86718027,87111243,262568
1,ENSG00000153936.11,86914635,1-86980595-C-G,rs10873807,1,C,G,86980595,65960,86718027,87111243,262568
1,ENSG00000117543.13,101025784,1-101121263-G-A,rs10875350,-1,G,A,101121263,95479,100829176,101222392,292087
1,ENSG00000117543.13,101025784,1-101121263-G-C,rs10875350,-1,G,C,101121263,95479,100829176,101222392,292087
1,ENSG00000163545.7,205321745,1-205435750-T-A,rs10900490,-1,T,A,205435750,114005,205125137,205518353,310613
1,ENSG00000163545.7,205321745,1-205435750-T-C,rs10900490,-1,T,C,205435750,114005,205125137,205518353,310613
1,ENSG00000163545.7,205321745,1-205435750-T-G,rs10900490,-1,T,G,205435750,114005,205125137,205518353,310613
1,ENSG00000157916.12,2391841,1-2244599-C-A,rs10910034,1,C,A,2244599,147242,2195233,2588449,49366
1,ENSG00000157916.12,2391841,1-2244599-C-T,rs10910034,1,C,T,2244599,147242,2195233,2588449,49366
1,ENSG00000157916.12,2391841,1-2244599-C-G,rs10910034,1,C,G,2244599,147242,2195233,2588449,49366
1,ENSG00000135829.11,182839347,1-182958550-T-C,rs10911167,1,T,C,182958550,119203,182642739,183035955,315811
1,ENSG00000135829.11,182839347,1-182958550-T-G,rs10911167,1,T,G,182958550,119203,182642739,183035955,315811
1,ENSG00000116690.7,186296279,1-186104049-C-G,rs10911820,1,C,G,186104049,192230,186099671,186492887,4378
1,ENSG00000116690.7,186296279,1-186104049-C-A,rs10911820,1,C,A,186104049,192230,186099671,186492887,4378
1,ENSG00000116690.7,186296279,1-186104049-C-T,rs10911820,1,C,T,186104049,192230,186099671,186492887,4378
1,ENSG00000116514.11,32964809,1-32833221-T-G,rs10914625,-1,T,G,32833221,131588,32768201,33161417,65020
1,ENSG00000160094.9,33256492,1-33283426-G-A,rs10914677,1,G,A,33283426,26934,33059884,33453100,223542
1,ENSG00000163041.5,226062716,1-226091349-G-A,rs10915933,1,G,A,226091349,28633,225866108,226259324,225241
1,ENSG00000185155.6,226223664,1-226173584-G-A,rs10915954,1,G,A,226173584,50080,226027056,226420272,146528
1,ENSG00000185155.6,226223664,1-226173584-G-C,rs10915954,1,G,C,226173584,50080,226027056,226420272,146528
1,ENSG00000162542.8,19799916,1-19756356-A-G,rs10917532,-1,A,G,19756356,43560,19603308,19996524,153048
1,ENSG00000162542.8,19799916,1-19756356-A-T,rs10917532,-1,A,T,19756356,43560,19603308,19996524,153048
1,ENSG00000143195.7,166975540,1-166827047-C-G,rs10918584,-1,C,G,166827047,148493,166778932,167172148,48115
1,ENSG00000143153.7,169106690,1-169073343-G-C,rs10919053,1,G,C,169073343,33347,168910082,169303298,163261
1,ENSG00000117228.8,89065208,1-89035109-G-C,rs10922552,-1,G,C,89035109,30099,88868600,89261816,166509
1,ENSG00000117228.8,89065208,1-89035109-G-A,rs10922552,-1,G,A,89035109,30099,88868600,89261816,166509
1,ENSG00000117228.8,89065208,1-89035109-G-T,rs10922552,-1,G,T,89035109,30099,88868600,89261816,166509
1,ENSG00000117226.7,89022866,1-89035109-G-C,rs10922552,-1,G,C,89035109,12243,88826258,89219474,208851
1,ENSG00000117226.7,89022866,1-89035109-G-A,rs10922552,-1,G,A,89035109,12243,88826258,89219474,208851
1,ENSG00000117226.7,89022866,1-89035109-G-T,rs10922552,-1,G,T,89035109,12243,88826258,89219474,208851
1,ENSG00000185420.13,246507279,1-246517814-G-A,rs10924763,-1,G,A,246517814,10535,246310671,246703887,207143
1,ENSG00000162636.10,108560100,1-108713513-T-C,rs11102279,1,T,C,108713513,153413,108363492,108756708,350021
1,ENSG00000162419.7,28668784,1-28810768-G-A,rs111261315,1,G,A,28810768,141984,28472176,28865392,338592
1,ENSG00000168509.13,146021735,1-145962300-A-G,rs111540919,-1,A,G,145962300,59435,145825127,146218343,137173
1,ENSG00000163131.5,150765778,1-150598509-T-G,rs11204675,-1,T,G,150598509,167269,150569170,150962386,29339
1,ENSG00000162373.7,48776891,1-48743085-C-G,rs11205534,-1,C,G,48743085,33806,48580283,48973499,162802
1,ENSG00000162373.7,48776891,1-48743085-C-A,rs11205534,-1,C,A,48743085,33806,48580283,48973499,162802
1,ENSG00000116157.5,52602371,1-52638216-G-T,rs11205985,1,G,T,52638216,35845,52405763,52798979,232453
1,ENSG00000116157.5,52602371,1-52638216-G-A,rs11205985,1,G,A,52638216,35845,52405763,52798979,232453
1,ENSG00000066185.8,42456022,1-42480043-T-G,rs11210651,-1,T,G,42480043,24021,42259414,42652630,220629
1,ENSG00000159479.12,43389800,1-43454329-G-A,rs11210843,-1,G,A,43454329,64529,43193192,43586408,261137
1,ENSG00000126106.9,44674481,1-44657463-C-G,rs11211021,-1,C,G,44657463,17018,44477873,44871089,179590
1,ENSG00000126106.9,44674481,1-44657463-C-A,rs11211021,-1,C,A,44657463,17018,44477873,44871089,179590
1,ENSG00000117640.13,25819954,1-25795606-G-T,rs11247709,1,G,T,25795606,24348,25623346,26016562,172260
1,ENSG00000117640.13,25819954,1-25795606-G-A,rs11247709,1,G,A,25795606,24348,25623346,26016562,172260
1,ENSG00000117640.13,25819954,1-25795606-G-C,rs11247709,1,G,C,25795606,24348,25623346,26016562,172260
1,ENSG00000130695.8,26234200,1-26329016-C-A,rs11247917,1,C,A,26329016,94816,26037592,26430808,291424
1,ENSG00000224051.2,1324802,1-1174845-C-A,rs11260544,1,C,A,1174845,149957,1128194,1521410,46651
1,ENSG00000224051.2,1324802,1-1174845-C-T,rs11260544,1,C,T,1174845,149957,1128194,1521410,46651
1,ENSG00000127054.12,1324660,1-1194826-G-C,rs11260556,-1,G,C,1194826,129834,1128052,1521268,66774
1,ENSG00000127054.12,1324660,1-1194826-G-T,rs11260556,-1,G,T,1194826,129834,1128052,1521268,66774
1,ENSG00000127054.12,1324660,1-1194826-G-A,rs11260556,-1,G,A,1194826,129834,1128052,1521268,66774
1,ENSG00000187144.7,16437424,1-16342438-T-A,rs11260732,-1,T,A,16342438,94986,16240816,16634032,101622
1,ENSG00000187144.7,16437424,1-16342438-T-C,rs11260732,-1,T,C,16342438,94986,16240816,16634032,101622
1,ENSG00000134697.6,37595937,1-37552935-G-A,rs11264072,-1,G,A,37552935,43002,37399329,37792545,153606
1,ENSG00000134697.6,37595937,1-37552935-G-C,rs11264072,-1,G,C,37552935,43002,37399329,37792545,153606
1,ENSG00000158714.6,159826873,1-159802961-G-A,rs11265281,1,G,A,159802961,23912,159630265,160023481,172696
1,ENSG00000162736.10,160343383,1-160407645-C-G,rs11265388,1,C,G,160407645,64262,160146775,160539991,260870
1,ENSG00000162736.10,160343383,1-160407645-C-T,rs11265388,1,C,T,160407645,64262,160146775,160539991,260870
1,ENSG00000158769.11,161021152,1-161077430-T-C,rs11265548,-1,T,C,161077430,56278,160824544,161217760,252886
1,ENSG00000160716.4,154567778,1-154385202-A-G,rs11265607,1,A,G,154385202,182576,154371170,154764386,14032
1,ENSG00000134184.7,109687817,1-109707875-G-T,rs112697537,1,G,T,109707875,20058,109491209,109884425,216666
1,ENSG00000134184.7,109687817,1-109707875-G-C,rs112697537,1,G,C,109707875,20058,109491209,109884425,216666
1,ENSG00000134184.7,109687817,1-109707875-G-A,rs112697537,1,G,A,109707875,20058,109491209,109884425,216666
1,ENSG00000023902.8,150149916,1-150153170-A-G,rs114052060,1,A,G,150153170,3254,149953308,150346524,199862
1,ENSG00000023902.8,150149916,1-150153170-A-C,rs114052060,1,A,C,150153170,3254,149953308,150346524,199862
1,ENSG00000132680.6,155934413,1-156108823-A-G,rs114103760,-1,A,G,156108823,174410,155737805,156131021,371018
1,ENSG00000188672.10,25420825,1-25381201-C-T,rs114311594,-1,C,T,25381201,39624,25224217,25617433,156984
1,ENSG00000188672.10,25420825,1-25381201-C-A,rs114311594,-1,C,A,25381201,39624,25224217,25617433,156984
1,ENSG00000177151.3,248645278,1-248802797-T-C,rs114515061,-1,T,C,248802797,157519,248448670,248841886,354127
1,ENSG00000057468.6,75796882,1-75799103-T-C,rs1146644,1,T,C,75799103,2221,75600274,75993490,198829
1,ENSG00000157216.10,54406419,1-54403352-C-G,rs114707444,-1,C,G,54403352,3067,54209811,54603027,193541
1,ENSG00000157216.10,54406419,1-54403352-C-T,rs114707444,-1,C,T,54403352,3067,54209811,54603027,193541
1,ENSG00000137942.10,93448118,1-93482476-G-T,rs114730474,1,G,T,93482476,34358,93251510,93644726,230966
1,ENSG00000187608.5,1013497,1-1180224-C-T,rs115023808,1,C,T,1180224,166727,816889,1210105,363335
1,ENSG00000187608.5,1013497,1-1180224-C-A,rs115023808,1,C,A,1180224,166727,816889,1210105,363335
1,ENSG00000203811.1,149841208,1-149926400-A-G,rs115070660,-1,A,G,149926400,85192,149644600,150037816,281800
1,ENSG00000203852.3,149852608,1-149926400-A-G,rs115070660,1,A,G,149926400,73792,149656000,150049216,270400
1,ENSG00000117000.6,40161387,1-39965929-C-T,rs115104693,1,C,T,39965929,195458,39964779,40357995,1150
1,ENSG00000241794.1,153057512,1-153141417-G-A,rs115264490,-1,G,A,153141417,83905,152860904,153254120,280513
1,ENSG00000188641.8,97921034,1-97745060-T-C,rs115413182,-1,T,C,97745060,175974,97724426,98117642,20634
1,ENSG00000188641.8,97921034,1-97745060-T-A,rs115413182,-1,T,A,97745060,175974,97724426,98117642,20634
1,ENSG00000116903.6,231337852,1-231166664-G-T,rs115461650,-1,G,T,231166664,171188,231141244,231534460,25420
1,ENSG00000134709.6,59814949,1-59899782-A-G,rs11572311,1,A,G,59899782,84833,59618341,60011557,281441
1,ENSG00000163875.11,37514766,1-37560999-C-T,rs11577094,-1,C,T,37560999,46233,37318158,37711374,242841
1,ENSG00000066322.7,43368011,1-43527222-A-T,rs11577317,-1,A,T,43527222,159211,43171403,43564619,355819
1,ENSG00000066322.7,43368011,1-43527222-A-C,rs11577317,-1,A,C,43527222,159211,43171403,43564619,355819
1,ENSG00000066322.7,43368011,1-43527222-A-G,rs11577317,-1,A,G,43527222,159211,43171403,43564619,355819
1,ENSG00000162946.14,231626790,1-231630717-C-T,rs11577625,1,C,T,231630717,3927,231430182,231823398,200535
1,ENSG00000143368.9,149927803,1-150029763-G-T,rs11578204,-1,G,T,150029763,101960,149731195,150124411,298568
1,ENSG00000143368.9,149927803,1-150029763-G-A,rs11578204,-1,G,A,150029763,101960,149731195,150124411,298568
1,ENSG00000143368.9,149927803,1-150029763-G-C,rs11578204,-1,G,C,150029763,101960,149731195,150124411,298568
1,ENSG00000079277.14,46604268,1-46528677-T-G,rs115830566,-1,T,G,46528677,75591,46407660,46800876,121017
1,ENSG00000172339.7,95072951,1-95143460-T-G,rs11584566,-1,T,G,95143460,70509,94876343,95269559,267117
1,ENSG00000177272.7,110674940,1-110640745-G-C,rs11585237,-1,G,C,110640745,34195,110478332,110871548,162413
1,ENSG00000177272.7,110674940,1-110640745-G-T,rs11585237,-1,G,T,110640745,34195,110478332,110871548,162413
1,ENSG00000142959.4,44788170,1-44616668-G-T,rs11585508,-1,G,T,44616668,171502,44591562,44984778,25106
1,ENSG00000142959.4,44788170,1-44616668-G-A,rs11585508,-1,G,A,44616668,171502,44591562,44984778,25106
1,ENSG00000143147.10,168136930,1-168121793-C-A,rs11586522,-1,C,A,168121793,15137,167940322,168333538,181471
1,ENSG00000143147.10,168136930,1-168121793-C-T,rs11586522,-1,C,T,168121793,15137,167940322,168333538,181471
1,ENSG00000184908.12,16043782,1-16049015-G-A,rs11588392,1,G,A,16049015,5233,15847174,16240390,201841
1,ENSG00000143537.8,155051316,1-155060832-G-A,rs11589479,1,G,A,155060832,9516,154854708,155247924,206124
1,ENSG00000215912.6,2801717,1-2620461-G-A,rs11590198,-1,G,A,2620461,181256,2605109,2998325,15352
1,ENSG00000010165.13,171781660,1-171724747-C-T,rs116141391,1,C,T,171724747,56913,171585052,171978268,139695
1,ENSG00000135801.5,229626047,1-229579145-G-A,rs116265206,-1,G,A,229579145,46902,229429439,229822655,149706
1,ENSG00000181773.6,27392622,1-27290549-A-C,rs116355033,1,A,C,27290549,102073,27196014,27589230,94535
1,ENSG00000162889.6,206684905,1-206676489-G-T,rs116652536,1,G,T,206676489,8416,206488297,206881513,188192
1,ENSG00000178965.9,74673792,1-74647046-A-G,rs116787849,-1,A,G,74647046,26746,74477184,74870400,169862
1,ENSG00000178965.9,74673792,1-74647046-A-C,rs116787849,-1,A,C,74647046,26746,74477184,74870400,169862
1,ENSG00000186891.9,1206592,1-1217251-C-A,rs11721,-1,C,A,1217251,10659,1009984,1403200,207267
1,ENSG00000186891.9,1206592,1-1217251-C-G,rs11721,-1,C,G,1217251,10659,1009984,1403200,207267
1,ENSG00000186891.9,1206592,1-1217251-C-T,rs11721,-1,C,T,1217251,10659,1009984,1403200,207267
1,ENSG00000198754.4,39771348,1-39663729-G-A,rs1180271,-1,G,A,39663729,107619,39574740,39967956,88989
1,ENSG00000143155.8,168178962,1-168119873-T-A,rs11802762,1,T,A,168119873,59089,167982354,168375570,137519
1,ENSG00000204219.5,23424748,1-23429223-T-A,rs1198431,-1,T,A,23429223,4475,23228140,23621356,201083
1,ENSG00000204219.5,23424748,1-23429223-T-C,rs1198431,-1,T,C,23429223,4475,23228140,23621356,201083
1,ENSG00000116679.11,185317243,1-185182246-T-C,rs1200610,-1,T,C,185182246,134997,185120635,185513851,61611
1,ENSG00000116679.11,185317243,1-185182246-T-G,rs1200610,-1,T,G,185182246,134997,185120635,185513851,61611
1,ENSG00000162746.10,161721563,1-161739421-A-G,rs12021510,1,A,G,161739421,17858,161524955,161918171,214466
1,ENSG00000198890.5,107056674,1-106862309-G-A,rs12024651,1,G,A,106862309,194365,106860066,107253282,2243
1,ENSG00000117133.6,84479266,1-84475894-C-T,rs12031171,1,C,T,84475894,3372,84282658,84675874,193236
1,ENSG00000197959.8,171841498,1-171766058-A-C,rs12032340,1,A,C,171766058,75440,171644890,172038106,121168
1,ENSG00000091483.6,241519755,1-241605450-G-A,rs12033126,-1,G,A,241605450,85695,241323147,241716363,282303
1,ENSG00000162545.5,20486210,1-20355078-A-G,rs12034781,-1,A,G,20355078,131132,20289602,20682818,65476
1,ENSG00000158715.5,205680509,1-205501636-C-T,rs12034971,-1,C,T,205501636,178873,205483901,205877117,17735
1,ENSG00000162552.8,22143097,1-22058220-G-T,rs12035094,-1,G,T,22058220,84877,21946489,22339705,111731
1,ENSG00000117266.10,205504669,1-205573746-C-T,rs12036780,1,C,T,205573746,69077,205308061,205701277,265685
1,ENSG00000117266.10,205504669,1-205573746-C-A,rs12036780,1,C,A,205573746,69077,205308061,205701277,265685
1,ENSG00000117266.10,205504669,1-205573746-C-G,rs12036780,1,C,G,205573746,69077,205308061,205701277,265685
1,ENSG00000142875.13,84144271,1-83979083-G-A,rs12042443,1,G,A,83979083,165188,83947663,84340879,31420
1,ENSG00000160058.13,32394441,1-32510360-T-C,rs12045880,-1,T,C,32510360,115919,32197833,32591049,312527
1,ENSG00000171824.9,11099869,1-10920244-G-A,rs12046400,-1,G,A,10920244,179625,10903261,11296477,16983
1,ENSG00000130775.11,27872544,1-27879373-G-A,rs12048235,1,G,A,27879373,6829,27675936,28069152,203437
1,ENSG00000130775.11,27872544,1-27879373-G-C,rs12048235,1,G,C,27879373,6829,27675936,28069152,203437
1,ENSG00000143624.9,153728050,1-153691926-A-G,rs12057911,1,A,G,153691926,36124,153531442,153924658,160484
1,ENSG00000116237.9,6235964,1-6145289-C-G,rs12067480,-1,C,G,6145289,90675,6039356,6432572,105933
1,ENSG00000116237.9,6235964,1-6145289-C-A,rs12067480,-1,C,A,6145289,90675,6039356,6432572,105933
1,ENSG00000116237.9,6235964,1-6145289-C-T,rs12067480,-1,C,T,6145289,90675,6039356,6432572,105933
1,ENSG00000158793.9,161118105,1-161300846-C-T,rs12068890,1,C,T,161300846,182741,160921497,161314713,379349
1,ENSG00000171608.9,9651731,1-9770151-T-C,rs12068953,1,T,C,9770151,118420,9455123,9848339,315028
1,ENSG00000143179.7,165827614,1-165861856-C-T,rs12075898,1,C,T,165861856,34242,165631006,166024222,230850
1,ENSG00000143149.8,165698562,1-165682679-A-G,rs12076579,-1,A,G,165682679,15883,165501954,165895170,180725
1,ENSG00000171502.10,86156772,1-86003852-A-G,rs12079919,-1,A,G,86003852,152920,85960164,86353380,43688
1,ENSG00000171502.10,86156772,1-86003852-A-T,rs12079919,-1,A,T,86003852,152920,85960164,86353380,43688
1,ENSG00000171502.10,86156772,1-86003852-A-C,rs12079919,-1,A,C,86003852,152920,85960164,86353380,43688
1,ENSG00000143575.10,154272629,1-154326569-T-C,rs12083170,1,T,C,154326569,53940,154076021,154469237,250548
1,ENSG00000122417.9,86396342,1-86227513-A-T,rs12083520,-1,A,T,86227513,168829,86199734,86592950,27779
1,ENSG00000122417.9,86396342,1-86227513-A-C,rs12083520,-1,A,C,86227513,168829,86199734,86592950,27779
1,ENSG00000116815.11,116571026,1-116551600-T-C,rs12086220,-1,T,C,116551600,19426,116374418,116767634,177182
1,ENSG00000117222.9,205121978,1-205142722-G-A,rs12089690,-1,G,A,205142722,20744,204925370,205318586,217352
1,ENSG00000143185.3,168543997,1-168686483-A-G,rs12090370,-1,A,G,168686483,142486,168347389,168740605,339094
1,ENSG00000127124.9,41918922,1-41974087-C-T,rs12095882,-1,C,T,41974087,55165,41722314,42115530,251773
1,ENSG00000035687.8,244451909,1-244427664-C-A,rs12116865,-1,C,A,244427664,24245,244255301,244648517,172363
1,ENSG00000162849.10,245154985,1-245124206-G-A,rs12117676,1,G,A,245124206,30779,244958377,245351593,165829
1,ENSG00000153207.10,246931948,1-247054925-T-C,rs12119007,-1,T,C,247054925,122977,246735340,247128556,319585
1,ENSG00000120370.7,170532166,1-170363623-T-C,rs12120356,1,T,C,170363623,168543,170335558,170728774,28065
1,ENSG00000119280.12,230868521,1-230823931-T-A,rs12121390,-1,T,A,230823931,44590,230671913,231065129,152018
1,ENSG00000119280.12,230868521,1-230823931-T-C,rs12121390,-1,T,C,230823931,44590,230671913,231065129,152018
1,ENSG00000116922.9,37690529,1-37741370-G-A,rs12130112,-1,G,A,37741370,50841,37493921,37887137,247449
1,ENSG00000054277.8,241640369,1-241653927-C-A,rs12130136,-1,C,A,241653927,13558,241443761,241836977,210166
1,ENSG00000143631.9,152325239,1-152189630-A-G,rs12130219,-1,A,G,152189630,135609,152128631,152521847,60999
1,ENSG00000177181.9,42380792,1-42443872-T-C,rs12131762,1,T,C,42443872,63080,42184184,42577400,259688
1,ENSG00000053371.8,19312144,1-19301437-C-T,rs12132200,-1,C,T,19301437,10707,19115536,19508752,185901
1,ENSG00000235750.4,175192776,1-175314278-A-G,rs12133262,-1,A,G,175314278,121502,174996168,175389384,318110
1,ENSG00000235750.4,175192776,1-175314278-A-T,rs12133262,-1,A,T,175314278,121502,174996168,175389384,318110
1,ENSG00000142867.6,85276632,1-85272625-C-T,rs12134420,-1,C,T,85272625,4007,85080024,85473240,192601
1,ENSG00000116809.6,15976101,1-15841304-A-G,rs12135073,-1,A,G,15841304,134797,15779493,16172709,61811
1,ENSG00000143499.9,214281159,1-214156523-G-A,rs12135339,1,G,A,214156523,124636,214084551,214477767,71972
1,ENSG00000197472.9,247008057,1-247088151-A-G,rs12135374,-1,A,G,247088151,80094,246811449,247204665,276702
1,ENSG00000162894.7,206921941,1-207017819-G-A,rs12138969,-1,G,A,207017819,95878,206725333,207118549,292486
1,ENSG00000175130.6,32336233,1-32438164-T-C,rs12140302,-1,T,C,32438164,101931,32139625,32532841,298539
1,ENSG00000175130.6,32336233,1-32438164-T-A,rs12140302,-1,T,A,32438164,101931,32139625,32532841,298539
1,ENSG00000225828.1,32362485,1-32508317-G-A,rs12142700,-1,G,A,32508317,145832,32165877,32559093,342440
1,ENSG00000162391.5,54623525,1-54436910-A-C,rs12145055,-1,A,C,54436910,186615,54426917,54820133,9993
1,ENSG00000162391.5,54623525,1-54436910-A-G,rs12145055,-1,A,G,54436910,186615,54426917,54820133,9993
1,ENSG00000213625.4,65420668,1-65421330-A-G,rs12145690,1,A,G,65421330,662,65224060,65617276,197270
1,ENSG00000213625.4,65420668,1-65421330-A-C,rs12145690,1,A,C,65421330,662,65224060,65617276,197270
1,ENSG00000213625.4,65420668,1-65421330-A-T,rs12145690,1,A,T,65421330,662,65224060,65617276,197270
1,ENSG00000198799.6,113073198,1-113174848-A-G,rs1216870,1,A,G,113174848,101650,112876590,113269806,298258
1,ENSG00000168528.7,31413213,1-31521014-G-A,rs12353942,1,G,A,31521014,107801,31216605,31609821,304409
1,ENSG00000116171.11,52927276,1-52814505-G-A,rs12401320,1,G,A,52814505,112771,52730668,53123884,83837
1,ENSG00000197921.5,2530263,1-2376785-G-C,rs12404555,-1,G,C,2376785,153478,2333655,2726871,43130
1,ENSG00000090686.11,21783149,1-21682305-T-C,rs12404648,-1,T,C,21682305,100844,21586541,21979757,95764
1,ENSG00000158825.5,20589097,1-20616702-A-G,rs12404655,1,A,G,20616702,27605,20392489,20785705,224213
1,ENSG00000174307.5,201469188,1-201284988-G-T,rs1257394,-1,G,T,201284988,184200,201272580,201665796,12408
1,ENSG00000174307.5,201469188,1-201284988-G-A,rs1257394,-1,G,A,201284988,184200,201272580,201665796,12408
1,ENSG00000174307.5,201469188,1-201284988-G-C,rs1257394,-1,G,C,201284988,184200,201272580,201665796,12408
1,ENSG00000132906.12,15524215,1-15581413-C-G,rs12691551,-1,C,G,15581413,57198,15327607,15720823,253806
1,ENSG00000132906.12,15524215,1-15581413-C-T,rs12691551,-1,C,T,15581413,57198,15327607,15720823,253806
1,ENSG00000188931.3,161367876,1-161385938-T-A,rs12725465,-1,T,A,161385938,18062,161171268,161564484,214670
1,ENSG00000188931.3,161367876,1-161385938-T-C,rs12725465,-1,T,C,161385938,18062,161171268,161564484,214670
1,ENSG00000168118.7,229271111,1-229377339-C-A,rs12726176,1,C,A,229377339,106228,229074503,229467719,302836
1,ENSG00000143184.4,168576605,1-168720364-C-T,rs12733054,1,C,T,168720364,143759,168379997,168773213,340367
1,ENSG00000143033.11,93079283,1-93066402-C-T,rs12736147,1,C,T,93066402,12881,92882675,93275891,183727
1,ENSG00000160856.14,157700769,1-157668178-A-G,rs12737968,-1,A,G,157668178,32591,157504161,157897377,164017
1,ENSG00000083444.10,11934717,1-11879536-A-C,rs12741980,1,A,C,11879536,55181,11738109,12131325,141427
1,ENSG00000118217.5,161766320,1-161758211-G-T,rs12745240,1,G,T,161758211,8109,161569712,161962928,188499
1,ENSG00000118217.5,161766320,1-161758211-G-A,rs12745240,1,G,A,161758211,8109,161569712,161962928,188499
1,ENSG00000118217.5,161766320,1-161758211-G-C,rs12745240,1,G,C,161758211,8109,161569712,161962928,188499
1,ENSG00000171161.7,248838224,1-248781834-A-C,rs12749315,1,A,C,248781834,56390,248641616,249034832,140218
1,ENSG00000171161.7,248838224,1-248781834-A-G,rs12749315,1,A,G,248781834,56390,248641616,249034832,140218
1,ENSG00000171163.10,248859085,1-248781834-A-C,rs12749315,-1,A,C,248781834,77251,248662477,249055693,119357
1,ENSG00000171163.10,248859085,1-248781834-A-G,rs12749315,-1,A,G,248781834,77251,248662477,249055693,119357
1,ENSG00000177807.5,160070160,1-160164570-A-T,rs12751488,-1,A,T,160164570,94410,159873552,160266768,291018
1,ENSG00000159388.5,203305519,1-203133861-G-C,rs12757387,1,G,C,203133861,171658,203108911,203502127,24950
1,ENSG00000159388.5,203305519,1-203133861-G-T,rs12757387,1,G,T,203133861,171658,203108911,203502127,24950
1,ENSG00000116830.5,117060326,1-117113466-A-G,rs1289658,1,A,G,117113466,53140,116863718,117256934,249748
1,ENSG00000120948.10,11012654,1-10833024-A-G,rs1292657,1,A,G,10833024,179630,10816046,11209262,16978
1,ENSG00000120948.10,11012654,1-10833024-A-T,rs1292657,1,A,T,10833024,179630,10816046,11209262,16978
1,ENSG00000121957.7,108876985,1-109066619-T-C,rs13303136,1,T,C,109066619,189634,108680377,109073593,386242
1,ENSG00000116183.6,176463175,1-176453459-C-T,rs13374369,1,C,T,176453459,9716,176266567,176659783,186892
1,ENSG00000116183.6,176463175,1-176453459-C-A,rs13374369,1,C,A,176453459,9716,176266567,176659783,186892
1,ENSG00000162897.9,206970460,1-206970205-C-T,rs1340232,-1,C,T,206970205,255,206773852,207167068,196353
1,ENSG00000162897.9,206970460,1-206970205-C-G,rs1340232,-1,C,G,206970205,255,206773852,207167068,196353
1,ENSG00000116857.11,201154474,1-201140856-G-A,rs1408869,-1,G,A,201140856,13618,200957866,201351082,182990
1,ENSG00000116857.11,201154474,1-201140856-G-T,rs1408869,-1,G,T,201140856,13618,200957866,201351082,182990
1,ENSG00000169418.7,153678688,1-153581642-G-A,rs146096977,1,G,A,153581642,97046,153482080,153875296,99562
1,ENSG00000117748.5,27914575,1-27885139-T-C,rs1467464,-1,T,C,27885139,29436,27717967,28111183,167172
1,ENSG00000212916.3,232805416,1-232801993-T-A,rs1495986,1,T,A,232801993,3423,232608808,233002024,193185
1,ENSG00000212916.3,232805416,1-232801993-T-C,rs1495986,1,T,C,232801993,3423,232608808,233002024,193185
1,ENSG00000069702.6,91886151,1-91695329-T-C,rs1555890,-1,T,C,91695329,190822,91689543,92082759,5786
1,ENSG00000117592.8,173477335,1-173384742-T-C,rs1557121,1,T,C,173384742,92593,173280727,173673943,104015
1,ENSG00000117090.8,160647044,1-160620975-C-A,rs164283,-1,C,A,160620975,26069,160450436,160843652,170539
1,ENSG00000117090.8,160647044,1-160620975-C-T,rs164283,-1,C,T,160620975,26069,160450436,160843652,170539
1,ENSG00000143127.7,145910050,1-145900761-T-C,rs16826985,-1,T,C,145900761,9289,145713442,146106658,187319
1,ENSG00000174827.9,145707368,1-145868002-T-C,rs16827032,-1,T,C,145868002,160634,145510760,145903976,357242
1,ENSG00000116962.10,236065090,1-235999149-C-T,rs16833089,-1,C,T,235999149,65941,235868482,236261698,130667
1,ENSG00000163191.5,152037004,1-152050163-A-G,rs16833811,-1,A,G,152050163,13159,151840396,152233612,209767
1,ENSG00000142920.11,33081153,1-32978534-C-T,rs16835227,1,C,T,32978534,102619,32884545,33277761,93989
1,ENSG00000142920.11,33081153,1-32978534-C-A,rs16835227,1,C,A,32978534,102619,32884545,33277761,93989
1,ENSG00000132694.14,157045742,1-157098880-C-T,rs16838072,-1,C,T,157098880,53138,156849134,157242350,249746
1,ENSG00000135837.11,179954810,1-179889157-G-A,rs16854910,1,G,A,179889157,65653,179758202,180151418,130955
1,ENSG00000185842.10,224929675,1-224918097-C-T,rs16858145,1,C,T,224918097,11578,224733067,225126283,185030
1,ENSG00000159363.13,17011928,1-17094094-G-A,rs16862492,-1,G,A,17094094,82166,16815320,17208536,278774
1,ENSG00000159363.13,17011928,1-17094094-G-C,rs16862492,-1,G,C,17094094,82166,16815320,17208536,278774
1,ENSG00000163444.7,203007374,1-203024974-C-G,rs1690821,1,C,G,203024974,17600,202810766,203203982,214208
1,ENSG00000162772.12,212608761,1-212599595-T-A,rs17019438,1,T,A,212599595,9166,212412153,212805369,187442
1,ENSG00000162772.12,212608761,1-212599595-T-C,rs17019438,1,T,C,212599595,9166,212412153,212805369,187442
1,ENSG00000131697.12,5992425,1-5956601-A-G,rs17028948,-1,A,G,5956601,35824,5795817,6189033,160784
1,ENSG00000011021.17,11806191,1-11800786-G-A,rs17037390,1,G,A,11800786,5405,11609583,12002799,191203
1,ENSG00000117322.12,207454328,1-207631132-C-A,rs17048122,1,C,A,207631132,176804,207257720,207650936,373412
1,ENSG00000137959.10,78620448,1-78598087-C-T,rs17101925,1,C,T,78598087,22361,78423840,78817056,174247
1,ENSG00000162374.12,50108920,1-50203286-T-C,rs17106016,1,T,C,50203286,94366,49912312,50305528,290974
1,ENSG00000184588.13,65792895,1-65866371-G-A,rs17128076,1,G,A,65866371,73476,65596287,65989503,270084
1,ENSG00000162594.9,67166454,1-67320405-A-G,rs17129772,1,A,G,67320405,153951,66969846,67363062,350559
1,ENSG00000081985.6,67307873,1-67320405-A-G,rs17129772,1,A,G,67320405,12532,67111265,67504481,209140
1,ENSG00000116353.8,29230934,1-29278260-T-C,rs17262440,-1,T,C,29278260,47326,29034326,29427542,243934
1,ENSG00000088035.8,63367627,1-63438990-G-A,rs17319555,1,G,A,63438990,71363,63171019,63564235,267971
1,ENSG00000135842.12,184974508,1-185071326-T-C,rs17379801,-1,T,C,185071326,96818,184777900,185171116,293426
1,ENSG00000169598.10,3857476,1-3703616-A-T,rs17379833,1,A,T,3703616,153860,3660868,4054084,42748
1,ENSG00000117597.12,209827972,1-209813827-A-G,rs17389541,1,A,G,209813827,14145,209631364,210024580,182463
1,ENSG00000178028.8,44213471,1-44157756-C-T,rs17414232,1,C,T,44157756,55715,44016863,44410079,140893
1,ENSG00000122435.5,100133163,1-100077965-T-C,rs17417834,1,T,C,100077965,55198,99936555,100329771,141410
1,ENSG00000162551.9,21509423,1-21557249-G-A,rs17421553,1,G,A,21557249,47826,21312815,21706031,244434
1,ENSG00000162551.9,21509423,1-21557249-G-T,rs17421553,1,G,T,21557249,47826,21312815,21706031,244434
1,ENSG00000158315.6,38941830,1-38779825-T-C,rs17485749,-1,T,C,38779825,162005,38745222,39138438,34603
1,ENSG00000117479.7,169485944,1-169482852-G-A,rs17518769,-1,G,A,169482852,3092,169289336,169682552,193516
1,ENSG00000086619.9,236281958,1-236176778-G-A,rs17563158,-1,G,A,236176778,105180,236085350,236478566,91428
1,ENSG00000086619.9,236281958,1-236176778-G-T,rs17563158,-1,G,T,236176778,105180,236085350,236478566,91428
1,ENSG00000086619.9,236281958,1-236176778-G-C,rs17563158,-1,G,C,236176778,105180,236085350,236478566,91428
1,ENSG00000162620.10,74198176,1-74010285-A-G,rs17588367,-1,A,G,74010285,187891,74001568,74394784,8717
1,ENSG00000185523.6,212847649,1-212668256-C-T,rs17674590,-1,C,T,212668256,179393,212651041,213044257,17215
1,ENSG00000215784.4,145095974,1-144987890-G-T,rs188201980,1,G,T,144987890,108084,144899366,145292582,88524
1,ENSG00000171517.5,84893206,1-84888880-G-A,rs1886647,-1,G,A,84888880,4326,84696598,85089814,192282
1,ENSG00000171517.5,84893206,1-84888880-G-C,rs1886647,-1,G,C,84888880,4326,84696598,85089814,192282
1,ENSG00000085552.11,159945613,1-160011515-G-T,rs1890530,-1,G,T,160011515,65902,159749005,160142221,262510
1,ENSG00000085552.11,159945613,1-160011515-G-C,rs1890530,-1,G,C,160011515,65902,159749005,160142221,262510
1,ENSG00000132122.6,48472204,1-48606963-T-C,rs191189,-1,T,C,48606963,134759,48275596,48668812,331367
1,ENSG00000132122.6,48472204,1-48606963-T-A,rs191189,-1,T,A,48606963,134759,48275596,48668812,331367
1,ENSG00000162437.10,64745095,1-64676312-C-T,rs1926306,1,C,T,64676312,68783,64548487,64941703,127825
1,ENSG00000162437.10,64745095,1-64676312-C-A,rs1926306,1,C,A,64676312,68783,64548487,64941703,127825
1,ENSG00000162437.10,64745095,1-64676312-C-G,rs1926306,1,C,G,64676312,68783,64548487,64941703,127825
1,ENSG00000155761.9,118185228,1-118074651-C-A,rs1935993,-1,C,A,118074651,110577,117988620,118381836,86031
1,ENSG00000155761.9,118185228,1-118074651-C-T,rs1935993,-1,C,T,118074651,110577,117988620,118381836,86031
1,ENSG00000090104.6,192575773,1-192385026-A-T,rs1936711,1,A,T,192385026,190747,192379165,192772381,5861
1,ENSG00000162664.10,89995110,1-89999581-T-G,rs1938035,1,T,G,89999581,4471,89798502,90191718,201079
1,ENSG00000162664.10,89995110,1-89999581-T-A,rs1938035,1,T,A,89999581,4471,89798502,90191718,201079
1,ENSG00000162664.10,89995110,1-89999581-T-C,rs1938035,1,T,C,89999581,4471,89798502,90191718,201079
1,ENSG00000196734.5,152811971,1-152752340-T-C,rs1953057,1,T,C,152752340,59631,152615363,153008579,136977
1,ENSG00000175206.6,11847783,1-11841535-T-C,rs198415,-1,T,C,11841535,6248,11651175,12044391,190360
1,ENSG00000160781.9,156248056,1-156344313-T-G,rs2025577,-1,T,G,156344313,96257,156051448,156444664,292865
1,ENSG00000160781.9,156248056,1-156344313-T-A,rs2025577,-1,T,A,156344313,96257,156051448,156444664,292865
1,ENSG00000160781.9,156248056,1-156344313-T-C,rs2025577,-1,T,C,156344313,96257,156051448,156444664,292865
1,ENSG00000162396.5,54764523,1-54761907-A-T,rs2057939,-1,A,T,54761907,2616,54567915,54961131,193992
1,ENSG00000162396.5,54764523,1-54761907-A-G,rs2057939,-1,A,G,54761907,2616,54567915,54961131,193992
1,ENSG00000132485.8,71081035,1-71202198-G-A,rs2066371,-1,G,A,71202198,121163,70884427,71277643,317771
1,ENSG00000160714.5,154558662,1-154576404-G-A,rs2072661,-1,G,A,154576404,17742,154362054,154755270,214350
1,ENSG00000215910.3,11762193,1-11837701-G-C,rs2075539,1,G,C,11837701,75508,11565585,11958801,272116
1,ENSG00000215910.3,11762193,1-11837701-G-A,rs2075539,1,G,A,11837701,75508,11565585,11958801,272116
1,ENSG00000143228.8,163321954,1-163332999-T-C,rs2136243,1,T,C,163332999,11045,163125346,163518562,207653
1,ENSG00000143228.8,163321954,1-163332999-T-A,rs2136243,1,T,A,163332999,11045,163125346,163518562,207653
1,ENSG00000162909.12,223712539,1-223712842-A-T,rs2230083,1,A,T,223712842,303,223515931,223909147,196911
1,ENSG00000162909.12,223712539,1-223712842-A-G,rs2230083,1,A,G,223712842,303,223515931,223909147,196911
1,ENSG00000084070.6,40373727,1-40417460-A-G,rs2235702,1,A,G,40417460,43733,40177119,40570335,240341
1,ENSG00000173171.9,155208695,1-155023027-G-A,rs2242193,1,G,A,155023027,185668,155012087,155405303,10940
1,ENSG00000173171.9,155208695,1-155023027-G-C,rs2242193,1,G,C,155023027,185668,155012087,155405303,10940
1,ENSG00000173641.12,16018043,1-15948752-C-A,rs2268341,-1,C,A,15948752,69291,15821435,16214651,127317
1,ENSG00000173641.12,16018043,1-15948752-C-T,rs2268341,-1,C,T,15948752,69291,15821435,16214651,127317
1,ENSG00000049247.8,7853065,1-7898027-A-G,rs227157,-1,A,G,7898027,44962,7656457,8049673,241570
1,ENSG00000116285.8,8026309,1-7898027-A-G,rs227157,-1,A,G,7898027,128282,7829701,8222917,68326
1,ENSG00000142910.9,31576515,1-31626924-A-G,rs2271933,1,A,G,31626924,50409,31379907,31773123,247017
1,ENSG00000064886.8,111227713,1-111230978-A-C,rs2274232,1,A,C,111230978,3265,111031105,111424321,199873
1,ENSG00000064886.8,111227713,1-111230978-A-G,rs2274232,1,A,G,111230978,3265,111031105,111424321,199873
1,ENSG00000143333.6,182604389,1-182589381-A-G,rs2274509,-1,A,G,182589381,15008,182407781,182800997,181600
1,ENSG00000134202.6,109741038,1-109751955-A-G,rs2274536,-1,A,G,109751955,10917,109544430,109937646,207525
1,ENSG00000132185.12,161707229,1-161711990-A-G,rs2275603,1,A,G,161711990,4761,161510621,161903837,201369
1,ENSG00000132185.12,161707229,1-161711990-A-T,rs2275603,1,A,T,161711990,4761,161510621,161903837,201369
1,ENSG00000117362.8,150269016,1-150268830-G-C,rs2275780,-1,G,C,150268830,186,150072408,150465624,196422
1,ENSG00000117362.8,150269016,1-150268830-G-T,rs2275780,-1,G,T,150268830,186,150072408,150465624,196422
1,ENSG00000169442.4,26317958,1-26300987-T-C,rs2276712,1,T,C,26300987,16971,26121350,26514566,179637
1,ENSG00000169442.4,26317958,1-26300987-T-G,rs2276712,1,T,G,26300987,16971,26121350,26514566,179637
1,ENSG00000116288.8,7961711,1-7851039-C-T,rs228651,1,C,T,7851039,110672,7765103,8158319,85936
1,ENSG00000049246.8,7784291,1-7820652-G-A,rs228692,1,G,A,7820652,36361,7587683,7980899,232969
1,ENSG00000142623.8,17205128,1-17205087-G-T,rs2293910,1,G,T,17205087,41,17008520,17401736,196567
1,ENSG00000142623.8,17205128,1-17205087-G-A,rs2293910,1,G,A,17205087,41,17008520,17401736,196567
1,ENSG00000001460.12,24413782,1-24444104-G-T,rs2294524,-1,G,T,24444104,30322,24217174,24610390,226930
1,ENSG00000001460.12,24413782,1-24444104-G-C,rs2294524,-1,G,C,24444104,30322,24217174,24610390,226930
1,ENSG00000116691.6,12019498,1-12022869-A-T,rs2295283,1,A,T,12022869,3371,11822890,12216106,199979
1,ENSG00000116691.6,12019498,1-12022869-A-G,rs2295283,1,A,G,12022869,3371,11822890,12216106,199979
1,ENSG00000188290.6,1000097,1-1129422-T-C,rs2298216,-1,T,C,1129422,129325,803489,1196705,325933
1,ENSG00000116198.8,3857211,1-3785099-T-C,rs2298227,-1,T,C,3785099,72112,3660603,4053819,124496
1,ENSG00000116128.5,147541501,1-147384534-G-A,rs2353974,1,G,A,147384534,156967,147344893,147738109,39641
1,ENSG00000116128.5,147541501,1-147384534-G-T,rs2353974,1,G,T,147384534,156967,147344893,147738109,39641
1,ENSG00000183780.8,233904676,1-234045040-T-A,rs2358208,1,T,A,234045040,140364,233708068,234101284,336972
1,ENSG00000183780.8,233904676,1-234045040-T-C,rs2358208,1,T,C,234045040,140364,233708068,234101284,336972
1,ENSG00000183780.8,233904676,1-234045040-T-G,rs2358208,1,T,G,234045040,140364,233708068,234101284,336972
1,ENSG00000079739.9,63593411,1-63403179-T-G,rs2367275,1,T,G,63403179,190232,63396803,63790019,6376
1,ENSG00000079739.9,63593411,1-63403179-T-C,rs2367275,1,T,C,63403179,190232,63396803,63790019,6376
1,ENSG00000079739.9,63593411,1-63403179-T-A,rs2367275,1,T,A,63403179,190232,63396803,63790019,6376
1,ENSG00000187010.13,25272509,1-25215440-T-C,rs2375279,1,T,C,25215440,57069,25075901,25469117,139539
1,ENSG00000187010.13,25272509,1-25215440-T-A,rs2375279,1,T,A,25215440,57069,25075901,25469117,139539
1,ENSG00000187010.13,25272509,1-25215440-T-G,rs2375279,1,T,G,25215440,57069,25075901,25469117,139539
1,ENSG00000142657.14,10399064,1-10424962-G-A,rs2483679,1,G,A,10424962,25898,10202456,10595672,222506
1,ENSG00000143702.10,243255281,1-243329341-C-T,rs2490400,-1,C,T,243329341,74060,243058673,243451889,270668
1,ENSG00000143702.10,243255281,1-243329341-C-G,rs2490400,-1,C,G,243329341,74060,243058673,243451889,270668
1,ENSG00000143079.7,112396214,1-112388634-T-G,rs2492501,1,T,G,112388634,7580,112199606,112592822,189028
1,ENSG00000116151.8,2391554,1-2420841-G-A,rs2494591,-1,G,A,2420841,29287,2194946,2588162,225895
1,ENSG00000158796.10,161132667,1-161265175-G-T,rs2501879,-1,G,T,161265175,132508,160936059,161329275,329116
1,ENSG00000158796.10,161132667,1-161265175-G-A,rs2501879,-1,G,A,161265175,132508,160936059,161329275,329116
1,ENSG00000158796.10,161132667,1-161265175-G-C,rs2501879,-1,G,C,161265175,132508,160936059,161329275,329116
1,ENSG00000076356.6,208244384,1-208236095-G-C,rs2590680,-1,G,C,208236095,8289,208047776,208440992,188319
1,ENSG00000076356.6,208244384,1-208236095-G-A,rs2590680,-1,G,A,208236095,8289,208047776,208440992,188319
1,ENSG00000116874.7,119140653,1-119012523-G-C,rs2645303,-1,G,C,119012523,128130,118944045,119337261,68478
1,ENSG00000116874.7,119140653,1-119012523-G-T,rs2645303,-1,G,T,119012523,128130,118944045,119337261,68478
1,ENSG00000116761.7,70411268,1-70259461-A-C,rs269277,1,A,C,70259461,151807,70214660,70607876,44801
1,ENSG00000197721.11,207645133,1-207736713-C-T,rs2761429,1,C,T,207736713,91580,207448525,207841741,288188
1,ENSG00000197721.11,207645133,1-207736713-C-G,rs2761429,1,C,G,207736713,91580,207448525,207841741,288188
1,ENSG00000159352.10,151254734,1-151329383-G-A,rs2769275,1,G,A,151329383,74649,151058126,151451342,271257
1,ENSG00000159352.10,151254734,1-151329383-G-C,rs2769275,1,G,C,151329383,74649,151058126,151451342,271257
1,ENSG00000116791.9,74733050,1-74811884-T-G,rs277385,-1,T,G,74811884,78834,74536442,74929658,275442
1,ENSG00000162769.7,212858275,1-212865033-G-T,rs2792561,1,G,T,212865033,6758,212661667,213054883,203366
1,ENSG00000162769.7,212858275,1-212865033-G-A,rs2792561,1,G,A,212865033,6758,212661667,213054883,203366
1,ENSG00000169213.5,51990700,1-51951866-T-C,rs2809944,-1,T,C,51951866,38834,51794092,52187308,157774
1,ENSG00000186283.9,179082070,1-179147649-C-T,rs2816184,1,C,T,179147649,65579,178885462,179278678,262187
1,ENSG00000204084.6,37947053,1-37965882-T-C,rs28450036,-1,T,C,37965882,18829,37750445,38143661,215437
1,ENSG00000204084.6,37947053,1-37965882-T-G,rs28450036,-1,T,G,37965882,18829,37750445,38143661,215437
1,ENSG00000163565.14,159009907,1-158871470-T-C,rs2852707,1,T,C,158871470,138437,158813299,159206515,58171
1,ENSG00000163565.14,159009907,1-158871470-T-A,rs2852707,1,T,A,158871470,138437,158813299,159206515,58171
1,ENSG00000065526.5,15847707,1-15822105-A-C,rs28537253,1,A,C,15822105,25602,15651099,16044315,171006
1,ENSG00000058668.10,203626832,1-203597612-T-C,rs28624854,1,T,C,203597612,29220,203430224,203823440,167388
1,ENSG00000184022.2,248597700,1-248482322-C-G,rs28625479,-1,C,G,248482322,115378,248401092,248794308,81230
1,ENSG00000184022.2,248597700,1-248482322-C-T,rs28625479,-1,C,T,248482322,115378,248401092,248794308,81230
1,ENSG00000174371.11,241848204,1-242033665-G-A,rs28649433,1,G,A,242033665,185461,241651596,242044812,382069
1,ENSG00000174371.11,241848204,1-242033665-G-T,rs28649433,1,G,T,242033665,185461,241651596,242044812,382069
1,ENSG00000173614.9,9943475,1-9967482-G-A,rs2890358,1,G,A,9967482,24007,9746867,10140083,220615
1,ENSG00000183814.10,226309164,1-226213058-C-G,rs2927340,-1,C,G,226213058,96106,226112556,226505772,100502
1,ENSG00000183814.10,226309164,1-226213058-C-T,rs2927340,-1,C,T,226213058,96106,226112556,226505772,100502
1,ENSG00000117593.8,173824673,1-173866609-A-G,rs2984704,1,A,G,173866609,41936,173628065,174021281,238544
1,ENSG00000117593.8,173824673,1-173866609-A-C,rs2984704,1,A,C,173866609,41936,173628065,174021281,238544
1,ENSG00000143851.11,202160602,1-202184455-C-A,rs2993427,-1,C,A,202184455,23853,201963994,202357210,220461
1,ENSG00000143851.11,202160602,1-202184455-C-T,rs2993427,-1,C,T,202184455,23853,201963994,202357210,220461
1,ENSG00000143851.11,202160602,1-202184455-C-G,rs2993427,-1,C,G,202184455,23853,201963994,202357210,220461
1,ENSG00000157873.11,2556371,1-2534353-C-A,rs3001339,1,C,A,2534353,22018,2359763,2752979,174590
1,ENSG00000157873.11,2556371,1-2534353-C-T,rs3001339,1,C,T,2534353,22018,2359763,2752979,174590
1,ENSG00000143458.6,151070761,1-151008076-C-G,rs3002293,1,C,G,151008076,62685,150874153,151267369,133923
1,ENSG00000143458.6,151070761,1-151008076-C-T,rs3002293,1,C,T,151008076,62685,150874153,151267369,133923
1,ENSG00000136634.5,206772494,1-206901564-A-G,rs3093431,-1,A,G,206901564,129070,206575886,206969102,325678
1,ENSG00000162434.7,64966549,1-64840194-G-A,rs310244,-1,G,A,64840194,126355,64769941,65163157,70253
1,ENSG00000162434.7,64966549,1-64840194-G-C,rs310244,-1,G,C,64840194,126355,64769941,65163157,70253
1,ENSG00000162490.6,11691710,1-11651532-G-C,rs3117061,1,G,C,11651532,40178,11495102,11888318,156430
1,ENSG00000162490.6,11691710,1-11651532-G-T,rs3117061,1,G,T,11651532,40178,11495102,11888318,156430
1,ENSG00000116663.6,11664200,1-11668837-G-A,rs3125818,1,G,A,11668837,4637,11467592,11860808,201245
1,ENSG00000116990.9,39901917,1-39892380-A-T,rs3131690,-1,A,T,39892380,9537,39705309,40098525,187071
1,ENSG00000088280.11,23484179,1-23519471-A-C,rs3218173,-1,A,C,23519471,35292,23287571,23680787,231900
1,ENSG00000156150.5,110070672,1-109897014-C-T,rs333961,-1,C,T,109897014,173658,109874064,110267280,22950
1,ENSG00000116299.11,109114115,1-108937665-G-A,rs338485,1,G,A,108937665,176450,108917507,109310723,20158
1,ENSG00000162576.10,1358555,1-1315577-G-A,rs34054191,-1,G,A,1315577,42978,1161947,1555163,153630
1,ENSG00000143162.7,167553762,1-167444249-C-G,rs35240301,-1,C,G,167444249,109513,167357154,167750370,87095
1,ENSG00000026751.11,160739247,1-160712795-G-C,rs35304526,1,G,C,160712795,26452,160542639,160935855,170156
1,ENSG00000026751.11,160739247,1-160712795-G-A,rs35304526,1,G,A,160712795,26452,160542639,160935855,170156
1,ENSG00000198912.6,3900272,1-3908961-C-T,rs35383955,-1,C,T,3908961,8689,3703664,4096880,205297
1,ENSG00000154309.7,222815039,1-222658668-A-G,rs35822937,1,A,G,222658668,156371,222618431,223011647,40237
1,ENSG00000187961.7,960584,1-1004823-G-A,rs35940137,1,G,A,1004823,44239,763976,1157192,240847
1,ENSG00000125703.8,62784132,1-62819362-T-C,rs3737891,1,T,C,62819362,35230,62587524,62980740,231838
1,ENSG00000117118.5,17054032,1-16988207-C-T,rs3738815,-1,C,T,16988207,65825,16857424,17250640,130783
1,ENSG00000117118.5,17054032,1-16988207-C-A,rs3738815,-1,C,A,16988207,65825,16857424,17250640,130783
1,ENSG00000184678.8,149886682,1-149943855-G-A,rs3754041,-1,G,A,149943855,57173,149690074,150083290,253781
1,ENSG00000116977.13,236523982,1-236557433-A-T,rs3754246,1,A,T,236557433,33451,236327374,236720590,230059
1,ENSG00000116977.13,236523982,1-236557433-A-G,rs3754246,1,A,G,236557433,33451,236327374,236720590,230059
1,ENSG00000116977.13,236523982,1-236557433-A-C,rs3754246,1,A,C,236557433,33451,236327374,236720590,230059
1,ENSG00000116771.5,15585051,1-15482377-G-A,rs3766160,-1,G,A,15482377,102674,15388443,15781659,93934
1,ENSG00000162836.6,147670524,1-147625834-T-C,rs3766512,-1,T,C,147625834,44690,147473916,147867132,151918
1,ENSG00000162836.6,147670524,1-147625834-T-A,rs3766512,-1,T,A,147625834,44690,147473916,147867132,151918
1,ENSG00000116260.12,180154869,1-180155737-T-G,rs3767196,1,T,G,180155737,868,179958261,180351477,197476
1,ENSG00000116260.12,180154869,1-180155737-T-C,rs3767196,1,T,C,180155737,868,179958261,180351477,197476
1,ENSG00000136628.11,220046505,1-220018404-G-A,rs3767661,-1,G,A,220018404,28101,219849897,220243113,168507
1,ENSG00000136628.11,220046505,1-220018404-G-T,rs3767661,-1,G,T,220018404,28101,219849897,220243113,168507
1,ENSG00000135823.9,181022870,1-180936558-C-G,rs3795503,-1,C,G,180936558,86312,180826262,181219478,110296
1,ENSG00000135823.9,181022870,1-180936558-C-A,rs3795503,-1,C,A,180936558,86312,180826262,181219478,110296
1,ENSG00000135823.9,181022870,1-180936558-C-T,rs3795503,-1,C,T,180936558,86312,180826262,181219478,110296
1,ENSG00000040487.8,19312326,1-19421002-G-T,rs3829833,1,G,T,19421002,108676,19115718,19508934,305284
1,ENSG00000135828.6,182589256,1-182523452-A-G,rs3843287,-1,A,G,182523452,65804,182392648,182785864,130804
1,ENSG00000121454.4,180230264,1-180271617-C-T,rs3845397,1,C,T,180271617,41353,180033656,180426872,237961
1,ENSG00000117480.10,46394317,1-46377544-T-C,rs3863641,1,T,C,46377544,16773,46197709,46590925,179835
1,ENSG00000143554.9,153775407,1-153685711-A-T,rs3891075,1,A,T,153685711,89696,153578799,153972015,106912
1,ENSG00000133055.4,203175826,1-203104668-A-C,rs3898276,-1,A,C,203104668,71158,202979218,203372434,125450
1,ENSG00000116678.14,65420668,1-65438772-C-G,rs3934256,1,C,G,65438772,18104,65224060,65617276,214712
1,ENSG00000149527.10,2476289,1-2605633-C-T,rs4074787,1,C,T,2605633,129344,2279681,2672897,325952
1,ENSG00000170989.7,101237019,1-101354021-T-C,rs4078120,1,T,C,101354021,117002,101040411,101433627,313610
1,ENSG00000143436.6,151763496,1-151729587-A-G,rs41263712,-1,A,G,151729587,33909,151566888,151960104,162699
1,ENSG00000162738.5,160400564,1-160312134-C-T,rs41265797,1,C,T,160312134,88430,160203956,160597172,108178
1,ENSG00000162738.5,160400564,1-160312134-C-A,rs41265797,1,C,A,160312134,88430,160203956,160597172,108178
1,ENSG00000143418.14,150974835,1-151060221-G-T,rs41266624,-1,G,T,151060221,85386,150778227,151171443,281994
1,ENSG00000142632.10,16212652,1-16206003-G-A,rs41269185,-1,G,A,16206003,6649,16016044,16409260,189959
1,ENSG00000171488.9,89633120,1-89763028-C-G,rs41305844,1,C,G,89763028,129908,89436512,89829728,326516
1,ENSG00000136636.6,215567304,1-215648597-C-T,rs41315587,1,C,T,215648597,81293,215370696,215763912,277901
1,ENSG00000136636.6,215567304,1-215648597-C-A,rs41315587,1,C,A,215648597,81293,215370696,215763912,277901
1,ENSG00000203965.7,63523525,1-63534976-A-G,rs41469347,1,A,G,63534976,11451,63326917,63720133,208059
1,ENSG00000162390.12,54548228,1-54571211-A-G,rs41503150,1,A,G,54571211,22983,54351620,54744836,219591
1,ENSG00000162654.8,89198942,1-89171264-C-T,rs4233337,-1,C,T,89171264,27678,89002334,89395550,168930
1,ENSG00000142224.11,206770773,1-206723277-C-T,rs4240847,1,C,T,206723277,47496,206574165,206967381,149112
1,ENSG00000142224.11,206770773,1-206723277-C-G,rs4240847,1,C,G,206723277,47496,206574165,206967381,149112
1,ENSG00000142224.11,206770773,1-206723277-C-A,rs4240847,1,C,A,206723277,47496,206574165,206967381,149112
1,ENSG00000196449.3,37808208,1-37782066-A-G,rs4308943,-1,A,G,37782066,26142,37611600,38004816,170466
1,ENSG00000142798.11,21937310,1-22009627-T-A,rs4344303,-1,T,A,22009627,72317,21740702,22133918,268925
1,ENSG00000142798.11,21937310,1-22009627-T-C,rs4344303,-1,T,C,22009627,72317,21740702,22133918,268925
1,ENSG00000189171.8,153627505,1-153770841-G-A,rs4345834,-1,G,A,153770841,143336,153430897,153824113,339944
1,ENSG00000189171.8,153627505,1-153770841-G-T,rs4345834,-1,G,T,153770841,143336,153430897,153824113,339944
1,ENSG00000143614.7,153922972,1-153770841-G-A,rs4345834,-1,G,A,153770841,152131,153726364,154119580,44477
1,ENSG00000143614.7,153922972,1-153770841-G-T,rs4345834,-1,G,T,153770841,152131,153726364,154119580,44477
1,ENSG00000132763.9,45500300,1-45635651-C-T,rs4431884,1,C,T,45635651,135351,45303692,45696908,331959
1,ENSG00000169885.5,1915260,1-2068898-G-A,rs4454477,1,G,A,2068898,153638,1718652,2111868,350246
1,ENSG00000143549.14,154192100,1-154095720-C-T,rs4459102,-1,C,T,154095720,96380,153995492,154388708,100228
1,ENSG00000143498.12,222589933,1-222559314-T-G,rs4481859,-1,T,G,222559314,30619,222393325,222786541,165989
1,ENSG00000117013.10,40783787,1-40821776-T-G,rs4483396,1,T,G,40821776,37989,40587179,40980395,234597
1,ENSG00000117013.10,40783787,1-40821776-T-A,rs4483396,1,T,A,40821776,37989,40587179,40980395,234597
1,ENSG00000158864.7,161202367,1-161219923-C-T,rs4489574,1,C,T,161219923,17556,161005759,161398975,214164
1,ENSG00000158864.7,161202367,1-161219923-C-G,rs4489574,1,C,G,161219923,17556,161005759,161398975,214164
1,ENSG00000143294.9,156767535,1-156693425-A-C,rs4492611,1,A,C,156693425,74110,156570927,156964143,122498
1,ENSG00000143294.9,156767535,1-156693425-A-T,rs4492611,1,A,T,156693425,74110,156570927,156964143,122498
1,ENSG00000143294.9,156767535,1-156693425-A-G,rs4492611,1,A,G,156693425,74110,156570927,156964143,122498
1,ENSG00000183520.7,38012734,1-38015316-C-T,rs4525008,1,C,T,38015316,2582,37816126,38209342,199190
1,ENSG00000186205.8,220786913,1-220756059-A-G,rs453079,1,A,G,220756059,30854,220590305,220983521,165754
1,ENSG00000054282.10,243256041,1-243227523-A-G,rs4634890,1,A,G,243227523,28518,243059433,243452649,168090
1,ENSG00000054282.10,243256041,1-243227523-A-T,rs4634890,1,A,T,243227523,28518,243059433,243452649,168090
1,ENSG00000054282.10,243256041,1-243227523-A-C,rs4634890,1,A,C,243227523,28518,243059433,243452649,168090
1,ENSG00000189339.7,1692795,1-1586425-A-G,rs4648786,-1,A,G,1586425,106370,1496187,1889403,90238
1,ENSG00000189339.7,1692795,1-1586425-A-C,rs4648786,-1,A,C,1586425,106370,1496187,1889403,90238
1,ENSG00000143819.8,225810124,1-225845382-A-T,rs4653695,1,A,T,225845382,35258,225613516,226006732,231866
1,ENSG00000143819.8,225810124,1-225845382-A-C,rs4653695,1,A,C,225845382,35258,225613516,226006732,231866
1,ENSG00000143819.8,225810124,1-225845382-A-G,rs4653695,1,A,G,225845382,35258,225613516,226006732,231866
1,ENSG00000000457.8,169893896,1-169857726-G-A,rs4656198,-1,G,A,169857726,36170,169697288,170090504,160438
1,ENSG00000000457.8,169893896,1-169857726-G-T,rs4656198,-1,G,T,169857726,36170,169697288,170090504,160438
1,ENSG00000122223.8,160862887,1-160861258-G-A,rs4656942,-1,G,A,160861258,1629,160666279,161059495,194979
1,ENSG00000122223.8,160862887,1-160861258-G-C,rs4656942,-1,G,C,160861258,1629,160666279,161059495,194979
1,ENSG00000122223.8,160862887,1-160861258-G-T,rs4656942,-1,G,T,160861258,1629,160666279,161059495,194979
1,ENSG00000117143.8,162561506,1-162485772-C-A,rs4657196,1,C,A,162485772,75734,162364898,162758114,120874
1,ENSG00000198771.6,167630232,1-167642314-G-T,rs4657693,1,G,T,167642314,12082,167433624,167826840,208690
1,ENSG00000198771.6,167630232,1-167642314-G-A,rs4657693,1,G,A,167642314,12082,167433624,167826840,208690
1,ENSG00000198771.6,167630232,1-167642314-G-C,rs4657693,1,G,C,167642314,12082,167433624,167826840,208690
1,ENSG00000010072.10,231338293,1-231210440-G-C,rs4658872,1,G,C,231210440,127853,231141685,231534901,68755
1,ENSG00000010072.10,231338293,1-231210440-G-A,rs4658872,1,G,A,231210440,127853,231141685,231534901,68755
1,ENSG00000117481.5,46340807,1-46339550-A-G,rs4660344,1,A,G,46339550,1257,46144199,46537415,195351
1,ENSG00000117481.5,46340807,1-46339550-A-T,rs4660344,1,A,T,46339550,1257,46144199,46537415,195351
1,ENSG00000179862.5,40862363,1-40936471-T-A,rs4660492,-1,T,A,40936471,74108,40665755,41058971,270716
1,ENSG00000179862.5,40862363,1-40936471-T-G,rs4660492,-1,T,G,40936471,74108,40665755,41058971,270716
1,ENSG00000179862.5,40862363,1-40936471-T-C,rs4660492,-1,T,C,40936471,74108,40665755,41058971,270716
1,ENSG00000163382.6,156591776,1-156626874-A-G,rs4661055,1,A,G,156626874,35098,156395168,156788384,231706
1,ENSG00000143314.8,156741088,1-156839414-G-T,rs4661229,-1,G,T,156839414,98326,156544480,156937696,294934
1,ENSG00000143314.8,156741088,1-156839414-G-A,rs4661229,-1,G,A,156839414,98326,156544480,156937696,294934
1,ENSG00000132881.5,16237183,1-16252575-C-T,rs4661729,-1,C,T,16252575,15392,16040575,16433791,212000
1,ENSG00000134201.5,109712251,1-109612515-C-T,rs475858,1,C,T,109612515,99736,109515643,109908859,96872
1,ENSG00000182866.11,32251265,1-32365942-C-A,rs476153,1,C,A,32365942,114677,32054657,32447873,311285
1,ENSG00000182866.11,32251265,1-32365942-C-G,rs476153,1,C,G,32365942,114677,32054657,32447873,311285
1,ENSG00000182866.11,32251265,1-32365942-C-T,rs476153,1,C,T,32365942,114677,32054657,32447873,311285
1,ENSG00000116981.3,39672107,1-39687469-T-C,rs477913,-1,T,C,39687469,15362,39475499,39868715,211970
1,ENSG00000143621.12,153670993,1-153656550-G-T,rs4845563,-1,G,T,153656550,14443,153474385,153867601,182165
1,ENSG00000143621.12,153670993,1-153656550-G-A,rs4845563,-1,G,A,153656550,14443,153474385,153867601,182165
1,ENSG00000143621.12,153670993,1-153656550-G-C,rs4845563,-1,G,C,153656550,14443,153474385,153867601,182165
1,ENSG00000159445.8,151909511,1-151858962-T-G,rs4845629,-1,T,G,151858962,50549,151712903,152106119,146059
1,ENSG00000162441.6,9943391,1-10024621-C-A,rs4846187,-1,C,A,10024621,81230,9746783,10139999,277838
1,ENSG00000055732.7,85048500,1-85071819-T-A,rs4907131,-1,T,A,85071819,23319,84851892,85245108,219927
1,ENSG00000055732.7,85048500,1-85071819-T-G,rs4907131,-1,T,G,85071819,23319,84851892,85245108,219927
1,ENSG00000055732.7,85048500,1-85071819-T-C,rs4907131,-1,T,C,85071819,23319,84851892,85245108,219927
1,ENSG00000130768.8,27935000,1-27946505-T-G,rs4908379,1,T,G,27946505,11505,27738392,28131608,208113
1,ENSG00000162413.11,6602869,1-6579787-G-T,rs4908932,-1,G,T,6579787,23082,6406261,6799477,173526
1,ENSG00000143847.10,203026491,1-203043778-G-A,rs4950908,1,G,A,203043778,17287,202829883,203223099,213895
1,ENSG00000143847.10,203026491,1-203043778-G-C,rs4950908,1,G,C,203043778,17287,202829883,203223099,213895
1,ENSG00000133069.10,205227946,1-205358153-A-G,rs4951209,1,A,G,205358153,130207,205031338,205424554,326815
1,ENSG00000133069.10,205227946,1-205358153-A-T,rs4951209,1,A,T,205358153,130207,205031338,205424554,326815
1,ENSG00000133069.10,205227946,1-205358153-A-C,rs4951209,1,A,C,205358153,130207,205031338,205424554,326815
1,ENSG00000187642.5,981029,1-1113575-A-G,rs4970405,-1,A,G,1113575,132546,784421,1177637,329154
1,ENSG00000187642.5,981029,1-1113575-A-T,rs4970405,-1,A,T,1113575,132546,784421,1177637,329154
1,ENSG00000116954.7,38859772,1-38847626-C-T,rs4970563,-1,C,T,38847626,12146,38663164,39056380,184462
1,ENSG00000169241.12,155135852,1-155171470-C-A,rs4971092,1,C,A,155171470,35618,154939244,155332460,232226
1,ENSG00000169241.12,155135852,1-155171470-C-G,rs4971092,1,C,G,155171470,35618,154939244,155332460,232226
1,ENSG00000169241.12,155135852,1-155171470-C-T,rs4971092,1,C,T,155171470,35618,154939244,155332460,232226
1,ENSG00000188404.4,169711620,1-169708883-T-C,rs4987285,-1,T,C,169708883,2737,169515012,169908228,193871
1,ENSG00000188404.4,169711620,1-169708883-T-G,rs4987285,-1,T,G,169708883,2737,169515012,169908228,193871
1,ENSG00000116985.6,39788865,1-39751321-A-G,rs501523,-1,A,G,39751321,37544,39592257,39985473,159064
1,ENSG00000069424.8,6045888,1-5853833-C-T,rs522049,1,C,T,5853833,192055,5849280,6242496,4553
1,ENSG00000143633.7,231241175,1-231219324-G-C,rs524331,-1,G,C,231219324,21851,231044567,231437783,174757
1,ENSG00000143633.7,231241175,1-231219324-G-T,rs524331,-1,G,T,231219324,21851,231044567,231437783,174757
1,ENSG00000143633.7,231241175,1-231219324-G-A,rs524331,-1,G,A,231219324,21851,231044567,231437783,174757
1,ENSG00000143799.7,226408093,1-226587175-G-A,rs528316,-1,G,A,226587175,179082,226211485,226604701,375690
1,ENSG00000142686.6,35718884,1-35866901-A-G,rs56183947,-1,A,G,35866901,148017,35522276,35915492,344625
1,ENSG00000142686.6,35718884,1-35866901-A-T,rs56183947,-1,A,T,35866901,148017,35522276,35915492,344625
1,ENSG00000085465.10,111427735,1-111414970-A-G,rs56294468,-1,A,G,111414970,12765,111231127,111624343,183843
1,ENSG00000158195.6,27490167,1-27417881-G-A,rs56362645,-1,G,A,27417881,72286,27293559,27686775,124322
1,ENSG00000133226.10,24643302,1-24516589-G-A,rs56843733,1,G,A,24516589,126713,24446694,24839910,69895
1,ENSG00000116133.6,54887195,1-54808791-A-C,rs585802,-1,A,C,54808791,78404,54690587,55083803,118204
1,ENSG00000116133.6,54887195,1-54808791-A-G,rs585802,-1,A,G,54808791,78404,54690587,55083803,118204
1,ENSG00000116754.9,70221380,1-70118777-G-A,rs593467,1,G,A,70118777,102603,70024772,70417988,94005
1,ENSG00000116754.9,70221380,1-70118777-G-C,rs593467,1,G,C,70118777,102603,70024772,70417988,94005
1,ENSG00000117395.5,43172290,1-43156889-T-C,rs603786,-1,T,C,43156889,15401,42975682,43368898,181207
1,ENSG00000237763.5,103655760,1-103803865-G-C,rs60555558,1,G,C,103803865,148105,103459152,103852368,344713
1,ENSG00000237763.5,103655760,1-103803865-G-T,rs60555558,1,G,T,103803865,148105,103459152,103852368,344713
1,ENSG00000237763.5,103655760,1-103803865-G-A,rs60555558,1,G,A,103803865,148105,103459152,103852368,344713
1,ENSG00000174876.11,103696210,1-103803865-G-C,rs60555558,-1,G,C,103803865,107655,103499602,103892818,304263
1,ENSG00000174876.11,103696210,1-103803865-G-T,rs60555558,-1,G,T,103803865,107655,103499602,103892818,304263
1,ENSG00000174876.11,103696210,1-103803865-G-A,rs60555558,-1,G,A,103803865,107655,103499602,103892818,304263
1,ENSG00000243480.3,103617427,1-103803865-G-C,rs60555558,1,G,C,103803865,186438,103420819,103814035,383046
1,ENSG00000243480.3,103617427,1-103803865-G-T,rs60555558,1,G,T,103803865,186438,103420819,103814035,383046
1,ENSG00000243480.3,103617427,1-103803865-G-A,rs60555558,1,G,A,103803865,186438,103420819,103814035,383046
1,ENSG00000090432.5,20508151,1-20522586-C-T,rs609210,-1,C,T,20522586,14435,20311543,20704759,211043
1,ENSG00000117009.7,241532378,1-241609119-A-G,rs613032,1,A,G,241609119,76741,241335770,241728986,273349
1,ENSG00000215717.4,109090764,1-109091719-C-T,rs616378,1,C,T,109091719,955,108894156,109287372,197563
1,ENSG00000169914.5,19882395,1-19920383-C-G,rs61729970,1,C,G,19920383,37988,19685787,20079003,234596
1,ENSG00000169914.5,19882395,1-19920383-C-T,rs61729970,1,C,T,19920383,37988,19685787,20079003,234596
1,ENSG00000162572.14,1280436,1-1228651-A-G,rs61744664,1,A,G,1228651,51785,1083828,1477044,144823
1,ENSG00000164008.7,42767249,1-42863789-G-T,rs61777677,1,G,T,42863789,96540,42570641,42963857,293148
1,ENSG00000134247.8,116909916,1-116726313-G-A,rs61787809,1,G,A,116726313,183603,116713308,117106524,13005
1,ENSG00000072694.13,161663143,1-161710728-T-A,rs61801161,1,T,A,161710728,47585,161466535,161859751,244193
1,ENSG00000160789.14,156114711,1-156049284-G-T,rs61813293,1,G,T,156049284,65427,155918103,156311319,131181
1,ENSG00000160789.14,156114711,1-156049284-G-C,rs61813293,1,G,C,156049284,65427,155918103,156311319,131181
1,ENSG00000160789.14,156114711,1-156049284-G-A,rs61813293,1,G,A,156049284,65427,155918103,156311319,131181
1,ENSG00000118454.8,70354722,1-70511646-A-G,rs620247,-1,A,G,70511646,156924,70158114,70551330,353532
1,ENSG00000118454.8,70354722,1-70511646-A-T,rs620247,-1,A,T,70511646,156924,70158114,70551330,353532
1,ENSG00000168765.10,109656099,1-109667284-G-A,rs638820,1,G,A,109667284,11185,109459491,109852707,207793
1,ENSG00000116406.13,184754858,1-184854862-A-C,rs639593,-1,A,C,184854862,100004,184558250,184951466,296612
1,ENSG00000059588.5,234479179,1-234302581-A-G,rs642044,-1,A,G,234302581,176598,234282571,234675787,20010
1,ENSG00000059588.5,234479179,1-234302581-A-T,rs642044,-1,A,T,234302581,176598,234282571,234675787,20010
1,ENSG00000121766.10,31297032,1-31180886-T-C,rs6425714,1,T,C,31180886,116146,31100424,31493640,80462
1,ENSG00000121766.10,31297032,1-31180886-T-G,rs6425714,1,T,G,31180886,116146,31100424,31493640,80462
1,ENSG00000162885.6,235504452,1-235447778-A-G,rs6429094,-1,A,G,235447778,56674,235307844,235701060,139934
1,ENSG00000198216.6,181483517,1-181466918-T-A,rs644796,1,T,A,181466918,16599,181286909,181680125,180009
1,ENSG00000198216.6,181483517,1-181466918-T-C,rs644796,1,T,C,181466918,16599,181286909,181680125,180009
1,ENSG00000117595.6,209806142,1-209826803-T-C,rs646596,-1,T,C,209826803,20661,209609534,210002750,217269
1,ENSG00000213366.6,109668057,1-109672556-A-G,rs655315,1,A,G,109672556,4499,109471449,109864665,201107
1,ENSG00000213366.6,109668057,1-109672556-A-T,rs655315,1,A,T,109672556,4499,109471449,109864665,201107
1,ENSG00000213366.6,109668057,1-109672556-A-C,rs655315,1,A,C,109672556,4499,109471449,109864665,201107
1,ENSG00000143434.10,151146631,1-151164668-A-G,rs6587557,-1,A,G,151164668,18037,150950023,151343239,214645
1,ENSG00000143443.8,151047751,1-151164668-A-G,rs6587557,1,A,G,151164668,116917,150851143,151244359,313525
1,ENSG00000122481.12,95234210,1-95316977-C-T,rs6593652,1,C,T,95316977,82767,95037602,95430818,279375
1,ENSG00000130766.4,28259518,1-28301726-C-T,rs6598926,1,C,T,28301726,42208,28062910,28456126,238816
1,ENSG00000142669.8,26280086,1-26204765-C-A,rs6598943,1,C,A,26204765,75321,26083478,26476694,121287
1,ENSG00000122188.8,203765183,1-203694307-T-C,rs6656569,1,T,C,203694307,70876,203568575,203961791,125732
1,ENSG00000188786.7,37859592,1-37676729-T-C,rs6656571,-1,T,C,37676729,182863,37662984,38056200,13745
1,ENSG00000084073.4,40258236,1-40157648-G-C,rs6656984,1,G,C,40157648,100588,40061628,40454844,96020
1,ENSG00000084073.4,40258236,1-40157648-G-A,rs6656984,1,G,A,40157648,100588,40061628,40454844,96020
1,ENSG00000157881.8,2526596,1-2441650-G-T,rs6659405,-1,G,T,2441650,84946,2329988,2723204,111662
1,ENSG00000157881.8,2526596,1-2441650-G-A,rs6659405,-1,G,A,2441650,84946,2329988,2723204,111662
1,ENSG00000157881.8,2526596,1-2441650-G-C,rs6659405,-1,G,C,2441650,84946,2329988,2723204,111662
1,ENSG00000048707.8,12230030,1-12360244-T-C,rs6660347,1,T,C,12360244,130214,12033422,12426638,326822
1,ENSG00000251503.2,10430435,1-10451532-T-C,rs666103,1,T,C,10451532,21097,10233827,10627043,217705
1,ENSG00000251503.2,10430435,1-10451532-T-A,rs666103,1,T,A,10451532,21097,10233827,10627043,217705
1,ENSG00000158966.9,64470129,1-64611899-G-A,rs6665381,1,G,A,64611899,141770,64273521,64666737,338378
1,ENSG00000214114.4,38873348,1-38965373-T-G,rs6665494,-1,T,G,38965373,92025,38676740,39069956,288633
1,ENSG00000214114.4,38873348,1-38965373-T-A,rs6665494,-1,T,A,38965373,92025,38676740,39069956,288633
1,ENSG00000214114.4,38873348,1-38965373-T-C,rs6665494,-1,T,C,38965373,92025,38676740,39069956,288633
1,ENSG00000197915.5,152224193,1-152244750-C-T,rs6666382,-1,C,T,152244750,20557,152027585,152420801,217165
1,ENSG00000197915.5,152224193,1-152244750-C-A,rs6666382,-1,C,A,152244750,20557,152027585,152420801,217165
1,ENSG00000197915.5,152224193,1-152244750-C-G,rs6666382,-1,C,G,152244750,20557,152027585,152420801,217165
1,ENSG00000182783.3,248562772,1-248469771-C-A,rs6666568,-1,C,A,248469771,93001,248366164,248759380,103607
1,ENSG00000182783.3,248562772,1-248469771-C-T,rs6666568,-1,C,T,248469771,93001,248366164,248759380,103607
1,ENSG00000183310.2,248574757,1-248469771-C-A,rs6666568,-1,C,A,248469771,104986,248378149,248771365,91622
1,ENSG00000183310.2,248574757,1-248469771-C-T,rs6666568,-1,C,T,248469771,104986,248378149,248771365,91622
1,ENSG00000203661.2,248488589,1-248469771-C-A,rs6666568,1,C,A,248469771,18818,248291981,248685197,177790
1,ENSG00000203661.2,248488589,1-248469771-C-T,rs6666568,1,C,T,248469771,18818,248291981,248685197,177790
1,ENSG00000196539.2,248473351,1-248469771-C-A,rs6666568,1,C,A,248469771,3580,248276743,248669959,193028
1,ENSG00000196539.2,248473351,1-248469771-C-T,rs6666568,1,C,T,248469771,3580,248276743,248669959,193028
1,ENSG00000143353.7,219173878,1-219041795-G-A,rs6667536,1,G,A,219041795,132083,218977270,219370486,64525
1,ENSG00000169991.5,18956676,1-18782542-C-G,rs6669544,-1,C,G,18782542,174134,18760068,19153284,22474
1,ENSG00000131788.10,145859081,1-145873487-G-T,rs6670984,-1,G,T,145873487,14406,145662473,146055689,211014
1,ENSG00000131788.10,145859081,1-145873487-G-A,rs6670984,-1,G,A,145873487,14406,145662473,146055689,211014
1,ENSG00000197323.6,114511203,1-114540572-T-C,rs6673875,-1,T,C,114540572,29369,114314595,114707811,225977
1,ENSG00000182134.11,151790500,1-151777957-T-C,rs6679233,-1,T,C,151777957,12543,151593892,151987108,184065
1,ENSG00000182134.11,151790500,1-151777957-T-A,rs6679233,-1,T,A,151777957,12543,151593892,151987108,184065
1,ENSG00000182134.11,151790500,1-151777957-T-G,rs6679233,-1,T,G,151777957,12543,151593892,151987108,184065
1,ENSG00000066027.4,212285410,1-212174010-C-T,rs6680653,1,C,T,212174010,111400,212088802,212482018,85208
1,ENSG00000185436.7,24187289,1-24116417-T-C,rs6686007,-1,T,C,24116417,70872,23990681,24383897,125736
1,ENSG00000185436.7,24187289,1-24116417-T-A,rs6686007,-1,T,A,24116417,70872,23990681,24383897,125736
1,ENSG00000215845.6,161038964,1-161043522-T-C,rs6686076,-1,T,C,161043522,4558,160842356,161235572,201166
1,ENSG00000215845.6,161038964,1-161043522-T-G,rs6686076,-1,T,G,161043522,4558,160842356,161235572,201166
1,ENSG00000171806.7,169794907,1-169839528-G-A,rs6687377,-1,G,A,169839528,44621,169598299,169991515,241229
1,ENSG00000171806.7,169794907,1-169839528-G-C,rs6687377,-1,G,C,169839528,44621,169598299,169991515,241229
1,ENSG00000171806.7,169794907,1-169839528-G-T,rs6687377,-1,G,T,169839528,44621,169598299,169991515,241229
1,ENSG00000196427.6,108244076,1-108336315-T-C,rs6690308,-1,T,C,108336315,92239,108047468,108440684,288847
1,ENSG00000196427.6,108244076,1-108336315-T-G,rs6690308,-1,T,G,108336315,92239,108047468,108440684,288847
1,ENSG00000132681.12,160151603,1-160177000-G-A,rs6693877,1,G,A,160177000,25397,159954995,160348211,222005
1,ENSG00000132681.12,160151603,1-160177000-G-T,rs6693877,1,G,T,160177000,25397,159954995,160348211,222005
1,ENSG00000184260.4,149886918,1-149907993-C-T,rs6696662,1,C,T,149907993,21075,149690310,150083526,217683
1,ENSG00000184260.4,149886918,1-149907993-C-G,rs6696662,1,C,G,149907993,21075,149690310,150083526,217683
1,ENSG00000184260.4,149886918,1-149907993-C-A,rs6696662,1,C,A,149907993,21075,149690310,150083526,217683
1,ENSG00000162729.8,160098619,1-160126388-T-A,rs6698729,-1,T,A,160126388,27769,159902011,160295227,224377
1,ENSG00000162729.8,160098619,1-160126388-T-C,rs6698729,-1,T,C,160126388,27769,159902011,160295227,224377
1,ENSG00000174529.6,205084460,1-205123246-A-G,rs6700182,-1,A,G,205123246,38786,204887852,205281068,235394
1,ENSG00000174529.6,205084460,1-205123246-A-C,rs6700182,-1,A,C,205123246,38786,204887852,205281068,235394
1,ENSG00000174529.6,205084460,1-205123246-A-T,rs6700182,-1,A,T,205123246,38786,204887852,205281068,235394
1,ENSG00000168679.13,110391026,1-110526711-T-G,rs6700661,-1,T,G,110526711,135685,110194418,110587634,332293
1,ENSG00000171960.6,42658423,1-42757818-C-T,rs6700677,1,C,T,42757818,99395,42461815,42855031,296003
1,ENSG00000117586.5,173207331,1-173383558-G-C,rs6701066,-1,G,C,173383558,176227,173010723,173403939,372835
1,ENSG00000058085.9,183186264,1-183193315-G-A,rs672525,1,G,A,183193315,7051,182989656,183382872,203659
1,ENSG00000058085.9,183186264,1-183193315-G-T,rs672525,1,G,T,183193315,7051,182989656,183382872,203659
1,ENSG00000197982.10,37807790,1-37683093-A-G,rs684260,1,A,G,37683093,124697,37611182,38004398,71911
1,ENSG00000197982.10,37807790,1-37683093-A-T,rs684260,1,A,T,37683093,124697,37611182,38004398,71911
1,ENSG00000197982.10,37807790,1-37683093-A-C,rs684260,1,A,C,37683093,124697,37611182,38004398,71911
1,ENSG00000131238.10,40097252,1-40266696-T-C,rs720793,-1,T,C,40266696,169444,39900644,40293860,366052
1,ENSG00000120949.10,12063303,1-12095014-C-G,rs72641068,1,C,G,12095014,31711,11866695,12259911,228319
1,ENSG00000117602.6,24502836,1-24448604-A-G,rs72652576,1,A,G,24448604,54232,24306228,24699444,142376
1,ENSG00000000938.7,27635185,1-27793142-C-G,rs72655055,-1,C,G,27793142,157957,27438577,27831793,354565
1,ENSG00000188060.6,28592265,1-28451932-G-A,rs72661781,1,G,A,28451932,140333,28395657,28788873,56275
1,ENSG00000184292.5,58577252,1-58620033-C-T,rs72676713,-1,C,T,58620033,42781,58380644,58773860,239389
1,ENSG00000184292.5,58577252,1-58620033-C-A,rs72676713,-1,C,A,58620033,42781,58380644,58773860,239389
1,ENSG00000116824.4,116754430,1-116582831-G-A,rs72697343,1,G,A,116582831,171599,116557822,116951038,25009
1,ENSG00000116824.4,116754430,1-116582831-G-C,rs72697343,1,G,C,116582831,171599,116557822,116951038,25009
1,ENSG00000120333.4,175023425,1-175081747-T-C,rs72719303,-1,T,C,175081747,58322,174826817,175220033,254930
1,ENSG00000143862.3,202144737,1-201952641-T-C,rs72744840,-1,T,C,201952641,192096,201948129,202341345,4512
1,ENSG00000162714.7,247331867,1-247375316-C-A,rs72771953,-1,C,A,247375316,43449,247135259,247528475,240057
1,ENSG00000162714.7,247331867,1-247375316-C-T,rs72771953,-1,C,T,247375316,43449,247135259,247528475,240057
1,ENSG00000158286.8,6206119,1-6162441-C-T,rs731975,1,C,T,6162441,43678,6009511,6402727,152930
1,ENSG00000158286.8,6206119,1-6162441-C-A,rs731975,1,C,A,6162441,43678,6009511,6402727,152930
1,ENSG00000117010.11,40531637,1-40465331-A-G,rs736861,1,A,G,40465331,66306,40335029,40728245,130302
1,ENSG00000187634.6,923923,1-931558-G-A,rs74047407,1,G,A,931558,7635,727315,1120531,204243
1,ENSG00000157978.6,25543606,1-25541624-G-A,rs74063479,1,G,A,25541624,1982,25346998,25740214,194626
1,ENSG00000162676.7,92486925,1-92509648-T-C,rs74101167,-1,T,C,92509648,22723,92290317,92683533,219331
1,ENSG00000135778.6,232950611,1-232960639-G-T,rs74230943,1,G,T,232960639,10028,232754003,233147219,206636
1,ENSG00000116574.4,228735479,1-228543976-C-G,rs744668,1,C,G,228543976,191503,228538871,228932087,5105
1,ENSG00000116574.4,228735479,1-228543976-C-T,rs744668,1,C,T,228543976,191503,228538871,228932087,5105
1,ENSG00000162627.12,98661721,1-98534305-T-C,rs74583498,1,T,C,98534305,127416,98465113,98858329,69192
1,ENSG00000134369.10,201648249,1-201615611-G-T,rs74718642,1,G,T,201615611,32638,201451641,201844857,163970
1,ENSG00000134369.10,201648249,1-201615611-G-C,rs74718642,1,G,C,201615611,32638,201451641,201844857,163970
1,ENSG00000134369.10,201648249,1-201615611-G-A,rs74718642,1,G,A,201615611,32638,201451641,201844857,163970
1,ENSG00000180198.9,28506043,1-28562282-T-C,rs74841008,1,T,C,28562282,56239,28309435,28702651,252847
1,ENSG00000162631.12,107141039,1-106955989-G-T,rs74844465,1,G,T,106955989,185050,106944431,107337647,11558
1,ENSG00000162631.12,107141039,1-106955989-G-C,rs74844465,1,G,C,106955989,185050,106944431,107337647,11558
1,ENSG00000162631.12,107141039,1-106955989-G-A,rs74844465,1,G,A,106955989,185050,106944431,107337647,11558
1,ENSG00000244038.2,20661369,1-20469333-C-G,rs75005663,-1,C,G,20469333,192036,20464761,20857977,4572
1,ENSG00000121940.11,108963484,1-108786501-C-T,rs75055869,-1,C,T,108786501,176983,108766876,109160092,19625
1,ENSG00000143387.8,150808260,1-150886564-G-C,rs75067938,-1,G,C,150886564,78304,150611652,151004868,274912
1,ENSG00000240563.1,62194849,1-62198115-C-T,rs7518470,1,C,T,62198115,3266,61998241,62391457,199874
1,ENSG00000117054.8,75724709,1-75558175-G-T,rs7518629,1,G,T,75558175,166534,75528101,75921317,30074
1,ENSG00000117054.8,75724709,1-75558175-G-A,rs7518629,1,G,A,75558175,166534,75528101,75921317,30074
1,ENSG00000135821.10,182391790,1-182350975-G-T,rs7524729,-1,G,T,182350975,40815,182195182,182588398,155793
1,ENSG00000135821.10,182391790,1-182350975-G-A,rs7524729,-1,G,A,182350975,40815,182195182,182588398,155793
1,ENSG00000135821.10,182391790,1-182350975-G-C,rs7524729,-1,G,C,182350975,40815,182195182,182588398,155793
1,ENSG00000162892.11,206897443,1-207013450-G-C,rs7525449,1,G,C,207013450,116007,206700835,207094051,312615
1,ENSG00000162892.11,206897443,1-207013450-G-A,rs7525449,1,G,A,207013450,116007,206700835,207094051,312615
1,ENSG00000162892.11,206897443,1-207013450-G-T,rs7525449,1,G,T,207013450,116007,206700835,207094051,312615
1,ENSG00000135845.4,172444069,1-172412243-T-C,rs7528296,-1,T,C,172412243,31826,172247461,172640677,164782
1,ENSG00000135845.4,172444069,1-172412243-T-A,rs7528296,-1,T,A,172412243,31826,172247461,172640677,164782
1,ENSG00000163344.5,154936719,1-154962189-C-T,rs7528548,-1,C,T,154962189,25470,154740111,155133327,222078
1,ENSG00000163344.5,154936719,1-154962189-C-G,rs7528548,-1,C,G,154962189,25470,154740111,155133327,222078
1,ENSG00000143257.7,161238203,1-161220144-C-A,rs7528588,-1,C,A,161220144,18059,161041595,161434811,178549
1,ENSG00000143257.7,161238203,1-161220144-C-T,rs7528588,-1,C,T,161220144,18059,161041595,161434811,178549
1,ENSG00000143257.7,161238203,1-161220144-C-G,rs7528588,-1,C,G,161220144,18059,161041595,161434811,178549
1,ENSG00000152382.5,166876264,1-166985633-A-G,rs7528849,-1,A,G,166985633,109369,166679656,167072872,305977
1,ENSG00000000460.11,169795040,1-169776518-T-C,rs75293665,1,T,C,169776518,18522,169598432,169991648,178086
1,ENSG00000198198.9,43389899,1-43579623-A-G,rs752963,1,A,G,43579623,189724,43193291,43586507,386332
1,ENSG00000117139.10,202808421,1-202718949-A-G,rs7529811,-1,A,G,202718949,89472,202611813,203005029,107136
1,ENSG00000117139.10,202808421,1-202718949-A-T,rs7529811,-1,A,T,202718949,89472,202611813,203005029,107136
1,ENSG00000177674.10,11736136,1-11722724-G-C,rs7533583,1,G,C,11722724,13412,11539528,11932744,183196
1,ENSG00000177674.10,11736136,1-11722724-G-T,rs7533583,1,G,T,11722724,13412,11539528,11932744,183196
1,ENSG00000118197.8,200669907,1-200703571-A-G,rs7535122,-1,A,G,200703571,33664,200473299,200866515,230272
1,ENSG00000117016.5,40665682,1-40566387-G-A,rs7537003,-1,G,A,40566387,99295,40469074,40862290,97313
1,ENSG00000163534.10,157820120,1-157808844-T-C,rs7538531,-1,T,C,157808844,11276,157623512,158016728,185332
1,ENSG00000163534.10,157820120,1-157808844-T-A,rs7538531,-1,T,A,157808844,11276,157623512,158016728,185332
1,ENSG00000197956.4,153535991,1-153699771-G-T,rs7541193,-1,G,T,153699771,163780,153339383,153732599,360388
1,ENSG00000188558.4,248508073,1-248359594-G-A,rs7541216,1,G,A,248359594,148479,248311465,248704681,48129
1,ENSG00000196878.7,209652425,1-209660101-T-C,rs7542165,-1,T,C,209660101,7676,209455817,209849033,204284
1,ENSG00000117697.10,212791777,1-212707744-C-T,rs7545473,-1,C,T,212707744,84033,212595169,212988385,112575
1,ENSG00000117697.10,212791777,1-212707744-C-G,rs7545473,-1,C,G,212707744,84033,212595169,212988385,112575
1,ENSG00000081721.6,161749786,1-161718641-T-C,rs7549830,1,T,C,161718641,31145,161553178,161946394,165463
1,ENSG00000116459.6,111449464,1-111387158-C-G,rs7552795,1,C,G,111387158,62306,111252856,111646072,134302
1,ENSG00000116459.6,111449464,1-111387158-C-A,rs7552795,1,C,A,111387158,62306,111252856,111646072,134302
1,ENSG00000116459.6,111449464,1-111387158-C-T,rs7552795,1,C,T,111387158,62306,111252856,111646072,134302
1,ENSG00000203943.4,84301708,1-84386875-A-G,rs7554646,1,A,G,84386875,85167,84105100,84498316,281775
1,ENSG00000162817.6,220690363,1-220510125-T-G,rs75968823,1,T,G,220510125,180238,220493755,220886971,16370
1,ENSG00000127463.8,19251524,1-19353625-C-T,rs761308,-1,C,T,19353625,102101,19054916,19448132,298709
1,ENSG00000177868.7,42817397,1-43001414-T-C,rs76794017,-1,T,C,43001414,184017,42620789,43014005,380625
1,ENSG00000143110.7,111473984,1-111466408-A-C,rs76940009,1,A,C,111466408,7576,111277376,111670592,189032
1,ENSG00000169972.7,1308597,1-1184166-G-A,rs77051049,1,G,A,1184166,124431,1111989,1505205,72177
1,ENSG00000169972.7,1308597,1-1184166-G-T,rs77051049,1,G,T,1184166,124431,1111989,1505205,72177
1,ENSG00000122483.13,93180724,1-93348442-G-A,rs771463,1,G,A,93348442,167718,92984116,93377332,364326
1,ENSG00000122483.13,93180724,1-93348442-G-T,rs771463,1,G,T,93348442,167718,92984116,93377332,364326
1,ENSG00000179403.10,1435690,1-1565709-G-A,rs77167259,1,G,A,1565709,130019,1239082,1632298,326627
1,ENSG00000121903.8,33472645,1-33379185-C-T,rs77782749,1,C,T,33379185,93460,33276037,33669253,103148
1,ENSG00000143256.4,161118037,1-161123347-A-G,rs78180560,-1,A,G,161123347,5310,160921429,161314645,201918
1,ENSG00000143093.9,110034624,1-110225968-C-T,rs78186862,1,C,T,110225968,191344,109838016,110231232,387952
1,ENSG00000159208.11,150282554,1-150434964-T-C,rs78372713,1,T,C,150434964,152410,150085946,150479162,349018
1,ENSG00000116983.7,39691433,1-39687004-T-C,rs785108,-1,T,C,39687004,4429,39494825,39888041,192179
1,ENSG00000116983.7,39691433,1-39687004-T-G,rs785108,-1,T,G,39687004,4429,39494825,39888041,192179
1,ENSG00000116983.7,39691433,1-39687004-T-A,rs785108,-1,T,A,39687004,4429,39494825,39888041,192179
1,ENSG00000123473.10,47314147,1-47397354-A-G,rs78612312,-1,A,G,47397354,83207,47117539,47510755,279815
1,ENSG00000117215.10,20119536,1-20216414-G-A,rs79023935,-1,G,A,20216414,96878,19922928,20316144,293486
1,ENSG00000118733.11,101996926,1-102027305-C-G,rs79079054,-1,C,G,102027305,30379,101800318,102193534,226987
1,ENSG00000118733.11,101996926,1-102027305-C-T,rs79079054,-1,C,T,102027305,30379,101800318,102193534,226987
1,ENSG00000043514.9,39883504,1-39826792-C-T,rs79316541,-1,C,T,39826792,56712,39686896,40080112,139896
1,ENSG00000155380.7,112956196,1-112772771-G-A,rs79681376,-1,G,A,112772771,183425,112759588,113152804,13183
1,ENSG00000142583.11,9069635,1-9010125-C-T,rs79843700,-1,C,T,9010125,59510,8873027,9266243,137098
1,ENSG00000158062.13,26306636,1-26402358-G-A,rs79954464,-1,G,A,26402358,95722,26110028,26503244,292330
1,ENSG00000134255.9,111140223,1-111015418-G-A,rs80048433,1,G,A,111015418,124805,110943615,111336831,71803
1,ENSG00000182749.5,25875708,1-25789585-G-T,rs807253,-1,G,T,25789585,86123,25679100,26072316,110485
1,ENSG00000182749.5,25875708,1-25789585-G-A,rs807253,-1,G,A,25789585,86123,25679100,26072316,110485
1,ENSG00000158747.9,19644311,1-19665879-G-A,rs8192529,1,G,A,19665879,21568,19447703,19840919,218176
1,ENSG00000158747.9,19644311,1-19665879-G-T,rs8192529,1,G,T,19665879,21568,19447703,19840919,218176
1,ENSG00000185519.8,16073651,1-15951152-C-T,rs848189,-1,C,T,15951152,122499,15877043,16270259,74109
1,ENSG00000186510.6,16022036,1-15958847-G-A,rs848194,1,G,A,15958847,63189,15825428,16218644,133419
1,ENSG00000142856.12,63523225,1-63603824-G-A,rs855316,-1,G,A,63603824,80599,63326617,63719833,277207
1,ENSG00000142856.12,63523225,1-63603824-G-C,rs855316,-1,G,C,63603824,80599,63326617,63719833,277207
1,ENSG00000132768.9,43970010,1-43982438-C-T,rs869896,1,C,T,43982438,12428,43773402,44166618,209036
1,ENSG00000142794.11,21440137,1-21489167-C-T,rs904927,1,C,T,21489167,49030,21243529,21636745,245638
1,ENSG00000160685.9,155002802,1-154850041-C-G,rs906597,1,C,G,154850041,152761,154806194,155199410,43847
1,ENSG00000116199.7,179025894,1-179085557-T-G,rs912758,1,T,G,179085557,59663,178829286,179222502,256271
1,ENSG00000160049.6,10472529,1-10287984-C-T,rs912963,-1,C,T,10287984,184545,10275921,10669137,12063
1,ENSG00000143774.10,228140279,1-228126990-T-A,rs9287011,1,T,A,228126990,13289,227943671,228336887,183319
1,ENSG00000143198.7,165631234,1-165631529-A-G,rs9333372,1,A,G,165631529,295,165434626,165827842,196903
1,ENSG00000117650.8,211675621,1-211564305-T-C,rs9430071,-1,T,C,211564305,111316,211479013,211872229,85292
1,ENSG00000049239.7,9234774,1-9232223-G-A,rs9434723,1,G,A,9232223,2551,9038166,9431382,194057
1,ENSG00000134716.5,59926773,1-59733919-T-C,rs9436185,-1,T,C,59733919,192854,59730165,60123381,3754
1,ENSG00000189409.7,1632173,1-1688328-C-T,rs9442411,1,C,T,1688328,56155,1435565,1828781,252763
1,ENSG00000228594.1,1600135,1-1688328-C-T,rs9442411,-1,C,T,1688328,88193,1403527,1796743,284801
1,ENSG00000133065.6,205813198,1-205838376-C-G,rs954206,-1,C,G,205838376,25178,205616590,206009806,221786
1,ENSG00000133065.6,205813198,1-205838376-C-T,rs954206,-1,C,T,205838376,25178,205616590,206009806,221786
1,ENSG00000159348.8,202967257,1-203099592-T-A,rs9660662,-1,T,A,203099592,132335,202770649,203163865,328943
1,ENSG00000159348.8,202967257,1-203099592-T-C,rs9660662,-1,T,C,203099592,132335,202770649,203163865,328943
1,ENSG00000171357.5,46203334,1-46256717-A-G,rs9793263,1,A,G,46256717,53383,46006726,46399942,249991
1,ENSG00000171357.5,46203334,1-46256717-A-T,rs9793263,1,A,T,46256717,53383,46006726,46399942,249991
1,ENSG00000094975.8,172533150,1-172504877-C-T,rs9943237,1,C,T,172504877,28273,172336542,172729758,168335
